API Key,Date,Year,Home Team,Away Team,Home Score,Away Score,Final Score,Winning Team,# Innings,End Top Inning?,Home Team PA #,Away Team PA #,Total Number PA,Homne Team # Pitches,Away Team # Pitches,Total # Pitches,Home Team Baserunners,Away Team Baserunners,Total # Baserunners,Pitching Changes,Time
385475,2014-03-30,2014,HOU,VRA,6,1,6-1,HOU,9,true,37,32,69,116,130,246,15,7,22,2,2:31
380546,2014-03-30,2014,SDN,LAN,3,1,3-1,SDN,9,true,33,34,67,133,125,258,9,7,16,3,2:49
380547,2014-03-31,2014,CHA,MIN,5,3,5-3,CHA,9,true,34,34,68,133,130,263,13,8,21,3,2:35
380544,2014-03-31,2014,MIA,COL,10,1,10-1,MIA,9,true,41,33,74,128,155,283,17,7,24,1,2:58
380551,2014-03-31,2014,CIN,SLN,0,1,1-0,SLN,9,false,36,34,70,128,140,268,9,7,16,3,2:56
380552,2014-03-31,2014,TBA,TOR,9,2,9-2,TBA,9,true,44,34,78,129,154,283,21,8,29,1,3:04
380543,2014-03-31,2014,OAK,CLE,0,2,2-0,CLE,9,false,36,40,76,161,141,302,9,13,22,2,3:15
380545,2014-03-31,2014,DET,KCA,4,3,4-3,DET,9,false,35,38,73,141,155,296,11,10,21,2,3:01
380542,2014-03-31,2014,PIT,CHN,1,0,1-0,PIT,10,false,33,38,71,154,128,282,9,10,19,1,3:16
380541,2014-03-31,2014,BAL,BOS,2,1,2-1,BAL,9,true,29,40,69,169,117,286,7,13,20,1,2:53
380550,2014-03-31,2014,ARI,SFN,8,9,9-8,SFN,9,false,46,41,87,141,167,308,19,14,33,3,3:25
380553,2014-03-31,2014,NYN,WAS,7,9,9-7,WAS,10,false,40,45,85,179,163,342,10,15,25,4,3:47
380548,2014-03-31,2014,TEX,PHI,10,14,14-10,PHI,9,false,44,50,94,192,172,364,18,23,41,3,3:36
380540,2014-03-31,2014,MIL,ATL,2,0,2-0,MIL,9,true,30,34,64,137,105,242,9,7,16,1,2:45
380549,2014-03-31,2014,ANA,SEA,3,10,10-3,SEA,9,false,36,45,81,167,145,312,8,20,28,4,3:17
380561,2014-04-01,2014,ARI,SFN,5,4,5-4,ARI,9,true,36,36,72,123,147,270,15,9,24,0,2:46
380554,2014-04-01,2014,MIL,ATL,2,5,5-2,ATL,9,false,35,37,72,125,133,258,10,11,21,1,2:34
380556,2014-04-01,2014,MIA,COL,4,3,4-3,MIA,9,true,29,37,66,147,107,254,6,11,17,1,2:24
380557,2014-04-01,2014,SDN,LAN,2,3,3-2,LAN,9,false,36,37,73,161,153,314,10,10,20,2,3:38
380562,2014-04-01,2014,TBA,TOR,2,4,4-2,TOR,9,false,36,37,73,168,141,309,11,11,22,2,3:32
380558,2014-04-01,2014,HOU,NYA,6,2,6-2,HOU,9,true,34,37,71,138,127,265,10,11,21,2,2:51
380560,2014-04-01,2014,ANA,SEA,3,8,8-3,SEA,9,false,35,39,74,176,121,297,10,14,24,2,3:05
380559,2014-04-01,2014,TEX,PHI,3,2,3-2,TEX,9,false,40,35,75,141,144,285,17,10,27,2,3:14
380575,2014-04-02,2014,CIN,SLN,1,0,1-0,CIN,9,false,36,33,69,137,141,278,11,6,17,1,2:45 (2:40 delay)
380574,2014-04-02,2014,ARI,SFN,0,2,2-0,SFN,9,false,31,37,68,149,123,272,3,10,13,2,2:49
380573,2014-04-02,2014,ANA,SEA,2,8,8-2,SEA,9,false,32,42,74,155,132,287,5,17,22,1,2:39
380564,2014-04-02,2014,BAL,BOS,2,6,6-2,BOS,9,false,35,40,75,147,139,286,7,16,23,1,2:43
380577,2014-04-02,2014,NYN,WAS,1,5,5-1,WAS,9,false,32,40,72,160,139,299,5,13,18,0,3:00
380569,2014-04-02,2014,SDN,LAN,1,5,5-1,LAN,9,false,34,39,73,151,132,283,6,13,19,2,3:02
380572,2014-04-02,2014,TEX,PHI,4,3,4-3,TEX,9,false,37,38,75,148,131,279,12,12,24,1,3:02
380576,2014-04-02,2014,TBA,TOR,0,3,3-0,TOR,9,false,32,42,74,167,118,285,6,16,22,4,2:55
380567,2014-04-02,2014,MIA,COL,5,6,6-5,COL,9,false,40,42,82,141,167,308,13,16,29,2,3:23
380568,2014-04-02,2014,DET,KCA,2,1,2-1,DET,10,false,37,37,74,144,158,302,9,9,18,0,3:22
380566,2014-04-02,2014,OAK,CLE,6,1,6-1,OAK,9,true,42,32,74,132,172,304,17,5,22,2,3:05
380571,2014-04-02,2014,HOU,NYA,3,1,3-1,HOU,9,true,32,36,68,160,129,289,9,10,19,3,3:18
380555,2014-04-02,2014,OAK,CLE,4,6,6-4,CLE,9,false,39,44,83,177,160,337,14,18,32,5,3:33
380555,2014-04-02,2014,OAK,CLE,4,6,6-4,CLE,9,false,39,44,83,177,160,337,14,18,32,5,3:33
380570,2014-04-02,2014,CHA,MIN,7,6,7-6,CHA,11,false,49,53,102,228,187,415,18,19,37,5,4:19
380565,2014-04-02,2014,PIT,CHN,4,3,4-3,PIT,16,false,65,70,135,258,256,514,21,24,45,1,5:55
380563,2014-04-02,2014,MIL,ATL,0,1,1-0,ATL,9,false,30,32,62,113,123,236,3,5,8,2,2:36
380580,2014-04-03,2014,MIA,COL,8,5,8-5,MIA,9,true,41,39,80,140,143,283,17,13,30,1,3:14
380587,2014-04-03,2014,TBA,TOR,7,2,7-2,TBA,9,true,38,36,74,150,157,307,16,9,25,2,3:21
380586,2014-04-03,2014,CIN,SLN,6,7,7-6,SLN,9,false,41,42,83,177,173,350,13,18,31,4,3:41 (3:42 delay)
380584,2014-04-03,2014,OAK,SEA,3,2,3-2,OAK,12,false,46,45,91,164,199,363,16,9,25,3,4:02
380588,2014-04-03,2014,NYN,WAS,2,8,8-2,WAS,9,false,37,44,81,174,139,313,11,18,29,1,3:21
380582,2014-04-03,2014,CHA,MIN,9,10,10-9,MIN,9,false,44,43,87,192,165,357,17,15,32,2,3:42
380583,2014-04-03,2014,HOU,NYA,2,4,4-2,NYA,9,false,36,37,73,154,128,282,13,11,24,2,3:17
380578,2014-04-03,2014,BAL,BOS,3,4,4-3,BOS,9,false,37,40,77,148,121,269,11,16,27,2,2:55
380579,2014-04-03,2014,PIT,CHN,2,3,3-2,CHN,9,false,34,33,67,129,133,262,8,8,16,3,2:39
380585,2014-04-03,2014,ARI,SFN,5,8,8-5,SFN,9,false,36,41,77,155,150,305,10,15,25,5,3:11
380594,2014-04-04,2014,NYN,CIN,4,3,4-3,NYN,9,true,33,40,73,151,132,283,9,14,23,3,2:59
380599,2014-04-04,2014,MIA,SDN,8,2,8-2,MIA,9,true,40,37,77,128,138,266,17,11,28,0,2:37
380591,2014-04-04,2014,WAS,ATL,1,2,2-1,ATL,9,false,36,35,71,125,138,263,12,9,21,1,3:03
380595,2014-04-04,2014,BOS,MIL,2,6,6-2,MIL,9,false,34,43,77,145,153,298,11,16,27,2,3:19
380598,2014-04-04,2014,CHN,PHI,2,7,7-2,PHI,9,false,32,43,75,171,128,299,6,15,21,5,3:16
380601,2014-04-04,2014,LAN,SFN,4,8,8-4,SFN,9,false,38,39,77,156,171,327,12,13,25,2,3:25
380592,2014-04-04,2014,DET,BAL,10,4,10-4,DET,9,true,42,38,80,150,151,301,21,11,32,2,3:07 (:44 delay)
380590,2014-04-04,2014,COL,ARI,12,2,12-2,COL,9,true,47,37,84,127,180,307,25,9,34,1,3:13
380603,2014-04-04,2014,TBA,TEX,8,1,8-1,TBA,9,true,44,35,79,141,171,312,18,9,27,1,3:10
380596,2014-04-04,2014,CLE,MIN,7,2,7-2,CLE,9,true,38,37,75,148,131,279,15,13,28,4,3:01 (2:13 delay)
380593,2014-04-04,2014,KCA,CHA,7,5,7-5,KCA,9,true,43,41,84,171,166,337,21,14,35,3,3:37
380602,2014-04-04,2014,PIT,SLN,12,2,12-2,PIT,9,true,41,37,78,149,164,313,22,10,32,2,3:07 (1:05 delay)
380597,2014-04-04,2014,TOR,NYA,3,7,7-3,NYA,9,false,35,45,80,170,134,304,8,21,29,4,3:26
380589,2014-04-04,2014,HOU,ANA,1,11,11-1,ANA,9,false,40,46,86,163,186,349,14,19,33,1,3:35
380615,2014-04-05,2014,OAK,SEA,1,3,3-1,SEA,9,false,34,35,69,132,113,245,7,9,16,1,2:22
380604,2014-04-05,2014,HOU,ANA,1,5,5-1,ANA,9,false,32,44,76,162,107,269,5,17,22,0,3:02
380612,2014-04-05,2014,TOR,NYA,4,0,4-0,TOR,9,true,32,37,69,155,125,280,9,12,21,3,2:45
380609,2014-04-05,2014,NYN,CIN,6,3,6-3,NYN,9,false,36,35,71,131,129,260,12,8,20,1,2:48
380613,2014-04-05,2014,CHN,PHI,0,2,2-0,PHI,9,false,37,37,74,151,136,287,11,14,25,1,2:53
380617,2014-04-05,2014,PIT,SLN,1,6,6-1,SLN,9,false,39,39,78,143,146,289,12,12,24,1,2:58
380608,2014-04-05,2014,KCA,CHA,4,3,4-3,KCA,9,true,34,39,73,154,134,288,12,12,24,2,2:59
380611,2014-04-05,2014,CLE,MIN,3,7,7-3,MIN,9,false,36,42,78,143,143,286,11,16,27,2,2:50
380606,2014-04-05,2014,WAS,ATL,2,6,6-2,ATL,9,false,37,45,82,170,151,321,11,17,28,1,3:36
380616,2014-04-05,2014,LAN,SFN,2,7,7-2,SFN,9,false,36,42,78,178,162,340,12,17,29,3,3:42
380605,2014-04-05,2014,COL,ARI,9,4,9-4,COL,9,true,36,38,74,177,114,291,13,9,22,1,3:09
380607,2014-04-05,2014,DET,BAL,7,6,7-6,DET,9,true,38,39,77,149,167,316,15,13,28,3,3:20
380614,2014-04-05,2014,MIA,SDN,5,0,5-0,MIA,9,true,39,35,74,148,153,301,16,8,24,2,2:49
380618,2014-04-05,2014,TBA,TEX,5,4,5-4,TBA,9,true,34,37,71,131,123,254,13,10,23,0,2:48
380610,2014-04-05,2014,BOS,MIL,6,7,7-6,MIL,11,false,42,53,95,188,179,367,10,20,30,5,4:23
380632,2014-04-06,2014,PIT,SLN,2,1,2-1,PIT,9,true,30,31,61,112,115,227,8,6,14,1,2:29
380631,2014-04-06,2014,LAN,SFN,6,2,6-2,LAN,9,true,31,35,66,140,101,241,7,8,15,1,2:51
380624,2014-04-06,2014,NYN,CIN,1,2,2-1,CIN,9,false,32,37,69,139,102,241,6,11,17,1,2:35
380633,2014-04-06,2014,TBA,TEX,0,3,3-0,TEX,9,false,37,35,72,140,119,259,10,8,18,2,3:01
380619,2014-04-06,2014,HOU,ANA,7,4,7-4,HOU,9,true,32,37,69,148,126,274,8,11,19,2,2:52
380629,2014-04-06,2014,MIA,SDN,2,4,4-2,SDN,9,false,32,36,68,136,129,265,6,10,16,1,2:44
380620,2014-04-06,2014,COL,ARI,3,5,5-3,ARI,9,false,33,42,75,126,113,239,11,18,29,0,2:29
380621,2014-04-06,2014,WAS,ATL,2,1,2-1,WAS,9,true,29,37,66,137,120,257,4,10,14,3,2:44
380623,2014-04-06,2014,KCA,CHA,1,5,5-1,CHA,9,false,33,38,71,146,131,277,8,12,20,1,2:49
380630,2014-04-06,2014,OAK,SEA,6,3,6-3,OAK,9,true,35,37,72,137,143,280,13,11,24,1,2:57
380628,2014-04-06,2014,CHN,PHI,8,3,8-3,CHN,9,true,38,40,78,142,150,292,14,13,27,2,3:14
380622,2014-04-06,2014,DET,BAL,1,3,3-1,BAL,9,false,33,37,70,128,127,255,6,10,16,1,2:34
380627,2014-04-06,2014,TOR,NYA,4,6,6-4,NYA,9,false,37,40,77,161,137,298,10,14,24,1,2:57
380626,2014-04-06,2014,CLE,MIN,7,10,10-7,MIN,9,false,46,45,91,194,196,390,21,21,42,4,3:55
380625,2014-04-06,2014,BOS,MIL,0,4,4-0,MIL,9,false,36,38,74,141,141,282,9,11,20,2,2:57
380641,2014-04-07,2014,KCA,TBA,4,2,4-2,KCA,9,true,35,35,70,128,137,265,13,7,20,3,2:56
380636,2014-04-07,2014,COL,CHA,8,1,8-1,COL,9,true,42,33,75,119,151,270,18,7,25,2,2:42
380634,2014-04-07,2014,HOU,ANA,1,9,9-1,ANA,9,false,31,43,74,160,132,292,5,15,20,0,2:44
380639,2014-04-07,2014,MIN,OAK,3,8,8-3,OAK,9,false,40,40,80,151,153,304,13,14,27,1,3:05
380642,2014-04-07,2014,BOS,TEX,5,1,5-1,BOS,9,true,40,35,75,132,153,285,18,10,28,1,3:07
380635,2014-04-07,2014,NYA,BAL,4,2,4-2,NYA,9,true,36,34,70,125,163,288,14,9,23,4,3:05
380637,2014-04-07,2014,SLN,CIN,5,3,5-3,SLN,9,true,39,37,76,132,154,286,16,13,29,2,2:59
380650,2014-04-08,2014,WAS,MIA,5,0,5-0,WAS,9,true,34,34,68,159,120,279,11,8,19,2,2:58
380643,2014-04-08,2014,SEA,ANA,5,3,5-3,SEA,9,true,38,34,72,120,151,271,14,8,22,5,2:59
380644,2014-04-08,2014,SFN,ARI,7,3,7-3,SFN,9,true,36,33,69,112,159,271,14,8,22,1,2:39
380654,2014-04-08,2014,KCA,TBA,0,1,1-0,TBA,9,false,37,33,70,159,133,292,12,6,18,1,3:13
380648,2014-04-08,2014,LAN,DET,3,2,3-2,LAN,10,false,38,35,73,155,145,300,12,7,19,1,3:23
380649,2014-04-08,2014,TOR,HOU,5,2,5-2,TOR,9,true,34,39,73,147,149,296,12,13,25,2,2:52
380651,2014-04-08,2014,ATL,NYN,0,4,4-0,NYN,9,false,37,39,76,156,137,293,8,13,21,3,3:07
380646,2014-04-08,2014,COL,CHA,3,15,15-3,CHA,9,false,35,50,85,174,119,293,10,26,36,2,3:10
380647,2014-04-08,2014,SLN,CIN,7,5,7-5,SLN,9,true,41,37,78,147,159,306,18,10,28,0,3:10
380655,2014-04-08,2014,BOS,TEX,7,10,10-7,TEX,9,false,40,44,84,148,160,308,18,17,35,2,3:11
380638,2014-04-08,2014,PHI,MIL,4,10,10-4,MIL,9,false,42,46,88,164,181,345,15,19,34,1,3:32
380638,2014-04-08,2014,PHI,MIL,4,10,10-4,MIL,9,false,42,46,88,164,181,345,15,19,34,1,3:32
380653,2014-04-08,2014,CLE,SDN,8,6,8-6,CLE,9,true,37,42,79,170,138,308,13,15,28,3,3:15
380652,2014-04-08,2014,CHN,PIT,6,7,7-6,PIT,9,false,38,45,83,164,140,304,11,20,31,2,3:20
380645,2014-04-08,2014,NYA,BAL,5,14,14-5,BAL,9,false,42,48,90,163,180,343,15,23,38,3,3:28
380660,2014-04-09,2014,SLN,CIN,0,4,4-0,CIN,9,false,29,40,69,131,112,243,5,13,18,0,2:19
380668,2014-04-09,2014,CLE,SDN,2,0,2-0,CLE,9,true,32,34,66,120,129,249,8,7,15,3,2:30
380665,2014-04-09,2014,ATL,NYN,4,3,4-3,ATL,9,true,33,35,68,122,131,253,9,8,17,2,2:40
380656,2014-04-09,2014,SEA,ANA,0,2,2-0,ANA,9,false,33,36,69,148,132,280,5,9,14,2,2:53
380669,2014-04-09,2014,KCA,TBA,7,3,7-3,KCA,9,true,35,36,71,136,128,264,12,10,22,0,2:46
380670,2014-04-09,2014,BOS,TEX,4,2,4-2,BOS,9,true,32,35,67,145,141,286,11,9,20,3,2:57
380640,2014-04-09,2014,CLE,SDN,1,2,2-1,SDN,9,false,35,35,70,129,146,275,8,8,16,1,2:51
380640,2014-04-09,2014,CLE,SDN,1,2,2-1,SDN,9,false,35,35,70,129,146,275,8,8,16,1,2:51
380667,2014-04-09,2014,CHN,PIT,7,5,7-5,CHN,9,true,41,34,75,130,150,280,19,7,26,0,2:41
380662,2014-04-09,2014,TOR,HOU,7,3,7-3,TOR,9,true,39,34,73,141,171,312,17,7,24,3,3:09
380658,2014-04-09,2014,NYA,BAL,4,5,5-4,BAL,9,false,36,41,77,156,134,290,13,14,27,2,3:06
380659,2014-04-09,2014,COL,CHA,10,4,10-4,COL,9,true,41,36,77,141,154,295,19,10,29,5,3:23
380664,2014-04-09,2014,PHI,MIL,4,9,9-4,MIL,9,false,39,45,84,173,136,309,12,16,28,0,3:24
380666,2014-04-09,2014,MIN,OAK,4,7,7-4,OAK,11,false,48,45,93,198,179,377,18,13,31,3,3:41
380663,2014-04-09,2014,WAS,MIA,10,7,10-7,WAS,9,true,41,46,87,195,169,364,17,20,37,4,3:56
380661,2014-04-09,2014,LAN,DET,6,7,7-6,DET,10,false,42,45,87,187,195,382,14,18,32,3,4:16
380657,2014-04-09,2014,SFN,ARI,3,7,7-3,ARI,9,false,38,41,79,150,143,293,12,14,26,0,2:52
380672,2014-04-10,2014,NYA,BOS,4,1,4-1,NYA,9,true,30,33,63,141,119,260,7,6,13,2,2:55
380675,2014-04-10,2014,WAS,MIA,7,1,7-1,WAS,9,true,37,33,70,127,147,274,14,5,19,3,2:53
380673,2014-04-10,2014,CHA,CLE,7,3,7-3,CHA,9,true,36,34,70,136,157,293,13,8,21,2,2:52
380674,2014-04-10,2014,TOR,HOU,4,6,6-4,HOU,9,false,38,37,75,146,139,285,11,12,23,1,2:49
380677,2014-04-10,2014,ATL,NYN,4,6,6-4,NYN,9,false,37,42,79,164,135,299,11,15,26,2,3:26
380671,2014-04-10,2014,SFN,ARI,5,6,6-5,ARI,10,false,45,47,92,180,175,355,18,19,37,5,4:10
380676,2014-04-10,2014,PHI,MIL,2,6,6-2,MIL,9,false,35,38,73,134,143,277,9,12,21,1,2:48
380679,2014-04-10,2014,CHN,PIT,4,5,5-4,PIT,9,false,37,40,77,166,156,322,11,13,24,3,3:20
380678,2014-04-10,2014,MIN,OAK,1,6,6-1,OAK,9,false,32,43,75,162,135,297,6,18,24,1,2:51
380693,2014-04-11,2014,BAL,TOR,0,2,2-0,TOR,9,false,35,32,67,115,120,235,8,4,12,2,2:20
380687,2014-04-11,2014,ARI,LAN,0,6,6-0,LAN,9,false,30,36,66,116,124,240,4,11,15,1,2:26
380692,2014-04-11,2014,CIN,TBA,1,2,2-1,TBA,9,false,35,38,73,153,139,292,8,12,20,1,3:22
380680,2014-04-11,2014,NYA,BOS,2,4,4-2,BOS,9,false,35,37,72,149,145,294,9,10,19,2,3:01
380690,2014-04-11,2014,SEA,OAK,6,4,6-4,SEA,9,true,38,37,75,140,142,282,12,9,21,4,3:09
380688,2014-04-11,2014,PHI,MIA,6,3,6-3,PHI,9,true,39,40,79,173,141,314,17,15,32,2,3:15
380691,2014-04-11,2014,MIL,PIT,4,2,4-2,MIL,9,true,32,33,65,131,123,254,8,6,14,0,2:41
380686,2014-04-11,2014,MIN,KCA,10,1,10-1,MIN,9,true,43,35,78,139,191,330,18,9,27,2,3:13
380689,2014-04-11,2014,ANA,NYN,5,4,5-4,ANA,11,false,53,41,94,148,195,343,24,10,34,3,3:54
380694,2014-04-11,2014,ATL,WAS,7,6,7-6,ATL,10,false,41,46,87,159,177,336,16,19,35,1,3:49
380681,2014-04-11,2014,SLN,CHN,3,6,6-3,CHN,11,false,47,45,92,179,189,368,16,16,32,2,4:09
380682,2014-04-11,2014,CHA,CLE,9,6,9-6,CHA,9,true,43,42,85,181,168,349,21,15,36,1,3:28
380685,2014-04-11,2014,TEX,HOU,1,0,1-0,TEX,12,false,52,40,92,156,211,367,22,5,27,1,4:11
380684,2014-04-11,2014,SDN,DET,6,0,6-0,SDN,9,true,36,30,66,108,122,230,13,3,16,1,2:25
380683,2014-04-11,2014,SFN,COL,6,5,6-5,SFN,9,true,35,38,73,156,138,294,10,13,23,2,3:16
380698,2014-04-12,2014,SFN,COL,0,1,1-0,COL,9,false,33,34,67,135,116,251,7,8,15,0,2:48
380701,2014-04-12,2014,MIN,KCA,7,1,7-1,MIN,9,true,35,34,69,117,160,277,9,7,16,1,2:35
380696,2014-04-12,2014,SLN,CHN,10,4,10-4,SLN,9,true,40,36,76,130,125,255,15,9,24,1,2:40
380695,2014-04-12,2014,NYA,BOS,7,4,7-4,NYA,9,true,38,38,76,138,146,284,15,11,26,4,3:07
380699,2014-04-12,2014,SDN,DET,2,6,6-2,DET,9,false,38,42,80,146,143,289,11,16,27,0,3:05
380703,2014-04-12,2014,PHI,MIA,5,4,5-4,PHI,10,false,38,46,84,159,160,319,11,16,27,2,3:29
380707,2014-04-12,2014,CIN,TBA,0,1,1-0,TBA,9,false,30,33,63,113,114,227,6,6,12,0,2:31
380709,2014-04-12,2014,ATL,WAS,6,3,6-3,ATL,9,true,40,41,81,193,148,341,16,16,32,0,3:33
380706,2014-04-12,2014,MIL,PIT,3,2,3-2,MIL,9,true,34,33,67,137,117,254,9,10,19,2,2:53
380704,2014-04-12,2014,ANA,NYN,6,7,7-6,NYN,13,false,47,57,104,243,184,427,11,20,31,4,4:29
380705,2014-04-12,2014,SEA,OAK,1,3,3-1,OAK,9,false,36,37,73,166,127,293,9,11,20,1,3:08
380708,2014-04-12,2014,BAL,TOR,2,1,2-1,BAL,12,false,44,46,90,190,176,366,13,13,26,1,3:39
380700,2014-04-12,2014,TEX,HOU,5,6,6-5,HOU,10,false,42,42,84,147,172,319,16,12,28,1,3:15
380697,2014-04-12,2014,CHA,CLE,6,12,12-6,CLE,9,false,43,47,90,189,155,344,15,21,36,4,3:28
380702,2014-04-12,2014,ARI,LAN,5,8,8-5,LAN,9,false,43,46,89,177,182,359,16,18,34,4,3:47
380721,2014-04-13,2014,MIL,PIT,4,1,4-1,MIL,9,true,34,31,65,103,105,208,11,4,15,1,2:11
380713,2014-04-13,2014,SFN,COL,5,4,5-4,SFN,10,false,34,36,70,120,109,229,11,8,19,2,2:41
380710,2014-04-13,2014,NYA,BOS,3,2,3-2,NYA,9,true,34,37,71,137,118,255,11,11,22,3,3:08
380716,2014-04-13,2014,MIN,KCA,4,3,4-3,MIN,9,true,33,34,67,106,153,259,11,8,19,3,2:47
380724,2014-04-13,2014,ATL,WAS,10,2,10-2,ATL,9,true,42,34,76,149,144,293,17,8,25,1,2:56
380714,2014-04-13,2014,SDN,DET,5,1,5-1,SDN,9,true,34,37,71,141,150,291,9,10,19,1,2:53
380718,2014-04-13,2014,PHI,MIA,4,3,4-3,PHI,9,true,41,37,78,151,140,291,20,9,29,0,3:12
380711,2014-04-13,2014,SLN,CHN,6,4,6-4,SLN,9,true,37,37,74,137,156,293,15,10,25,2,3:10 (:46 delay)
380715,2014-04-13,2014,TEX,HOU,1,0,1-0,TEX,9,true,29,29,58,119,102,221,5,8,13,0,2:15
380720,2014-04-13,2014,SEA,OAK,0,3,3-0,OAK,9,false,31,40,71,149,118,267,3,13,16,1,2:44
380717,2014-04-13,2014,ARI,LAN,6,8,8-6,LAN,9,false,42,41,83,172,170,342,17,13,30,5,3:39
380722,2014-04-13,2014,CIN,TBA,12,4,12-4,CIN,9,true,44,39,83,151,188,339,22,13,35,3,3:41
380712,2014-04-13,2014,CHA,CLE,4,3,4-3,CHA,9,false,35,39,74,171,123,294,11,12,23,2,3:18 (2:00 delay)
380719,2014-04-13,2014,ANA,NYN,14,2,14-2,ANA,9,true,46,34,80,150,156,306,24,10,34,0,3:05
380723,2014-04-13,2014,BAL,TOR,3,11,11-3,TOR,9,false,37,46,83,167,130,297,9,21,30,2,2:45
380731,2014-04-14,2014,MIL,SLN,0,4,4-0,SLN,9,false,33,37,70,126,131,257,6,12,18,1,2:48
380728,2014-04-14,2014,ANA,OAK,2,3,3-2,OAK,9,false,33,36,69,146,122,268,5,11,16,1,2:56
380732,2014-04-14,2014,BAL,TBA,7,1,7-1,BAL,9,true,38,33,71,130,119,249,14,9,23,1,2:46
380729,2014-04-14,2014,CIN,PIT,7,8,8-7,PIT,9,false,37,42,79,176,113,289,10,15,25,0,3:07 (1:38 delay)
380733,2014-04-14,2014,MIA,WAS,2,9,9-2,WAS,9,false,36,45,81,154,126,280,10,18,28,1,2:56
380729,2014-04-14,2014,CIN,PIT,7,8,8-7,PIT,9,false,37,42,79,176,113,289,10,15,25,0,3:07 (1:38 delay)
380730,2014-04-14,2014,TEX,SEA,1,7,7-1,SEA,9,false,34,42,76,161,149,310,11,14,25,3,3:01
380726,2014-04-14,2014,SDN,COL,5,4,5-4,SDN,9,true,34,40,74,150,146,296,13,14,27,1,3:19
380727,2014-04-14,2014,ARI,NYN,3,7,7-3,NYN,9,false,37,45,82,184,132,316,12,17,29,1,3:08
380725,2014-04-14,2014,PHI,ATL,6,9,9-6,ATL,9,false,39,45,84,187,154,341,12,19,31,2,3:41
380745,2014-04-15,2014,MIL,SLN,1,6,6-1,SLN,9,false,32,35,67,137,127,264,7,10,17,0,2:41
380744,2014-04-15,2014,TEX,SEA,5,0,5-0,TEX,9,true,34,36,70,113,115,228,14,9,23,1,2:22
380741,2014-04-15,2014,ARI,NYN,0,9,9-0,NYN,9,false,32,42,74,148,125,273,5,15,20,1,2:49
380739,2014-04-15,2014,HOU,KCA,2,4,4-2,KCA,9,false,34,37,71,148,132,280,7,10,17,0,2:45
380748,2014-04-15,2014,MIA,WAS,11,2,11-2,MIA,9,true,43,36,79,141,154,295,20,10,30,0,2:54
380743,2014-04-15,2014,CIN,PIT,7,5,7-5,CIN,9,true,40,39,79,157,147,304,20,11,31,2,3:13
380747,2014-04-15,2014,MIN,TOR,3,9,9-3,TOR,9,false,41,45,86,170,180,350,14,19,33,5,3:31
380740,2014-04-15,2014,SFN,LAN,3,2,3-2,SFN,12,false,54,51,105,207,211,418,23,16,39,3,4:54
380735,2014-04-15,2014,CHA,BOS,2,1,2-1,CHA,9,false,38,34,72,147,174,321,12,7,19,6,3:36
380738,2014-04-15,2014,SDN,COL,2,3,3-2,COL,9,false,35,39,74,170,132,302,11,14,25,4,3:29
380742,2014-04-15,2014,ANA,OAK,9,10,10-9,OAK,11,false,50,52,102,191,187,378,17,23,40,5,4:12
380758,2014-04-16,2014,CIN,PIT,4,0,4-0,CIN,9,true,36,30,66,107,116,223,12,3,15,0,2:22
380736,2014-04-16,2014,NYA,CHN,3,0,3-0,NYA,9,true,32,31,63,129,123,252,9,4,13,1,2:41
380736,2014-04-16,2014,NYA,CHN,3,0,3-0,NYA,9,true,32,31,63,129,123,252,9,4,13,1,2:41
380760,2014-04-16,2014,MIL,SLN,5,1,5-1,MIL,9,true,37,36,73,130,127,257,12,10,22,2,2:56
380753,2014-04-16,2014,SDN,COL,4,2,4-2,SDN,9,true,33,37,70,128,123,251,10,11,21,1,2:53
380756,2014-04-16,2014,ARI,NYN,2,5,5-2,NYN,9,false,34,42,76,148,107,255,8,16,24,2,2:46
380759,2014-04-16,2014,TEX,SEA,3,2,3-2,TEX,9,false,35,36,71,126,137,263,8,9,17,2,2:47
380749,2014-04-16,2014,PHI,ATL,0,1,1-0,ATL,9,false,30,38,68,128,115,243,3,12,15,0,2:29
380755,2014-04-16,2014,SFN,LAN,2,1,2-1,SFN,9,true,34,32,66,118,123,241,13,9,22,3,2:53
380761,2014-04-16,2014,BAL,TBA,3,0,3-0,BAL,9,true,34,36,70,153,133,286,10,10,20,0,2:53
380763,2014-04-16,2014,MIA,WAS,3,6,6-3,WAS,9,false,35,37,72,144,124,268,9,9,18,2,2:37
380752,2014-04-16,2014,DET,CLE,2,3,3-2,CLE,9,false,36,37,73,161,157,318,11,11,22,1,3:23
380751,2014-04-16,2014,NYA,CHN,2,0,2-0,NYA,9,true,38,35,73,149,144,293,13,9,22,4,3:08
380757,2014-04-16,2014,ANA,OAK,5,4,5-4,ANA,12,false,52,49,101,179,188,367,15,15,30,3,4:19
380754,2014-04-16,2014,HOU,KCA,4,6,6-4,KCA,11,false,49,48,97,193,191,384,16,17,33,2,4:05
380750,2014-04-16,2014,CHA,BOS,4,6,6-4,BOS,14,false,56,64,120,275,229,504,14,24,38,6,5:17
380764,2014-04-17,2014,PHI,ATL,1,0,1-0,PHI,9,true,29,32,61,129,103,232,9,6,15,0,2:28
380767,2014-04-17,2014,SDN,COL,1,3,3-1,COL,9,false,31,33,64,119,123,242,7,7,14,0,2:38
380768,2014-04-17,2014,HOU,KCA,1,5,5-1,KCA,9,false,33,35,68,118,121,239,7,10,17,0,2:37
380765,2014-04-17,2014,CHA,BOS,1,3,3-1,BOS,9,false,34,36,70,162,125,287,8,12,20,1,2:54
380770,2014-04-17,2014,PIT,MIL,11,2,11-2,PIT,9,true,41,34,75,94,174,268,18,9,27,1,3:06
380771,2014-04-17,2014,TBA,NYA,2,10,10-2,NYA,9,false,36,44,80,168,138,306,11,17,28,1,3:13
380774,2014-04-17,2014,MIN,TOR,7,0,7-0,MIN,9,true,39,31,70,115,180,295,15,5,20,1,2:38
380769,2014-04-17,2014,SFN,LAN,1,2,2-1,LAN,9,false,37,36,73,145,170,315,9,12,21,1,3:08
380773,2014-04-17,2014,WAS,SLN,0,8,8-0,SLN,9,false,32,50,82,192,110,302,6,21,27,1,3:10
380766,2014-04-17,2014,DET,CLE,7,5,7-5,DET,9,true,37,41,78,183,138,321,15,15,30,5,3:38
380772,2014-04-17,2014,TEX,SEA,8,6,8-6,TEX,9,true,41,41,82,165,170,335,19,15,34,3,3:28
380762,2014-04-17,2014,MIN,TOR,9,5,9-5,MIN,9,true,43,43,86,189,177,366,20,16,36,5,3:37
380762,2014-04-17,2014,MIN,TOR,9,5,9-5,MIN,9,true,43,43,86,189,177,366,20,16,36,5,3:37
380788,2014-04-18,2014,WAS,SLN,3,1,3-1,WAS,9,true,30,34,64,149,108,257,5,8,13,1,2:32
380779,2014-04-18,2014,TEX,CHA,12,0,12-0,TEX,9,true,45,31,76,109,160,269,24,4,28,1,2:41
380787,2014-04-18,2014,SDN,SFN,2,1,2-1,SDN,9,true,30,33,63,131,113,244,7,7,14,0,2:35
380789,2014-04-18,2014,CLE,TOR,2,3,3-2,TOR,9,false,41,39,80,148,159,307,14,14,28,4,3:15
380785,2014-04-18,2014,COL,PHI,12,1,12-1,COL,9,true,45,31,76,110,177,287,22,3,25,1,2:48
380777,2014-04-18,2014,NYN,ATL,0,6,6-0,ATL,9,false,34,41,75,161,151,312,7,16,23,1,2:55
380786,2014-04-18,2014,MIA,SEA,8,4,8-4,MIA,9,false,39,40,79,152,137,289,20,14,34,2,3:09
380780,2014-04-18,2014,CHN,CIN,1,4,4-1,CIN,9,false,36,40,76,161,145,306,10,12,22,2,3:09
380782,2014-04-18,2014,PIT,MIL,3,5,5-3,MIL,9,false,41,39,80,124,161,285,12,15,27,3,3:07
380784,2014-04-18,2014,TBA,NYA,11,5,11-5,TBA,9,true,44,39,83,152,183,335,22,11,33,7,3:56
380778,2014-04-18,2014,BOS,BAL,4,8,8-4,BAL,9,false,43,46,89,156,190,346,17,20,37,2,3:26
380776,2014-04-18,2014,LAN,ARI,2,4,4-2,ARI,12,false,47,48,95,189,201,390,13,13,26,3,4:13
380781,2014-04-18,2014,OAK,HOU,11,3,11-3,OAK,9,true,43,42,85,150,182,332,20,14,34,3,3:22
380775,2014-04-18,2014,DET,ANA,6,11,11-6,ANA,9,false,42,43,85,174,165,339,16,18,34,2,3:34
380783,2014-04-18,2014,KCA,MIN,5,0,5-0,KCA,9,true,35,34,69,140,134,274,12,9,21,1,2:39
380800,2014-04-19,2014,COL,PHI,3,1,3-1,COL,9,true,30,33,63,114,92,206,6,6,12,1,2:23
380802,2014-04-19,2014,SDN,SFN,3,1,3-1,SDN,9,true,32,30,62,118,107,225,9,4,13,1,2:36
380803,2014-04-19,2014,WAS,SLN,3,4,4-3,SLN,9,false,39,36,75,119,133,252,12,11,23,2,2:44
380794,2014-04-19,2014,TEX,CHA,6,3,6-3,TEX,9,true,36,37,73,132,145,277,15,12,27,2,2:49
380798,2014-04-19,2014,KCA,MIN,5,4,5-4,KCA,9,true,37,39,76,151,130,281,13,13,26,0,2:54
380799,2014-04-19,2014,TBA,NYA,16,1,16-1,TBA,9,true,46,29,75,114,181,295,22,3,25,3,3:15
380790,2014-04-19,2014,DET,ANA,5,2,5-2,DET,9,true,39,32,71,142,165,307,17,6,23,0,3:13
380793,2014-04-19,2014,BOS,BAL,4,2,4-2,BOS,9,true,31,36,67,137,123,260,8,9,17,2,2:47
380792,2014-04-19,2014,NYN,ATL,5,7,7-5,ATL,9,false,43,41,84,146,155,301,16,15,31,1,3:13
380796,2014-04-19,2014,OAK,HOU,4,3,4-3,OAK,9,false,43,34,77,119,159,278,18,9,27,1,3:07
380804,2014-04-19,2014,CLE,TOR,0,5,5-0,TOR,9,false,34,40,74,144,142,286,9,13,22,2,2:42
380791,2014-04-19,2014,LAN,ARI,8,6,8-6,LAN,9,true,35,39,74,139,126,265,10,12,22,2,2:48
380795,2014-04-19,2014,CHN,CIN,8,4,8-4,CHN,9,true,38,39,77,139,165,304,16,13,29,2,3:20
380801,2014-04-19,2014,MIA,SEA,7,0,7-0,MIA,9,true,39,28,67,90,147,237,17,2,19,1,2:20
380797,2014-04-19,2014,PIT,MIL,7,8,8-7,MIL,9,false,41,42,83,139,140,279,15,15,30,1,3:04
380806,2014-04-20,2014,LAN,ARI,4,1,4-1,LAN,9,true,30,33,63,147,117,264,8,7,15,2,2:45
380811,2014-04-20,2014,OAK,HOU,4,1,4-1,OAK,9,true,37,37,74,149,134,283,15,9,24,1,2:54
380817,2014-04-20,2014,SDN,SFN,3,4,4-3,SFN,9,false,35,34,69,148,145,293,12,7,19,2,2:59
380805,2014-04-20,2014,DET,ANA,2,1,2-1,DET,9,true,34,33,67,131,166,297,11,8,19,2,3:28
380816,2014-04-20,2014,MIA,SEA,3,2,3-2,MIA,9,true,34,35,69,132,135,267,11,9,20,6,2:58
380808,2014-04-20,2014,BOS,BAL,6,5,6-5,BOS,9,false,41,43,84,141,171,312,14,17,31,7,3:32
380813,2014-04-20,2014,KCA,MIN,3,8,8-3,MIN,9,false,38,46,84,191,129,320,12,21,33,3,3:08
380810,2014-04-20,2014,CHN,CIN,2,8,8-2,CIN,9,false,43,45,88,190,179,369,18,18,36,2,3:50
380815,2014-04-20,2014,COL,PHI,9,10,10-9,PHI,9,false,46,44,90,175,165,340,22,16,38,4,4:08
380807,2014-04-20,2014,NYN,ATL,4,3,4-3,NYN,14,false,56,54,110,210,205,415,15,16,31,1,4:37
380819,2014-04-20,2014,CLE,TOR,6,4,6-4,CLE,9,true,34,40,74,140,151,291,11,14,25,4,2:55
380814,2014-04-20,2014,TBA,NYA,1,5,5-1,NYA,12,false,48,50,98,173,176,349,12,16,28,6,4:23
380818,2014-04-20,2014,WAS,SLN,3,2,3-2,WAS,9,false,46,34,80,121,171,292,19,8,27,2,3:18
380812,2014-04-20,2014,PIT,MIL,2,3,3-2,MIL,14,false,55,55,110,175,219,394,14,19,33,1,4:21
380809,2014-04-20,2014,TEX,CHA,2,16,16-2,CHA,9,false,33,49,82,175,144,319,11,21,32,1,3:16
380829,2014-04-21,2014,MIL,SDN,4,3,4-3,MIL,9,true,34,39,73,130,124,254,15,11,26,1,2:47
380826,2014-04-21,2014,CLE,KCA,4,3,4-3,CLE,9,true,34,34,68,128,123,251,11,7,18,2,2:37
380828,2014-04-21,2014,LAN,PHI,0,7,7-0,PHI,9,false,31,42,73,159,124,283,5,14,19,0,2:47
380821,2014-04-21,2014,CHN,ARI,5,1,5-1,CHN,9,true,35,35,70,135,136,271,13,8,21,1,2:40 (1:01 delay)
380823,2014-04-21,2014,DET,CHA,1,3,3-1,CHA,9,false,38,34,72,131,136,267,13,7,20,3,3:06
380827,2014-04-21,2014,ATL,MIA,4,2,4-2,ATL,10,false,43,42,85,159,159,318,16,12,28,2,3:41
380820,2014-04-21,2014,WAS,ANA,2,4,4-2,ANA,9,false,37,41,78,147,163,310,11,16,27,2,3:18
380824,2014-04-21,2014,PIT,CIN,6,5,6-5,PIT,9,false,41,41,82,139,128,267,17,16,33,2,3:02
380832,2014-04-21,2014,OAK,TEX,3,4,4-3,TEX,9,false,41,41,82,146,166,312,14,16,30,3,3:25
380822,2014-04-21,2014,BOS,BAL,6,7,7-6,BAL,9,false,41,37,78,127,177,304,17,14,31,2,3:18
380831,2014-04-21,2014,NYN,SLN,2,0,2-0,NYN,9,true,35,34,69,133,118,251,13,9,22,2,2:34
380825,2014-04-21,2014,SEA,HOU,2,7,7-2,HOU,9,false,35,38,73,122,155,277,8,11,19,0,2:49
380830,2014-04-21,2014,COL,SFN,8,2,8-2,COL,9,true,38,37,75,161,132,293,16,10,26,1,3:13
380845,2014-04-22,2014,COL,SFN,2,1,2-1,COL,9,true,33,37,70,137,97,234,11,11,22,2,2:41
380833,2014-04-22,2014,WAS,ANA,2,7,7-2,ANA,9,false,33,38,71,124,115,239,8,10,18,0,2:43
380846,2014-04-22,2014,NYN,SLN,0,3,3-0,SLN,9,false,31,39,70,154,110,264,6,15,21,0,2:40
380840,2014-04-22,2014,ATL,MIA,0,1,1-0,MIA,9,false,30,31,61,113,117,230,3,4,7,0,2:08
380838,2014-04-22,2014,SEA,HOU,2,5,5-2,HOU,9,false,32,41,73,164,128,292,6,14,20,2,3:02
380841,2014-04-22,2014,TBA,MIN,7,3,7-3,TBA,9,true,39,33,72,113,159,272,16,7,23,1,2:53
380837,2014-04-22,2014,PIT,CIN,1,4,4-1,CIN,9,false,33,38,71,138,117,255,6,12,18,1,2:47
380835,2014-04-22,2014,TOR,BAL,9,3,9-3,TOR,9,true,40,40,80,143,158,301,15,14,29,5,2:54
380847,2014-04-22,2014,OAK,TEX,4,5,5-4,TEX,9,false,39,38,77,115,141,256,13,15,28,3,3:01
380839,2014-04-22,2014,CLE,KCA,2,8,8-2,KCA,9,false,39,44,83,170,159,329,11,19,30,4,3:34
380842,2014-04-22,2014,BOS,NYA,3,9,9-3,NYA,9,false,35,45,80,177,131,308,9,19,28,2,3:17
380834,2014-04-22,2014,CHN,ARI,9,2,9-2,CHN,9,true,39,31,70,150,174,324,15,6,21,2,3:05
380843,2014-04-22,2014,LAN,PHI,2,3,3-2,PHI,10,false,39,44,83,171,138,309,9,15,24,1,3:36
380844,2014-04-22,2014,MIL,SDN,1,2,2-1,SDN,12,false,48,44,92,169,201,370,12,9,21,0,4:04
380836,2014-04-22,2014,DET,CHA,8,6,8-6,DET,9,true,42,42,84,170,159,329,18,17,35,3,3:22
380862,2014-04-23,2014,OAK,TEX,0,3,3-0,TEX,9,false,30,38,68,140,109,249,5,12,17,0,2:35
380859,2014-04-23,2014,MIL,SDN,5,2,5-2,MIL,9,true,33,35,68,142,131,273,11,7,18,1,2:38
380853,2014-04-23,2014,SEA,HOU,5,3,5-3,SEA,9,false,33,39,72,158,128,286,10,13,23,1,2:50
380851,2014-04-23,2014,DET,CHA,4,6,6-4,CHA,9,false,35,36,71,143,130,273,9,12,21,3,2:51
380855,2014-04-23,2014,ATL,MIA,3,1,3-1,ATL,9,true,35,35,70,145,153,298,11,10,21,4,3:01
380854,2014-04-23,2014,CLE,KCA,5,3,5-3,CLE,9,true,38,39,77,136,150,286,16,12,28,3,3:05
380849,2014-04-23,2014,CHN,ARI,5,7,7-5,ARI,9,false,35,42,77,161,147,308,8,14,22,4,3:11
380858,2014-04-23,2014,LAN,PHI,5,2,5-2,LAN,9,true,36,33,69,134,126,260,13,7,20,3,2:52
380861,2014-04-23,2014,NYN,SLN,3,2,3-2,NYN,9,true,35,39,74,146,170,316,10,13,23,4,3:08
380848,2014-04-23,2014,WAS,ANA,5,4,5-4,WAS,9,false,40,40,80,160,142,302,14,16,30,3,3:18
380850,2014-04-23,2014,TOR,BAL,8,10,10-8,BAL,9,false,45,42,87,160,163,323,20,18,38,5,3:11
380860,2014-04-23,2014,COL,SFN,10,12,12-10,SFN,11,false,52,53,105,209,191,400,21,24,45,2,4:26
380852,2014-04-23,2014,PIT,CIN,2,5,5-2,CIN,9,false,39,39,78,166,151,317,11,15,26,2,3:20
380857,2014-04-23,2014,BOS,NYA,5,1,5-1,BOS,9,true,38,35,73,125,164,289,14,8,22,3,3:12
380856,2014-04-23,2014,TBA,MIN,4,6,6-4,MIN,12,false,51,52,103,233,182,415,15,19,34,5,4:48
380867,2014-04-24,2014,CLE,KCA,5,1,5-1,CLE,9,true,31,31,62,101,115,216,8,4,12,1,2:15
380866,2014-04-24,2014,PIT,CIN,1,2,2-1,CIN,9,false,36,35,71,129,136,265,9,10,19,0,2:46
380871,2014-04-24,2014,LAN,PHI,3,7,7-3,PHI,9,false,40,44,84,171,157,328,13,19,32,2,3:33
380864,2014-04-24,2014,TOR,BAL,4,11,11-4,BAL,9,false,35,45,80,179,120,299,10,19,29,3,2:54
380865,2014-04-24,2014,DET,CHA,7,4,7-4,DET,9,true,38,39,77,166,148,314,15,13,28,1,3:14
380873,2014-04-24,2014,NYN,SLN,4,1,4-1,NYN,9,true,33,34,67,154,125,279,10,6,16,3,3:03
380870,2014-04-24,2014,HOU,OAK,1,10,10-1,OAK,9,false,39,48,87,177,145,322,14,20,34,2,3:29
380868,2014-04-24,2014,TBA,MIN,7,9,9-7,MIN,9,false,41,49,90,206,149,355,17,22,39,3,3:42
380869,2014-04-24,2014,BOS,NYA,5,14,14-5,NYA,9,false,40,56,96,217,163,380,12,27,39,4,3:51
380872,2014-04-24,2014,WAS,SDN,3,4,4-3,SDN,12,false,53,46,99,188,195,383,19,12,31,2,4:14
380863,2014-04-24,2014,CHN,ARI,2,5,5-2,ARI,9,false,35,36,71,128,129,257,7,11,18,2,2:51
380878,2014-04-25,2014,SFN,CLE,5,1,5-1,SFN,9,true,31,37,68,142,128,270,8,9,17,1,2:42
380877,2014-04-25,2014,ATL,CIN,5,4,5-4,ATL,9,true,33,38,71,128,120,248,11,13,24,4,2:41
380876,2014-04-25,2014,MIL,CHN,5,2,5-2,MIL,9,true,38,33,71,127,142,269,14,6,20,0,3:12
380886,2014-04-25,2014,WAS,SDN,11,1,11-1,WAS,9,true,45,37,82,146,161,307,21,12,33,1,3:08 (:57 delay)
380879,2014-04-25,2014,LAN,COL,4,5,5-4,COL,11,false,43,42,85,139,166,305,11,9,20,2,3:40
380885,2014-04-25,2014,SLN,PIT,1,0,1-0,SLN,9,true,35,35,70,157,123,280,12,11,23,1,3:03
380884,2014-04-25,2014,ARI,PHI,5,4,5-4,ARI,9,true,35,40,75,183,135,318,11,14,25,2,3:21
380875,2014-04-25,2014,TOR,BOS,1,8,8-1,BOS,9,false,34,47,81,184,144,328,8,23,31,2,2:57
380874,2014-04-25,2014,NYA,ANA,1,13,13-1,ANA,9,false,37,45,82,175,177,352,11,17,28,2,3:30
380887,2014-04-25,2014,CHA,TBA,9,6,9-6,CHA,9,false,39,44,83,196,148,344,15,21,36,3,4:04
380880,2014-04-25,2014,MIN,DET,6,10,10-6,DET,9,false,40,43,83,160,176,336,13,17,30,6,3:32
380883,2014-04-25,2014,HOU,OAK,5,12,12-5,OAK,9,false,41,52,93,214,148,362,14,25,39,3,4:06
380888,2014-04-25,2014,SEA,TEX,6,5,6-5,SEA,9,true,37,39,76,148,144,292,15,15,30,2,2:55
380882,2014-04-25,2014,NYN,MIA,4,3,4-3,NYN,9,false,38,37,75,152,142,294,13,10,23,0,2:59
380881,2014-04-25,2014,BAL,KCA,0,5,5-0,KCA,9,false,36,41,77,149,124,273,10,15,25,1,2:40 (:55 delay)
380892,2014-04-26,2014,ATL,CIN,4,1,4-1,ATL,9,true,32,31,63,123,99,222,9,5,14,1,2:17
380896,2014-04-26,2014,BAL,KCA,3,2,3-2,BAL,10,false,39,43,82,141,143,284,10,14,24,4,3:09
380900,2014-04-26,2014,SLN,PIT,1,6,6-1,PIT,9,false,37,36,73,108,167,275,10,9,19,3,3:02
380897,2014-04-26,2014,NYN,MIA,6,7,7-6,MIA,10,false,41,44,85,151,162,313,11,14,25,2,3:35
380903,2014-04-26,2014,SEA,TEX,3,6,6-3,TEX,9,false,38,41,79,155,140,295,12,15,27,4,3:13
380902,2014-04-26,2014,CHA,TBA,0,4,4-0,TBA,9,false,34,41,75,184,117,301,8,13,21,2,3:11
380901,2014-04-26,2014,WAS,SDN,4,0,4-0,WAS,9,true,37,31,68,105,136,241,12,4,16,0,2:19
380898,2014-04-26,2014,HOU,OAK,7,6,7-6,HOU,9,true,33,39,72,155,126,281,10,14,24,4,3:13
380890,2014-04-26,2014,TOR,BOS,6,7,7-6,BOS,9,false,44,38,82,158,164,322,17,14,31,4,3:23
380891,2014-04-26,2014,MIL,CHN,5,3,5-3,MIL,9,true,35,31,66,128,130,258,12,4,16,2,2:51
380889,2014-04-26,2014,NYA,ANA,4,3,4-3,NYA,9,true,34,40,74,161,125,286,10,13,23,5,3:05
380894,2014-04-26,2014,LAN,COL,6,3,6-3,LAN,9,true,39,37,76,145,154,299,17,13,30,2,3:38
380899,2014-04-26,2014,ARI,PHI,5,6,6-5,PHI,9,false,40,44,84,161,131,292,16,17,33,3,3:05
380895,2014-04-26,2014,MIN,DET,5,3,5-3,MIN,9,true,36,35,71,142,163,305,13,9,22,3,3:13
380893,2014-04-26,2014,SFN,CLE,5,3,5-3,SFN,9,true,32,39,71,148,118,266,8,13,21,3,2:47
380915,2014-04-27,2014,SLN,PIT,7,0,7-0,SLN,9,true,33,32,65,114,112,226,10,6,16,1,2:35
380913,2014-04-27,2014,HOU,OAK,5,1,5-1,HOU,9,true,34,33,67,117,123,240,9,6,15,2,2:32
380908,2014-04-27,2014,SFN,CLE,4,1,4-1,SFN,9,false,35,31,66,130,131,261,11,5,16,1,2:43
380907,2014-04-27,2014,ATL,CIN,1,0,1-0,ATL,10,false,39,36,75,136,142,278,10,7,17,2,3:02
380917,2014-04-27,2014,CHA,TBA,9,2,9-2,CHA,9,true,38,35,73,124,131,255,13,12,25,2,2:55
380914,2014-04-27,2014,ARI,PHI,0,2,2-0,PHI,9,false,33,35,68,123,120,243,7,9,16,0,2:37
380911,2014-04-27,2014,BAL,KCA,3,9,9-3,KCA,9,false,34,44,78,176,140,316,7,17,24,1,3:08
380905,2014-04-27,2014,TOR,BOS,7,1,7-1,TOR,9,true,33,34,67,132,139,271,9,7,16,2,2:28
380918,2014-04-27,2014,SEA,TEX,6,5,6-5,SEA,9,true,36,38,74,163,144,307,12,11,23,1,3:10
380904,2014-04-27,2014,NYA,ANA,3,2,3-2,NYA,9,true,32,37,69,156,140,296,8,12,20,3,3:28
380912,2014-04-27,2014,NYN,MIA,4,0,4-0,NYN,9,true,35,32,67,125,153,278,11,7,18,0,2:42
380909,2014-04-27,2014,LAN,COL,1,6,6-1,COL,9,false,38,39,77,134,136,270,12,12,24,1,3:09
380916,2014-04-27,2014,WAS,SDN,2,4,4-2,SDN,9,false,33,39,72,160,142,302,6,14,20,2,3:12
380906,2014-04-27,2014,MIL,CHN,0,4,4-0,CHN,9,false,32,36,68,132,120,252,5,10,15,1,2:47
380920,2014-04-28,2014,ANA,CLE,6,3,6-3,ANA,9,true,34,34,68,136,125,261,11,7,18,1,2:39
380921,2014-04-28,2014,ARI,COL,5,8,8-5,COL,9,false,38,40,78,147,144,291,13,15,28,2,3:03
380923,2014-04-28,2014,TEX,OAK,0,4,4-0,OAK,9,false,30,38,68,171,108,279,4,15,19,1,3:03
380925,2014-04-28,2014,CHA,TBA,7,3,7-3,CHA,9,true,40,38,78,141,156,297,18,10,28,2,3:19
380922,2014-04-28,2014,SLN,MIL,3,5,5-3,MIL,12,false,52,52,104,183,212,395,16,18,34,2,4:16
380924,2014-04-28,2014,SFN,SDN,4,6,6-4,SDN,9,false,36,43,79,158,149,307,12,14,26,2,3:29
380926,2014-04-29,2014,MIA,ATL,9,0,9-0,MIA,9,true,37,32,69,109,111,220,14,5,19,1,2:07
380936,2014-04-29,2014,SFN,SDN,6,0,6-0,SFN,9,true,36,29,65,105,112,217,13,3,16,1,2:28
380930,2014-04-29,2014,CHA,DET,3,4,4-3,DET,9,false,36,36,72,159,141,300,12,9,21,0,3:04 (:21 delay)
380927,2014-04-29,2014,CIN,CHN,3,2,3-2,CIN,9,true,38,37,75,151,146,297,16,12,28,2,3:00 (1:45 delay)
380934,2014-04-29,2014,TEX,OAK,3,9,9-3,OAK,9,false,37,41,78,146,147,293,11,16,27,2,3:08
380929,2014-04-29,2014,ARI,COL,4,5,5-4,COL,9,false,42,39,81,140,146,286,15,12,27,2,3:10
380940,2014-04-29,2014,HOU,WAS,3,4,4-3,WAS,9,false,37,41,78,167,156,323,10,16,26,2,3:25
380933,2014-04-29,2014,PHI,NYN,1,6,6-1,NYN,9,false,34,39,73,154,148,302,7,15,22,1,2:53 (1:28 delay)
380932,2014-04-29,2014,SLN,MIL,4,5,5-4,MIL,11,false,46,44,90,174,182,356,15,11,26,0,3:39
380928,2014-04-29,2014,ANA,CLE,6,4,6-4,ANA,9,true,44,40,84,145,161,306,21,15,36,7,3:36
380938,2014-04-29,2014,BOS,TBA,7,4,7-4,BOS,9,true,41,37,78,134,198,332,18,10,28,2,3:40
380937,2014-04-29,2014,NYA,SEA,3,6,6-3,SEA,9,false,39,44,83,180,172,352,12,17,29,3,3:33
380939,2014-04-29,2014,KCA,TOR,10,7,10-7,KCA,9,true,39,42,81,133,164,297,16,15,31,5,3:08 (:27 delay)
380951,2014-04-30,2014,SFN,SDN,3,2,3-2,SFN,9,true,34,32,66,94,117,211,11,5,16,2,2:17
380954,2014-04-30,2014,KCA,TOR,4,2,4-2,KCA,9,true,31,41,72,178,117,295,7,14,21,1,2:59
380941,2014-04-30,2014,MIA,ATL,9,3,9-3,MIA,9,true,41,33,74,126,158,284,17,7,24,2,2:50
380945,2014-04-30,2014,CHA,DET,1,5,5-1,DET,9,false,36,41,77,160,142,302,9,13,22,2,3:03
380955,2014-04-30,2014,HOU,WAS,0,7,7-0,WAS,9,false,37,41,78,144,145,289,11,16,27,2,3:02
380949,2014-04-30,2014,TEX,OAK,1,12,12-1,OAK,9,false,32,49,81,184,122,306,5,20,25,1,2:57
380947,2014-04-30,2014,SLN,MIL,9,3,9-3,SLN,9,true,44,39,83,135,180,315,20,13,33,2,3:25
380942,2014-04-30,2014,CIN,CHN,4,9,9-4,CHN,9,false,36,47,83,185,143,328,9,20,29,3,3:39
380943,2014-04-30,2014,ANA,CLE,7,1,7-1,ANA,9,true,36,30,66,126,145,271,13,5,18,2,2:46
380944,2014-04-30,2014,ARI,COL,5,4,5-4,ARI,10,false,40,39,79,136,159,295,13,10,23,0,2:57
380946,2014-04-30,2014,MIN,LAN,4,6,6-4,LAN,9,false,40,44,84,140,190,330,14,16,30,4,3:38
380959,2014-05-01,2014,COL,NYN,7,4,7-4,COL,9,true,36,35,71,135,122,257,13,9,22,1,2:48
380958,2014-05-01,2014,CIN,MIL,8,3,8-3,CIN,9,true,44,35,79,115,154,269,23,9,32,1,2:52
380935,2014-05-01,2014,BAL,PIT,5,1,5-1,BAL,9,true,35,41,76,162,134,296,12,15,27,5,3:08 (:21 delay)
380960,2014-05-01,2014,NYA,SEA,2,4,4-2,SEA,9,false,35,35,70,131,138,269,9,9,18,1,2:47
380956,2014-05-01,2014,MIA,ATL,5,4,5-4,MIA,9,true,37,39,76,135,133,268,13,13,26,3,2:54
380962,2014-05-01,2014,KCA,TOR,3,7,7-3,TOR,9,false,35,44,79,167,116,283,9,17,26,2,2:35
380957,2014-05-01,2014,MIN,LAN,4,9,9-4,LAN,9,false,37,45,82,156,139,295,10,21,31,2,3:01
380935,2014-05-01,2014,BAL,PIT,5,1,5-1,BAL,9,true,35,41,76,162,134,296,12,15,27,5,3:08 (:21 delay)
380953,2014-05-01,2014,BOS,TBA,1,2,2-1,TBA,9,false,39,35,74,150,161,311,13,10,23,2,3:27
380953,2014-05-01,2014,BOS,TBA,1,2,2-1,TBA,9,false,39,35,74,150,161,311,13,10,23,2,3:27
380961,2014-05-01,2014,BOS,TBA,5,6,6-5,TBA,9,false,42,38,80,146,175,321,17,11,28,3,3:44
380950,2014-05-01,2014,BAL,PIT,6,5,6-5,BAL,10,false,41,50,91,212,165,377,15,21,36,6,3:57 (:46 delay)
380950,2014-05-01,2014,BAL,PIT,6,5,6-5,BAL,10,false,41,50,91,212,165,377,15,21,36,6,3:57 (:46 delay)
380931,2014-05-01,2014,MIN,LAN,3,4,4-3,LAN,12,false,49,56,105,255,223,478,13,23,36,7,5:11
380931,2014-05-01,2014,MIN,LAN,3,4,4-3,LAN,12,false,49,56,105,255,223,478,13,23,36,7,5:11
380964,2014-05-02,2014,MIN,BAL,0,3,3-0,BAL,9,false,33,36,69,110,151,261,5,10,15,1,2:29
380968,2014-05-02,2014,CIN,MIL,0,2,2-0,MIL,9,false,32,34,66,118,122,240,5,9,14,0,2:35
380967,2014-05-02,2014,MIA,LAN,6,3,6-3,MIA,9,true,36,37,73,139,138,277,14,11,25,2,3:08
380966,2014-05-02,2014,KCA,DET,2,8,8-2,DET,9,false,31,42,73,139,116,255,4,16,20,1,2:41
380972,2014-05-02,2014,ATL,SFN,1,2,2-1,SFN,9,false,40,36,76,136,150,286,13,10,23,2,3:08
380969,2014-05-02,2014,COL,NYN,10,3,10-3,COL,9,true,38,38,76,145,128,273,14,13,27,0,3:02
380977,2014-05-02,2014,PHI,WAS,3,5,5-3,WAS,9,false,36,41,77,166,126,292,11,14,25,2,3:11
380963,2014-05-02,2014,SDN,ARI,0,2,2-0,ARI,9,false,31,36,67,134,114,248,4,10,14,0,2:24
380975,2014-05-02,2014,ANA,TEX,2,5,5-2,TEX,9,false,38,38,76,146,140,286,11,12,23,6,3:14
380976,2014-05-02,2014,PIT,TOR,6,5,6-5,PIT,9,false,42,40,82,161,169,330,19,12,31,0,3:21
380973,2014-05-02,2014,CHN,SLN,6,5,6-5,CHN,9,true,36,36,72,143,146,289,14,9,23,1,3:08
380965,2014-05-02,2014,CLE,CHA,12,5,12-5,CLE,9,true,43,40,83,164,168,332,19,14,33,3,3:26
380971,2014-05-02,2014,HOU,SEA,5,4,5-4,HOU,11,false,49,42,91,162,184,346,18,12,30,3,4:02
380974,2014-05-02,2014,NYA,TBA,5,10,10-5,TBA,14,false,60,65,125,260,228,488,21,30,51,5,5:49
380970,2014-05-02,2014,BOS,OAK,7,1,7-1,BOS,9,true,41,36,77,155,186,341,19,10,29,4,3:37
380980,2014-05-03,2014,CLE,CHA,2,0,2-0,CLE,9,true,31,33,64,129,127,256,7,7,14,1,2:38
380978,2014-05-03,2014,SDN,ARI,3,4,4-3,ARI,9,false,36,42,78,168,131,299,11,16,27,2,3:11
380988,2014-05-03,2014,CHN,SLN,3,0,3-0,CHN,9,true,33,35,68,123,126,249,9,9,18,3,2:43
380985,2014-05-03,2014,BOS,OAK,6,3,6-3,BOS,9,true,34,34,68,143,120,263,10,8,18,2,2:44
380987,2014-05-03,2014,ATL,SFN,1,3,3-1,SFN,9,false,35,32,67,109,145,254,10,5,15,1,2:51
380981,2014-05-03,2014,KCA,DET,2,9,9-2,DET,9,false,33,43,76,160,126,286,7,20,27,1,2:55
380983,2014-05-03,2014,CIN,MIL,6,2,6-2,CIN,9,true,38,31,69,119,124,243,14,4,18,0,2:30
380992,2014-05-03,2014,PHI,WAS,7,2,7-2,PHI,9,true,39,35,74,139,153,292,15,7,22,1,2:57 (:24 delay)
380986,2014-05-03,2014,HOU,SEA,8,9,9-8,SEA,9,false,41,41,82,131,148,279,16,14,30,6,3:24
380990,2014-05-03,2014,ANA,TEX,5,3,5-3,ANA,9,true,42,38,80,149,175,324,18,13,31,1,3:24
380991,2014-05-03,2014,PIT,TOR,8,6,8-6,PIT,9,true,42,42,84,161,163,324,20,15,35,3,3:19
380984,2014-05-03,2014,COL,NYN,11,10,11-10,COL,9,false,42,49,91,178,133,311,19,22,41,4,3:47
380979,2014-05-03,2014,MIN,BAL,6,1,6-1,MIN,9,true,36,34,70,131,159,290,13,7,20,2,2:51
380989,2014-05-03,2014,NYA,TBA,9,3,9-3,NYA,9,true,40,36,76,145,177,322,17,9,26,1,3:31
380982,2014-05-03,2014,MIA,LAN,7,9,9-7,LAN,11,false,53,48,101,170,204,374,24,18,42,1,4:07
381004,2014-05-04,2014,NYA,TBA,1,5,5-1,TBA,9,false,36,41,77,149,126,275,9,14,23,2,3:14
380995,2014-05-04,2014,CLE,CHA,3,4,4-3,CHA,9,false,42,34,76,139,164,303,15,8,23,2,2:55
381002,2014-05-04,2014,ATL,SFN,1,4,4-1,SFN,9,false,34,41,75,168,141,309,6,16,22,2,3:15
381007,2014-05-04,2014,PHI,WAS,1,0,1-0,PHI,9,true,30,36,66,135,116,251,8,9,17,3,2:45
380998,2014-05-04,2014,CIN,MIL,4,3,4-3,CIN,10,false,41,37,78,123,155,278,14,9,23,3,3:06
380993,2014-05-04,2014,SDN,ARI,4,3,4-3,SDN,9,false,35,37,72,142,134,276,10,10,20,0,2:56
380997,2014-05-04,2014,MIA,LAN,5,4,5-4,MIA,9,false,38,40,78,152,138,290,12,15,27,1,3:06
381001,2014-05-04,2014,HOU,SEA,7,8,8-7,SEA,9,false,40,42,82,157,157,314,13,16,29,1,3:30
381000,2014-05-04,2014,BOS,OAK,2,3,3-2,OAK,10,false,37,42,79,191,147,338,11,15,26,5,3:45
380996,2014-05-04,2014,KCA,DET,4,9,9-4,DET,9,false,39,46,85,184,150,334,12,21,33,0,3:11
381005,2014-05-04,2014,ANA,TEX,3,14,14-3,TEX,9,false,37,52,89,216,158,374,11,26,37,3,3:57
380994,2014-05-04,2014,MIN,BAL,5,2,5-2,MIN,9,true,40,37,77,136,155,291,17,9,26,5,3:02
380999,2014-05-04,2014,COL,NYN,1,5,5-1,NYN,9,false,35,41,76,135,158,293,9,17,26,2,3:03
381003,2014-05-04,2014,CHN,SLN,4,5,5-4,SLN,9,false,39,39,78,157,154,311,12,15,27,1,3:14
381006,2014-05-04,2014,PIT,TOR,2,7,7-2,TOR,9,false,34,41,75,138,139,277,8,15,23,1,2:49
381016,2014-05-05,2014,OAK,SEA,2,4,4-2,SEA,9,false,32,38,70,133,116,249,7,12,19,4,2:36
381019,2014-05-05,2014,COL,TEX,8,2,8-2,COL,9,true,40,35,75,126,148,274,18,11,29,3,3:01
381010,2014-05-05,2014,DET,HOU,2,0,2-0,DET,9,true,33,31,64,124,121,245,10,6,16,0,2:53
381014,2014-05-05,2014,ANA,NYA,4,1,4-1,ANA,9,true,35,32,67,120,159,279,12,7,19,3,3:09
381012,2014-05-05,2014,WAS,LAN,4,0,4-0,WAS,9,true,36,33,69,111,147,258,14,8,22,0,2:59 (3:17 delay)
381018,2014-05-05,2014,ATL,SLN,3,4,4-3,SLN,9,false,38,38,76,146,143,289,12,10,22,1,3:15
381015,2014-05-05,2014,MIA,NYN,4,3,4-3,MIA,9,false,40,34,74,135,168,303,16,8,24,2,2:53
381013,2014-05-05,2014,CLE,MIN,0,1,1-0,MIN,10,false,34,41,75,165,144,309,6,10,16,2,3:09
381008,2014-05-05,2014,MIL,ARI,8,3,8-3,MIL,9,true,38,42,80,149,165,314,16,15,31,1,3:19
381009,2014-05-05,2014,CHN,CHA,1,3,3-1,CHA,12,false,44,47,91,177,170,347,9,11,20,2,3:51
381011,2014-05-05,2014,SDN,KCA,6,5,6-5,SDN,12,false,46,52,98,184,190,374,11,18,29,2,3:57
381017,2014-05-05,2014,PIT,SFN,10,11,11-10,SFN,13,false,58,61,119,200,241,441,25,27,52,4,5:29
381020,2014-05-05,2014,PHI,TOR,0,3,3-0,TOR,9,false,38,37,75,143,147,290,12,11,23,1,2:59
381030,2014-05-06,2014,MIA,NYN,3,0,3-0,MIA,9,true,33,31,64,111,108,219,10,7,17,0,2:08
381028,2014-05-06,2014,CLE,MIN,4,2,4-2,CLE,9,true,32,35,67,141,110,251,8,6,14,1,2:28
381032,2014-05-06,2014,PIT,SFN,2,1,2-1,PIT,9,false,32,35,67,137,108,245,7,9,16,0,2:41
381033,2014-05-06,2014,ATL,SLN,2,1,2-1,ATL,9,true,32,33,65,131,124,255,9,8,17,1,2:42
381029,2014-05-06,2014,ANA,NYA,3,4,4-3,NYA,9,false,34,37,71,139,132,271,7,12,19,1,2:57
381021,2014-05-06,2014,MIL,ARI,5,7,7-5,ARI,9,false,37,40,77,149,143,292,9,13,22,1,3:05
381035,2014-05-06,2014,PHI,TOR,5,6,6-5,TOR,10,false,40,42,82,155,138,293,11,15,26,1,3:06
381023,2014-05-06,2014,CHN,CHA,1,5,5-1,CHA,9,false,34,38,72,143,152,295,7,13,20,2,3:30
381027,2014-05-06,2014,WAS,LAN,3,8,8-3,LAN,9,false,40,41,81,152,135,287,15,16,31,2,3:15
381026,2014-05-06,2014,SDN,KCA,1,3,3-1,KCA,11,false,38,44,82,161,139,300,7,13,20,0,3:03
381022,2014-05-06,2014,TBA,BAL,3,5,5-3,BAL,9,false,39,42,81,182,145,327,13,15,28,3,3:36 (:19 delay)
381031,2014-05-06,2014,OAK,SEA,3,8,8-3,SEA,9,false,39,43,82,163,159,322,12,19,31,4,3:19
381034,2014-05-06,2014,COL,TEX,12,1,12-1,COL,9,true,46,39,85,162,159,321,24,15,39,3,3:32
381024,2014-05-06,2014,BOS,CIN,4,3,4-3,BOS,12,false,50,49,99,174,195,369,19,14,33,3,4:04
381025,2014-05-06,2014,DET,HOU,11,4,11-4,DET,9,true,42,36,78,138,162,300,19,10,29,2,3:27
380600,2014-05-07,2014,OAK,SEA,2,0,2-0,OAK,9,true,31,31,62,114,125,239,8,4,12,0,2:21
380600,2014-05-07,2014,OAK,SEA,2,0,2-0,OAK,9,true,31,31,62,114,125,239,8,4,12,0,2:21
381050,2014-05-07,2014,ATL,SLN,1,7,7-1,SLN,9,false,35,41,76,154,113,267,8,15,23,1,2:43
381046,2014-05-07,2014,MIA,NYN,1,0,1-0,MIA,9,false,33,30,63,106,147,253,9,3,12,1,2:40
381047,2014-05-07,2014,TOR,PHI,10,0,10-0,TOR,9,true,37,32,69,120,142,262,13,5,18,2,2:23
381043,2014-05-07,2014,WAS,LAN,3,2,3-2,WAS,9,true,35,35,70,139,135,274,12,9,21,2,2:59 (1:40 delay)
381049,2014-05-07,2014,PIT,SFN,4,3,4-3,PIT,9,true,36,34,70,118,135,253,14,8,22,0,2:47
381037,2014-05-07,2014,TBA,BAL,3,4,4-3,BAL,9,false,38,35,73,117,155,272,12,9,21,3,3:08
381039,2014-05-07,2014,BOS,CIN,4,3,4-3,BOS,9,true,37,33,70,135,128,263,17,9,26,4,2:47
381036,2014-05-07,2014,MIL,ARI,2,3,3-2,ARI,9,false,32,43,75,155,107,262,9,15,24,1,2:43
381045,2014-05-07,2014,ANA,NYA,2,9,9-2,NYA,9,false,36,43,79,151,129,280,9,17,26,3,3:01
381040,2014-05-07,2014,TEX,COL,2,9,9-2,COL,9,false,35,44,79,158,146,304,8,18,26,2,3:06
381048,2014-05-07,2014,OAK,SEA,4,6,6-4,SEA,10,false,46,43,89,170,147,317,18,16,34,4,3:24
381042,2014-05-07,2014,SDN,KCA,0,8,8-0,KCA,9,false,35,46,81,168,149,317,11,19,30,0,3:09
381041,2014-05-07,2014,DET,HOU,3,2,3-2,DET,9,true,33,35,68,141,123,264,9,10,19,2,3:06 (:09 delay)
381044,2014-05-07,2014,CLE,MIN,4,3,4-3,CLE,9,false,36,38,74,146,138,284,10,11,21,1,2:57
381038,2014-05-07,2014,CHA,CHN,8,3,8-3,CHA,9,true,40,33,73,136,151,287,17,6,23,1,3:03
381054,2014-05-08,2014,DET,HOU,2,6,6-2,HOU,9,false,33,36,69,135,115,250,7,12,19,2,2:37
381055,2014-05-08,2014,SEA,KCA,1,0,1-0,SEA,9,true,30,31,61,110,113,223,7,6,13,1,2:25
381053,2014-05-08,2014,TEX,COL,5,0,5-0,TEX,9,true,37,34,71,155,117,272,15,9,24,3,2:59
381058,2014-05-08,2014,TOR,PHI,12,6,12-6,TOR,9,true,39,41,80,168,147,315,17,14,31,2,3:00
381051,2014-05-08,2014,TBA,BAL,1,3,3-1,BAL,9,false,39,37,76,145,176,321,14,11,25,4,3:33
381057,2014-05-08,2014,CLE,MIN,9,4,9-4,CLE,9,true,43,38,81,144,162,306,20,11,31,4,3:14
381059,2014-05-08,2014,LAN,SFN,1,3,3-1,SFN,10,false,36,42,78,173,139,312,8,13,21,4,3:47
381052,2014-05-08,2014,CHA,CHN,5,12,12-5,CHN,9,false,43,52,95,186,173,359,17,25,42,4,4:07
381056,2014-05-08,2014,SDN,MIA,1,3,3-1,MIA,11,false,41,40,81,172,159,331,9,7,16,0,3:22
381069,2014-05-09,2014,DET,MIN,1,2,2-1,MIN,9,false,36,38,74,148,113,261,10,12,22,2,3:00 (:27 delay)
381066,2014-05-09,2014,BAL,HOU,4,3,4-3,BAL,9,true,32,33,65,126,113,239,8,8,16,0,2:29
381073,2014-05-09,2014,PIT,SLN,6,4,6-4,PIT,9,true,36,39,75,152,131,283,13,14,27,1,2:48 (:25 delay)
381074,2014-05-09,2014,OAK,WAS,8,0,8-0,OAK,9,true,40,33,73,126,152,278,16,6,22,2,2:42
381067,2014-05-09,2014,SEA,KCA,1,6,6-1,KCA,9,false,34,42,76,131,135,266,8,17,25,1,2:45
381060,2014-05-09,2014,TOR,ANA,3,4,4-3,ANA,9,false,35,42,77,170,132,302,9,19,28,1,3:09
381072,2014-05-09,2014,LAN,SFN,1,3,3-1,SFN,9,false,31,36,67,145,122,267,5,12,17,1,2:57
381061,2014-05-09,2014,CHA,ARI,9,3,9-3,CHA,9,true,39,35,74,142,134,276,16,6,22,2,2:45
381064,2014-05-09,2014,TBA,CLE,3,6,6-3,CLE,9,false,39,43,82,187,161,348,14,15,29,5,4:10 (:01 delay)
381062,2014-05-09,2014,TEX,BOS,8,0,8-0,TEX,9,true,38,31,69,132,161,293,16,4,20,2,3:10
381070,2014-05-09,2014,MIL,NYA,3,5,5-3,NYA,9,false,34,36,70,163,144,307,9,9,18,2,3:02
381068,2014-05-09,2014,SDN,MIA,10,1,10-1,SDN,9,true,40,33,73,138,160,298,16,8,24,1,2:54
381063,2014-05-09,2014,ATL,CHN,3,2,3-2,ATL,10,false,39,36,75,151,161,312,13,7,20,1,3:07 (:18 delay)
381065,2014-05-09,2014,CIN,COL,4,3,4-3,CIN,9,false,31,35,66,126,108,234,7,8,15,0,2:34
381071,2014-05-09,2014,NYN,PHI,2,3,3-2,PHI,11,false,50,53,103,226,195,421,17,24,41,2,4:39
381089,2014-05-10,2014,OAK,WAS,4,3,4-3,OAK,10,false,37,38,75,120,121,241,7,9,16,1,2:32
381082,2014-05-10,2014,SEA,KCA,3,1,3-1,SEA,9,true,33,31,64,106,116,222,11,4,15,1,2:18
381078,2014-05-10,2014,ATL,CHN,2,0,2-0,ATL,9,true,31,32,63,122,96,218,7,8,15,1,2:19 (1:07 delay)
381079,2014-05-10,2014,TBA,CLE,7,1,7-1,TBA,9,true,37,33,70,143,128,271,15,7,22,2,3:03
381075,2014-05-10,2014,TOR,ANA,3,5,5-3,ANA,9,false,33,38,71,153,113,266,6,13,19,2,2:46
381084,2014-05-10,2014,DET,MIN,9,3,9-3,DET,9,true,37,38,75,156,122,278,13,12,25,0,2:50
381085,2014-05-10,2014,MIL,NYA,5,4,5-4,MIL,9,true,37,36,73,125,144,269,12,11,23,2,2:48
381087,2014-05-10,2014,LAN,SFN,6,2,6-2,LAN,9,true,36,41,77,141,134,275,15,14,29,2,3:22
381076,2014-05-10,2014,CHA,ARI,3,4,4-3,ARI,9,false,33,39,72,160,133,293,7,16,23,0,2:58
381086,2014-05-10,2014,NYN,PHI,4,5,5-4,PHI,9,false,39,41,80,138,154,292,12,15,27,2,3:16 (:39 delay)
381077,2014-05-10,2014,TEX,BOS,3,8,8-3,BOS,9,false,36,43,79,170,134,304,10,20,30,3,3:09
381088,2014-05-10,2014,PIT,SLN,4,3,4-3,PIT,9,true,37,40,77,167,132,299,14,14,28,2,3:30
381081,2014-05-10,2014,BAL,HOU,5,4,5-4,BAL,10,false,43,43,86,146,147,293,16,15,31,3,3:29 (:55 delay)
381080,2014-05-10,2014,CIN,COL,2,11,11-2,COL,9,false,36,45,81,168,135,303,9,20,29,0,3:10
381083,2014-05-10,2014,SDN,MIA,9,3,9-3,SDN,9,true,45,38,83,158,194,352,22,11,33,0,3:21
381092,2014-05-11,2014,TEX,BOS,2,5,5-2,BOS,9,false,34,37,71,147,134,281,8,11,19,3,2:47
381097,2014-05-11,2014,SEA,KCA,7,9,9-7,KCA,9,false,38,42,80,165,146,311,13,15,28,1,3:01
381096,2014-05-11,2014,BAL,HOU,2,5,5-2,HOU,9,false,36,43,79,164,149,313,11,16,27,1,3:21
381100,2014-05-11,2014,MIL,NYA,6,5,6-5,MIL,9,false,41,41,82,158,137,295,17,15,32,3,3:40
381090,2014-05-11,2014,TOR,ANA,3,9,9-3,ANA,9,false,36,46,82,204,146,350,9,20,29,3,3:24
381094,2014-05-11,2014,TBA,CLE,5,6,6-5,CLE,9,false,39,43,82,179,163,342,11,18,29,4,3:48
381103,2014-05-11,2014,PIT,SLN,5,6,6-5,SLN,9,false,43,42,85,157,163,320,18,16,34,2,3:37
381098,2014-05-11,2014,SDN,MIA,5,4,5-4,SDN,9,true,39,41,80,177,166,343,16,14,30,2,3:29
381101,2014-05-11,2014,NYN,PHI,5,4,5-4,NYN,11,false,53,49,102,179,213,392,24,18,42,2,4:22
381093,2014-05-11,2014,ATL,CHN,5,2,5-2,ATL,9,true,33,37,70,149,115,264,10,12,22,1,2:54
381095,2014-05-11,2014,CIN,COL,4,1,4-1,CIN,9,true,32,33,65,142,119,261,7,7,14,1,2:49
381099,2014-05-11,2014,DET,MIN,3,4,4-3,MIN,9,false,35,36,71,164,130,294,9,13,22,2,3:08
381104,2014-05-11,2014,OAK,WAS,9,1,9-1,OAK,9,true,41,33,74,123,150,273,17,7,24,1,2:40
381102,2014-05-11,2014,LAN,SFN,4,7,7-4,SFN,10,false,45,44,89,159,145,304,17,17,34,2,3:54
381091,2014-05-11,2014,CHA,ARI,1,5,5-1,ARI,9,false,30,42,72,185,120,305,5,17,22,2,3:10
381107,2014-05-12,2014,OAK,CHA,5,4,5-4,OAK,9,true,37,37,74,113,167,280,15,10,25,4,2:57
381105,2014-05-12,2014,TOR,ANA,7,3,7-3,TOR,9,true,36,38,74,146,154,300,13,13,26,2,2:45
381114,2014-05-12,2014,ARI,WAS,5,6,6-5,WAS,9,false,38,38,76,149,130,279,13,11,24,1,2:53
381113,2014-05-12,2014,HOU,TEX,0,4,4-0,TEX,9,false,39,39,78,138,180,318,14,12,26,3,3:16
381109,2014-05-12,2014,BAL,DET,1,4,4-1,DET,9,false,34,33,67,133,122,255,6,8,14,1,2:48 (:35 delay)
381112,2014-05-12,2014,SEA,TBA,12,5,12-5,SEA,9,true,42,37,79,159,144,303,17,11,28,2,3:10
381108,2014-05-12,2014,SLN,CHN,5,17,17-5,CHN,9,false,37,50,87,179,131,310,11,22,33,1,3:12
381110,2014-05-12,2014,LAN,MIA,6,5,6-5,LAN,9,true,42,35,77,128,203,331,20,9,29,3,3:31
381111,2014-05-12,2014,NYA,NYN,7,9,9-7,NYN,9,false,41,41,82,164,150,314,16,15,31,4,3:34
381106,2014-05-12,2014,SFN,ATL,4,2,4-2,SFN,9,true,33,33,66,131,118,249,9,8,17,3,2:43
381121,2014-05-13,2014,KCA,COL,5,1,5-1,KCA,9,true,36,32,68,129,141,270,15,6,21,0,2:50
381128,2014-05-13,2014,HOU,TEX,8,0,8-0,HOU,9,true,40,31,71,108,177,285,16,8,24,1,2:45
381129,2014-05-13,2014,ARI,WAS,3,1,3-1,ARI,9,true,32,33,65,110,109,219,8,8,16,0,2:21
381126,2014-05-13,2014,CIN,SDN,1,2,2-1,SDN,9,false,36,33,69,126,125,251,9,7,16,0,2:31
381123,2014-05-13,2014,LAN,MIA,7,1,7-1,LAN,9,true,36,35,71,151,127,278,14,8,22,2,3:02
381127,2014-05-13,2014,SEA,TBA,1,2,2-1,TBA,9,false,32,36,68,126,109,235,6,9,15,1,2:48
381122,2014-05-13,2014,BAL,DET,1,4,4-1,DET,9,false,35,32,67,138,140,278,9,9,18,1,2:57
381118,2014-05-13,2014,OAK,CHA,11,0,11-0,OAK,9,true,43,31,74,121,158,279,20,6,26,0,2:50
381120,2014-05-13,2014,TOR,CLE,5,4,5-4,TOR,9,true,34,38,72,146,115,261,10,11,21,3,2:29
381116,2014-05-13,2014,SFN,ATL,0,5,5-0,ATL,9,false,35,37,72,129,147,276,8,10,18,2,2:51
381115,2014-05-13,2014,PHI,ANA,3,4,4-3,ANA,9,false,34,39,73,141,119,260,8,9,17,0,2:49
381117,2014-05-13,2014,MIN,BOS,8,6,8-6,MIN,9,false,42,40,82,175,166,341,18,14,32,5,3:25
381119,2014-05-13,2014,SLN,CHN,4,3,4-3,SLN,12,false,51,49,100,202,214,416,19,17,36,3,4:39
381124,2014-05-13,2014,NYA,NYN,7,12,12-7,NYN,9,false,43,45,88,193,196,389,19,17,36,2,3:58
381125,2014-05-13,2014,MIL,PIT,5,2,5-2,MIL,9,true,40,37,77,158,134,292,18,11,29,1,3:14
381136,2014-05-14,2014,KCA,COL,3,2,3-2,KCA,9,true,33,34,67,138,118,256,10,8,18,1,2:34
381144,2014-05-14,2014,ARI,WAS,1,5,5-1,WAS,9,false,32,36,68,136,126,262,7,9,16,1,2:33
381137,2014-05-14,2014,BAL,DET,5,7,7-5,DET,9,false,41,39,80,163,171,334,14,12,26,1,3:27
381130,2014-05-14,2014,PHI,ANA,0,3,3-0,ANA,9,false,33,39,72,175,125,300,5,14,19,0,3:08
381143,2014-05-14,2014,HOU,TEX,5,4,5-4,HOU,9,false,41,39,80,130,181,311,16,15,31,6,3:36
381135,2014-05-14,2014,TOR,CLE,4,15,15-4,CLE,9,false,36,54,90,210,140,350,9,27,36,3,3:37
381139,2014-05-14,2014,NYN,NYA,0,4,4-0,NYA,9,false,30,37,67,157,114,271,4,10,14,0,3:00
381140,2014-05-14,2014,MIL,PIT,1,4,4-1,PIT,9,false,36,38,74,139,133,272,11,12,23,0,3:01
381142,2014-05-14,2014,SEA,TBA,0,2,2-0,TBA,9,false,30,36,66,164,140,304,5,10,15,1,3:21
381131,2014-05-14,2014,SFN,ATL,10,4,10-4,SFN,9,true,45,35,80,149,160,309,21,9,30,1,3:18
381132,2014-05-14,2014,MIN,BOS,4,9,9-4,BOS,9,false,40,43,83,171,163,334,13,15,28,1,3:07
381133,2014-05-14,2014,OAK,CHA,2,4,4-2,CHA,9,false,32,36,68,142,145,287,6,10,16,3,2:57
381138,2014-05-14,2014,LAN,MIA,3,13,13-3,MIA,9,false,38,48,86,181,136,317,11,23,34,1,3:20
381145,2014-05-15,2014,KCA,BAL,1,2,2-1,BAL,9,false,34,36,70,147,142,289,8,11,19,4,2:56
381152,2014-05-15,2014,CIN,SDN,5,0,5-0,CIN,9,true,39,29,68,116,141,257,16,5,21,0,2:36
381149,2014-05-15,2014,SFN,MIA,6,4,6-4,SFN,9,true,39,37,76,122,151,273,16,10,26,2,2:53
381153,2014-05-15,2014,ANA,TBA,6,5,6-5,ANA,9,false,38,37,75,147,143,290,12,11,23,5,3:42
381147,2014-05-15,2014,SLN,CHN,5,3,5-3,SLN,9,true,33,38,71,149,143,292,10,11,21,2,2:49
381148,2014-05-15,2014,TOR,CLE,4,2,4-2,TOR,9,true,38,38,76,144,176,320,15,12,27,6,3:23
381150,2014-05-15,2014,NYN,NYA,0,1,1-0,NYA,9,false,33,34,67,134,136,270,6,10,16,4,3:04
381151,2014-05-15,2014,MIL,PIT,4,3,4-3,MIL,9,false,33,37,70,151,126,277,10,11,21,2,3:00
381141,2014-05-15,2014,CIN,SDN,1,6,6-1,SDN,9,false,35,39,74,150,131,281,9,12,21,1,2:47
381141,2014-05-15,2014,CIN,SDN,1,6,6-1,SDN,9,false,35,39,74,150,131,281,9,12,21,1,2:47
381146,2014-05-15,2014,MIN,BOS,4,3,4-3,MIN,10,false,44,40,84,149,157,306,18,10,28,0,3:21
381168,2014-05-16,2014,TEX,TOR,0,2,2-0,TOR,9,false,30,34,64,128,105,233,4,9,13,0,2:27
381157,2014-05-16,2014,PHI,CIN,0,3,3-0,CIN,9,false,36,34,70,141,133,274,9,7,16,1,2:48
381159,2014-05-16,2014,ARI,LAN,0,7,7-0,LAN,9,false,32,42,74,160,124,284,8,15,23,0,2:54
381167,2014-05-16,2014,ANA,TBA,0,3,3-0,TBA,9,false,37,38,75,145,155,300,10,12,22,2,3:27
381166,2014-05-16,2014,MIN,SEA,5,4,5-4,MIN,9,true,37,41,78,139,116,255,13,13,26,2,2:42
381158,2014-05-16,2014,BOS,DET,0,1,1-0,DET,9,false,32,34,66,138,146,284,9,9,18,3,3:14 (:47 delay)
381165,2014-05-16,2014,COL,SDN,3,1,3-1,COL,9,true,35,33,68,134,125,259,10,7,17,3,3:02
381156,2014-05-16,2014,HOU,CHA,2,7,7-2,CHA,9,false,39,44,83,160,162,322,13,18,31,3,3:31
381154,2014-05-16,2014,SLN,ATL,5,2,5-2,SLN,9,true,37,34,71,131,155,286,16,10,26,1,2:55
381163,2014-05-16,2014,CLE,OAK,1,11,11-1,OAK,9,false,34,43,77,173,143,316,7,18,25,2,3:07
381161,2014-05-16,2014,CHN,MIL,3,4,4-3,MIL,9,false,34,40,74,171,114,285,9,13,22,1,3:05
381162,2014-05-16,2014,WAS,NYN,5,2,5-2,WAS,9,true,37,38,75,154,139,293,14,12,26,0,3:08
381155,2014-05-16,2014,KCA,BAL,0,4,4-0,BAL,9,false,32,36,68,129,117,246,6,9,15,0,2:22
381160,2014-05-16,2014,SFN,MIA,5,7,7-5,MIA,9,false,39,43,82,152,123,275,13,16,29,3,3:17
381170,2014-05-17,2014,KCA,BAL,1,0,1-0,KCA,9,true,31,32,63,135,104,239,6,5,11,3,2:37
381181,2014-05-17,2014,MIN,SEA,4,3,4-3,MIN,9,true,30,36,66,136,105,241,8,9,17,0,2:26
381179,2014-05-17,2014,NYA,PIT,7,1,7-1,NYA,9,true,33,36,69,156,107,263,10,12,22,1,2:56
381176,2014-05-17,2014,CHN,MIL,3,0,3-0,CHN,9,true,30,32,62,141,119,260,6,5,11,0,2:57
381172,2014-05-17,2014,PHI,CIN,12,1,12-1,PHI,9,true,43,33,76,115,184,299,19,6,25,2,2:54
381178,2014-05-17,2014,CLE,OAK,2,6,6-2,OAK,9,false,34,38,72,137,122,259,10,10,20,2,3:00
381173,2014-05-17,2014,BOS,DET,1,6,6-1,DET,9,false,34,40,74,138,122,260,8,13,21,1,2:49
381169,2014-05-17,2014,SLN,ATL,4,1,4-1,SLN,9,true,30,33,63,124,127,251,9,9,18,2,2:31
381183,2014-05-17,2014,TEX,TOR,2,4,4-2,TOR,9,false,34,43,77,182,129,311,9,18,27,5,3:09
381175,2014-05-17,2014,SFN,MIA,0,5,5-0,MIA,9,false,36,40,76,152,130,282,9,13,22,2,2:57
381182,2014-05-17,2014,ANA,TBA,6,0,6-0,ANA,9,true,37,31,68,127,141,268,14,7,21,2,2:59
381174,2014-05-17,2014,ARI,LAN,18,7,18-7,ARI,9,true,50,42,92,165,183,348,27,15,42,6,3:55
381177,2014-05-17,2014,WAS,NYN,2,5,5-2,NYN,9,false,33,38,71,159,119,278,7,11,18,0,2:48
381171,2014-05-17,2014,HOU,CHA,6,5,6-5,HOU,9,true,40,41,81,170,147,317,17,16,33,3,3:26
381180,2014-05-17,2014,COL,SDN,5,8,8-5,SDN,9,false,37,45,82,196,130,326,15,20,35,2,3:39
381191,2014-05-18,2014,CHN,MIL,4,2,4-2,CHN,9,true,34,33,67,137,138,275,11,6,17,0,2:47
381197,2014-05-18,2014,ANA,TBA,6,2,6-2,ANA,9,true,36,35,71,129,135,264,12,8,20,2,2:59
381189,2014-05-18,2014,ARI,LAN,5,3,5-3,ARI,9,true,35,37,72,133,133,266,11,11,22,1,2:50
381190,2014-05-18,2014,SFN,MIA,4,1,4-1,SFN,9,true,34,37,71,138,155,293,10,11,21,1,3:04
381186,2014-05-18,2014,HOU,CHA,8,2,8-2,HOU,9,true,37,35,72,135,154,289,15,10,25,2,2:46
381184,2014-05-18,2014,SLN,ATL,5,6,6-5,ATL,9,false,44,37,81,136,167,303,19,13,32,4,3:20
381194,2014-05-18,2014,NYA,PIT,4,3,4-3,NYA,9,true,30,35,65,133,126,259,8,8,16,2,2:52
381164,2014-05-18,2014,NYA,PIT,3,5,5-3,PIT,9,false,37,37,74,136,153,289,12,11,23,3,3:04
381192,2014-05-18,2014,WAS,NYN,6,3,6-3,WAS,9,true,35,35,70,133,139,272,12,10,22,0,2:45
381164,2014-05-18,2014,NYA,PIT,3,5,5-3,PIT,9,false,37,37,74,136,153,289,12,11,23,3,3:04
381196,2014-05-18,2014,MIN,SEA,2,6,6-2,SEA,9,false,34,42,76,176,115,291,9,16,25,1,3:02
381187,2014-05-18,2014,PHI,CIN,8,3,8-3,PHI,9,true,37,40,77,162,140,302,14,12,26,1,3:03
381195,2014-05-18,2014,COL,SDN,8,6,8-6,COL,10,false,42,42,84,154,164,318,17,14,31,0,3:34
381193,2014-05-18,2014,CLE,OAK,3,13,13-3,OAK,9,false,42,47,89,163,177,340,16,22,38,5,3:21
381198,2014-05-18,2014,TEX,TOR,6,2,6-2,TEX,9,true,36,37,73,145,134,279,10,11,21,2,2:52
381185,2014-05-18,2014,KCA,BAL,8,6,8-6,KCA,9,true,39,41,80,133,168,301,15,15,30,1,2:58
381188,2014-05-18,2014,BOS,DET,2,6,6-2,DET,9,false,36,42,78,145,143,288,10,17,27,3,3:19
381203,2014-05-19,2014,ATL,MIL,9,3,9-3,ATL,9,true,45,36,81,147,180,327,22,10,32,3,3:29
381199,2014-05-19,2014,KCA,CHA,6,7,7-6,CHA,9,false,40,39,79,137,150,287,14,14,28,3,3:16
381201,2014-05-19,2014,CLE,DET,5,4,5-4,CLE,10,false,48,41,89,133,194,327,21,13,34,1,3:51
381200,2014-05-19,2014,WAS,CIN,3,4,4-3,CIN,15,false,61,63,124,214,218,432,17,21,38,1,4:58
381202,2014-05-19,2014,ANA,HOU,2,5,5-2,HOU,9,false,32,35,67,126,135,261,7,12,19,1,2:40
381216,2014-05-20,2014,TEX,SEA,2,6,6-2,SEA,9,false,32,42,74,161,112,273,7,17,24,1,2:54
381207,2014-05-20,2014,WAS,CIN,9,4,9-4,WAS,9,true,39,39,78,149,151,300,13,11,24,3,3:03
381214,2014-05-20,2014,TBA,OAK,0,3,3-0,OAK,9,false,33,41,74,183,150,333,9,14,23,2,3:31
381205,2014-05-20,2014,PIT,BAL,2,9,9-2,BAL,9,false,36,42,78,154,141,295,12,15,27,2,2:55
381210,2014-05-20,2014,NYN,LAN,4,9,9-4,LAN,9,false,41,48,89,194,176,370,14,22,36,6,4:08
381213,2014-05-20,2014,CHN,NYA,6,1,6-1,CHN,9,true,39,38,77,156,139,295,16,11,27,4,3:25
381209,2014-05-20,2014,ANA,HOU,9,3,9-3,ANA,9,true,42,38,80,146,176,322,17,12,29,3,3:34
381215,2014-05-20,2014,MIA,PHI,5,6,6-5,PHI,9,false,42,42,84,175,175,350,15,17,32,1,3:30
381206,2014-05-20,2014,KCA,CHA,6,7,7-6,CHA,9,false,42,38,80,154,168,322,15,12,27,3,3:19
381211,2014-05-20,2014,ATL,MIL,5,0,5-0,ATL,9,true,36,37,73,128,128,256,12,9,21,1,2:53
381208,2014-05-20,2014,CLE,DET,6,2,6-2,CLE,9,true,37,33,70,129,150,279,15,10,25,1,3:06
381218,2014-05-20,2014,BOS,TOR,4,7,7-4,TOR,9,false,40,41,81,147,146,293,15,15,30,6,3:17
381204,2014-05-20,2014,SLN,ARI,5,0,5-0,SLN,9,true,34,28,62,115,106,221,10,1,11,0,2:20
381217,2014-05-20,2014,COL,SFN,5,4,5-4,COL,9,false,41,36,77,143,162,305,15,10,25,0,3:33
381212,2014-05-20,2014,SDN,MIN,3,5,5-3,MIN,9,false,35,36,71,155,145,300,8,10,18,2,3:05
381226,2014-05-21,2014,ATL,MIL,1,6,6-1,MIL,9,false,32,40,72,124,116,240,5,14,19,0,2:26
381222,2014-05-21,2014,WAS,CIN,1,2,2-1,CIN,9,false,34,39,73,132,116,248,8,13,21,0,2:52 (1:01 delay)
381224,2014-05-21,2014,ANA,HOU,2,1,2-1,ANA,9,true,30,30,60,94,125,219,6,4,10,0,2:26
381225,2014-05-21,2014,NYN,LAN,3,4,4-3,LAN,9,false,39,34,73,134,142,276,14,10,24,1,3:01
381221,2014-05-21,2014,KCA,CHA,3,1,3-1,KCA,9,true,34,33,67,131,130,261,12,8,20,1,2:41
381231,2014-05-21,2014,TEX,SEA,4,3,4-3,TEX,9,true,35,34,69,138,128,266,12,8,20,3,2:47
381232,2014-05-21,2014,COL,SFN,1,5,5-1,SFN,9,false,33,36,69,169,100,269,7,10,17,4,3:00
381233,2014-05-21,2014,BOS,TOR,4,6,6-4,TOR,9,false,42,44,86,157,165,322,14,16,30,5,3:23
381230,2014-05-21,2014,MIA,PHI,14,5,14-5,MIA,9,true,46,42,88,167,186,353,21,17,38,1,3:39
381228,2014-05-21,2014,CHN,NYA,2,4,4-2,NYA,13,false,53,56,109,215,190,405,15,18,33,3,4:39
381219,2014-05-21,2014,SLN,ARI,3,2,3-2,SLN,12,false,51,46,97,182,199,381,21,11,32,2,4:00
381223,2014-05-21,2014,CLE,DET,11,10,11-10,CLE,13,false,59,63,122,269,206,475,25,24,49,6,5:16
381229,2014-05-21,2014,TBA,OAK,2,3,3-2,OAK,9,false,37,36,73,172,154,326,11,8,19,3,3:53
381227,2014-05-21,2014,SDN,MIN,0,2,2-0,MIN,9,false,34,34,68,136,119,255,8,7,15,0,2:32
381220,2014-05-21,2014,PIT,BAL,9,8,9-8,PIT,9,true,39,45,84,182,129,311,17,19,36,3,3:28 (:10 delay)
381238,2014-05-22,2014,NYN,LAN,5,3,5-3,NYN,9,true,34,33,67,121,149,270,10,8,18,1,2:59
381234,2014-05-22,2014,SLN,ARI,4,2,4-2,SLN,9,true,38,36,74,123,133,256,16,9,25,2,2:40
381235,2014-05-22,2014,SDN,CHN,1,5,5-1,CHN,9,false,34,36,70,128,147,275,8,9,17,1,2:56
381237,2014-05-22,2014,SEA,HOU,3,1,3-1,SEA,9,true,35,35,70,146,141,287,13,8,21,2,3:09
381242,2014-05-22,2014,MIA,PHI,4,3,4-3,MIA,9,false,37,38,75,137,128,265,12,11,23,1,2:46
381239,2014-05-22,2014,ATL,MIL,5,4,5-4,ATL,9,true,35,38,73,143,130,273,13,14,27,4,3:36
381241,2014-05-22,2014,TBA,OAK,5,2,5-2,TBA,11,false,43,42,85,168,143,311,12,11,23,3,3:45
381246,2014-05-22,2014,PIT,WAS,3,1,3-1,PIT,9,true,38,38,76,153,141,294,15,11,26,1,3:13
381243,2014-05-22,2014,COL,SFN,2,4,4-2,SFN,9,false,41,35,76,128,160,288,17,12,29,2,3:13 (2:46 delay)
381243,2014-05-22,2014,COL,SFN,2,4,4-2,SFN,9,false,41,35,76,128,160,288,17,12,29,2,3:13 (2:46 delay)
381240,2014-05-22,2014,CHA,NYA,3,2,3-2,CHA,9,true,34,31,65,134,128,262,10,4,14,0,2:45
381245,2014-05-22,2014,BOS,TOR,2,7,7-2,TOR,9,false,34,42,76,166,131,297,7,17,24,2,2:58 (:08 delay)
381244,2014-05-22,2014,DET,TEX,2,9,9-2,TEX,9,false,35,46,81,192,126,318,10,21,31,2,3:30
381236,2014-05-22,2014,BAL,CLE,7,8,8-7,CLE,13,false,57,54,111,194,207,401,23,16,39,6,4:22
381253,2014-05-23,2014,ANA,KCA,6,1,6-1,ANA,9,true,37,38,75,134,125,259,15,11,26,2,2:51
381260,2014-05-23,2014,DET,TEX,7,2,7-2,DET,9,true,36,32,68,131,123,254,15,8,23,0,2:30
381259,2014-05-23,2014,CIN,SLN,5,3,5-3,CIN,9,true,34,36,70,127,121,248,10,12,22,1,2:35
381248,2014-05-23,2014,TBA,BOS,1,0,1-0,TBA,9,false,34,36,70,155,128,283,8,10,18,3,3:25
381255,2014-05-23,2014,MIA,MIL,5,9,9-5,MIL,9,false,37,42,79,137,146,283,9,15,24,1,2:54
381252,2014-05-23,2014,SEA,HOU,6,1,6-1,SEA,9,true,36,32,68,115,112,227,14,6,20,2,2:40
381258,2014-05-23,2014,TOR,OAK,3,2,3-2,TOR,9,true,30,38,68,137,108,245,7,13,20,2,2:37
381256,2014-05-23,2014,SFN,MIN,6,2,6-2,SFN,9,true,31,39,70,153,106,259,6,14,20,1,2:43
381250,2014-05-23,2014,BAL,CLE,8,4,8-4,BAL,9,true,39,36,75,143,111,254,22,12,34,1,2:43
381251,2014-05-23,2014,ATL,COL,3,2,3-2,ATL,9,true,36,35,71,128,136,264,12,8,20,2,3:13
381249,2014-05-23,2014,SDN,CHN,11,1,11-1,SDN,9,true,39,35,74,142,156,298,15,10,25,0,3:04
381261,2014-05-23,2014,PIT,WAS,4,3,4-3,PIT,9,true,34,41,75,178,125,303,10,16,26,2,3:13
381257,2014-05-23,2014,CHA,NYA,6,5,6-5,CHA,9,false,41,41,82,175,170,345,16,16,32,4,3:52
381254,2014-05-23,2014,PHI,LAN,0,2,2-0,LAN,9,false,35,40,75,143,149,292,7,16,23,2,3:15 (:43 delay)
381273,2014-05-24,2014,TOR,OAK,5,2,5-2,TOR,9,true,35,34,69,127,135,262,12,7,19,3,2:35
381276,2014-05-24,2014,PIT,WAS,3,2,3-2,PIT,9,true,33,37,70,142,127,269,13,10,23,1,2:59
381272,2014-05-24,2014,CHA,NYA,3,4,4-3,NYA,10,false,38,40,78,143,138,281,11,9,20,2,2:56
381262,2014-05-24,2014,NYN,ARI,2,3,3-2,ARI,9,false,37,38,75,148,150,298,11,10,21,3,3:18
381264,2014-05-24,2014,SDN,CHN,2,3,3-2,CHN,9,false,32,37,69,118,111,229,5,11,16,2,2:34
381271,2014-05-24,2014,SFN,MIN,2,1,2-1,SFN,9,true,31,35,66,140,124,264,8,6,14,3,2:51
381270,2014-05-24,2014,MIA,MIL,2,1,2-1,MIA,9,true,34,37,71,131,133,264,11,12,23,2,3:03
381267,2014-05-24,2014,SEA,HOU,4,9,9-4,HOU,9,false,37,44,81,173,131,304,9,16,25,2,3:18
381274,2014-05-24,2014,CIN,SLN,3,6,6-3,SLN,9,false,38,42,80,142,142,284,12,16,28,4,3:09
381266,2014-05-24,2014,ATL,COL,1,3,3-1,COL,9,false,35,35,70,139,147,286,8,9,17,2,3:10
381275,2014-05-24,2014,DET,TEX,2,12,12-2,TEX,9,false,40,48,88,178,158,336,15,23,38,2,3:43
381269,2014-05-24,2014,PHI,LAN,5,3,5-3,PHI,9,true,33,35,68,127,144,271,10,9,19,0,2:37
381268,2014-05-24,2014,ANA,KCA,4,7,7-4,KCA,13,false,53,58,111,218,204,422,16,18,34,2,4:53
381263,2014-05-24,2014,TBA,BOS,6,5,6-5,TBA,15,false,60,56,116,207,240,447,19,13,32,2,5:16
381265,2014-05-24,2014,BAL,CLE,0,9,9-0,CLE,9,false,37,43,80,174,134,308,10,18,28,2,3:05
381282,2014-05-25,2014,SEA,HOU,1,4,4-1,HOU,9,false,30,35,65,132,106,238,4,12,16,0,2:28
381281,2014-05-25,2014,ATL,COL,7,0,7-0,ATL,9,true,34,33,67,115,137,252,10,5,15,1,2:48
381283,2014-05-25,2014,ANA,KCA,4,3,4-3,ANA,9,true,36,34,70,150,140,290,14,9,23,1,3:04
381279,2014-05-25,2014,SDN,CHN,4,3,4-3,SDN,9,true,32,34,66,148,134,282,9,8,17,3,3:02
381289,2014-05-25,2014,CIN,SLN,0,4,4-0,SLN,9,false,34,42,76,141,134,275,7,14,21,2,3:15
381284,2014-05-25,2014,PHI,LAN,0,6,6-0,LAN,9,false,30,39,69,124,128,252,3,12,15,0,2:37
381286,2014-05-25,2014,SFN,MIN,8,1,8-1,SFN,9,true,35,32,67,131,132,263,13,5,18,1,2:40
381288,2014-05-25,2014,TOR,OAK,3,1,3-1,TOR,9,true,36,35,71,148,142,290,14,8,22,1,3:08
381291,2014-05-25,2014,PIT,WAS,2,5,5-2,WAS,9,false,35,41,76,162,131,293,9,15,24,2,3:08
381287,2014-05-25,2014,CHA,NYA,1,7,7-1,NYA,9,false,35,42,77,170,152,322,10,14,24,1,3:17
381277,2014-05-25,2014,NYN,ARI,1,2,2-1,ARI,9,false,38,39,77,176,120,296,15,13,28,2,3:09
381278,2014-05-25,2014,TBA,BOS,8,5,8-5,TBA,9,true,39,39,78,159,141,300,15,12,27,2,3:27
381290,2014-05-25,2014,DET,TEX,4,12,12-4,TEX,9,false,42,50,92,179,154,333,17,22,39,5,3:43
381247,2014-05-25,2014,NYN,ARI,4,2,4-2,NYN,9,true,41,35,76,138,146,284,18,7,25,3,3:12
381247,2014-05-25,2014,NYN,ARI,4,2,4-2,NYN,9,true,41,35,76,138,146,284,18,7,25,3,3:12
381280,2014-05-25,2014,BAL,CLE,4,2,4-2,BAL,9,true,37,36,73,155,162,317,13,11,24,2,3:12
381285,2014-05-25,2014,MIA,MIL,1,7,7-1,MIL,9,false,36,43,79,163,150,313,10,17,27,1,3:16
381304,2014-05-26,2014,ARI,SDN,7,5,7-5,ARI,9,false,37,36,73,118,139,257,12,12,24,2,2:59
381299,2014-05-26,2014,OAK,DET,10,0,10-0,OAK,9,true,41,35,76,122,156,278,14,7,21,1,2:53
381296,2014-05-26,2014,LAN,CIN,4,3,4-3,LAN,9,true,34,35,69,139,140,279,9,8,17,3,3:07
381292,2014-05-26,2014,SEA,ANA,5,1,5-1,SEA,9,true,34,31,65,127,115,242,12,6,18,1,2:40
381298,2014-05-26,2014,PHI,COL,9,0,9-0,PHI,9,true,37,36,73,126,147,273,14,11,25,3,3:06
381306,2014-05-26,2014,MIN,TEX,2,7,7-2,TEX,9,false,35,39,74,116,135,251,10,13,23,2,2:52
381300,2014-05-26,2014,KCA,HOU,2,9,9-2,HOU,9,false,38,46,84,184,138,322,12,21,33,1,3:23
381294,2014-05-26,2014,ATL,BOS,6,8,8-6,BOS,9,false,42,41,83,184,154,338,17,15,32,2,3:40 (1:26 delay)
381295,2014-05-26,2014,SFN,CHN,4,8,8-4,CHN,9,false,35,41,76,127,143,270,7,16,23,2,3:11
381293,2014-05-26,2014,MIL,BAL,6,7,7-6,BAL,10,false,45,44,89,167,172,339,17,16,33,2,3:42
381302,2014-05-26,2014,SLN,NYA,4,6,6-4,NYA,12,false,47,46,93,172,168,340,12,13,25,3,3:41 (1:01 delay)
381301,2014-05-26,2014,WAS,MIA,2,3,3-2,MIA,9,false,34,34,68,128,142,270,6,9,15,1,2:46
381297,2014-05-26,2014,CHA,CLE,6,2,6-2,CHA,9,true,35,37,72,163,154,317,10,11,21,4,3:22
381303,2014-05-26,2014,NYN,PIT,3,5,5-3,PIT,9,false,36,45,81,195,120,315,10,20,30,3,3:30
381305,2014-05-26,2014,TOR,TBA,10,5,10-5,TOR,9,true,42,41,83,139,137,276,18,17,35,1,2:58
381311,2014-05-27,2014,LAN,CIN,6,3,6-3,LAN,9,true,36,34,70,119,132,251,15,8,23,2,2:58
381310,2014-05-27,2014,SFN,CHN,4,0,4-0,SFN,9,true,34,33,67,117,118,235,10,6,16,0,2:39
381321,2014-05-27,2014,MIN,TEX,4,3,4-3,MIN,9,false,36,35,71,121,140,261,9,9,18,1,2:43
381317,2014-05-27,2014,SLN,NYA,6,0,6-0,SLN,9,true,37,34,71,126,157,283,13,8,21,0,2:41
381312,2014-05-27,2014,CHA,CLE,2,1,2-1,CHA,9,true,36,33,69,139,152,291,12,9,21,3,3:05 (2:39 delay)
381315,2014-05-27,2014,KCA,HOU,0,3,3-0,HOU,9,false,32,41,73,153,122,275,5,17,22,1,3:02
381314,2014-05-27,2014,OAK,DET,5,6,6-5,DET,9,false,38,38,76,151,145,296,12,12,24,2,3:19
381309,2014-05-27,2014,ATL,BOS,3,6,6-3,BOS,9,false,39,43,82,156,160,316,14,17,31,4,3:32
381308,2014-05-27,2014,MIL,BAL,7,6,7-6,MIL,10,false,44,41,85,168,156,324,17,11,28,2,3:44
381307,2014-05-27,2014,SEA,ANA,4,6,6-4,ANA,9,false,41,40,81,133,163,296,15,14,29,2,3:03
381320,2014-05-27,2014,TOR,TBA,9,6,9-6,TOR,9,true,40,39,79,141,133,274,17,14,31,3,3:00
381318,2014-05-27,2014,NYN,PIT,4,2,4-2,NYN,9,true,38,40,78,175,165,340,13,14,27,2,3:43
381319,2014-05-27,2014,ARI,SDN,3,4,4-3,SDN,9,false,38,38,76,143,129,272,12,11,23,3,2:53
381313,2014-05-27,2014,PHI,COL,2,6,6-2,COL,9,false,39,37,76,147,151,298,13,11,24,2,3:21 (1:22 delay)
381326,2014-05-28,2014,LAN,CIN,2,3,3-2,CIN,9,false,34,36,70,138,116,254,7,9,16,2,3:08
381335,2014-05-28,2014,TOR,TBA,3,2,3-2,TOR,9,false,36,34,70,143,148,291,13,7,20,2,3:23
381322,2014-05-28,2014,SEA,ANA,3,1,3-1,SEA,9,true,30,31,61,119,119,238,8,6,14,2,2:30
381330,2014-05-28,2014,KCA,HOU,3,9,9-3,HOU,9,false,38,49,87,186,165,351,11,22,33,1,3:21
381325,2014-05-28,2014,SFN,CHN,5,0,5-0,SFN,9,true,36,36,72,151,143,294,14,8,22,5,3:18
381332,2014-05-28,2014,SLN,NYA,4,7,7-4,NYA,9,false,44,42,86,150,164,314,16,15,31,4,3:22 (:05 delay)
381331,2014-05-28,2014,WAS,MIA,5,8,8-5,MIA,10,false,50,45,95,176,182,358,21,21,42,2,3:47
381327,2014-05-28,2014,CHA,CLE,3,2,3-2,CHA,9,false,36,35,71,118,147,265,11,9,20,3,2:46
381336,2014-05-28,2014,MIN,TEX,0,1,1-0,TEX,9,false,36,34,70,143,151,294,10,8,18,4,3:12
381329,2014-05-28,2014,OAK,DET,3,1,3-1,OAK,9,false,30,30,60,103,117,220,6,6,12,1,2:26
381333,2014-05-28,2014,NYN,PIT,5,0,5-0,NYN,9,true,37,35,72,140,168,308,14,8,22,2,3:08
381323,2014-05-28,2014,BOS,ATL,4,0,4-0,BOS,9,true,39,37,76,135,172,307,17,10,27,2,3:09
381324,2014-05-28,2014,MIL,BAL,8,3,8-3,MIL,9,true,37,39,76,148,152,300,14,14,28,3,3:29
381334,2014-05-28,2014,ARI,SDN,12,6,12-6,ARI,9,true,45,42,87,163,171,334,21,14,35,3,3:29
381328,2014-05-28,2014,PHI,COL,6,3,6-3,PHI,9,false,40,45,85,172,160,332,14,19,33,3,3:46
381343,2014-05-29,2014,PHI,NYN,1,4,4-1,NYN,9,false,31,39,70,136,137,273,4,12,16,4,2:55
381345,2014-05-29,2014,SLN,SFN,5,6,6-5,SFN,9,false,38,36,74,123,146,269,13,11,24,2,3:08
381346,2014-05-29,2014,MIN,TEX,4,5,5-4,TEX,9,false,41,41,82,159,168,327,15,14,29,4,3:34
381340,2014-05-29,2014,ARI,CIN,4,0,4-0,ARI,9,true,36,27,63,94,147,241,14,3,17,1,2:30
381337,2014-05-29,2014,SEA,ANA,5,7,7-5,ANA,9,false,34,46,80,161,140,301,7,20,27,3,3:08
381339,2014-05-29,2014,HOU,BAL,3,1,3-1,HOU,9,true,36,34,70,122,148,270,10,7,17,0,2:56
381341,2014-05-29,2014,OAK,DET,4,5,5-4,DET,9,false,45,39,84,142,178,320,19,13,32,1,3:28
381344,2014-05-29,2014,LAN,PIT,3,6,6-3,PIT,9,false,35,40,75,143,117,260,9,16,25,2,2:58
381338,2014-05-29,2014,BOS,ATL,4,3,4-3,BOS,9,false,38,37,75,120,155,275,16,10,26,2,3:00
381342,2014-05-29,2014,TOR,KCA,6,8,8-6,KCA,10,false,37,49,86,188,146,334,9,19,28,2,3:26
381349,2014-05-30,2014,HOU,BAL,2,1,2-1,HOU,9,true,30,32,62,109,113,222,8,6,14,3,2:40
381353,2014-05-30,2014,SEA,DET,3,6,6-3,DET,9,false,35,36,71,132,151,283,9,12,21,1,3:05
381352,2014-05-30,2014,CLE,COL,5,2,5-2,CLE,9,true,35,32,67,126,141,267,12,6,18,2,3:07
381360,2014-05-30,2014,BOS,TBA,3,2,3-2,BOS,10,false,42,37,79,159,149,308,13,9,22,2,3:55
381358,2014-05-30,2014,CHA,SDN,1,4,4-1,SDN,9,false,33,39,72,150,140,290,8,13,21,0,2:51
381350,2014-05-30,2014,MIL,CHN,11,5,11-5,MIL,9,true,39,42,81,169,134,303,17,16,33,1,3:15
381359,2014-05-30,2014,SLN,SFN,4,9,9-4,SFN,9,false,35,42,77,171,150,321,9,15,24,3,3:14
381354,2014-05-30,2014,TOR,KCA,1,6,6-1,KCA,9,false,42,38,80,135,182,317,15,11,26,1,3:01
381356,2014-05-30,2014,PHI,NYN,6,5,6-5,PHI,14,false,62,59,121,225,239,464,25,20,45,4,5:23
381351,2014-05-30,2014,ARI,CIN,4,6,6-4,CIN,9,false,36,36,72,128,128,256,8,12,20,0,2:40
381361,2014-05-30,2014,WAS,TEX,9,2,9-2,WAS,9,true,40,36,76,119,130,249,18,9,27,1,2:45
381357,2014-05-30,2014,LAN,PIT,1,2,2-1,PIT,9,false,36,35,71,174,139,313,9,11,20,1,3:25
381355,2014-05-30,2014,NYA,MIN,1,6,6-1,MIN,9,false,37,39,76,150,155,305,13,12,25,1,3:04
381347,2014-05-30,2014,OAK,ANA,9,5,9-5,OAK,9,true,42,38,80,156,146,302,18,11,29,3,3:04
381348,2014-05-30,2014,MIA,ATL,2,3,3-2,ATL,9,false,32,37,69,133,127,260,6,14,20,2,2:53
381364,2014-05-31,2014,HOU,BAL,1,4,4-1,BAL,9,false,34,38,72,129,132,261,9,12,21,1,2:45
381366,2014-05-31,2014,ARI,CIN,0,5,5-0,CIN,9,false,35,38,73,136,135,271,9,14,23,3,2:57
381367,2014-05-31,2014,CLE,COL,7,6,7-6,CLE,9,true,37,36,73,147,129,276,14,10,24,3,3:05
381365,2014-05-31,2014,MIL,CHN,0,8,8-0,CHN,9,false,31,38,69,155,132,287,6,12,18,1,3:00
381370,2014-05-31,2014,NYA,MIN,3,1,3-1,NYA,9,true,36,34,70,133,145,278,16,7,23,1,3:04 (:34 delay)
381362,2014-05-31,2014,OAK,ANA,11,3,11-3,OAK,9,true,41,37,78,110,157,267,19,12,31,3,3:13
381373,2014-05-31,2014,CHA,SDN,2,4,4-2,SDN,9,false,36,40,76,162,137,299,9,18,27,2,3:16
381376,2014-05-31,2014,WAS,TEX,10,2,10-2,WAS,9,true,38,32,70,146,155,301,15,6,21,0,2:47
381372,2014-05-31,2014,LAN,PIT,12,2,12-2,LAN,9,true,42,38,80,148,146,294,17,11,28,1,3:07
381374,2014-05-31,2014,SLN,SFN,2,0,2-0,SLN,9,true,31,31,62,132,113,245,9,4,13,0,2:29 (1:38 delay)
381368,2014-05-31,2014,SEA,DET,3,2,3-2,SEA,9,true,32,37,69,162,156,318,9,10,19,3,3:18
381371,2014-05-31,2014,PHI,NYN,4,5,5-4,NYN,14,false,57,58,115,253,227,480,16,20,36,3,5:32
381375,2014-05-31,2014,BOS,TBA,7,1,7-1,BOS,9,true,38,33,71,143,141,284,15,7,22,1,3:07
381369,2014-05-31,2014,TOR,KCA,12,2,12-2,TOR,9,true,44,38,82,133,176,309,21,11,32,1,2:53
381363,2014-05-31,2014,MIA,ATL,5,9,9-5,ATL,9,false,40,48,88,168,152,320,16,22,38,5,3:28
381385,2014-06-01,2014,NYA,MIN,2,7,7-2,MIN,9,false,31,41,72,161,109,270,5,15,20,2,2:58
381384,2014-06-01,2014,TOR,KCA,4,0,4-0,TOR,9,true,34,34,68,110,119,229,12,7,19,0,2:14
381388,2014-06-01,2014,CHA,SDN,4,1,4-1,CHA,9,true,31,28,59,100,128,228,8,2,10,0,2:08
381382,2014-06-01,2014,CLE,COL,6,4,6-4,CLE,9,false,37,37,74,154,133,287,12,9,21,2,3:11
381380,2014-06-01,2014,MIL,CHN,9,0,9-0,MIL,9,true,35,31,66,93,121,214,13,4,17,0,2:18
381391,2014-06-01,2014,WAS,TEX,0,2,2-0,TEX,9,false,34,38,72,155,112,267,7,15,22,1,3:06
381377,2014-06-01,2014,OAK,ANA,6,3,6-3,OAK,9,true,37,37,74,155,123,278,16,11,27,1,2:58
381381,2014-06-01,2014,ARI,CIN,3,4,4-3,CIN,9,false,36,38,74,151,134,285,10,11,21,2,2:59
381383,2014-06-01,2014,SEA,DET,4,0,4-0,SEA,9,true,34,31,65,111,145,256,11,5,16,2,2:46
381378,2014-06-01,2014,MIA,ATL,2,4,4-2,ATL,9,false,37,36,73,125,131,256,13,10,23,1,2:39
381389,2014-06-01,2014,SLN,SFN,0,8,8-0,SFN,9,false,34,47,81,175,135,310,7,20,27,1,3:04
381379,2014-06-01,2014,HOU,BAL,4,9,9-4,BAL,9,false,38,41,79,150,160,310,11,16,27,2,3:14
381387,2014-06-01,2014,LAN,PIT,3,5,5-3,PIT,9,false,37,37,74,148,137,285,10,11,21,0,3:22
381386,2014-06-01,2014,PHI,NYN,3,4,4-3,NYN,11,false,41,46,87,186,131,317,10,17,27,1,3:29
381390,2014-06-01,2014,BOS,TBA,4,0,4-0,BOS,9,true,38,35,73,141,170,311,15,8,23,1,3:12
381394,2014-06-02,2014,SLN,KCA,0,6,6-0,KCA,9,false,31,37,68,118,131,249,5,11,16,2,2:41
381395,2014-06-02,2014,MIL,MIN,6,2,6-2,MIL,9,true,33,38,71,164,106,270,10,14,24,4,3:02
381397,2014-06-02,2014,MIA,TBA,3,1,3-1,MIA,9,true,29,33,62,119,118,237,7,7,14,1,2:33
381392,2014-06-02,2014,CLE,BOS,3,2,3-2,CLE,9,true,31,34,65,135,96,231,10,9,19,1,2:21
380952,2014-06-02,2014,NYA,SEA,2,10,10-2,SEA,9,false,34,42,76,139,136,275,9,15,24,1,2:54
380952,2014-06-02,2014,NYA,SEA,2,10,10-2,SEA,9,false,34,42,76,139,136,275,9,15,24,1,2:54
380948,2014-06-02,2014,PHI,NYN,2,11,11-2,NYN,9,false,35,44,79,187,135,322,10,19,29,4,3:17
380948,2014-06-02,2014,PHI,NYN,2,11,11-2,NYN,9,false,35,44,79,187,135,322,10,19,29,4,3:17
381393,2014-06-02,2014,LAN,CHA,5,2,5-2,LAN,9,true,35,32,67,114,135,249,9,5,14,0,2:41
381396,2014-06-02,2014,SDN,PIT,3,10,10-3,PIT,9,false,41,53,94,249,156,405,13,26,39,4,4:04
381411,2014-06-03,2014,MIA,TBA,1,0,1-0,MIA,9,true,29,30,59,88,106,194,7,8,15,0,2:10
381407,2014-06-03,2014,WAS,PHI,7,0,7-0,WAS,9,true,38,35,73,124,144,268,14,8,22,0,2:42
381399,2014-06-03,2014,COL,ARI,2,4,4-2,ARI,9,false,35,38,73,136,135,271,10,13,23,0,3:03
381401,2014-06-03,2014,CLE,BOS,5,3,5-3,CLE,9,true,35,41,76,152,138,290,12,16,28,5,3:09
381402,2014-06-03,2014,LAN,CHA,1,4,4-1,CHA,9,false,40,34,74,125,165,290,13,9,22,2,3:05
381400,2014-06-03,2014,TEX,BAL,3,8,8-3,BAL,9,false,38,46,84,164,151,315,12,21,33,5,3:15
381398,2014-06-03,2014,HOU,ANA,7,2,7-2,HOU,9,true,39,37,76,147,176,323,18,8,26,3,3:31
381403,2014-06-03,2014,SLN,KCA,7,8,8-7,KCA,9,false,41,41,82,148,145,293,14,17,31,2,3:12
381405,2014-06-03,2014,CHN,NYN,2,1,2-1,CHN,9,false,33,38,71,169,148,317,8,12,20,4,3:19
381409,2014-06-03,2014,ATL,SEA,5,7,7-5,SEA,9,false,39,42,81,147,149,296,14,15,29,1,3:08
381410,2014-06-03,2014,CIN,SFN,8,3,8-3,CIN,9,true,37,34,71,134,139,273,12,7,19,1,2:57
381408,2014-06-03,2014,SDN,PIT,1,4,4-1,PIT,9,false,33,35,68,126,139,265,7,8,15,2,2:43
381406,2014-06-03,2014,NYA,OAK,2,5,5-2,OAK,10,false,40,39,79,171,161,332,10,11,21,4,3:33 (1:12 delay)
381404,2014-06-03,2014,MIL,MIN,4,6,6-4,MIN,9,false,40,36,76,149,174,323,16,10,26,0,3:18
381412,2014-06-03,2014,DET,TOR,3,5,5-3,TOR,9,false,33,34,67,144,140,284,6,7,13,3,2:51
381423,2014-06-04,2014,SDN,PIT,3,2,3-2,SDN,9,true,34,35,69,129,153,282,13,8,21,0,2:49
381413,2014-06-04,2014,HOU,ANA,0,4,4-0,ANA,9,false,33,39,72,155,118,273,6,12,18,1,2:53
381425,2014-06-04,2014,CIN,SFN,2,3,3-2,SFN,9,false,35,37,72,137,131,268,9,11,20,4,3:12
381415,2014-06-04,2014,TEX,BAL,5,6,6-5,BAL,9,false,39,45,84,166,144,310,14,20,34,4,3:33
381418,2014-06-04,2014,TBA,MIA,4,5,5-4,MIA,9,false,40,38,78,140,161,301,16,10,26,1,3:17
381424,2014-06-04,2014,ATL,SEA,0,2,2-0,SEA,9,false,32,39,71,139,122,261,6,13,19,1,2:51
381427,2014-06-04,2014,DET,TOR,2,8,8-2,TOR,9,false,40,40,80,170,143,313,13,16,29,3,3:14
381421,2014-06-04,2014,NYA,OAK,4,7,7-4,OAK,9,false,39,44,83,174,149,323,11,18,29,3,3:22
381420,2014-06-04,2014,CHN,NYN,5,4,5-4,CHN,9,true,38,41,79,167,160,327,16,15,31,6,3:40
381416,2014-06-04,2014,CLE,BOS,7,4,7-4,CLE,12,false,47,48,95,183,181,364,14,12,26,6,4:29 (2:28 delay)
381426,2014-06-04,2014,KCA,SLN,2,5,5-2,SLN,11,false,41,50,91,192,153,345,8,18,26,2,3:46
381419,2014-06-04,2014,MIN,MIL,6,4,6-4,MIN,9,true,39,34,73,115,146,261,15,7,22,1,2:52
381417,2014-06-04,2014,LAN,CHA,1,2,2-1,CHA,9,false,34,37,71,136,131,267,8,12,20,2,3:03
381422,2014-06-04,2014,WAS,PHI,8,4,8-4,WAS,9,true,38,38,76,147,135,282,15,10,25,0,3:00 (1:48 delay)
381414,2014-06-04,2014,COL,ARI,8,16,16-8,ARI,9,false,44,51,95,191,158,349,18,26,44,4,3:58
381432,2014-06-05,2014,MIN,MIL,5,8,8-5,MIL,9,false,39,40,79,157,165,322,14,13,27,3,3:26
381436,2014-06-05,2014,CIN,SFN,1,6,6-1,SFN,9,false,30,41,71,154,118,272,3,15,18,1,2:49
381437,2014-06-05,2014,KCA,SLN,3,2,3-2,KCA,9,true,31,36,67,130,114,244,9,10,19,0,2:26
381429,2014-06-05,2014,COL,ARI,7,12,12-7,ARI,9,false,42,47,89,167,147,314,15,21,36,4,3:36
381433,2014-06-05,2014,CHN,NYN,7,4,7-4,CHN,9,true,37,42,79,163,150,313,14,15,29,2,3:16
381430,2014-06-05,2014,TEX,BAL,8,6,8-6,TEX,9,true,39,37,76,147,153,300,18,11,29,3,3:11
381431,2014-06-05,2014,TBA,MIA,6,11,11-6,MIA,9,false,43,44,87,189,159,348,16,17,33,5,3:45
381434,2014-06-05,2014,NYA,OAK,2,1,2-1,NYA,9,true,31,36,67,157,117,274,8,9,17,0,2:57
381428,2014-06-05,2014,HOU,ANA,8,5,8-5,HOU,9,true,40,39,79,152,169,321,18,11,29,5,3:33
381438,2014-06-05,2014,DET,TOR,3,7,7-3,TOR,9,false,35,39,74,132,134,266,12,14,26,2,2:52
381435,2014-06-05,2014,WAS,PHI,4,2,4-2,WAS,9,true,36,32,68,119,118,237,14,5,19,1,2:38
381442,2014-06-06,2014,TEX,CLE,6,4,6-4,TEX,9,true,32,40,72,145,122,267,10,14,24,3,3:01
381440,2014-06-06,2014,DET,BOS,6,2,6-2,DET,9,true,35,35,70,142,125,267,15,8,23,2,2:49
381448,2014-06-06,2014,SFN,NYN,4,2,4-2,SFN,9,true,34,29,63,115,115,230,11,5,16,0,2:17
381446,2014-06-06,2014,PIT,MIL,15,5,15-5,PIT,9,true,46,39,85,127,172,299,23,14,37,2,3:11
381449,2014-06-06,2014,BAL,OAK,3,4,4-3,OAK,11,false,43,45,88,171,148,319,15,13,28,1,3:36
381451,2014-06-06,2014,TBA,SEA,4,0,4-0,TBA,9,true,43,33,76,146,153,299,21,6,27,0,3:17
381444,2014-06-06,2014,COL,LAN,2,7,7-2,LAN,9,false,40,43,83,136,161,297,13,17,30,1,3:23
381445,2014-06-06,2014,CHN,MIA,5,3,5-3,CHN,13,false,48,51,99,204,170,374,12,14,26,4,4:02
381441,2014-06-06,2014,ANA,CHA,8,4,8-4,ANA,9,true,34,43,77,177,128,305,13,18,31,1,3:10
381452,2014-06-06,2014,TOR,SLN,3,1,3-1,TOR,9,true,39,37,76,132,164,296,16,11,27,4,3:12
381453,2014-06-06,2014,SDN,WAS,0,6,6-0,WAS,9,false,32,38,70,135,116,251,3,10,13,1,2:32
381450,2014-06-06,2014,CIN,PHI,0,8,8-0,PHI,9,false,34,43,77,176,139,315,7,16,23,2,3:18
381439,2014-06-06,2014,ARI,ATL,2,5,5-2,ATL,9,false,34,41,75,146,123,269,7,14,21,4,3:03
381447,2014-06-06,2014,KCA,NYA,2,4,4-2,NYA,9,false,33,37,70,152,125,277,8,13,21,0,2:51
381443,2014-06-06,2014,MIN,HOU,4,5,5-4,HOU,9,false,40,34,74,129,154,283,12,8,20,2,3:00 (1:21 delay)
381466,2014-06-07,2014,TBA,SEA,4,7,7-4,SEA,9,false,34,40,74,135,110,245,7,13,20,3,2:46
381467,2014-06-07,2014,TOR,SLN,0,5,5-0,SLN,9,false,31,43,74,171,105,276,4,19,23,1,2:37
381468,2014-06-07,2014,SDN,WAS,4,3,4-3,SDN,11,false,42,41,83,153,126,279,11,9,20,1,3:12
381456,2014-06-07,2014,ANA,CHA,6,5,6-5,ANA,9,true,35,37,72,150,140,290,11,11,22,2,2:53
381462,2014-06-07,2014,KCA,NYA,8,4,8-4,KCA,9,true,39,37,76,150,141,291,16,11,27,3,3:10
381463,2014-06-07,2014,SFN,NYN,5,4,5-4,SFN,9,false,41,43,84,149,138,287,15,16,31,1,3:33
381455,2014-06-07,2014,DET,BOS,8,6,8-6,DET,9,true,41,43,84,168,152,320,20,17,37,3,3:36
381461,2014-06-07,2014,PIT,MIL,3,9,9-3,MIL,9,false,38,44,82,158,132,290,14,17,31,1,3:23
381465,2014-06-07,2014,CIN,PHI,6,5,6-5,CIN,9,true,35,37,72,134,146,280,12,12,24,1,2:56
381457,2014-06-07,2014,TEX,CLE,3,8,8-3,CLE,9,false,34,42,76,139,111,250,8,16,24,3,2:53
381458,2014-06-07,2014,MIN,HOU,8,0,8-0,MIN,9,true,42,35,77,135,182,317,16,8,24,3,3:24
381464,2014-06-07,2014,BAL,OAK,6,3,6-3,BAL,9,true,36,35,71,141,148,289,12,9,21,2,2:51
381459,2014-06-07,2014,COL,LAN,5,4,5-4,COL,10,false,43,44,87,157,141,298,17,16,33,4,3:35
381454,2014-06-07,2014,ARI,ATL,4,3,4-3,ARI,11,false,47,42,89,148,174,322,16,9,25,3,3:31
381460,2014-06-07,2014,CHN,MIA,5,2,5-2,CHN,9,true,34,33,67,126,154,280,12,6,18,2,2:49
381474,2014-06-08,2014,COL,LAN,1,6,6-1,LAN,6,true,18,26,44,116,73,189,3,10,13,1,2:04 (1:35 delay)
381481,2014-06-08,2014,TBA,SEA,0,5,5-0,SEA,9,false,32,41,73,153,120,273,6,14,20,2,3:10
381472,2014-06-08,2014,TEX,CLE,2,3,3-2,CLE,9,false,35,40,75,145,148,293,10,15,25,3,3:09
381477,2014-06-08,2014,KCA,NYA,2,1,2-1,KCA,9,true,28,37,65,163,95,258,7,10,17,0,2:48
381469,2014-06-08,2014,ARI,ATL,6,5,6-5,ARI,9,true,37,39,76,162,150,312,15,12,27,3,3:07
381478,2014-06-08,2014,SFN,NYN,6,4,6-4,SFN,9,true,36,36,72,154,146,300,14,11,25,5,3:24
381483,2014-06-08,2014,SDN,WAS,0,6,6-0,WAS,9,false,29,42,71,150,114,264,2,16,18,1,2:38
381476,2014-06-08,2014,PIT,MIL,0,1,1-0,MIL,9,false,37,31,68,94,159,253,10,5,15,1,2:57
381475,2014-06-08,2014,CHN,MIA,3,4,4-3,MIA,9,false,40,38,78,159,142,301,14,13,27,3,3:18
381470,2014-06-08,2014,DET,BOS,3,5,5-3,BOS,9,false,34,42,76,186,125,311,8,16,24,2,3:35
381479,2014-06-08,2014,BAL,OAK,1,11,11-1,OAK,9,false,36,46,82,188,140,328,10,21,31,3,3:27
381473,2014-06-08,2014,MIN,HOU,5,14,14-5,HOU,9,false,43,50,93,196,191,387,17,24,41,3,3:45
381471,2014-06-08,2014,ANA,CHA,4,2,4-2,ANA,9,true,39,34,73,138,146,284,17,11,28,2,3:01
381482,2014-06-08,2014,TOR,SLN,0,5,5-0,SLN,9,false,36,38,74,145,141,286,8,12,20,0,2:42
381480,2014-06-08,2014,CIN,PHI,4,1,4-1,CIN,9,true,30,36,66,137,132,269,7,9,16,0,2:40
381493,2014-06-09,2014,ANA,OAK,4,1,4-1,ANA,9,true,38,32,70,136,130,266,15,5,20,2,2:55
381484,2014-06-09,2014,COL,ATL,1,3,3-1,ATL,9,false,35,39,74,133,131,264,8,13,21,1,2:55
381485,2014-06-09,2014,BAL,BOS,4,0,4-0,BAL,9,true,32,32,64,108,110,218,9,6,15,0,2:21
381486,2014-06-09,2014,PIT,CHN,6,2,6-2,PIT,9,true,37,35,72,106,126,232,13,8,21,0,2:33
381489,2014-06-09,2014,ARI,HOU,3,4,4-3,HOU,9,false,36,39,75,136,151,287,10,13,23,3,3:12
381487,2014-06-09,2014,TEX,CLE,7,17,17-7,CLE,9,false,40,47,87,180,159,339,13,21,34,2,3:20
381495,2014-06-09,2014,SFN,WAS,2,9,9-2,WAS,9,false,34,43,77,144,137,281,9,16,25,1,3:01
381488,2014-06-09,2014,CHA,DET,6,5,6-5,CHA,9,true,38,38,76,140,145,285,15,11,26,3,3:13
381491,2014-06-09,2014,TOR,MIN,5,4,5-4,TOR,9,false,38,37,75,149,163,312,16,13,29,3,2:53
381490,2014-06-09,2014,CIN,LAN,2,6,6-2,LAN,9,false,36,42,78,167,146,313,13,17,30,2,3:26
381494,2014-06-09,2014,TBA,SEA,0,3,3-0,SEA,9,false,37,35,72,131,146,277,11,8,19,3,3:11
381501,2014-06-10,2014,ARI,HOU,4,1,4-1,ARI,9,true,34,33,67,118,136,254,12,9,21,0,2:40
381502,2014-06-10,2014,CIN,LAN,1,6,6-1,LAN,9,false,38,42,80,164,163,327,12,16,28,2,3:34 (2:05 delay)
381497,2014-06-10,2014,BAL,BOS,0,1,1-0,BOS,9,false,29,37,66,137,95,232,3,11,14,1,2:32 (1:33 delay)
381508,2014-06-10,2014,PHI,SDN,5,2,5-2,PHI,9,true,33,35,68,125,131,256,9,8,17,2,2:40
381503,2014-06-10,2014,TEX,MIA,5,8,8-5,MIA,9,false,39,48,87,200,145,345,12,20,32,3,3:39
381496,2014-06-10,2014,COL,ATL,10,13,13-10,ATL,9,false,46,46,92,160,182,342,20,21,41,5,3:49
381504,2014-06-10,2014,NYN,MIL,6,2,6-2,NYN,9,true,34,36,70,147,124,271,10,11,21,0,2:45
381510,2014-06-10,2014,SFN,WAS,1,2,2-1,WAS,9,false,37,35,72,129,139,268,12,11,23,0,2:55
381509,2014-06-10,2014,TBA,SLN,0,1,1-0,SLN,9,false,38,33,71,133,128,261,14,5,19,3,2:52
381505,2014-06-10,2014,TOR,MIN,0,4,4-0,MIN,9,false,35,41,76,173,145,318,8,16,24,2,3:07
381499,2014-06-10,2014,KCA,CLE,9,5,9-5,KCA,9,true,39,39,78,140,140,280,15,13,28,5,3:00
381498,2014-06-10,2014,PIT,CHN,3,7,7-3,CHN,9,false,39,38,77,138,145,283,14,14,28,4,3:20
381507,2014-06-10,2014,ANA,OAK,2,1,2-1,ANA,14,false,53,52,105,209,196,405,17,12,29,1,4:39
381506,2014-06-10,2014,SEA,NYA,2,3,3-2,NYA,9,false,36,35,71,125,152,277,10,11,21,2,2:50
381520,2014-06-11,2014,TOR,MIN,2,7,7-2,MIN,9,false,38,42,80,155,134,289,11,17,28,1,2:57
381519,2014-06-11,2014,NYN,MIL,1,3,3-1,MIL,9,false,32,40,72,154,127,281,6,14,20,4,3:09
381517,2014-06-11,2014,CIN,LAN,5,0,5-0,CIN,9,true,35,32,67,177,153,330,12,7,19,2,3:19
381523,2014-06-11,2014,PHI,SDN,3,0,3-0,PHI,9,false,35,33,68,132,136,268,11,7,18,0,2:55
381511,2014-06-11,2014,HOU,ARI,5,1,5-1,HOU,9,true,34,31,65,111,113,224,12,6,18,2,2:22
381514,2014-06-11,2014,PIT,CHN,4,2,4-2,PIT,9,true,38,37,75,139,134,273,17,9,26,0,2:56 (1:38 delay)
381515,2014-06-11,2014,KCA,CLE,4,1,4-1,KCA,9,true,36,36,72,125,153,278,12,9,21,1,2:53
381518,2014-06-11,2014,TEX,MIA,6,0,6-0,TEX,9,true,36,32,68,117,142,259,12,9,21,0,2:37
381522,2014-06-11,2014,ANA,OAK,1,7,7-1,OAK,9,false,37,40,77,166,131,297,12,13,25,4,3:19
381516,2014-06-11,2014,CHA,DET,8,2,8-2,CHA,9,true,42,39,81,129,170,299,20,13,33,2,3:17
381524,2014-06-11,2014,TBA,SLN,6,3,6-3,TBA,9,true,36,41,77,162,134,296,12,14,26,4,3:10
381512,2014-06-11,2014,COL,ATL,8,2,8-2,COL,9,true,37,34,71,102,128,230,15,7,22,2,2:40
381513,2014-06-11,2014,BAL,BOS,6,0,6-0,BAL,9,true,38,29,67,121,148,269,15,5,20,1,2:49 (1:38 delay)
381525,2014-06-11,2014,SFN,WAS,2,6,6-2,WAS,9,false,34,41,75,175,131,306,8,14,22,2,3:19
381521,2014-06-11,2014,SEA,NYA,2,4,4-2,NYA,9,false,32,39,71,154,110,264,7,13,20,0,2:44
381526,2014-06-12,2014,HOU,ARI,5,4,5-4,HOU,10,false,42,40,82,144,170,314,18,9,27,4,3:27
381535,2014-06-12,2014,BAL,TOR,4,2,4-2,BAL,9,true,36,36,72,146,148,294,12,11,23,2,2:59
381527,2014-06-12,2014,COL,ATL,10,3,10-3,COL,9,true,39,35,74,125,129,254,18,9,27,4,2:39
381534,2014-06-12,2014,PHI,SDN,7,3,7-3,PHI,9,true,37,35,72,149,141,290,13,8,21,2,3:05
381528,2014-06-12,2014,PIT,CHN,4,0,4-0,PIT,9,true,34,35,69,124,120,244,14,9,23,2,2:46 (1:35 delay)
381529,2014-06-12,2014,BOS,CLE,5,2,5-2,BOS,9,true,36,35,71,127,152,279,15,9,24,3,3:08
381532,2014-06-12,2014,NYN,MIL,1,5,5-1,MIL,13,false,50,56,106,188,179,367,12,18,30,3,4:08 (:03 delay)
381533,2014-06-12,2014,SEA,NYA,3,6,6-3,NYA,9,false,36,41,77,151,113,264,9,14,23,3,2:56
381531,2014-06-12,2014,CIN,LAN,4,1,4-1,CIN,9,true,32,36,68,125,112,237,10,10,20,0,2:43
381536,2014-06-12,2014,SFN,WAS,7,1,7-1,SFN,9,true,39,35,74,134,141,275,17,10,27,0,2:59
381530,2014-06-12,2014,CHA,DET,0,4,4-0,DET,9,false,34,36,70,160,113,273,6,10,16,0,2:52
381550,2014-06-13,2014,BAL,TOR,0,4,4-0,TOR,9,false,36,35,71,138,136,274,10,10,20,2,2:44 (:21 delay)
381537,2014-06-13,2014,ATL,ANA,4,3,4-3,ATL,9,true,35,36,71,148,126,274,11,10,21,0,2:59
381547,2014-06-13,2014,NYN,SDN,6,2,6-2,NYN,9,true,36,35,71,157,133,290,13,8,21,3,3:01 (1:56 delay)
381545,2014-06-13,2014,OAK,NYA,0,7,7-0,NYA,9,false,31,42,73,172,135,307,5,17,22,1,3:05
381538,2014-06-13,2014,LAN,ARI,4,3,4-3,LAN,9,true,39,42,81,151,160,311,17,15,32,1,3:32
381546,2014-06-13,2014,MIA,PIT,6,8,8-6,PIT,13,false,55,57,112,216,200,416,18,20,38,3,4:26
381544,2014-06-13,2014,DET,MIN,0,2,2-0,MIN,9,false,35,37,72,149,137,286,8,10,18,1,3:00
381541,2014-06-13,2014,BOS,CLE,10,3,10-3,BOS,9,true,40,36,76,139,171,310,19,8,27,6,3:13
381549,2014-06-13,2014,SEA,TEX,0,1,1-0,TEX,9,false,30,32,62,121,104,225,4,6,10,2,2:30
381542,2014-06-13,2014,SFN,COL,4,7,7-4,COL,9,false,38,37,75,161,146,307,13,13,26,3,3:36
381543,2014-06-13,2014,CHA,KCA,2,7,7-2,KCA,9,false,40,43,83,179,155,334,13,16,29,1,3:22
381548,2014-06-13,2014,HOU,TBA,1,6,6-1,TBA,9,false,35,40,75,151,156,307,8,15,23,2,3:30
381551,2014-06-13,2014,SLN,WAS,1,0,1-0,SLN,9,true,26,29,55,129,76,205,4,2,6,0,2:03
381539,2014-06-13,2014,PHI,CHN,1,2,2-1,CHN,9,false,34,32,66,122,140,262,7,7,14,1,2:51
381540,2014-06-13,2014,MIL,CIN,5,6,6-5,CIN,9,false,39,40,79,136,151,287,14,11,25,2,3:23
381555,2014-06-14,2014,MIL,CIN,4,2,4-2,MIL,9,true,31,33,64,139,114,253,7,9,16,1,2:55
381561,2014-06-14,2014,MIA,PIT,6,8,8-6,PIT,9,false,38,46,84,159,151,310,14,22,36,1,3:09
381553,2014-06-14,2014,LAN,ARI,6,4,6-4,LAN,9,true,33,36,69,126,118,244,12,9,21,1,2:39
381565,2014-06-14,2014,BAL,TOR,3,2,3-2,BAL,9,true,34,38,72,145,111,256,9,14,23,4,3:02
381564,2014-06-14,2014,SEA,TEX,3,4,4-3,TEX,9,false,38,38,76,165,148,313,11,13,24,1,3:34
381562,2014-06-14,2014,NYN,SDN,0,5,5-0,SDN,9,false,34,41,75,184,139,323,7,16,23,0,3:13
381552,2014-06-14,2014,ATL,ANA,6,11,11-6,ANA,13,false,59,58,117,209,243,452,24,22,46,4,4:57
381566,2014-06-14,2014,SLN,WAS,4,1,4-1,SLN,9,true,35,34,69,131,121,252,13,9,22,3,2:44
381563,2014-06-14,2014,HOU,TBA,7,3,7-3,HOU,9,true,37,37,74,132,170,302,13,11,24,2,3:39
381559,2014-06-14,2014,DET,MIN,12,9,12-9,DET,9,true,46,44,90,197,173,370,23,17,40,6,3:48
381556,2014-06-14,2014,BOS,CLE,2,3,3-2,CLE,9,false,36,43,79,157,155,312,12,16,28,5,3:24
381560,2014-06-14,2014,OAK,NYA,5,1,5-1,OAK,9,true,36,33,69,132,143,275,12,6,18,1,2:45 (:38 delay)
381558,2014-06-14,2014,CHA,KCA,1,9,9-1,KCA,9,false,36,43,79,169,121,290,9,17,26,2,3:03
381557,2014-06-14,2014,SFN,COL,4,5,5-4,COL,9,false,37,39,76,164,132,296,10,14,24,2,3:23
381554,2014-06-14,2014,PHI,CHN,7,4,7-4,PHI,9,true,37,36,73,148,140,288,13,11,24,1,3:04
381569,2014-06-15,2014,PHI,CHN,0,3,3-0,CHN,9,false,33,35,68,115,123,238,6,8,14,0,2:35
381567,2014-06-15,2014,ATL,ANA,7,3,7-3,ATL,9,true,38,41,79,176,147,323,16,14,30,3,3:31
381573,2014-06-15,2014,CHA,KCA,3,6,6-3,KCA,9,false,43,39,82,144,162,306,16,15,31,2,3:10
381574,2014-06-15,2014,DET,MIN,4,3,4-3,DET,9,false,41,39,80,144,157,301,16,11,27,2,3:19
381576,2014-06-15,2014,MIA,PIT,3,2,3-2,MIA,10,false,40,43,83,168,155,323,11,16,27,0,3:22
381571,2014-06-15,2014,BOS,CLE,2,3,3-2,CLE,11,false,43,46,89,182,186,368,13,12,25,3,4:03
381575,2014-06-15,2014,OAK,NYA,10,5,10-5,OAK,9,true,40,40,80,156,163,319,16,14,30,2,3:06
381568,2014-06-15,2014,LAN,ARI,3,6,6-3,ARI,9,false,39,37,76,131,154,285,14,10,24,2,3:04
381579,2014-06-15,2014,SEA,TEX,5,1,5-1,SEA,9,true,37,32,69,119,125,244,15,6,21,1,2:46
381577,2014-06-15,2014,NYN,SDN,3,1,3-1,NYN,9,true,38,35,73,139,168,307,14,10,24,2,3:15
381572,2014-06-15,2014,SFN,COL,7,8,8-7,COL,9,false,46,40,86,154,167,321,20,16,36,4,3:43
381581,2014-06-15,2014,SLN,WAS,5,2,5-2,SLN,9,true,35,39,74,148,127,275,12,12,24,1,2:40
381578,2014-06-15,2014,HOU,TBA,3,4,4-3,TBA,9,false,33,43,76,169,131,300,6,17,23,4,3:41
381570,2014-06-15,2014,MIL,CIN,4,13,13-4,CIN,9,false,39,48,87,202,121,323,15,20,35,2,3:19
381580,2014-06-15,2014,BAL,TOR,2,5,5-2,TOR,9,false,36,41,77,129,141,270,10,14,24,3,3:07
381588,2014-06-16,2014,BOS,MIN,1,0,1-0,BOS,9,true,32,32,64,141,135,276,9,7,16,1,2:45
381589,2014-06-16,2014,SLN,NYN,6,2,6-2,SLN,9,true,36,36,72,145,134,279,14,11,25,3,2:52
381587,2014-06-16,2014,ARI,MIL,3,9,9-3,MIL,9,false,36,39,75,140,135,275,12,16,28,1,3:00
381584,2014-06-16,2014,MIA,CHN,4,5,5-4,CHN,13,false,55,53,108,199,209,408,17,15,32,4,4:39
381590,2014-06-16,2014,ATL,PHI,1,6,6-1,PHI,13,false,52,55,107,217,206,423,17,18,35,2,4:47
381582,2014-06-16,2014,CLE,ANA,4,3,4-3,CLE,9,true,32,40,72,152,126,278,9,14,23,1,2:59
381586,2014-06-16,2014,DET,KCA,8,11,11-8,KCA,9,false,42,48,90,156,157,313,17,22,39,2,3:26
381592,2014-06-16,2014,OAK,TEX,8,14,14-8,TEX,9,false,47,47,94,161,182,343,22,18,40,6,3:41
381585,2014-06-16,2014,LAN,COL,6,1,6-1,LAN,9,true,41,32,73,141,144,285,18,5,23,1,3:11
381583,2014-06-16,2014,TBA,BAL,5,4,5-4,TBA,9,true,36,38,74,162,137,299,12,11,23,4,3:21
381591,2014-06-16,2014,SEA,SDN,5,1,5-1,SEA,9,true,38,33,71,138,138,276,15,8,23,2,2:44
381602,2014-06-17,2014,SLN,NYN,5,2,5-2,SLN,9,true,38,36,74,124,117,241,13,9,22,1,2:36
381601,2014-06-17,2014,BOS,MIN,2,1,2-1,BOS,9,true,31,33,64,149,105,254,8,6,14,2,2:48
381600,2014-06-17,2014,ARI,MIL,5,7,7-5,MIL,9,false,40,39,79,133,135,268,12,12,24,2,2:52
381605,2014-06-17,2014,CHA,SFN,8,2,8-2,CHA,9,true,35,38,73,131,125,256,11,11,22,1,2:42
381603,2014-06-17,2014,ATL,PHI,2,5,5-2,PHI,9,false,33,43,76,176,114,290,7,18,25,1,3:05
381595,2014-06-17,2014,MIA,CHN,6,5,6-5,MIA,9,true,38,39,77,154,152,306,14,13,27,2,3:11
381606,2014-06-17,2014,OAK,TEX,10,6,10-6,OAK,9,true,41,37,78,132,158,290,19,9,28,6,3:28
381599,2014-06-17,2014,DET,KCA,4,11,11-4,KCA,9,false,36,45,81,179,136,315,13,20,33,1,3:14
381596,2014-06-17,2014,PIT,CIN,5,6,6-5,CIN,9,false,45,41,86,169,192,361,20,15,35,3,3:54
381604,2014-06-17,2014,SEA,SDN,6,1,6-1,SEA,9,true,37,31,68,117,165,282,13,5,18,0,2:42
381593,2014-06-17,2014,CLE,ANA,3,9,9-3,ANA,9,false,34,43,77,177,121,298,8,17,25,2,3:08 (:11 delay)
381598,2014-06-17,2014,WAS,HOU,6,5,6-5,WAS,9,true,39,43,82,159,161,320,15,17,32,4,3:41
381594,2014-06-17,2014,TBA,BAL,5,7,7-5,BAL,9,false,40,40,80,168,152,320,14,15,29,3,3:31
381597,2014-06-17,2014,LAN,COL,4,2,4-2,LAN,9,true,34,42,76,184,131,315,11,16,27,1,3:33
381607,2014-06-17,2014,NYA,TOR,3,1,3-1,NYA,9,true,34,36,70,151,168,319,10,9,19,1,3:07
381617,2014-06-18,2014,SLN,NYN,2,3,3-2,NYN,9,false,32,36,68,129,107,236,8,12,20,2,2:38
381612,2014-06-18,2014,LAN,COL,8,0,8-0,LAN,9,true,37,28,65,107,150,257,15,0,15,1,2:58
381622,2014-06-18,2014,NYA,TOR,7,3,7-3,NYA,9,true,39,37,76,172,140,312,14,10,24,2,3:02
381613,2014-06-18,2014,WAS,HOU,6,5,6-5,WAS,9,true,39,39,78,178,143,321,17,15,32,3,3:42
381618,2014-06-18,2014,ATL,PHI,5,10,10-5,PHI,9,false,40,49,89,177,154,331,17,22,39,0,3:32
381616,2014-06-18,2014,BOS,MIN,2,1,2-1,BOS,10,false,32,34,66,118,136,254,4,5,9,1,2:31
381610,2014-06-18,2014,MIA,CHN,1,6,6-1,CHN,9,false,34,40,74,133,139,272,7,13,20,1,2:54
381620,2014-06-18,2014,CHA,SFN,7,6,7-6,CHA,9,true,36,44,80,173,118,291,13,18,31,4,3:12 (:12 delay)
381621,2014-06-18,2014,OAK,TEX,4,2,4-2,OAK,9,true,36,35,71,118,141,259,14,8,22,0,2:50
381614,2014-06-18,2014,DET,KCA,1,2,2-1,KCA,9,false,33,34,67,133,140,273,6,9,15,2,2:53
381619,2014-06-18,2014,SDN,SEA,2,1,2-1,SDN,9,true,30,36,66,114,125,239,6,11,17,1,2:40
381609,2014-06-18,2014,TBA,BAL,0,2,2-0,BAL,9,false,32,40,72,139,145,284,6,12,18,1,3:09
381615,2014-06-18,2014,ARI,MIL,4,3,4-3,ARI,9,false,35,35,70,124,115,239,9,9,18,2,2:39
381611,2014-06-18,2014,PIT,CIN,4,11,11-4,CIN,9,false,40,48,88,178,150,328,14,21,35,3,3:25 (1:15 delay)
381626,2014-06-19,2014,MIN,CHA,4,2,4-2,MIN,9,true,34,33,67,120,137,257,12,7,19,0,2:43 (2:06 delay)
381631,2014-06-19,2014,SLN,PHI,1,4,4-1,PHI,9,false,32,37,69,128,126,254,6,11,17,3,2:48
381625,2014-06-19,2014,OAK,BOS,4,2,4-2,OAK,9,true,33,32,65,134,143,277,12,5,17,1,2:39
381629,2014-06-19,2014,ARI,MIL,1,4,4-1,MIL,9,false,33,34,67,127,135,262,7,11,18,2,2:56
380581,2014-06-19,2014,DET,KCA,2,1,2-1,DET,9,true,28,33,61,131,109,240,5,7,12,0,2:27
380581,2014-06-19,2014,DET,KCA,2,1,2-1,DET,9,true,28,33,61,131,109,240,5,7,12,0,2:27
381633,2014-06-19,2014,NYA,TOR,6,4,6-4,NYA,9,true,41,37,78,157,167,324,18,11,29,5,3:47
381624,2014-06-19,2014,WAS,ATL,0,3,3-0,ATL,9,false,31,40,71,140,109,249,5,13,18,1,2:56
381623,2014-06-19,2014,CLE,ANA,5,3,5-3,CLE,10,false,42,40,82,185,172,357,13,13,26,4,3:36
381630,2014-06-19,2014,MIA,NYN,0,1,1-0,NYN,9,false,28,34,62,144,111,255,4,11,15,0,2:35
381628,2014-06-19,2014,TBA,HOU,5,0,5-0,TBA,9,true,37,33,70,139,128,267,12,6,18,1,3:06
381632,2014-06-19,2014,SDN,SEA,4,1,4-1,SDN,9,true,33,36,69,120,107,227,9,10,19,1,2:42
381627,2014-06-19,2014,PIT,CIN,4,3,4-3,PIT,12,false,53,45,98,167,202,369,20,10,30,3,4:16 (:35 delay)
381639,2014-06-20,2014,TBA,HOU,1,3,3-1,HOU,9,false,35,38,73,140,126,266,9,12,21,0,2:59
381644,2014-06-20,2014,CHN,PIT,6,3,6-3,CHN,9,true,37,37,74,159,137,296,13,12,25,1,3:03
381638,2014-06-20,2014,CLE,DET,4,6,6-4,DET,9,false,37,38,75,150,166,316,12,15,27,3,3:22
381643,2014-06-20,2014,SLN,PHI,1,5,5-1,PHI,9,false,35,40,75,155,111,266,10,13,23,1,2:48 (:50 delay)
381646,2014-06-20,2014,ARI,SFN,4,1,4-1,ARI,9,true,30,35,65,159,115,274,8,9,17,1,2:52
381647,2014-06-20,2014,ANA,TEX,7,3,7-3,ANA,9,true,37,39,76,182,143,325,14,13,27,2,3:23
381640,2014-06-20,2014,SDN,LAN,6,5,6-5,SDN,9,false,38,37,75,157,148,305,12,11,23,2,3:12
381645,2014-06-20,2014,KCA,SEA,5,7,7-5,SEA,9,false,41,41,82,155,148,303,17,16,33,4,3:31
381635,2014-06-20,2014,NYA,BAL,5,3,5-3,NYA,9,false,42,40,82,168,162,330,18,12,30,4,3:38
381641,2014-06-20,2014,COL,MIL,10,13,13-10,MIL,9,false,44,49,93,188,167,355,17,22,39,2,3:59
381636,2014-06-20,2014,OAK,BOS,4,3,4-3,OAK,9,true,38,38,76,158,151,309,13,13,26,3,3:21
381634,2014-06-20,2014,WAS,ATL,4,6,6-4,ATL,13,false,53,53,106,208,210,418,16,15,31,0,4:34
381648,2014-06-20,2014,CIN,TOR,9,14,14-9,TOR,9,false,40,50,90,207,151,358,12,25,37,4,4:00
381637,2014-06-20,2014,MIN,CHA,5,4,5-4,MIN,9,false,38,39,77,164,145,309,12,15,27,4,3:16
381642,2014-06-20,2014,MIA,NYN,3,2,3-2,MIA,9,true,33,36,69,151,130,281,11,13,24,3,3:19
381658,2014-06-21,2014,SLN,PHI,4,1,4-1,SLN,9,true,34,35,69,124,131,255,11,8,19,1,2:48
381660,2014-06-21,2014,KCA,SEA,1,2,2-1,SEA,9,false,29,35,64,120,124,244,5,10,15,1,2:42
381650,2014-06-21,2014,NYA,BAL,1,6,6-1,BAL,9,false,36,41,77,155,139,294,10,13,23,2,2:57
381659,2014-06-21,2014,CHN,PIT,3,5,5-3,PIT,9,false,33,36,69,153,111,264,6,10,16,2,2:54 (2:01 delay)
381654,2014-06-21,2014,TBA,HOU,8,0,8-0,TBA,9,true,42,30,72,134,156,290,18,3,21,2,3:05
381655,2014-06-21,2014,SDN,LAN,2,4,4-2,LAN,9,false,37,37,74,135,143,278,11,11,22,1,3:07
381656,2014-06-21,2014,COL,MIL,4,9,9-4,MIL,9,false,37,41,78,131,126,257,10,15,25,2,2:58 (:23 delay)
381652,2014-06-21,2014,MIN,CHA,4,3,4-3,MIN,9,true,35,41,76,169,128,297,12,13,25,2,3:07
381653,2014-06-21,2014,CLE,DET,4,5,5-4,DET,10,false,42,41,83,151,162,313,12,14,26,3,3:41
381661,2014-06-21,2014,ARI,SFN,4,6,6-4,SFN,9,false,39,43,82,146,152,298,13,16,29,1,3:15
381649,2014-06-21,2014,WAS,ATL,3,0,3-0,WAS,9,true,33,34,67,131,115,246,9,7,16,0,2:44
381663,2014-06-21,2014,CIN,TOR,11,1,11-1,CIN,9,true,39,33,72,122,147,269,15,6,21,0,2:35
381657,2014-06-21,2014,MIA,NYN,0,4,4-0,NYN,9,false,35,35,70,121,125,246,10,10,20,0,2:38
381662,2014-06-21,2014,ANA,TEX,3,2,3-2,ANA,10,false,32,37,69,140,128,268,6,8,14,2,3:00
381651,2014-06-21,2014,OAK,BOS,2,1,2-1,OAK,10,false,37,39,76,146,146,292,9,11,20,2,3:04
381676,2014-06-22,2014,ARI,SFN,1,4,4-1,SFN,9,false,31,35,66,120,123,243,5,10,15,4,2:39
381675,2014-06-22,2014,KCA,SEA,1,2,2-1,SEA,9,false,36,35,71,122,121,243,10,9,19,3,2:54
381667,2014-06-22,2014,MIN,CHA,6,5,6-5,MIN,9,true,36,35,71,131,137,268,15,9,24,2,2:55
381674,2014-06-22,2014,CHN,PIT,1,2,2-1,PIT,9,false,34,35,69,142,119,261,8,9,17,1,2:50
381672,2014-06-22,2014,MIA,NYN,5,11,11-5,NYN,9,false,37,46,83,169,133,302,11,20,31,2,3:09
381669,2014-06-22,2014,TBA,HOU,5,2,5-2,TBA,9,true,35,37,72,165,111,276,16,11,27,1,2:51
381671,2014-06-22,2014,COL,MIL,5,6,6-5,MIL,9,false,44,40,84,155,146,301,20,14,34,2,3:38
381677,2014-06-22,2014,ANA,TEX,5,2,5-2,ANA,9,true,35,34,69,132,136,268,11,11,22,1,2:54
381678,2014-06-22,2014,CIN,TOR,4,3,4-3,CIN,9,true,35,37,72,138,120,258,12,9,21,1,2:42
381670,2014-06-22,2014,SDN,LAN,1,2,2-1,LAN,9,false,33,35,68,133,133,266,6,11,17,1,2:45
381666,2014-06-22,2014,OAK,BOS,6,7,7-6,BOS,10,false,41,43,84,166,147,313,12,14,26,2,3:22
381665,2014-06-22,2014,NYA,BAL,0,8,8-0,BAL,9,false,35,41,76,155,143,298,9,16,25,0,3:03
381664,2014-06-22,2014,WAS,ATL,4,1,4-1,WAS,9,true,32,35,67,135,125,260,10,7,17,3,2:54
381673,2014-06-22,2014,SLN,PHI,5,3,5-3,SLN,9,true,36,36,72,147,133,280,14,8,22,2,2:54
381668,2014-06-22,2014,CLE,DET,4,10,10-4,DET,9,false,40,46,86,189,150,339,13,16,29,4,3:44
381680,2014-06-23,2014,BAL,CHA,6,4,6-4,BAL,9,false,41,37,78,144,161,305,18,11,29,1,3:08
381690,2014-06-23,2014,MIL,WAS,0,3,3-0,WAS,9,false,33,36,69,146,159,305,7,10,17,0,3:11
381679,2014-06-23,2014,SEA,BOS,12,3,12-3,SEA,9,true,42,35,77,127,166,293,19,8,27,2,2:57
381686,2014-06-23,2014,TOR,NYA,8,3,8-3,TOR,9,true,41,34,75,131,168,299,18,8,26,2,2:45
381684,2014-06-23,2014,PHI,MIA,0,4,4-0,MIA,9,false,32,40,72,161,133,294,8,14,22,4,3:14
381681,2014-06-23,2014,CHN,CIN,1,6,6-1,CIN,9,false,33,41,74,184,135,319,6,15,21,1,3:21
381689,2014-06-23,2014,COL,SLN,0,8,8-0,SLN,9,false,30,39,69,140,122,262,3,13,16,1,2:41
381688,2014-06-23,2014,SFN,SDN,0,6,6-0,SDN,9,false,30,35,65,125,109,234,4,9,13,2,2:34
381683,2014-06-23,2014,KCA,LAN,5,3,5-3,KCA,9,true,34,34,68,112,133,245,11,8,19,2,2:46
381687,2014-06-23,2014,TBA,PIT,1,8,8-1,PIT,9,false,32,42,74,174,127,301,8,16,24,1,3:22
381697,2014-06-24,2014,KCA,LAN,0,2,2-0,LAN,9,false,33,36,69,157,120,277,7,11,18,1,3:02
381703,2014-06-24,2014,SFN,SDN,2,7,7-2,SDN,9,false,33,40,73,119,137,256,6,15,21,2,2:56
381698,2014-06-24,2014,PHI,MIA,7,4,7-4,PHI,9,true,36,40,76,175,150,325,11,14,25,2,3:15
381700,2014-06-24,2014,TOR,NYA,7,6,7-6,TOR,9,false,38,40,78,141,158,299,14,12,26,2,3:05
381691,2014-06-24,2014,HOU,ATL,2,3,3-2,ATL,9,false,39,34,73,141,161,302,12,7,19,1,3:06
381692,2014-06-24,2014,SEA,BOS,8,2,8-2,SEA,9,true,37,41,78,161,129,290,12,14,26,4,3:14
381693,2014-06-24,2014,BAL,CHA,2,4,4-2,CHA,9,false,36,39,75,126,149,275,13,15,28,1,3:09
381696,2014-06-24,2014,TEX,DET,2,8,8-2,DET,9,false,38,42,80,165,162,327,11,19,30,4,3:32
381699,2014-06-24,2014,ANA,MIN,8,6,8-6,ANA,9,true,37,39,76,157,136,293,14,13,27,1,2:59
381701,2014-06-24,2014,NYN,OAK,10,1,10-1,NYN,9,true,37,32,69,123,125,248,14,5,19,0,2:24
381695,2014-06-24,2014,ARI,CLE,9,8,9-8,ARI,14,false,68,62,130,235,278,513,32,21,53,6,5:32
381702,2014-06-24,2014,TBA,PIT,5,6,6-5,PIT,9,false,40,36,76,121,145,266,15,10,25,2,3:03
381704,2014-06-24,2014,COL,SLN,10,5,10-5,COL,9,true,47,39,86,133,179,312,25,13,38,4,3:55
381705,2014-06-24,2014,MIL,WAS,2,4,4-2,WAS,16,false,61,61,122,254,231,485,19,13,32,0,5:22
381694,2014-06-24,2014,CHN,CIN,7,3,7-3,CHN,9,true,34,33,67,124,138,262,11,6,17,4,3:00 (:53 delay)
381717,2014-06-25,2014,TBA,PIT,5,1,5-1,TBA,9,true,35,32,67,133,139,272,10,6,16,2,2:51
381713,2014-06-25,2014,PHI,MIA,2,3,3-2,MIA,9,false,37,35,72,139,127,266,11,9,20,1,2:53
381714,2014-06-25,2014,ANA,MIN,6,2,6-2,ANA,9,true,36,37,73,138,146,284,12,10,22,1,2:55
381712,2014-06-25,2014,KCA,LAN,4,5,5-4,LAN,9,false,37,39,76,141,162,303,12,14,26,2,3:23
381711,2014-06-25,2014,TEX,DET,6,8,8-6,DET,9,false,42,41,83,150,172,322,13,17,30,4,3:38
381718,2014-06-25,2014,SFN,SDN,4,0,4-0,SFN,9,true,38,28,66,113,161,274,15,1,16,3,2:37
381706,2014-06-25,2014,HOU,ATL,0,4,4-0,ATL,9,false,31,34,65,130,109,239,4,9,13,1,2:33
381716,2014-06-25,2014,NYN,OAK,5,8,8-5,OAK,9,false,37,40,77,133,138,271,12,15,27,1,2:55
381720,2014-06-25,2014,MIL,WAS,9,2,9-2,MIL,9,true,40,33,73,146,142,288,18,6,24,2,3:01
381715,2014-06-25,2014,TOR,NYA,3,5,5-3,NYA,9,false,37,40,77,143,138,281,12,15,27,4,3:02
381719,2014-06-25,2014,COL,SLN,6,9,9-6,SLN,9,false,40,43,83,184,155,339,13,16,29,1,3:38
381710,2014-06-25,2014,ARI,CLE,1,6,6-1,CLE,9,false,32,41,73,138,158,296,8,14,22,1,3:00
381709,2014-06-25,2014,CHN,CIN,1,4,4-1,CIN,9,false,33,37,70,148,137,285,6,13,19,1,3:10
381708,2014-06-25,2014,BAL,CHA,5,4,5-4,BAL,12,false,46,50,96,185,163,348,16,17,33,6,4:03 (1:09 delay)
381707,2014-06-25,2014,SEA,BOS,4,5,5-4,BOS,9,false,34,37,71,139,106,245,9,12,21,2,2:40
381728,2014-06-26,2014,LAN,SLN,1,0,1-0,LAN,9,true,29,31,60,130,100,230,6,7,13,0,2:32
381729,2014-06-26,2014,CHN,WAS,5,3,5-3,CHN,9,true,32,35,67,125,140,265,10,13,23,1,2:41
381725,2014-06-26,2014,TEX,DET,0,6,6-0,DET,9,false,30,44,74,153,115,268,6,19,25,1,2:58
381722,2014-06-26,2014,TOR,CHA,7,0,7-0,TOR,9,true,39,33,72,137,156,293,14,6,20,2,3:00
381685,2014-06-26,2014,ANA,MIN,6,4,6-4,ANA,9,true,36,40,76,165,137,302,15,14,29,3,3:17
381724,2014-06-26,2014,MIL,COL,7,4,7-4,MIL,9,true,39,39,78,154,160,314,16,14,30,2,3:50
381726,2014-06-26,2014,PHI,MIA,5,3,5-3,PHI,14,false,57,53,110,207,227,434,18,15,33,1,4:41
381721,2014-06-26,2014,HOU,ATL,6,1,6-1,HOU,9,true,35,33,68,131,130,261,11,9,20,2,2:52
381723,2014-06-26,2014,SFN,CIN,1,3,3-1,CIN,9,false,33,36,69,141,119,260,6,10,16,0,2:46
381727,2014-06-26,2014,PIT,NYN,5,2,5-2,PIT,9,true,35,36,71,129,124,253,15,12,27,1,2:53
381730,2014-06-27,2014,KCA,ANA,8,6,8-6,KCA,9,true,40,37,77,142,133,275,16,10,26,2,3:02
381734,2014-06-27,2014,TOR,CHA,4,5,5-4,CHA,9,false,38,37,75,147,175,322,10,11,21,3,2:58 (:04 delay)
381732,2014-06-27,2014,PHI,ATL,2,4,4-2,ATL,9,false,35,39,74,140,150,290,9,12,21,0,3:11
381741,2014-06-27,2014,MIA,OAK,5,9,9-5,OAK,9,false,40,45,85,149,159,308,15,19,34,2,3:14
381731,2014-06-27,2014,SDN,ARI,1,2,2-1,ARI,9,false,32,34,66,138,113,251,6,10,16,1,2:34
381740,2014-06-27,2014,PIT,NYN,3,2,3-2,PIT,11,false,45,42,87,150,154,304,15,11,26,2,3:45
380746,2014-06-27,2014,BAL,TBA,2,5,5-2,TBA,9,false,33,38,71,147,153,300,7,14,21,2,3:14
380746,2014-06-27,2014,BAL,TBA,2,5,5-2,TBA,9,false,33,38,71,147,153,300,7,14,21,2,3:14
381733,2014-06-27,2014,NYA,BOS,6,0,6-0,NYA,9,true,35,33,68,138,130,268,11,6,17,1,2:42
381736,2014-06-27,2014,SEA,CLE,3,2,3-2,SEA,9,true,35,38,73,155,134,289,13,11,24,4,3:05
381735,2014-06-27,2014,SFN,CIN,2,6,6-2,CIN,9,false,32,39,71,140,115,255,6,14,20,1,2:44
381738,2014-06-27,2014,HOU,DET,4,3,4-3,HOU,11,false,41,41,82,150,176,326,12,11,23,2,4:05
381743,2014-06-27,2014,BAL,TBA,4,1,4-1,BAL,9,true,38,32,70,118,152,270,15,6,21,0,3:05
381742,2014-06-27,2014,LAN,SLN,1,3,3-1,SLN,9,false,34,36,70,128,144,272,12,10,22,3,2:48
381744,2014-06-27,2014,CHN,WAS,7,2,7-2,CHN,9,true,39,33,72,132,145,277,17,8,25,2,2:49
381737,2014-06-27,2014,MIL,COL,3,2,3-2,MIL,9,false,38,35,73,134,133,267,14,11,25,2,3:09
381739,2014-06-27,2014,TEX,MIN,5,4,5-4,TEX,9,true,33,38,71,148,134,282,10,10,20,2,2:59
381758,2014-06-28,2014,BAL,TBA,4,5,5-4,TBA,9,false,34,40,74,170,127,297,8,13,21,3,3:13
381745,2014-06-28,2014,KCA,ANA,2,6,6-2,ANA,9,false,35,40,75,144,138,282,8,14,22,0,2:48 (4:05 delay)
381751,2014-06-28,2014,SEA,CLE,0,5,5-0,CLE,9,false,28,34,62,137,111,248,1,9,10,0,2:24
380734,2014-06-28,2014,PHI,ATL,1,5,5-1,ATL,9,false,36,40,76,146,143,289,8,15,23,1,3:09
381748,2014-06-28,2014,NYA,BOS,1,2,2-1,BOS,9,false,34,33,67,116,129,245,8,8,16,0,2:47
380734,2014-06-28,2014,PHI,ATL,1,5,5-1,ATL,9,false,36,40,76,146,143,289,8,15,23,1,3:09
381754,2014-06-28,2014,TEX,MIN,5,0,5-0,TEX,9,true,34,32,66,122,102,224,13,5,18,1,2:27
381752,2014-06-28,2014,MIL,COL,7,4,7-4,MIL,9,true,36,35,71,143,117,260,14,11,25,2,3:11
381746,2014-06-28,2014,SDN,ARI,1,3,3-1,ARI,9,false,37,37,74,143,147,290,10,11,21,3,3:07
381753,2014-06-28,2014,HOU,DET,3,4,4-3,DET,9,false,35,39,74,134,149,283,9,12,21,1,3:15
381757,2014-06-28,2014,LAN,SLN,9,1,9-1,LAN,9,true,40,34,74,146,142,288,17,7,24,0,3:02
381759,2014-06-28,2014,CHN,WAS,0,3,3-0,WAS,9,false,31,36,67,135,137,272,5,12,17,2,2:42
381755,2014-06-28,2014,PIT,NYN,3,5,5-3,NYN,9,false,37,40,77,176,118,294,10,14,24,0,3:08
381774,2014-06-28,2014,CHN,WAS,2,7,7-2,WAS,9,false,34,41,75,139,130,269,7,14,21,0,2:45 (:55 delay)
381749,2014-06-28,2014,TOR,CHA,3,4,4-3,CHA,9,false,39,36,75,143,149,292,13,11,24,4,2:58
381747,2014-06-28,2014,PHI,ATL,3,10,10-3,ATL,9,false,37,43,80,163,122,285,10,15,25,2,3:08
381750,2014-06-28,2014,SFN,CIN,3,7,7-3,CIN,11,false,43,47,90,183,153,336,12,19,31,2,3:59
381756,2014-06-28,2014,MIA,OAK,6,7,7-6,OAK,14,false,62,61,123,223,209,432,22,24,46,2,4:47
381769,2014-06-29,2014,TEX,MIN,2,3,3-2,MIN,9,false,32,34,66,135,105,240,8,8,16,2,2:39
381765,2014-06-29,2014,SFN,CIN,0,4,4-0,CIN,9,false,30,36,66,129,107,236,4,9,13,2,2:38
381767,2014-06-29,2014,MIL,COL,4,10,10-4,COL,9,false,34,45,79,157,150,307,8,17,25,1,3:33
381771,2014-06-29,2014,MIA,OAK,3,4,4-3,OAK,9,false,34,33,67,116,127,243,8,8,16,2,2:48
381761,2014-06-29,2014,SDN,ARI,2,1,2-1,SDN,9,true,32,33,65,133,120,253,9,9,18,2,2:45
381764,2014-06-29,2014,TOR,CHA,0,4,4-0,CHA,9,false,32,36,68,130,141,271,6,11,17,0,2:32
381772,2014-06-29,2014,LAN,SLN,6,0,6-0,LAN,9,true,37,36,73,138,121,259,14,8,22,0,2:46
381762,2014-06-29,2014,PHI,ATL,2,3,3-2,ATL,9,false,39,38,77,160,129,289,15,12,27,0,3:06
381768,2014-06-29,2014,HOU,DET,6,4,6-4,HOU,9,true,40,37,77,154,153,307,21,12,33,3,3:25
381760,2014-06-29,2014,KCA,ANA,5,4,5-4,KCA,9,false,42,37,79,142,162,304,19,12,31,2,3:31
381763,2014-06-29,2014,NYA,BOS,5,8,8-5,BOS,9,false,37,42,79,197,157,354,11,20,31,3,3:38
381766,2014-06-29,2014,SEA,CLE,3,0,3-0,SEA,9,true,33,30,63,117,108,225,10,4,14,1,2:17
381773,2014-06-29,2014,BAL,TBA,7,12,12-7,TBA,9,false,41,48,89,162,172,334,15,24,39,4,3:51
381770,2014-06-29,2014,PIT,NYN,5,2,5-2,PIT,9,true,33,40,73,159,114,273,9,15,24,1,2:58
381777,2014-06-30,2014,SDN,CIN,1,0,1-0,SDN,9,true,27,32,59,147,107,254,3,8,11,0,2:42
381782,2014-06-30,2014,DET,OAK,5,4,5-4,DET,9,false,37,39,76,146,149,295,13,12,25,3,3:23
381779,2014-06-30,2014,WAS,COL,7,3,7-3,WAS,9,true,36,36,72,121,136,257,14,11,25,1,2:58
381776,2014-06-30,2014,BOS,CHN,0,2,2-0,CHN,9,false,29,35,64,155,138,293,3,9,12,1,2:59
381783,2014-06-30,2014,HOU,SEA,4,10,10-4,SEA,9,false,36,43,79,168,130,298,11,17,28,0,3:07
381780,2014-06-30,2014,MIN,KCA,1,6,6-1,KCA,9,false,39,39,78,153,161,314,12,13,25,4,3:13
381781,2014-06-30,2014,ATL,NYN,5,3,5-3,ATL,9,true,40,35,75,146,158,304,15,9,24,3,3:25
381785,2014-06-30,2014,BAL,TEX,7,1,7-1,BAL,9,true,39,33,72,131,164,295,14,6,20,0,2:53
381784,2014-06-30,2014,NYA,TBA,3,4,4-3,TBA,12,false,47,53,100,212,179,391,12,19,31,2,4:35
381778,2014-06-30,2014,LAN,CLE,1,0,1-0,LAN,9,true,31,29,60,130,124,254,8,2,10,1,2:34
381787,2014-07-01,2014,PIT,ARI,3,2,3-2,PIT,9,false,31,38,69,128,122,250,8,12,20,1,2:33
381793,2014-07-01,2014,TOR,MIL,4,1,4-1,TOR,9,true,32,35,67,138,129,267,10,9,19,2,2:56
381798,2014-07-01,2014,SFN,SLN,5,0,5-0,SFN,9,true,35,35,70,124,123,247,15,8,23,1,2:28
381795,2014-07-01,2014,DET,OAK,3,0,3-0,DET,9,true,31,31,62,95,116,211,9,4,13,1,2:13
381791,2014-07-01,2014,WAS,COL,7,1,7-1,WAS,9,true,42,34,76,134,172,306,17,8,25,3,3:19
381786,2014-07-01,2014,CHA,ANA,4,8,8-4,ANA,9,false,34,42,76,174,133,307,8,15,23,2,2:54
381797,2014-07-01,2014,HOU,SEA,2,13,13-2,SEA,9,false,41,51,92,188,144,332,13,24,37,1,3:36
381775,2014-07-01,2014,CHA,ANA,5,7,7-5,ANA,9,false,38,41,79,137,138,275,12,21,33,3,3:08
381775,2014-07-01,2014,CHA,ANA,5,7,7-5,ANA,9,false,38,41,79,137,138,275,12,21,33,3,3:08
381790,2014-07-01,2014,LAN,CLE,3,10,10-3,CLE,9,false,40,41,81,147,171,318,16,15,31,3,3:21
381794,2014-07-01,2014,ATL,NYN,5,4,5-4,ATL,9,true,35,38,73,178,130,308,11,11,22,1,3:17
381792,2014-07-01,2014,MIN,KCA,10,2,10-2,MIN,9,true,46,36,82,141,193,334,20,11,31,1,3:23
381796,2014-07-01,2014,MIA,PHI,5,4,5-4,MIA,11,false,47,43,90,138,190,328,17,10,27,1,3:37
381799,2014-07-01,2014,NYA,TBA,1,2,2-1,TBA,9,false,36,37,73,124,150,274,9,10,19,0,3:13
381800,2014-07-01,2014,BAL,TEX,8,3,8-3,BAL,9,true,37,35,72,125,150,275,11,11,22,1,2:58
381789,2014-07-01,2014,SDN,CIN,8,2,8-2,SDN,9,true,40,39,79,142,123,265,18,13,31,2,2:49
381788,2014-07-01,2014,BOS,CHN,1,2,2-1,CHN,9,false,38,34,72,147,152,299,14,9,23,2,3:35
381811,2014-07-02,2014,MIA,PHI,5,0,5-0,MIA,9,true,37,34,71,134,163,297,14,7,21,1,3:11
381804,2014-07-02,2014,SDN,CIN,3,0,3-0,SDN,9,true,33,30,63,120,122,242,10,3,13,0,2:20
381807,2014-07-02,2014,MIN,KCA,0,4,4-0,KCA,9,false,33,41,74,163,145,308,7,14,21,0,3:00
381801,2014-07-02,2014,CHA,ANA,3,2,3-2,CHA,9,false,35,35,70,141,113,254,11,9,20,2,2:49
381806,2014-07-02,2014,WAS,COL,4,3,4-3,WAS,9,true,30,36,66,122,119,241,8,10,18,1,2:42 (:30 delay)
381813,2014-07-02,2014,SFN,SLN,0,2,2-0,SLN,9,false,32,34,66,123,130,253,7,9,16,2,2:51
381808,2014-07-02,2014,TOR,MIL,7,4,7-4,TOR,9,false,41,34,75,121,156,277,19,7,26,2,3:01
381814,2014-07-02,2014,NYA,TBA,3,6,6-3,TBA,9,false,39,42,81,166,155,321,12,19,31,4,3:32
381805,2014-07-02,2014,LAN,CLE,4,5,5-4,CLE,9,false,40,40,80,152,172,324,13,13,26,3,3:30
381812,2014-07-02,2014,HOU,SEA,2,5,5-2,SEA,9,false,31,39,70,151,129,280,4,13,17,2,2:47
381815,2014-07-02,2014,BAL,TEX,6,4,6-4,BAL,9,true,36,39,75,143,139,282,14,13,27,2,3:14 (1:38 delay)
381809,2014-07-02,2014,ATL,NYN,3,1,3-1,ATL,9,true,35,34,69,138,153,291,11,8,19,1,3:11
381810,2014-07-02,2014,DET,OAK,9,3,9-3,DET,9,true,39,38,77,134,152,286,18,12,30,2,3:02
381802,2014-07-02,2014,PIT,ARI,5,1,5-1,PIT,9,true,40,38,78,139,158,297,18,12,30,1,3:14
381803,2014-07-02,2014,BOS,CHN,9,16,16-9,CHN,9,false,50,48,98,192,197,389,22,22,44,5,4:19
381818,2014-07-03,2014,COL,LAN,2,3,3-2,LAN,9,false,36,36,72,139,115,254,12,9,21,0,3:02
381819,2014-07-03,2014,MIN,NYA,4,7,7-4,NYA,9,false,34,36,70,127,124,251,10,11,21,1,2:36
381824,2014-07-03,2014,OAK,TOR,4,1,4-1,OAK,9,true,32,32,64,123,126,249,9,8,17,0,2:23
381822,2014-07-03,2014,DET,TBA,8,1,8-1,DET,9,true,39,30,69,119,145,264,17,3,20,1,2:41
381821,2014-07-03,2014,SFN,SLN,2,7,7-2,SLN,9,false,36,44,80,175,139,314,9,19,28,0,3:12
381820,2014-07-03,2014,MIA,PHI,4,5,5-4,PHI,9,false,37,40,77,175,124,299,11,12,23,1,3:12
381823,2014-07-03,2014,BAL,TEX,5,2,5-2,BAL,9,true,38,36,74,130,144,274,17,10,27,3,3:12 (:56 delay)
381816,2014-07-03,2014,PIT,ARI,2,10,10-2,ARI,9,false,37,42,79,153,152,305,14,16,30,2,3:16
381817,2014-07-03,2014,ANA,HOU,5,2,5-2,ANA,9,true,33,37,70,145,124,269,12,12,24,1,3:00
381837,2014-07-04,2014,DET,TBA,3,6,6-3,TBA,9,false,35,41,76,157,138,295,10,14,24,2,3:18
381836,2014-07-04,2014,SDN,SFN,2,0,2-0,SDN,9,true,32,32,64,121,126,247,11,6,17,1,2:31
381835,2014-07-04,2014,CHA,SEA,7,1,7-1,CHA,9,true,35,32,67,112,131,243,11,6,17,0,2:28
381828,2014-07-04,2014,ANA,HOU,7,6,7-6,ANA,9,false,38,37,75,129,140,269,17,10,27,5,3:02
381825,2014-07-04,2014,ATL,ARI,5,2,5-2,ATL,9,true,36,34,70,132,133,265,13,8,21,3,2:54
381832,2014-07-04,2014,CIN,MIL,4,2,4-2,CIN,9,true,35,35,70,118,149,267,11,9,20,1,2:49
381829,2014-07-04,2014,CLE,KCA,1,7,7-1,KCA,9,false,34,40,74,150,124,274,8,13,21,2,2:50
381827,2014-07-04,2014,WAS,CHN,2,7,7-2,CHN,9,false,35,41,76,139,131,270,9,17,26,3,2:54
381831,2014-07-04,2014,SLN,MIA,3,2,3-2,SLN,9,true,31,40,71,169,137,306,9,15,24,1,3:01
381830,2014-07-04,2014,COL,LAN,0,9,9-0,LAN,9,false,30,49,79,196,107,303,4,23,27,1,3:13
381834,2014-07-04,2014,PIT,PHI,8,2,8-2,PIT,9,true,41,33,74,137,158,295,19,7,26,2,3:13
381833,2014-07-04,2014,MIN,NYA,5,6,6-5,NYA,9,false,39,39,78,146,170,316,13,12,25,2,3:17
381838,2014-07-04,2014,NYN,TEX,6,5,6-5,NYN,9,true,37,44,81,177,164,341,14,18,32,3,4:08
381839,2014-07-04,2014,OAK,TOR,1,0,1-0,OAK,12,false,45,46,91,171,197,368,13,12,25,1,4:05
381849,2014-07-05,2014,PIT,PHI,3,2,3-2,PIT,9,true,32,35,67,129,108,237,9,9,18,1,2:40
381847,2014-07-05,2014,CIN,MIL,0,1,1-0,MIL,9,false,30,35,65,132,111,243,4,11,15,0,2:47
381841,2014-07-05,2014,BOS,BAL,4,7,7-4,BAL,9,false,37,45,82,175,150,325,12,18,30,5,3:36
381842,2014-07-05,2014,WAS,CHN,13,0,13-0,WAS,9,true,46,31,77,116,187,303,22,6,28,3,3:10
381844,2014-07-05,2014,CLE,KCA,7,3,7-3,CLE,9,true,40,38,78,131,146,277,17,14,31,2,2:48
381854,2014-07-05,2014,OAK,TOR,5,1,5-1,OAK,9,true,37,33,70,136,136,272,13,7,20,1,2:37
381845,2014-07-05,2014,COL,LAN,8,7,8-7,COL,9,true,35,41,76,166,137,303,13,16,29,3,3:25
381840,2014-07-05,2014,ATL,ARI,10,4,10-4,ATL,9,true,44,35,79,123,174,297,19,12,31,1,3:00
381853,2014-07-05,2014,NYN,TEX,3,5,5-3,TEX,9,false,38,38,76,135,151,286,11,13,24,2,3:10
381843,2014-07-05,2014,ANA,HOU,11,5,11-5,ANA,9,true,43,39,82,150,190,340,19,13,32,2,3:36
381851,2014-07-05,2014,SDN,SFN,3,5,5-3,SFN,10,false,38,42,80,179,160,339,10,13,23,2,3:44
381848,2014-07-05,2014,MIN,NYA,2,1,2-1,MIN,11,false,43,42,85,180,170,350,13,9,22,0,3:41
381850,2014-07-05,2014,CHA,SEA,2,3,3-2,SEA,14,false,50,56,106,230,190,420,7,16,23,3,4:38
381826,2014-07-05,2014,BOS,BAL,3,2,3-2,BOS,9,false,36,33,69,130,119,249,12,5,17,0,2:40
381826,2014-07-05,2014,BOS,BAL,3,2,3-2,BOS,9,false,36,33,69,130,119,249,12,5,17,0,2:40
381852,2014-07-05,2014,DET,TBA,2,7,7-2,TBA,9,false,36,41,77,152,116,268,10,17,27,3,3:05
381846,2014-07-05,2014,SLN,MIA,5,6,6-5,MIA,9,false,41,42,83,174,149,323,15,15,30,4,3:31
381859,2014-07-06,2014,CLE,KCA,4,1,4-1,CLE,9,true,34,32,66,113,125,238,11,5,16,1,2:32
381869,2014-07-06,2014,OAK,TOR,4,2,4-2,OAK,9,true,38,32,70,130,142,272,14,6,20,1,2:46
381866,2014-07-06,2014,SDN,SFN,3,5,5-3,SFN,9,false,35,36,71,125,144,269,9,9,18,3,2:58
381855,2014-07-06,2014,ATL,ARI,1,3,3-1,ARI,9,false,36,34,70,135,133,268,10,9,19,2,2:43
381862,2014-07-06,2014,CIN,MIL,4,2,4-2,CIN,9,true,33,31,64,105,116,221,11,5,16,0,2:38
381858,2014-07-06,2014,ANA,HOU,6,1,6-1,ANA,9,true,34,34,68,132,145,277,13,8,21,3,3:07
381864,2014-07-06,2014,PIT,PHI,6,2,6-2,PIT,9,true,37,31,68,112,137,249,13,5,18,1,2:43
381860,2014-07-06,2014,COL,LAN,2,8,8-2,LAN,9,false,38,44,82,166,164,330,12,19,31,3,3:44
381863,2014-07-06,2014,MIN,NYA,7,9,9-7,NYA,9,false,42,41,83,138,166,304,17,16,33,1,3:11
381857,2014-07-06,2014,WAS,CHN,2,1,2-1,WAS,9,true,32,40,72,162,122,284,12,13,25,1,3:12
381867,2014-07-06,2014,DET,TBA,3,7,7-3,TBA,9,false,36,45,81,161,112,273,10,20,30,3,3:12
381868,2014-07-06,2014,NYN,TEX,8,4,8-4,NYN,9,true,36,39,75,159,134,293,13,12,25,4,3:21
381861,2014-07-06,2014,SLN,MIA,4,8,8-4,MIA,9,false,39,49,88,191,145,336,13,24,37,3,3:13
381856,2014-07-06,2014,BOS,BAL,6,7,7-6,BAL,12,false,50,54,104,213,234,447,18,20,38,6,5:05
381865,2014-07-06,2014,CHA,SEA,1,0,1-0,CHA,9,true,34,36,70,118,136,254,11,8,19,1,2:50
381876,2014-07-07,2014,ARI,MIA,9,1,9-1,ARI,9,true,39,38,77,145,138,283,14,12,26,2,2:56
381882,2014-07-07,2014,OAK,SFN,5,0,5-0,OAK,9,true,38,34,72,142,138,280,13,8,21,3,3:10
381877,2014-07-07,2014,SEA,MIN,2,0,2-0,SEA,9,true,32,32,64,131,112,243,8,4,12,0,2:34
381872,2014-07-07,2014,BOS,CHA,0,4,4-0,CHA,9,false,32,32,64,136,138,274,5,7,12,1,2:55 (:39 delay)
381880,2014-07-07,2014,SLN,PIT,2,0,2-0,SLN,9,false,30,39,69,151,98,249,7,13,20,0,2:37 (:58 delay)
381875,2014-07-07,2014,TBA,KCA,0,6,6-0,KCA,9,false,32,43,75,152,129,281,6,16,22,0,2:51
381878,2014-07-07,2014,CLE,NYA,3,5,5-3,NYA,9,false,33,41,74,150,116,266,7,17,24,2,3:00
381881,2014-07-07,2014,COL,SDN,1,6,6-1,SDN,9,false,33,40,73,146,129,275,9,16,25,1,2:47 (:56 delay)
381883,2014-07-07,2014,ANA,TOR,5,2,5-2,ANA,9,true,39,33,72,138,164,302,14,6,20,4,3:16
381873,2014-07-07,2014,CIN,CHN,9,3,9-3,CIN,9,true,39,39,78,145,150,295,15,12,27,0,3:19 (:21 delay)
381874,2014-07-07,2014,TEX,HOU,7,12,12-7,HOU,9,false,41,45,86,173,163,336,14,19,33,4,3:48
381871,2014-07-07,2014,WAS,BAL,2,8,8-2,BAL,11,false,43,48,91,179,163,342,11,15,26,1,3:39
381870,2014-07-07,2014,NYN,ATL,4,3,4-3,NYN,11,false,44,47,91,161,171,332,14,17,31,4,3:50
381879,2014-07-07,2014,MIL,PHI,2,3,3-2,PHI,9,false,35,38,73,167,135,302,10,11,21,1,3:25
381892,2014-07-08,2014,SEA,MIN,0,2,2-0,MIN,9,false,33,35,68,132,103,235,8,11,19,2,2:34
381891,2014-07-08,2014,ARI,MIA,1,2,2-1,MIA,9,false,39,33,72,121,122,243,11,7,18,2,2:33
381898,2014-07-08,2014,ANA,TOR,0,4,4-0,TOR,9,false,32,38,70,132,120,252,6,15,21,1,2:45
381897,2014-07-08,2014,OAK,SFN,6,1,6-1,OAK,9,true,36,37,73,124,110,234,14,10,24,1,2:47
381896,2014-07-08,2014,COL,SDN,2,1,2-1,COL,9,true,32,37,69,151,134,285,8,11,19,2,3:11
381895,2014-07-08,2014,SLN,PIT,5,4,5-4,SLN,9,false,35,38,73,136,125,261,12,12,24,1,2:44
381894,2014-07-08,2014,MIL,PHI,7,9,9-7,PHI,9,false,42,40,82,159,143,302,15,13,28,3,3:24
381884,2014-07-08,2014,NYN,ATL,8,3,8-3,NYN,9,true,42,40,82,166,143,309,20,14,34,3,3:20
380919,2014-07-08,2014,CIN,CHN,4,2,4-2,CIN,9,true,35,38,73,143,144,287,13,11,24,3,2:51
381893,2014-07-08,2014,CLE,NYA,5,3,5-3,CLE,9,true,35,34,69,143,122,265,11,6,17,1,2:55
380919,2014-07-08,2014,CIN,CHN,4,2,4-2,CIN,9,true,35,38,73,143,144,287,13,11,24,3,2:51
381889,2014-07-08,2014,TBA,KCA,4,3,4-3,TBA,9,true,36,41,77,165,144,309,11,15,26,3,3:31
381886,2014-07-08,2014,BOS,CHA,3,8,8-3,CHA,9,false,39,41,80,156,144,300,14,17,31,2,3:11
381890,2014-07-08,2014,DET,LAN,14,5,14-5,DET,9,true,46,36,82,142,174,316,25,10,35,3,3:29
381887,2014-07-08,2014,CIN,CHN,6,5,6-5,CIN,9,false,37,44,81,168,155,323,16,17,33,2,3:33 (:35 delay)
381888,2014-07-08,2014,TEX,HOU,3,8,8-3,HOU,9,false,38,43,81,147,169,316,12,17,29,7,3:33
381904,2014-07-09,2014,DET,LAN,4,1,4-1,DET,9,true,33,32,65,131,132,263,10,6,16,0,2:48
381899,2014-07-09,2014,NYN,ATL,4,1,4-1,NYN,9,true,29,34,63,116,101,217,8,9,17,1,2:23
381902,2014-07-09,2014,TEX,HOU,4,8,8-4,HOU,9,false,39,39,78,152,141,293,12,14,26,1,3:05
381911,2014-07-09,2014,COL,SDN,6,3,6-3,COL,9,true,32,40,72,168,108,276,8,14,22,1,3:09
381909,2014-07-09,2014,MIL,PHI,1,4,4-1,PHI,9,false,32,34,66,120,93,213,5,7,12,0,2:15
381912,2014-07-09,2014,ANA,TOR,8,7,8-7,ANA,9,true,37,46,83,187,145,332,14,19,33,7,3:47
381900,2014-07-09,2014,BOS,CHA,5,4,5-4,BOS,9,false,37,35,72,133,138,271,12,10,22,2,2:54
381903,2014-07-09,2014,TBA,KCA,4,5,5-4,KCA,9,false,42,43,85,150,176,326,16,15,31,4,3:35
381901,2014-07-09,2014,CIN,CHN,4,1,4-1,CIN,9,true,33,34,67,162,125,287,11,7,18,1,2:52
381908,2014-07-09,2014,SFN,OAK,5,2,5-2,SFN,9,true,37,34,71,143,157,300,13,7,20,0,3:02
381910,2014-07-09,2014,SLN,PIT,5,2,5-2,SLN,9,true,41,35,76,142,153,295,19,9,28,2,3:24
381905,2014-07-09,2014,ARI,MIA,4,3,4-3,ARI,10,false,39,39,78,147,137,284,13,12,25,1,2:53
381906,2014-07-09,2014,SEA,MIN,1,8,8-1,MIN,9,false,40,42,82,175,151,326,13,16,29,2,3:11
381907,2014-07-09,2014,CLE,NYA,4,5,5-4,NYA,14,false,57,56,113,207,219,426,16,15,31,5,4:51
381913,2014-07-09,2014,BAL,WAS,2,6,6-2,WAS,9,false,35,37,72,143,137,280,10,10,20,2,2:50
381924,2014-07-10,2014,LAN,SDN,2,1,2-1,LAN,9,true,33,31,64,115,128,243,9,4,13,0,2:31
381919,2014-07-10,2014,SEA,MIN,2,4,4-2,MIN,9,false,39,39,78,139,155,294,14,15,29,3,3:11
381923,2014-07-10,2014,SLN,PIT,1,9,9-1,PIT,9,false,32,43,75,169,114,283,9,15,24,0,3:05
381921,2014-07-10,2014,SFN,OAK,1,6,6-1,OAK,9,false,35,39,74,130,127,257,7,15,22,2,3:01
381925,2014-07-10,2014,BAL,WAS,4,3,4-3,BAL,9,true,32,39,71,133,125,258,9,14,23,2,2:45
381918,2014-07-10,2014,KCA,DET,4,16,16-4,DET,9,false,37,52,89,193,144,337,10,26,36,3,3:17
381916,2014-07-10,2014,BOS,CHA,4,3,4-3,BOS,10,false,35,41,76,152,154,306,8,12,20,2,3:22
381914,2014-07-10,2014,TEX,ANA,6,15,15-6,ANA,9,false,38,45,83,167,138,305,11,18,29,1,3:10
381917,2014-07-10,2014,CIN,CHN,4,6,6-4,CHN,12,false,51,50,101,184,188,372,16,18,34,0,4:10
381915,2014-07-10,2014,NYN,ATL,1,3,3-1,ATL,9,false,37,36,73,114,143,257,10,11,21,1,2:50
381922,2014-07-10,2014,MIL,PHI,1,9,9-1,PHI,9,false,32,41,73,163,127,290,6,15,21,2,3:06
381920,2014-07-10,2014,CLE,NYA,9,3,9-3,CLE,9,true,42,41,83,147,160,307,19,15,34,5,3:30
381927,2014-07-11,2014,SFN,ARI,5,0,5-0,SFN,9,true,37,32,69,134,131,265,13,7,20,1,2:35
381932,2014-07-11,2014,NYN,MIA,7,1,7-1,NYN,9,true,35,34,69,133,125,258,12,8,20,2,2:43
381926,2014-07-11,2014,TEX,ANA,0,3,3-0,ANA,9,false,35,32,67,119,132,251,9,8,17,1,2:41
381933,2014-07-11,2014,COL,MIN,6,2,6-2,COL,9,true,33,37,70,170,100,270,11,13,24,1,2:59
381935,2014-07-11,2014,SEA,OAK,3,2,3-2,SEA,9,true,28,35,63,127,98,225,6,9,15,0,2:22
381928,2014-07-11,2014,CHN,ATL,5,4,5-4,CHN,9,false,38,36,74,116,142,258,12,10,22,2,3:01
381931,2014-07-11,2014,KCA,DET,1,2,2-1,DET,9,false,37,34,71,130,127,257,12,7,19,1,2:58
381940,2014-07-11,2014,PHI,WAS,6,2,6-2,PHI,9,true,34,36,70,126,116,242,11,10,21,3,2:44
381930,2014-07-11,2014,CLE,CHA,7,4,7-4,CLE,9,true,38,37,75,145,134,279,16,11,27,3,3:16
381936,2014-07-11,2014,CIN,PIT,6,5,6-5,CIN,9,true,37,37,74,157,126,283,14,10,24,2,3:11
381929,2014-07-11,2014,HOU,BOS,3,8,8-3,BOS,9,false,40,41,81,167,171,338,13,18,31,1,3:27
381937,2014-07-11,2014,LAN,SDN,3,6,6-3,SDN,9,false,39,40,79,160,153,313,13,14,27,2,3:25
381938,2014-07-11,2014,MIL,SLN,6,7,7-6,SLN,9,false,43,40,83,177,161,338,16,14,30,4,3:53
381939,2014-07-11,2014,TBA,TOR,5,8,8-5,TOR,9,false,41,42,83,184,172,356,15,17,32,4,3:41
381934,2014-07-11,2014,BAL,NYA,3,2,3-2,BAL,10,false,36,39,75,130,136,266,8,9,17,0,3:05
381942,2014-07-12,2014,SFN,ARI,0,2,2-0,ARI,9,false,33,37,70,132,119,251,7,11,18,3,2:44
381945,2014-07-12,2014,CLE,CHA,2,6,6-2,CHA,9,false,36,37,73,125,155,280,9,12,21,4,3:10
381943,2014-07-12,2014,CHN,ATL,6,11,11-6,ATL,9,false,37,42,79,144,126,270,13,17,30,1,3:02
381950,2014-07-12,2014,SEA,OAK,6,2,6-2,SEA,9,true,40,32,72,105,130,235,17,5,22,3,2:43
381952,2014-07-12,2014,LAN,SDN,1,0,1-0,LAN,9,false,34,31,65,107,145,252,11,5,16,1,2:47
381949,2014-07-12,2014,BAL,NYA,0,3,3-0,NYA,9,false,33,38,71,131,125,256,7,14,21,3,3:02
381946,2014-07-12,2014,KCA,DET,1,5,5-1,DET,9,false,34,37,71,164,116,280,9,13,22,1,3:08
381947,2014-07-12,2014,NYN,MIA,5,4,5-4,NYN,9,true,34,38,72,156,125,281,10,11,21,2,2:52
381948,2014-07-12,2014,COL,MIN,3,9,9-3,MIN,9,false,40,45,85,154,136,290,16,17,33,2,3:17
381953,2014-07-12,2014,MIL,SLN,2,10,10-2,SLN,9,false,34,45,79,187,121,308,7,17,24,1,3:17
381954,2014-07-12,2014,TBA,TOR,10,3,10-3,TBA,9,true,43,38,81,144,176,320,20,11,31,3,3:19
381955,2014-07-12,2014,PHI,WAS,3,5,5-3,WAS,10,false,42,42,84,175,182,357,13,11,24,2,4:03
381951,2014-07-12,2014,CIN,PIT,5,6,6-5,PIT,11,false,46,49,95,178,176,354,17,17,34,3,4:06
381941,2014-07-12,2014,TEX,ANA,2,5,5-2,ANA,9,false,36,41,77,148,128,276,8,16,24,1,3:17
381944,2014-07-12,2014,HOU,BOS,3,2,3-2,HOU,9,true,34,38,72,148,124,272,11,15,26,4,3:06
381964,2014-07-13,2014,BAL,NYA,3,1,3-1,BAL,5,false,20,18,38,78,79,157,8,4,12,1,1:39 (2:22 delay)
381967,2014-07-13,2014,LAN,SDN,1,0,1-0,LAN,9,true,32,33,65,137,133,270,9,6,15,3,3:15
381965,2014-07-13,2014,SEA,OAK,1,4,4-1,OAK,9,false,34,36,70,136,125,261,9,9,18,2,2:43
381969,2014-07-13,2014,TBA,TOR,3,0,3-0,TBA,9,true,35,32,67,127,137,264,11,7,18,2,2:45
381961,2014-07-13,2014,KCA,DET,5,2,5-2,KCA,9,true,37,34,71,137,135,272,15,9,24,4,3:02
381957,2014-07-13,2014,SFN,ARI,8,4,8-4,SFN,9,true,40,35,75,132,153,285,15,10,25,3,3:01
381968,2014-07-13,2014,MIL,SLN,11,2,11-2,MIL,9,true,45,34,79,119,131,250,24,6,30,1,2:55
381960,2014-07-13,2014,CLE,CHA,3,2,3-2,CLE,9,true,37,41,78,161,133,294,13,16,29,1,3:00
381959,2014-07-13,2014,HOU,BOS,0,11,11-0,BOS,9,false,30,49,79,199,109,308,3,25,28,4,3:23
381962,2014-07-13,2014,NYN,MIA,9,1,9-1,NYN,9,true,45,32,77,141,174,315,22,8,30,2,3:19
381956,2014-07-13,2014,TEX,ANA,7,10,10-7,ANA,9,false,36,46,82,161,149,310,11,20,31,2,3:38
381963,2014-07-13,2014,COL,MIN,5,13,13-5,MIN,9,false,40,48,88,177,153,330,14,22,36,1,3:23
381958,2014-07-13,2014,CHN,ATL,7,10,10-7,ATL,9,false,39,44,83,169,147,316,14,18,32,4,3:18
381970,2014-07-13,2014,PHI,WAS,3,10,10-3,WAS,9,false,35,40,75,149,141,290,7,14,21,2,3:03
381966,2014-07-13,2014,CIN,PIT,6,3,6-3,CIN,9,true,41,36,77,148,168,316,17,8,25,0,3:08 (:56 delay)
381971,2014-07-15,2014,AAS,NAS,5,3,5-3,AAS,9,true,33,37,70,139,129,268,8,10,18,4,3:13
381986,2014-07-18,2014,TOR,TEX,1,5,5-1,TEX,9,false,37,36,73,142,159,301,10,11,21,2,2:56
381973,2014-07-18,2014,ARI,CHN,5,4,5-4,ARI,9,true,35,35,70,128,151,279,13,9,22,3,3:15
381982,2014-07-18,2014,ATL,PHI,6,4,6-4,ATL,9,true,35,34,69,142,115,257,11,10,21,0,2:45
381981,2014-07-18,2014,SDN,NYN,4,5,5-4,NYN,9,false,35,42,77,169,138,307,9,17,26,1,3:10
381977,2014-07-18,2014,CHA,HOU,3,2,3-2,CHA,9,true,32,32,64,165,122,287,10,5,15,0,2:50
381974,2014-07-18,2014,NYA,CIN,4,3,4-3,NYA,9,true,35,36,71,135,119,254,11,8,19,1,2:36
381980,2014-07-18,2014,WAS,MIL,2,4,4-2,MIL,9,false,36,35,71,132,127,259,11,10,21,1,3:00
381978,2014-07-18,2014,BOS,KCA,5,4,5-4,BOS,9,true,37,39,76,149,160,309,13,12,25,2,3:31
381984,2014-07-18,2014,MIA,SFN,1,9,9-1,SFN,9,false,35,42,77,165,137,302,9,15,24,2,3:00
381976,2014-07-18,2014,PIT,COL,4,2,4-2,PIT,9,true,37,40,77,164,158,322,13,13,26,2,3:46
381975,2014-07-18,2014,DET,CLE,3,9,9-3,CLE,9,false,38,43,81,168,156,324,13,19,32,3,3:32
381983,2014-07-18,2014,ANA,SEA,3,2,3-2,ANA,16,false,59,64,123,233,191,424,14,19,33,6,5:14
381972,2014-07-18,2014,OAK,BAL,5,4,5-4,OAK,9,false,32,34,66,122,125,247,8,11,19,1,2:31
381985,2014-07-18,2014,MIN,TBA,2,6,6-2,TBA,9,false,38,38,76,137,156,293,11,14,25,3,3:04
381979,2014-07-18,2014,SLN,LAN,3,2,3-2,SLN,9,true,35,37,72,155,141,296,12,10,22,2,3:02
381989,2014-07-19,2014,NYA,CIN,7,1,7-1,NYA,9,true,35,34,69,133,132,265,10,7,17,1,2:41
382001,2014-07-19,2014,TOR,TEX,4,1,4-1,TOR,9,true,38,35,73,148,153,301,16,8,24,2,3:02
381997,2014-07-19,2014,ATL,PHI,1,2,2-1,PHI,9,false,31,39,70,157,112,269,6,12,18,2,2:57
381993,2014-07-19,2014,BOS,KCA,2,1,2-1,BOS,9,true,32,35,67,126,113,239,9,9,18,1,2:39
381996,2014-07-19,2014,SDN,NYN,6,0,6-0,SDN,9,true,32,34,66,138,135,273,8,8,16,2,2:41
381992,2014-07-19,2014,CHA,HOU,4,3,4-3,CHA,9,true,39,38,77,136,137,273,16,13,29,2,3:18
381999,2014-07-19,2014,MIA,SFN,3,5,5-3,SFN,9,false,35,39,74,146,114,260,11,15,26,3,3:01
382000,2014-07-19,2014,MIN,TBA,1,5,5-1,TBA,9,false,34,36,70,121,146,267,7,14,21,1,2:51
381994,2014-07-19,2014,SLN,LAN,4,2,4-2,SLN,9,true,36,34,70,144,139,283,15,9,24,2,3:02
381991,2014-07-19,2014,PIT,COL,3,2,3-2,PIT,11,false,44,37,81,124,177,301,14,10,24,2,3:31
381990,2014-07-19,2014,DET,CLE,2,5,5-2,CLE,9,false,36,41,77,165,171,336,9,15,24,2,3:40
381995,2014-07-19,2014,WAS,MIL,8,3,8-3,WAS,9,true,40,36,76,150,164,314,16,10,26,1,3:17
381998,2014-07-19,2014,ANA,SEA,2,3,3-2,SEA,12,false,45,47,92,164,191,355,13,13,26,3,4:07
380737,2014-07-19,2014,DET,CLE,2,6,6-2,CLE,9,false,34,39,73,155,121,276,8,17,25,3,3:02
380737,2014-07-19,2014,DET,CLE,2,6,6-2,CLE,9,false,34,39,73,155,121,276,8,17,25,3,3:02
381987,2014-07-19,2014,OAK,BAL,4,8,8-4,BAL,9,false,36,44,80,177,145,322,10,19,29,3,3:14
381988,2014-07-19,2014,ARI,CHN,9,3,9-3,ARI,9,true,40,37,77,121,144,265,16,12,28,1,2:55
382012,2014-07-20,2014,ATL,PHI,8,2,8-2,ATL,9,true,41,35,76,142,147,289,17,9,26,0,2:44 (1:39 delay)
382014,2014-07-20,2014,MIA,SFN,3,2,3-2,MIA,9,true,32,33,65,121,123,244,8,7,15,1,2:41
382015,2014-07-20,2014,MIN,TBA,3,5,5-3,TBA,9,false,38,44,82,177,156,333,11,18,29,2,3:40
382005,2014-07-20,2014,DET,CLE,5,1,5-1,DET,9,true,35,33,68,133,134,267,12,8,20,3,2:54
382008,2014-07-20,2014,BOS,KCA,6,0,6-0,BOS,9,true,40,33,73,125,153,278,16,7,23,2,2:56
382010,2014-07-20,2014,WAS,MIL,5,4,5-4,WAS,9,false,39,39,78,175,155,330,15,12,27,1,3:35
382006,2014-07-20,2014,PIT,COL,5,3,5-3,PIT,9,true,40,35,75,129,146,275,18,12,30,1,3:05
382007,2014-07-20,2014,CHA,HOU,7,11,11-7,HOU,9,false,43,44,87,151,162,313,15,20,35,4,3:39
382011,2014-07-20,2014,SDN,NYN,2,1,2-1,SDN,9,false,39,35,74,138,152,290,16,8,24,3,3:07
382002,2014-07-20,2014,OAK,BAL,10,2,10-2,OAK,9,true,42,35,77,143,161,304,18,5,23,3,3:14
382013,2014-07-20,2014,ANA,SEA,6,5,6-5,ANA,9,false,44,37,81,134,159,293,22,11,33,2,3:15
382003,2014-07-20,2014,ARI,CHN,3,2,3-2,ARI,9,true,33,34,67,126,130,256,9,7,16,2,2:50
382004,2014-07-20,2014,NYA,CIN,3,2,3-2,NYA,9,false,41,35,76,136,191,327,16,8,24,2,3:32
382009,2014-07-20,2014,SLN,LAN,3,4,4-3,LAN,9,false,35,40,75,140,143,283,11,16,27,3,3:28
382016,2014-07-20,2014,TOR,TEX,9,6,9-6,TOR,9,true,41,42,83,154,164,318,18,16,34,3,3:07
382017,2014-07-21,2014,ANA,BAL,2,4,4-2,BAL,9,false,37,33,70,127,125,252,10,7,17,3,3:02
382018,2014-07-21,2014,TOR,BOS,1,14,14-1,BOS,9,false,30,46,76,186,99,285,3,19,22,2,2:45
382023,2014-07-21,2014,PIT,LAN,2,5,5-2,LAN,9,false,34,43,77,144,136,280,7,19,26,2,3:12
382021,2014-07-21,2014,ARI,DET,3,4,4-3,DET,9,false,37,37,74,147,151,298,12,11,23,2,3:09
382024,2014-07-21,2014,ATL,MIA,1,3,3-1,MIA,10,false,40,43,83,182,134,316,9,14,23,2,3:36
382025,2014-07-21,2014,SEA,NYN,5,2,5-2,SEA,9,true,37,39,76,164,123,287,16,12,28,4,2:53
382027,2014-07-21,2014,NYA,TEX,2,4,4-2,TEX,9,false,35,43,78,176,130,306,9,14,23,3,3:31
382022,2014-07-21,2014,CHA,KCA,3,1,3-1,CHA,9,true,35,34,69,131,125,256,14,10,24,1,2:46
382019,2014-07-21,2014,MIL,CIN,5,2,5-2,MIL,9,true,34,34,68,129,119,248,9,8,17,0,2:55
382020,2014-07-21,2014,MIN,CLE,4,3,4-3,MIN,9,true,34,38,72,158,135,293,12,11,23,2,3:01
382028,2014-07-21,2014,COL,WAS,2,7,7-2,WAS,9,false,37,45,82,145,123,268,12,19,31,1,3:01
382026,2014-07-21,2014,PHI,SFN,4,7,7-4,SFN,9,false,42,42,84,135,165,300,14,18,32,3,3:28
382039,2014-07-22,2014,CHN,SDN,6,0,6-0,CHN,9,true,38,33,71,108,149,257,14,9,23,0,2:35
382030,2014-07-22,2014,TOR,BOS,7,3,7-3,TOR,9,true,38,39,77,158,137,295,17,14,31,3,3:07
382031,2014-07-22,2014,MIL,CIN,4,3,4-3,MIL,9,false,32,35,67,122,129,251,9,9,18,1,3:01
382037,2014-07-22,2014,ATL,MIA,5,6,6-5,MIA,9,false,36,43,79,156,147,303,11,17,28,2,3:13
382032,2014-07-22,2014,MIN,CLE,2,8,8-2,CLE,9,false,39,41,80,151,147,298,13,15,28,4,3:06
382029,2014-07-22,2014,ANA,BAL,2,4,4-2,BAL,9,false,33,37,70,161,125,286,7,10,17,2,3:08
382036,2014-07-22,2014,PIT,LAN,12,7,12-7,PIT,9,true,44,43,87,152,157,309,20,15,35,4,3:39
382033,2014-07-22,2014,ARI,DET,5,4,5-4,ARI,9,true,32,40,72,159,103,262,9,17,26,5,3:09
382038,2014-07-22,2014,SEA,NYN,1,3,3-1,NYN,9,false,33,36,69,146,132,278,7,11,18,0,2:49
382041,2014-07-22,2014,SLN,TBA,2,7,7-2,TBA,9,false,38,41,79,138,166,304,12,13,25,2,3:23
382043,2014-07-22,2014,COL,WAS,4,7,7-4,WAS,9,false,39,41,80,166,143,309,13,15,28,2,3:34
382035,2014-07-22,2014,CHA,KCA,1,7,7-1,KCA,9,false,38,48,86,166,160,326,12,22,34,3,3:35
382042,2014-07-22,2014,NYA,TEX,2,1,2-1,NYA,14,false,54,51,105,202,209,411,19,12,31,5,4:51
382034,2014-07-22,2014,OAK,HOU,2,3,3-2,HOU,12,false,46,46,92,184,174,358,11,13,24,3,4:09
382040,2014-07-22,2014,PHI,SFN,6,9,9-6,SFN,14,false,63,65,128,259,248,507,22,25,47,5,5:46
382057,2014-07-23,2014,NYA,TEX,2,1,2-1,NYA,5,false,18,18,36,72,67,139,5,5,10,0,1:36 (1:49 delay)
382052,2014-07-23,2014,ATL,MIA,6,1,6-1,ATL,9,true,36,36,72,146,120,266,11,11,22,1,2:42
382044,2014-07-23,2014,ANA,BAL,3,2,3-2,ANA,9,true,38,34,72,122,145,267,15,7,22,2,2:55
382047,2014-07-23,2014,MIN,CLE,3,1,3-1,MIN,9,true,33,34,67,130,123,253,11,7,18,2,2:46
382056,2014-07-23,2014,SLN,TBA,0,3,3-0,TBA,9,false,31,41,72,166,125,291,5,15,20,2,3:12
382050,2014-07-23,2014,CHA,KCA,1,2,2-1,KCA,9,false,33,39,72,162,127,289,7,18,25,1,3:03
382055,2014-07-23,2014,PHI,SFN,1,3,3-1,SFN,9,false,32,38,70,160,109,269,7,14,21,0,3:02 (:59 delay)
382049,2014-07-23,2014,OAK,HOU,9,7,9-7,OAK,9,true,44,40,84,159,168,327,20,12,32,5,3:30
382045,2014-07-23,2014,TOR,BOS,6,4,6-4,TOR,9,true,36,37,73,130,125,255,14,10,24,0,2:35
382051,2014-07-23,2014,PIT,LAN,6,1,6-1,PIT,9,true,34,34,68,128,125,253,14,10,24,0,2:38
382054,2014-07-23,2014,CHN,SDN,3,8,8-3,SDN,9,false,37,46,83,193,142,335,10,20,30,3,3:36
382048,2014-07-23,2014,ARI,DET,5,11,11-5,DET,9,false,38,44,82,159,134,293,14,17,31,1,3:10
382058,2014-07-23,2014,COL,WAS,6,4,6-4,COL,9,true,38,41,79,144,137,281,16,12,28,2,3:17
382053,2014-07-23,2014,SEA,NYN,2,3,3-2,NYN,9,false,33,38,71,149,127,276,6,12,18,4,3:05
382046,2014-07-23,2014,MIL,CIN,5,1,5-1,MIL,9,true,35,34,69,130,113,243,12,7,19,1,2:33
382065,2014-07-24,2014,ATL,MIA,2,3,3-2,MIA,9,false,32,36,68,138,119,257,7,10,17,0,2:33
382060,2014-07-24,2014,TOR,BOS,8,0,8-0,TOR,9,true,40,30,70,142,153,295,19,6,25,1,2:56
382059,2014-07-24,2014,SEA,BAL,0,4,4-0,BAL,9,false,33,35,68,124,128,252,6,8,14,0,2:44
382066,2014-07-24,2014,MIL,NYN,9,1,9-1,MIL,9,true,36,31,67,123,136,259,12,4,16,0,2:38
382067,2014-07-24,2014,CHN,SDN,3,13,13-3,SDN,9,false,40,48,88,159,169,328,11,19,30,3,3:36
382061,2014-07-24,2014,MIN,CHA,2,5,5-2,CHA,9,false,31,41,72,149,124,273,4,14,18,2,2:46
382063,2014-07-24,2014,ANA,DET,4,6,6-4,DET,9,false,35,41,76,153,137,290,9,15,24,0,3:17
382064,2014-07-24,2014,OAK,HOU,13,1,13-1,OAK,9,true,45,33,78,117,178,295,23,6,29,1,3:03
382062,2014-07-24,2014,KCA,CLE,2,1,2-1,KCA,14,false,44,53,97,229,168,397,6,13,19,3,4:23
382068,2014-07-24,2014,PHI,SFN,2,1,2-1,PHI,9,true,35,35,70,126,130,256,11,8,19,0,2:46
382069,2014-07-24,2014,NYA,TEX,4,2,4-2,NYA,9,true,34,34,68,149,111,260,10,8,18,3,2:47
382080,2014-07-25,2014,COL,PIT,8,1,8-1,COL,9,true,36,37,73,154,124,278,13,12,25,4,2:56
382077,2014-07-25,2014,HOU,MIA,0,2,2-0,MIA,9,false,29,38,67,149,125,274,5,13,18,1,2:59
382071,2014-07-25,2014,SEA,BAL,1,2,2-1,BAL,10,false,39,35,74,148,151,299,11,6,17,3,3:16
382081,2014-07-25,2014,ATL,SDN,2,5,5-2,SDN,9,false,37,40,77,152,135,287,10,15,25,2,3:08
382083,2014-07-25,2014,NYA,TOR,6,4,6-4,NYA,9,true,35,37,72,128,127,255,12,11,23,2,2:40
382079,2014-07-25,2014,TEX,OAK,4,1,4-1,TEX,9,true,33,34,67,139,124,263,11,8,19,2,2:52
382078,2014-07-25,2014,MIL,NYN,2,3,3-2,NYN,9,false,38,35,73,129,147,276,9,8,17,2,3:01
382072,2014-07-25,2014,TBA,BOS,6,4,6-4,TBA,9,true,36,37,73,129,155,284,12,10,22,1,3:04
382076,2014-07-25,2014,SFN,LAN,1,8,8-1,LAN,9,false,36,44,80,179,148,327,9,17,26,1,3:29
382084,2014-07-25,2014,CIN,WAS,1,4,4-1,WAS,9,false,34,43,77,171,126,297,7,17,24,1,3:07
382070,2014-07-25,2014,PHI,ARI,9,5,9-5,PHI,9,true,41,40,81,170,155,325,17,15,32,2,3:23
382075,2014-07-25,2014,ANA,DET,2,1,2-1,ANA,9,true,32,34,66,152,124,276,10,8,18,2,3:02
382074,2014-07-25,2014,KCA,CLE,6,4,6-4,KCA,9,true,34,37,71,140,142,282,11,9,20,5,3:02
382073,2014-07-25,2014,MIN,CHA,5,9,9-5,CHA,9,false,36,48,84,158,139,297,9,21,30,0,2:51
382082,2014-07-25,2014,CHN,SLN,7,6,7-6,CHN,9,true,40,41,81,179,157,336,16,14,30,4,3:44
382099,2014-07-26,2014,CIN,WAS,1,0,1-0,CIN,9,true,27,34,61,131,107,238,6,10,16,1,2:29
382088,2014-07-26,2014,MIN,CHA,0,7,7-0,CHA,9,false,35,40,75,126,126,252,8,14,22,1,2:30
382091,2014-07-26,2014,SFN,LAN,0,5,5-0,LAN,9,false,30,40,70,146,113,259,4,14,18,0,2:53
382098,2014-07-26,2014,NYA,TOR,4,6,6-4,TOR,9,false,42,44,86,161,135,296,15,17,32,3,3:14
382095,2014-07-26,2014,COL,PIT,8,1,8-1,COL,9,true,40,33,73,119,147,266,18,7,25,1,2:49
382086,2014-07-26,2014,SEA,BAL,4,3,4-3,SEA,9,true,33,37,70,149,115,264,12,10,22,3,2:49
382093,2014-07-26,2014,MIL,NYN,5,2,5-2,MIL,9,true,34,38,72,167,135,302,10,12,22,2,3:02
382089,2014-07-26,2014,KCA,CLE,7,5,7-5,KCA,9,true,35,41,76,168,129,297,11,16,27,3,3:06
382096,2014-07-26,2014,ATL,SDN,5,3,5-3,ATL,9,true,39,38,77,149,157,306,17,11,28,3,3:26
382085,2014-07-26,2014,PHI,ARI,6,10,10-6,ARI,10,false,50,50,100,167,208,375,22,22,44,2,4:20
382090,2014-07-26,2014,ANA,DET,4,0,4-0,ANA,9,true,36,30,66,100,134,234,12,4,16,1,2:47
382087,2014-07-26,2014,TBA,BOS,3,0,3-0,TBA,9,true,36,36,72,173,131,304,13,11,24,2,3:23
382097,2014-07-26,2014,CHN,SLN,3,6,6-3,SLN,9,false,34,40,74,180,130,310,8,11,19,2,3:20
382094,2014-07-26,2014,TEX,OAK,1,5,5-1,OAK,9,false,36,34,70,117,138,255,12,7,19,1,2:47
382092,2014-07-26,2014,HOU,MIA,3,7,7-3,MIA,9,false,40,41,81,159,150,309,14,14,28,3,3:29
382105,2014-07-27,2014,ANA,DET,2,1,2-1,ANA,9,true,29,30,59,125,118,243,7,3,10,1,2:39
382112,2014-07-27,2014,CHN,SLN,0,1,1-0,SLN,9,false,34,33,67,131,126,257,10,10,20,1,2:41
382111,2014-07-27,2014,ATL,SDN,8,3,8-3,ATL,9,true,35,38,73,144,151,295,12,11,23,2,2:56
382103,2014-07-27,2014,MIN,CHA,4,3,4-3,MIN,9,true,32,35,67,148,112,260,9,10,19,1,2:44
382106,2014-07-27,2014,SFN,LAN,3,4,4-3,LAN,9,false,35,38,73,145,138,283,9,10,19,1,3:13
382114,2014-07-27,2014,CIN,WAS,2,4,4-2,WAS,9,false,35,39,74,160,149,309,8,12,20,1,3:19 (:16 delay)
382108,2014-07-27,2014,MIL,NYN,0,2,2-0,NYN,9,false,35,36,71,121,153,274,8,10,18,2,3:10
382101,2014-07-27,2014,SEA,BAL,2,3,3-2,BAL,10,false,43,44,87,163,152,315,14,17,31,1,3:21
382109,2014-07-27,2014,TEX,OAK,3,9,9-3,OAK,9,false,37,45,82,156,159,315,11,16,27,2,3:26
382102,2014-07-27,2014,TBA,BOS,2,3,3-2,BOS,9,false,36,38,74,158,144,302,11,12,23,3,3:22
382113,2014-07-27,2014,NYA,TOR,4,5,5-4,TOR,9,false,35,41,76,147,154,301,8,17,25,4,3:22
382104,2014-07-27,2014,KCA,CLE,3,10,10-3,CLE,9,false,35,44,79,177,140,317,8,20,28,1,3:03
382110,2014-07-27,2014,COL,PIT,5,7,7-5,PIT,9,false,40,46,86,189,145,334,15,21,36,3,3:58
382100,2014-07-27,2014,PHI,ARI,4,2,4-2,PHI,9,true,32,32,64,98,137,235,7,7,14,1,2:30
382107,2014-07-27,2014,HOU,MIA,2,4,4-2,MIA,9,false,35,37,72,148,136,284,9,10,19,3,3:00
382117,2014-07-28,2014,TBA,MIL,2,1,2-1,TBA,9,true,32,30,62,117,130,247,10,3,13,0,2:35
382122,2014-07-28,2014,ATL,SDN,2,0,2-0,ATL,9,true,34,32,66,115,130,245,10,6,16,1,2:33
382123,2014-07-28,2014,BOS,TOR,1,14,14-1,TOR,9,false,34,48,82,189,137,326,7,23,30,2,3:15
382118,2014-07-28,2014,TEX,NYA,4,2,4-2,TEX,9,true,36,38,74,138,124,262,11,12,23,1,3:01
382120,2014-07-28,2014,NYN,PHI,7,1,7-1,NYN,9,true,36,40,76,149,120,269,12,14,26,2,2:54
382115,2014-07-28,2014,CIN,ARI,1,2,2-1,ARI,15,false,55,54,109,203,217,420,13,11,24,0,4:34
382124,2014-07-28,2014,MIA,WAS,7,6,7-6,MIA,9,false,38,40,78,154,142,296,13,14,27,4,3:17
382121,2014-07-28,2014,SFN,PIT,0,5,5-0,PIT,9,false,29,36,65,144,100,244,5,9,14,1,2:34
382119,2014-07-28,2014,HOU,OAK,7,3,7-3,HOU,9,true,33,38,71,139,128,267,10,12,22,3,2:51
382116,2014-07-28,2014,CHN,COL,4,1,4-1,CHN,9,true,31,33,64,118,117,235,11,7,18,3,2:53
382135,2014-07-29,2014,SFN,PIT,1,3,3-1,PIT,9,false,33,36,69,141,134,275,7,9,16,0,2:45
382131,2014-07-29,2014,KCA,MIN,1,2,2-1,MIN,9,false,33,37,70,170,131,301,7,13,20,0,3:14
382137,2014-07-29,2014,SDN,SLN,3,1,3-1,SDN,9,true,36,38,74,166,155,321,11,12,23,1,3:20
382134,2014-07-29,2014,NYN,PHI,0,6,6-0,PHI,9,false,33,38,71,146,126,272,7,11,18,1,2:36
382130,2014-07-29,2014,TBA,MIL,5,1,5-1,TBA,9,true,34,30,64,116,135,251,14,5,19,1,2:56
382139,2014-07-29,2014,MIA,WAS,3,0,3-0,MIA,9,true,32,38,70,145,133,278,9,12,21,2,3:07
382127,2014-07-29,2014,LAN,ATL,8,4,8-4,LAN,9,true,40,45,85,185,165,350,16,20,36,3,3:46
382138,2014-07-29,2014,BOS,TOR,2,4,4-2,TOR,9,false,37,39,76,153,152,305,11,14,25,1,3:03
382125,2014-07-29,2014,BAL,ANA,7,6,7-6,BAL,12,false,47,50,97,174,179,353,15,13,28,2,4:05
382128,2014-07-29,2014,DET,CHA,4,11,11-4,CHA,9,false,39,45,84,171,143,314,16,19,35,2,3:16
382132,2014-07-29,2014,TEX,NYA,11,12,12-11,NYA,9,false,49,45,94,160,204,364,23,18,41,2,3:51
382129,2014-07-29,2014,CHN,COL,4,3,4-3,CHN,16,false,67,63,130,274,282,556,21,18,39,3,6:27
382136,2014-07-29,2014,CLE,SEA,2,5,5-2,SEA,9,false,35,41,76,148,129,277,9,15,24,4,3:15
382133,2014-07-29,2014,HOU,OAK,4,7,7-4,OAK,9,false,35,43,78,149,132,281,10,17,27,3,3:15
382126,2014-07-29,2014,CIN,ARI,3,0,3-0,CIN,9,true,30,35,65,126,123,249,7,7,14,1,2:33
382151,2014-07-30,2014,CLE,SEA,2,0,2-0,CLE,9,true,30,28,58,85,114,199,6,3,9,0,2:10
382140,2014-07-30,2014,BAL,ANA,4,3,4-3,BAL,9,true,31,33,64,128,119,247,6,7,13,0,2:35
382150,2014-07-30,2014,SFN,PIT,7,5,7-5,SFN,9,true,42,37,79,148,163,311,18,12,30,3,3:24
382143,2014-07-30,2014,DET,CHA,7,2,7-2,DET,9,true,39,33,72,135,129,264,17,8,25,0,2:49 (:29 delay)
382145,2014-07-30,2014,TBA,MIL,0,5,5-0,MIL,9,false,34,39,73,149,132,281,9,12,21,2,3:14
382153,2014-07-30,2014,BOS,TOR,1,6,6-1,TOR,9,false,36,42,78,154,131,285,9,14,23,1,2:48
382152,2014-07-30,2014,SDN,SLN,12,1,12-1,SDN,9,true,42,33,75,126,162,288,22,8,30,2,3:10
382146,2014-07-30,2014,KCA,MIN,3,2,3-2,KCA,9,true,34,38,72,172,120,292,10,14,24,3,3:10
382154,2014-07-30,2014,MIA,WAS,3,4,4-3,WAS,9,false,36,38,74,143,153,296,9,11,20,1,3:20
382141,2014-07-30,2014,CIN,ARI,4,5,5-4,ARI,9,false,41,39,80,148,139,287,17,14,31,3,3:02
382148,2014-07-30,2014,HOU,OAK,8,1,8-1,HOU,9,true,38,33,71,111,155,266,14,7,21,1,2:35
382144,2014-07-30,2014,CHN,COL,4,6,6-4,COL,10,false,41,45,86,188,162,350,14,17,31,0,3:27
382147,2014-07-30,2014,TEX,NYA,3,2,3-2,TEX,9,true,36,33,69,130,137,267,13,6,19,0,2:49
382142,2014-07-30,2014,LAN,ATL,3,2,3-2,LAN,10,false,41,38,79,144,164,308,15,9,24,0,3:25
382149,2014-07-30,2014,NYN,PHI,11,2,11-2,NYN,9,true,44,40,84,155,171,326,21,14,35,3,3:28
382156,2014-07-31,2014,LAN,ATL,2,1,2-1,LAN,9,true,31,32,63,111,118,229,9,9,18,0,2:35
382158,2014-07-31,2014,MIA,CIN,1,3,3-1,CIN,9,false,33,36,69,107,133,240,8,7,15,2,2:43
382165,2014-07-31,2014,HOU,TOR,5,6,6-5,TOR,9,false,39,36,75,117,145,262,13,11,24,2,2:46
382164,2014-07-31,2014,SDN,SLN,2,6,6-2,SLN,9,false,30,38,68,146,120,266,3,13,16,1,2:36
382163,2014-07-31,2014,CLE,SEA,5,6,6-5,SEA,9,false,41,39,80,165,166,331,15,13,28,8,3:33
382157,2014-07-31,2014,DET,CHA,4,7,7-4,CHA,9,false,41,45,86,190,167,357,16,22,38,2,4:01
382155,2014-07-31,2014,BAL,ANA,0,1,1-0,ANA,13,false,48,51,99,188,205,393,10,15,25,2,4:33
382159,2014-07-31,2014,CHN,COL,3,1,3-1,CHN,9,true,31,34,65,138,122,260,10,7,17,2,2:59
382160,2014-07-31,2014,KCA,MIN,6,3,6-3,KCA,9,true,33,41,74,147,131,278,9,12,21,2,2:50
382162,2014-07-31,2014,ARI,PIT,7,4,7-4,ARI,9,true,38,38,76,169,132,301,13,12,25,2,3:08
382161,2014-07-31,2014,WAS,PHI,4,10,10-4,PHI,9,false,36,46,82,176,133,309,10,20,30,4,3:31
382180,2014-08-01,2014,HOU,TOR,3,1,3-1,HOU,9,true,31,34,65,141,119,260,7,7,14,3,2:46
382171,2014-08-01,2014,OAK,KCA,0,1,1-0,KCA,9,false,35,32,67,134,162,296,8,5,13,1,2:54
382178,2014-08-01,2014,NYN,SFN,1,5,5-1,SFN,9,false,28,38,66,98,102,200,3,12,15,1,2:06
382166,2014-08-01,2014,TBA,ANA,3,5,5-3,ANA,9,false,39,39,78,149,172,321,13,15,28,2,3:39
382175,2014-08-01,2014,WAS,PHI,1,2,2-1,PHI,9,false,34,34,68,121,116,237,9,8,17,0,2:28
382177,2014-08-01,2014,BAL,SEA,2,1,2-1,BAL,9,true,31,34,65,126,103,229,9,7,16,2,2:29
382173,2014-08-01,2014,CHA,MIN,10,8,10-8,CHA,9,true,45,43,88,166,165,331,22,16,38,4,3:47
382169,2014-08-01,2014,MIA,CIN,2,5,5-2,CIN,9,false,36,38,74,146,120,266,12,10,22,1,2:58
382170,2014-08-01,2014,DET,COL,4,2,4-2,DET,9,true,36,37,73,121,130,251,14,10,24,0,2:56
382172,2014-08-01,2014,SLN,MIL,4,7,7-4,MIL,9,false,38,46,84,155,136,291,12,20,32,3,3:14
382168,2014-08-01,2014,LAN,CHN,2,8,8-2,CHN,9,false,32,44,76,174,132,306,6,17,23,1,3:18
382176,2014-08-01,2014,ARI,PIT,4,9,9-4,PIT,9,false,38,45,83,180,140,320,12,20,32,3,3:25
382167,2014-08-01,2014,SDN,ATL,10,1,10-1,SDN,9,true,45,37,82,158,162,320,23,9,32,2,3:09
382179,2014-08-01,2014,CLE,TEX,12,2,12-2,CLE,9,true,43,39,82,159,151,310,21,13,34,2,3:23
382174,2014-08-01,2014,BOS,NYA,4,3,4-3,BOS,9,true,33,37,70,130,115,245,10,11,21,2,3:03
382193,2014-08-02,2014,NYN,SFN,4,2,4-2,NYN,9,true,29,34,63,121,101,222,5,7,12,1,2:24
382194,2014-08-02,2014,CLE,TEX,2,0,2-0,CLE,9,true,32,36,68,161,115,276,9,8,17,2,3:00
382186,2014-08-02,2014,OAK,KCA,8,3,8-3,OAK,9,true,34,38,72,143,124,267,9,12,21,3,2:45
382184,2014-08-02,2014,MIA,CIN,2,1,2-1,MIA,10,false,37,38,75,147,141,288,10,10,20,3,3:11
382187,2014-08-02,2014,SLN,MIL,9,7,9-7,SLN,9,true,41,38,79,131,144,275,17,13,30,1,2:58
382195,2014-08-02,2014,HOU,TOR,8,2,8-2,HOU,9,true,37,36,73,122,133,255,13,9,22,3,2:38
382185,2014-08-02,2014,DET,COL,11,5,11-5,DET,9,true,39,38,77,142,144,286,19,12,31,2,3:15
382188,2014-08-02,2014,CHA,MIN,6,8,8-6,MIN,9,false,41,40,81,146,125,271,17,16,33,4,2:58
382192,2014-08-02,2014,BAL,SEA,3,6,6-3,SEA,9,false,38,41,79,166,160,326,12,15,27,5,3:38
382190,2014-08-02,2014,WAS,PHI,11,0,11-0,WAS,9,true,43,34,77,119,176,295,18,7,25,2,3:19
382189,2014-08-02,2014,BOS,NYA,4,6,6-4,NYA,9,false,38,43,81,197,169,366,11,17,28,5,3:56
382181,2014-08-02,2014,TBA,ANA,10,3,10-3,TBA,9,true,43,38,81,155,178,333,23,12,35,2,3:34
382191,2014-08-02,2014,ARI,PIT,3,8,8-3,PIT,9,false,41,43,84,182,139,321,14,14,28,2,3:30
382183,2014-08-02,2014,LAN,CHN,5,2,5-2,LAN,12,false,48,50,98,184,200,384,16,16,32,3,4:39
382182,2014-08-02,2014,SDN,ATL,3,2,3-2,SDN,12,false,51,52,103,201,200,401,21,19,40,4,4:35
382202,2014-08-03,2014,SLN,MIL,3,2,3-2,SLN,9,true,30,37,67,155,100,255,7,10,17,1,2:50
382201,2014-08-03,2014,OAK,KCA,2,4,4-2,KCA,9,false,30,38,68,134,112,246,4,15,19,2,2:32
382206,2014-08-03,2014,ARI,PIT,3,2,3-2,ARI,10,false,36,40,76,161,143,304,10,15,25,0,3:13
382205,2014-08-03,2014,WAS,PHI,4,0,4-0,WAS,9,true,34,31,65,128,122,250,10,4,14,1,2:47
382204,2014-08-03,2014,BOS,NYA,7,8,8-7,NYA,9,false,38,40,78,161,176,337,13,15,28,0,3:42
382198,2014-08-03,2014,LAN,CHN,3,7,7-3,CHN,9,false,34,44,78,191,129,320,10,19,29,2,3:34
382208,2014-08-03,2014,NYN,SFN,0,9,9-0,SFN,9,false,30,40,70,157,94,251,3,13,16,2,2:40
382200,2014-08-03,2014,DET,COL,4,0,4-0,DET,9,true,34,32,66,145,128,273,10,4,14,1,2:58
382197,2014-08-03,2014,SDN,ATL,4,3,4-3,SDN,10,false,46,39,85,157,196,353,18,12,30,3,4:01
382209,2014-08-03,2014,CLE,TEX,4,3,4-3,CLE,12,false,48,47,95,163,186,349,18,14,32,3,3:58
382196,2014-08-03,2014,TBA,ANA,5,7,7-5,ANA,9,false,44,42,86,165,178,343,17,16,33,3,3:46 (:19 delay)
382210,2014-08-03,2014,HOU,TOR,6,1,6-1,HOU,9,true,36,33,69,109,140,249,13,10,23,1,2:39
382199,2014-08-03,2014,MIA,CIN,3,7,7-3,CIN,9,false,37,42,79,144,152,296,10,17,27,0,3:05
382207,2014-08-03,2014,BAL,SEA,1,0,1-0,BAL,9,true,30,31,61,127,110,237,7,5,12,1,2:33
382203,2014-08-03,2014,CHA,MIN,3,16,16-3,MIN,9,false,37,58,95,244,134,378,9,31,40,2,4:01 (:45 delay)
382212,2014-08-04,2014,CLE,CIN,7,1,7-1,CLE,9,true,35,39,74,137,110,247,14,11,25,2,2:52
382211,2014-08-04,2014,LAN,ANA,0,5,5-0,ANA,9,false,34,36,70,123,122,245,7,7,14,0,2:49
381885,2014-08-04,2014,WAS,BAL,3,7,7-3,BAL,9,false,36,41,77,144,139,283,10,15,25,3,3:10
382213,2014-08-04,2014,NYA,DET,2,1,2-1,NYA,9,true,33,36,69,151,130,281,12,8,20,1,3:19
381885,2014-08-04,2014,WAS,BAL,3,7,7-3,BAL,9,false,36,41,77,144,139,283,10,15,25,3,3:10
382215,2014-08-04,2014,OAK,TBA,3,2,3-2,OAK,10,false,50,39,89,139,200,339,22,7,29,2,3:57
382216,2014-08-04,2014,CHA,TEX,5,3,5-3,CHA,7,false,29,29,58,104,124,228,13,8,21,1,2:28 (1:20 delay)
382214,2014-08-04,2014,NYN,SFN,3,4,4-3,SFN,9,false,38,41,79,179,157,336,13,16,29,4,3:40
382218,2014-08-05,2014,SEA,ATL,4,2,4-2,SEA,9,true,34,33,67,113,129,242,11,7,18,0,2:29
382229,2014-08-05,2014,MIL,SFN,4,3,4-3,MIL,9,true,34,38,72,130,123,253,11,10,21,1,2:54
382228,2014-08-05,2014,MIN,SDN,3,1,3-1,MIN,9,true,32,39,71,145,132,277,9,13,22,1,2:55
382231,2014-08-05,2014,CHA,TEX,0,16,16-0,TEX,9,false,33,52,85,197,110,307,7,25,32,1,2:56
382227,2014-08-05,2014,WAS,NYN,1,6,6-1,NYN,9,false,35,40,75,135,144,279,12,15,27,2,3:12
382230,2014-08-05,2014,OAK,TBA,3,0,3-0,OAK,9,true,37,36,73,129,153,282,16,11,27,2,3:09
382223,2014-08-05,2014,NYA,DET,3,4,4-3,DET,12,false,45,46,91,162,160,322,9,10,19,5,4:11
382219,2014-08-05,2014,TOR,BAL,3,9,9-3,BAL,9,false,40,47,87,203,143,346,16,22,38,3,3:29
382217,2014-08-05,2014,LAN,ANA,5,4,5-4,LAN,9,false,36,35,71,135,140,275,10,10,20,1,3:00
382222,2014-08-05,2014,CLE,CIN,2,9,9-2,CIN,9,false,33,44,77,149,117,266,8,18,26,2,2:48
382224,2014-08-05,2014,PHI,HOU,2,1,2-1,PHI,15,false,58,54,112,234,233,467,16,11,27,1,5:05
382225,2014-08-05,2014,ARI,KCA,2,12,12-2,KCA,9,false,35,44,79,159,149,308,7,19,26,1,3:02
382226,2014-08-05,2014,PIT,MIA,3,6,6-3,MIA,9,false,36,42,78,162,126,288,10,17,27,4,3:03
382221,2014-08-05,2014,COL,CHN,5,6,6-5,CHN,12,false,53,50,103,204,169,373,20,18,38,4,4:21
382220,2014-08-05,2014,SLN,BOS,3,2,3-2,SLN,9,true,36,34,70,141,144,285,14,7,21,1,3:04
382233,2014-08-06,2014,TOR,BAL,5,1,5-1,TOR,9,true,38,29,67,119,137,256,14,2,16,1,2:41
382242,2014-08-06,2014,WAS,NYN,7,1,7-1,WAS,9,true,34,34,68,132,133,265,11,8,19,1,2:31
382245,2014-08-06,2014,OAK,TBA,3,7,7-3,TBA,9,false,33,45,78,158,142,300,6,19,25,1,3:10
382237,2014-08-06,2014,NYA,DET,5,1,5-1,NYA,9,true,34,36,70,137,138,275,10,7,17,2,3:10
382234,2014-08-06,2014,SLN,BOS,1,2,2-1,BOS,9,false,35,35,70,123,128,251,9,11,20,1,3:01 (1:03 delay)
382238,2014-08-06,2014,PHI,HOU,10,3,10-3,PHI,9,true,38,37,75,133,142,275,17,10,27,1,2:45
382240,2014-08-06,2014,ANA,LAN,1,2,2-1,LAN,9,false,31,37,68,145,110,255,5,11,16,2,3:06
382239,2014-08-06,2014,ARI,KCA,3,4,4-3,KCA,9,false,41,35,76,120,164,284,14,8,22,1,3:02
382232,2014-08-06,2014,SEA,ATL,7,3,7-3,SEA,9,true,38,38,76,146,140,286,15,12,27,3,2:53
382243,2014-08-06,2014,MIN,SDN,4,5,5-4,SDN,10,false,48,42,90,154,180,334,20,13,33,3,3:45
382244,2014-08-06,2014,MIL,SFN,4,7,7-4,SFN,9,false,41,46,87,186,153,339,15,21,36,3,3:53
382236,2014-08-06,2014,CIN,CLE,8,3,8-3,CIN,9,true,34,35,69,132,120,252,10,9,19,2,2:44
382246,2014-08-06,2014,CHA,TEX,1,3,3-1,TEX,9,false,33,33,66,147,135,282,10,9,19,3,2:57
382241,2014-08-06,2014,PIT,MIA,7,3,7-3,PIT,9,true,36,34,70,128,145,273,13,7,20,1,2:43
382235,2014-08-06,2014,COL,CHN,13,4,13-4,COL,9,true,41,36,77,142,127,269,21,10,31,1,2:51
382247,2014-08-07,2014,TOR,BAL,1,2,2-1,BAL,9,false,34,34,68,139,148,287,8,7,15,0,2:59
382252,2014-08-07,2014,NYA,DET,1,0,1-0,NYA,9,true,33,33,66,112,127,239,11,9,20,1,2:49
382250,2014-08-07,2014,COL,CHN,2,6,6-2,CHN,9,false,35,35,70,126,117,243,7,10,17,1,2:29 (:39 delay)
382253,2014-08-07,2014,PHI,HOU,6,5,6-5,PHI,9,true,32,34,66,122,128,250,10,10,20,2,2:47
382251,2014-08-07,2014,CIN,CLE,4,0,4-0,CIN,9,true,33,33,66,129,112,241,9,6,15,1,2:35
382254,2014-08-07,2014,ARI,KCA,2,6,6-2,KCA,9,false,34,38,72,149,109,258,7,13,20,0,2:34
382257,2014-08-07,2014,OAK,MIN,3,0,3-0,OAK,9,true,36,31,67,122,144,266,12,5,17,2,2:42
382259,2014-08-07,2014,MIL,SFN,3,1,3-1,MIL,9,true,34,37,71,158,122,280,12,11,23,3,3:14
382256,2014-08-07,2014,PIT,MIA,7,2,7-2,PIT,9,true,37,31,68,138,148,286,15,6,21,3,3:03
382249,2014-08-07,2014,SEA,CHA,13,3,13-3,SEA,9,true,45,37,82,141,163,304,23,9,32,4,3:08
382258,2014-08-07,2014,WAS,NYN,5,3,5-3,WAS,13,false,51,50,101,186,196,382,17,12,29,5,4:34
382255,2014-08-07,2014,ANA,LAN,0,7,7-0,LAN,9,false,31,46,77,178,136,314,5,21,26,2,3:24
382248,2014-08-07,2014,SLN,BOS,5,2,5-2,SLN,9,true,33,37,70,154,132,286,10,10,20,2,3:08 (1:04 delay)
382260,2014-08-08,2014,ANA,BOS,2,4,4-2,BOS,9,false,37,38,75,156,126,282,11,10,21,1,3:10
382270,2014-08-08,2014,KCA,SFN,4,2,4-2,KCA,9,true,30,37,67,154,123,277,8,12,20,0,2:59
382274,2014-08-08,2014,ATL,WAS,7,6,7-6,ATL,9,true,36,36,72,121,142,263,12,9,21,1,2:47 (1:11 delay)
382265,2014-08-08,2014,MIL,LAN,9,3,9-3,MIL,9,true,35,38,73,148,113,261,9,13,22,4,3:05
382263,2014-08-08,2014,ARI,COL,5,3,5-3,ARI,9,true,38,37,75,154,138,292,15,10,25,1,3:05
382269,2014-08-08,2014,PIT,SDN,2,1,2-1,PIT,9,true,33,32,65,125,130,255,11,7,18,0,2:41
382268,2014-08-08,2014,PHI,NYN,4,5,5-4,NYN,9,false,36,39,75,147,126,273,10,14,24,1,2:51
382271,2014-08-08,2014,BAL,SLN,12,2,12-2,BAL,9,true,46,32,78,139,157,296,23,5,28,2,2:57
382262,2014-08-08,2014,NYA,CLE,10,6,10-6,NYA,9,true,43,42,85,170,164,334,19,16,35,8,3:53
382273,2014-08-08,2014,HOU,TEX,4,3,4-3,HOU,9,true,38,36,74,131,166,297,14,10,24,0,3:24
382272,2014-08-08,2014,CHN,TBA,3,4,4-3,TBA,10,false,39,41,80,159,148,307,9,10,19,3,3:30
382264,2014-08-08,2014,TOR,DET,4,5,5-4,DET,9,false,44,39,83,143,159,302,15,13,28,3,3:19
382261,2014-08-08,2014,SEA,CHA,4,1,4-1,SEA,9,true,36,32,68,117,126,243,12,6,18,2,2:43
382266,2014-08-08,2014,CIN,MIA,1,2,2-1,MIA,9,false,35,39,74,153,132,285,9,13,22,0,2:40
382267,2014-08-08,2014,OAK,MIN,6,5,6-5,OAK,9,true,36,34,70,116,151,267,12,8,20,4,2:51
382285,2014-08-09,2014,KCA,SFN,5,0,5-0,KCA,9,true,32,31,63,109,114,223,9,5,14,2,2:30
382276,2014-08-09,2014,SEA,CHA,1,2,2-1,CHA,10,false,35,38,73,124,118,242,8,10,18,3,2:50 (:17 delay)
382277,2014-08-09,2014,NYA,CLE,0,3,3-0,CLE,9,false,35,36,71,124,150,274,8,9,17,2,2:59
382280,2014-08-09,2014,MIL,LAN,4,1,4-1,MIL,9,true,32,31,63,117,113,230,11,6,17,0,2:43
382278,2014-08-09,2014,ARI,COL,14,4,14-4,ARI,9,true,40,36,76,130,164,294,16,9,25,1,3:11
382283,2014-08-09,2014,PHI,NYN,1,2,2-1,NYN,11,false,42,43,85,177,166,343,9,13,22,1,3:41
382286,2014-08-09,2014,BAL,SLN,10,3,10-3,BAL,9,true,40,40,80,149,149,298,18,14,32,2,2:58
382281,2014-08-09,2014,CIN,MIA,3,4,4-3,MIA,9,false,38,43,81,174,152,326,12,17,29,1,3:27
382289,2014-08-09,2014,ATL,WAS,1,4,4-1,WAS,11,false,45,46,91,164,175,339,15,15,30,2,3:38 (3:41 delay)
382282,2014-08-09,2014,OAK,MIN,9,4,9-4,OAK,9,true,45,42,87,158,179,337,22,15,37,1,3:21
382275,2014-08-09,2014,ANA,BOS,5,4,5-4,ANA,19,false,75,66,141,286,272,558,26,10,36,2,6:32
382279,2014-08-09,2014,TOR,DET,3,2,3-2,TOR,10,false,36,36,72,125,145,270,11,8,19,1,2:50
382287,2014-08-09,2014,CHN,TBA,0,4,4-0,TBA,9,false,32,36,68,135,157,292,6,9,15,0,3:06
382284,2014-08-09,2014,PIT,SDN,1,2,2-1,SDN,9,false,36,34,70,131,144,275,9,9,18,2,2:53
382288,2014-08-09,2014,HOU,TEX,8,3,8-3,HOU,9,true,41,38,79,151,174,325,19,11,30,2,3:32
382296,2014-08-10,2014,CIN,MIA,7,2,7-2,CIN,9,true,35,36,71,130,144,274,10,8,18,1,2:45
382290,2014-08-10,2014,ANA,BOS,1,3,3-1,BOS,9,false,36,36,72,160,132,292,10,9,19,1,3:03
382303,2014-08-10,2014,HOU,TEX,2,6,6-2,TEX,9,false,36,38,74,131,156,287,10,11,21,0,3:08
382295,2014-08-10,2014,MIL,LAN,1,5,5-1,LAN,9,false,32,44,76,147,111,258,8,18,26,1,3:05
382291,2014-08-10,2014,SEA,CHA,4,2,4-2,SEA,9,true,34,35,69,136,125,261,13,12,25,3,2:50
382300,2014-08-10,2014,KCA,SFN,7,4,7-4,KCA,9,true,38,40,78,163,142,305,15,13,28,3,3:21
382304,2014-08-10,2014,ATL,WAS,3,1,3-1,ATL,9,true,37,35,72,134,172,306,14,9,23,2,3:07
382298,2014-08-10,2014,PHI,NYN,7,6,7-6,PHI,9,false,40,42,82,136,170,306,14,17,31,1,3:14
382301,2014-08-10,2014,BAL,SLN,3,8,8-3,SLN,9,false,38,45,83,191,147,338,11,20,31,2,3:39
382294,2014-08-10,2014,TOR,DET,6,5,6-5,TOR,19,false,84,81,165,304,325,629,36,29,65,5,6:37
382299,2014-08-10,2014,PIT,SDN,2,8,8-2,SDN,9,false,36,44,80,177,141,318,11,17,28,0,3:20
382292,2014-08-10,2014,NYA,CLE,1,4,4-1,CLE,9,false,31,40,71,169,123,292,5,14,19,2,3:08
382297,2014-08-10,2014,OAK,MIN,1,6,6-1,MIN,9,false,35,41,76,163,119,282,8,14,22,1,2:49
382302,2014-08-10,2014,CHN,TBA,3,2,3-2,CHN,12,false,48,47,95,182,188,370,14,12,26,2,4:08
382293,2014-08-10,2014,ARI,COL,3,5,5-3,COL,10,false,43,42,85,176,171,347,12,14,26,1,3:34
382311,2014-08-11,2014,PHI,NYN,3,5,5-3,NYN,9,false,37,37,74,146,138,284,12,10,22,2,2:48
382309,2014-08-11,2014,HOU,MIN,2,4,4-2,MIN,9,false,37,40,77,182,142,324,12,15,27,1,3:20
382315,2014-08-11,2014,SEA,TOR,11,1,11-1,SEA,9,true,40,30,70,122,159,281,16,3,19,1,2:43
382313,2014-08-11,2014,MIA,SLN,6,5,6-5,MIA,9,true,36,40,76,137,137,274,13,15,28,1,2:56
382305,2014-08-11,2014,SDN,COL,4,3,4-3,SDN,9,true,35,35,70,144,154,298,13,8,21,3,3:10
382307,2014-08-11,2014,ATL,LAN,2,6,6-2,LAN,9,false,34,40,74,158,125,283,7,15,22,2,3:11
382314,2014-08-11,2014,TEX,TBA,0,7,7-0,TBA,9,false,35,43,78,175,147,322,9,17,26,2,3:17
382310,2014-08-11,2014,BAL,NYA,11,3,11-3,BAL,9,true,41,37,78,173,156,329,16,10,26,2,3:41
382306,2014-08-11,2014,PIT,DET,11,6,11-6,PIT,9,true,43,42,85,145,168,313,19,18,37,3,3:30
382312,2014-08-11,2014,KCA,OAK,3,2,3-2,KCA,9,true,31,33,64,150,106,256,9,8,17,0,2:35
382308,2014-08-11,2014,CHN,MIL,1,3,3-1,MIL,9,false,33,33,66,118,136,254,7,8,15,1,3:01
382323,2014-08-12,2014,HOU,MIN,10,4,10-4,HOU,9,true,38,35,73,144,152,296,15,8,23,2,3:08
382327,2014-08-12,2014,MIA,SLN,3,0,3-0,MIA,9,true,30,33,63,135,102,237,10,6,16,2,2:34
382319,2014-08-12,2014,SDN,COL,4,1,4-1,SDN,9,true,33,34,67,125,119,244,9,8,17,1,2:41
382321,2014-08-12,2014,ATL,LAN,2,4,4-2,LAN,9,false,35,38,73,133,139,272,8,12,20,2,2:56
382320,2014-08-12,2014,PIT,DET,4,2,4-2,PIT,9,true,34,37,71,149,131,280,12,9,21,1,3:10
382325,2014-08-12,2014,KCA,OAK,3,11,11-3,OAK,9,false,35,45,80,148,139,287,9,20,29,1,2:49
382317,2014-08-12,2014,CIN,BOS,2,3,3-2,BOS,9,false,35,35,70,133,149,282,10,9,19,2,3:05
382330,2014-08-12,2014,NYN,WAS,1,7,7-1,WAS,9,false,37,39,76,156,136,292,10,14,24,1,2:46 (:25 delay)
382318,2014-08-12,2014,SFN,CHA,2,3,3-2,CHA,10,false,40,39,79,151,153,304,11,9,20,1,3:12
382322,2014-08-12,2014,CHN,MIL,3,0,3-0,CHN,9,true,32,32,64,107,114,221,9,8,17,2,2:22
382329,2014-08-12,2014,SEA,TOR,6,3,6-3,SEA,9,true,33,36,69,147,128,275,9,9,18,2,2:41
382326,2014-08-12,2014,ANA,PHI,7,2,7-2,ANA,9,true,36,36,72,140,129,269,13,11,24,3,2:56
382328,2014-08-12,2014,TEX,TBA,3,2,3-2,TEX,14,false,57,51,108,183,215,398,18,8,26,3,4:49
382336,2014-08-13,2014,CHN,MIL,4,2,4-2,CHN,9,true,34,33,67,123,123,246,11,7,18,1,2:36
382338,2014-08-13,2014,BAL,NYA,5,3,5-3,BAL,9,true,31,34,65,141,121,262,7,8,15,1,2:45
382342,2014-08-13,2014,MIA,SLN,2,5,5-2,SLN,9,false,31,40,71,143,127,270,5,13,18,1,2:40
382344,2014-08-13,2014,SEA,TOR,2,0,2-0,SEA,9,true,32,36,68,139,124,263,12,9,21,2,2:41
382335,2014-08-13,2014,ATL,LAN,3,2,3-2,ATL,9,true,35,40,75,151,126,277,11,16,27,1,3:02
382333,2014-08-13,2014,SFN,CHA,7,1,7-1,SFN,9,true,35,33,68,128,118,246,9,9,18,2,2:44
382337,2014-08-13,2014,HOU,MIN,1,3,3-1,MIN,9,false,34,39,73,143,122,265,8,13,21,2,2:45
382343,2014-08-13,2014,TEX,TBA,1,10,10-1,TBA,9,false,32,42,74,133,134,267,6,16,22,2,2:51
382334,2014-08-13,2014,SDN,COL,5,3,5-3,SDN,9,true,36,38,74,147,127,274,13,13,26,1,3:01
382340,2014-08-13,2014,ANA,PHI,4,3,4-3,ANA,9,true,35,39,74,141,123,264,12,13,25,0,2:51
382332,2014-08-13,2014,CIN,BOS,4,5,5-4,BOS,9,false,38,37,75,138,134,272,11,10,21,0,3:01
382339,2014-08-13,2014,KCA,OAK,3,0,3-0,KCA,9,true,31,29,60,97,111,208,9,3,12,0,2:06
382341,2014-08-13,2014,DET,PIT,8,4,8-4,DET,9,true,37,37,74,143,133,276,16,12,28,2,3:06
382331,2014-08-13,2014,CLE,ARI,3,2,3-2,CLE,9,false,35,32,67,126,140,266,11,7,18,3,2:50
382345,2014-08-13,2014,NYN,WAS,2,3,3-2,WAS,9,false,37,36,73,128,121,249,10,10,20,1,2:47
382316,2014-08-13,2014,CLE,ARI,0,1,1-0,ARI,12,false,46,48,94,157,215,372,13,13,26,4,4:16
382316,2014-08-13,2014,CLE,ARI,0,1,1-0,ARI,12,false,46,48,94,157,215,372,13,13,26,4,4:16
382354,2014-08-14,2014,TEX,TBA,3,6,6-3,TBA,9,false,33,39,72,167,135,302,6,12,18,2,3:02
382347,2014-08-14,2014,COL,CIN,7,3,7-3,COL,9,true,37,33,70,124,130,254,13,7,20,1,2:53
382351,2014-08-14,2014,KCA,OAK,7,3,7-3,KCA,9,true,36,40,76,151,132,283,13,13,26,5,3:13
382355,2014-08-14,2014,NYN,WAS,1,4,4-1,WAS,9,false,31,39,70,144,133,277,5,12,17,1,2:53
382353,2014-08-14,2014,SLN,SDN,4,3,4-3,SLN,9,true,33,38,71,143,122,265,11,13,24,1,2:44
382350,2014-08-14,2014,CHN,MIL,2,6,6-2,MIL,9,false,34,39,73,150,156,306,6,13,19,1,3:06
382346,2014-08-14,2014,MIA,ARI,5,4,5-4,MIA,10,false,43,41,84,168,175,343,20,12,32,1,3:31
382349,2014-08-14,2014,ATL,LAN,4,6,6-4,LAN,9,false,40,41,81,138,189,327,15,18,33,3,3:39
382352,2014-08-14,2014,DET,PIT,5,2,5-2,DET,9,true,35,33,68,138,141,279,13,7,20,1,2:55
382348,2014-08-14,2014,BOS,HOU,9,4,9-4,BOS,9,true,40,37,77,140,157,297,18,12,30,2,3:19
382364,2014-08-15,2014,TBA,NYA,5,0,5-0,TBA,9,true,34,34,68,135,125,260,9,8,17,2,2:42
382362,2014-08-15,2014,MIN,KCA,5,6,6-5,KCA,9,false,37,40,77,126,143,269,10,14,24,4,3:05
382356,2014-08-15,2014,TEX,ANA,4,5,5-4,ANA,9,false,37,40,77,167,141,308,12,14,26,4,3:18
382357,2014-08-15,2014,MIA,ARI,2,3,3-2,ARI,9,false,36,35,71,130,145,275,13,8,21,2,2:55
382365,2014-08-15,2014,ATL,OAK,7,2,7-2,ATL,9,true,37,32,69,137,132,269,12,7,19,1,2:37
382369,2014-08-15,2014,DET,SEA,2,7,7-2,SEA,9,false,35,37,72,142,142,284,8,13,21,0,2:51
382368,2014-08-15,2014,SLN,SDN,4,2,4-2,SLN,9,true,37,37,74,151,145,296,14,10,24,1,3:00
382358,2014-08-15,2014,CLE,BAL,2,1,2-1,CLE,11,false,38,44,82,159,138,297,9,10,19,4,3:36
382359,2014-08-15,2014,NYN,CHN,3,2,3-2,NYN,9,true,33,36,69,162,139,301,11,10,21,2,3:04
382363,2014-08-15,2014,LAN,MIL,3,6,6-3,MIL,9,false,35,43,78,156,125,281,10,19,29,1,3:31
382361,2014-08-15,2014,BOS,HOU,3,5,5-3,HOU,10,false,38,45,83,165,145,310,10,15,25,4,3:46
382366,2014-08-15,2014,SFN,PHI,3,5,5-3,PHI,10,false,40,41,81,176,143,319,13,11,24,3,3:36
382370,2014-08-15,2014,CHA,TOR,11,5,11-5,CHA,9,true,45,38,83,149,179,328,23,11,34,4,3:22
382367,2014-08-15,2014,WAS,PIT,5,4,5-4,WAS,9,true,36,37,73,147,143,290,15,10,25,1,3:05
382360,2014-08-15,2014,COL,CIN,2,3,3-2,CIN,9,false,35,39,74,143,119,262,11,13,24,1,3:02
382373,2014-08-16,2014,CLE,BAL,6,0,6-0,CLE,9,true,35,30,65,105,150,255,11,4,15,2,2:39
382372,2014-08-16,2014,MIA,ARI,2,1,2-1,MIA,9,true,30,32,62,119,118,237,6,7,13,0,2:25
382374,2014-08-16,2014,NYN,CHN,7,3,7-3,NYN,9,true,35,36,71,125,128,253,11,9,20,3,2:39
382384,2014-08-16,2014,DET,SEA,4,2,4-2,DET,9,true,39,33,72,122,147,269,15,8,23,1,2:55
382377,2014-08-16,2014,MIN,KCA,4,1,4-1,MIN,9,true,37,35,72,125,137,262,13,9,22,2,2:37
382382,2014-08-16,2014,WAS,PIT,4,3,4-3,WAS,9,false,34,36,70,145,134,279,13,11,24,1,2:49
382379,2014-08-16,2014,TBA,NYA,2,3,3-2,NYA,9,false,36,33,69,146,138,284,9,8,17,1,2:59
382385,2014-08-16,2014,CHA,TOR,3,6,6-3,TOR,9,false,35,40,75,150,127,277,10,14,24,4,2:54
382380,2014-08-16,2014,ATL,OAK,4,3,4-3,ATL,9,true,34,36,70,163,133,296,11,10,21,2,3:11
382381,2014-08-16,2014,SFN,PHI,6,5,6-5,SFN,9,true,39,43,82,164,133,297,14,19,33,6,3:34
382376,2014-08-16,2014,BOS,HOU,10,7,10-7,BOS,9,true,41,44,85,174,161,335,18,18,36,4,3:50
382378,2014-08-16,2014,LAN,MIL,2,3,3-2,MIL,9,false,34,32,66,97,113,210,8,5,13,0,2:28
382371,2014-08-16,2014,TEX,ANA,4,5,5-4,ANA,9,false,37,38,75,135,153,288,10,11,21,2,3:03
382383,2014-08-16,2014,SLN,SDN,5,9,9-5,SDN,9,false,39,44,83,182,155,337,12,21,33,2,3:28 (1:46 delay)
382395,2014-08-17,2014,ATL,OAK,4,3,4-3,ATL,9,true,30,34,64,142,125,267,7,7,14,2,2:49
382393,2014-08-17,2014,LAN,MIL,2,7,7-2,MIL,9,false,38,38,76,138,152,290,11,11,22,0,2:55
382396,2014-08-17,2014,SFN,PHI,5,2,5-2,SFN,9,true,37,39,76,156,130,286,13,14,27,2,2:57
382391,2014-08-17,2014,BOS,HOU,1,8,8-1,HOU,9,false,37,42,79,154,153,307,12,17,29,0,3:11
382375,2014-08-17,2014,COL,CIN,10,5,10-5,COL,9,true,42,36,78,134,153,287,19,9,28,2,3:06
382392,2014-08-17,2014,MIN,KCA,6,12,12-6,KCA,9,false,37,44,81,151,137,288,10,17,27,1,2:51 (1:28 delay)
382375,2014-08-17,2014,COL,CIN,10,5,10-5,COL,9,true,42,36,78,134,153,287,19,9,28,2,3:06
382399,2014-08-17,2014,DET,SEA,1,8,8-1,SEA,9,false,36,46,82,162,157,319,10,18,28,1,3:18
382397,2014-08-17,2014,WAS,PIT,6,5,6-5,WAS,11,false,47,46,93,159,164,323,15,13,28,2,3:42
382386,2014-08-17,2014,TEX,ANA,3,2,3-2,TEX,9,false,33,37,70,118,134,252,10,13,23,2,2:51
382389,2014-08-17,2014,NYN,CHN,1,2,2-1,CHN,9,false,32,35,67,129,131,260,6,10,16,2,2:55
382388,2014-08-17,2014,CLE,BAL,1,4,4-1,BAL,9,false,32,41,73,161,131,292,7,14,21,5,3:11
382398,2014-08-17,2014,SLN,SDN,7,6,7-6,SLN,9,true,36,40,76,151,134,285,13,13,26,2,2:56
382400,2014-08-17,2014,CHA,TOR,7,5,7-5,CHA,9,true,33,43,76,159,108,267,12,18,30,2,3:00
382394,2014-08-17,2014,TBA,NYA,2,4,4-2,NYA,9,false,33,39,72,159,128,287,6,10,16,1,3:13
382390,2014-08-17,2014,COL,CIN,10,9,10-9,COL,9,false,47,44,91,178,191,369,23,17,40,2,3:59 (:21 delay)
382387,2014-08-17,2014,MIA,ARI,10,3,10-3,MIA,9,true,40,38,78,137,170,307,16,12,28,1,2:56
382403,2014-08-18,2014,PIT,ATL,3,7,7-3,ATL,9,false,37,43,80,150,132,282,12,17,29,3,3:00
382408,2014-08-18,2014,PHI,SEA,4,1,4-1,PHI,9,true,39,35,74,137,150,287,16,10,26,2,2:52
382407,2014-08-18,2014,MIN,KCA,4,6,6-4,KCA,9,false,35,43,78,161,150,311,8,18,26,2,3:09
382406,2014-08-18,2014,SLN,CIN,6,5,6-5,SLN,10,false,41,43,84,166,135,301,14,14,28,2,3:19
382404,2014-08-18,2014,CHA,BAL,2,8,8-2,BAL,9,false,30,42,72,179,105,284,4,16,20,3,3:02
382405,2014-08-18,2014,NYN,CHN,1,4,4-1,CHN,9,false,32,40,72,167,128,295,6,13,19,2,2:53
382402,2014-08-18,2014,WAS,ARI,5,4,5-4,WAS,11,false,40,45,85,162,142,304,10,14,24,1,3:16
382401,2014-08-18,2014,BOS,ANA,2,4,4-2,ANA,9,false,41,36,77,127,171,298,15,12,27,1,3:22
382410,2014-08-19,2014,WAS,ARI,8,1,8-1,WAS,9,true,40,29,69,109,151,260,17,4,21,1,2:50
382412,2014-08-19,2014,CHA,BAL,1,5,5-1,BAL,9,false,31,36,67,130,119,249,4,9,13,0,2:42
382420,2014-08-19,2014,PHI,SEA,2,5,5-2,SEA,9,false,35,40,75,153,127,280,8,14,22,3,3:06
382414,2014-08-19,2014,MIN,CLE,5,7,7-5,CLE,9,false,37,38,75,140,155,295,10,14,24,7,3:14
382411,2014-08-19,2014,PIT,ATL,3,11,11-3,ATL,9,false,36,46,82,162,121,283,9,18,27,2,2:50
382413,2014-08-19,2014,SLN,CIN,5,4,5-4,SLN,9,false,42,37,79,131,167,298,21,8,29,3,3:29
382418,2014-08-19,2014,OAK,NYN,6,2,6-2,OAK,9,true,37,36,73,152,163,315,14,10,24,2,3:02
382417,2014-08-19,2014,COL,KCA,4,7,7-4,KCA,9,false,41,42,83,158,149,307,16,16,32,3,3:12
382419,2014-08-19,2014,LAN,SDN,8,6,8-6,LAN,9,true,36,40,76,148,147,295,11,16,27,3,3:23
382423,2014-08-19,2014,MIL,TOR,6,1,6-1,MIL,9,true,37,30,67,129,120,249,12,3,15,1,2:39
382422,2014-08-19,2014,MIA,TEX,4,3,4-3,MIA,10,false,48,45,93,173,190,363,22,17,39,4,3:59
382415,2014-08-19,2014,TBA,DET,6,8,8-6,DET,11,false,50,53,103,215,204,419,18,22,40,3,4:42
382416,2014-08-19,2014,NYA,HOU,4,7,7-4,HOU,9,false,37,44,81,170,149,319,10,18,28,3,3:38
382409,2014-08-19,2014,BOS,ANA,3,4,4-3,ANA,9,false,40,37,77,138,169,307,14,12,26,1,3:24
382421,2014-08-19,2014,CHN,SFN,2,1,2-1,CHN,9,true,30,37,67,147,132,279,6,11,17,0,2:50 (6:31 delay)
382421,2014-08-19,2014,CHN,SFN,2,1,2-1,CHN,9,true,30,37,67,147,132,279,6,11,17,0,2:50 (6:31 delay)
382430,2014-08-20,2014,TBA,DET,0,6,6-0,DET,9,false,30,38,68,147,104,251,3,10,13,1,2:37
382427,2014-08-20,2014,CHA,BAL,3,4,4-3,BAL,9,false,34,34,68,133,107,240,7,8,15,1,2:37
382425,2014-08-20,2014,WAS,ARI,3,2,3-2,WAS,9,false,36,36,72,143,140,283,14,11,25,2,3:04 (:12 delay)
382432,2014-08-20,2014,COL,KCA,5,2,5-2,COL,9,true,32,31,63,116,111,227,7,8,15,0,2:37
382437,2014-08-20,2014,MIA,TEX,4,5,5-4,TEX,9,false,38,35,73,143,140,283,13,12,25,0,2:55
382426,2014-08-20,2014,PIT,ATL,3,2,3-2,PIT,9,false,32,34,66,118,130,248,7,10,17,1,2:45
382438,2014-08-20,2014,MIL,TOR,5,9,9-5,TOR,9,false,41,43,84,166,152,318,16,18,34,4,3:23
382433,2014-08-20,2014,OAK,NYN,5,8,8-5,NYN,9,false,40,42,82,169,165,334,12,16,28,6,3:20
382428,2014-08-20,2014,SLN,CIN,7,3,7-3,SLN,9,true,41,39,80,141,150,291,18,13,31,4,3:12 (:58 delay)
382434,2014-08-20,2014,LAN,SDN,1,4,4-1,SDN,9,false,35,39,74,155,147,302,10,14,24,0,3:13
382436,2014-08-20,2014,CHN,SFN,3,8,8-3,SFN,9,false,35,43,78,163,134,297,11,17,28,1,3:11
382431,2014-08-20,2014,NYA,HOU,2,5,5-2,HOU,9,false,39,38,77,143,161,304,13,11,24,3,3:29
382424,2014-08-20,2014,BOS,ANA,3,8,8-3,ANA,9,false,40,41,81,149,169,318,13,14,27,1,3:42
382435,2014-08-20,2014,PHI,SEA,4,3,4-3,PHI,9,true,38,40,78,157,140,297,14,14,28,0,3:00
382429,2014-08-20,2014,MIN,CLE,0,5,5-0,CLE,9,false,36,38,74,148,130,278,9,13,22,3,3:02
382445,2014-08-21,2014,LAN,SDN,2,1,2-1,LAN,9,true,28,32,60,119,97,216,6,6,12,0,2:23
382443,2014-08-21,2014,TBA,DET,1,0,1-0,TBA,9,true,26,32,58,137,100,237,1,7,8,0,2:34
382440,2014-08-21,2014,WAS,ARI,1,0,1-0,WAS,9,false,38,32,70,121,136,257,17,8,25,2,2:51
382439,2014-08-21,2014,BOS,ANA,0,2,2-0,ANA,9,false,30,39,69,158,132,290,3,15,18,3,3:10
382444,2014-08-21,2014,NYA,HOU,3,0,3-0,NYA,9,true,30,31,61,107,96,203,7,4,11,0,2:07
382441,2014-08-21,2014,CIN,ATL,0,8,8-0,ATL,9,false,32,45,77,190,119,309,6,19,25,1,3:10
382442,2014-08-21,2014,MIN,CLE,4,1,4-1,MIN,9,true,35,33,68,131,129,260,13,6,19,1,2:54
382446,2014-08-21,2014,CHN,SFN,3,5,5-3,SFN,9,false,37,40,77,153,142,295,10,14,24,1,3:16
382457,2014-08-22,2014,ARI,SDN,5,1,5-1,ARI,9,true,35,30,65,109,128,237,9,4,13,1,2:21
382455,2014-08-22,2014,LAN,NYN,6,2,6-2,LAN,9,true,38,32,70,121,140,261,15,7,22,3,2:40
382450,2014-08-22,2014,NYA,CHA,4,3,4-3,NYA,9,false,41,37,78,135,160,295,17,14,31,4,3:23
382453,2014-08-22,2014,TEX,KCA,3,6,6-3,KCA,9,false,38,40,78,158,157,315,11,11,22,2,3:09
382456,2014-08-22,2014,MIL,PIT,3,8,8-3,PIT,9,false,39,42,81,165,149,314,14,15,29,0,3:14
382449,2014-08-22,2014,CHN,BAL,4,1,4-1,CHN,9,true,33,33,66,123,140,263,9,7,16,1,2:48
382460,2014-08-22,2014,PHI,SLN,5,4,5-4,PHI,9,true,34,35,69,126,134,260,11,9,20,2,2:48
382452,2014-08-22,2014,CLE,HOU,1,5,5-1,HOU,9,false,31,35,66,137,121,258,5,7,12,1,3:01
382461,2014-08-22,2014,TOR,TBA,0,8,8-0,TBA,9,false,28,47,75,186,105,291,2,20,22,1,2:45
382451,2014-08-22,2014,MIN,DET,20,6,20-6,MIN,9,true,55,44,99,172,214,386,29,17,46,7,3:59
382459,2014-08-22,2014,WAS,SFN,3,10,10-3,SFN,9,false,36,43,79,172,159,331,10,16,26,2,3:24
382458,2014-08-22,2014,BOS,SEA,3,5,5-3,SEA,9,false,36,40,76,180,168,348,11,15,26,3,3:41
382447,2014-08-22,2014,OAK,ANA,5,3,5-3,OAK,9,true,35,36,71,128,147,275,12,11,23,1,2:53
382448,2014-08-22,2014,CIN,ATL,1,3,3-1,ATL,12,false,44,52,96,196,184,380,9,18,27,2,4:22
382454,2014-08-22,2014,COL,MIA,5,13,13-5,MIA,9,false,41,52,93,199,147,346,15,27,42,2,3:36
382474,2014-08-23,2014,WAS,SFN,6,2,6-2,WAS,9,true,34,34,68,115,135,250,10,9,19,1,2:38 (1:12 delay)
382472,2014-08-23,2014,ARI,SDN,5,2,5-2,ARI,9,true,37,32,69,114,134,248,14,6,20,1,2:31
382476,2014-08-23,2014,TOR,TBA,5,4,5-4,TOR,10,false,37,42,79,142,161,303,10,14,24,4,3:19
382467,2014-08-23,2014,CLE,HOU,3,2,3-2,CLE,9,false,38,32,70,139,166,305,13,6,19,3,3:18
382468,2014-08-23,2014,TEX,KCA,3,6,6-3,KCA,9,false,33,36,69,130,132,262,9,12,21,2,2:37
382462,2014-08-23,2014,OAK,ANA,2,1,2-1,OAK,9,true,32,34,66,130,134,264,11,7,18,1,3:00
382463,2014-08-23,2014,CIN,ATL,1,0,1-0,CIN,9,true,31,32,63,146,129,275,7,6,13,1,2:47 (1:56 delay)
380910,2014-08-23,2014,MIN,DET,12,4,12-4,MIN,9,true,45,39,84,145,184,329,22,12,34,2,3:12
382464,2014-08-23,2014,CHN,BAL,7,2,7-2,CHN,9,true,37,34,71,139,156,295,13,9,22,1,3:09 (3:09 delay)
382473,2014-08-23,2014,BOS,SEA,3,7,7-3,SEA,9,false,41,38,79,145,183,328,16,12,28,3,3:28
382471,2014-08-23,2014,MIL,PIT,2,10,10-2,PIT,9,false,42,44,86,169,138,307,17,17,34,1,3:17
380910,2014-08-23,2014,MIN,DET,12,4,12-4,MIN,9,true,45,39,84,145,184,329,22,12,34,2,3:12
382475,2014-08-23,2014,PHI,SLN,5,6,6-5,SLN,12,false,49,57,106,221,198,419,13,23,36,4,4:53
382466,2014-08-23,2014,MIN,DET,6,8,8-6,DET,9,false,40,43,83,148,146,294,14,18,32,3,3:23
382470,2014-08-23,2014,LAN,NYN,7,4,7-4,LAN,9,true,34,39,73,142,117,259,10,14,24,2,2:51
382469,2014-08-23,2014,COL,MIA,5,4,5-4,COL,13,false,50,58,108,219,180,399,18,19,37,3,4:28
382465,2014-08-23,2014,NYA,CHA,5,3,5-3,NYA,9,true,33,38,71,147,105,252,11,11,22,1,2:54
382479,2014-08-24,2014,CHN,BAL,2,1,2-1,CHN,9,true,31,31,62,129,116,245,7,4,11,2,2:37
382486,2014-08-24,2014,MIL,PIT,4,3,4-3,MIL,9,true,35,33,68,138,103,241,14,6,20,1,2:40
382484,2014-08-24,2014,COL,MIA,7,4,7-4,COL,9,true,40,39,79,125,142,267,19,13,32,4,3:07
382485,2014-08-24,2014,LAN,NYN,3,11,11-3,NYN,9,false,36,42,78,134,152,286,11,14,25,1,3:02
382477,2014-08-24,2014,OAK,ANA,4,9,9-4,ANA,9,false,37,42,79,148,141,289,10,17,27,2,3:05
382480,2014-08-24,2014,NYA,CHA,7,4,7-4,NYA,10,false,42,39,81,146,166,312,16,10,26,2,3:17
382478,2014-08-24,2014,CIN,ATL,5,3,5-3,CIN,9,true,36,40,76,165,148,313,13,15,28,3,3:13
382488,2014-08-24,2014,BOS,SEA,6,8,8-6,SEA,9,false,48,40,88,152,198,350,22,17,39,6,4:07
382490,2014-08-24,2014,PHI,SLN,7,1,7-1,PHI,9,true,34,36,70,122,122,244,10,9,19,1,2:33
382483,2014-08-24,2014,TEX,KCA,3,1,3-1,TEX,9,true,38,34,72,121,136,257,17,7,24,0,2:46
382491,2014-08-24,2014,TOR,TBA,1,2,2-1,TBA,10,false,39,42,81,171,138,309,9,13,22,1,3:28
382482,2014-08-24,2014,CLE,HOU,3,1,3-1,CLE,9,true,35,39,74,177,122,299,11,14,25,2,3:14
382481,2014-08-24,2014,MIN,DET,4,13,13-4,DET,9,false,43,53,96,196,202,398,16,28,44,3,4:10
382487,2014-08-24,2014,ARI,SDN,4,7,7-4,SDN,9,false,41,40,81,152,154,306,14,14,28,3,3:10
382489,2014-08-24,2014,WAS,SFN,14,6,14-6,WAS,9,true,46,41,87,139,185,324,24,14,38,3,3:46
382493,2014-08-25,2014,SFN,COL,2,3,3-2,COL,9,false,35,34,69,122,127,249,12,7,19,0,2:47
382497,2014-08-25,2014,PIT,SLN,2,3,3-2,SLN,9,false,34,37,71,134,121,255,11,12,23,2,2:55
382495,2014-08-25,2014,SDN,MIL,1,10,10-1,MIL,9,false,36,49,85,175,133,308,12,23,35,2,3:10
382496,2014-08-25,2014,HOU,OAK,2,8,8-2,OAK,9,false,35,42,77,164,129,293,9,15,24,1,3:18
382500,2014-08-25,2014,PHI,WAS,3,2,3-2,PHI,9,true,31,36,67,137,134,271,10,9,19,0,2:46
382492,2014-08-25,2014,TOR,BOS,3,4,4-3,BOS,10,false,37,40,77,168,127,295,8,11,19,1,3:07
381492,2014-08-25,2014,KCA,NYA,1,8,8-1,NYA,9,false,33,41,74,141,121,262,7,16,23,3,3:02
381492,2014-08-25,2014,KCA,NYA,1,8,8-1,NYA,9,false,33,41,74,141,121,262,7,16,23,3,3:02
382499,2014-08-25,2014,SEA,TEX,0,2,2-0,TEX,9,false,30,37,67,153,109,262,5,11,16,0,2:50
382494,2014-08-25,2014,ANA,MIA,1,7,7-1,MIA,9,false,36,43,79,167,130,297,9,17,26,2,2:57
382498,2014-08-25,2014,BAL,TBA,9,1,9-1,BAL,9,true,40,32,72,112,163,275,16,6,22,1,2:56
382505,2014-08-26,2014,SFN,COL,3,0,3-0,SFN,9,true,32,28,60,103,119,222,7,1,8,2,2:33
382514,2014-08-26,2014,SEA,TEX,5,0,5-0,SEA,9,true,36,34,70,151,141,292,12,8,20,1,2:51
382508,2014-08-26,2014,SDN,MIL,4,1,4-1,SDN,9,true,36,31,67,135,143,278,11,7,18,1,2:57
382509,2014-08-26,2014,KCA,MIN,2,1,2-1,KCA,9,false,30,31,61,126,114,240,8,7,15,1,2:38
382501,2014-08-26,2014,NYN,ATL,3,2,3-2,NYN,9,true,30,33,63,125,120,245,7,10,17,1,2:27
382510,2014-08-26,2014,DET,NYA,5,2,5-2,DET,9,true,34,34,68,110,106,216,12,9,21,1,2:30 (1:08 delay)
382515,2014-08-26,2014,PHI,WAS,4,3,4-3,PHI,9,true,31,35,66,106,107,213,8,9,17,1,2:24
382512,2014-08-26,2014,PIT,SLN,5,2,5-2,PIT,9,true,37,36,73,156,129,285,13,9,22,1,2:56
382507,2014-08-26,2014,ANA,MIA,8,2,8-2,ANA,9,true,42,37,79,150,135,285,19,10,29,2,3:01
382503,2014-08-26,2014,CIN,CHN,0,3,3-0,CHN,9,false,32,37,69,129,138,267,5,10,15,1,2:42 (:50 delay)
382511,2014-08-26,2014,HOU,OAK,4,2,4-2,HOU,9,true,32,37,69,150,104,254,7,9,16,0,2:36
382513,2014-08-26,2014,BAL,TBA,4,2,4-2,BAL,9,true,37,38,75,157,162,319,13,13,26,2,3:37
382504,2014-08-26,2014,CHA,CLE,6,8,8-6,CLE,10,false,40,46,86,188,149,337,14,19,33,8,3:48
382506,2014-08-26,2014,ARI,LAN,5,9,9-5,LAN,9,false,41,42,83,155,142,297,14,18,32,3,3:22
382502,2014-08-26,2014,TOR,BOS,7,11,11-7,BOS,11,false,53,53,106,226,213,439,22,18,40,6,4:33
382517,2014-08-27,2014,TOR,BOS,5,2,5-2,TOR,9,true,33,33,66,126,123,249,9,7,16,3,2:38
382516,2014-08-27,2014,NYN,ATL,2,3,3-2,ATL,9,false,36,34,70,130,144,274,10,9,19,1,2:48
382530,2014-08-27,2014,PHI,WAS,8,4,8-4,PHI,9,true,42,36,78,148,144,292,20,10,30,2,3:04 (:38 delay)
382524,2014-08-27,2014,KCA,MIN,6,1,6-1,KCA,9,true,33,32,65,121,109,230,10,5,15,2,2:27
382527,2014-08-27,2014,PIT,SLN,3,1,3-1,PIT,9,true,36,35,71,114,132,246,12,9,21,1,2:43
382528,2014-08-27,2014,BAL,TBA,1,3,3-1,TBA,9,false,31,36,67,135,107,242,3,9,12,0,2:44
382529,2014-08-27,2014,SEA,TEX,4,12,12-4,TEX,9,false,34,40,74,128,112,240,8,13,21,1,2:24
382519,2014-08-27,2014,CHA,CLE,3,2,3-2,CHA,9,true,35,35,70,135,131,266,12,9,21,4,3:07
382525,2014-08-27,2014,DET,NYA,4,8,8-4,NYA,9,false,39,42,81,174,141,315,11,17,28,1,3:29
382521,2014-08-27,2014,ARI,LAN,1,3,3-1,LAN,9,false,35,38,73,144,121,265,8,14,22,1,2:55
382522,2014-08-27,2014,ANA,MIA,6,1,6-1,ANA,9,true,39,35,74,148,134,282,12,9,21,2,2:51
382523,2014-08-27,2014,SDN,MIL,3,2,3-2,SDN,10,false,43,37,80,140,193,333,17,7,24,0,3:36
382518,2014-08-27,2014,CIN,CHN,7,5,7-5,CIN,9,true,39,38,77,143,136,279,16,13,29,3,3:19
382526,2014-08-27,2014,HOU,OAK,4,5,5-4,OAK,9,false,40,42,82,172,160,332,14,18,32,6,3:43
382520,2014-08-27,2014,SFN,COL,4,2,4-2,SFN,9,false,39,33,72,102,152,254,13,9,22,1,2:54
382534,2014-08-28,2014,SFN,COL,4,1,4-1,SFN,9,true,36,32,68,118,150,268,12,7,19,0,2:50
382533,2014-08-28,2014,CHA,CLE,2,3,3-2,CLE,9,false,35,40,75,165,143,308,7,14,21,3,3:18
382538,2014-08-28,2014,BAL,TBA,5,4,5-4,BAL,9,true,38,36,74,138,148,286,16,10,26,3,3:26
382531,2014-08-28,2014,NYN,ATL,1,6,6-1,ATL,9,false,31,39,70,128,122,250,5,14,19,3,2:31
382536,2014-08-28,2014,DET,NYA,3,2,3-2,DET,9,false,35,33,68,131,131,262,9,7,16,2,2:54
382539,2014-08-28,2014,HOU,TEX,4,2,4-2,HOU,9,true,35,35,70,132,146,278,13,9,22,1,3:04
382537,2014-08-28,2014,ANA,OAK,4,3,4-3,ANA,10,false,41,41,82,168,148,316,15,13,28,3,3:44
382535,2014-08-28,2014,KCA,MIN,5,11,11-5,MIN,10,false,46,49,95,181,173,354,17,20,37,4,3:50
382532,2014-08-28,2014,CIN,CHN,7,2,7-2,CIN,9,true,41,34,75,151,166,317,16,9,25,0,3:14
382542,2014-08-29,2014,PIT,CIN,2,1,2-1,PIT,9,true,31,34,65,130,94,224,9,9,18,1,2:30
382547,2014-08-29,2014,ATL,MIA,5,2,5-2,ATL,9,true,36,35,71,140,141,281,13,11,24,2,3:01
382552,2014-08-29,2014,NYN,PHI,4,1,4-1,NYN,9,true,32,35,67,138,104,242,8,7,15,2,2:31
382549,2014-08-29,2014,BAL,MIN,9,1,9-1,BAL,9,true,36,32,68,128,136,264,12,5,17,1,2:40
382551,2014-08-29,2014,ANA,OAK,4,0,4-0,ANA,9,true,34,36,70,136,129,265,8,9,17,0,2:54
382545,2014-08-29,2014,CHA,DET,1,7,7-1,DET,9,false,39,41,80,161,140,301,14,13,27,3,3:28
382543,2014-08-29,2014,KCA,CLE,1,6,6-1,CLE,9,false,40,41,81,176,136,312,13,15,28,2,3:17 (:44 delay)
382553,2014-08-29,2014,HOU,TEX,6,13,13-6,TEX,9,false,40,44,84,153,157,310,16,19,35,2,3:16
382550,2014-08-29,2014,TOR,NYA,3,6,6-3,NYA,9,false,38,40,78,151,152,303,11,13,24,5,3:20
382554,2014-08-29,2014,SEA,WAS,3,8,8-3,WAS,9,false,38,41,79,148,147,295,11,16,27,1,2:55
382540,2014-08-29,2014,TBA,BOS,4,8,8-4,BOS,9,false,40,45,85,173,146,319,13,17,30,0,3:34
382548,2014-08-29,2014,SFN,MIL,13,2,13-2,SFN,9,true,49,32,81,110,198,308,26,6,32,1,3:17
382544,2014-08-29,2014,ARI,COL,5,2,5-2,ARI,9,true,34,32,66,126,145,271,12,6,18,4,2:54
382546,2014-08-29,2014,SDN,LAN,3,2,3-2,SDN,12,false,49,49,98,198,182,380,15,14,29,2,4:12
382541,2014-08-29,2014,SLN,CHN,2,7,7-2,CHN,9,false,38,37,75,128,141,269,10,11,21,1,2:52
382557,2014-08-30,2014,PIT,CIN,3,2,3-2,PIT,9,true,29,32,61,126,108,234,7,6,13,1,2:34
382566,2014-08-30,2014,ANA,OAK,2,0,2-0,ANA,9,true,29,31,60,149,102,251,4,6,10,1,2:46
382565,2014-08-30,2014,TOR,NYA,2,0,2-0,TOR,9,true,32,32,64,131,119,250,8,5,13,1,2:32
382563,2014-08-30,2014,SFN,MIL,3,1,3-1,SFN,9,true,36,34,70,134,133,267,13,9,22,2,2:57
382560,2014-08-30,2014,CHA,DET,4,8,8-4,DET,9,false,37,43,80,151,158,309,11,19,30,4,3:23
382567,2014-08-30,2014,NYN,PHI,2,7,7-2,PHI,9,false,35,41,76,143,140,283,9,16,25,3,2:58
381134,2014-08-30,2014,SLN,CHN,1,5,5-1,CHN,9,false,34,35,69,134,117,251,9,9,18,1,2:40
382555,2014-08-30,2014,TBA,BOS,7,0,7-0,TBA,9,true,38,32,70,122,137,259,14,6,20,1,2:48 (:12 delay)
381134,2014-08-30,2014,SLN,CHN,1,5,5-1,CHN,9,false,34,35,69,134,117,251,9,9,18,1,2:40
382559,2014-08-30,2014,ARI,COL,0,2,2-0,COL,9,false,36,30,66,115,142,257,9,3,12,2,2:37
382564,2014-08-30,2014,BAL,MIN,3,2,3-2,BAL,9,true,37,40,77,153,139,292,13,13,26,1,3:12
382562,2014-08-30,2014,ATL,MIA,0,4,4-0,MIA,9,false,34,42,76,158,127,285,10,13,23,3,2:54
382558,2014-08-30,2014,KCA,CLE,2,3,3-2,CLE,11,false,51,42,93,173,214,387,20,10,30,5,4:23
382556,2014-08-30,2014,SLN,CHN,13,2,13-2,SLN,9,true,42,37,79,142,146,288,20,10,30,2,3:16
382561,2014-08-30,2014,SDN,LAN,2,1,2-1,SDN,10,false,35,41,76,155,132,287,10,11,21,1,3:20
382569,2014-08-30,2014,SEA,WAS,1,3,3-1,WAS,9,false,35,36,71,141,116,257,8,11,19,2,2:54
382568,2014-08-30,2014,HOU,TEX,2,0,2-0,HOU,9,true,33,30,63,115,122,237,9,4,13,1,2:25
381500,2014-08-30,2014,CHA,DET,6,3,6-3,CHA,9,true,36,37,73,153,133,286,11,12,23,3,2:54
381500,2014-08-30,2014,CHA,DET,6,3,6-3,CHA,9,true,36,37,73,153,133,286,11,12,23,3,2:54
382580,2014-08-31,2014,TOR,NYA,4,3,4-3,TOR,9,true,32,38,70,136,119,255,9,12,21,1,2:28
382574,2014-08-31,2014,ARI,COL,6,2,6-2,ARI,9,true,37,35,72,140,135,275,14,8,22,1,3:04
382570,2014-08-31,2014,TBA,BOS,0,3,3-0,BOS,9,false,29,36,65,148,98,246,3,10,13,2,2:52
382582,2014-08-31,2014,NYN,PHI,6,5,6-5,NYN,9,true,36,42,78,152,140,292,12,17,29,1,3:14
382577,2014-08-31,2014,ATL,MIA,1,0,1-0,ATL,9,true,36,32,68,117,136,253,12,6,18,1,2:33
382583,2014-08-31,2014,HOU,TEX,3,2,3-2,HOU,9,true,39,35,74,138,160,298,17,10,27,3,3:18
382578,2014-08-31,2014,SFN,MIL,15,5,15-5,SFN,9,true,45,38,83,155,150,305,21,12,33,4,3:14
382581,2014-08-31,2014,ANA,OAK,8,1,8-1,ANA,9,true,36,34,70,128,147,275,12,7,19,1,2:54
382575,2014-08-31,2014,CHA,DET,6,2,6-2,CHA,9,true,41,33,74,126,127,253,13,7,20,2,3:04
382571,2014-08-31,2014,SLN,CHN,9,6,9-6,SLN,9,true,41,42,83,142,160,302,19,16,35,4,3:26
382572,2014-08-31,2014,PIT,CIN,2,3,3-2,CIN,9,false,35,37,72,142,127,269,10,10,20,1,3:01
382579,2014-08-31,2014,BAL,MIN,12,8,12-8,BAL,9,true,47,43,90,174,150,324,26,18,44,6,3:33
382576,2014-08-31,2014,SDN,LAN,1,7,7-1,LAN,9,false,31,44,75,186,104,290,5,20,25,2,3:04
382573,2014-08-31,2014,KCA,CLE,3,4,4-3,CLE,10,false,38,44,82,174,129,303,10,13,23,1,3:24 (:58 delay)
382573,2014-08-31,2014,KCA,CLE,3,4,4-3,CLE,10,false,38,44,82,174,129,303,10,13,23,1,3:24 (:58 delay)
382584,2014-08-31,2014,SEA,WAS,5,3,5-3,SEA,9,true,35,36,71,138,119,257,13,8,21,3,2:57
382588,2014-09-01,2014,CHN,MIL,4,2,4-2,CHN,9,true,33,33,66,123,115,238,13,8,21,2,2:47
382592,2014-09-01,2014,SLN,PIT,5,4,5-4,SLN,9,true,36,42,78,167,121,288,14,16,30,3,3:08
382593,2014-09-01,2014,OAK,SEA,6,1,6-1,OAK,9,true,39,31,70,126,140,266,16,5,21,2,2:30
382585,2014-09-01,2014,SDN,ARI,3,1,3-1,SDN,9,true,40,35,75,145,152,297,18,8,26,1,3:03
382589,2014-09-01,2014,BAL,MIN,4,6,6-4,MIN,9,false,34,36,70,122,109,231,6,9,15,1,2:36
382591,2014-09-01,2014,ATL,PHI,0,7,7-0,PHI,9,false,33,41,74,152,147,299,6,17,23,2,3:10
382596,2014-09-01,2014,LAN,WAS,4,6,6-4,WAS,9,false,36,38,74,161,124,285,9,12,21,3,3:12
382586,2014-09-01,2014,TBA,BOS,4,3,4-3,TBA,10,false,39,37,76,161,162,323,13,9,22,4,3:32
382587,2014-09-01,2014,CLE,DET,1,12,12-1,DET,9,false,37,50,87,177,133,310,11,26,37,2,3:31
382590,2014-09-01,2014,MIA,NYN,9,6,9-6,MIA,9,true,41,39,80,155,176,331,19,13,32,4,3:32
382595,2014-09-01,2014,KCA,TEX,4,3,4-3,KCA,9,true,35,34,69,122,118,240,12,9,21,2,2:31
382594,2014-09-01,2014,COL,SFN,10,9,10-9,COL,9,false,46,43,89,156,160,316,19,19,38,4,3:44
382605,2014-09-02,2014,ATL,PHI,0,4,4-0,PHI,9,false,32,38,70,139,126,265,7,11,18,1,2:57
382609,2014-09-02,2014,KCA,TEX,2,1,2-1,KCA,9,true,32,36,68,137,130,267,9,12,21,2,3:00
382603,2014-09-02,2014,CHN,MIL,7,1,7-1,CHN,9,true,38,37,75,144,144,288,13,13,26,0,3:12
382610,2014-09-02,2014,TBA,TOR,2,8,8-2,TOR,9,false,34,42,76,179,134,313,7,16,23,2,3:07
382601,2014-09-02,2014,BAL,CIN,5,4,5-4,BAL,9,true,32,38,70,148,113,261,11,11,22,2,3:07 (2:09 delay)
382604,2014-09-02,2014,MIA,NYN,6,8,8-6,NYN,9,false,37,44,81,163,133,296,11,19,30,2,3:10
382606,2014-09-02,2014,SLN,PIT,6,4,6-4,SLN,9,true,37,35,72,143,165,308,13,9,22,2,3:05
382597,2014-09-02,2014,HOU,ANA,8,3,8-3,HOU,9,true,41,35,76,135,172,307,19,8,27,4,3:13
382599,2014-09-02,2014,NYA,BOS,4,9,9-4,BOS,9,false,37,46,83,187,144,331,12,19,31,3,3:28
382608,2014-09-02,2014,COL,SFN,7,12,12-7,SFN,9,false,39,46,85,153,155,308,13,19,32,4,3:37
382600,2014-09-02,2014,MIN,CHA,3,6,6-3,CHA,10,false,37,45,82,196,143,339,11,18,29,4,3:35
382602,2014-09-02,2014,CLE,DET,2,4,4-2,DET,9,false,40,43,83,175,162,337,14,18,32,6,3:52
382607,2014-09-02,2014,OAK,SEA,5,6,6-5,SEA,9,false,35,35,70,121,124,245,12,10,22,2,2:42
382598,2014-09-02,2014,SDN,ARI,2,1,2-1,SDN,9,false,34,33,67,138,107,245,12,7,19,0,2:28
382611,2014-09-02,2014,LAN,WAS,4,1,4-1,LAN,9,true,36,33,69,123,133,256,13,5,18,2,2:40
382622,2014-09-03,2014,OAK,SEA,1,2,2-1,SEA,9,false,31,34,65,118,110,228,5,8,13,0,2:20
382613,2014-09-03,2014,SDN,ARI,1,6,6-1,ARI,9,false,32,39,71,137,113,250,7,11,18,2,2:43
382614,2014-09-03,2014,NYA,BOS,5,1,5-1,NYA,9,true,36,33,69,132,147,279,15,7,22,1,3:12
382616,2014-09-03,2014,BAL,CIN,6,0,6-0,BAL,9,true,33,33,66,117,142,259,10,5,15,1,2:36
382623,2014-09-03,2014,COL,SFN,9,2,9-2,COL,9,true,41,35,76,108,143,251,17,10,27,1,2:53
382617,2014-09-03,2014,CLE,DET,7,0,7-0,CLE,9,true,35,33,68,118,131,249,12,8,20,1,2:37
382624,2014-09-03,2014,KCA,TEX,4,1,4-1,KCA,9,true,29,37,66,145,105,250,6,9,15,3,2:46
382620,2014-09-03,2014,ATL,PHI,7,4,7-4,ATL,9,true,41,37,78,141,170,311,16,11,27,2,3:08
382618,2014-09-03,2014,CHN,MIL,6,2,6-2,CHN,9,true,37,37,74,129,127,256,14,11,25,1,2:53
382619,2014-09-03,2014,MIA,NYN,3,4,4-3,NYN,9,false,36,41,77,151,147,298,13,17,30,3,3:07
382621,2014-09-03,2014,SLN,PIT,1,0,1-0,SLN,9,false,35,33,68,138,116,254,10,9,19,1,2:50
382612,2014-09-03,2014,HOU,ANA,4,1,4-1,HOU,9,true,32,32,64,111,113,224,9,4,13,2,2:37
382625,2014-09-03,2014,TBA,TOR,4,7,7-4,TOR,9,false,37,41,78,160,132,292,12,15,27,0,3:09 (:30 delay)
382626,2014-09-03,2014,LAN,WAS,5,8,8-5,WAS,14,false,59,62,121,240,227,467,19,19,38,5,5:34
382615,2014-09-03,2014,MIN,CHA,11,4,11-4,MIN,9,true,48,37,85,139,173,312,24,10,34,2,3:12 (:16 delay)
382633,2014-09-04,2014,TBA,TOR,0,1,1-0,TOR,10,false,37,35,72,134,135,269,11,5,16,1,2:49
382628,2014-09-04,2014,SDN,ARI,1,5,5-1,ARI,9,false,32,41,73,146,128,274,5,15,20,3,2:59
382627,2014-09-04,2014,MIN,ANA,4,5,5-4,ANA,9,false,41,37,78,117,149,266,15,12,27,1,3:13
382631,2014-09-04,2014,TEX,SEA,2,10,10-2,SEA,9,false,36,44,80,173,126,299,13,17,30,3,3:02
382632,2014-09-04,2014,MIL,SLN,2,3,3-2,SLN,9,false,40,41,81,153,153,306,13,18,31,5,3:35
382630,2014-09-04,2014,BAL,CIN,9,7,9-7,BAL,9,true,39,41,80,171,163,334,16,14,30,3,3:26
381682,2014-09-04,2014,CLE,DET,4,11,11-4,DET,11,false,44,54,98,198,195,393,12,24,36,4,4:32
382629,2014-09-04,2014,NYA,BOS,5,4,5-4,NYA,9,false,34,37,71,147,136,283,10,9,19,4,3:16
382635,2014-09-05,2014,LAN,ARI,2,1,2-1,LAN,9,true,33,33,66,139,121,260,10,6,16,2,2:44
382639,2014-09-05,2014,OAK,HOU,3,4,4-3,HOU,9,false,38,34,72,125,144,269,10,7,17,2,3:08
382636,2014-09-05,2014,MIA,ATL,11,3,11-3,MIA,9,true,43,33,76,109,167,276,21,6,27,3,2:48
382637,2014-09-05,2014,TBA,BAL,3,0,3-0,TBA,9,true,37,32,69,134,154,288,14,7,21,2,3:08
382647,2014-09-05,2014,MIL,SLN,6,2,6-2,MIL,9,true,35,36,71,143,134,277,12,10,22,1,3:08
382645,2014-09-05,2014,TEX,SEA,5,7,7-5,SEA,9,false,41,38,79,140,165,305,15,11,26,5,3:27
382643,2014-09-05,2014,CHN,PIT,3,5,5-3,PIT,11,false,47,48,95,191,173,364,14,17,31,3,4:19 (1:52 delay)
382643,2014-09-05,2014,CHN,PIT,3,5,5-3,PIT,11,false,47,48,95,191,173,364,14,17,31,3,4:19 (1:52 delay)
382644,2014-09-05,2014,COL,SDN,3,0,3-0,COL,9,true,33,31,64,103,129,232,10,4,14,2,2:28
382646,2014-09-05,2014,DET,SFN,2,8,8-2,SFN,9,false,33,44,77,154,112,266,8,19,27,0,2:48 (2:42 delay)
382640,2014-09-05,2014,NYA,KCA,0,1,1-0,KCA,9,false,31,30,61,121,108,229,4,3,7,1,2:33
382638,2014-09-05,2014,CLE,CHA,2,1,2-1,CLE,10,false,36,42,78,162,155,317,12,15,27,3,3:13
382648,2014-09-05,2014,BOS,TOR,9,8,9-8,BOS,10,false,49,44,93,150,186,336,21,17,38,5,3:53
382641,2014-09-05,2014,CIN,NYN,5,14,14-5,NYN,9,false,38,54,92,218,119,337,12,27,39,3,3:34
382642,2014-09-05,2014,WAS,PHI,8,9,9-8,PHI,11,false,51,47,98,203,192,395,23,14,37,5,4:32
382634,2014-09-05,2014,MIN,ANA,6,7,7-6,ANA,10,false,46,51,97,197,194,391,18,20,38,5,4:30
382653,2014-09-06,2014,CLE,CHA,3,1,3-1,CLE,9,true,35,33,68,104,134,238,11,5,16,0,2:46
382654,2014-09-06,2014,OAK,HOU,4,3,4-3,OAK,9,false,34,37,71,123,122,245,9,11,20,2,2:40
382650,2014-09-06,2014,LAN,ARI,5,2,5-2,LAN,9,true,31,36,67,147,112,259,9,10,19,3,3:02
382652,2014-09-06,2014,TBA,BAL,3,2,3-2,TBA,9,false,37,36,73,141,133,274,11,10,21,3,3:06
382656,2014-09-06,2014,CIN,NYN,2,1,2-1,CIN,9,true,31,36,67,153,122,275,8,11,19,1,2:47
382655,2014-09-06,2014,NYA,KCA,6,2,6-2,NYA,9,true,36,33,69,127,136,263,12,7,19,1,2:48
382660,2014-09-06,2014,TEX,SEA,2,4,4-2,SEA,9,false,38,40,78,145,143,288,12,14,26,2,3:00 (3:13 delay)
382662,2014-09-06,2014,MIL,SLN,3,5,5-3,SLN,9,false,38,34,72,140,146,286,12,7,19,2,3:02
382651,2014-09-06,2014,MIA,ATL,3,4,4-3,ATL,10,false,39,44,83,156,157,313,10,15,25,4,3:28
382657,2014-09-06,2014,WAS,PHI,1,3,3-1,PHI,9,false,34,34,68,123,123,246,9,7,16,0,2:33
382658,2014-09-06,2014,CHN,PIT,0,5,5-0,PIT,9,false,35,42,77,177,151,328,9,16,25,1,3:20
382649,2014-09-06,2014,MIN,ANA,5,8,8-5,ANA,9,false,38,42,80,153,150,303,15,16,31,3,3:20
382661,2014-09-06,2014,DET,SFN,4,5,5-4,SFN,9,false,36,38,74,116,139,255,11,10,21,1,3:08
382659,2014-09-06,2014,COL,SDN,7,6,7-6,COL,12,false,56,51,107,194,205,399,24,17,41,7,4:52
382663,2014-09-06,2014,BOS,TOR,4,3,4-3,BOS,9,true,36,39,75,151,145,296,12,13,25,4,3:23 (1:12 delay)
382668,2014-09-07,2014,CLE,CHA,2,0,2-0,CLE,9,true,32,31,63,106,117,223,11,4,15,3,2:36
382675,2014-09-07,2014,TEX,SEA,1,0,1-0,TEX,9,true,30,34,64,125,128,253,8,9,17,2,2:42
382666,2014-09-07,2014,MIA,ATL,4,0,4-0,MIA,9,true,32,33,65,117,118,235,10,6,16,2,2:44
382674,2014-09-07,2014,COL,SDN,6,0,6-0,COL,9,true,38,34,72,134,152,286,18,8,26,1,3:04
382665,2014-09-07,2014,LAN,ARI,7,2,7-2,LAN,9,true,38,35,73,132,145,277,13,9,22,2,3:11
382677,2014-09-07,2014,MIL,SLN,1,9,9-1,SLN,9,false,32,40,72,171,100,271,8,15,23,1,3:01
382678,2014-09-07,2014,BOS,TOR,1,3,3-1,TOR,9,false,34,36,70,144,134,278,7,12,19,2,2:44
382667,2014-09-07,2014,TBA,BAL,5,7,7-5,BAL,11,false,52,50,102,211,193,404,20,19,39,6,4:36
382671,2014-09-07,2014,CIN,NYN,3,4,4-3,NYN,9,false,40,41,81,167,153,320,15,14,29,1,3:34
382670,2014-09-07,2014,NYA,KCA,0,2,2-0,KCA,9,false,34,36,70,160,139,299,8,12,20,2,3:16
382669,2014-09-07,2014,OAK,HOU,3,4,4-3,HOU,9,false,39,40,79,149,148,297,13,16,29,4,3:15
382676,2014-09-07,2014,DET,SFN,6,1,6-1,DET,9,true,36,38,74,161,148,309,15,12,27,4,3:43
382664,2014-09-07,2014,MIN,ANA,4,14,14-4,ANA,9,false,37,52,89,180,157,337,10,24,34,3,3:20
382673,2014-09-07,2014,CHN,PIT,4,10,10-4,PIT,9,false,39,46,85,167,164,331,14,20,34,3,3:17
382672,2014-09-07,2014,WAS,PHI,3,2,3-2,WAS,9,true,35,32,67,145,155,300,12,7,19,2,3:20
382681,2014-09-08,2014,TOR,CHN,8,0,8-0,TOR,9,true,36,29,65,93,132,225,13,3,16,1,2:20
382679,2014-09-08,2014,WAS,ATL,2,1,2-1,WAS,9,true,33,34,67,147,111,258,11,8,19,3,2:39
382687,2014-09-08,2014,PHI,PIT,4,6,6-4,PIT,9,false,35,41,76,145,133,278,7,14,21,3,3:08
382682,2014-09-08,2014,NYN,COL,3,2,3-2,NYN,9,false,34,37,71,140,154,294,9,11,20,2,2:53
382680,2014-09-08,2014,BOS,BAL,0,4,4-0,BAL,9,false,35,40,75,147,146,293,10,13,23,5,3:08
382688,2014-09-08,2014,LAN,SDN,9,4,9-4,LAN,9,true,42,33,75,101,185,286,19,6,25,2,3:04
382684,2014-09-08,2014,DET,KCA,9,5,9-5,DET,9,true,41,36,77,151,163,314,18,10,28,3,3:19
382686,2014-09-08,2014,CHA,OAK,5,4,5-4,CHA,12,false,44,45,89,170,163,333,11,12,23,3,3:38
382685,2014-09-08,2014,MIL,MIA,4,6,6-4,MIA,9,false,34,39,73,143,119,262,10,13,23,2,2:50
382689,2014-09-08,2014,CIN,SLN,0,5,5-0,SLN,9,false,28,42,70,150,96,246,3,14,17,6,3:00
382683,2014-09-08,2014,SEA,HOU,4,1,4-1,SEA,9,true,39,39,78,161,162,323,16,13,29,4,3:42
381608,2014-09-08,2014,CLE,ANA,3,12,12-3,ANA,9,false,38,44,82,176,147,323,12,20,32,3,3:16
381608,2014-09-08,2014,CLE,ANA,3,12,12-3,ANA,9,false,38,44,82,176,147,323,12,20,32,3,3:16
382696,2014-09-09,2014,SEA,HOU,1,2,2-1,HOU,9,false,29,37,66,139,111,250,2,11,13,2,2:57
382691,2014-09-09,2014,SFN,ARI,5,1,5-1,SFN,9,true,39,29,68,84,152,236,15,4,19,0,2:29
382704,2014-09-09,2014,NYA,TBA,3,4,4-3,TBA,9,false,32,39,71,140,117,257,8,13,21,7,3:18
382701,2014-09-09,2014,PHI,PIT,4,3,4-3,PHI,9,true,33,37,70,132,122,254,11,11,22,0,2:56
382699,2014-09-09,2014,CLE,MIN,3,4,4-3,MIN,9,false,38,34,72,123,168,291,13,8,21,3,3:04
382697,2014-09-09,2014,DET,KCA,4,2,4-2,DET,9,true,36,40,76,152,136,288,12,15,27,3,3:26
382702,2014-09-09,2014,LAN,SDN,3,6,6-3,SDN,9,false,38,39,77,153,136,289,13,12,25,1,3:03
382690,2014-09-09,2014,TEX,ANA,3,9,9-3,ANA,9,false,38,40,78,138,161,299,12,13,25,3,3:04
382693,2014-09-09,2014,BOS,BAL,1,4,4-1,BAL,9,false,36,40,76,149,174,323,12,13,25,3,3:32
382692,2014-09-09,2014,WAS,ATL,6,4,6-4,WAS,9,true,37,34,71,135,144,279,14,7,21,2,3:02
382695,2014-09-09,2014,NYN,COL,2,0,2-0,NYN,9,true,33,33,66,125,125,250,9,6,15,2,2:41
382700,2014-09-09,2014,CHA,OAK,2,11,11-2,OAK,9,false,35,49,84,178,133,311,10,19,29,0,3:19
382694,2014-09-09,2014,TOR,CHN,9,2,9-2,TOR,9,true,40,40,80,128,162,290,18,14,32,2,3:04
382698,2014-09-09,2014,MIL,MIA,3,6,6-3,MIA,9,false,43,42,85,183,146,329,16,17,33,3,3:50
382703,2014-09-09,2014,CIN,SLN,9,5,9-5,CIN,9,true,44,42,86,192,156,348,20,16,36,5,3:33
382711,2014-09-10,2014,SEA,HOU,2,5,5-2,HOU,9,false,32,39,71,149,125,274,8,12,20,2,3:01
382710,2014-09-10,2014,NYN,COL,2,0,2-0,NYN,9,true,32,34,66,157,113,270,9,9,18,3,2:53
382717,2014-09-10,2014,LAN,SDN,4,0,4-0,LAN,9,true,34,31,65,131,134,265,14,6,20,1,2:45
382715,2014-09-10,2014,CHA,OAK,2,1,2-1,CHA,9,true,33,33,66,133,140,273,12,8,20,1,3:15
382707,2014-09-10,2014,WAS,ATL,2,6,6-2,ATL,9,false,35,42,77,155,123,278,8,16,24,1,3:01
382713,2014-09-10,2014,MIL,MIA,4,1,4-1,MIL,9,true,34,36,70,145,121,266,10,10,20,4,2:59
382718,2014-09-10,2014,CIN,SLN,4,2,4-2,CIN,9,true,34,34,68,138,137,275,14,10,24,2,2:51
382706,2014-09-10,2014,SFN,ARI,5,0,5-0,SFN,9,true,35,33,68,129,148,277,13,7,20,2,3:07
382708,2014-09-10,2014,BOS,BAL,6,10,10-6,BAL,9,false,38,45,83,167,152,319,11,18,29,2,3:23
382705,2014-09-10,2014,TEX,ANA,1,8,8-1,ANA,9,false,34,48,82,185,126,311,11,26,37,5,3:34
382709,2014-09-10,2014,TOR,CHN,11,1,11-1,TOR,9,true,41,33,74,136,166,302,19,7,26,4,3:12
382716,2014-09-10,2014,PHI,PIT,3,6,6-3,PIT,9,false,34,43,77,166,135,301,6,17,23,1,3:08
382719,2014-09-10,2014,NYA,TBA,8,5,8-5,NYA,9,true,37,40,77,164,146,310,13,14,27,4,3:31
382712,2014-09-10,2014,DET,KCA,0,3,3-0,KCA,9,false,29,38,67,148,129,277,3,12,15,2,3:18 (:42 delay)
382727,2014-09-11,2014,CIN,SLN,1,0,1-0,CIN,9,true,27,31,58,127,101,228,4,6,10,0,2:12
382728,2014-09-11,2014,NYA,TBA,5,4,5-4,NYA,9,false,35,37,72,125,136,261,8,13,21,4,3:05
382714,2014-09-11,2014,CLE,MIN,2,0,2-0,CLE,9,true,33,31,64,127,136,263,9,6,15,1,2:33
382724,2014-09-11,2014,CLE,MIN,8,2,8-2,CLE,9,true,38,34,72,118,140,258,14,8,22,1,2:40
382714,2014-09-11,2014,CLE,MIN,2,0,2-0,CLE,9,true,33,31,64,127,136,263,9,6,15,1,2:33
382720,2014-09-11,2014,TEX,ANA,3,7,7-3,ANA,9,false,36,39,75,158,140,298,10,12,22,5,3:24
382729,2014-09-11,2014,NYN,WAS,2,6,6-2,WAS,9,false,35,43,78,159,121,280,11,17,28,5,3:10
382723,2014-09-11,2014,MIL,MIA,4,2,4-2,MIL,9,true,35,36,71,131,130,261,12,8,20,2,3:19
382721,2014-09-11,2014,SFN,ARI,6,2,6-2,SFN,9,true,40,36,76,150,152,302,18,10,28,4,3:28
382725,2014-09-11,2014,CHA,OAK,1,0,1-0,CHA,9,true,28,32,60,125,113,238,5,6,11,0,2:18
382726,2014-09-11,2014,PHI,PIT,1,4,4-1,PIT,9,false,35,38,73,160,125,285,9,13,22,1,3:09
382722,2014-09-11,2014,KCA,BOS,3,6,6-3,BOS,9,false,37,42,79,174,130,304,10,16,26,4,3:28
382743,2014-09-12,2014,TOR,TBA,0,1,1-0,TBA,9,false,32,32,64,129,141,270,5,4,9,0,2:55
382735,2014-09-12,2014,SLN,COL,5,1,5-1,SLN,9,true,34,35,69,112,138,250,13,8,21,1,2:44
382740,2014-09-12,2014,BAL,NYA,5,0,5-0,BAL,9,true,38,32,70,130,143,273,14,6,20,1,2:57
382738,2014-09-12,2014,PHI,MIA,3,1,3-1,PHI,10,false,38,39,77,141,142,283,13,10,23,2,3:02
382737,2014-09-12,2014,SFN,LAN,9,0,9-0,SFN,9,true,41,33,74,113,153,266,17,6,23,0,3:01
382741,2014-09-12,2014,SEA,OAK,4,2,4-2,SEA,9,true,30,39,69,148,117,265,8,10,18,2,2:44
382742,2014-09-12,2014,ARI,SDN,5,6,6-5,SDN,9,false,36,40,76,162,124,286,11,14,25,1,2:55
382736,2014-09-12,2014,ANA,HOU,11,3,11-3,ANA,9,true,40,41,81,179,164,343,14,15,29,3,3:37
382744,2014-09-12,2014,NYN,WAS,4,3,4-3,NYN,9,true,33,41,74,162,131,293,9,17,26,2,3:10
382731,2014-09-12,2014,KCA,BOS,2,4,4-2,BOS,9,false,33,38,71,147,118,265,6,12,18,1,2:49
382732,2014-09-12,2014,PIT,CHN,7,3,7-3,PIT,9,true,41,36,77,150,154,304,17,9,26,2,3:29
382733,2014-09-12,2014,MIL,CIN,3,2,3-2,MIL,9,false,34,36,70,145,122,267,10,10,20,1,3:01
382734,2014-09-12,2014,DET,CLE,7,2,7-2,DET,9,true,38,36,74,132,133,265,15,10,25,4,3:07
382324,2014-09-12,2014,BAL,NYA,2,1,2-1,BAL,11,false,45,43,88,174,185,359,13,12,25,2,3:51
382324,2014-09-12,2014,BAL,NYA,2,1,2-1,BAL,11,false,45,43,88,174,185,359,13,12,25,2,3:51
382730,2014-09-12,2014,TEX,ATL,2,1,2-1,TEX,9,true,35,36,71,150,127,277,11,11,22,4,2:59
382746,2014-09-13,2014,KCA,BOS,7,1,7-1,KCA,9,true,36,33,69,127,153,280,13,5,18,0,2:48
382750,2014-09-13,2014,SLN,COL,5,4,5-4,SLN,9,true,36,36,72,134,158,292,12,10,22,3,3:24
382758,2014-09-13,2014,TOR,TBA,6,3,6-3,TOR,9,true,36,35,71,126,139,265,13,9,22,1,2:40
382754,2014-09-13,2014,CHA,MIN,5,1,5-1,CHA,9,true,35,32,67,139,121,260,12,6,18,3,2:38
382753,2014-09-13,2014,PHI,MIA,2,1,2-1,PHI,9,true,28,35,63,120,102,222,4,10,14,1,2:33
382756,2014-09-13,2014,SEA,OAK,2,3,3-2,OAK,10,false,34,43,77,167,115,282,7,15,22,3,3:20
382751,2014-09-13,2014,ANA,HOU,5,2,5-2,ANA,9,true,37,35,72,133,163,296,16,8,24,2,3:19
382739,2014-09-13,2014,CHA,MIN,7,6,7-6,CHA,9,false,41,37,78,158,175,333,16,12,28,3,3:34
382749,2014-09-13,2014,DET,CLE,5,4,5-4,DET,9,true,34,36,70,147,130,277,11,11,22,2,3:14
382759,2014-09-13,2014,NYN,WAS,3,10,10-3,WAS,9,false,35,48,83,203,114,317,8,20,28,3,3:32
382755,2014-09-13,2014,BAL,NYA,2,3,3-2,NYA,9,false,37,36,73,154,158,312,11,9,20,2,3:28 (:35 delay)
382757,2014-09-13,2014,ARI,SDN,10,4,10-4,ARI,9,true,40,37,77,137,159,296,15,11,26,1,3:13
382739,2014-09-13,2014,CHA,MIN,7,6,7-6,CHA,9,false,41,37,78,158,175,333,16,12,28,3,3:34
382747,2014-09-13,2014,PIT,CHN,4,6,6-4,CHN,9,false,38,42,80,176,149,325,11,16,27,3,3:27
382745,2014-09-13,2014,TEX,ATL,3,2,3-2,TEX,9,true,28,35,63,115,105,220,4,10,14,2,2:25
382752,2014-09-13,2014,SFN,LAN,0,17,17-0,LAN,9,false,31,59,90,196,114,310,5,31,36,2,3:15
382748,2014-09-13,2014,MIL,CIN,1,5,5-1,CIN,9,false,32,38,70,156,118,274,7,12,19,0,2:56
382762,2014-09-14,2014,PIT,CHN,7,3,7-3,PIT,9,true,39,33,72,122,136,258,16,9,25,1,2:53
382771,2014-09-14,2014,SEA,OAK,0,4,4-0,OAK,9,false,38,36,74,131,168,299,13,9,22,2,2:58
382774,2014-09-14,2014,NYN,WAS,0,3,3-0,WAS,9,false,38,35,73,143,136,279,11,9,20,1,2:53
382767,2014-09-14,2014,SFN,LAN,2,4,4-2,LAN,9,false,34,35,69,107,123,230,8,10,18,1,2:53
382770,2014-09-14,2014,BAL,NYA,3,2,3-2,BAL,9,false,34,35,69,152,123,275,9,8,17,1,3:04
382765,2014-09-14,2014,SLN,COL,4,1,4-1,SLN,9,true,37,36,73,140,136,276,15,9,24,4,3:03
382766,2014-09-14,2014,ANA,HOU,1,6,6-1,HOU,9,false,30,44,74,197,143,340,5,20,25,3,3:20
382772,2014-09-14,2014,ARI,SDN,8,6,8-6,ARI,9,true,39,44,83,145,136,281,15,17,32,4,3:16
382773,2014-09-14,2014,TOR,TBA,5,6,6-5,TBA,10,false,39,45,84,166,156,322,10,16,26,4,3:26
382761,2014-09-14,2014,KCA,BOS,4,8,8-4,BOS,9,false,39,39,78,173,165,338,13,13,26,3,3:23
382769,2014-09-14,2014,CHA,MIN,4,6,6-4,MIN,9,false,34,41,75,145,123,268,7,17,24,1,2:43
382768,2014-09-14,2014,PHI,MIA,4,5,5-4,MIA,9,false,39,40,79,143,155,298,13,11,24,3,3:20
382763,2014-09-14,2014,MIL,CIN,9,2,9-2,MIL,9,true,45,36,81,126,156,282,21,10,31,2,3:08
382764,2014-09-14,2014,DET,CLE,6,4,6-4,DET,9,true,40,43,83,167,143,310,20,17,37,6,3:56
382760,2014-09-14,2014,TEX,ATL,10,3,10-3,TEX,9,true,44,37,81,118,169,287,23,11,34,1,3:00
382782,2014-09-15,2014,SDN,PHI,1,0,1-0,SDN,9,true,31,28,59,92,121,213,7,3,10,2,2:09
382786,2014-09-15,2014,ATL,WAS,2,4,4-2,WAS,9,false,35,37,72,152,127,279,10,11,21,4,3:06
382776,2014-09-15,2014,CHN,CIN,1,0,1-0,CHN,9,false,30,32,62,135,129,264,8,8,16,1,2:46
382775,2014-09-15,2014,KCA,CHA,4,3,4-3,KCA,9,false,39,39,78,133,169,302,15,13,28,1,3:18
382779,2014-09-15,2014,COL,LAN,3,11,11-3,LAN,9,false,39,47,86,178,128,306,14,21,35,4,3:39
382781,2014-09-15,2014,TBA,NYA,1,0,1-0,TBA,9,false,37,34,71,147,145,292,10,8,18,2,3:28
382784,2014-09-15,2014,ARI,SFN,6,2,6-2,ARI,9,true,35,38,73,148,128,276,13,11,24,2,2:59
382778,2014-09-15,2014,MIN,DET,6,8,8-6,DET,9,false,37,42,79,139,147,286,13,19,32,6,3:15
382777,2014-09-15,2014,HOU,CLE,3,1,3-1,HOU,9,true,32,35,67,120,129,249,9,7,16,4,2:45
382783,2014-09-15,2014,ANA,SEA,8,1,8-1,ANA,9,true,39,32,71,119,148,267,15,6,21,2,2:54
382780,2014-09-15,2014,NYN,MIA,5,6,6-5,MIA,9,false,40,39,79,142,160,302,13,12,25,4,3:10
382785,2014-09-15,2014,BAL,TOR,5,2,5-2,BAL,9,true,35,40,75,163,135,298,13,13,26,3,3:12
382798,2014-09-16,2014,ARI,SFN,1,2,2-1,SFN,9,false,33,35,68,117,112,229,7,9,16,2,2:34
382801,2014-09-16,2014,ATL,WAS,0,3,3-0,WAS,9,false,31,36,67,135,108,243,5,10,15,0,2:36
382789,2014-09-16,2014,CHN,CIN,7,0,7-0,CHN,9,true,36,28,64,110,149,259,12,2,14,1,2:36
382795,2014-09-16,2014,TBA,NYA,6,1,6-1,TBA,9,true,37,36,73,146,136,282,12,10,22,6,3:32
382787,2014-09-16,2014,PIT,BOS,4,0,4-0,PIT,9,true,34,35,69,157,140,297,10,9,19,3,3:07
382793,2014-09-16,2014,NYN,MIA,9,1,9-1,NYN,9,true,38,38,76,131,133,264,14,14,28,3,2:47
382800,2014-09-16,2014,BAL,TOR,8,2,8-2,BAL,9,true,37,36,73,140,145,285,12,9,21,3,3:02
382790,2014-09-16,2014,HOU,CLE,2,4,4-2,CLE,9,false,39,37,76,167,150,317,12,10,22,1,3:18
382788,2014-09-16,2014,KCA,CHA,5,7,7-5,CHA,9,false,42,41,83,146,197,343,16,16,32,9,4:16
382794,2014-09-16,2014,SLN,MIL,2,3,3-2,MIL,12,false,42,49,91,185,166,351,9,16,25,1,3:55
382799,2014-09-16,2014,OAK,TEX,3,6,6-3,TEX,9,false,35,40,75,141,130,271,7,14,21,2,2:53
382797,2014-09-16,2014,ANA,SEA,2,13,13-2,SEA,9,false,34,47,81,163,119,282,9,22,31,4,3:18
382796,2014-09-16,2014,SDN,PHI,5,4,5-4,SDN,9,true,37,38,75,174,137,311,15,11,26,2,3:11
382792,2014-09-16,2014,COL,LAN,10,4,10-4,COL,9,true,36,41,77,137,139,276,14,17,31,3,3:04
382791,2014-09-16,2014,MIN,DET,4,3,4-3,MIN,9,false,35,33,68,125,129,254,12,9,21,0,2:40
382816,2014-09-17,2014,ATL,WAS,3,1,3-1,ATL,9,true,33,32,65,128,123,251,10,7,17,1,2:43
382804,2014-09-17,2014,CHN,CIN,3,1,3-1,CHN,9,true,33,35,68,109,129,238,10,9,19,1,2:33
382803,2014-09-17,2014,KCA,CHA,6,2,6-2,KCA,9,true,40,33,73,125,147,272,18,8,26,1,2:50
382812,2014-09-17,2014,ANA,SEA,5,0,5-0,ANA,9,true,32,31,63,116,125,241,9,4,13,2,2:37
382808,2014-09-17,2014,NYN,MIA,3,4,4-3,MIA,9,false,37,40,77,142,150,292,12,16,28,3,3:07
382806,2014-09-17,2014,MIN,DET,8,4,8-4,MIN,9,true,40,39,79,130,156,286,16,14,30,5,3:19
382811,2014-09-17,2014,SDN,PHI,2,5,5-2,PHI,9,false,36,37,73,129,151,280,12,11,23,1,2:50
382814,2014-09-17,2014,OAK,TEX,1,6,6-1,TEX,9,false,38,39,77,159,154,313,12,14,26,6,3:37
382802,2014-09-17,2014,PIT,BOS,9,1,9-1,PIT,9,true,39,36,75,153,138,291,16,11,27,0,3:04
382813,2014-09-17,2014,ARI,SFN,2,4,4-2,SFN,9,false,39,38,77,155,155,310,12,13,25,1,3:35
382807,2014-09-17,2014,COL,LAN,16,2,16-2,COL,9,true,48,36,84,128,160,288,23,9,32,1,3:01
382805,2014-09-17,2014,HOU,CLE,0,2,2-0,CLE,9,false,30,35,65,108,98,206,3,7,10,1,2:20
382815,2014-09-17,2014,BAL,TOR,6,1,6-1,BAL,9,true,35,35,70,167,131,298,11,11,22,3,3:13
382810,2014-09-17,2014,TBA,NYA,2,3,3-2,NYA,9,false,33,35,68,134,129,263,7,8,15,1,2:57
382809,2014-09-17,2014,SLN,MIL,2,0,2-0,SLN,9,true,28,34,62,102,115,217,5,9,14,0,2:32
382826,2014-09-18,2014,MIA,WAS,2,6,6-2,WAS,9,false,33,38,71,127,125,252,6,11,17,1,2:46
382818,2014-09-18,2014,PIT,BOS,3,2,3-2,PIT,9,true,33,35,68,128,131,259,10,9,19,2,2:53
382823,2014-09-18,2014,ANA,SEA,1,3,3-1,SEA,9,false,37,34,71,126,134,260,10,9,19,2,3:08
382821,2014-09-18,2014,SLN,MIL,3,2,3-2,SLN,13,false,51,53,104,185,187,372,18,14,32,3,4:26
382824,2014-09-18,2014,OAK,TEX,2,7,7-2,TEX,9,false,34,41,75,146,130,276,9,17,26,5,3:05
382825,2014-09-18,2014,NYA,TOR,3,2,3-2,NYA,9,false,34,33,67,138,127,265,9,7,16,1,2:39
382819,2014-09-18,2014,HOU,CLE,1,2,2-1,CLE,13,false,48,51,99,184,179,363,12,14,26,7,4:32
382822,2014-09-18,2014,SDN,PHI,7,3,7-3,SDN,9,true,39,38,77,137,143,280,19,11,30,1,3:02
382817,2014-09-18,2014,COL,ARI,7,6,7-6,COL,9,false,41,36,77,111,141,252,16,11,27,3,2:47
382820,2014-09-18,2014,CHN,LAN,4,8,8-4,LAN,9,false,39,42,81,167,178,345,13,16,29,2,3:53
382841,2014-09-19,2014,MIA,WAS,2,3,3-2,WAS,9,false,34,37,71,152,129,281,8,11,19,1,2:47
382838,2014-09-19,2014,SDN,SFN,5,0,5-0,SDN,9,true,34,32,66,138,131,269,10,5,15,2,2:49
382836,2014-09-19,2014,OAK,PHI,3,1,3-1,OAK,9,true,36,33,69,142,129,271,13,8,21,2,2:56
382834,2014-09-19,2014,PIT,MIL,4,2,4-2,PIT,9,true,37,33,70,111,150,261,13,8,21,1,2:57
382835,2014-09-19,2014,ATL,NYN,0,5,5-0,NYN,9,false,34,38,72,144,139,283,7,13,20,1,3:03
382828,2014-09-19,2014,BAL,BOS,3,5,5-3,BOS,10,false,40,41,81,165,162,327,11,9,20,4,3:42
382839,2014-09-19,2014,ANA,TEX,3,12,12-3,TEX,9,false,38,44,82,152,160,312,13,17,30,1,3:16
382829,2014-09-19,2014,TBA,CHA,3,4,4-3,CHA,9,false,36,41,77,177,134,311,11,16,27,5,3:29
382833,2014-09-19,2014,CHN,LAN,5,14,14-5,LAN,9,false,41,45,86,182,157,339,15,19,34,2,3:31
382830,2014-09-19,2014,SLN,CIN,2,1,2-1,SLN,9,true,33,34,67,112,122,234,9,8,17,3,2:35
382840,2014-09-19,2014,NYA,TOR,5,3,5-3,NYA,9,true,33,37,70,149,119,268,10,10,20,4,2:44
382837,2014-09-19,2014,HOU,SEA,5,10,10-5,SEA,9,false,41,45,86,182,145,327,16,20,36,4,3:34
382832,2014-09-19,2014,KCA,DET,1,10,10-1,DET,9,false,32,46,78,169,136,305,7,20,27,3,3:16
382827,2014-09-19,2014,COL,ARI,15,3,15-3,COL,9,true,44,38,82,123,137,260,21,11,32,0,2:51
382831,2014-09-19,2014,MIN,CLE,5,4,5-4,MIN,10,false,41,42,83,127,161,288,15,11,26,8,3:27
382844,2014-09-20,2014,TBA,CHA,3,1,3-1,TBA,9,true,32,35,67,143,118,261,12,9,21,3,3:05
382843,2014-09-20,2014,BAL,BOS,7,2,7-2,BAL,9,true,37,35,72,133,164,297,14,8,22,0,2:51
382850,2014-09-20,2014,ATL,NYN,2,4,4-2,NYN,9,false,36,41,77,160,120,280,10,14,24,2,2:52
382853,2014-09-20,2014,SDN,SFN,3,2,3-2,SDN,9,true,35,34,69,130,121,251,12,7,19,4,2:53
382842,2014-09-20,2014,COL,ARI,5,1,5-1,COL,9,true,36,35,71,125,132,257,11,10,21,1,2:43
382856,2014-09-20,2014,MIA,WAS,2,3,3-2,WAS,9,false,33,37,70,134,128,262,7,14,21,2,2:59
382851,2014-09-20,2014,OAK,PHI,0,3,3-0,PHI,9,false,31,38,69,161,121,282,6,10,16,3,2:59
382852,2014-09-20,2014,HOU,SEA,10,1,10-1,HOU,9,true,37,35,72,136,137,273,15,9,24,1,2:34
382854,2014-09-20,2014,ANA,TEX,8,5,8-5,ANA,9,true,37,35,72,138,134,272,14,9,23,3,2:57
382849,2014-09-20,2014,PIT,MIL,0,1,1-0,MIL,9,false,37,37,74,134,135,269,14,11,25,3,3:32
382847,2014-09-20,2014,KCA,DET,2,3,3-2,DET,9,false,39,35,74,128,153,281,13,8,21,1,3:29
382855,2014-09-20,2014,NYA,TOR,3,6,6-3,TOR,9,false,41,41,82,144,159,303,13,16,29,4,3:18
382848,2014-09-20,2014,CHN,LAN,8,7,8-7,CHN,9,true,41,40,81,139,172,311,18,16,34,5,3:44
382846,2014-09-20,2014,MIN,CLE,3,7,7-3,CLE,9,false,37,40,77,162,152,314,11,14,25,5,3:14 (1:01 delay)
382845,2014-09-20,2014,SLN,CIN,8,4,8-4,SLN,9,true,36,36,72,137,128,265,15,8,23,3,2:52
382864,2014-09-21,2014,PIT,MIL,1,0,1-0,PIT,9,true,29,32,61,100,102,202,8,7,15,0,2:25
382871,2014-09-21,2014,MIA,WAS,1,2,2-1,WAS,9,false,30,34,64,133,107,240,7,8,15,0,2:30
382858,2014-09-21,2014,BAL,BOS,2,3,3-2,BOS,9,false,36,38,74,148,123,271,9,15,24,3,3:07
382870,2014-09-21,2014,NYA,TOR,5,2,5-2,NYA,9,true,37,35,72,122,182,304,13,9,22,3,3:09
382861,2014-09-21,2014,MIN,CLE,2,7,7-2,CLE,9,false,35,45,80,149,136,285,8,20,28,2,3:08
382862,2014-09-21,2014,KCA,DET,5,2,5-2,KCA,9,true,38,36,74,120,148,268,16,9,25,4,3:09
382865,2014-09-21,2014,ATL,NYN,2,10,10-2,NYN,9,false,34,45,79,158,139,297,7,18,25,1,3:06
382868,2014-09-21,2014,SDN,SFN,8,2,8-2,SDN,9,true,38,34,72,130,172,302,14,8,22,5,3:24
382867,2014-09-21,2014,HOU,SEA,8,3,8-3,HOU,9,true,43,33,76,128,161,289,21,8,29,4,3:29
382857,2014-09-21,2014,COL,ARI,8,3,8-3,COL,9,true,39,34,73,113,138,251,17,9,26,3,2:47
382869,2014-09-21,2014,ANA,TEX,1,2,2-1,TEX,9,false,34,38,72,159,127,286,10,14,24,3,3:17
382859,2014-09-21,2014,TBA,CHA,5,10,10-5,CHA,9,false,41,45,86,179,157,336,15,18,33,3,3:26
382866,2014-09-21,2014,OAK,PHI,8,6,8-6,OAK,10,false,48,43,91,153,200,353,21,14,35,3,3:48
382860,2014-09-21,2014,SLN,CIN,2,7,7-2,CIN,9,false,38,38,76,151,128,279,11,11,22,2,3:01
382863,2014-09-21,2014,CHN,LAN,5,8,8-5,LAN,9,false,40,44,84,164,184,348,13,17,30,1,3:45
382875,2014-09-22,2014,DET,CHA,0,2,2-0,CHA,9,false,35,32,67,114,123,237,8,6,14,1,2:36
382877,2014-09-22,2014,TEX,HOU,4,3,4-3,TEX,9,true,32,36,68,136,120,256,10,10,20,3,2:48
382876,2014-09-22,2014,SDN,COL,1,0,1-0,SDN,9,true,32,37,69,142,119,261,8,11,19,2,2:46
382879,2014-09-22,2014,ATL,PIT,0,1,1-0,PIT,9,false,35,33,68,139,142,281,8,6,14,0,2:50
382880,2014-09-22,2014,TOR,SEA,14,4,14-4,TOR,9,true,45,37,82,127,153,280,22,10,32,1,2:48
382872,2014-09-22,2014,OAK,ANA,8,4,8-4,OAK,9,true,41,35,76,134,184,318,16,10,26,3,3:17
382881,2014-09-22,2014,LAN,SFN,2,5,5-2,SFN,13,false,46,55,101,204,145,349,8,17,25,2,4:16
382874,2014-09-22,2014,NYA,BAL,5,0,5-0,NYA,9,true,34,30,64,132,132,264,11,3,14,5,3:00
382878,2014-09-22,2014,CLE,KCA,0,2,2-0,KCA,9,false,36,36,72,124,141,265,10,9,19,2,3:03
382882,2014-09-22,2014,CHN,SLN,0,8,8-0,SLN,9,false,32,42,74,166,135,301,7,15,22,0,3:00
382873,2014-09-22,2014,MIN,ARI,2,6,6-2,ARI,9,false,37,40,77,153,163,316,11,15,26,3,3:14
382895,2014-09-23,2014,LAN,SFN,4,2,4-2,LAN,9,true,30,32,62,129,120,249,7,7,14,1,2:49
382894,2014-09-23,2014,TOR,SEA,10,2,10-2,TOR,9,true,41,34,75,116,148,264,16,8,24,1,2:36
382890,2014-09-23,2014,CIN,MIL,3,1,3-1,CIN,9,true,30,32,62,121,128,249,7,7,14,0,2:36
382893,2014-09-23,2014,ATL,PIT,2,3,3-2,PIT,9,false,30,36,66,150,126,276,8,11,19,1,2:48
382885,2014-09-23,2014,NYA,BAL,4,5,5-4,BAL,9,false,38,43,81,146,153,299,11,17,28,4,3:22
382889,2014-09-23,2014,CLE,KCA,1,7,7-1,KCA,9,false,36,42,78,145,143,288,9,18,27,4,2:57
382896,2014-09-23,2014,CHN,SLN,4,3,4-3,CHN,10,false,42,39,81,146,164,310,15,10,25,3,3:11
382887,2014-09-23,2014,SDN,COL,2,3,3-2,COL,9,false,39,35,74,135,161,296,15,10,25,1,3:20
382892,2014-09-23,2014,MIA,PHI,2,0,2-0,MIA,9,true,31,36,67,121,117,238,8,9,17,1,2:20
382886,2014-09-23,2014,DET,CHA,4,3,4-3,DET,9,false,39,36,75,121,150,271,15,9,24,2,3:19
382883,2014-09-23,2014,OAK,ANA,0,2,2-0,ANA,9,false,35,30,65,115,147,262,11,6,17,2,3:02
382897,2014-09-23,2014,BOS,TBA,2,6,6-2,TBA,9,false,34,36,70,125,146,271,10,13,23,3,3:14
382891,2014-09-23,2014,WAS,NYN,4,2,4-2,WAS,9,true,34,36,70,149,119,268,9,9,18,4,2:57
382884,2014-09-23,2014,MIN,ARI,6,3,6-3,MIN,9,true,37,38,75,144,139,283,17,11,28,2,3:05
382888,2014-09-23,2014,TEX,HOU,2,1,2-1,TEX,9,true,38,34,72,138,142,280,15,8,23,2,2:55
382909,2014-09-24,2014,TOR,SEA,1,0,1-0,TOR,9,true,28,29,57,103,99,202,5,4,9,1,1:59
382899,2014-09-24,2014,MIN,ARI,2,1,2-1,MIN,9,true,32,34,66,116,152,268,9,6,15,0,2:31 (1:06 delay)
382905,2014-09-24,2014,CIN,MIL,0,5,5-0,MIL,9,false,29,41,70,169,106,275,2,16,18,1,2:54
382910,2014-09-24,2014,LAN,SFN,9,1,9-1,LAN,9,true,39,35,74,131,137,268,17,8,25,4,3:07
382904,2014-09-24,2014,CLE,KCA,6,4,6-4,CLE,9,true,37,41,78,144,152,296,14,16,30,5,3:29
382908,2014-09-24,2014,ATL,PIT,6,2,6-2,ATL,9,true,41,40,81,158,142,300,18,14,32,3,3:17
382900,2014-09-24,2014,NYA,BAL,5,9,9-5,BAL,9,false,37,45,82,151,155,306,11,20,31,7,3:32
382912,2014-09-24,2014,BOS,TBA,11,3,11-3,BOS,9,true,44,38,82,136,206,342,20,11,31,2,3:40
382911,2014-09-24,2014,CHN,SLN,3,1,3-1,CHN,9,true,36,34,70,127,130,257,13,7,20,3,2:41
382903,2014-09-24,2014,TEX,HOU,5,1,5-1,TEX,9,true,38,32,70,137,152,289,14,10,24,1,3:06
382901,2014-09-24,2014,DET,CHA,6,1,6-1,DET,9,true,39,34,73,121,154,275,17,7,24,1,3:04
382907,2014-09-24,2014,MIA,PHI,1,2,2-1,PHI,9,false,34,39,73,145,105,250,8,16,24,1,2:54
382902,2014-09-24,2014,SDN,COL,4,3,4-3,SDN,9,true,35,36,71,143,144,287,12,10,22,4,3:10
382898,2014-09-24,2014,OAK,ANA,4,5,5-4,ANA,9,false,38,36,74,129,165,294,12,10,22,3,3:27
382916,2014-09-25,2014,DET,MIN,4,2,4-2,DET,9,true,33,36,69,155,115,270,10,9,19,0,2:55
382919,2014-09-25,2014,MIA,PHI,6,4,6-4,MIA,9,true,37,35,72,131,137,268,17,10,27,2,3:01
382917,2014-09-25,2014,WAS,NYN,3,0,3-0,WAS,9,true,36,31,67,133,149,282,12,5,17,0,3:00
382915,2014-09-25,2014,CIN,MIL,5,3,5-3,CIN,9,true,37,35,72,128,149,277,11,9,20,2,3:11
382923,2014-09-25,2014,BOS,TBA,11,1,11-1,BOS,9,true,41,36,77,119,157,276,17,10,27,2,3:16
382914,2014-09-25,2014,CHA,KCA,3,6,6-3,KCA,9,false,39,40,79,126,160,286,11,15,26,1,3:06
382920,2014-09-25,2014,ATL,PIT,1,10,10-1,PIT,9,false,36,46,82,186,136,322,9,24,33,3,3:27
382918,2014-09-25,2014,TEX,OAK,2,1,2-1,TEX,9,false,31,38,69,135,125,260,6,13,19,2,2:47
382922,2014-09-25,2014,TOR,SEA,5,7,7-5,SEA,9,false,37,40,77,152,143,295,10,15,25,6,3:02
382921,2014-09-25,2014,SFN,SDN,9,8,9-8,SFN,9,true,39,41,80,169,147,316,14,14,28,6,3:32
382913,2014-09-25,2014,NYA,BAL,6,5,6-5,NYA,9,false,38,33,71,119,163,282,9,6,15,2,3:10
382906,2014-09-25,2014,WAS,NYN,4,7,7-4,NYN,9,false,38,45,83,167,151,318,13,20,33,2,3:31
382906,2014-09-25,2014,WAS,NYN,4,7,7-4,NYN,9,false,38,45,83,167,151,318,13,20,33,2,3:31
382938,2014-09-26,2014,CLE,TBA,1,0,1-0,CLE,9,true,28,33,61,116,115,231,5,7,12,1,2:33
382924,2014-09-26,2014,SEA,ANA,4,3,4-3,SEA,9,true,34,34,68,120,129,249,11,7,18,2,2:48
382926,2014-09-26,2014,TOR,BAL,4,2,4-2,TOR,9,true,36,34,70,132,123,255,13,7,20,1,2:36
382935,2014-09-26,2014,CIN,PIT,1,3,3-1,PIT,9,false,36,36,72,147,116,263,11,11,22,1,2:49
382936,2014-09-26,2014,SFN,SDN,1,4,4-1,SDN,9,false,35,38,73,140,122,262,7,13,20,1,2:55
382933,2014-09-26,2014,BOS,NYA,2,3,3-2,NYA,9,false,32,37,69,150,123,273,6,10,16,1,3:01
382928,2014-09-26,2014,LAN,COL,7,4,7-4,LAN,9,true,35,40,75,149,133,282,13,14,27,6,3:24
382927,2014-09-26,2014,MIL,CHN,4,6,6-4,CHN,9,false,42,40,82,144,171,315,14,14,28,2,3:34
382937,2014-09-26,2014,ARI,SLN,6,7,7-6,SLN,10,false,46,45,91,170,179,349,16,18,34,5,3:45
381316,2014-09-26,2014,WAS,MIA,4,0,4-0,WAS,9,true,41,30,71,104,154,258,19,4,23,1,2:31
381316,2014-09-26,2014,WAS,MIA,4,0,4-0,WAS,9,true,41,30,71,104,154,258,19,4,23,1,2:31
382934,2014-09-26,2014,TEX,OAK,2,6,6-2,OAK,9,false,33,38,71,143,123,266,5,12,17,1,2:49
382925,2014-09-26,2014,PHI,ATL,5,4,5-4,PHI,9,true,36,37,73,127,133,260,12,12,24,1,2:41
382929,2014-09-26,2014,NYN,HOU,1,3,3-1,HOU,9,false,35,35,70,140,148,288,8,10,18,3,3:10
382932,2014-09-26,2014,DET,MIN,4,11,11-4,MIN,9,false,39,46,85,155,130,285,12,22,34,5,3:23
382930,2014-09-26,2014,CHA,KCA,1,3,3-1,KCA,9,false,34,34,68,124,128,252,7,9,16,1,2:41
382931,2014-09-26,2014,WAS,MIA,7,15,15-7,MIA,9,false,42,48,90,178,155,333,16,26,42,4,3:34
382941,2014-09-27,2014,TOR,BAL,4,2,4-2,TOR,9,true,33,33,66,129,100,229,8,8,16,1,2:25
382944,2014-09-27,2014,NYN,HOU,2,1,2-1,NYN,9,false,31,35,66,135,121,256,6,9,15,3,2:59
382949,2014-09-27,2014,TEX,OAK,5,4,5-4,TEX,9,true,31,38,69,145,115,260,9,15,24,6,3:06
382951,2014-09-27,2014,SFN,SDN,3,1,3-1,SFN,9,true,34,37,71,136,126,262,11,9,20,1,2:35
382946,2014-09-27,2014,WAS,MIA,5,1,5-1,WAS,9,true,38,35,73,137,140,277,16,6,22,1,2:57
382948,2014-09-27,2014,BOS,NYA,10,4,10-4,BOS,9,true,41,40,81,123,141,264,20,14,34,3,3:04
382952,2014-09-27,2014,ARI,SLN,5,2,5-2,ARI,9,true,38,37,75,150,151,301,14,10,24,2,2:58
382947,2014-09-27,2014,DET,MIN,3,12,12-3,MIN,9,false,38,48,86,183,129,312,11,24,35,2,3:26
382939,2014-09-27,2014,SEA,ANA,2,1,2-1,SEA,11,false,46,46,92,175,167,342,17,14,31,5,3:54
382943,2014-09-27,2014,LAN,COL,6,5,6-5,LAN,12,false,49,49,98,178,185,363,17,14,31,5,4:06
382953,2014-09-27,2014,CLE,TBA,0,2,2-0,TBA,9,false,32,35,67,124,118,242,6,8,14,3,2:55
382940,2014-09-27,2014,PHI,ATL,2,4,4-2,ATL,9,false,37,35,72,154,140,294,12,9,21,2,3:05
382945,2014-09-27,2014,CHA,KCA,5,4,5-4,CHA,9,true,32,37,69,145,154,299,10,12,22,5,3:19
382942,2014-09-27,2014,MIL,CHN,2,1,2-1,MIL,9,true,35,34,69,135,136,271,14,7,21,1,3:10
382950,2014-09-27,2014,CIN,PIT,10,6,10-6,CIN,10,false,44,42,86,154,173,327,17,12,29,1,3:41
382956,2014-09-28,2014,TOR,BAL,0,1,1-0,BAL,9,false,32,34,66,122,113,235,6,8,14,1,2:26
382962,2014-09-28,2014,DET,MIN,3,0,3-0,DET,9,true,30,33,63,139,95,234,7,6,13,2,2:41
382967,2014-09-28,2014,ARI,SLN,0,1,1-0,SLN,9,false,30,29,59,98,124,222,5,3,8,2,2:20
382954,2014-09-28,2014,SEA,ANA,4,1,4-1,SEA,9,true,35,33,68,126,130,256,11,6,17,4,2:50
382957,2014-09-28,2014,MIL,CHN,2,5,5-2,CHN,9,false,34,39,73,141,137,278,9,10,19,1,3:09
382966,2014-09-28,2014,SFN,SDN,9,3,9-3,SFN,9,true,39,35,74,134,145,279,16,9,25,4,3:03
382958,2014-09-28,2014,LAN,COL,10,5,10-5,LAN,9,true,43,37,80,149,154,303,18,10,28,2,3:15
382955,2014-09-28,2014,PHI,ATL,1,2,2-1,ATL,9,false,34,32,66,108,120,228,9,5,14,0,2:18
382961,2014-09-28,2014,WAS,MIA,1,0,1-0,WAS,9,true,32,28,60,104,101,205,11,1,12,0,2:01
382965,2014-09-28,2014,CIN,PIT,4,1,4-1,CIN,9,true,32,35,67,124,132,256,9,8,17,1,2:46
382964,2014-09-28,2014,TEX,OAK,0,4,4-0,OAK,9,false,32,34,66,140,103,243,7,9,16,2,2:39
382959,2014-09-28,2014,NYN,HOU,8,3,8-3,NYN,9,true,36,35,71,119,137,256,13,11,24,1,2:42
382968,2014-09-28,2014,CLE,TBA,7,2,7-2,CLE,9,true,39,33,72,96,139,235,15,9,24,1,2:28
382960,2014-09-28,2014,CHA,KCA,4,6,6-4,KCA,9,false,41,44,85,173,158,331,15,17,32,1,3:34
382963,2014-09-28,2014,BOS,NYA,5,9,9-5,NYA,9,false,35,40,75,139,149,288,8,13,21,3,3:14