API Key,Date,Year,Home Team,Away Team,Home Score,Away Score,Final Score,Winning Team,# Innings,End Top Inning?,Home Team PA #,Away Team PA #,Total Number PA,Homne Team # Pitches,Away Team # Pitches,Total # Pitches,Home Team Baserunners,Away Team Baserunners,Total # Baserunners,Pitching Changes,Time
413661,2015-04-05,2015,CHN,SLN,0,3,3-0,SLN,9,false,34,40,74,158,156,314,7,15,22,1,3:04
413658,2015-04-06,2015,CIN,PIT,5,2,5-2,CIN,9,true,32,35,67,132,111,243,8,8,16,2,2:30 (:35 delay)
413654,2015-04-06,2015,HOU,CLE,2,0,2-0,HOU,9,true,28,32,60,122,108,230,5,6,11,1,2:30
413649,2015-04-06,2015,SEA,ANA,4,1,4-1,SEA,9,true,33,32,65,129,124,253,11,7,18,2,2:33
413662,2015-04-06,2015,OAK,TEX,8,0,8-0,OAK,9,true,41,30,71,113,174,287,15,3,18,1,2:45
413657,2015-04-06,2015,WAS,NYN,1,3,3-1,NYN,9,false,32,37,69,123,122,245,4,8,12,3,2:35
413659,2015-04-06,2015,LAN,SDN,6,3,6-3,LAN,9,true,39,35,74,134,148,282,17,11,28,2,3:04
413663,2015-04-06,2015,NYA,TOR,1,6,6-1,TOR,9,false,33,39,72,167,130,297,7,11,18,3,2:59
413651,2015-04-06,2015,TBA,BAL,2,6,6-2,BAL,9,false,35,37,72,154,141,295,11,11,22,5,3:01
413656,2015-04-06,2015,DET,MIN,4,0,4-0,DET,9,true,34,31,65,105,124,229,12,5,17,1,2:30
413650,2015-04-06,2015,MIA,ATL,1,2,2-1,ATL,9,false,32,35,67,112,131,243,9,7,16,2,2:36 (:16 delay)
413653,2015-04-06,2015,KCA,CHA,10,1,10-1,KCA,9,true,42,31,73,115,142,257,21,8,29,3,2:50
413655,2015-04-06,2015,MIL,COL,0,10,10-0,COL,9,false,34,44,78,162,122,284,9,17,26,1,3:00
413652,2015-04-06,2015,PHI,BOS,0,8,8-0,BOS,9,false,33,42,75,184,118,302,5,16,21,1,3:01
413660,2015-04-06,2015,ARI,SFN,4,5,5-4,SFN,9,false,39,40,79,148,132,280,14,15,29,5,3:18
413667,2015-04-07,2015,MIL,COL,2,5,5-2,COL,9,false,33,41,74,148,114,262,8,14,22,0,2:48
413664,2015-04-07,2015,SEA,ANA,0,2,2-0,ANA,9,false,30,33,63,123,111,234,3,6,9,1,2:13
413670,2015-04-07,2015,OAK,TEX,1,3,3-1,TEX,9,false,33,37,70,125,135,260,8,11,19,1,2:30
413668,2015-04-07,2015,LAN,SDN,3,7,7-3,SDN,9,false,36,43,79,175,134,309,11,14,25,4,3:31 (:30 delay)
413666,2015-04-07,2015,TBA,BAL,5,6,6-5,BAL,9,false,37,37,74,151,176,327,10,13,23,4,3:22
413669,2015-04-07,2015,ARI,SFN,7,6,7-6,ARI,9,true,36,39,75,153,140,293,13,14,27,2,3:10
413665,2015-04-07,2015,MIA,ATL,2,12,12-2,ATL,9,false,35,46,81,191,148,339,10,22,32,2,3:14
413676,2015-04-08,2015,HOU,CLE,0,2,2-0,CLE,9,false,33,34,67,127,120,247,7,7,14,3,2:40
413693,2015-04-08,2015,CHN,SLN,2,0,2-0,CHN,9,true,28,34,62,126,111,237,4,7,11,3,2:23
413679,2015-04-08,2015,WAS,NYN,2,1,2-1,WAS,9,true,34,33,67,136,114,250,12,7,19,0,2:21 (:56 delay)
413684,2015-04-08,2015,OAK,TEX,10,0,10-0,OAK,9,true,43,33,76,128,158,286,19,5,24,1,2:55
413672,2015-04-08,2015,MIA,ATL,0,2,2-0,ATL,9,false,35,33,68,130,148,278,9,10,19,2,2:45
413675,2015-04-08,2015,KCA,CHA,7,5,7-5,KCA,9,true,41,35,76,121,152,273,18,10,28,1,3:11
413673,2015-04-08,2015,TBA,BAL,2,0,2-0,TBA,9,true,33,31,64,142,151,293,13,5,18,3,3:00
413671,2015-04-08,2015,SEA,ANA,3,5,5-3,ANA,9,false,37,39,76,142,122,264,12,14,26,2,2:48
413674,2015-04-08,2015,PHI,BOS,4,2,4-2,PHI,9,true,34,35,69,165,127,292,8,7,15,2,2:54
413685,2015-04-08,2015,NYA,TOR,4,3,4-3,NYA,9,true,35,37,72,156,133,289,14,10,24,3,2:56
413682,2015-04-08,2015,ARI,SFN,2,5,5-2,SFN,9,false,35,44,79,154,123,277,8,16,24,2,3:08
413677,2015-04-08,2015,MIL,COL,4,5,5-4,COL,10,false,41,38,79,134,158,292,13,10,23,1,3:15
413681,2015-04-08,2015,LAN,SDN,7,4,7-4,LAN,9,true,38,39,77,142,151,293,15,12,27,3,3:16
413678,2015-04-08,2015,DET,MIN,11,0,11-0,DET,9,true,46,33,79,137,178,315,24,6,30,4,3:06
413680,2015-04-08,2015,CIN,PIT,5,4,5-4,CIN,11,false,47,48,95,189,199,388,15,17,32,4,4:01 (2:34 delay)
413687,2015-04-09,2015,KCA,CHA,4,1,4-1,KCA,9,true,35,32,67,105,114,219,10,6,16,1,2:37
413691,2015-04-09,2015,CIN,PIT,3,2,3-2,CIN,9,false,33,35,68,113,131,244,9,9,18,1,2:32 (1:14 delay)
413689,2015-04-09,2015,DET,MIN,7,1,7-1,DET,9,true,39,32,71,94,149,243,16,6,22,1,2:43 (3:36 delay)
413695,2015-04-09,2015,NYA,TOR,3,6,6-3,TOR,9,false,37,35,72,142,152,294,12,9,21,2,2:52
413694,2015-04-09,2015,OAK,TEX,1,10,10-1,TEX,9,false,34,43,77,143,131,274,9,16,25,1,2:32
413688,2015-04-09,2015,HOU,CLE,1,5,5-1,CLE,9,false,35,40,75,161,163,324,8,14,22,1,3:08
413690,2015-04-09,2015,WAS,NYN,3,6,6-3,NYN,9,false,37,40,77,151,145,296,10,14,24,2,2:54
413686,2015-04-09,2015,PHI,BOS,2,6,6-2,BOS,9,false,35,45,80,203,137,340,8,17,25,0,3:08
413692,2015-04-09,2015,SDN,SFN,0,1,1-0,SFN,12,false,46,45,91,170,165,335,13,12,25,4,4:05
413706,2015-04-10,2015,SDN,SFN,1,0,1-0,SDN,9,true,30,30,60,108,115,223,11,8,19,1,2:31
413699,2015-04-10,2015,TEX,HOU,1,5,5-1,HOU,9,false,34,37,71,125,119,244,8,12,20,1,2:45
413707,2015-04-10,2015,CIN,SLN,5,4,5-4,CIN,9,true,31,39,70,161,98,259,9,14,23,2,2:26
413697,2015-04-10,2015,COL,CHN,5,1,5-1,COL,9,true,37,37,74,140,150,290,15,11,26,2,3:01
413710,2015-04-10,2015,PHI,WAS,4,1,4-1,PHI,9,true,34,33,67,131,122,253,13,7,20,2,2:30
413700,2015-04-10,2015,ANA,KCA,2,4,4-2,KCA,9,false,35,41,76,158,150,308,9,14,23,3,3:16
413702,2015-04-10,2015,CHA,MIN,0,6,6-0,MIN,9,false,30,46,76,190,112,302,5,23,28,2,3:01
413701,2015-04-10,2015,ARI,LAN,4,3,4-3,ARI,10,false,38,39,77,161,148,309,10,12,22,0,3:01
413704,2015-04-10,2015,MIL,PIT,2,6,6-2,PIT,9,false,38,41,79,154,136,290,12,15,27,2,3:13
413705,2015-04-10,2015,OAK,SEA,12,0,12-0,OAK,9,true,44,31,75,124,164,288,22,5,27,2,2:44
413703,2015-04-10,2015,ATL,NYN,5,3,5-3,ATL,9,true,39,35,74,161,154,315,13,10,23,3,3:01 (1:09 delay)
413709,2015-04-10,2015,BAL,TOR,5,12,12-5,TOR,9,false,38,47,85,162,130,292,15,20,35,2,2:45
413698,2015-04-10,2015,CLE,DET,4,8,8-4,DET,9,false,37,47,84,178,139,317,13,21,34,5,3:35
413708,2015-04-10,2015,MIA,TBA,10,9,10-9,MIA,10,false,47,44,91,184,169,353,20,16,36,4,3:36
413696,2015-04-10,2015,NYA,BOS,5,6,6-5,BOS,19,false,75,83,158,332,296,628,22,28,50,5,6:49 (:16 delay)
413716,2015-04-11,2015,ARI,LAN,6,0,6-0,ARI,9,true,35,32,67,151,118,269,13,6,19,1,2:36
413719,2015-04-11,2015,MIL,PIT,6,0,6-0,MIL,9,true,33,29,62,115,111,226,9,5,14,1,2:26
413717,2015-04-11,2015,CHA,MIN,5,4,5-4,CHA,9,true,35,36,71,144,126,270,12,9,21,1,2:54
413722,2015-04-11,2015,CIN,SLN,1,4,4-1,SLN,9,false,34,36,70,118,114,232,7,10,17,5,2:36
413723,2015-04-11,2015,MIA,TBA,0,2,2-0,TBA,9,false,30,35,65,140,118,258,4,9,13,1,2:32
413718,2015-04-11,2015,ATL,NYN,5,3,5-3,ATL,9,true,32,34,66,119,115,234,9,8,17,3,2:25
413715,2015-04-11,2015,ANA,KCA,4,6,6-4,KCA,9,false,33,42,75,148,113,261,7,18,25,3,2:41
413724,2015-04-11,2015,BAL,TOR,7,1,7-1,BAL,9,true,39,32,71,119,153,272,18,5,23,1,2:34
413711,2015-04-11,2015,NYA,BOS,4,8,8-4,BOS,9,false,34,42,76,174,128,302,7,14,21,3,3:13
413714,2015-04-11,2015,TEX,HOU,6,2,6-2,TEX,9,true,39,42,81,145,144,289,15,15,30,3,3:18
413721,2015-04-11,2015,SDN,SFN,10,2,10-2,SDN,9,true,44,36,80,137,179,316,21,8,29,1,3:14
413712,2015-04-11,2015,COL,CHN,5,9,9-5,CHN,9,false,40,44,84,164,146,310,14,19,33,3,3:19
413725,2015-04-11,2015,PHI,WAS,3,2,3-2,PHI,10,false,43,40,83,180,155,335,16,12,28,2,3:25
413720,2015-04-11,2015,OAK,SEA,4,5,5-4,SEA,11,false,47,46,93,174,162,336,17,13,30,5,3:39
413713,2015-04-11,2015,CLE,DET,6,9,9-6,DET,9,false,40,45,85,189,168,357,13,21,34,7,4:16
413733,2015-04-12,2015,ATL,NYN,3,4,4-3,NYN,9,false,34,40,74,131,102,233,7,16,23,4,2:37
413736,2015-04-12,2015,SDN,SFN,6,4,6-4,SDN,9,true,36,37,73,136,151,287,13,11,24,3,3:01
413732,2015-04-12,2015,CHA,MIN,6,2,6-2,CHA,9,true,37,36,73,155,131,286,12,9,21,3,2:56
413730,2015-04-12,2015,ANA,KCA,2,9,9-2,KCA,9,false,33,44,77,151,129,280,8,17,25,2,2:56
413727,2015-04-12,2015,COL,CHN,5,6,6-5,CHN,9,false,38,38,76,151,142,293,12,11,23,4,3:05
413734,2015-04-12,2015,MIL,PIT,2,10,10-2,PIT,9,false,35,41,76,142,148,290,9,14,23,3,3:00
413740,2015-04-12,2015,PHI,WAS,3,4,4-3,WAS,10,false,43,43,86,158,165,323,13,14,27,1,3:19
413738,2015-04-12,2015,MIA,TBA,5,8,8-5,TBA,9,false,38,43,81,178,138,316,10,17,27,2,3:16
413731,2015-04-12,2015,ARI,LAN,4,7,7-4,LAN,9,false,38,47,85,159,159,318,11,23,34,2,3:27
413735,2015-04-12,2015,OAK,SEA,7,8,8-7,SEA,10,false,45,41,86,147,156,303,18,10,28,2,3:11
413726,2015-04-12,2015,NYA,BOS,14,4,14-4,NYA,9,true,44,39,83,157,166,323,22,11,33,2,3:24
413728,2015-04-12,2015,CLE,DET,5,8,8-5,DET,9,false,41,44,85,166,153,319,13,21,34,2,3:13
413739,2015-04-12,2015,BAL,TOR,7,10,10-7,TOR,9,false,39,43,82,190,139,329,12,16,28,3,3:17
413737,2015-04-12,2015,CIN,SLN,5,7,7-5,SLN,11,false,53,48,101,183,206,389,20,17,37,3,4:03
413729,2015-04-12,2015,TEX,HOU,4,6,6-4,HOU,14,false,61,53,114,197,225,422,20,15,35,3,4:24
413753,2015-04-13,2015,TOR,TBA,1,2,2-1,TBA,9,false,32,37,69,143,122,265,6,10,16,0,2:30
413750,2015-04-13,2015,HOU,OAK,1,8,8-1,OAK,9,false,35,39,74,156,138,294,9,14,23,0,2:51
413745,2015-04-13,2015,PIT,DET,5,4,5-4,PIT,9,true,33,34,67,125,117,242,9,9,18,2,2:31
413742,2015-04-13,2015,SDN,ARI,4,8,8-4,ARI,9,false,35,44,79,173,145,318,10,16,26,1,3:02
413744,2015-04-13,2015,SFN,COL,0,2,2-0,COL,9,false,39,38,77,122,149,271,13,15,28,2,2:58
413752,2015-04-13,2015,LAN,SEA,6,5,6-5,LAN,10,false,42,36,78,142,155,297,14,7,21,4,3:04
413747,2015-04-13,2015,ATL,MIA,3,2,3-2,ATL,9,true,35,36,71,153,142,295,14,10,24,1,3:02 (1:31 delay)
413751,2015-04-13,2015,NYN,PHI,2,0,2-0,NYN,9,true,35,34,69,133,150,283,11,9,20,1,2:53
413741,2015-04-13,2015,TEX,ANA,3,6,6-3,ANA,9,false,35,43,78,143,146,289,8,17,25,3,3:17
413749,2015-04-13,2015,BAL,NYA,5,6,6-5,NYA,9,false,38,36,74,145,150,295,14,10,24,3,3:09
413748,2015-04-13,2015,SLN,MIL,4,5,5-4,MIL,9,false,43,36,79,127,141,268,16,9,25,2,3:01
413754,2015-04-13,2015,BOS,WAS,9,4,9-4,BOS,9,true,42,34,76,137,164,301,20,6,26,1,3:01
413746,2015-04-13,2015,MIN,KCA,3,12,12-3,KCA,9,false,33,46,79,152,125,277,8,20,28,5,2:50
413743,2015-04-13,2015,CHN,CIN,7,6,7-6,CHN,10,false,42,42,84,145,168,313,16,13,29,1,3:02
413762,2015-04-14,2015,BAL,NYA,4,3,4-3,BAL,9,true,32,35,67,134,102,236,8,7,15,1,2:29
413756,2015-04-14,2015,SDN,ARI,5,1,5-1,SDN,9,true,35,32,67,108,125,233,12,7,19,1,2:31
413760,2015-04-14,2015,PIT,DET,0,2,2-0,DET,9,false,29,39,68,156,91,247,3,13,16,2,2:50
413763,2015-04-14,2015,HOU,OAK,0,4,4-0,OAK,9,false,38,36,74,143,145,288,13,11,24,4,2:58
413758,2015-04-14,2015,CHN,CIN,2,3,3-2,CIN,9,false,36,35,71,141,146,287,10,9,19,2,2:45
413757,2015-04-14,2015,CLE,CHA,1,4,4-1,CHA,9,false,34,35,69,119,153,272,6,10,16,2,3:01
413755,2015-04-14,2015,TEX,ANA,8,2,8-2,TEX,9,true,39,37,76,127,166,293,17,11,28,2,2:57
413759,2015-04-14,2015,SFN,COL,1,4,4-1,COL,9,false,37,37,74,130,161,291,10,12,22,1,3:09
413764,2015-04-14,2015,NYN,PHI,6,5,6-5,NYN,9,true,42,38,80,139,156,295,20,10,30,2,3:12
413765,2015-04-14,2015,LAN,SEA,6,5,6-5,LAN,9,false,40,42,82,170,152,322,16,15,31,3,3:40
413766,2015-04-14,2015,TOR,TBA,2,3,3-2,TBA,9,false,37,39,76,160,154,314,10,14,24,3,3:06
413761,2015-04-14,2015,ATL,MIA,2,8,8-2,MIA,9,false,37,44,81,160,147,307,10,18,28,3,3:00
413767,2015-04-14,2015,BOS,WAS,8,7,8-7,BOS,9,true,40,41,81,162,150,312,15,15,30,5,3:23
413774,2015-04-15,2015,MIN,KCA,3,1,3-1,MIN,9,true,30,35,65,134,109,243,6,10,16,2,2:25
413773,2015-04-15,2015,PIT,DET,0,1,1-0,DET,9,false,29,32,61,136,118,254,3,7,10,0,2:52
413778,2015-04-15,2015,HOU,OAK,6,1,6-1,HOU,9,true,32,35,67,140,128,268,10,8,18,2,2:42
413771,2015-04-15,2015,CHN,CIN,5,0,5-0,CHN,9,true,39,33,72,125,132,257,17,7,24,1,2:39
413775,2015-04-15,2015,ATL,MIA,2,6,6-2,MIA,9,false,32,36,68,143,130,273,5,12,17,1,2:25
413772,2015-04-15,2015,SFN,COL,2,4,4-2,COL,9,false,36,35,71,135,143,278,10,7,17,0,2:51
413769,2015-04-15,2015,SDN,ARI,3,2,3-2,SDN,9,true,32,34,66,122,118,240,11,10,21,0,2:41
413780,2015-04-15,2015,LAN,SEA,5,2,5-2,LAN,9,true,39,36,75,132,133,265,19,11,30,3,2:53
413779,2015-04-15,2015,NYN,PHI,6,1,6-1,NYN,9,true,42,39,81,125,141,266,19,13,32,1,2:36
413776,2015-04-15,2015,SLN,MIL,4,2,4-2,SLN,9,true,35,40,75,162,103,265,11,12,23,2,2:50
413781,2015-04-15,2015,TOR,TBA,12,7,12-7,TOR,9,true,41,42,83,155,164,319,19,15,34,4,3:02
413770,2015-04-15,2015,CLE,CHA,4,2,4-2,CLE,9,true,34,39,73,163,140,303,10,12,22,3,2:58
413777,2015-04-15,2015,BAL,NYA,7,5,7-5,BAL,9,true,42,38,80,164,146,310,20,12,32,2,3:14
413782,2015-04-15,2015,BOS,WAS,5,10,10-5,WAS,9,false,37,44,81,193,158,351,9,18,27,2,3:08
413768,2015-04-15,2015,TEX,ANA,2,10,10-2,ANA,9,false,37,45,82,194,143,337,10,19,29,2,3:13
413786,2015-04-16,2015,SLN,MIL,4,0,4-0,SLN,9,true,35,35,70,137,144,281,13,7,20,2,2:54
413784,2015-04-16,2015,MIN,KCA,8,5,8-5,MIN,9,true,40,42,82,152,138,290,16,14,30,6,3:01
413788,2015-04-16,2015,TOR,TBA,2,4,4-2,TBA,9,false,37,37,74,144,152,296,11,12,23,2,3:00
413785,2015-04-16,2015,NYN,MIA,7,5,7-5,NYN,9,true,35,36,71,164,140,304,12,10,22,4,3:01
413783,2015-04-16,2015,SFN,ARI,6,7,7-6,ARI,12,false,52,51,103,171,221,392,18,16,34,6,4:20
413787,2015-04-16,2015,WAS,PHI,5,2,5-2,WAS,9,true,33,36,69,113,119,232,11,10,21,1,2:16
413802,2015-04-17,2015,CHN,SDN,4,5,5-4,SDN,9,false,38,36,74,135,145,280,11,10,21,2,2:57
413798,2015-04-17,2015,PIT,MIL,6,3,6-3,PIT,9,true,36,38,74,135,134,269,15,14,29,2,2:57
413789,2015-04-17,2015,HOU,ANA,3,6,6-3,ANA,9,false,36,35,71,149,123,272,9,9,18,2,2:57
413801,2015-04-17,2015,WAS,PHI,7,2,7-2,WAS,9,true,39,35,74,117,141,258,15,7,22,1,2:38
413800,2015-04-17,2015,KCA,OAK,6,4,6-4,KCA,9,true,38,36,74,111,136,247,16,10,26,1,2:33
413790,2015-04-17,2015,SFN,ARI,0,9,9-0,ARI,9,false,31,51,82,176,114,290,5,24,29,2,3:00
413796,2015-04-17,2015,LAN,COL,7,3,7-3,LAN,9,true,38,35,73,148,154,302,16,8,24,1,3:18
413799,2015-04-17,2015,TBA,NYA,4,5,5-4,NYA,9,false,37,37,74,184,165,349,11,11,22,3,3:12
413791,2015-04-17,2015,TOR,ATL,7,8,8-7,ATL,9,false,41,45,86,164,161,325,15,17,32,2,3:09
413795,2015-04-17,2015,MIN,CLE,3,2,3-2,MIN,11,false,42,45,87,175,149,324,14,14,28,3,3:38
413803,2015-04-17,2015,SEA,TEX,1,3,3-1,TEX,9,false,34,36,70,139,147,286,10,11,21,3,3:00
413793,2015-04-17,2015,DET,CHA,2,1,2-1,DET,9,false,35,32,67,118,113,231,10,6,16,0,2:35
413794,2015-04-17,2015,SLN,CIN,6,1,6-1,SLN,9,true,33,37,70,134,120,254,10,9,19,0,2:21
413797,2015-04-17,2015,NYN,MIA,4,1,4-1,NYN,9,true,34,33,67,117,134,251,10,7,17,2,2:38
413792,2015-04-17,2015,BOS,BAL,3,2,3-2,BOS,9,false,35,34,69,165,137,302,13,7,20,4,3:13
413810,2015-04-18,2015,MIN,CLE,2,4,4-2,CLE,9,false,34,36,70,108,145,253,9,9,18,2,2:33
413813,2015-04-18,2015,PIT,MIL,6,2,6-2,PIT,9,true,36,32,68,117,139,256,12,6,18,0,2:30
413804,2015-04-18,2015,HOU,ANA,4,0,4-0,HOU,9,true,33,33,66,147,135,282,10,6,16,1,2:38
413815,2015-04-18,2015,KCA,OAK,0,5,5-0,OAK,9,false,34,37,71,134,122,256,9,11,20,2,2:34
413811,2015-04-18,2015,LAN,COL,6,3,6-3,LAN,9,true,37,34,71,134,131,265,14,8,22,1,2:55
413814,2015-04-18,2015,TBA,NYA,0,9,9-0,NYA,9,false,32,42,74,174,129,303,5,16,21,2,3:07
413812,2015-04-18,2015,NYN,MIA,5,4,5-4,NYN,9,true,34,38,72,149,112,261,11,12,23,2,2:51
413816,2015-04-18,2015,WAS,PHI,3,5,5-3,PHI,9,false,38,38,76,135,125,260,13,11,24,1,2:56 (:12 delay)
413806,2015-04-18,2015,TOR,ATL,6,5,6-5,TOR,10,false,38,42,80,151,123,274,16,13,29,2,2:41
413808,2015-04-18,2015,DET,CHA,3,12,12-3,CHA,9,false,36,48,84,174,144,318,9,22,31,2,3:01
413807,2015-04-18,2015,BOS,BAL,1,4,4-1,BAL,9,false,35,41,76,145,163,308,10,15,25,1,3:24
413818,2015-04-18,2015,SEA,TEX,3,1,3-1,SEA,9,true,36,33,69,141,149,290,15,6,21,1,3:00
413817,2015-04-18,2015,CHN,SDN,7,6,7-6,CHN,11,false,51,44,95,177,219,396,21,11,32,3,3:49
413805,2015-04-18,2015,SFN,ARI,4,1,4-1,SFN,9,true,39,34,73,127,145,272,14,8,22,2,2:38
413809,2015-04-18,2015,SLN,CIN,5,2,5-2,SLN,9,true,37,38,75,132,125,257,15,12,27,3,2:42
413824,2015-04-19,2015,SLN,CIN,2,1,2-1,SLN,9,true,27,37,64,114,86,200,4,10,14,0,2:02
413819,2015-04-19,2015,HOU,ANA,4,3,4-3,HOU,9,true,38,34,72,151,161,312,14,8,22,3,3:20
413822,2015-04-19,2015,BOS,BAL,3,8,8-3,BAL,9,false,37,44,81,153,150,303,10,19,29,1,3:14
413823,2015-04-19,2015,DET,CHA,9,1,9-1,DET,9,true,37,33,70,131,144,275,14,10,24,1,2:45
413829,2015-04-19,2015,TBA,NYA,3,5,5-3,NYA,9,false,38,42,80,178,153,331,12,17,29,6,3:33
413830,2015-04-19,2015,KCA,OAK,4,2,4-2,KCA,9,true,34,37,71,151,124,275,11,13,24,2,3:08
413821,2015-04-19,2015,TOR,ATL,2,5,5-2,ATL,9,false,35,37,72,155,142,297,10,13,23,3,2:41
413832,2015-04-19,2015,CHN,SDN,2,5,5-2,SDN,9,false,38,38,76,152,144,296,10,12,22,1,2:51
413820,2015-04-19,2015,SFN,ARI,1,5,5-1,ARI,9,false,33,38,71,124,112,236,9,11,20,2,2:45
413828,2015-04-19,2015,PIT,MIL,5,2,5-2,PIT,9,true,35,33,68,133,130,263,12,6,18,0,2:39
413831,2015-04-19,2015,WAS,PHI,4,1,4-1,WAS,9,true,38,36,74,117,148,265,15,9,24,1,2:40
413827,2015-04-19,2015,NYN,MIA,7,6,7-6,NYN,9,true,35,39,74,128,129,257,13,12,25,3,2:49
413826,2015-04-19,2015,LAN,COL,7,0,7-0,LAN,9,true,39,32,71,137,152,289,16,7,23,1,2:55
413825,2015-04-19,2015,MIN,CLE,7,2,7-2,MIN,9,true,39,36,75,159,151,310,15,9,24,2,2:45
413833,2015-04-19,2015,SEA,TEX,11,10,11-10,SEA,9,false,49,47,96,166,210,376,25,20,45,5,3:45
413840,2015-04-20,2015,DET,NYA,2,1,2-1,DET,9,true,29,31,60,124,98,222,11,7,18,1,2:20
413835,2015-04-20,2015,PIT,CHN,2,5,5-2,CHN,9,false,33,41,74,141,126,267,5,18,23,0,3:13 (:28 delay)
413836,2015-04-20,2015,MIL,CIN,1,6,6-1,CIN,9,false,32,39,71,131,107,238,4,14,18,0,2:23
413838,2015-04-20,2015,SEA,HOU,5,7,7-5,HOU,9,false,42,37,79,136,179,315,15,10,25,5,3:26
413839,2015-04-20,2015,KCA,MIN,7,1,7-1,KCA,9,true,35,33,68,125,136,261,12,7,19,2,2:43
413834,2015-04-20,2015,BOS,BAL,7,1,7-1,BOS,7,true,32,27,59,113,128,241,14,7,21,2,2:21 (1:42 delay)
413841,2015-04-20,2015,ANA,OAK,3,6,6-3,OAK,9,false,37,38,75,139,143,282,10,12,22,2,2:57
413837,2015-04-20,2015,CHA,CLE,4,3,4-3,CHA,9,false,38,36,74,131,153,284,14,9,23,2,2:53
413842,2015-04-20,2015,COL,SDN,3,14,14-3,SDN,9,false,38,46,84,161,151,312,13,18,31,2,3:09
413851,2015-04-21,2015,PHI,MIA,7,3,7-3,PHI,9,true,34,37,71,131,127,258,10,11,21,0,2:29
413845,2015-04-21,2015,TBA,BOS,0,1,1-0,BOS,9,false,32,37,69,151,117,268,8,10,18,3,2:48
413850,2015-04-21,2015,SFN,LAN,6,2,6-2,SFN,9,true,37,36,73,134,155,289,15,13,28,6,3:09
413843,2015-04-21,2015,NYN,ATL,7,1,7-1,NYN,9,true,40,37,77,140,149,289,15,11,26,3,2:41
413849,2015-04-21,2015,SEA,HOU,3,6,6-3,HOU,9,false,34,43,77,169,127,296,9,16,25,2,3:00
413857,2015-04-21,2015,ARI,TEX,1,7,7-1,TEX,9,false,38,39,77,170,148,318,9,10,19,2,3:04
413853,2015-04-21,2015,DET,NYA,2,5,5-2,NYA,9,false,36,43,79,177,136,313,13,17,30,5,3:24
413854,2015-04-21,2015,ANA,OAK,14,1,14-1,ANA,9,true,44,36,80,146,176,322,20,9,29,2,3:15
413852,2015-04-21,2015,KCA,MIN,6,5,6-5,KCA,9,true,39,37,76,145,141,286,15,11,26,4,2:55
413855,2015-04-21,2015,COL,SDN,6,7,7-6,SDN,9,false,35,44,79,159,137,296,8,21,29,2,3:06
413846,2015-04-21,2015,PIT,CHN,8,9,9-8,CHN,9,false,40,45,85,168,159,327,15,18,33,2,3:18
413847,2015-04-21,2015,MIL,CIN,10,16,16-10,CIN,9,false,42,49,91,185,159,344,15,20,35,2,3:22
413856,2015-04-21,2015,WAS,SLN,2,1,2-1,WAS,10,false,42,44,86,165,196,361,15,18,33,5,3:43
413844,2015-04-21,2015,TOR,BAL,13,6,13-6,TOR,9,true,45,40,85,142,157,299,21,14,35,3,2:53
413848,2015-04-21,2015,CHA,CLE,2,6,6-2,CLE,9,false,35,38,73,173,140,313,8,12,20,5,3:07
413862,2015-04-22,2015,MIL,CIN,1,2,2-1,CIN,9,false,34,31,65,110,139,249,7,7,14,0,2:28
413870,2015-04-22,2015,COL,SDN,5,4,5-4,COL,9,false,36,34,70,108,131,239,16,8,24,0,2:39
413864,2015-04-22,2015,SEA,HOU,3,2,3-2,SEA,9,true,31,39,70,132,114,246,8,13,21,2,2:34
413867,2015-04-22,2015,KCA,MIN,0,3,3-0,MIN,9,false,35,42,77,155,122,277,10,17,27,0,2:47
413859,2015-04-22,2015,TOR,BAL,4,2,4-2,TOR,9,true,35,36,71,136,137,273,12,13,25,2,2:36
413865,2015-04-22,2015,SFN,LAN,3,2,3-2,SFN,9,false,34,38,72,146,138,284,9,10,19,3,3:16
413858,2015-04-22,2015,NYN,ATL,3,2,3-2,NYN,9,true,34,36,70,131,143,274,10,12,22,2,2:34 (:31 delay)
413863,2015-04-22,2015,CHA,CLE,6,0,6-0,CHA,9,true,37,38,75,162,126,288,15,12,27,1,2:56
413860,2015-04-22,2015,TBA,BOS,7,5,7-5,TBA,9,true,37,40,77,166,134,300,16,13,29,3,3:10
413869,2015-04-22,2015,ANA,OAK,2,9,9-2,OAK,9,false,34,45,79,158,124,282,7,21,28,2,2:58
413861,2015-04-22,2015,PIT,CHN,4,3,4-3,PIT,9,true,34,40,74,168,131,299,8,13,21,3,3:04
413866,2015-04-22,2015,PHI,MIA,1,6,6-1,MIA,9,false,30,44,74,178,126,304,5,17,22,1,2:55
413872,2015-04-22,2015,ARI,TEX,8,5,8-5,ARI,9,true,37,38,75,146,153,299,11,15,26,2,2:59
413871,2015-04-22,2015,WAS,SLN,5,7,7-5,SLN,9,false,37,43,80,166,140,306,10,17,27,1,2:51
413868,2015-04-22,2015,DET,NYA,4,13,13-4,NYA,9,false,37,49,86,212,155,367,11,23,34,2,3:35
413877,2015-04-23,2015,MIL,CIN,4,2,4-2,MIL,9,true,34,30,64,123,121,244,12,5,17,1,2:28
413884,2015-04-23,2015,WAS,SLN,1,4,4-1,SLN,9,false,35,36,71,118,122,240,9,11,20,1,2:31
413882,2015-04-23,2015,ANA,OAK,2,0,2-0,ANA,9,true,29,37,66,145,108,253,4,10,14,1,2:20
413881,2015-04-23,2015,DET,NYA,1,2,2-1,NYA,9,false,32,36,68,153,123,276,5,10,15,3,3:02
413875,2015-04-23,2015,TBA,BOS,2,1,2-1,TBA,9,false,36,34,70,125,146,271,11,6,17,1,3:00
413873,2015-04-23,2015,NYN,ATL,6,3,6-3,NYN,9,true,37,35,72,132,179,311,14,9,23,3,3:18
413876,2015-04-23,2015,PIT,CHN,5,4,5-4,PIT,9,true,36,35,71,141,169,310,13,11,24,3,3:06
413880,2015-04-23,2015,PHI,MIA,1,9,9-1,MIA,9,false,35,45,80,188,124,312,10,18,28,1,2:52
413874,2015-04-23,2015,TOR,BAL,7,6,7-6,TOR,9,true,38,36,74,122,146,268,15,9,24,2,2:36
413883,2015-04-23,2015,COL,SDN,2,1,2-1,COL,9,true,37,34,71,143,154,297,13,10,23,2,2:53
413879,2015-04-23,2015,SFN,LAN,3,2,3-2,SFN,10,false,42,39,81,138,153,291,16,10,26,3,3:23
413878,2015-04-23,2015,CHA,KCA,2,3,3-2,KCA,13,false,51,50,101,187,189,376,13,17,30,0,4:07
413892,2015-04-24,2015,SEA,MIN,2,0,2-0,SEA,9,true,30,32,62,102,96,198,6,5,11,0,2:03
413893,2015-04-24,2015,NYA,NYN,6,1,6-1,NYA,9,true,37,32,69,115,140,255,13,5,18,2,2:33
413899,2015-04-24,2015,MIA,WAS,3,2,3-2,MIA,9,true,31,35,66,121,108,229,9,9,18,3,2:32
413885,2015-04-24,2015,PHI,ATL,1,0,1-0,PHI,9,false,37,28,65,117,142,259,10,4,14,3,2:34
413896,2015-04-24,2015,MIL,SLN,0,3,3-0,SLN,9,false,32,38,70,140,121,261,7,12,19,1,2:42
413897,2015-04-24,2015,ANA,TEX,3,2,3-2,ANA,9,true,35,33,68,134,139,273,12,8,20,0,2:47
413895,2015-04-24,2015,COL,SFN,6,4,6-4,COL,9,true,41,38,79,127,134,261,19,16,35,3,2:51
413891,2015-04-24,2015,SDN,LAN,0,3,3-0,LAN,9,false,35,36,71,144,133,277,9,11,20,2,3:04
413898,2015-04-24,2015,TBA,TOR,12,3,12-3,TBA,9,true,41,34,75,129,154,283,16,7,23,2,2:29
413894,2015-04-24,2015,ARI,PIT,1,4,4-1,PIT,9,false,36,36,72,133,123,256,9,11,20,3,2:41
413890,2015-04-24,2015,CHA,KCA,3,2,3-2,CHA,9,false,40,33,73,130,164,294,14,9,23,3,3:19
413888,2015-04-24,2015,DET,CLE,1,13,13-1,CLE,9,false,39,43,82,140,150,290,12,18,30,1,2:52
413886,2015-04-24,2015,BAL,BOS,5,7,7-5,BOS,9,false,39,41,80,146,161,307,15,14,29,4,3:29
413890,2015-04-24,2015,CHA,KCA,3,2,3-2,CHA,9,false,40,33,73,130,164,294,14,9,23,3,3:19
413889,2015-04-24,2015,OAK,HOU,4,5,5-4,HOU,11,false,42,49,91,187,161,348,11,20,31,3,3:36
413887,2015-04-24,2015,CIN,CHN,3,7,7-3,CHN,11,false,44,45,89,194,200,394,13,13,26,2,3:48
413900,2015-04-25,2015,PHI,ATL,2,5,5-2,ATL,9,false,34,38,72,134,106,240,8,13,21,2,2:27
413913,2015-04-25,2015,TBA,TOR,4,2,4-2,TBA,9,true,35,33,68,132,135,267,12,7,19,2,2:31
413908,2015-04-25,2015,NYA,NYN,2,8,8-2,NYN,9,false,33,41,74,152,110,262,7,13,20,2,2:45
413914,2015-04-25,2015,MIA,WAS,8,0,8-0,MIA,9,true,37,34,71,120,145,265,16,8,24,1,2:35
413911,2015-04-25,2015,MIL,SLN,3,5,5-3,SLN,9,false,37,38,75,145,124,269,13,13,26,4,3:01
413909,2015-04-25,2015,ARI,PIT,1,2,2-1,PIT,9,false,36,34,70,143,127,270,12,7,19,0,2:52
413903,2015-04-25,2015,DET,CLE,4,1,4-1,DET,9,true,39,35,74,148,154,302,18,10,28,1,2:58
413904,2015-04-25,2015,OAK,HOU,3,9,9-3,HOU,9,false,37,44,81,142,152,294,10,17,27,2,2:55
413901,2015-04-25,2015,BAL,BOS,5,4,5-4,BAL,10,false,41,39,80,145,131,276,13,11,24,1,2:57
413912,2015-04-25,2015,ANA,TEX,4,1,4-1,ANA,9,true,34,38,72,146,151,297,13,12,25,4,3:10
413906,2015-04-25,2015,SDN,LAN,8,11,11-8,LAN,9,false,38,45,83,196,164,360,11,19,30,3,3:36
413907,2015-04-25,2015,SEA,MIN,5,8,8-5,MIN,9,false,37,46,83,192,146,338,10,17,27,8,3:26
413910,2015-04-25,2015,COL,SFN,4,5,5-4,SFN,11,false,42,51,93,199,140,339,12,19,31,3,3:52
413928,2015-04-26,2015,TBA,TOR,5,1,5-1,TBA,9,true,38,34,72,126,121,247,16,6,22,1,2:23
413921,2015-04-26,2015,SDN,LAN,3,1,3-1,SDN,9,true,30,31,61,132,118,250,7,6,13,0,2:30
413923,2015-04-26,2015,NYA,NYN,6,4,6-4,NYA,9,true,33,36,69,142,127,269,10,10,20,3,2:45
413929,2015-04-26,2015,MIA,WAS,6,2,6-2,MIA,9,true,38,34,72,151,133,284,15,7,22,1,2:40
413915,2015-04-26,2015,PHI,ATL,5,4,5-4,PHI,9,true,34,40,74,142,121,263,11,14,25,1,2:38
413917,2015-04-26,2015,CIN,CHN,2,5,5-2,CHN,9,false,36,36,72,142,153,295,9,10,19,0,2:46
413926,2015-04-26,2015,MIL,SLN,6,3,6-3,MIL,9,true,35,44,79,157,134,291,11,17,28,1,3:03
413918,2015-04-26,2015,DET,CLE,8,6,8-6,DET,9,true,40,39,79,131,153,284,19,13,32,2,3:01
413919,2015-04-26,2015,OAK,HOU,6,7,7-6,HOU,9,false,37,42,79,167,139,306,10,15,25,2,3:11
413924,2015-04-26,2015,ARI,PIT,0,8,8-0,PIT,9,false,35,44,79,178,140,318,10,17,27,4,3:18
413922,2015-04-26,2015,SEA,MIN,2,4,4-2,MIN,11,false,43,49,92,205,148,353,11,20,31,3,3:40
413916,2015-04-26,2015,BAL,BOS,18,7,18-7,BAL,9,true,49,43,92,152,185,337,24,15,39,3,3:13
413927,2015-04-26,2015,ANA,TEX,4,5,5-4,TEX,11,false,51,52,103,203,186,389,20,19,39,1,4:13
413920,2015-04-26,2015,CHA,KCA,5,3,5-3,CHA,9,true,33,36,69,145,119,264,8,10,18,2,2:48
413936,2015-04-27,2015,MIA,NYN,1,3,3-1,NYN,9,false,33,35,68,120,86,206,6,9,15,1,1:58
413938,2015-04-27,2015,CHN,PIT,4,0,4-0,CHN,9,true,34,32,66,120,124,244,13,4,17,0,2:20
413937,2015-04-27,2015,SLN,PHI,1,4,4-1,PHI,9,false,36,37,73,108,147,255,11,12,23,0,2:32
413939,2015-04-27,2015,TEX,SEA,1,3,3-1,SEA,9,false,36,33,69,140,130,270,10,8,18,2,2:47 (:55 delay)
413941,2015-04-27,2015,NYA,TBA,4,1,4-1,NYA,9,true,38,34,72,127,162,289,16,7,23,4,2:59
413932,2015-04-27,2015,MIN,DET,4,5,5-4,DET,9,false,38,38,76,151,145,296,11,18,29,3,3:17
413942,2015-04-27,2015,BOS,TOR,6,5,6-5,BOS,9,false,37,36,73,145,156,301,14,10,24,1,2:48 (:33 delay)
413940,2015-04-27,2015,LAN,SFN,8,3,8-3,LAN,9,true,39,37,76,143,136,279,16,11,27,2,2:58
413934,2015-04-27,2015,CLE,KCA,2,6,6-2,KCA,9,false,35,42,77,154,157,311,9,17,26,2,3:22
413943,2015-04-27,2015,ATL,WAS,8,4,8-4,ATL,9,true,40,39,79,150,158,308,17,11,28,3,3:08
413931,2015-04-27,2015,ARI,COL,4,5,5-4,COL,9,false,40,38,78,149,159,308,13,17,30,2,3:29
413933,2015-04-27,2015,SDN,HOU,4,9,9-4,HOU,9,false,37,42,79,193,137,330,10,15,25,3,3:28
413935,2015-04-27,2015,CIN,MIL,9,6,9-6,CIN,9,true,42,39,81,147,176,323,20,15,35,3,3:02
413944,2015-04-28,2015,OAK,ANA,6,2,6-2,OAK,9,true,33,31,64,117,116,233,9,7,16,0,2:06
413950,2015-04-28,2015,CIN,MIL,4,2,4-2,CIN,9,true,33,31,64,98,136,234,10,4,14,0,2:11
413947,2015-04-28,2015,MIN,DET,3,2,3-2,MIN,9,true,34,32,66,128,132,260,11,5,16,1,2:40
413954,2015-04-28,2015,TEX,SEA,1,2,2-1,SEA,9,false,35,34,69,141,119,260,8,9,17,4,2:43
413955,2015-04-28,2015,LAN,SFN,1,2,2-1,SFN,9,false,33,38,71,129,120,249,6,12,18,2,2:50
413951,2015-04-28,2015,MIA,NYN,4,3,4-3,MIA,9,true,34,40,74,138,125,263,10,12,22,3,2:46
413953,2015-04-28,2015,CHN,PIT,6,2,6-2,CHN,9,true,42,32,74,117,159,276,20,5,25,1,2:51
413956,2015-04-28,2015,NYA,TBA,4,2,4-2,NYA,9,true,34,39,73,167,124,291,11,12,23,2,2:58
413949,2015-04-28,2015,CLE,KCA,5,11,11-5,KCA,9,false,39,45,84,155,151,306,14,23,37,3,3:13
413946,2015-04-28,2015,ARI,COL,12,5,12-5,ARI,9,true,40,41,81,159,134,293,18,15,33,2,3:10
413952,2015-04-28,2015,SLN,PHI,11,5,11-5,SLN,9,true,44,39,83,126,172,298,21,12,33,3,2:58
413948,2015-04-28,2015,SDN,HOU,3,14,14-3,HOU,9,false,36,50,86,185,143,328,8,23,31,1,3:17
413957,2015-04-28,2015,BOS,TOR,8,11,11-8,TOR,9,false,46,48,94,197,175,372,20,23,43,5,4:01
413958,2015-04-28,2015,ATL,WAS,12,13,13-12,WAS,9,false,51,47,98,148,174,322,25,20,45,2,3:26
413960,2015-04-29,2015,BAL,CHA,8,2,8-2,BAL,9,true,36,31,67,115,112,227,12,5,17,0,2:03
413972,2015-04-29,2015,BOS,TOR,4,1,4-1,BOS,9,true,32,33,65,135,121,256,10,6,16,0,2:43
413961,2015-04-29,2015,ARI,COL,9,1,9-1,ARI,9,true,40,31,71,110,136,246,18,5,23,1,2:34
413967,2015-04-29,2015,SLN,PHI,5,2,5-2,SLN,9,true,35,38,73,138,110,248,11,13,24,0,2:38
413964,2015-04-29,2015,CLE,KCA,7,5,7-5,CLE,9,true,37,37,74,138,136,274,13,10,23,2,2:41
413970,2015-04-29,2015,LAN,SFN,7,3,7-3,LAN,9,true,33,37,70,154,119,273,11,9,20,0,2:54
413966,2015-04-29,2015,MIA,NYN,7,3,7-3,MIA,9,true,36,36,72,142,127,269,13,11,24,4,2:54
413959,2015-04-29,2015,OAK,ANA,3,6,6-3,ANA,9,false,36,37,73,153,131,284,9,12,21,4,3:01
413963,2015-04-29,2015,SDN,HOU,2,7,7-2,HOU,9,false,31,40,71,159,127,286,3,12,15,1,2:34
413965,2015-04-29,2015,CIN,MIL,3,8,8-3,MIL,9,false,34,44,78,184,129,313,9,16,25,1,2:58
413973,2015-04-29,2015,ATL,WAS,4,13,13-4,WAS,9,false,33,47,80,192,120,312,9,20,29,0,2:47
413969,2015-04-29,2015,TEX,SEA,2,5,5-2,SEA,9,false,32,43,75,169,143,312,6,16,22,4,3:05
413968,2015-04-29,2015,CHN,PIT,1,8,8-1,PIT,9,false,33,46,79,175,154,329,9,21,30,0,3:04
413962,2015-04-29,2015,MIN,DET,7,10,10-7,DET,9,false,40,42,82,158,163,321,15,17,32,6,3:33
413971,2015-04-29,2015,NYA,TBA,2,3,3-2,TBA,13,false,48,51,99,196,194,390,11,13,24,3,3:58
413976,2015-04-30,2015,ATL,CIN,1,5,5-1,CIN,9,false,31,40,71,146,122,268,7,14,21,0,2:22
413977,2015-04-30,2015,KCA,DET,8,1,8-1,KCA,9,true,40,35,75,129,145,274,16,10,26,2,3:02
413981,2015-04-30,2015,NYN,WAS,2,8,8-2,WAS,9,false,35,42,77,156,139,295,8,15,23,4,2:54
413979,2015-04-30,2015,HOU,SEA,3,2,3-2,HOU,10,false,37,39,76,145,137,282,10,13,23,2,3:01
413978,2015-04-30,2015,SLN,PHI,9,3,9-3,SLN,9,true,40,36,76,133,163,296,19,10,29,4,2:55
413980,2015-04-30,2015,CLE,TOR,1,5,5-1,TOR,9,false,38,37,75,124,172,296,13,12,25,2,2:46
413974,2015-04-30,2015,OAK,ANA,5,6,6-5,ANA,9,false,39,42,81,154,161,315,14,17,31,3,3:23
413975,2015-04-30,2015,MIN,CHA,12,2,12-2,MIN,9,true,40,39,79,139,129,268,15,13,28,2,2:40
413984,2015-05-01,2015,MIN,CHA,1,0,1-0,MIN,9,true,31,35,66,111,124,235,10,8,18,1,2:32
413982,2015-05-01,2015,SFN,ANA,3,2,3-2,SFN,9,false,36,37,73,144,133,277,10,9,19,3,3:04
413989,2015-05-01,2015,BOS,NYA,2,3,3-2,NYA,9,false,38,42,80,136,151,287,12,17,29,1,3:14
413988,2015-05-01,2015,CHN,MIL,1,0,1-0,CHN,9,true,33,33,66,118,156,274,13,6,19,0,2:39
413996,2015-05-01,2015,NYN,WAS,4,0,4-0,NYN,9,true,34,32,66,122,120,242,11,7,18,2,2:29
413983,2015-05-01,2015,LAN,ARI,8,0,8-0,LAN,9,true,36,33,69,113,157,270,12,6,18,1,2:47
413994,2015-05-01,2015,BAL,TBA,0,2,2-0,TBA,9,false,31,32,63,120,114,234,4,6,10,0,2:19
413987,2015-05-01,2015,KCA,DET,4,1,4-1,KCA,9,true,35,36,71,151,110,261,12,9,21,1,2:47
413992,2015-05-01,2015,SLN,PIT,2,1,2-1,SLN,10,false,40,37,77,148,166,314,14,9,23,4,3:31
413993,2015-05-01,2015,HOU,SEA,4,3,4-3,HOU,9,true,32,35,67,138,130,268,12,8,20,2,2:50
413985,2015-05-01,2015,ATL,CIN,4,3,4-3,ATL,9,true,35,37,72,141,134,275,12,11,23,1,2:36
413990,2015-05-01,2015,TEX,OAK,5,7,7-5,OAK,9,false,39,38,77,173,140,313,12,12,24,3,3:11
413995,2015-05-01,2015,CLE,TOR,9,4,9-4,CLE,9,true,41,37,78,144,135,279,18,12,30,1,2:37
413991,2015-05-01,2015,MIA,PHI,4,3,4-3,MIA,9,false,40,34,74,148,148,296,19,8,27,0,2:57
413986,2015-05-01,2015,SDN,COL,14,3,14-3,SDN,9,true,45,35,80,150,173,323,19,9,28,1,3:26
413997,2015-05-02,2015,SFN,ANA,5,4,5-4,SFN,9,true,37,33,70,117,127,244,13,8,21,3,2:36
414004,2015-05-02,2015,BOS,NYA,2,4,4-2,NYA,9,false,36,35,71,136,147,283,10,9,19,3,2:44
414009,2015-05-02,2015,BAL,TBA,4,0,4-0,BAL,9,true,34,32,66,122,147,269,11,5,16,1,2:33
414002,2015-05-02,2015,KCA,DET,1,2,2-1,DET,9,false,31,36,67,138,106,244,5,10,15,0,2:55
413999,2015-05-02,2015,MIN,CHA,5,3,5-3,MIN,9,true,37,35,72,130,140,270,14,13,27,5,3:05
414011,2015-05-02,2015,NYN,WAS,0,1,1-0,WAS,9,false,33,37,70,127,137,264,8,10,18,1,2:31
414008,2015-05-02,2015,HOU,SEA,11,4,11-4,HOU,9,true,41,35,76,132,138,270,18,9,27,1,2:38
414006,2015-05-02,2015,MIA,PHI,7,0,7-0,MIA,9,true,40,33,73,141,135,276,18,6,24,0,2:38
414000,2015-05-02,2015,ATL,CIN,4,8,8-4,CIN,9,false,36,40,76,131,138,269,10,14,24,2,2:34
414003,2015-05-02,2015,CHN,MIL,1,6,6-1,MIL,9,false,35,39,74,160,153,313,8,13,21,2,3:05
414010,2015-05-02,2015,CLE,TOR,4,11,11-4,TOR,9,false,40,45,85,157,166,323,12,18,30,4,3:23
413998,2015-05-02,2015,LAN,ARI,6,4,6-4,LAN,9,true,37,36,73,143,142,285,14,11,25,2,3:14
414001,2015-05-02,2015,SDN,COL,4,2,4-2,SDN,9,true,37,34,71,137,150,287,14,8,22,0,2:57
414007,2015-05-02,2015,SLN,PIT,2,1,2-1,SLN,11,false,38,52,90,179,131,310,10,21,31,2,3:27
414005,2015-05-02,2015,TEX,OAK,8,7,8-7,TEX,10,false,45,44,89,169,157,326,19,15,34,7,3:45
414012,2015-05-03,2015,SFN,ANA,5,0,5-0,SFN,9,true,36,32,68,124,119,243,13,5,18,0,2:16
414017,2015-05-03,2015,KCA,DET,4,6,6-4,DET,9,false,34,36,70,117,132,249,7,12,19,1,2:38
414026,2015-05-03,2015,NYN,WAS,0,1,1-0,WAS,9,false,34,40,74,146,130,276,7,15,22,4,2:55
414023,2015-05-03,2015,HOU,SEA,7,6,7-6,HOU,9,true,34,36,70,143,121,264,13,13,26,2,2:50
414018,2015-05-03,2015,CHN,MIL,3,5,5-3,MIL,9,false,38,37,75,133,142,275,10,13,23,3,3:01
414025,2015-05-03,2015,CLE,TOR,10,7,10-7,CLE,9,true,41,42,83,152,163,315,21,15,36,5,3:06
414015,2015-05-03,2015,ATL,CIN,5,0,5-0,ATL,9,true,33,34,67,146,108,254,10,8,18,1,2:31
414024,2015-05-03,2015,BAL,TBA,4,2,4-2,BAL,9,true,35,36,71,129,131,260,11,10,21,5,2:44
414021,2015-05-03,2015,MIA,PHI,2,6,6-2,PHI,9,false,34,42,76,158,111,269,8,13,21,1,2:45
414016,2015-05-03,2015,SDN,COL,8,6,8-6,SDN,9,true,35,39,74,151,136,287,11,13,24,2,3:12
414014,2015-05-03,2015,MIN,CHA,13,3,13-3,MIN,9,true,47,38,85,135,166,301,21,14,35,4,3:20
414020,2015-05-03,2015,TEX,OAK,1,7,7-1,OAK,9,false,42,42,84,173,160,333,14,16,30,4,3:21
414019,2015-05-03,2015,BOS,NYA,5,8,8-5,NYA,9,false,39,47,86,188,165,353,13,19,32,6,3:52
414013,2015-05-03,2015,LAN,ARI,1,0,1-0,LAN,13,false,44,44,88,177,191,368,9,11,20,4,4:02
414022,2015-05-03,2015,SLN,PIT,3,2,3-2,SLN,14,false,54,57,111,218,216,434,18,15,33,3,4:28
414031,2015-05-04,2015,TOR,NYA,3,1,3-1,TOR,9,true,34,32,66,118,112,230,10,6,16,1,2:18
414034,2015-05-04,2015,SFN,SDN,2,0,2-0,SFN,9,true,33,33,66,128,117,245,11,3,14,1,2:32
414030,2015-05-04,2015,WAS,MIA,6,4,6-4,WAS,9,true,39,39,78,133,128,261,16,14,30,3,2:42
414037,2015-05-04,2015,HOU,TEX,1,2,2-1,TEX,9,false,32,35,67,128,134,262,6,9,15,0,2:36
414029,2015-05-04,2015,MIL,LAN,4,3,4-3,MIL,9,true,31,39,70,177,105,282,7,12,19,1,2:51
414036,2015-05-04,2015,BOS,TBA,1,5,5-1,TBA,9,false,34,42,76,162,139,301,8,16,24,1,3:10
414028,2015-05-04,2015,SLN,CHN,10,9,10-9,SLN,9,true,40,46,86,193,154,347,16,19,35,4,3:39
414033,2015-05-04,2015,ATL,PHI,2,5,5-2,PHI,9,false,38,42,80,163,164,327,12,18,30,2,3:08
414035,2015-05-04,2015,ANA,SEA,2,3,3-2,SEA,9,false,34,33,67,112,129,241,10,6,16,2,2:36
414032,2015-05-04,2015,MIN,OAK,8,7,8-7,MIN,9,true,38,42,80,143,161,304,15,15,30,2,3:10
414039,2015-05-05,2015,NYN,BAL,3,2,3-2,NYN,9,true,30,34,64,112,105,217,8,7,15,1,2:19
414049,2015-05-05,2015,SFN,SDN,6,0,6-0,SFN,9,true,37,33,70,119,129,248,14,6,20,0,2:25
414050,2015-05-05,2015,ANA,SEA,5,4,5-4,ANA,9,false,35,39,74,146,114,260,13,13,26,1,2:37
414043,2015-05-05,2015,CHA,DET,5,2,5-2,CHA,9,true,32,36,68,127,115,242,11,8,19,1,2:37
414051,2015-05-05,2015,BOS,TBA,2,0,2-0,BOS,9,true,32,34,66,127,120,247,8,8,16,0,2:26
414042,2015-05-05,2015,KCA,CLE,5,3,5-3,KCA,9,true,32,33,65,129,134,263,8,6,14,1,2:26
414044,2015-05-05,2015,MIL,LAN,2,8,8-2,LAN,9,false,33,42,75,184,119,303,6,15,21,3,3:12
414046,2015-05-05,2015,TOR,NYA,3,6,6-3,NYA,9,false,37,39,76,156,128,284,11,13,24,2,2:54
414052,2015-05-05,2015,HOU,TEX,1,7,7-1,TEX,9,false,31,37,68,156,117,273,4,13,17,0,2:41
414048,2015-05-05,2015,ATL,PHI,9,0,9-0,ATL,9,true,40,31,71,99,150,249,18,4,22,1,2:23
414047,2015-05-05,2015,MIN,OAK,1,2,2-1,OAK,9,false,33,37,70,145,117,262,6,11,17,4,2:43
414045,2015-05-05,2015,WAS,MIA,1,2,2-1,MIA,9,false,36,39,75,157,147,304,9,11,20,2,3:07 (:28 delay)
414040,2015-05-05,2015,SLN,CHN,7,4,7-4,SLN,9,true,39,42,81,180,127,307,17,14,31,3,3:13
414041,2015-05-05,2015,PIT,CIN,1,7,7-1,CIN,9,false,37,40,77,139,148,287,11,15,26,1,2:50
414065,2015-05-06,2015,ANA,SEA,4,3,4-3,ANA,9,false,33,37,70,132,111,243,9,11,20,1,2:35
414038,2015-05-06,2015,COL,ARI,1,5,5-1,ARI,9,false,32,39,71,129,129,258,6,14,20,1,2:31
414059,2015-05-06,2015,MIL,LAN,6,3,6-3,MIL,9,true,38,34,72,117,144,261,15,8,23,2,2:47
414054,2015-05-06,2015,NYN,BAL,5,1,5-1,NYN,9,true,34,38,72,139,149,288,10,11,21,1,2:52
414058,2015-05-06,2015,CHA,DET,7,6,7-6,CHA,9,true,42,45,87,177,179,356,17,20,37,4,3:41
414038,2015-05-06,2015,COL,ARI,1,5,5-1,ARI,9,false,32,39,71,129,129,258,6,14,20,1,2:31
414067,2015-05-06,2015,HOU,TEX,3,11,11-3,TEX,9,false,34,42,76,154,102,256,9,16,25,1,2:32
414055,2015-05-06,2015,SLN,CHN,5,6,6-5,CHN,9,false,41,38,79,140,140,280,15,13,28,0,2:56
414056,2015-05-06,2015,PIT,CIN,0,3,3-0,CIN,9,false,35,37,72,136,120,256,7,13,20,0,2:35
414061,2015-05-06,2015,TOR,NYA,5,1,5-1,TOR,9,true,36,36,72,135,128,263,14,11,25,3,2:30
414064,2015-05-06,2015,SFN,SDN,1,9,9-1,SDN,9,false,33,50,83,171,119,290,7,23,30,1,2:59
414060,2015-05-06,2015,WAS,MIA,7,5,7-5,WAS,9,true,36,40,76,151,129,280,14,14,28,1,2:40
414063,2015-05-06,2015,ATL,PHI,7,5,7-5,ATL,9,true,35,42,77,170,129,299,14,16,30,3,3:07
414057,2015-05-06,2015,KCA,CLE,3,10,10-3,CLE,9,false,34,44,78,174,122,296,7,19,26,2,3:04
414066,2015-05-06,2015,BOS,TBA,3,5,5-3,TBA,9,false,39,43,82,160,155,315,11,19,30,5,3:22
414062,2015-05-06,2015,MIN,OAK,13,0,13-0,MIN,9,true,41,34,75,139,158,297,17,8,25,1,2:56
414053,2015-05-06,2015,COL,ARI,7,13,13-7,ARI,9,false,41,50,91,196,147,343,15,27,42,5,3:29
414073,2015-05-07,2015,ANA,HOU,2,3,3-2,HOU,9,false,33,38,71,155,119,274,9,12,21,4,2:57
414069,2015-05-07,2015,SLN,CHN,5,1,5-1,SLN,9,true,34,35,69,132,143,275,12,8,20,4,2:53
414068,2015-05-07,2015,NYA,BAL,4,3,4-3,NYA,9,true,36,36,72,152,139,291,14,10,24,2,2:51
414072,2015-05-07,2015,CHA,DET,1,4,4-1,DET,9,false,33,39,72,166,116,282,7,14,21,2,2:53
414075,2015-05-07,2015,SFN,MIA,2,7,7-2,MIA,9,false,34,41,75,135,113,248,9,17,26,1,2:31
414076,2015-05-07,2015,MIN,OAK,6,5,6-5,MIN,9,true,35,37,72,149,142,291,11,10,21,2,2:57
414078,2015-05-07,2015,TBA,TEX,4,5,5-4,TEX,9,false,34,40,74,174,135,309,8,12,20,2,2:47
414077,2015-05-07,2015,ARI,SDN,11,0,11-0,ARI,9,true,42,32,74,138,154,292,18,5,23,0,2:52
414070,2015-05-07,2015,PIT,CIN,7,2,7-2,PIT,9,true,40,36,76,122,158,280,18,12,30,2,2:56
414071,2015-05-07,2015,KCA,CLE,7,4,7-4,KCA,9,true,42,37,79,149,155,304,17,10,27,4,3:13 (2:17 delay)
414074,2015-05-07,2015,MIL,LAN,4,14,14-4,LAN,9,false,38,49,87,196,129,325,11,26,37,3,3:16
414086,2015-05-08,2015,COL,LAN,1,2,2-1,LAN,6,true,20,23,43,90,62,152,8,10,18,0,1:41 (2:44 delay)
414084,2015-05-08,2015,ANA,HOU,2,0,2-0,ANA,9,true,30,32,62,120,96,216,8,6,14,1,2:09
414089,2015-05-08,2015,PHI,NYN,3,1,3-1,PHI,9,true,32,35,67,137,114,251,9,9,18,1,2:27
414079,2015-05-08,2015,WAS,ATL,9,2,9-2,WAS,9,true,36,34,70,127,131,258,13,9,22,1,2:21
414081,2015-05-08,2015,TOR,BOS,7,0,7-0,TOR,9,true,36,34,70,134,150,284,13,8,21,2,2:41
414080,2015-05-08,2015,NYA,BAL,5,4,5-4,NYA,9,true,34,40,74,153,142,295,13,15,28,4,3:05
414093,2015-05-08,2015,TBA,TEX,8,2,8-2,TBA,9,true,36,36,72,157,147,304,11,9,20,4,2:55
414092,2015-05-08,2015,PIT,SLN,5,8,8-5,SLN,9,false,39,40,79,141,158,299,13,12,25,1,2:58
414085,2015-05-08,2015,DET,KCA,6,5,6-5,DET,9,false,38,39,77,127,142,269,16,14,30,2,3:18
414091,2015-05-08,2015,ARI,SDN,5,6,6-5,SDN,9,false,37,43,80,178,138,316,11,18,29,2,3:26
414088,2015-05-08,2015,CLE,MIN,3,9,9-3,MIN,9,false,37,42,79,138,132,270,10,16,26,2,2:47
414090,2015-05-08,2015,SEA,OAK,4,3,4-3,SEA,11,false,42,44,86,180,178,358,14,11,25,3,3:34
414087,2015-05-08,2015,SFN,MIA,6,0,6-0,SFN,9,true,41,34,75,152,149,301,19,7,26,0,2:47
414082,2015-05-08,2015,MIL,CHN,6,7,7-6,CHN,9,false,42,39,81,153,150,303,18,12,30,1,3:03
414107,2015-05-09,2015,PIT,SLN,7,5,7-5,PIT,9,true,34,39,73,126,115,241,13,14,27,2,2:34
414095,2015-05-09,2015,NYA,BAL,2,6,6-2,BAL,9,false,38,39,77,140,151,291,9,13,22,2,2:55
414083,2015-05-09,2015,CHA,CIN,8,2,8-2,CHA,9,true,38,35,73,154,140,294,16,12,28,3,2:53
414104,2015-05-09,2015,PHI,NYN,2,3,3-2,NYN,9,false,37,39,76,144,120,264,10,12,22,3,2:44
414108,2015-05-09,2015,TBA,TEX,7,2,7-2,TBA,9,true,37,40,77,154,165,319,15,12,27,4,3:18
414083,2015-05-09,2015,CHA,CIN,8,2,8-2,CHA,9,true,38,35,73,154,140,294,16,12,28,3,2:53
414100,2015-05-09,2015,DET,KCA,2,6,6-2,KCA,9,false,37,43,80,149,112,261,10,18,28,1,2:40
414096,2015-05-09,2015,TOR,BOS,7,1,7-1,TOR,9,true,42,37,79,152,169,321,17,9,26,1,3:12
414094,2015-05-09,2015,WAS,ATL,8,6,8-6,WAS,9,false,40,38,78,139,147,286,18,11,29,3,3:12
414099,2015-05-09,2015,ANA,HOU,5,6,6-5,HOU,9,false,39,37,76,142,144,286,14,11,25,1,2:42
414097,2015-05-09,2015,MIL,CHN,12,4,12-4,MIL,9,true,40,36,76,150,164,314,16,9,25,1,3:03
414098,2015-05-09,2015,CHA,CIN,4,10,10-4,CIN,9,false,35,48,83,175,131,306,8,23,31,4,3:33
414103,2015-05-09,2015,CLE,MIN,4,7,7-4,MIN,9,false,41,43,84,157,146,303,15,19,34,3,3:02
414102,2015-05-09,2015,SFN,MIA,2,6,6-2,MIA,9,false,39,41,80,181,160,341,13,13,26,1,3:24
414105,2015-05-09,2015,SEA,OAK,7,2,7-2,SEA,9,true,43,41,84,162,178,340,19,12,31,4,3:36
414106,2015-05-09,2015,ARI,SDN,4,6,6-4,SDN,12,false,48,54,102,198,204,402,15,19,34,3,4:17
414114,2015-05-10,2015,ANA,HOU,3,1,3-1,ANA,9,true,31,33,64,132,110,242,8,6,14,1,2:40
414120,2015-05-10,2015,SEA,OAK,4,3,4-3,SEA,9,true,34,34,68,129,136,265,9,7,16,1,2:36
414121,2015-05-10,2015,ARI,SDN,2,1,2-1,ARI,9,true,29,37,66,136,120,256,6,12,18,4,2:47
414123,2015-05-10,2015,TBA,TEX,1,2,2-1,TEX,9,false,34,38,72,146,149,295,8,12,20,2,3:06
414109,2015-05-10,2015,WAS,ATL,5,4,5-4,WAS,9,true,33,41,74,147,119,266,13,15,28,1,2:51
414117,2015-05-10,2015,SFN,MIA,3,2,3-2,SFN,9,false,38,35,73,136,155,291,14,9,23,1,3:02
414115,2015-05-10,2015,DET,KCA,1,2,2-1,KCA,10,false,41,37,78,127,170,297,11,8,19,0,3:23 (1:43 delay)
414119,2015-05-10,2015,PHI,NYN,4,7,7-4,NYN,9,false,38,41,79,133,130,263,11,15,26,3,2:57
414111,2015-05-10,2015,TOR,BOS,3,6,6-3,BOS,9,false,36,37,73,138,136,274,12,11,23,1,2:38
414122,2015-05-10,2015,PIT,SLN,4,3,4-3,PIT,9,true,35,36,71,129,131,260,12,11,23,2,2:38
414118,2015-05-10,2015,CLE,MIN,8,2,8-2,CLE,9,true,40,31,71,148,134,282,17,4,21,0,2:37
414116,2015-05-10,2015,COL,LAN,5,9,9-5,LAN,9,false,39,44,83,181,152,333,14,19,33,5,3:36
414112,2015-05-10,2015,MIL,CHN,3,2,3-2,MIL,11,false,43,40,83,161,165,326,16,9,25,2,3:26
414110,2015-05-10,2015,NYA,BAL,6,2,6-2,NYA,9,true,39,35,74,144,165,309,18,8,26,3,3:03
414113,2015-05-10,2015,CHA,CIN,4,3,4-3,CHA,9,false,43,39,82,154,157,311,18,16,34,1,3:10
414132,2015-05-11,2015,BAL,TOR,5,2,5-2,BAL,9,true,35,35,70,132,143,275,11,10,21,1,2:43
414126,2015-05-11,2015,MIL,CHA,10,7,10-7,MIL,9,true,37,41,78,154,118,272,12,15,27,2,3:09
414133,2015-05-11,2015,ARI,WAS,1,11,11-1,WAS,9,false,34,45,79,167,123,290,8,18,26,1,2:42
414130,2015-05-11,2015,CHN,NYN,4,3,4-3,CHN,9,true,36,36,72,156,145,301,14,11,25,3,2:56
414124,2015-05-11,2015,CIN,ATL,1,2,2-1,ATL,9,false,34,40,74,155,122,277,7,13,20,0,2:54 (1:40 delay)
414129,2015-05-11,2015,TBA,NYA,5,11,11-5,NYA,9,false,35,42,77,137,142,279,10,16,26,0,2:48
414131,2015-05-11,2015,PHI,PIT,3,4,4-3,PIT,9,false,37,38,75,143,120,263,12,12,24,2,2:55
414128,2015-05-11,2015,LAN,MIA,5,3,5-3,LAN,9,false,35,37,72,141,155,296,12,13,25,2,3:02
414127,2015-05-11,2015,TEX,KCA,8,2,8-2,TEX,9,true,42,34,76,132,171,303,17,9,26,1,2:53
414125,2015-05-11,2015,OAK,BOS,4,5,5-4,BOS,11,false,48,47,95,192,179,371,16,17,33,4,3:57
414136,2015-05-12,2015,MIL,CHA,2,4,4-2,CHA,9,false,31,40,71,139,123,262,4,13,17,2,2:45
414141,2015-05-12,2015,TBA,NYA,4,2,4-2,TBA,9,true,32,35,67,132,112,244,10,10,20,1,2:33
414135,2015-05-12,2015,OAK,BOS,9,2,9-2,OAK,9,true,40,30,70,123,167,290,16,4,20,1,2:32
414140,2015-05-12,2015,DET,MIN,2,1,2-1,DET,10,false,38,37,75,136,137,273,12,8,20,1,2:56
414143,2015-05-12,2015,PHI,PIT,2,7,7-2,PIT,9,false,35,38,73,167,115,282,9,12,21,0,2:49
414148,2015-05-12,2015,ARI,WAS,14,6,14-6,ARI,9,true,43,39,82,128,157,285,20,15,35,3,2:59
414137,2015-05-12,2015,ANA,COL,5,2,5-2,ANA,9,true,36,33,69,125,119,244,12,7,19,1,2:44
414145,2015-05-12,2015,HOU,SFN,1,8,8-1,SFN,9,false,29,43,72,160,111,271,2,17,19,1,2:39
414139,2015-05-12,2015,LAN,MIA,11,1,11-1,LAN,9,true,47,34,81,133,155,288,23,9,32,3,3:03
414147,2015-05-12,2015,BAL,TOR,2,10,10-2,TOR,9,false,32,44,76,162,111,273,7,17,24,2,2:37
414142,2015-05-12,2015,CHN,NYN,6,1,6-1,CHN,9,true,42,31,73,133,170,303,19,7,26,1,2:55
414144,2015-05-12,2015,SEA,SDN,11,4,11-4,SEA,9,true,42,42,84,179,173,352,20,15,35,2,3:17
414138,2015-05-12,2015,TEX,KCA,6,7,7-6,KCA,10,false,43,45,88,164,150,314,17,16,33,3,3:34
414146,2015-05-12,2015,CLE,SLN,3,8,8-3,SLN,9,false,40,43,83,144,173,317,13,14,27,7,3:31
414134,2015-05-12,2015,CIN,ATL,4,3,4-3,CIN,9,false,36,42,78,164,126,290,12,16,28,1,2:46
414153,2015-05-13,2015,TEX,KCA,5,2,5-2,TEX,9,true,34,32,66,106,119,225,13,7,20,0,2:15
414157,2015-05-13,2015,CHN,NYN,2,1,2-1,CHN,9,false,34,34,68,107,141,248,14,9,23,2,2:37
414156,2015-05-13,2015,TBA,NYA,3,2,3-2,TBA,9,true,30,39,69,165,104,269,8,12,20,1,2:41
414151,2015-05-13,2015,MIL,CHA,2,4,4-2,CHA,9,false,34,38,72,146,150,296,9,13,22,2,3:07
414160,2015-05-13,2015,HOU,SFN,4,3,4-3,HOU,9,true,33,40,73,164,116,280,11,15,26,3,3:10
414149,2015-05-13,2015,CIN,ATL,5,1,5-1,CIN,9,true,33,32,65,114,126,240,11,5,16,0,2:06
414155,2015-05-13,2015,DET,MIN,2,6,6-2,MIN,9,false,39,39,78,141,161,302,12,15,27,5,3:07
414158,2015-05-13,2015,PHI,PIT,3,2,3-2,PHI,9,true,33,35,68,142,121,263,10,10,20,0,2:37
414154,2015-05-13,2015,LAN,MIA,4,5,5-4,MIA,9,false,34,41,75,164,125,289,9,15,24,5,3:24
414152,2015-05-13,2015,ANA,COL,2,1,2-1,ANA,11,false,39,42,81,174,138,312,11,10,21,1,3:18
414161,2015-05-13,2015,CLE,SLN,2,0,2-0,CLE,9,true,39,29,68,124,154,278,15,2,17,1,2:47
414162,2015-05-13,2015,BAL,TOR,6,1,6-1,BAL,9,true,40,34,74,116,141,257,16,8,24,2,2:39
414150,2015-05-13,2015,OAK,BOS,0,2,2-0,BOS,9,false,36,35,71,141,123,264,10,8,18,2,2:33
414159,2015-05-13,2015,SEA,SDN,2,4,4-2,SDN,9,false,39,37,76,136,165,301,12,12,24,1,2:59
414163,2015-05-13,2015,ARI,WAS,6,9,9-6,WAS,9,false,45,42,87,151,179,330,20,16,36,4,3:38
414170,2015-05-14,2015,PHI,PIT,4,2,4-2,PHI,9,true,37,34,71,129,147,276,15,10,25,1,2:40
414169,2015-05-14,2015,CHN,NYN,6,5,6-5,CHN,9,true,35,38,73,168,121,289,10,11,21,4,2:49
414164,2015-05-14,2015,SEA,BOS,1,2,2-1,BOS,9,false,35,40,75,145,122,267,10,15,25,3,2:53
414171,2015-05-14,2015,CIN,SFN,4,3,4-3,CIN,9,true,36,35,71,140,143,283,14,11,25,3,2:58
414172,2015-05-14,2015,CLE,SLN,1,2,2-1,SLN,9,false,37,35,72,137,171,308,11,10,21,5,3:12
414168,2015-05-14,2015,TBA,NYA,6,1,6-1,TBA,9,true,36,33,69,130,141,271,14,7,21,1,2:45
414167,2015-05-14,2015,DET,MIN,13,1,13-1,DET,9,true,47,31,78,123,182,305,24,6,30,2,3:03
414165,2015-05-14,2015,LAN,COL,4,5,5-4,COL,9,false,41,39,80,146,160,306,15,11,26,1,3:11 (1:25 delay)
414173,2015-05-14,2015,HOU,TOR,6,4,6-4,HOU,9,true,37,34,71,118,160,278,15,10,25,2,2:48
414174,2015-05-14,2015,SDN,WAS,8,3,8-3,SDN,9,true,37,40,77,155,129,284,15,12,27,2,2:44 (1:56 delay)
414166,2015-05-14,2015,TEX,KCA,3,6,6-3,KCA,9,false,38,42,80,171,156,327,12,16,28,2,3:11
414183,2015-05-15,2015,NYN,MIL,0,7,7-0,MIL,9,false,32,36,68,111,126,237,4,10,14,0,2:18
414175,2015-05-15,2015,BAL,ANA,1,3,3-1,ANA,9,false,33,34,67,110,116,226,6,9,15,2,2:23
414178,2015-05-15,2015,SEA,BOS,2,1,2-1,SEA,9,false,31,33,64,120,117,237,5,8,13,1,2:32
414187,2015-05-15,2015,MIN,TBA,3,2,3-2,MIN,9,true,34,35,69,122,120,242,9,9,18,1,2:29
414181,2015-05-15,2015,LAN,COL,6,4,6-4,LAN,9,true,40,40,80,159,156,315,18,12,30,4,3:34
414177,2015-05-15,2015,MIA,ATL,3,5,5-3,ATL,9,false,41,39,80,136,152,288,14,13,27,3,3:10
414186,2015-05-15,2015,CIN,SFN,2,10,10-2,SFN,9,false,37,43,80,154,129,283,10,17,27,0,2:53
414188,2015-05-15,2015,HOU,TOR,8,4,8-4,HOU,9,true,36,37,73,135,136,271,12,11,23,1,2:29
414176,2015-05-15,2015,PHI,ARI,4,3,4-3,PHI,9,true,34,38,72,126,146,272,11,11,22,5,3:05
414180,2015-05-15,2015,TEX,CLE,3,8,8-3,CLE,9,false,40,42,82,165,159,324,13,17,30,4,3:17
414179,2015-05-15,2015,OAK,CHA,6,7,7-6,CHA,9,false,46,39,85,147,183,330,20,13,33,6,3:34
414182,2015-05-15,2015,SLN,DET,4,10,10-4,DET,9,false,41,46,87,192,154,346,16,20,36,2,3:26
414189,2015-05-15,2015,SDN,WAS,0,10,10-0,WAS,9,false,34,44,78,177,128,305,8,21,29,0,2:43
414184,2015-05-15,2015,KCA,NYA,12,1,12-1,KCA,9,true,46,34,80,125,171,296,20,7,27,5,3:12
414185,2015-05-15,2015,CHN,PIT,11,10,11-10,CHN,12,false,61,58,119,233,263,496,29,24,53,5,5:01
414190,2015-05-16,2015,BAL,ANA,1,6,6-1,ANA,9,false,30,39,69,127,106,233,3,13,16,0,2:28 (:57 delay)
414204,2015-05-16,2015,SDN,WAS,1,4,4-1,WAS,9,false,35,38,73,142,146,288,9,14,23,1,2:53
414203,2015-05-16,2015,HOU,TOR,6,5,6-5,HOU,9,true,36,38,74,162,155,317,12,11,23,2,3:08
414198,2015-05-16,2015,NYN,MIL,14,1,14-1,NYN,9,true,42,33,75,144,162,306,19,8,27,1,2:56
414196,2015-05-16,2015,LAN,COL,1,7,7-1,COL,9,false,33,39,72,152,121,273,6,11,17,1,2:54
414200,2015-05-16,2015,CHN,PIT,4,1,4-1,CHN,9,true,36,38,74,137,149,286,13,12,25,2,3:05
414194,2015-05-16,2015,OAK,CHA,3,4,4-3,CHA,9,false,36,40,76,155,149,304,10,16,26,4,3:06
414202,2015-05-16,2015,MIN,TBA,6,4,6-4,MIN,9,true,38,36,74,129,141,270,17,9,26,3,3:03
414201,2015-05-16,2015,CIN,SFN,2,11,11-2,SFN,9,false,40,43,83,148,138,286,13,17,30,1,2:53
414191,2015-05-16,2015,PHI,ARI,7,5,7-5,PHI,9,true,42,37,79,137,158,295,18,10,28,3,3:14 (1:17 delay)
414195,2015-05-16,2015,TEX,CLE,8,10,10-8,CLE,9,false,41,47,88,182,148,330,16,20,36,5,3:37
414199,2015-05-16,2015,KCA,NYA,1,5,5-1,NYA,9,false,34,42,76,163,112,275,6,13,19,0,2:52
414192,2015-05-16,2015,MIA,ATL,3,5,5-3,ATL,9,false,39,38,77,138,148,286,12,13,25,1,2:59
414197,2015-05-16,2015,SLN,DET,3,4,4-3,DET,10,false,42,45,87,198,180,378,14,17,31,2,3:54 (1:20 delay)
414193,2015-05-16,2015,SEA,BOS,2,4,4-2,BOS,9,false,34,40,74,150,135,285,7,13,20,2,2:48
414205,2015-05-17,2015,BAL,ANA,3,0,3-0,BAL,9,true,31,32,63,108,116,224,8,6,14,2,2:20
414207,2015-05-17,2015,MIA,ATL,0,6,6-0,ATL,9,false,29,39,68,130,94,224,3,12,15,1,2:15
414206,2015-05-17,2015,PHI,ARI,6,0,6-0,PHI,9,true,38,37,75,120,137,257,15,12,27,1,2:52
414208,2015-05-17,2015,SEA,BOS,5,0,5-0,SEA,9,true,34,33,67,120,139,259,11,7,18,1,2:31
414211,2015-05-17,2015,LAN,COL,1,0,1-0,LAN,9,true,32,32,64,125,117,242,9,6,15,0,2:40
414215,2015-05-17,2015,CHN,PIT,0,3,3-0,PIT,9,false,36,36,72,153,143,296,11,11,22,0,3:07
414217,2015-05-17,2015,MIN,TBA,3,11,11-3,TBA,9,false,33,50,83,188,138,326,8,24,32,2,3:17
414219,2015-05-17,2015,SDN,WAS,5,10,10-5,WAS,9,false,36,40,76,159,141,300,8,15,23,3,3:04
414218,2015-05-17,2015,HOU,TOR,4,2,4-2,HOU,9,true,32,37,69,136,111,247,8,10,18,0,2:22
414212,2015-05-17,2015,SLN,DET,2,1,2-1,SLN,9,true,36,35,71,135,119,254,15,9,24,2,2:57
414210,2015-05-17,2015,TEX,CLE,5,1,5-1,TEX,9,true,32,38,70,153,114,267,9,13,22,0,2:49
414214,2015-05-17,2015,KCA,NYA,6,0,6-0,KCA,9,true,35,36,71,143,138,281,11,9,20,2,3:03
414213,2015-05-17,2015,NYN,MIL,5,1,5-1,NYN,9,true,37,34,71,143,134,277,14,7,21,2,2:49
414209,2015-05-17,2015,OAK,CHA,3,7,7-3,CHA,9,false,36,42,78,168,134,302,11,13,24,2,2:56
414216,2015-05-17,2015,CIN,SFN,8,9,9-8,SFN,9,false,43,48,91,177,147,324,16,21,37,3,3:25 (:24 delay)
414222,2015-05-18,2015,CHA,CLE,2,1,2-1,CHA,10,false,36,36,72,130,125,255,9,6,15,0,2:34
414223,2015-05-18,2015,DET,MIL,2,3,3-2,MIL,9,false,35,37,72,132,152,284,11,11,22,2,3:13
414224,2015-05-18,2015,HOU,OAK,1,2,2-1,OAK,9,false,35,37,72,174,136,310,9,11,20,3,3:15
414221,2015-05-18,2015,MIA,ARI,2,3,3-2,ARI,13,false,45,47,92,165,154,319,9,10,19,0,3:11
414220,2015-05-18,2015,TOR,ANA,10,6,10-6,TOR,9,true,44,40,84,154,179,333,22,13,35,3,3:28
414226,2015-05-18,2015,NYN,SLN,2,1,2-1,NYN,14,false,51,54,105,205,193,398,15,13,28,3,4:14
414225,2015-05-18,2015,COL,PHI,3,4,4-3,PHI,9,false,38,38,76,139,146,285,11,13,24,1,3:14
414230,2015-05-19,2015,KCA,CIN,3,0,3-0,KCA,9,true,33,31,64,115,111,226,10,5,15,0,2:12
414240,2015-05-19,2015,ATL,TBA,3,5,5-3,TBA,9,false,36,37,73,123,146,269,9,10,19,1,2:43
414233,2015-05-19,2015,DET,MIL,1,8,8-1,MIL,9,false,35,40,75,136,117,253,8,15,23,1,2:34
414231,2015-05-19,2015,CHA,CLE,1,3,3-1,CLE,9,false,35,39,74,143,139,282,8,15,23,3,2:57
414229,2015-05-19,2015,SDN,CHN,4,3,4-3,SDN,9,true,31,35,66,142,134,276,5,8,13,1,2:47
414232,2015-05-19,2015,SFN,LAN,2,0,2-0,SFN,9,true,35,38,73,146,127,273,11,12,23,3,2:59
414234,2015-05-19,2015,PIT,MIN,5,8,8-5,MIN,9,false,42,38,80,144,132,276,15,12,27,3,2:53
414239,2015-05-19,2015,NYN,SLN,2,10,10-2,SLN,9,false,35,43,78,148,132,280,8,18,26,1,2:43
414241,2015-05-19,2015,BOS,TEX,4,3,4-3,BOS,9,true,40,38,78,137,153,290,17,10,27,1,2:50
414237,2015-05-19,2015,COL,PHI,6,5,6-5,COL,9,true,35,38,73,139,139,278,11,13,24,1,2:54 (:17 delay)
414227,2015-05-19,2015,TOR,ANA,2,3,3-2,ANA,9,false,34,36,70,133,120,253,7,9,16,1,2:32
414236,2015-05-19,2015,HOU,OAK,6,4,6-4,HOU,9,true,37,37,74,154,155,309,15,14,29,3,3:21
414235,2015-05-19,2015,WAS,NYA,8,6,8-6,WAS,10,false,41,41,82,146,168,314,15,11,26,3,3:20
414238,2015-05-19,2015,BAL,SEA,9,4,9-4,BAL,9,true,40,37,77,129,141,270,19,10,29,2,2:42
414228,2015-05-19,2015,MIA,ARI,2,4,4-2,ARI,9,false,34,37,71,126,142,268,8,11,19,2,2:46
414255,2015-05-20,2015,ATL,TBA,2,1,2-1,ATL,9,true,32,37,69,132,122,254,8,12,20,1,2:34
414253,2015-05-20,2015,BAL,SEA,2,4,4-2,SEA,9,false,35,39,74,134,121,255,10,13,23,2,2:38
414243,2015-05-20,2015,MIA,ARI,1,6,6-1,ARI,9,false,31,42,73,153,104,257,6,14,20,1,2:36
414254,2015-05-20,2015,NYN,SLN,0,9,9-0,SLN,9,false,33,45,78,151,120,271,7,17,24,2,2:43
414247,2015-05-20,2015,SFN,LAN,4,0,4-0,SFN,9,true,35,35,70,140,131,271,11,8,19,2,2:36
414245,2015-05-20,2015,KCA,CIN,7,1,7-1,KCA,9,true,35,38,73,139,136,275,12,11,23,1,2:44
414244,2015-05-20,2015,SDN,CHN,2,3,3-2,CHN,9,false,37,36,73,146,147,293,11,12,23,2,2:57
414250,2015-05-20,2015,WAS,NYA,3,2,3-2,WAS,9,true,34,36,70,125,135,260,10,9,19,1,2:43
414246,2015-05-20,2015,CHA,CLE,3,4,4-3,CLE,9,false,35,38,73,163,127,290,8,12,20,2,2:56 (:31 delay)
414248,2015-05-20,2015,DET,MIL,5,2,5-2,DET,9,true,36,35,71,145,140,285,15,10,25,3,3:05
414252,2015-05-20,2015,COL,PHI,2,4,4-2,PHI,9,false,32,41,73,168,121,289,8,14,22,1,2:50
414251,2015-05-20,2015,HOU,OAK,6,1,6-1,HOU,9,true,37,38,75,153,149,302,13,10,23,2,3:02
414256,2015-05-20,2015,BOS,TEX,1,2,2-1,TEX,9,false,40,35,75,135,162,297,14,10,24,3,3:13
414249,2015-05-20,2015,PIT,MIN,3,4,4-3,MIN,13,false,51,52,103,184,189,373,16,16,32,2,3:56
414242,2015-05-20,2015,TOR,ANA,3,4,4-3,ANA,9,false,34,39,73,139,116,255,8,13,21,1,2:36
414259,2015-05-21,2015,SDN,CHN,0,3,3-0,CHN,9,false,30,36,66,139,108,247,5,9,14,0,2:08
414267,2015-05-21,2015,NYN,SLN,5,0,5-0,NYN,9,true,35,29,64,121,138,259,16,2,18,2,2:26
414257,2015-05-21,2015,TOR,ANA,8,4,8-4,TOR,9,true,38,33,71,107,126,233,14,7,21,1,2:22
414263,2015-05-21,2015,ATL,MIL,10,1,10-1,ATL,9,true,40,30,70,114,146,260,15,4,19,3,2:49
414264,2015-05-21,2015,TBA,OAK,3,0,3-0,TBA,9,true,33,34,67,152,140,292,8,8,16,2,2:58
414262,2015-05-21,2015,SFN,LAN,4,0,4-0,SFN,9,true,34,37,71,150,110,260,12,12,24,4,2:54
414268,2015-05-21,2015,BOS,TEX,1,3,3-1,TEX,9,false,33,35,68,131,148,279,8,10,18,2,2:49
414258,2015-05-21,2015,MIA,ARI,6,7,7-6,ARI,9,false,41,42,83,134,137,271,15,14,29,3,3:02
414260,2015-05-21,2015,CHA,CLE,2,5,5-2,CLE,9,false,36,43,79,168,148,316,10,18,28,2,3:04
414265,2015-05-21,2015,COL,PHI,7,3,7-3,COL,9,true,42,37,79,173,127,300,19,12,31,2,3:15
414266,2015-05-21,2015,BAL,SEA,5,4,5-4,BAL,9,true,36,44,80,196,157,353,11,18,29,3,3:30 (2:17 delay)
414261,2015-05-21,2015,DET,HOU,6,5,6-5,DET,11,false,44,43,87,153,170,323,16,10,26,5,3:40
414275,2015-05-22,2015,CHA,MIN,3,2,3-2,CHA,9,true,35,31,66,127,106,233,12,4,16,1,2:21
414276,2015-05-22,2015,PIT,NYN,4,1,4-1,PIT,9,true,32,31,63,114,128,242,7,8,15,1,2:24
414278,2015-05-22,2015,WAS,PHI,2,1,2-1,WAS,9,true,30,34,64,127,119,246,9,7,16,0,2:35
414279,2015-05-22,2015,LAN,SDN,2,1,2-1,LAN,9,true,30,34,64,118,133,251,7,7,14,1,2:39
414280,2015-05-22,2015,TOR,SEA,3,4,4-3,SEA,9,false,34,36,70,132,128,260,10,10,20,0,2:30
414273,2015-05-22,2015,DET,HOU,6,2,6-2,DET,9,true,36,33,69,138,127,265,15,5,20,0,2:47
414277,2015-05-22,2015,TBA,OAK,5,2,5-2,TBA,9,true,37,41,78,158,144,302,15,13,28,5,3:05
414272,2015-05-22,2015,CLE,CIN,7,3,7-3,CLE,9,true,42,35,77,154,154,308,19,9,28,0,2:56
414274,2015-05-22,2015,ATL,MIL,0,11,11-0,MIL,9,false,34,45,79,185,126,311,6,21,27,1,2:52
414281,2015-05-22,2015,COL,SFN,8,11,11-8,SFN,9,false,43,45,88,160,149,309,17,18,35,3,3:33 (1:44 delay)
414270,2015-05-22,2015,MIA,BAL,5,8,8-5,BAL,9,false,44,45,89,177,156,333,15,19,34,5,3:22
414269,2015-05-22,2015,BOS,ANA,5,12,12-5,ANA,9,false,39,48,87,189,150,339,14,21,35,3,3:35
414283,2015-05-22,2015,NYA,TEX,9,10,10-9,TEX,9,false,43,42,85,155,155,310,15,15,30,3,3:19
414282,2015-05-22,2015,KCA,SLN,5,0,5-0,KCA,9,true,35,40,75,170,120,290,12,14,26,0,2:53
414271,2015-05-22,2015,ARI,CHN,5,4,5-4,ARI,13,false,53,54,107,238,198,436,18,17,35,3,4:27
413925,2015-05-23,2015,COL,SFN,5,3,5-3,COL,9,true,37,36,73,125,107,232,14,11,25,2,2:45 (:58 delay)
414297,2015-05-23,2015,KCA,SLN,3,2,3-2,KCA,6,true,23,25,48,84,68,152,9,8,17,0,1:40 (1:10 delay)
414294,2015-05-23,2015,LAN,SDN,2,0,2-0,LAN,9,true,30,27,57,99,134,233,6,1,7,0,2:11
414287,2015-05-23,2015,CLE,CIN,2,1,2-1,CLE,9,true,31,34,65,120,131,251,9,9,18,0,2:33
413925,2015-05-23,2015,COL,SFN,5,3,5-3,COL,9,true,37,36,73,125,107,232,14,11,25,2,2:45 (:58 delay)
414290,2015-05-23,2015,CHA,MIN,3,4,4-3,MIN,9,false,35,35,70,124,108,232,8,10,18,1,2:12 (:30 delay)
414293,2015-05-23,2015,WAS,PHI,1,8,8-1,PHI,9,false,33,40,73,146,116,262,6,12,18,1,2:33
414291,2015-05-23,2015,PIT,NYN,8,2,8-2,PIT,9,true,36,34,70,131,129,260,12,8,20,0,2:41
414295,2015-05-23,2015,TOR,SEA,2,3,3-2,SEA,9,false,33,36,69,121,141,262,8,10,18,1,2:25
414288,2015-05-23,2015,DET,HOU,2,3,3-2,HOU,9,false,33,36,69,128,139,267,8,11,19,3,2:44
414284,2015-05-23,2015,BOS,ANA,8,3,8-3,BOS,9,true,39,36,75,118,169,287,16,9,25,4,3:09
414286,2015-05-23,2015,ARI,CHN,6,9,9-6,CHN,9,false,36,41,77,160,123,283,9,13,22,3,3:14
414292,2015-05-23,2015,TBA,OAK,0,5,5-0,OAK,9,false,36,42,78,181,132,313,10,17,27,2,2:55
414296,2015-05-23,2015,COL,SFN,8,10,10-8,SFN,9,false,41,42,83,135,150,285,15,15,30,3,3:04 (2:15 delay)
414298,2015-05-23,2015,NYA,TEX,4,15,15-4,TEX,9,false,38,49,87,183,138,321,10,22,32,3,3:03
414289,2015-05-23,2015,ATL,MIL,3,2,3-2,ATL,11,false,46,44,90,168,180,348,17,16,33,2,3:48
414285,2015-05-23,2015,MIA,BAL,1,0,1-0,MIA,13,false,49,49,98,191,177,368,16,13,29,1,3:51
414301,2015-05-24,2015,ARI,CHN,4,3,4-3,ARI,9,true,31,32,63,124,118,242,8,6,14,1,2:31
414304,2015-05-24,2015,ATL,MIL,2,1,2-1,ATL,9,true,33,33,66,119,143,262,13,6,19,2,2:47
414299,2015-05-24,2015,BOS,ANA,6,1,6-1,BOS,9,true,36,31,67,110,157,267,15,5,20,2,2:37
414308,2015-05-24,2015,WAS,PHI,4,1,4-1,WAS,9,true,36,34,70,127,119,246,12,9,21,4,2:45
414311,2015-05-24,2015,COL,SFN,11,2,11-2,COL,9,true,41,34,75,111,139,250,16,8,24,3,2:49 (2:10 delay)
414310,2015-05-24,2015,TOR,SEA,8,2,8-2,TOR,9,true,40,34,74,134,153,287,16,10,26,4,2:50
414305,2015-05-24,2015,CHA,MIN,1,8,8-1,MIN,9,false,31,39,70,148,114,262,5,11,16,1,2:37
414312,2015-05-24,2015,KCA,SLN,1,6,6-1,SLN,9,false,34,39,73,176,116,292,8,13,21,0,2:40
414300,2015-05-24,2015,MIA,BAL,5,2,5-2,MIA,9,true,37,37,74,142,153,295,15,11,26,3,3:00
414306,2015-05-24,2015,PIT,NYN,9,1,9-1,PIT,9,true,42,36,78,143,150,293,20,9,29,1,2:46
414309,2015-05-24,2015,LAN,SDN,3,11,11-3,SDN,9,false,33,48,81,158,114,272,8,23,31,1,2:47
414302,2015-05-24,2015,CLE,CIN,5,2,5-2,CLE,9,true,42,35,77,130,184,314,15,7,22,2,3:07
414313,2015-05-24,2015,NYA,TEX,2,5,5-2,TEX,9,false,35,40,75,153,158,311,8,14,22,4,3:25
414307,2015-05-24,2015,TBA,OAK,2,7,7-2,OAK,9,false,37,41,78,150,147,297,11,15,26,1,2:53
414303,2015-05-24,2015,DET,HOU,8,10,10-8,HOU,9,false,42,44,86,176,155,331,17,18,35,4,3:22
414317,2015-05-25,2015,TOR,CHA,6,0,6-0,TOR,9,true,34,29,63,96,142,238,11,4,15,0,2:10
414320,2015-05-25,2015,BAL,HOU,4,3,4-3,BAL,9,true,28,37,65,141,98,239,7,11,18,0,2:20
414319,2015-05-25,2015,OAK,DET,4,0,4-0,OAK,9,true,35,33,68,112,120,232,10,5,15,2,2:40
414322,2015-05-25,2015,PIT,MIA,4,2,4-2,PIT,9,true,33,34,67,109,125,234,12,9,21,0,2:20
414328,2015-05-25,2015,CHN,WAS,1,2,2-1,WAS,9,false,32,35,67,132,122,254,7,8,15,2,2:39
414316,2015-05-25,2015,MIN,BOS,7,2,7-2,MIN,9,true,40,34,74,125,151,276,18,8,26,2,2:52
414326,2015-05-25,2015,MIL,SFN,4,8,8-4,SFN,9,false,36,43,79,152,149,301,9,18,27,4,3:15
414323,2015-05-25,2015,NYN,PHI,6,3,6-3,NYN,9,true,34,37,71,148,132,280,12,9,21,4,3:07
414325,2015-05-25,2015,TBA,SEA,1,4,4-1,SEA,9,false,39,38,77,148,140,288,12,13,25,0,2:51
414318,2015-05-25,2015,CIN,COL,4,5,5-4,COL,9,false,40,41,81,151,129,280,14,15,29,2,2:59
414321,2015-05-25,2015,NYA,KCA,14,1,14-1,NYA,9,true,45,37,82,129,192,321,22,12,34,3,3:12
414315,2015-05-25,2015,LAN,ATL,6,3,6-3,LAN,9,true,40,36,76,129,164,293,17,12,29,3,2:49
414324,2015-05-25,2015,ANA,SDN,4,3,4-3,ANA,9,false,39,36,75,146,150,296,17,11,28,3,3:11
414314,2015-05-25,2015,SLN,ARI,3,2,3-2,SLN,10,false,41,43,84,150,152,302,17,14,31,3,3:24
414327,2015-05-25,2015,CLE,TEX,8,10,10-8,TEX,9,false,42,40,82,153,183,336,16,13,29,7,3:32
414330,2015-05-26,2015,LAN,ATL,8,0,8-0,LAN,9,true,33,34,67,135,119,254,15,6,21,1,2:38
414331,2015-05-26,2015,MIN,BOS,2,1,2-1,MIN,9,true,32,34,66,139,109,248,9,9,18,2,2:36 (1:21 delay)
414333,2015-05-26,2015,CIN,COL,2,1,2-1,CIN,9,false,35,32,67,133,115,248,10,8,18,0,2:39
414343,2015-05-26,2015,CHN,WAS,3,2,3-2,CHN,9,false,36,32,68,113,145,258,12,9,21,1,2:33
414334,2015-05-26,2015,OAK,DET,0,1,1-0,DET,9,false,37,33,70,130,137,267,9,10,19,2,2:58
414336,2015-05-26,2015,NYA,KCA,5,1,5-1,NYA,9,true,35,32,67,128,143,271,10,4,14,1,2:31
414329,2015-05-26,2015,SLN,ARI,6,4,6-4,SLN,9,true,34,41,75,140,137,277,11,15,26,2,2:51
414335,2015-05-26,2015,BAL,HOU,1,4,4-1,HOU,9,false,33,39,72,139,124,263,8,14,22,2,2:50
414337,2015-05-26,2015,PIT,MIA,5,1,5-1,PIT,9,true,34,38,72,148,134,282,12,11,23,2,2:38
414342,2015-05-26,2015,CLE,TEX,3,4,4-3,TEX,9,false,39,39,78,142,161,303,11,12,23,3,3:06 (:56 delay)
414341,2015-05-26,2015,MIL,SFN,3,6,6-3,SFN,9,false,37,39,76,164,146,310,10,13,23,2,3:07
414339,2015-05-26,2015,ANA,SDN,0,4,4-0,SDN,10,false,37,43,80,153,162,315,8,14,22,3,3:24
414332,2015-05-26,2015,TOR,CHA,10,9,10-9,TOR,9,false,38,45,83,175,150,325,14,17,31,3,3:12
414338,2015-05-26,2015,NYN,PHI,5,4,5-4,NYN,10,false,42,40,82,156,176,332,16,13,29,4,3:17
414340,2015-05-26,2015,TBA,SEA,6,7,7-6,SEA,10,false,46,44,90,180,175,355,17,15,32,4,3:52
414355,2015-05-27,2015,TBA,SEA,0,3,3-0,SEA,9,false,29,32,61,123,101,224,6,5,11,0,2:13
414346,2015-05-27,2015,MIN,BOS,6,4,6-4,MIN,9,true,31,35,66,131,101,232,10,8,18,3,2:29
414350,2015-05-27,2015,BAL,HOU,5,4,5-4,BAL,9,true,34,39,73,109,131,240,11,12,23,1,2:26 (1:11 delay)
414351,2015-05-27,2015,NYA,KCA,4,2,4-2,NYA,9,true,36,37,73,145,136,281,12,10,22,2,2:42
414356,2015-05-27,2015,MIL,SFN,1,3,3-1,SFN,9,false,32,37,69,135,150,285,6,10,16,0,3:00
414353,2015-05-27,2015,NYN,PHI,7,0,7-0,NYN,9,true,38,33,71,128,140,268,15,8,23,2,2:41
414352,2015-05-27,2015,PIT,MIA,5,2,5-2,PIT,9,true,37,36,73,112,142,254,13,9,22,2,2:38
414354,2015-05-27,2015,ANA,SDN,4,5,5-4,SDN,9,false,36,40,76,140,126,266,12,13,25,3,2:51
414348,2015-05-27,2015,CIN,COL,4,6,6-4,COL,9,false,36,39,75,152,107,259,9,14,23,3,2:46
414358,2015-05-27,2015,CHN,WAS,0,3,3-0,WAS,9,false,36,40,76,146,140,286,9,12,21,2,3:00
414349,2015-05-27,2015,OAK,DET,2,3,3-2,DET,9,false,35,39,74,173,141,314,11,15,26,2,3:06
414344,2015-05-27,2015,SLN,ARI,4,3,4-3,SLN,9,false,40,39,79,134,175,309,15,12,27,1,3:19
414357,2015-05-27,2015,CLE,TEX,12,3,12-3,CLE,9,true,44,34,78,129,170,299,20,9,29,1,2:47
414347,2015-05-27,2015,TOR,CHA,3,5,5-3,CHA,10,false,45,44,89,155,167,322,15,15,30,2,3:31
414345,2015-05-27,2015,LAN,ATL,2,3,3-2,ATL,9,false,36,36,72,149,130,279,11,11,22,1,2:58
413945,2015-05-28,2015,BAL,CHA,6,3,6-3,BAL,9,true,39,35,74,147,122,269,17,9,26,0,2:48
413930,2015-05-28,2015,BAL,CHA,2,3,3-2,CHA,9,false,33,36,69,137,149,286,6,11,17,3,2:51
414359,2015-05-28,2015,SFN,ATL,7,0,7-0,SFN,9,true,36,32,68,120,123,243,13,5,18,3,2:31
413945,2015-05-28,2015,BAL,CHA,6,3,6-3,BAL,9,true,39,35,74,147,122,269,17,9,26,0,2:48
414363,2015-05-28,2015,OAK,NYA,5,4,5-4,OAK,9,true,35,38,73,145,128,273,11,11,22,4,2:50
414361,2015-05-28,2015,SEA,CLE,3,5,5-3,CLE,9,false,36,40,76,133,142,275,9,12,21,1,2:50
414360,2015-05-28,2015,TEX,BOS,1,5,5-1,BOS,9,false,34,41,75,160,126,286,7,21,28,4,2:49
413930,2015-05-28,2015,BAL,CHA,2,3,3-2,CHA,9,false,33,36,69,137,149,286,6,11,17,3,2:51
414364,2015-05-28,2015,SDN,PIT,5,11,11-5,PIT,9,false,38,45,83,179,128,307,11,19,30,2,3:05
414362,2015-05-28,2015,ANA,DET,12,2,12-2,ANA,9,true,39,37,76,157,147,304,18,11,29,2,3:07
414377,2015-05-29,2015,BAL,TBA,2,1,2-1,BAL,9,false,33,35,68,125,135,260,8,8,16,2,2:43
414366,2015-05-29,2015,SFN,ATL,4,2,4-2,SFN,9,true,36,34,70,119,128,247,12,8,20,1,2:36
414371,2015-05-29,2015,ANA,DET,2,0,2-0,ANA,9,true,32,34,66,138,133,271,9,9,18,2,2:46
414373,2015-05-29,2015,SLN,LAN,3,0,3-0,SLN,9,true,38,33,71,129,146,275,16,7,23,2,2:58
414367,2015-05-29,2015,TEX,BOS,7,4,7-4,TEX,9,true,36,36,72,153,135,288,15,10,25,3,2:59
414376,2015-05-29,2015,SDN,PIT,6,2,6-2,SDN,9,false,38,37,75,142,150,292,13,10,23,2,3:16
414372,2015-05-29,2015,CHN,KCA,4,8,8-4,KCA,9,false,37,40,77,148,150,298,10,15,25,3,3:09
414374,2015-05-29,2015,NYN,MIA,3,4,4-3,MIA,9,false,33,34,67,115,119,234,7,7,14,0,2:08
414369,2015-05-29,2015,SEA,CLE,2,1,2-1,SEA,9,true,33,30,63,123,137,260,11,4,15,2,2:24
414370,2015-05-29,2015,PHI,COL,1,4,4-1,COL,9,false,32,34,66,138,123,261,2,9,11,0,2:32
414378,2015-05-29,2015,MIN,TOR,4,6,6-4,TOR,9,false,32,38,70,130,111,241,6,13,19,3,2:15 (1:01 delay)
414368,2015-05-29,2015,HOU,CHA,3,6,6-3,CHA,11,false,44,50,94,195,162,357,13,17,30,5,4:08
414379,2015-05-29,2015,CIN,WAS,5,2,5-2,CIN,9,true,37,42,79,148,127,275,14,17,31,4,3:02
414375,2015-05-29,2015,OAK,NYA,6,2,6-2,OAK,9,true,38,34,72,119,149,268,13,8,21,2,2:49
414365,2015-05-29,2015,MIL,ARI,5,7,7-5,ARI,9,false,41,43,84,180,151,331,14,17,31,3,3:23
414392,2015-05-30,2015,BAL,TBA,0,3,3-0,TBA,9,false,30,35,65,127,102,229,4,10,14,0,2:09
414391,2015-05-30,2015,SDN,PIT,2,5,5-2,PIT,9,false,32,42,74,161,110,271,5,16,21,2,2:50
414386,2015-05-30,2015,ANA,DET,8,6,8-6,ANA,9,true,36,39,75,136,134,270,13,14,27,5,2:50
414384,2015-05-30,2015,SEA,CLE,3,4,4-3,CLE,9,false,39,36,75,132,138,270,15,11,26,5,3:04
414388,2015-05-30,2015,SLN,LAN,1,5,5-1,LAN,9,false,32,39,71,165,130,295,8,13,21,2,2:53 (2:20 delay)
414385,2015-05-30,2015,PHI,COL,2,5,5-2,COL,9,false,37,38,75,159,144,303,10,11,21,4,3:23
414390,2015-05-30,2015,OAK,NYA,3,5,5-3,NYA,9,false,38,38,76,144,158,302,12,11,23,3,3:06
414389,2015-05-30,2015,NYN,MIA,5,9,9-5,MIA,9,false,43,42,85,157,159,316,16,15,31,4,3:07
414383,2015-05-30,2015,HOU,CHA,3,0,3-0,HOU,9,true,34,31,65,113,138,251,12,4,16,1,2:29
414393,2015-05-30,2015,MIN,TOR,3,2,3-2,MIN,9,true,33,38,71,141,127,268,12,14,26,1,2:41
414380,2015-05-30,2015,MIL,ARI,3,7,7-3,ARI,9,false,36,42,78,135,144,279,9,14,23,1,2:58
414382,2015-05-30,2015,TEX,BOS,8,0,8-0,TEX,9,true,41,36,77,146,145,291,16,10,26,2,2:49
414381,2015-05-30,2015,SFN,ATL,0,8,8-0,ATL,9,false,38,42,80,150,146,296,12,16,28,2,2:51
414394,2015-05-30,2015,CIN,WAS,8,5,8-5,CIN,9,true,37,40,77,151,152,303,16,14,30,2,3:08
414404,2015-05-31,2015,NYN,MIA,4,3,4-3,NYN,9,true,33,36,69,114,138,252,9,9,18,2,2:47
414398,2015-05-31,2015,HOU,CHA,0,6,6-0,CHA,9,false,33,39,72,137,118,255,11,11,22,1,2:37
414400,2015-05-31,2015,PHI,COL,1,4,4-1,COL,9,false,35,36,71,116,147,263,8,11,19,2,2:56
414409,2015-05-31,2015,CIN,WAS,8,2,8-2,CIN,9,true,38,33,71,124,141,265,16,8,24,3,2:45
414407,2015-05-31,2015,BAL,TBA,5,9,9-5,TBA,9,false,42,45,87,157,158,315,15,20,35,4,3:24
414397,2015-05-31,2015,TEX,BOS,4,3,4-3,TEX,9,false,40,40,80,173,146,319,12,14,26,4,3:16
414405,2015-05-31,2015,OAK,NYA,3,0,3-0,OAK,9,true,31,34,65,128,108,236,9,9,18,2,2:21
414402,2015-05-31,2015,CHN,KCA,2,1,2-1,CHN,11,false,41,42,83,192,167,359,14,9,23,6,3:39
414403,2015-05-31,2015,SLN,LAN,3,1,3-1,SLN,9,true,32,34,66,147,135,282,13,7,20,1,2:33
414401,2015-05-31,2015,ANA,DET,4,2,4-2,ANA,9,true,37,37,74,151,124,275,13,12,25,3,3:19
414406,2015-05-31,2015,SDN,PIT,7,1,7-1,SDN,9,true,41,36,77,126,159,285,16,9,25,0,2:46
414396,2015-05-31,2015,SFN,ATL,5,7,7-5,ATL,9,false,39,39,78,142,139,281,12,11,23,5,3:02
414408,2015-05-31,2015,MIN,TOR,6,5,6-5,MIN,9,true,34,40,74,163,132,295,10,16,26,5,3:08
414399,2015-05-31,2015,SEA,CLE,3,6,6-3,CLE,12,false,47,59,106,232,194,426,13,27,40,5,4:36
414395,2015-05-31,2015,MIL,ARI,7,6,7-6,MIL,17,false,71,74,145,253,275,528,23,28,51,3,5:49
414418,2015-06-01,2015,SFN,PIT,3,4,4-3,PIT,9,false,34,37,71,129,117,246,8,9,17,0,2:38
414417,2015-06-01,2015,SDN,NYN,0,7,7-0,NYN,9,false,28,39,67,152,114,266,2,14,16,1,2:21
414419,2015-06-01,2015,ANA,TBA,7,3,7-3,ANA,9,true,40,35,75,131,134,265,17,9,26,2,2:55
414416,2015-06-01,2015,SEA,NYA,2,7,7-2,NYA,9,false,35,38,73,139,140,279,10,12,22,2,2:55
414413,2015-06-01,2015,COL,LAN,4,11,11-4,LAN,9,false,36,49,85,175,123,298,10,24,34,2,3:08
414410,2015-06-01,2015,ARI,ATL,1,8,8-1,ATL,9,false,33,44,77,183,123,306,7,19,26,0,2:45
414414,2015-06-01,2015,SLN,MIL,0,1,1-0,MIL,9,false,37,33,70,109,145,254,11,6,17,2,3:05
414412,2015-06-01,2015,MIA,CHN,1,5,5-1,CHN,9,false,34,39,73,149,156,305,7,13,20,1,2:45
414411,2015-06-01,2015,HOU,BAL,5,2,5-2,HOU,9,true,35,34,69,127,129,256,14,9,23,3,2:45
414101,2015-06-02,2015,COL,LAN,6,3,6-3,COL,9,true,38,35,73,143,139,282,14,9,23,1,3:01
414420,2015-06-02,2015,WAS,TOR,2,0,2-0,WAS,9,true,35,33,68,117,123,240,11,7,18,0,2:17
414422,2015-06-02,2015,HOU,BAL,6,4,6-4,HOU,9,true,37,34,71,133,138,271,13,9,22,1,2:42
414424,2015-06-02,2015,MIA,CHN,5,2,5-2,MIA,9,true,34,36,70,135,121,256,10,11,21,1,2:33
414429,2015-06-02,2015,BOS,MIN,1,0,1-0,BOS,9,true,31,32,63,110,113,223,9,6,15,0,2:21
414426,2015-06-02,2015,KCA,CLE,1,2,2-1,CLE,9,false,34,36,70,175,134,309,7,9,16,3,3:16
414101,2015-06-02,2015,COL,LAN,6,3,6-3,COL,9,true,38,35,73,143,139,282,14,9,23,1,3:01
414432,2015-06-02,2015,DET,OAK,3,5,5-3,OAK,9,false,37,39,76,150,133,283,10,12,22,1,2:50
414434,2015-06-02,2015,ANA,TBA,1,6,6-1,TBA,9,false,34,37,71,139,119,258,7,11,18,0,2:33
414435,2015-06-02,2015,WAS,TOR,3,7,7-3,TOR,9,false,36,41,77,155,147,302,8,14,22,1,3:04
414431,2015-06-02,2015,SDN,NYN,7,2,7-2,SDN,9,true,39,36,75,141,151,292,16,10,26,2,3:00
414423,2015-06-02,2015,TEX,CHA,15,2,15-2,TEX,9,true,46,34,80,118,161,279,24,7,31,1,2:35
414420,2015-06-02,2015,WAS,TOR,2,0,2-0,WAS,9,true,35,33,68,117,123,240,11,7,18,0,2:17
414425,2015-06-02,2015,PHI,CIN,5,4,5-4,PHI,9,false,36,39,75,125,126,251,9,13,22,1,2:52
414427,2015-06-02,2015,COL,LAN,8,9,9-8,LAN,9,false,42,42,84,157,143,300,18,16,34,4,3:24
414430,2015-06-02,2015,SEA,NYA,3,5,5-3,NYA,11,false,49,48,97,189,180,369,18,18,36,3,3:55
414433,2015-06-02,2015,SFN,PIT,4,7,7-4,PIT,9,false,42,44,86,161,157,318,15,19,34,2,3:14
414421,2015-06-02,2015,ARI,ATL,7,6,7-6,ARI,9,true,43,38,81,154,164,318,21,12,33,4,3:18
414428,2015-06-02,2015,SLN,MIL,1,0,1-0,SLN,9,true,26,33,59,136,99,235,6,8,14,1,2:27
414415,2015-06-03,2015,BOS,MIN,6,3,6-3,BOS,9,true,38,34,72,139,125,264,15,8,23,1,2:33
414444,2015-06-03,2015,BOS,MIN,0,2,2-0,MIN,9,false,29,31,60,115,117,232,2,5,7,0,2:15
414437,2015-06-03,2015,HOU,BAL,3,1,3-1,HOU,9,true,27,31,58,107,118,225,4,4,8,1,2:14
414445,2015-06-03,2015,SEA,NYA,1,3,3-1,NYA,9,false,33,33,66,118,122,240,7,6,13,1,2:21
414443,2015-06-03,2015,SLN,MIL,7,4,7-4,SLN,9,true,36,41,77,116,125,241,12,15,27,1,2:40
414447,2015-06-03,2015,DET,OAK,1,6,6-1,OAK,9,false,33,40,73,136,128,264,5,14,19,1,2:39
414446,2015-06-03,2015,SDN,NYN,7,3,7-3,SDN,9,true,38,39,77,131,124,255,12,14,26,1,2:45
414441,2015-06-03,2015,KCA,CLE,4,2,4-2,KCA,9,true,32,35,67,127,110,237,10,10,20,0,2:33
414448,2015-06-03,2015,SFN,PIT,2,5,5-2,PIT,9,false,37,38,75,135,133,268,10,12,22,3,2:59
414436,2015-06-03,2015,ARI,ATL,9,8,9-8,ARI,9,true,41,42,83,168,160,328,17,16,33,3,3:17
414439,2015-06-03,2015,MIA,CHN,7,3,7-3,MIA,9,true,38,40,78,145,137,282,16,13,29,3,2:56
414450,2015-06-03,2015,WAS,TOR,0,8,8-0,TOR,9,false,32,40,72,136,93,229,7,14,21,0,2:13
414442,2015-06-03,2015,COL,LAN,7,6,7-6,COL,9,false,41,42,83,170,164,334,17,17,34,5,3:44 (2:26 delay)
414415,2015-06-03,2015,BOS,MIN,6,3,6-3,BOS,9,true,38,34,72,139,125,264,15,8,23,1,2:33
414438,2015-06-03,2015,TEX,CHA,2,9,9-2,CHA,9,false,36,45,81,189,163,352,10,19,29,2,3:06
414449,2015-06-03,2015,ANA,TBA,5,6,6-5,TBA,10,false,43,41,84,150,157,307,18,12,30,3,3:20
414440,2015-06-03,2015,PHI,CIN,5,4,5-4,PHI,11,false,43,51,94,173,171,344,11,17,28,3,3:31
414460,2015-06-04,2015,SEA,TBA,1,2,2-1,TBA,9,false,38,32,70,117,131,248,12,8,20,2,2:42
414454,2015-06-04,2015,PHI,CIN,4,6,6-4,CIN,9,false,34,38,72,141,131,272,9,13,22,2,2:41
414455,2015-06-04,2015,KCA,CLE,2,6,6-2,CLE,8,false,31,37,68,145,120,265,9,13,22,2,2:38 (:44 delay)
414459,2015-06-04,2015,LAN,SLN,1,7,7-1,SLN,9,false,36,43,79,149,141,290,9,18,27,1,2:56
414458,2015-06-04,2015,DET,OAK,5,7,7-5,OAK,9,false,36,40,76,152,144,296,10,15,25,2,3:06
414453,2015-06-04,2015,WAS,CHN,1,2,2-1,CHN,9,false,37,34,71,145,147,292,13,11,24,3,3:16 (1:51 delay)
414457,2015-06-04,2015,ARI,NYN,2,6,6-2,NYN,9,false,36,43,79,193,145,338,10,15,25,2,3:22
414451,2015-06-04,2015,HOU,BAL,2,3,3-2,BAL,9,false,36,35,71,168,140,308,9,10,19,2,2:59
414452,2015-06-04,2015,TEX,CHA,2,1,2-1,TEX,11,false,47,44,91,177,185,362,21,8,29,3,3:55
414456,2015-06-04,2015,BOS,MIN,4,8,8-4,MIN,9,false,39,45,84,169,150,319,13,17,30,4,3:12
414469,2015-06-05,2015,BOS,OAK,4,2,4-2,BOS,9,true,34,35,69,122,120,242,12,10,22,2,2:31
414462,2015-06-05,2015,CLE,BAL,2,5,5-2,BAL,9,false,37,36,73,115,142,257,11,12,23,4,2:48
414463,2015-06-05,2015,WAS,CHN,7,5,7-5,WAS,9,true,38,35,73,144,139,283,16,9,25,2,2:58
414472,2015-06-05,2015,PHI,SFN,4,5,5-4,SFN,9,false,35,39,74,152,142,294,10,14,24,2,2:58
414466,2015-06-05,2015,COL,MIA,2,6,6-2,MIA,9,false,38,40,78,132,136,268,13,14,27,2,2:43 (1:55 delay)
414473,2015-06-05,2015,LAN,SLN,1,2,2-1,SLN,9,false,34,34,68,101,132,233,8,8,16,2,2:22
414475,2015-06-05,2015,KCA,TEX,0,4,4-0,TEX,9,false,30,38,68,140,116,256,5,10,15,1,2:40
414464,2015-06-05,2015,CHA,DET,4,3,4-3,CHA,11,false,40,41,81,135,151,286,11,11,22,2,3:08
414471,2015-06-05,2015,CIN,SDN,2,6,6-2,SDN,9,false,36,38,74,138,147,285,10,12,22,1,2:51 (1:09 delay)
414461,2015-06-05,2015,NYA,ANA,8,7,8-7,NYA,9,true,40,46,86,188,154,342,16,18,34,3,3:27
414474,2015-06-05,2015,SEA,TBA,0,1,1-0,TBA,9,false,36,34,70,133,146,279,10,10,20,1,2:55
414468,2015-06-05,2015,ARI,NYN,7,2,7-2,ARI,9,true,36,35,71,151,122,273,14,9,23,2,2:49
414467,2015-06-05,2015,MIN,MIL,5,10,10-5,MIL,9,false,38,41,79,142,143,285,12,15,27,3,2:48
414465,2015-06-05,2015,TOR,HOU,6,2,6-2,TOR,9,true,35,31,66,114,127,241,13,6,19,3,2:35
414470,2015-06-05,2015,ATL,PIT,8,10,10-8,PIT,9,false,45,44,89,177,161,338,19,18,37,2,3:28
414488,2015-06-06,2015,LAN,SLN,2,0,2-0,LAN,9,true,28,30,58,117,99,216,7,4,11,1,2:22
414477,2015-06-06,2015,CLE,BAL,2,1,2-1,CLE,9,true,36,32,68,132,158,290,15,8,23,2,2:44
414478,2015-06-06,2015,WAS,CHN,2,4,4-2,CHN,9,false,34,35,69,159,123,282,8,9,17,2,2:52
414476,2015-06-06,2015,NYA,ANA,8,2,8-2,NYA,9,true,42,35,77,139,166,305,17,9,26,3,3:05
414490,2015-06-06,2015,KCA,TEX,2,4,4-2,TEX,9,false,37,41,78,170,135,305,9,18,27,2,2:50
414481,2015-06-06,2015,COL,MIA,10,5,10-5,COL,9,true,42,42,84,139,143,282,19,15,34,2,2:59 (1:11 delay)
414489,2015-06-06,2015,SEA,TBA,2,1,2-1,SEA,9,true,34,32,66,128,126,254,14,6,20,0,2:45
414480,2015-06-06,2015,TOR,HOU,7,2,7-2,TOR,9,true,41,33,74,135,169,304,16,9,25,4,3:16
414485,2015-06-06,2015,ATL,PIT,5,4,5-4,ATL,9,false,35,32,67,117,120,237,11,6,17,2,2:44
414482,2015-06-06,2015,MIN,MIL,2,4,4-2,MIL,9,false,34,38,72,149,138,287,8,14,22,2,3:22
414483,2015-06-06,2015,ARI,NYN,2,1,2-1,ARI,9,true,31,36,67,153,109,262,9,12,21,3,2:40
414486,2015-06-06,2015,CIN,SDN,7,9,9-7,SDN,9,false,42,44,86,173,149,322,18,18,36,2,3:12
414487,2015-06-06,2015,PHI,SFN,5,7,7-5,SFN,9,false,33,45,78,167,118,285,8,17,25,1,2:53 (:29 delay)
414484,2015-06-06,2015,BOS,OAK,4,2,4-2,BOS,9,true,39,36,75,154,162,316,18,9,27,4,3:10
414479,2015-06-06,2015,CHA,DET,1,7,7-1,DET,9,false,31,46,77,152,110,262,7,20,27,1,2:54
414494,2015-06-07,2015,CHA,DET,4,6,6-4,DET,9,false,35,35,70,113,124,237,8,11,19,1,2:38
414498,2015-06-07,2015,ARI,NYN,3,6,6-3,NYN,9,false,35,40,75,168,132,300,8,17,25,0,2:44
414500,2015-06-07,2015,ATL,PIT,0,3,3-0,PIT,9,false,38,39,77,138,148,286,12,13,25,0,2:50
414499,2015-06-07,2015,BOS,OAK,7,4,7-4,BOS,9,true,37,40,77,159,133,292,15,14,29,5,3:11
414505,2015-06-07,2015,KCA,TEX,4,3,4-3,KCA,9,true,35,34,69,136,113,249,12,8,20,1,2:31
414501,2015-06-07,2015,CIN,SDN,4,0,4-0,CIN,9,true,34,33,67,126,110,236,10,6,16,0,2:22
414493,2015-06-07,2015,WAS,CHN,3,6,6-3,CHN,9,false,36,44,80,172,151,323,8,20,28,1,3:12
414504,2015-06-07,2015,SEA,TBA,1,3,3-1,TBA,9,false,34,34,68,129,146,275,7,6,13,1,2:46
414497,2015-06-07,2015,MIN,MIL,2,0,2-0,MIN,9,true,36,34,70,118,145,263,13,10,23,2,2:53
414491,2015-06-07,2015,NYA,ANA,6,2,6-2,NYA,9,true,32,32,64,134,111,245,9,7,16,0,2:20
414496,2015-06-07,2015,COL,MIA,2,3,3-2,MIA,10,false,39,36,75,122,164,286,11,8,19,0,3:05
414502,2015-06-07,2015,PHI,SFN,6,4,6-4,PHI,9,true,34,42,76,149,117,266,12,16,28,3,3:07
414495,2015-06-07,2015,TOR,HOU,7,6,7-6,TOR,9,false,40,42,82,163,152,315,15,15,30,1,3:06
414503,2015-06-07,2015,LAN,SLN,2,4,4-2,SLN,9,false,35,37,72,136,168,304,9,11,20,5,3:25
414492,2015-06-07,2015,CLE,BAL,3,7,7-3,BAL,9,false,40,44,84,167,163,330,13,15,28,6,3:33
414507,2015-06-08,2015,CHA,HOU,3,1,3-1,CHA,9,true,28,34,62,135,106,241,5,7,12,0,2:13 (1:03 delay)
414509,2015-06-08,2015,TOR,MIA,11,3,11-3,TOR,9,true,44,34,78,129,161,290,20,8,28,2,2:47
414506,2015-06-08,2015,LAN,ARI,9,3,9-3,LAN,9,true,35,33,68,129,135,264,11,7,18,0,2:42
414508,2015-06-08,2015,MIN,KCA,1,3,3-1,KCA,9,false,34,36,70,128,117,245,10,10,20,2,2:36
414512,2015-06-08,2015,ATL,SDN,3,5,5-3,SDN,11,false,44,44,88,175,182,357,13,11,24,2,3:47
414510,2015-06-08,2015,PIT,MIL,0,2,2-0,MIL,9,false,36,35,71,144,146,290,12,9,21,1,3:07 (2:13 delay)
414513,2015-06-08,2015,COL,SLN,11,3,11-3,COL,9,true,43,35,78,118,146,264,17,9,26,0,2:39
414511,2015-06-08,2015,CIN,PHI,6,4,6-4,CIN,9,true,36,39,75,152,144,296,13,14,27,0,2:55
414521,2015-06-09,2015,PIT,MIL,1,4,4-1,MIL,9,false,33,34,67,111,117,228,6,7,13,0,2:25
414519,2015-06-09,2015,MIN,KCA,0,2,2-0,KCA,9,false,31,38,69,156,118,274,5,13,18,4,2:50
414522,2015-06-09,2015,CIN,PHI,11,2,11-2,CIN,9,true,41,38,79,141,156,297,15,13,28,1,2:50
414525,2015-06-09,2015,NYN,SFN,0,5,5-0,SFN,9,false,29,40,69,143,110,253,3,16,19,1,2:32
414523,2015-06-09,2015,ATL,SDN,6,5,6-5,ATL,9,true,38,44,82,163,136,299,13,17,30,3,3:15 (:50 delay)
414528,2015-06-09,2015,NYA,WAS,6,1,6-1,NYA,9,true,39,33,72,128,148,276,16,7,23,2,2:51
414516,2015-06-09,2015,BAL,BOS,1,0,1-0,BAL,9,true,32,36,68,159,133,292,9,10,19,2,3:08
414520,2015-06-09,2015,TOR,MIA,4,3,4-3,TOR,9,false,31,38,69,145,113,258,6,12,18,0,2:16
414517,2015-06-09,2015,DET,CHN,6,0,6-0,DET,9,true,37,36,73,135,152,287,15,10,25,2,2:53
414526,2015-06-09,2015,COL,SLN,4,3,4-3,COL,9,true,35,36,71,149,137,286,13,10,23,3,2:56 (1:07 delay)
414515,2015-06-09,2015,LAN,ARI,3,1,3-1,LAN,9,true,36,35,71,111,126,237,14,10,24,2,2:32
414514,2015-06-09,2015,TBA,ANA,2,8,8-2,ANA,9,false,34,46,80,171,123,294,8,17,25,2,2:52
414524,2015-06-09,2015,CLE,SEA,2,3,3-2,SEA,9,false,37,39,76,149,119,268,10,14,24,3,3:03
414527,2015-06-09,2015,OAK,TEX,1,2,2-1,TEX,9,false,37,37,74,134,164,298,10,11,21,3,3:00
414518,2015-06-09,2015,CHA,HOU,4,2,4-2,CHA,9,true,37,37,74,168,151,319,14,10,24,3,3:07
414536,2015-06-10,2015,PIT,MIL,2,0,2-0,PIT,9,true,33,31,64,111,116,227,13,6,19,3,2:22
414535,2015-06-10,2015,TOR,MIA,7,2,7-2,TOR,9,true,33,34,67,119,115,234,11,7,18,1,2:08
414533,2015-06-10,2015,CHA,HOU,4,1,4-1,CHA,9,true,35,38,73,130,146,276,15,9,24,1,3:12
414538,2015-06-10,2015,ATL,SDN,4,1,4-1,ATL,9,true,36,34,70,116,146,262,16,8,24,1,2:39
414534,2015-06-10,2015,MIN,KCA,2,7,7-2,KCA,9,false,36,38,74,161,146,307,10,10,20,0,2:56
414540,2015-06-10,2015,NYN,SFN,5,8,8-5,SFN,9,false,38,42,80,158,153,311,14,17,31,5,3:23
414532,2015-06-10,2015,DET,CHN,3,12,12-3,CHN,9,false,35,47,82,186,137,323,11,22,33,2,3:18
414529,2015-06-10,2015,TBA,ANA,4,2,4-2,TBA,9,true,35,35,70,140,114,254,12,10,22,1,2:39
414537,2015-06-10,2015,CIN,PHI,5,2,5-2,CIN,9,true,36,37,73,151,136,287,12,12,24,2,2:48
414530,2015-06-10,2015,LAN,ARI,7,6,7-6,LAN,9,false,40,41,81,149,156,305,14,14,28,3,3:35
414543,2015-06-10,2015,NYA,WAS,4,5,5-4,WAS,11,false,45,47,92,160,168,328,13,14,27,3,3:36
414539,2015-06-10,2015,CLE,SEA,3,9,9-3,SEA,9,false,40,44,84,169,139,308,14,17,31,1,3:04
414542,2015-06-10,2015,OAK,TEX,5,4,5-4,OAK,9,false,38,40,78,142,150,292,13,15,28,2,3:05
414531,2015-06-10,2015,BAL,BOS,5,2,5-2,BAL,9,true,34,32,66,132,115,247,12,8,20,2,2:36
414541,2015-06-10,2015,COL,SLN,2,4,4-2,SLN,9,false,34,40,74,168,142,310,9,14,23,2,2:59
414546,2015-06-11,2015,CHN,CIN,6,3,6-3,CHN,9,true,39,35,74,150,166,316,15,8,23,3,2:58
414550,2015-06-11,2015,NYN,SFN,5,4,5-4,NYN,9,false,40,36,76,125,161,286,15,10,25,3,3:03
414544,2015-06-11,2015,TBA,ANA,2,6,6-2,ANA,9,false,32,42,74,176,123,299,6,18,24,4,3:20
414552,2015-06-11,2015,MIL,WAS,6,5,6-5,MIL,9,true,37,37,74,130,130,260,12,10,22,2,2:54
414549,2015-06-11,2015,CLE,SEA,6,0,6-0,CLE,9,true,35,30,65,125,146,271,13,3,16,1,2:40
414548,2015-06-11,2015,ATL,SDN,4,6,6-4,SDN,11,false,45,47,92,178,164,342,14,15,29,5,3:42 (:56 delay)
414547,2015-06-11,2015,MIA,COL,6,0,6-0,MIA,9,true,40,34,74,123,133,256,16,7,23,1,2:41
414551,2015-06-11,2015,OAK,TEX,7,0,7-0,OAK,9,true,40,29,69,114,134,248,18,3,21,2,2:35
414545,2015-06-11,2015,BAL,BOS,6,5,6-5,BAL,9,true,35,37,72,158,118,276,12,10,22,2,2:39
414559,2015-06-12,2015,SLN,KCA,4,0,4-0,SLN,9,true,36,32,68,114,140,254,13,5,18,2,2:38
414561,2015-06-12,2015,TEX,MIN,6,2,6-2,TEX,9,true,32,34,66,155,124,279,10,8,18,4,2:39
414553,2015-06-12,2015,SFN,ARI,0,1,1-0,ARI,9,false,31,39,70,144,124,268,5,15,20,2,2:52
414555,2015-06-12,2015,TBA,CHA,7,5,7-5,TBA,9,true,40,37,77,149,148,297,17,10,27,3,3:07
414562,2015-06-12,2015,BAL,NYA,11,3,11-3,BAL,9,true,42,40,82,168,142,310,18,13,31,3,3:18
414558,2015-06-12,2015,MIA,COL,5,1,5-1,MIA,9,true,36,31,67,109,136,245,13,7,20,2,2:45
414560,2015-06-12,2015,SDN,LAN,3,4,4-3,LAN,9,false,38,39,77,155,168,323,10,16,26,4,3:28
414557,2015-06-12,2015,DET,CLE,4,0,4-0,DET,9,true,33,30,63,93,122,215,12,7,19,1,2:25
414566,2015-06-12,2015,BOS,TOR,10,13,13-10,TOR,9,false,46,43,89,157,185,342,19,17,36,4,3:24
414556,2015-06-12,2015,CHN,CIN,4,5,5-4,CIN,10,false,41,45,86,199,162,361,12,15,27,0,3:21
414554,2015-06-12,2015,NYN,ATL,5,3,5-3,NYN,9,true,34,40,74,163,125,288,13,18,31,2,3:09
414565,2015-06-12,2015,HOU,SEA,10,0,10-0,HOU,9,true,39,34,73,131,148,279,16,7,23,1,2:45
414567,2015-06-12,2015,MIL,WAS,8,4,8-4,MIL,9,true,39,36,75,132,163,295,17,10,27,1,2:59
414563,2015-06-12,2015,ANA,OAK,5,4,5-4,ANA,9,true,33,39,72,169,118,287,12,12,24,2,2:55
414564,2015-06-12,2015,PIT,PHI,1,0,1-0,PIT,13,false,56,52,108,206,212,418,20,16,36,1,4:34 (1:26 delay)
414579,2015-06-13,2015,PIT,PHI,4,3,4-3,PIT,9,true,35,37,72,153,135,288,12,10,22,0,3:05
414576,2015-06-13,2015,TEX,MIN,11,7,11-7,TEX,9,true,40,38,78,137,130,267,21,12,33,2,2:44 (1:19 delay)
414569,2015-06-13,2015,NYN,ATL,3,5,5-3,ATL,11,false,45,50,95,180,161,341,13,17,30,4,3:39
414568,2015-06-13,2015,SFN,ARI,2,4,4-2,ARI,9,false,34,37,71,135,134,269,7,12,19,2,2:50
414570,2015-06-13,2015,TBA,CHA,5,4,5-4,TBA,9,true,35,37,72,137,129,266,13,11,24,2,2:46
414581,2015-06-13,2015,BOS,TOR,4,5,5-4,TOR,11,false,44,45,89,164,166,330,10,13,23,2,3:26
414573,2015-06-13,2015,MIA,COL,4,1,4-1,MIA,9,true,32,34,66,129,127,256,9,7,16,1,2:43
414575,2015-06-13,2015,SDN,LAN,2,1,2-1,SDN,9,true,31,31,62,124,100,224,9,7,16,0,2:30
414571,2015-06-13,2015,CHN,CIN,4,3,4-3,CHN,9,false,33,37,70,140,106,246,13,11,24,1,2:39 (2:48 delay)
414578,2015-06-13,2015,ANA,OAK,1,0,1-0,ANA,9,true,30,32,62,134,111,245,8,6,14,0,2:27
414574,2015-06-13,2015,SLN,KCA,3,2,3-2,SLN,9,true,35,36,71,139,139,278,13,8,21,4,2:46 (:24 delay)
414582,2015-06-13,2015,MIL,WAS,2,7,7-2,WAS,9,false,36,43,79,141,122,263,9,16,25,1,2:52
414580,2015-06-13,2015,HOU,SEA,1,8,8-1,SEA,9,false,36,43,79,162,133,295,11,16,27,0,2:47
414577,2015-06-13,2015,BAL,NYA,9,4,9-4,BAL,9,true,39,39,78,143,154,297,15,13,28,2,3:14
414572,2015-06-13,2015,DET,CLE,4,5,5-4,CLE,9,false,41,40,81,157,152,309,15,15,30,6,3:34
414591,2015-06-14,2015,TEX,MIN,3,4,4-3,MIN,9,false,36,40,76,145,129,274,11,16,27,0,2:49
414583,2015-06-14,2015,SFN,ARI,0,4,4-0,ARI,9,false,33,40,73,161,111,272,11,15,26,1,2:51
414594,2015-06-14,2015,PIT,PHI,1,0,1-0,PIT,11,false,46,38,84,126,162,288,15,7,22,0,3:04
414593,2015-06-14,2015,ANA,OAK,1,8,8-1,OAK,9,false,36,44,80,163,130,293,7,15,22,4,3:16
414584,2015-06-14,2015,NYN,ATL,10,8,10-8,NYN,9,true,40,43,83,144,146,290,18,18,36,3,2:59
414587,2015-06-14,2015,DET,CLE,8,1,8-1,DET,9,true,35,36,71,139,128,267,12,10,22,2,2:46 (1:51 delay)
414588,2015-06-14,2015,MIA,COL,1,4,4-1,COL,9,false,37,38,75,158,147,305,10,12,22,2,3:08
414585,2015-06-14,2015,TBA,CHA,2,1,2-1,TBA,9,true,33,34,67,139,145,284,9,9,18,1,2:42
414597,2015-06-14,2015,MIL,WAS,0,4,4-0,WAS,9,false,29,39,68,169,119,288,2,13,15,0,2:59
414590,2015-06-14,2015,SDN,LAN,2,4,4-2,LAN,12,false,50,49,99,182,181,363,15,17,32,4,4:16
414592,2015-06-14,2015,BAL,NYA,3,5,5-3,NYA,9,false,38,42,80,171,158,329,11,15,26,4,3:29
414595,2015-06-14,2015,HOU,SEA,13,0,13-0,HOU,9,true,47,33,80,162,189,351,22,7,29,1,3:26
414586,2015-06-14,2015,CHN,CIN,2,1,2-1,CHN,11,false,41,43,84,172,169,341,10,12,22,4,3:54
414596,2015-06-14,2015,BOS,TOR,5,13,13-5,TOR,9,false,40,45,85,153,163,316,14,20,34,2,3:12
414601,2015-06-15,2015,DET,CIN,6,0,6-0,DET,9,true,37,28,65,112,130,242,14,2,16,1,2:37
414607,2015-06-15,2015,MIA,NYA,2,1,2-1,MIA,9,true,35,33,68,134,115,249,12,6,18,1,2:41
414606,2015-06-15,2015,SLN,MIN,3,2,3-2,SLN,9,true,34,33,67,113,136,249,11,7,18,1,2:32 (:20 delay)
414603,2015-06-15,2015,HOU,COL,6,3,6-3,HOU,9,true,36,34,70,132,142,274,12,7,19,1,2:48
414598,2015-06-15,2015,ANA,ARI,3,7,7-3,ARI,9,false,33,41,74,139,143,282,8,16,24,2,2:58
414610,2015-06-15,2015,SFN,SEA,1,5,5-1,SEA,9,false,34,40,74,159,121,280,7,13,20,1,2:52
414609,2015-06-15,2015,BAL,PHI,4,0,4-0,BAL,9,true,31,30,61,124,116,240,8,5,13,0,2:09 (:27 delay)
414604,2015-06-15,2015,MIL,KCA,5,8,8-5,KCA,9,false,41,42,83,169,152,321,16,17,33,1,3:19
414599,2015-06-15,2015,BOS,ATL,2,4,4-2,ATL,9,false,36,36,72,127,138,265,12,11,23,3,2:54
414608,2015-06-15,2015,SDN,OAK,1,9,9-1,OAK,9,false,37,47,84,184,141,325,9,21,30,1,3:18
414611,2015-06-15,2015,NYN,TOR,4,3,4-3,NYN,11,false,41,43,84,193,146,339,8,10,18,2,3:26
414605,2015-06-15,2015,TEX,LAN,4,1,4-1,TEX,9,true,32,34,66,142,109,251,9,11,20,1,2:44
414600,2015-06-15,2015,PIT,CHA,11,0,11-0,PIT,9,true,43,28,71,120,168,288,21,3,24,1,2:51
414612,2015-06-15,2015,TBA,WAS,6,1,6-1,TBA,9,true,43,40,83,162,163,325,20,14,34,1,3:12
414621,2015-06-16,2015,SLN,MIN,3,2,3-2,SLN,9,true,32,35,67,124,124,248,10,9,19,3,2:31 (1:32 delay)
414619,2015-06-16,2015,MIL,KCA,2,7,7-2,KCA,9,false,35,43,78,147,125,272,9,17,26,1,2:51
414626,2015-06-16,2015,NYN,TOR,3,2,3-2,NYN,9,true,32,35,67,148,120,268,9,9,18,1,2:35
414616,2015-06-16,2015,DET,CIN,2,5,5-2,CIN,9,false,35,36,71,122,145,267,11,11,22,3,2:57
414623,2015-06-16,2015,SDN,OAK,5,6,6-5,OAK,9,false,35,39,74,151,131,282,10,14,24,2,2:57
414614,2015-06-16,2015,BOS,ATL,9,4,9-4,BOS,9,true,38,39,77,150,124,274,19,12,31,2,2:38
414618,2015-06-16,2015,HOU,COL,8,5,8-5,HOU,9,true,39,39,78,165,166,331,17,13,30,1,3:34
414620,2015-06-16,2015,TEX,LAN,3,2,3-2,TEX,9,false,34,36,70,120,117,237,12,9,21,1,2:22
414617,2015-06-16,2015,CHN,CLE,0,6,6-0,CLE,9,false,34,43,77,187,134,321,8,18,26,1,3:08
414613,2015-06-16,2015,ANA,ARI,4,1,4-1,ANA,9,true,34,35,69,122,129,251,10,8,18,1,2:42
414627,2015-06-16,2015,TBA,WAS,4,16,16-4,WAS,9,false,37,53,90,171,150,321,10,29,39,3,3:08
414622,2015-06-16,2015,MIA,NYA,12,2,12-2,MIA,9,true,44,36,80,132,175,307,20,9,29,2,3:09
414615,2015-06-16,2015,PIT,CHA,3,0,3-0,PIT,9,true,38,33,71,116,152,268,16,6,22,0,2:44
414625,2015-06-16,2015,SFN,SEA,6,2,6-2,SFN,9,true,35,35,70,130,134,264,13,9,22,3,2:39
414624,2015-06-16,2015,BAL,PHI,19,3,19-3,BAL,9,true,50,35,85,134,210,344,26,9,35,2,3:11
414639,2015-06-17,2015,SEA,SFN,2,0,2-0,SEA,9,true,28,34,62,121,112,233,6,6,12,1,2:24
414640,2015-06-17,2015,MIN,SLN,3,1,3-1,MIN,9,true,34,33,67,143,127,270,11,8,19,2,2:47
414636,2015-06-17,2015,TOR,NYN,8,0,8-0,TOR,9,true,38,33,71,145,140,285,18,7,25,3,2:33
414628,2015-06-17,2015,ARI,ANA,3,2,3-2,ARI,9,true,35,37,72,135,136,271,12,12,24,3,3:00
414638,2015-06-17,2015,OAK,SDN,16,2,16-2,OAK,9,true,46,33,79,129,161,290,24,6,30,3,2:49
414630,2015-06-17,2015,ATL,BOS,5,2,5-2,ATL,9,true,40,37,77,129,164,293,16,10,26,3,3:09
414634,2015-06-17,2015,NYA,MIA,2,1,2-1,NYA,9,true,35,34,69,144,134,278,14,7,21,2,2:50
414637,2015-06-17,2015,CHA,PIT,2,3,3-2,PIT,9,false,33,32,65,123,136,259,7,5,12,0,2:27
414641,2015-06-17,2015,WAS,TBA,0,5,5-0,TBA,9,false,31,39,70,136,117,253,5,13,18,0,2:35 (:27 delay)
414633,2015-06-17,2015,COL,HOU,4,8,8-4,HOU,9,false,34,43,77,169,108,277,9,17,26,3,3:13
414642,2015-06-17,2015,LAN,TEX,3,5,5-3,TEX,9,false,40,35,75,151,154,305,14,10,24,3,3:18
414629,2015-06-17,2015,PHI,BAL,4,6,6-4,BAL,9,false,36,36,72,128,124,252,10,9,19,3,2:34
414635,2015-06-17,2015,KCA,MIL,10,2,10-2,KCA,9,true,40,33,73,134,150,284,17,7,24,1,3:05
414631,2015-06-17,2015,CLE,CHN,0,17,17-0,CHN,9,false,31,49,80,202,126,328,6,24,30,3,3:06
414632,2015-06-17,2015,CIN,DET,8,4,8-4,CIN,13,false,57,49,106,208,230,438,20,10,30,3,4:56 (1:14 delay)
414644,2015-06-18,2015,PHI,BAL,2,1,2-1,PHI,9,true,29,36,65,131,107,238,7,8,15,0,2:32
414651,2015-06-18,2015,TOR,NYN,7,1,7-1,TOR,9,true,37,35,72,140,130,270,13,8,21,2,2:34
414655,2015-06-18,2015,MIN,SLN,2,1,2-1,MIN,9,false,35,32,67,113,139,252,12,6,18,3,2:38
414646,2015-06-18,2015,CLE,CHN,4,3,4-3,CLE,9,true,34,37,71,153,143,296,12,10,22,6,3:01 (1:41 delay)
414652,2015-06-18,2015,CHA,PIT,2,3,3-2,PIT,9,false,33,40,73,153,127,280,6,16,22,2,2:58
414654,2015-06-18,2015,SEA,SFN,0,7,7-0,SFN,9,false,34,40,74,136,144,280,9,14,23,3,2:53
414650,2015-06-18,2015,KCA,MIL,3,2,3-2,KCA,9,true,35,37,72,109,124,233,15,9,24,1,2:38
414653,2015-06-18,2015,OAK,SDN,1,3,3-1,SDN,9,false,32,36,68,138,130,268,6,9,15,1,2:39
414656,2015-06-18,2015,WAS,TBA,3,5,5-3,TBA,9,false,40,39,79,136,148,284,14,13,27,1,3:02 (:17 delay)
414645,2015-06-18,2015,ATL,BOS,2,5,5-2,BOS,9,false,36,38,74,161,126,287,9,14,23,1,3:04 (:45 delay)
414643,2015-06-18,2015,ARI,ANA,1,7,7-1,ANA,9,false,34,38,72,141,125,266,8,17,25,1,2:36
414649,2015-06-18,2015,NYA,MIA,9,4,9-4,NYA,9,true,45,37,82,149,177,326,21,11,32,3,3:26
414657,2015-06-18,2015,LAN,TEX,1,0,1-0,LAN,9,false,34,31,65,123,137,260,9,5,14,1,2:55
414648,2015-06-18,2015,COL,HOU,4,8,8-4,HOU,9,false,40,41,81,166,165,331,13,15,28,1,3:30
414661,2015-06-19,2015,MIN,CHN,7,2,7-2,MIN,9,true,36,30,66,105,123,228,14,4,18,1,2:18
414667,2015-06-19,2015,WAS,PIT,4,1,4-1,WAS,9,true,37,32,69,117,112,229,15,7,22,2,2:36
414666,2015-06-19,2015,ATL,NYN,2,1,2-1,ATL,9,true,32,34,66,109,119,228,9,7,16,3,2:29
414664,2015-06-19,2015,CIN,MIA,5,0,5-0,CIN,9,true,35,34,69,125,131,256,12,8,20,2,2:27
414672,2015-06-19,2015,CHA,TEX,1,2,2-1,TEX,9,false,38,33,71,139,128,267,11,7,18,0,2:26
414663,2015-06-19,2015,SEA,HOU,5,2,5-2,SEA,9,true,36,33,69,117,135,252,12,6,18,2,2:33
414669,2015-06-19,2015,LAN,SFN,5,9,9-5,SFN,9,false,37,43,80,180,124,304,12,18,30,4,3:24
414671,2015-06-19,2015,CLE,TBA,1,4,4-1,TBA,9,false,35,36,71,141,140,281,10,12,22,2,3:01
414662,2015-06-19,2015,NYA,DET,7,2,7-2,NYA,9,true,38,33,71,122,134,256,15,9,24,1,2:50
414668,2015-06-19,2015,ARI,SDN,4,2,4-2,ARI,9,true,36,40,76,141,138,279,14,11,25,1,3:08
414660,2015-06-19,2015,KCA,BOS,3,7,7-3,BOS,9,false,39,41,80,136,162,298,13,19,32,2,2:57
414659,2015-06-19,2015,TOR,BAL,5,4,5-4,TOR,9,true,36,40,76,175,132,307,16,13,29,3,3:07
414665,2015-06-19,2015,COL,MIL,5,9,9-5,MIL,9,false,38,44,82,158,142,300,12,21,33,1,3:16
414658,2015-06-19,2015,OAK,ANA,7,12,12-7,ANA,9,false,40,46,86,189,149,338,14,18,32,6,3:38
414670,2015-06-19,2015,PHI,SLN,4,12,12-4,SLN,9,false,42,52,94,226,166,392,15,26,41,0,3:34
414682,2015-06-20,2015,WAS,PIT,6,0,6-0,WAS,9,true,32,28,60,106,127,233,9,1,10,1,2:21
414687,2015-06-20,2015,CHA,TEX,3,2,3-2,CHA,9,true,36,32,68,134,123,257,13,7,20,0,2:47
414675,2015-06-20,2015,KCA,BOS,7,4,7-4,KCA,9,true,37,40,77,150,127,277,16,13,29,3,3:09
414679,2015-06-20,2015,CIN,MIA,0,5,5-0,MIA,9,false,32,37,69,138,112,250,7,11,18,2,2:33
414674,2015-06-20,2015,TOR,BAL,3,5,5-3,BAL,9,false,40,38,78,141,165,306,15,13,28,1,2:56
414680,2015-06-20,2015,COL,MIL,5,1,5-1,COL,9,true,33,33,66,117,115,232,9,8,17,1,2:27
414681,2015-06-20,2015,ATL,NYN,6,4,6-4,ATL,9,true,36,37,73,140,150,290,15,12,27,2,3:11
414685,2015-06-20,2015,PHI,SLN,1,10,10-1,SLN,9,false,35,46,81,176,137,313,10,21,31,0,3:02
414676,2015-06-20,2015,MIN,CHN,1,4,4-1,CHN,10,false,37,44,81,157,156,313,12,16,28,3,3:17
414673,2015-06-20,2015,OAK,ANA,4,1,4-1,OAK,9,true,38,35,73,137,138,275,14,9,23,4,2:59
414686,2015-06-20,2015,CLE,TBA,1,4,4-1,TBA,9,false,36,36,72,143,145,288,10,14,24,2,3:07
414683,2015-06-20,2015,ARI,SDN,1,8,8-1,SDN,9,false,32,40,72,163,111,274,6,14,20,2,2:40
414678,2015-06-20,2015,SEA,HOU,6,3,6-3,SEA,9,true,36,36,72,131,133,264,12,9,21,5,2:43
414684,2015-06-20,2015,LAN,SFN,2,6,6-2,SFN,9,false,35,38,73,144,127,271,9,12,21,2,2:56
414677,2015-06-20,2015,NYA,DET,14,3,14-3,NYA,9,true,48,35,83,144,179,323,25,8,33,2,3:24
414700,2015-06-21,2015,PHI,SLN,9,2,9-2,PHI,9,true,39,35,74,114,144,258,15,9,24,1,2:29
414691,2015-06-21,2015,MIN,CHN,0,8,8-0,CHN,9,false,31,44,75,179,122,301,4,19,23,1,2:59
414693,2015-06-21,2015,SEA,HOU,2,6,6-2,HOU,9,false,37,40,77,169,159,328,10,14,24,2,3:24
414696,2015-06-21,2015,ATL,NYN,1,0,1-0,ATL,9,true,33,31,64,103,143,246,9,6,15,2,2:26
414698,2015-06-21,2015,ARI,SDN,7,2,7-2,ARI,9,true,33,35,68,118,113,231,7,8,15,0,2:30
414690,2015-06-21,2015,KCA,BOS,2,13,13-2,BOS,9,false,39,46,85,169,147,316,13,20,33,2,2:58
414692,2015-06-21,2015,NYA,DET,4,12,12-4,DET,9,false,37,49,86,178,132,310,11,22,33,1,3:01
414688,2015-06-21,2015,OAK,ANA,3,2,3-2,OAK,9,true,33,37,70,146,130,276,10,11,21,1,2:58
414699,2015-06-21,2015,LAN,SFN,10,2,10-2,LAN,9,true,43,34,77,142,151,293,19,11,30,1,3:06
414702,2015-06-21,2015,CHA,TEX,3,2,3-2,CHA,11,false,43,45,88,163,183,346,15,17,32,3,3:49
414694,2015-06-21,2015,CIN,MIA,5,2,5-2,CIN,9,true,35,38,73,135,138,273,14,12,26,2,2:52
414697,2015-06-21,2015,WAS,PIT,9,2,9-2,WAS,9,true,38,36,74,114,141,255,14,10,24,1,2:34
414695,2015-06-21,2015,COL,MIL,10,4,10-4,COL,9,true,39,36,75,129,144,273,18,12,30,4,3:09
414689,2015-06-21,2015,TOR,BAL,9,13,13-9,BAL,9,false,43,47,90,203,165,368,18,21,39,8,3:44
414701,2015-06-21,2015,CLE,TBA,1,0,1-0,CLE,9,false,31,35,66,125,116,241,8,10,18,1,2:36
414706,2015-06-22,2015,SEA,KCA,1,4,4-1,KCA,9,false,30,35,65,140,126,266,3,12,15,2,2:34
414707,2015-06-22,2015,CHN,LAN,4,2,4-2,CHN,9,true,31,32,63,131,120,251,7,9,16,3,2:40 (:10 delay)
414703,2015-06-22,2015,MIN,CHA,13,2,13-2,MIN,9,true,41,39,80,136,151,287,18,16,34,1,2:55
414705,2015-06-22,2015,ANA,HOU,4,3,4-3,ANA,9,true,38,34,72,157,155,312,13,7,20,4,3:23
414704,2015-06-22,2015,CLE,DET,5,8,8-5,DET,9,false,37,45,82,171,133,304,11,20,31,2,3:27 (:10 delay)
414709,2015-06-22,2015,TBA,TOR,5,8,8-5,TOR,9,false,46,39,85,167,189,356,20,13,33,4,3:28
414708,2015-06-22,2015,NYA,PHI,8,11,11-8,PHI,9,false,44,47,91,165,177,342,18,21,39,1,3:33
414718,2015-06-23,2015,CHN,LAN,1,0,1-0,CHN,10,false,37,36,73,132,162,294,8,6,14,2,3:10
414724,2015-06-23,2015,TBA,TOR,4,3,4-3,TBA,9,true,36,33,69,115,126,241,15,5,20,0,2:14
414720,2015-06-23,2015,TEX,OAK,6,8,8-6,OAK,9,false,42,40,82,152,171,323,15,14,29,4,3:17
414714,2015-06-23,2015,PIT,CIN,7,6,7-6,PIT,9,true,37,45,82,157,173,330,15,18,33,2,3:37
414723,2015-06-23,2015,MIA,SLN,3,4,4-3,SLN,9,false,37,39,76,146,135,281,13,14,27,1,2:45
414713,2015-06-23,2015,MIN,CHA,2,6,6-2,CHA,9,false,35,44,79,168,125,293,11,18,29,3,2:57
414711,2015-06-23,2015,WAS,ATL,3,1,3-1,WAS,9,true,35,38,73,164,117,281,13,11,24,2,2:52 (2:12 delay)
414716,2015-06-23,2015,ANA,HOU,3,13,13-3,HOU,9,false,38,49,87,170,128,298,13,22,35,1,2:59
414710,2015-06-23,2015,COL,ARI,10,5,10-5,COL,9,true,36,39,75,130,123,253,14,13,27,1,2:51 (:38 delay)
414717,2015-06-23,2015,SEA,KCA,7,0,7-0,SEA,9,true,39,33,72,105,150,255,15,6,21,0,2:23
414719,2015-06-23,2015,MIL,NYN,3,2,3-2,MIL,9,true,38,34,72,149,136,285,16,7,23,3,2:53
414722,2015-06-23,2015,SFN,SDN,2,3,3-2,SDN,11,false,44,41,85,174,198,372,13,10,23,4,4:03
414712,2015-06-23,2015,BOS,BAL,4,6,6-4,BAL,9,false,40,38,78,166,170,336,13,14,27,2,3:08
414721,2015-06-23,2015,NYA,PHI,6,11,11-6,PHI,9,false,43,45,88,173,166,339,16,18,34,4,3:45 (1:21 delay)
414715,2015-06-23,2015,CLE,DET,3,7,7-3,DET,9,false,38,39,77,162,157,319,12,12,24,3,3:28
414730,2015-06-24,2015,CLE,DET,8,2,8-2,CLE,9,true,43,31,74,121,184,305,22,6,28,4,3:06
414731,2015-06-24,2015,ANA,HOU,2,1,2-1,ANA,13,false,54,46,100,177,216,393,16,11,27,5,4:31
414734,2015-06-24,2015,MIL,NYN,4,1,4-1,MIL,9,true,35,30,65,116,106,222,13,4,17,0,2:13
414728,2015-06-24,2015,MIN,CHA,6,1,6-1,MIN,9,true,35,34,69,102,121,223,12,7,19,1,2:19
414737,2015-06-24,2015,SFN,SDN,6,0,6-0,SFN,9,true,34,34,68,122,131,253,11,7,18,0,2:36
414738,2015-06-24,2015,MIA,SLN,1,6,6-1,SLN,9,false,34,34,68,115,112,227,7,9,16,2,2:31
414727,2015-06-24,2015,BOS,BAL,5,1,5-1,BOS,9,true,32,34,66,128,127,255,9,9,18,1,2:38
414733,2015-06-24,2015,CHN,LAN,2,5,5-2,LAN,9,false,37,34,71,141,150,291,13,8,21,4,3:12
414732,2015-06-24,2015,SEA,KCA,2,8,8-2,KCA,9,false,36,39,75,132,144,276,9,15,24,2,2:47
414736,2015-06-24,2015,NYA,PHI,10,2,10-2,NYA,9,true,47,37,84,141,179,320,22,9,31,1,3:10
414729,2015-06-24,2015,PIT,CIN,2,5,5-2,CIN,9,false,36,41,77,162,141,303,9,16,25,2,3:09
414735,2015-06-24,2015,TEX,OAK,2,8,8-2,OAK,9,false,36,46,82,170,121,291,11,19,30,1,2:46
414726,2015-06-24,2015,WAS,ATL,2,1,2-1,WAS,11,false,43,42,85,147,160,307,14,12,26,2,3:10
414725,2015-06-24,2015,COL,ARI,7,8,8-7,ARI,9,false,39,45,84,168,166,334,13,18,31,6,3:55 (:46 delay)
414739,2015-06-24,2015,TBA,TOR,0,1,1-0,TOR,12,false,43,45,88,163,193,356,8,11,19,2,3:39
414741,2015-06-25,2015,WAS,ATL,7,0,7-0,WAS,9,true,37,34,71,143,131,274,14,8,22,0,2:36
414740,2015-06-25,2015,COL,ARI,6,4,6-4,COL,9,true,37,40,77,161,137,298,15,15,30,3,3:30
414745,2015-06-25,2015,CHN,LAN,0,4,4-0,LAN,9,false,35,37,72,144,135,279,11,12,23,1,2:57
414747,2015-06-25,2015,MIL,NYN,0,2,2-0,NYN,9,false,30,37,67,158,112,270,4,13,17,1,2:46
414749,2015-06-25,2015,SFN,SDN,13,8,13-8,SFN,9,true,44,40,84,147,150,297,21,15,36,4,3:11
414748,2015-06-25,2015,TEX,OAK,3,6,6-3,OAK,9,false,38,40,78,168,132,300,11,14,25,3,2:57
414742,2015-06-25,2015,BOS,BAL,6,8,8-6,BAL,9,false,39,44,83,177,146,323,13,18,31,4,3:06
414743,2015-06-25,2015,DET,CHA,7,8,8-7,CHA,10,false,49,46,95,174,190,364,22,16,38,2,3:53
414746,2015-06-25,2015,HOU,NYA,4,0,4-0,HOU,9,true,34,33,67,116,127,243,12,7,19,1,2:29
414750,2015-06-25,2015,MIA,SLN,1,5,5-1,SLN,9,false,35,40,75,153,130,283,8,15,23,3,2:47
414744,2015-06-25,2015,PIT,CIN,4,5,5-4,CIN,13,false,55,58,113,219,193,412,18,22,40,1,4:41 (:56 delay)
414756,2015-06-26,2015,NYN,CIN,2,1,2-1,NYN,9,true,31,31,62,98,135,233,6,5,11,0,2:24
414757,2015-06-26,2015,BAL,CLE,4,3,4-3,BAL,9,true,35,39,74,144,127,271,13,13,26,1,2:47
414751,2015-06-26,2015,SDN,ARI,4,2,4-2,SDN,9,true,32,32,64,130,137,267,8,8,16,0,2:42
414754,2015-06-26,2015,DET,CHA,5,4,5-4,DET,9,true,36,37,73,137,122,259,14,10,24,1,2:47
414765,2015-06-26,2015,PHI,WAS,2,5,5-2,WAS,9,false,33,39,72,135,107,242,7,12,19,0,2:38
414752,2015-06-26,2015,PIT,ATL,3,2,3-2,PIT,10,false,42,38,80,124,144,268,18,10,28,1,3:10
414760,2015-06-26,2015,MIA,LAN,1,7,7-1,LAN,9,false,32,43,75,147,144,291,7,19,26,0,2:38
414758,2015-06-26,2015,SFN,COL,6,8,8-6,COL,9,false,40,44,84,142,163,305,14,20,34,4,3:30
414755,2015-06-26,2015,SLN,CHN,3,2,3-2,SLN,10,false,39,44,83,165,146,311,12,16,28,3,3:25
414763,2015-06-26,2015,ANA,SEA,1,3,3-1,SEA,9,false,36,36,72,115,121,236,11,13,24,3,2:43
414759,2015-06-26,2015,OAK,KCA,2,5,5-2,KCA,9,false,33,40,73,147,142,289,6,15,21,2,2:51
414762,2015-06-26,2015,HOU,NYA,2,3,3-2,NYA,9,false,35,38,73,140,150,290,8,12,20,4,3:08
414764,2015-06-26,2015,TOR,TEX,12,2,12-2,TOR,9,true,41,35,76,130,147,277,19,9,28,0,2:26
414753,2015-06-26,2015,TBA,BOS,3,4,4-3,BOS,10,false,41,42,83,154,142,296,15,15,30,4,3:23
414761,2015-06-26,2015,MIL,MIN,10,4,10-4,MIL,9,true,40,35,75,133,157,290,15,8,23,1,2:49
414776,2015-06-27,2015,MIL,MIN,2,5,5-2,MIN,9,false,35,35,70,132,128,260,8,11,19,1,2:47
414768,2015-06-27,2015,TBA,BOS,4,1,4-1,TBA,9,true,33,30,63,124,134,258,11,3,14,1,2:21
414767,2015-06-27,2015,PIT,ATL,8,4,8-4,PIT,9,true,39,38,77,136,132,268,15,13,28,2,3:02 (:46 delay)
414770,2015-06-27,2015,SLN,CHN,8,1,8-1,SLN,9,true,41,35,76,144,160,304,20,12,32,1,3:03
414774,2015-06-27,2015,OAK,KCA,2,3,3-2,KCA,9,false,34,37,71,129,142,271,8,10,18,1,2:49
414777,2015-06-27,2015,HOU,NYA,6,9,9-6,NYA,9,false,41,46,87,167,166,333,14,18,32,2,3:39
414775,2015-06-27,2015,MIA,LAN,3,2,3-2,MIA,9,true,31,32,63,104,122,226,8,6,14,1,2:26
414779,2015-06-27,2015,TOR,TEX,0,4,4-0,TEX,9,false,30,38,68,141,108,249,5,11,16,3,2:24
414778,2015-06-27,2015,ANA,SEA,4,2,4-2,ANA,9,true,32,36,68,115,132,247,10,10,20,1,2:38
414771,2015-06-27,2015,NYN,CIN,2,1,2-1,NYN,13,false,57,52,109,197,232,429,20,15,35,3,4:33 (:53 delay)
414766,2015-06-27,2015,SDN,ARI,7,2,7-2,SDN,9,true,39,33,72,141,129,270,16,8,24,1,2:57
414773,2015-06-27,2015,SFN,COL,7,5,7-5,SFN,9,true,38,40,78,156,135,291,17,13,30,3,3:26
414771,2015-06-27,2015,NYN,CIN,2,1,2-1,NYN,13,false,57,52,109,197,232,429,20,15,35,3,4:33 (:53 delay)
414792,2015-06-28,2015,HOU,NYA,3,1,3-1,HOU,9,true,28,31,59,119,107,226,7,4,11,0,2:24
414785,2015-06-28,2015,SLN,CHN,4,1,4-1,SLN,9,true,32,37,69,131,123,254,10,9,19,1,2:28 (2:29 delay)
414784,2015-06-28,2015,DET,CHA,5,4,5-4,DET,9,false,35,35,70,149,127,276,10,9,19,2,3:01
414772,2015-06-28,2015,BAL,CLE,8,0,8-0,BAL,9,true,37,34,71,140,155,295,12,8,20,2,2:46
414772,2015-06-28,2015,BAL,CLE,8,0,8-0,BAL,9,true,37,34,71,140,155,295,12,8,20,2,2:46
414787,2015-06-28,2015,BAL,CLE,4,0,4-0,BAL,9,true,31,33,64,127,116,243,9,6,15,2,2:21
414790,2015-06-28,2015,MIA,LAN,0,2,2-0,LAN,9,false,32,41,73,159,117,276,6,16,22,2,2:54
414793,2015-06-28,2015,ANA,SEA,3,2,3-2,ANA,10,false,40,36,76,134,158,292,15,7,22,3,3:14
414788,2015-06-28,2015,SFN,COL,6,3,6-3,SFN,9,true,33,33,66,119,133,252,10,9,19,4,2:55
414781,2015-06-28,2015,SDN,ARI,4,6,6-4,ARI,9,false,34,35,69,132,119,251,7,7,14,2,2:31
414782,2015-06-28,2015,PIT,ATL,1,2,2-1,ATL,9,false,34,38,72,141,126,267,8,12,20,1,2:46
414791,2015-06-28,2015,MIL,MIN,5,3,5-3,MIL,9,true,36,37,73,146,142,288,12,12,24,1,3:02
414794,2015-06-28,2015,TOR,TEX,3,2,3-2,TOR,9,true,31,41,72,149,120,269,8,13,21,3,2:40
414786,2015-06-28,2015,NYN,CIN,7,2,7-2,NYN,9,true,38,34,72,141,161,302,16,9,25,2,2:56
414789,2015-06-28,2015,OAK,KCA,3,5,5-3,KCA,9,false,39,39,78,166,156,322,12,11,23,1,2:58
414795,2015-06-28,2015,PHI,WAS,2,3,3-2,WAS,9,false,34,43,77,153,138,291,6,15,21,4,3:07
414783,2015-06-28,2015,TBA,BOS,3,5,5-3,BOS,9,false,39,36,75,162,169,331,13,11,24,1,3:02
414780,2015-06-28,2015,PHI,WAS,8,5,8-5,PHI,9,true,41,40,81,176,145,321,17,12,29,3,3:15
414780,2015-06-28,2015,PHI,WAS,8,5,8-5,PHI,9,true,41,40,81,176,145,321,17,12,29,3,3:15
414796,2015-06-29,2015,TOR,BOS,1,3,3-1,BOS,9,false,30,35,65,138,107,245,6,10,16,1,2:26
414803,2015-06-29,2015,ANA,NYA,4,1,4-1,ANA,9,true,32,37,69,144,110,254,8,13,21,1,2:40
414801,2015-06-29,2015,PHI,MIL,4,7,7-4,MIL,9,false,36,43,79,136,142,278,11,18,29,3,3:22
414802,2015-06-29,2015,CIN,MIN,11,7,11-7,CIN,9,true,46,38,84,150,175,325,23,12,35,1,3:34
414799,2015-06-29,2015,HOU,KCA,6,1,6-1,HOU,9,true,37,35,72,132,171,303,14,9,23,2,2:57
414800,2015-06-29,2015,ARI,LAN,10,6,10-6,ARI,9,true,41,44,85,163,155,318,18,19,37,4,3:49
414798,2015-06-29,2015,OAK,COL,7,1,7-1,OAK,9,true,36,37,73,153,130,283,13,11,24,1,2:40
414797,2015-06-29,2015,TBA,CLE,1,7,7-1,CLE,9,false,29,43,72,162,113,275,3,19,22,1,2:45
414804,2015-06-29,2015,BAL,TEX,1,8,8-1,TEX,9,false,37,42,79,153,165,318,12,16,28,1,3:11
414807,2015-06-30,2015,NYN,CHN,0,1,1-0,CHN,9,false,31,35,66,138,128,266,4,10,14,0,2:22
414817,2015-06-30,2015,MIA,SFN,5,3,5-3,MIA,9,true,37,35,72,135,112,247,13,8,21,2,2:44
414818,2015-06-30,2015,BAL,TEX,6,8,8-6,TEX,9,false,36,39,75,149,135,284,8,16,24,1,2:44
414808,2015-06-30,2015,TBA,CLE,2,6,6-2,CLE,9,false,32,37,69,161,129,290,5,10,15,4,2:42
414819,2015-06-30,2015,ATL,WAS,1,6,6-1,WAS,9,false,36,42,78,163,139,302,9,16,25,1,2:53
414805,2015-06-30,2015,TOR,BOS,3,4,4-3,BOS,9,false,35,39,74,161,140,301,8,12,20,3,3:04
414813,2015-06-30,2015,CIN,MIN,5,8,8-5,MIN,9,false,40,44,84,168,146,314,13,20,33,2,3:19 (2:01 delay)
414812,2015-06-30,2015,PHI,MIL,3,4,4-3,MIL,9,false,41,40,81,168,160,328,14,13,27,3,3:26 (1:19 delay)
414810,2015-06-30,2015,HOU,KCA,4,0,4-0,HOU,9,true,31,34,65,122,111,233,8,8,16,1,2:14
414814,2015-06-30,2015,ANA,NYA,2,1,2-1,ANA,9,true,35,30,65,117,125,242,12,4,16,1,2:37
414816,2015-06-30,2015,SDN,SEA,0,5,5-0,SEA,9,false,32,35,67,139,113,252,6,8,14,0,2:23
414809,2015-06-30,2015,OAK,COL,1,2,2-1,COL,9,false,35,33,68,145,134,279,11,7,18,1,2:56
414815,2015-06-30,2015,DET,PIT,4,5,5-4,PIT,14,false,58,66,124,249,233,482,20,26,46,5,5:30
414806,2015-06-30,2015,SLN,CHA,1,2,2-1,CHA,11,false,43,44,87,191,158,349,10,11,21,1,3:34
414811,2015-06-30,2015,ARI,LAN,4,6,6-4,LAN,10,false,40,44,84,185,175,360,15,14,29,3,4:09
414834,2015-07-01,2015,ATL,WAS,4,1,4-1,ATL,9,true,33,35,68,143,123,266,10,10,20,2,2:39 (2:09 delay)
414826,2015-07-01,2015,ARI,LAN,3,4,4-3,LAN,9,false,37,39,76,164,127,291,13,14,27,1,2:58
414833,2015-07-01,2015,BAL,TEX,4,2,4-2,BAL,9,true,33,32,65,101,119,220,10,5,15,2,2:18
414828,2015-07-01,2015,CIN,MIN,2,1,2-1,CIN,9,true,33,33,66,123,122,245,9,6,15,2,2:40
414820,2015-07-01,2015,TOR,BOS,11,2,11-2,TOR,9,true,40,33,73,139,137,276,18,6,24,0,2:19
414832,2015-07-01,2015,MIA,SFN,6,5,6-5,MIA,9,false,31,39,70,157,116,273,13,14,27,2,2:45
414823,2015-07-01,2015,TBA,CLE,1,8,8-1,CLE,9,false,30,39,69,142,131,273,4,12,16,2,2:44
414824,2015-07-01,2015,OAK,COL,4,1,4-1,OAK,9,true,37,36,73,145,139,284,14,9,23,3,3:14
414830,2015-07-01,2015,DET,PIT,3,9,9-3,PIT,9,false,40,47,87,176,131,307,12,22,34,2,3:21
414831,2015-07-01,2015,SDN,SEA,0,7,7-0,SEA,9,false,31,41,72,168,127,295,5,14,19,3,3:01
414829,2015-07-01,2015,ANA,NYA,1,3,3-1,NYA,9,false,36,40,76,140,157,297,11,14,25,5,3:22
414825,2015-07-01,2015,HOU,KCA,6,5,6-5,HOU,9,true,38,35,73,128,147,275,14,9,23,4,3:21
414827,2015-07-01,2015,PHI,MIL,5,9,9-5,MIL,9,false,40,44,84,147,128,275,13,18,31,2,2:58
414821,2015-07-01,2015,SLN,CHA,1,7,7-1,CHA,9,false,35,41,76,153,138,291,8,16,24,4,3:16 (2:19 delay)
414822,2015-07-01,2015,NYN,CHN,0,2,2-0,CHN,11,false,43,44,87,165,169,334,10,16,26,2,3:40
414843,2015-07-02,2015,OAK,SEA,4,0,4-0,OAK,9,true,32,29,61,113,140,253,8,3,11,0,2:17
414846,2015-07-02,2015,ATL,WAS,2,1,2-1,ATL,9,false,29,32,61,110,105,215,5,7,12,1,2:33
414836,2015-07-02,2015,NYN,CHN,1,6,6-1,CHN,9,false,31,40,71,173,105,278,6,14,20,1,2:41
414841,2015-07-02,2015,DET,PIT,4,8,8-4,PIT,9,false,40,46,86,183,151,334,14,21,35,5,3:32
414840,2015-07-02,2015,KCA,MIN,0,2,2-0,MIN,9,false,34,36,70,147,125,272,8,11,19,2,2:54
414844,2015-07-02,2015,MIA,SFN,5,4,5-4,MIA,9,true,36,38,74,139,121,260,13,11,24,2,2:45
414838,2015-07-02,2015,ARI,COL,8,1,8-1,ARI,9,true,39,31,70,116,147,263,16,5,21,1,3:01
414845,2015-07-02,2015,BAL,TEX,0,2,2-0,TEX,9,false,31,38,69,159,126,285,6,11,17,5,2:55
414837,2015-07-02,2015,TBA,CLE,4,5,5-4,CLE,10,false,37,39,76,152,138,290,8,11,19,1,3:01
414842,2015-07-02,2015,SLN,SDN,3,5,5-3,SDN,11,false,49,46,95,175,198,373,16,16,32,1,3:55
414835,2015-07-02,2015,TOR,BOS,6,12,12-6,BOS,9,false,47,49,96,188,165,353,22,22,44,2,3:34
414839,2015-07-02,2015,PHI,MIL,7,8,8-7,MIL,11,false,51,50,101,172,186,358,19,20,39,1,3:57
414859,2015-07-03,2015,WAS,SFN,2,1,2-1,WAS,9,true,32,31,63,107,119,226,10,5,15,1,2:33
414857,2015-07-03,2015,SLN,SDN,1,2,2-1,SDN,9,false,31,35,66,128,123,251,8,9,17,1,2:35
414856,2015-07-03,2015,ATL,PHI,2,1,2-1,ATL,9,true,32,37,69,134,118,252,9,12,21,1,2:43
414850,2015-07-03,2015,ARI,COL,4,3,4-3,ARI,10,false,44,36,80,141,158,299,19,7,26,1,3:36
414852,2015-07-03,2015,CHN,MIA,1,2,2-1,MIA,9,false,36,36,72,151,132,283,9,9,18,2,2:50
414855,2015-07-03,2015,LAN,NYN,1,2,2-1,NYN,9,false,33,36,69,141,152,293,5,8,13,0,3:00
414847,2015-07-03,2015,TEX,ANA,2,8,8-2,ANA,9,false,35,45,80,179,114,293,8,19,27,2,3:03
414853,2015-07-03,2015,CIN,MIL,1,12,12-1,MIL,9,false,34,47,81,185,152,337,9,22,31,1,3:34
414861,2015-07-03,2015,DET,TOR,8,6,8-6,DET,9,true,36,38,74,154,136,290,16,11,27,3,3:01
414849,2015-07-03,2015,PIT,CLE,2,5,5-2,CLE,9,false,32,42,74,177,125,302,6,16,22,3,3:11 (2:08 delay)
414858,2015-07-03,2015,OAK,SEA,5,9,9-5,SEA,9,false,37,40,77,140,148,288,11,13,24,2,2:52
414854,2015-07-03,2015,KCA,MIN,3,2,3-2,KCA,10,false,41,37,78,148,153,301,14,6,20,2,3:14
414848,2015-07-03,2015,CHA,BAL,1,0,1-0,CHA,9,true,31,33,64,126,116,242,9,7,16,0,2:23
414851,2015-07-03,2015,BOS,HOU,8,12,12-8,HOU,10,false,47,53,100,189,199,388,17,22,39,6,4:23
414860,2015-07-03,2015,NYA,TBA,7,5,7-5,NYA,12,false,50,47,97,198,215,413,20,16,36,6,4:30
414864,2015-07-04,2015,PIT,CLE,1,0,1-0,PIT,9,true,29,30,59,108,92,200,6,5,11,0,2:06
414863,2015-07-04,2015,CHA,BAL,3,2,3-2,CHA,9,true,37,32,69,121,153,274,13,6,19,3,2:53
414867,2015-07-04,2015,CHN,MIA,7,2,7-2,CHN,9,true,32,41,73,132,126,258,8,12,20,3,2:40
414873,2015-07-04,2015,OAK,SEA,2,0,2-0,OAK,9,true,35,33,68,145,107,252,12,8,20,0,2:36
414875,2015-07-04,2015,NYA,TBA,3,2,3-2,NYA,9,false,33,35,68,132,137,269,9,8,17,2,2:42
414872,2015-07-04,2015,SLN,SDN,2,1,2-1,SLN,9,true,31,36,67,130,129,259,7,11,18,2,2:37
414866,2015-07-04,2015,BOS,HOU,6,1,6-1,BOS,9,true,42,32,74,110,164,274,17,6,23,1,3:02
414870,2015-07-04,2015,LAN,NYN,4,3,4-3,LAN,9,true,39,37,76,137,149,286,16,10,26,4,3:25
414865,2015-07-04,2015,ARI,COL,7,3,7-3,ARI,9,true,39,36,75,125,155,280,14,11,25,2,3:18
414874,2015-07-04,2015,WAS,SFN,9,3,9-3,WAS,9,true,40,35,75,141,144,285,17,10,27,2,3:10 (:19 delay)
414871,2015-07-04,2015,ATL,PHI,9,5,9-5,ATL,9,true,40,39,79,130,167,297,15,14,29,2,3:04
414869,2015-07-04,2015,KCA,MIN,3,5,5-3,MIN,9,false,38,39,77,139,141,280,13,14,27,4,3:25
414868,2015-07-04,2015,CIN,MIL,3,7,7-3,MIL,9,false,40,47,87,166,136,302,12,25,37,5,3:46
414876,2015-07-04,2015,DET,TOR,8,3,8-3,DET,9,true,39,37,76,141,164,305,19,11,30,2,3:10
414862,2015-07-04,2015,TEX,ANA,0,13,13-0,ANA,9,false,34,52,86,213,138,351,6,27,33,1,3:21
414884,2015-07-05,2015,KCA,MIN,3,2,3-2,KCA,9,false,31,34,65,109,101,210,9,10,19,2,2:20
414882,2015-07-05,2015,CHN,MIA,2,0,2-0,CHN,9,true,31,31,62,111,110,221,7,6,13,1,2:18
414887,2015-07-05,2015,SLN,SDN,3,1,3-1,SLN,9,true,30,33,63,134,135,269,8,6,14,0,2:26
414889,2015-07-05,2015,WAS,SFN,3,1,3-1,WAS,9,true,34,33,67,125,123,248,10,6,16,3,3:02
414883,2015-07-05,2015,CIN,MIL,1,6,6-1,MIL,9,false,33,40,73,127,120,247,7,16,23,1,2:41
414879,2015-07-05,2015,PIT,CLE,5,3,5-3,PIT,9,true,35,32,67,121,139,260,11,7,18,4,2:51
414888,2015-07-05,2015,OAK,SEA,1,2,2-1,SEA,9,false,34,33,67,143,133,276,10,7,17,3,2:47
414890,2015-07-05,2015,NYA,TBA,1,8,8-1,TBA,9,false,35,41,76,144,149,293,9,15,24,1,2:59
414878,2015-07-05,2015,CHA,BAL,1,9,9-1,BAL,9,false,33,45,78,164,143,307,8,15,23,2,3:13
414880,2015-07-05,2015,ARI,COL,4,6,6-4,COL,9,false,39,39,78,143,149,292,13,15,28,4,3:32
414886,2015-07-05,2015,ATL,PHI,0,4,4-0,PHI,10,false,37,44,81,165,149,314,9,15,24,3,3:13
414881,2015-07-05,2015,BOS,HOU,5,4,5-4,BOS,9,true,38,41,79,174,177,351,16,14,30,3,4:01
414877,2015-07-05,2015,TEX,ANA,6,12,12-6,ANA,9,false,40,46,86,164,154,318,13,20,33,1,3:03
414891,2015-07-05,2015,DET,TOR,5,10,10-5,TOR,9,false,39,46,85,171,164,335,13,19,32,2,3:17
414885,2015-07-05,2015,LAN,NYN,0,8,8-0,NYN,9,false,33,47,80,168,142,310,6,21,27,0,2:54
414894,2015-07-06,2015,WAS,CIN,2,3,3-2,CIN,9,false,37,39,76,132,138,270,10,13,23,1,2:43 (:29 delay)
414900,2015-07-06,2015,CHN,SLN,0,6,6-0,SLN,9,false,32,37,69,139,121,260,7,9,16,0,2:43 (1:16 delay)
414899,2015-07-06,2015,PIT,SDN,2,1,2-1,PIT,9,false,33,33,66,129,143,272,8,10,18,1,2:53 (:28 delay)
414892,2015-07-06,2015,MIL,ATL,3,5,5-3,ATL,9,false,35,44,79,173,140,313,10,18,28,1,3:30
414896,2015-07-06,2015,CLE,HOU,4,9,9-4,HOU,9,false,38,44,82,170,150,320,13,19,32,2,3:15
414893,2015-07-06,2015,MIN,BAL,4,2,4-2,MIN,10,false,37,39,76,141,137,278,10,11,21,1,2:49
414895,2015-07-06,2015,SEA,DET,5,12,12-5,DET,9,false,38,44,82,142,153,295,12,20,32,4,3:17
414898,2015-07-06,2015,LAN,PHI,10,7,10-7,LAN,9,true,42,45,87,186,181,367,18,19,37,4,4:13
414902,2015-07-06,2015,CHA,TOR,4,2,4-2,CHA,9,true,31,32,63,108,104,212,9,7,16,0,1:54
414897,2015-07-06,2015,SFN,NYN,0,3,3-0,NYN,9,false,32,38,70,134,93,227,5,12,17,4,2:20
413683,2015-07-07,2015,CHN,SLN,7,4,7-4,CHN,9,true,45,35,80,133,168,301,20,11,31,4,3:10
414907,2015-07-07,2015,WAS,CIN,0,5,5-0,CIN,9,false,31,38,69,133,122,255,3,11,14,1,2:30
414909,2015-07-07,2015,CLE,HOU,2,0,2-0,CLE,9,true,33,34,67,145,129,274,10,8,18,2,3:03 (:11 delay)
414911,2015-07-07,2015,SFN,NYN,3,0,3-0,SFN,9,true,35,33,68,151,117,268,11,8,19,1,2:47
414903,2015-07-07,2015,COL,ANA,2,10,10-2,ANA,9,false,36,40,76,136,126,262,10,14,24,2,2:30
414910,2015-07-07,2015,BOS,MIA,4,3,4-3,BOS,9,true,35,36,71,132,147,279,11,9,20,3,2:44
414906,2015-07-07,2015,MIN,BAL,8,3,8-3,MIN,9,true,38,35,73,150,141,291,17,9,26,2,2:48
414913,2015-07-07,2015,LAN,PHI,2,7,7-2,PHI,9,false,35,42,77,163,123,286,10,14,24,0,2:45
414914,2015-07-07,2015,PIT,SDN,3,2,3-2,PIT,9,true,38,36,74,137,150,287,14,9,23,1,2:55 (1:42 delay)
414905,2015-07-07,2015,MIL,ATL,3,4,4-3,ATL,9,false,37,37,74,133,148,281,12,12,24,3,2:55
414916,2015-07-07,2015,KCA,TBA,7,1,7-1,KCA,9,true,40,35,75,147,143,290,16,9,25,3,3:10
414901,2015-07-07,2015,KCA,TBA,9,5,9-5,KCA,9,false,43,40,83,140,145,285,21,12,33,3,3:10
414901,2015-07-07,2015,KCA,TBA,9,5,9-5,KCA,9,false,43,40,83,140,145,285,21,12,33,3,3:10
413683,2015-07-07,2015,CHN,SLN,7,4,7-4,CHN,9,true,45,35,80,133,168,301,20,11,31,4,3:10
414912,2015-07-07,2015,NYA,OAK,3,4,4-3,OAK,10,false,40,37,77,147,156,303,11,9,20,3,3:16
414908,2015-07-07,2015,SEA,DET,7,6,7-6,SEA,11,false,48,43,91,170,181,351,19,13,32,2,3:44
414917,2015-07-07,2015,CHA,TOR,1,2,2-1,TOR,9,false,36,31,67,129,125,254,9,6,15,2,2:33
414915,2015-07-07,2015,CHN,SLN,5,3,5-3,CHN,9,true,35,39,74,147,146,293,10,12,22,4,3:02
414904,2015-07-07,2015,TEX,ARI,2,4,4-2,ARI,9,false,33,44,77,175,106,281,5,19,24,4,3:03
414928,2015-07-08,2015,LAN,PHI,5,0,5-0,LAN,9,true,37,36,73,123,155,278,12,9,21,0,2:41
414931,2015-07-08,2015,KCA,TBA,9,7,9-7,KCA,9,true,38,42,80,146,126,272,15,18,33,2,2:52
414921,2015-07-08,2015,MIN,BAL,5,3,5-3,MIN,9,true,39,35,74,132,183,315,17,9,26,0,2:59
414919,2015-07-08,2015,TEX,ARI,4,7,7-4,ARI,9,false,42,39,81,143,158,301,15,14,29,5,3:26
414923,2015-07-08,2015,SEA,DET,4,5,5-4,DET,9,false,42,38,80,169,160,329,14,15,29,3,3:28
414927,2015-07-08,2015,NYA,OAK,5,4,5-4,NYA,9,true,36,39,75,157,144,301,14,12,26,4,3:09
414932,2015-07-08,2015,CHA,TOR,7,6,7-6,CHA,11,false,46,46,92,186,168,354,20,16,36,2,3:51
414918,2015-07-08,2015,COL,ANA,2,3,3-2,ANA,9,false,42,38,80,161,148,309,18,14,32,2,3:27 (2:07 delay)
414930,2015-07-08,2015,CHN,SLN,5,6,6-5,SLN,9,false,37,40,77,167,163,330,11,14,25,1,3:11
414925,2015-07-08,2015,BOS,MIA,6,3,6-3,BOS,9,true,32,37,69,138,131,269,7,11,18,0,2:41
414926,2015-07-08,2015,SFN,NYN,1,4,4-1,NYN,9,false,34,37,71,115,115,230,6,10,16,1,2:28
414924,2015-07-08,2015,CLE,HOU,4,2,4-2,CLE,9,true,33,33,66,118,127,245,9,6,15,2,2:39
414920,2015-07-08,2015,MIL,ATL,6,5,6-5,MIL,9,true,33,38,71,140,145,285,9,13,22,2,3:00
414929,2015-07-08,2015,PIT,SDN,5,2,5-2,PIT,9,true,32,37,69,155,119,274,8,11,19,2,2:48
414939,2015-07-09,2015,LAN,PHI,6,0,6-0,LAN,9,true,36,29,65,111,123,234,12,2,14,2,2:14
414938,2015-07-09,2015,NYA,OAK,6,2,6-2,NYA,9,true,38,32,70,137,145,282,13,4,17,2,2:55
414941,2015-07-09,2015,KCA,TBA,8,3,8-3,KCA,9,true,37,38,75,154,149,303,14,11,25,0,2:57
414934,2015-07-09,2015,COL,ATL,5,3,5-3,COL,9,true,40,37,77,131,138,269,19,11,30,3,3:13 (2:06 delay)
414933,2015-07-09,2015,SEA,ANA,7,2,7-2,SEA,9,true,42,38,80,147,145,292,21,12,33,4,3:14
414942,2015-07-09,2015,CHA,TOR,2,0,2-0,CHA,9,true,31,30,61,108,133,241,7,5,12,0,2:15
414937,2015-07-09,2015,CLE,HOU,3,1,3-1,CLE,9,true,34,32,66,123,134,257,12,7,19,3,2:49
414936,2015-07-09,2015,MIN,DET,2,4,4-2,DET,9,false,37,33,70,126,130,256,9,9,18,2,3:01
414935,2015-07-09,2015,MIA,CIN,2,0,2-0,MIA,9,true,32,32,64,128,120,248,11,7,18,0,2:31
414940,2015-07-09,2015,PIT,SLN,1,4,4-1,SLN,9,false,33,37,70,135,142,277,8,11,19,3,2:52 (:36 delay)
414952,2015-07-10,2015,CLE,OAK,5,1,5-1,CLE,9,true,39,33,72,115,157,272,14,7,21,2,2:57
414956,2015-07-10,2015,KCA,TOR,3,0,3-0,KCA,9,true,36,35,71,147,131,278,12,10,22,1,2:55 (2:07 delay)
414946,2015-07-10,2015,CHN,CHA,0,1,1-0,CHA,9,false,32,33,65,113,152,265,10,7,17,0,2:40
414945,2015-07-10,2015,COL,ATL,5,3,5-3,COL,9,true,37,35,72,118,140,258,15,11,26,2,2:47
414943,2015-07-10,2015,SEA,ANA,3,7,7-3,ANA,9,false,36,42,78,158,139,297,10,15,25,2,2:49
414948,2015-07-10,2015,MIN,DET,8,6,8-6,MIN,9,false,37,41,78,149,150,299,13,15,28,2,3:22
414947,2015-07-10,2015,MIA,CIN,0,1,1-0,CIN,9,false,32,35,67,120,119,239,5,9,14,0,2:21
414957,2015-07-10,2015,BAL,WAS,3,2,3-2,BAL,9,false,36,35,71,149,147,296,12,11,23,2,3:12
414953,2015-07-10,2015,SFN,PHI,15,2,15-2,SFN,9,true,49,39,88,135,201,336,26,14,40,2,3:23
414950,2015-07-10,2015,LAN,MIL,3,2,3-2,LAN,9,true,33,34,67,122,110,232,9,8,17,0,2:35
414949,2015-07-10,2015,TBA,HOU,3,1,3-1,TBA,9,true,29,31,60,119,108,227,6,6,12,2,2:19
414955,2015-07-10,2015,PIT,SLN,5,2,5-2,PIT,9,true,35,35,70,148,148,296,13,9,22,0,3:01
414954,2015-07-10,2015,TEX,SDN,4,3,4-3,TEX,9,true,33,39,72,165,145,310,9,13,22,3,3:05
414944,2015-07-10,2015,NYN,ARI,4,2,4-2,NYN,9,true,36,35,71,137,169,306,14,8,22,2,3:02
414951,2015-07-10,2015,BOS,NYA,1,5,5-1,NYA,9,false,35,41,76,156,126,282,8,12,20,3,3:03
414964,2015-07-11,2015,TBA,HOU,3,0,3-0,TBA,9,true,33,35,68,143,118,261,10,8,18,2,2:41
414971,2015-07-11,2015,KCA,TOR,2,6,6-2,TOR,9,false,33,43,76,167,110,277,6,16,22,2,2:42
414967,2015-07-11,2015,CLE,OAK,4,5,5-4,OAK,9,false,37,37,74,145,145,290,11,12,23,6,3:08
414966,2015-07-11,2015,BOS,NYA,5,3,5-3,BOS,9,true,36,34,70,144,139,283,13,10,23,4,3:10
414969,2015-07-11,2015,TEX,SDN,5,6,6-5,SDN,9,false,38,40,78,135,163,298,13,13,26,3,3:11
414960,2015-07-11,2015,COL,ATL,3,2,3-2,COL,9,false,40,38,78,148,146,294,18,12,30,5,3:26
414959,2015-07-11,2015,NYN,ARI,4,2,4-2,NYN,9,true,30,34,64,130,109,239,6,10,16,2,2:25
414972,2015-07-11,2015,BAL,WAS,4,7,7-4,WAS,9,false,39,38,77,125,159,284,14,14,28,2,3:05
414968,2015-07-11,2015,SFN,PHI,8,5,8-5,SFN,9,true,41,38,79,150,146,296,18,12,30,5,3:17
414961,2015-07-11,2015,CHN,CHA,1,5,5-1,CHA,9,false,35,36,71,141,144,285,8,10,18,2,2:45
414958,2015-07-11,2015,SEA,ANA,5,0,5-0,SEA,9,true,39,33,72,119,137,256,16,6,22,2,2:42
414965,2015-07-11,2015,LAN,MIL,1,7,7-1,MIL,9,false,29,42,71,157,100,257,5,19,24,1,2:56
414963,2015-07-11,2015,MIN,DET,9,5,9-5,MIN,9,true,40,39,79,143,152,295,19,13,32,5,3:27
414970,2015-07-11,2015,PIT,SLN,6,5,6-5,PIT,14,false,57,59,116,221,211,432,19,20,39,5,5:04
414962,2015-07-11,2015,MIA,CIN,14,3,14-3,MIA,9,true,45,37,82,134,158,292,23,11,34,2,2:54
414976,2015-07-12,2015,CHN,CHA,3,1,3-1,CHN,9,true,32,29,61,106,107,213,10,2,12,1,2:18
414987,2015-07-12,2015,BAL,WAS,2,3,3-2,WAS,9,false,31,35,66,124,119,243,4,9,13,1,2:21
414982,2015-07-12,2015,CLE,OAK,0,2,2-0,OAK,9,false,29,32,61,125,107,232,3,7,10,0,2:25
414983,2015-07-12,2015,SFN,PHI,4,2,4-2,SFN,9,true,32,32,64,116,122,238,11,9,20,2,2:23
414978,2015-07-12,2015,MIN,DET,7,1,7-1,MIN,9,true,35,33,68,123,136,259,12,8,20,2,2:44
414975,2015-07-12,2015,COL,ATL,11,3,11-3,COL,9,true,42,41,83,148,149,297,20,16,36,1,3:08
414973,2015-07-12,2015,SEA,ANA,3,10,10-3,ANA,9,false,36,44,80,167,137,304,10,16,26,2,2:56
414986,2015-07-12,2015,KCA,TOR,11,10,11-10,KCA,9,true,39,42,81,175,133,308,16,16,32,3,3:23
414974,2015-07-12,2015,NYN,ARI,5,3,5-3,NYN,9,true,39,34,73,121,159,280,16,7,23,2,2:44
414985,2015-07-12,2015,PIT,SLN,6,5,6-5,PIT,10,false,44,44,88,160,164,324,17,16,33,3,3:42
414979,2015-07-12,2015,TBA,HOU,4,3,4-3,TBA,9,true,30,38,68,154,114,268,8,11,19,1,2:41
414977,2015-07-12,2015,MIA,CIN,8,1,8-1,MIA,9,true,36,37,73,139,116,255,11,9,20,0,2:27
414980,2015-07-12,2015,LAN,MIL,4,3,4-3,LAN,9,true,34,34,68,109,163,272,10,8,18,3,2:42
414981,2015-07-12,2015,BOS,NYA,6,8,8-6,NYA,9,false,43,38,81,145,183,328,14,12,26,5,3:36
414984,2015-07-12,2015,TEX,SDN,1,2,2-1,SDN,9,false,35,39,74,145,154,299,10,12,22,3,3:13
414988,2015-07-14,2015,NAS,AAS,3,6,6-3,AAS,9,false,36,39,75,158,130,288,8,11,19,1,3:02
413905,2015-07-17,2015,CHA,KCA,2,4,4-2,KCA,9,false,36,35,71,134,137,271,12,11,23,0,2:44
414996,2015-07-17,2015,PHI,MIA,6,3,6-3,PHI,9,true,33,36,69,130,99,229,9,12,21,3,2:26
414997,2015-07-17,2015,OAK,MIN,0,5,5-0,MIN,9,false,34,38,72,149,125,274,6,11,17,1,2:42
414994,2015-07-17,2015,CHA,KCA,2,0,2-0,CHA,9,true,34,34,68,132,135,267,12,8,20,3,3:08
413905,2015-07-17,2015,CHA,KCA,2,4,4-2,KCA,9,false,36,35,71,134,137,271,12,11,23,0,2:44
414998,2015-07-17,2015,SLN,NYN,3,2,3-2,SLN,9,true,33,35,68,161,125,286,9,8,17,2,3:01
414995,2015-07-17,2015,WAS,LAN,5,3,5-3,WAS,9,true,37,37,74,126,140,266,14,9,23,2,2:51 (2:02 delay)
414989,2015-07-17,2015,DET,BAL,7,3,7-3,DET,9,true,35,41,76,162,127,289,11,14,25,3,2:55
414993,2015-07-17,2015,SDN,COL,4,2,4-2,SDN,9,true,32,37,69,158,151,309,9,14,23,0,3:13
415001,2015-07-17,2015,ARI,SFN,5,6,6-5,SFN,12,false,52,57,109,234,204,438,17,21,38,7,5:11
414990,2015-07-17,2015,ANA,BOS,1,0,1-0,ANA,9,false,30,34,64,121,124,245,4,8,12,1,2:24
414992,2015-07-17,2015,CIN,CLE,6,1,6-1,CIN,9,true,39,36,75,145,150,295,15,8,23,1,2:58 (1:05 delay)
415002,2015-07-17,2015,TOR,TBA,6,2,6-2,TOR,9,true,35,35,70,122,133,255,12,9,21,1,2:35
414999,2015-07-17,2015,MIL,PIT,4,1,4-1,MIL,9,true,39,33,72,114,133,247,16,7,23,1,2:51
415003,2015-07-17,2015,HOU,TEX,3,2,3-2,HOU,9,true,33,39,72,147,137,284,13,15,28,0,3:11
414991,2015-07-17,2015,ATL,CHN,4,2,4-2,ATL,9,true,36,34,70,143,146,289,13,10,23,2,3:04
415000,2015-07-17,2015,NYA,SEA,4,3,4-3,NYA,9,true,37,35,72,130,138,268,13,8,21,2,2:43
414995,2015-07-17,2015,WAS,LAN,5,3,5-3,WAS,9,true,37,37,74,126,140,266,14,9,23,2,2:51 (2:02 delay)
415004,2015-07-18,2015,DET,BAL,0,3,3-0,BAL,9,false,29,38,67,143,119,262,2,11,13,1,2:57
415017,2015-07-18,2015,TOR,TBA,2,3,3-2,TBA,9,false,35,34,69,137,126,263,8,9,17,2,2:38
415011,2015-07-18,2015,PHI,MIA,3,1,3-1,PHI,9,true,32,36,68,138,119,257,7,11,18,1,2:39
415010,2015-07-18,2015,WAS,LAN,2,4,4-2,LAN,9,false,32,43,75,154,119,273,5,19,24,0,2:43
415018,2015-07-18,2015,HOU,TEX,6,7,7-6,TEX,9,false,37,43,80,159,142,301,9,16,25,4,3:28
415006,2015-07-18,2015,ATL,CHN,0,4,4-0,CHN,9,false,32,40,72,158,138,296,5,13,18,3,3:06
415008,2015-07-18,2015,SDN,COL,5,4,5-4,SDN,9,true,32,35,67,153,110,263,9,10,19,2,2:39
415016,2015-07-18,2015,ARI,SFN,4,8,8-4,SFN,9,false,38,45,83,183,142,325,12,20,32,5,3:38
415013,2015-07-18,2015,SLN,NYN,12,2,12-2,SLN,9,true,45,40,85,130,164,294,21,15,36,2,3:01
415009,2015-07-18,2015,CHA,KCA,6,7,7-6,KCA,13,false,57,61,118,235,220,455,19,26,45,3,4:56
415005,2015-07-18,2015,ANA,BOS,3,0,3-0,ANA,9,true,33,30,63,113,136,249,9,3,12,0,2:37
415007,2015-07-18,2015,CIN,CLE,4,9,9-4,CLE,9,false,36,43,79,140,137,277,10,16,26,2,3:04
415012,2015-07-18,2015,OAK,MIN,3,2,3-2,OAK,10,false,38,35,73,145,153,298,14,8,22,2,3:00
415015,2015-07-18,2015,NYA,SEA,3,4,4-3,SEA,9,false,35,36,71,165,134,299,7,10,17,3,3:12
415014,2015-07-18,2015,MIL,PIT,8,5,8-5,MIL,9,true,42,39,81,141,161,302,20,12,32,1,3:24
415033,2015-07-19,2015,HOU,TEX,10,0,10-0,HOU,9,true,44,30,74,118,173,291,20,3,23,1,2:56
415025,2015-07-19,2015,WAS,LAN,0,5,5-0,LAN,9,false,31,45,76,187,130,317,6,19,25,2,3:14
415030,2015-07-19,2015,NYA,SEA,2,1,2-1,NYA,9,true,32,36,68,135,125,260,9,10,19,1,2:45
415029,2015-07-19,2015,MIL,PIT,6,1,6-1,MIL,9,true,35,35,70,140,112,252,13,10,23,3,2:56
415024,2015-07-19,2015,CHA,KCA,1,4,4-1,KCA,9,false,32,37,69,133,125,258,7,14,21,2,2:45
415026,2015-07-19,2015,PHI,MIA,8,7,8-7,PHI,9,false,36,42,78,170,126,296,13,16,29,1,3:15
415019,2015-07-19,2015,DET,BAL,3,9,9-3,BAL,9,false,43,41,84,167,168,335,17,18,35,1,3:30
415031,2015-07-19,2015,ARI,SFN,1,2,2-1,SFN,9,false,37,35,72,140,141,281,10,8,18,1,3:05
415032,2015-07-19,2015,TOR,TBA,4,0,4-0,TOR,9,true,32,29,61,125,133,258,8,4,12,1,2:30
415021,2015-07-19,2015,ATL,CHN,1,4,4-1,CHN,9,false,36,42,78,157,151,308,9,16,25,1,3:18
415027,2015-07-19,2015,OAK,MIN,14,1,14-1,OAK,9,true,42,36,78,141,148,289,15,9,24,1,2:49
415028,2015-07-19,2015,SLN,NYN,1,3,3-1,NYN,18,false,69,82,151,319,239,558,21,32,53,3,5:55
415022,2015-07-19,2015,CIN,CLE,3,5,5-3,CLE,11,false,44,56,100,237,146,383,13,23,36,4,4:11 (:47 delay)
415038,2015-07-20,2015,WAS,NYN,7,2,7-2,WAS,9,true,35,39,74,153,114,267,10,13,23,0,2:50
415034,2015-07-20,2015,ANA,BOS,7,3,7-3,ANA,9,true,36,35,71,133,140,273,12,8,20,1,2:34
415037,2015-07-20,2015,ARI,MIA,3,1,3-1,ARI,9,true,34,36,70,143,126,269,13,13,26,2,2:58
415041,2015-07-20,2015,SDN,SFN,4,2,4-2,SDN,9,true,37,36,73,137,164,301,15,9,24,1,3:13
415036,2015-07-20,2015,ATL,LAN,7,5,7-5,ATL,9,true,38,39,77,139,151,290,16,14,30,1,3:01
415020,2015-07-20,2015,ANA,BOS,11,1,11-1,ANA,9,true,40,37,77,165,138,303,17,11,28,2,3:05
415043,2015-07-20,2015,COL,TEX,8,7,8-7,COL,9,false,42,41,83,139,168,307,17,14,31,3,3:31
415039,2015-07-20,2015,KCA,PIT,7,10,10-7,PIT,9,false,42,45,87,170,140,310,19,18,37,4,3:31
415040,2015-07-20,2015,DET,SEA,5,4,5-4,DET,9,true,30,39,69,145,106,251,8,12,20,1,2:54
415035,2015-07-20,2015,CIN,CHN,5,4,5-4,CIN,9,true,33,40,73,171,137,308,11,14,25,2,3:09
415042,2015-07-20,2015,PHI,TBA,5,3,5-3,PHI,9,true,32,36,68,132,121,253,13,9,22,3,2:44
415020,2015-07-20,2015,ANA,BOS,11,1,11-1,ANA,9,true,40,37,77,165,138,303,17,11,28,2,3:05
415050,2015-07-21,2015,ANA,MIN,7,0,7-0,ANA,9,true,37,31,68,124,137,261,15,5,20,1,2:52
415052,2015-07-21,2015,KCA,PIT,3,1,3-1,KCA,9,true,30,37,67,150,120,270,7,11,18,3,3:02
415049,2015-07-21,2015,ARI,MIA,0,3,3-0,MIA,9,false,33,37,70,145,106,251,6,11,17,2,2:55
415045,2015-07-21,2015,HOU,BOS,8,3,8-3,HOU,9,true,38,33,71,127,163,290,15,8,23,1,3:01
415054,2015-07-21,2015,SDN,SFN,3,9,9-3,SFN,9,false,33,37,70,143,150,293,7,13,20,3,2:50
415047,2015-07-21,2015,MIL,CLE,8,1,8-1,MIL,9,true,38,35,73,136,141,277,14,12,26,4,2:58
415051,2015-07-21,2015,WAS,NYN,2,7,7-2,NYN,9,false,32,42,74,151,127,278,6,15,21,3,2:54
415044,2015-07-21,2015,NYA,BAL,3,2,3-2,NYA,9,true,37,35,72,139,134,273,14,10,24,3,2:48 (:15 delay)
415058,2015-07-21,2015,OAK,TOR,1,7,7-1,TOR,9,false,35,41,76,165,123,288,9,15,24,2,2:38
415048,2015-07-21,2015,ATL,LAN,4,3,4-3,ATL,9,true,37,36,73,139,158,297,14,10,24,3,3:20
415057,2015-07-21,2015,COL,TEX,0,9,9-0,TEX,9,false,34,47,81,154,137,291,10,20,30,2,3:06
415055,2015-07-21,2015,CHA,SLN,5,8,8-5,SLN,9,false,39,44,83,164,165,329,12,18,30,1,3:06
415046,2015-07-21,2015,CIN,CHN,4,5,5-4,CHN,13,false,54,58,112,246,209,455,16,19,35,2,4:51
415056,2015-07-21,2015,PHI,TBA,0,1,1-0,TBA,9,false,33,35,68,133,137,270,8,8,16,2,2:52
415053,2015-07-21,2015,DET,SEA,9,11,11-9,SEA,9,false,44,48,92,175,184,359,18,23,41,7,3:55
413902,2015-07-22,2015,CIN,CHN,5,6,6-5,CHN,9,false,44,43,87,164,180,344,21,19,40,2,3:39
415067,2015-07-22,2015,KCA,PIT,5,1,5-1,KCA,9,true,35,35,70,112,119,231,12,9,21,2,2:39
415060,2015-07-22,2015,HOU,BOS,4,2,4-2,HOU,9,true,33,36,69,123,129,252,10,10,20,1,2:44
415063,2015-07-22,2015,ATL,LAN,1,3,3-1,LAN,9,false,32,36,68,139,125,264,5,11,16,1,2:49
415061,2015-07-22,2015,CIN,CHN,9,1,9-1,CIN,9,true,41,33,74,137,156,293,17,7,24,0,2:42
415065,2015-07-22,2015,ANA,MIN,5,2,5-2,ANA,9,true,36,41,77,169,109,278,16,14,30,0,3:03
415070,2015-07-22,2015,CHA,SLN,2,3,3-2,SLN,9,false,36,37,73,139,158,297,9,10,19,3,3:02
415066,2015-07-22,2015,WAS,NYN,4,3,4-3,WAS,9,true,40,34,74,132,159,291,18,7,25,0,3:02
415068,2015-07-22,2015,DET,SEA,9,4,9-4,DET,9,true,41,39,80,159,159,318,19,15,34,4,3:10
415064,2015-07-22,2015,ARI,MIA,3,5,5-3,MIA,9,false,41,37,78,165,148,313,14,11,25,4,3:16
415069,2015-07-22,2015,SDN,SFN,1,7,7-1,SFN,9,false,35,43,78,181,152,333,9,18,27,3,3:20
415062,2015-07-22,2015,MIL,CLE,5,7,7-5,CLE,9,false,42,43,85,171,159,330,18,22,40,2,3:27
415072,2015-07-22,2015,COL,TEX,8,10,10-8,TEX,9,false,42,45,87,185,152,337,16,20,36,4,3:45
413902,2015-07-22,2015,CIN,CHN,5,6,6-5,CHN,9,false,44,43,87,164,180,344,21,19,40,2,3:39
415071,2015-07-22,2015,PHI,TBA,5,4,5-4,PHI,10,false,45,46,91,167,163,330,15,19,34,2,3:43
415059,2015-07-22,2015,NYA,BAL,4,3,4-3,NYA,9,true,33,33,66,129,123,252,9,7,16,0,2:33
415073,2015-07-22,2015,OAK,TOR,4,3,4-3,OAK,10,false,43,44,87,164,185,349,16,17,33,3,3:49
414589,2015-07-23,2015,SLN,KCA,4,3,4-3,SLN,9,true,34,38,72,149,143,292,11,13,24,1,2:56
415077,2015-07-23,2015,NYN,LAN,0,3,3-0,LAN,9,false,29,34,63,112,104,216,3,10,13,1,2:27
415080,2015-07-23,2015,ANA,MIN,0,3,3-0,MIN,9,false,32,33,65,114,105,219,5,9,14,0,2:16
415082,2015-07-23,2015,OAK,TOR,2,5,5-2,TOR,9,false,33,36,69,130,106,236,7,9,16,3,2:34
415074,2015-07-23,2015,NYA,BAL,9,3,9-3,NYA,9,true,39,32,71,118,146,264,16,5,21,3,2:40
415076,2015-07-23,2015,CLE,CHA,1,8,8-1,CHA,9,false,32,38,70,135,120,255,5,12,17,1,2:28
415078,2015-07-23,2015,SDN,MIA,0,4,4-0,MIA,9,false,33,37,70,142,135,277,8,11,19,1,2:46
415079,2015-07-23,2015,ARI,MIL,8,3,8-3,ARI,9,true,41,33,74,143,154,297,18,8,26,0,3:12
414589,2015-07-23,2015,SLN,KCA,4,3,4-3,SLN,9,true,34,38,72,149,143,292,11,13,24,1,2:56
415083,2015-07-23,2015,PIT,WAS,7,3,7-3,PIT,9,true,38,37,75,156,154,310,14,11,25,1,2:52
415075,2015-07-23,2015,HOU,BOS,5,4,5-4,HOU,9,false,37,40,77,156,159,315,15,13,28,3,3:31
415081,2015-07-23,2015,DET,SEA,2,3,3-2,SEA,12,false,48,48,96,192,189,381,18,14,32,4,4:33
415096,2015-07-24,2015,ANA,TEX,2,4,4-2,TEX,9,false,34,35,69,121,127,248,7,9,16,3,2:39
415091,2015-07-24,2015,SDN,MIA,3,1,3-1,SDN,9,true,32,37,69,145,117,262,9,10,19,0,2:36
415089,2015-07-24,2015,KCA,HOU,0,4,4-0,HOU,9,false,32,38,70,132,120,252,6,13,19,1,2:38
415084,2015-07-24,2015,SLN,ATL,4,2,4-2,SLN,9,true,36,33,69,109,144,253,14,7,21,3,2:55
415097,2015-07-24,2015,SEA,TOR,5,2,5-2,SEA,9,true,36,35,71,130,151,281,14,8,22,1,2:49
415086,2015-07-24,2015,CLE,CHA,0,6,6-0,CHA,9,false,31,39,70,134,120,254,7,13,20,2,2:43
415090,2015-07-24,2015,NYN,LAN,2,7,7-2,LAN,9,false,32,39,71,132,143,275,7,14,21,1,2:40
415092,2015-07-24,2015,ARI,MIL,1,2,2-1,MIL,9,false,35,37,72,124,130,254,12,10,22,2,2:56
415093,2015-07-24,2015,MIN,NYA,10,1,10-1,MIN,9,true,38,38,76,136,144,280,14,11,25,1,2:57
415085,2015-07-24,2015,TBA,BAL,3,1,3-1,TBA,9,true,32,36,68,164,120,284,11,10,21,1,2:55
415087,2015-07-24,2015,COL,CIN,6,5,6-5,COL,9,false,38,40,78,148,130,278,13,18,31,1,3:05
415098,2015-07-24,2015,PIT,WAS,7,5,7-5,PIT,9,true,36,38,74,144,152,296,13,11,24,0,2:57
415088,2015-07-24,2015,BOS,DET,2,1,2-1,BOS,11,false,39,39,78,175,146,321,10,8,18,0,3:42
415094,2015-07-24,2015,SFN,OAK,9,3,9-3,SFN,9,true,43,34,77,143,174,317,19,8,27,5,3:25
415095,2015-07-24,2015,CHN,PHI,3,5,5-3,PHI,10,false,43,41,84,140,163,303,14,13,27,1,3:13
415099,2015-07-25,2015,SLN,ATL,1,0,1-0,SLN,9,true,28,31,59,102,109,211,5,9,14,2,2:13
415100,2015-07-25,2015,TBA,BAL,1,5,5-1,BAL,9,false,32,34,66,108,127,235,5,7,12,2,2:21
415109,2015-07-25,2015,SFN,OAK,2,1,2-1,SFN,9,true,29,37,66,131,133,264,7,10,17,0,2:41
415110,2015-07-25,2015,CHN,PHI,0,5,5-0,PHI,9,false,29,42,71,142,129,271,2,15,17,0,2:38
415107,2015-07-25,2015,ARI,MIL,2,0,2-0,ARI,9,true,31,37,68,131,132,263,9,9,18,0,2:55
415106,2015-07-25,2015,SDN,MIA,3,1,3-1,SDN,9,true,34,35,69,137,130,267,10,9,19,3,2:51
415103,2015-07-25,2015,BOS,DET,1,5,5-1,DET,9,false,33,38,71,137,128,265,9,12,21,2,2:57
415104,2015-07-25,2015,KCA,HOU,2,1,2-1,KCA,10,false,37,34,71,142,131,273,10,6,16,2,3:03
415108,2015-07-25,2015,MIN,NYA,5,8,8-5,NYA,9,false,39,37,76,125,135,260,12,11,23,3,2:54
415102,2015-07-25,2015,COL,CIN,2,5,5-2,CIN,9,false,34,37,71,142,118,260,8,12,20,1,2:47
415113,2015-07-25,2015,PIT,WAS,3,9,9-3,WAS,9,false,35,45,80,141,124,265,8,18,26,3,3:01
415101,2015-07-25,2015,CLE,CHA,3,10,10-3,CHA,9,false,35,44,79,170,131,301,8,18,26,2,2:54
415112,2015-07-25,2015,SEA,TOR,6,8,8-6,TOR,9,false,41,43,84,183,149,332,13,19,32,3,3:29
415105,2015-07-25,2015,NYN,LAN,15,2,15-2,NYN,9,true,50,34,84,130,204,334,28,8,36,3,3:12
415111,2015-07-25,2015,ANA,TEX,6,7,7-6,TEX,9,false,41,42,83,161,163,324,16,14,30,3,3:32
415128,2015-07-26,2015,PIT,WAS,3,1,3-1,PIT,9,true,30,33,63,115,95,210,7,8,15,1,2:18
415121,2015-07-26,2015,SDN,MIA,3,2,3-2,SDN,9,true,32,34,66,137,116,253,8,7,15,0,2:32
415119,2015-07-26,2015,KCA,HOU,5,1,5-1,KCA,9,true,33,34,67,115,127,242,11,7,18,1,2:38
415123,2015-07-26,2015,MIN,NYA,2,7,7-2,NYA,9,false,35,39,74,161,118,279,11,12,23,3,3:00
415122,2015-07-26,2015,ARI,MIL,3,0,3-0,ARI,9,true,37,36,73,131,149,280,14,10,24,1,3:20
415115,2015-07-26,2015,TBA,BAL,2,5,5-2,BAL,9,false,37,38,75,144,136,280,13,14,27,1,2:43
415116,2015-07-26,2015,CLE,CHA,1,2,2-1,CHA,9,false,34,38,72,146,147,293,8,13,21,4,2:52
415124,2015-07-26,2015,SFN,OAK,4,3,4-3,SFN,9,true,37,35,72,144,142,286,14,9,23,2,3:04
415114,2015-07-26,2015,SLN,ATL,2,3,3-2,ATL,9,false,38,39,77,155,133,288,13,12,25,1,3:02
415118,2015-07-26,2015,BOS,DET,11,1,11-1,BOS,9,true,46,33,79,128,164,292,23,6,29,1,3:14
415120,2015-07-26,2015,NYN,LAN,3,2,3-2,NYN,10,false,40,38,78,160,156,316,15,8,23,3,3:27
415125,2015-07-26,2015,CHN,PHI,5,11,11-5,PHI,9,false,34,46,80,191,124,315,9,20,29,2,3:01
415127,2015-07-26,2015,SEA,TOR,6,5,6-5,SEA,10,false,41,41,82,165,159,324,15,14,29,1,3:05
415117,2015-07-26,2015,COL,CIN,17,7,17-7,COL,9,true,46,45,91,170,181,351,21,19,40,2,3:30
415126,2015-07-26,2015,ANA,TEX,13,7,13-7,ANA,9,true,45,43,88,158,187,345,19,16,35,5,3:33
415136,2015-07-27,2015,SFN,MIL,4,2,4-2,SFN,9,true,33,33,66,121,120,241,9,10,19,1,2:37
415132,2015-07-27,2015,SLN,CIN,4,1,4-1,SLN,9,true,35,36,71,136,128,264,12,10,22,0,2:38
415134,2015-07-27,2015,TBA,DET,5,2,5-2,TBA,9,true,37,34,71,137,162,299,15,7,22,3,3:06
415135,2015-07-27,2015,CLE,KCA,4,9,9-4,KCA,9,false,39,42,81,130,146,276,14,15,29,3,2:59
415137,2015-07-27,2015,TEX,NYA,2,6,6-2,NYA,9,false,38,39,77,152,144,296,11,14,25,1,3:01
415130,2015-07-27,2015,BAL,ATL,2,1,2-1,BAL,11,false,41,42,83,165,164,329,13,10,23,2,3:20
415129,2015-07-27,2015,SEA,ARI,3,4,4-3,ARI,10,false,41,44,85,175,161,336,15,12,27,3,3:27
415133,2015-07-27,2015,CHN,COL,9,8,9-8,CHN,9,false,39,42,81,190,134,324,14,16,30,3,3:35
415131,2015-07-27,2015,BOS,CHA,8,10,10-8,CHA,9,false,44,46,90,175,174,349,16,22,38,4,3:54
415148,2015-07-28,2015,LAN,OAK,0,2,2-0,OAK,9,false,30,33,63,117,110,227,4,7,11,0,2:22
415151,2015-07-28,2015,NYN,SDN,4,0,4-0,NYN,9,true,31,30,61,119,115,234,8,4,12,1,2:20
415142,2015-07-28,2015,SLN,CIN,0,4,4-0,CIN,9,false,32,34,66,116,105,221,5,9,14,1,2:22
415149,2015-07-28,2015,TOR,PHI,2,3,3-2,PHI,9,false,34,32,66,124,119,243,8,8,16,1,2:29
415145,2015-07-28,2015,CLE,KCA,1,2,2-1,KCA,9,false,36,32,68,112,136,248,12,7,19,1,2:40
415146,2015-07-28,2015,SFN,MIL,2,5,5-2,MIL,9,false,34,36,70,128,124,252,9,9,18,2,2:38
415152,2015-07-28,2015,MIA,WAS,4,1,4-1,MIA,9,true,36,38,74,149,110,259,18,14,32,1,2:42
415144,2015-07-28,2015,TBA,DET,10,2,10-2,TBA,9,true,37,36,73,150,155,305,14,10,24,1,3:09
415139,2015-07-28,2015,SEA,ARI,4,8,8-4,ARI,9,false,36,41,77,158,134,292,12,16,28,2,3:00
415141,2015-07-28,2015,BOS,CHA,4,9,9-4,CHA,9,false,35,45,80,154,125,279,9,20,29,2,2:39
415140,2015-07-28,2015,BAL,ATL,7,3,7-3,BAL,9,true,39,39,78,135,153,288,14,12,26,2,2:53
415143,2015-07-28,2015,CHN,COL,2,7,7-2,COL,9,false,36,41,77,149,145,294,11,16,27,3,3:11
415138,2015-07-28,2015,HOU,ANA,10,5,10-5,HOU,9,true,40,40,80,136,165,301,20,13,33,2,3:19
415150,2015-07-28,2015,MIN,PIT,7,8,8-7,PIT,9,false,41,44,85,162,147,309,17,15,32,6,3:24
415147,2015-07-28,2015,TEX,NYA,5,21,21-5,NYA,9,false,36,60,96,244,146,390,9,31,40,3,3:38
415155,2015-07-29,2015,BAL,ATL,2,0,2-0,BAL,9,true,30,30,60,100,125,225,8,4,12,1,2:15 (:33 delay)
415157,2015-07-29,2015,SLN,CIN,0,1,1-0,CIN,9,false,33,31,64,102,129,231,8,4,12,0,2:18
415158,2015-07-29,2015,CHN,COL,3,2,3-2,CHN,9,true,32,32,64,132,130,262,11,7,18,0,2:37
415159,2015-07-29,2015,TBA,DET,1,2,2-1,DET,9,false,31,33,64,135,126,261,5,6,11,0,2:39
415153,2015-07-29,2015,HOU,ANA,6,3,6-3,HOU,9,true,36,36,72,133,128,261,14,9,23,1,2:50
415164,2015-07-29,2015,TOR,PHI,8,2,8-2,TOR,9,true,40,35,75,112,146,258,17,8,25,1,2:37
415160,2015-07-29,2015,CLE,KCA,12,1,12-1,CLE,9,true,47,33,80,112,166,278,23,6,29,1,2:55
415154,2015-07-29,2015,SEA,ARI,2,8,8-2,ARI,9,false,36,42,78,143,138,281,9,17,26,1,2:59
415162,2015-07-29,2015,TEX,NYA,5,2,5-2,TEX,9,true,38,34,72,143,154,297,15,9,24,1,3:09
415161,2015-07-29,2015,SFN,MIL,5,0,5-0,SFN,9,true,34,33,67,135,151,286,11,7,18,2,3:02
415167,2015-07-29,2015,MIA,WAS,2,7,7-2,WAS,9,false,35,38,73,142,148,290,9,11,20,0,2:39
415163,2015-07-29,2015,LAN,OAK,10,7,10-7,LAN,9,true,39,43,82,160,152,312,16,17,33,5,3:24
415166,2015-07-29,2015,NYN,SDN,3,7,7-3,SDN,9,false,34,44,78,165,153,318,10,18,28,1,3:12
415165,2015-07-29,2015,MIN,PIT,4,10,10-4,PIT,9,false,40,45,85,165,170,335,14,19,33,5,3:29
415156,2015-07-29,2015,BOS,CHA,2,9,9-2,CHA,9,false,35,48,83,200,163,363,10,21,31,2,3:42
415172,2015-07-30,2015,OAK,CLE,1,3,3-1,CLE,9,false,30,31,61,122,103,225,3,8,11,1,2:15
415168,2015-07-30,2015,HOU,ANA,3,0,3-0,HOU,9,false,35,33,68,129,137,266,9,6,15,2,3:02
415180,2015-07-30,2015,MIA,WAS,0,1,1-0,WAS,9,false,31,34,65,138,128,266,6,7,13,0,2:38
415175,2015-07-30,2015,TOR,KCA,5,2,5-2,TOR,9,true,36,33,69,129,136,265,14,6,20,1,2:33
415171,2015-07-30,2015,MIL,CHN,2,5,5-2,CHN,9,false,35,39,74,150,127,277,10,12,22,2,3:07
415169,2015-07-30,2015,PHI,ATL,4,1,4-1,PHI,9,true,35,40,75,157,127,284,13,14,27,1,2:59
415178,2015-07-30,2015,NYN,SDN,7,8,8-7,SDN,9,false,39,41,80,146,144,290,11,15,26,2,2:46 (3:36 delay)
415179,2015-07-30,2015,MIN,SEA,9,5,9-5,MIN,9,true,43,39,82,138,175,313,18,13,31,2,3:08
415173,2015-07-30,2015,SLN,COL,9,8,9-8,SLN,9,false,43,45,88,167,171,338,21,21,42,3,3:50
415170,2015-07-30,2015,BOS,CHA,8,2,8-2,BOS,9,true,39,36,75,143,128,271,18,9,27,1,2:40 (:51 delay)
415176,2015-07-30,2015,TEX,NYA,7,6,7-6,TEX,9,false,41,42,83,164,155,319,18,16,34,4,3:31
415174,2015-07-30,2015,BAL,DET,8,9,9-8,DET,9,false,42,43,85,171,161,332,15,19,34,6,3:36
415177,2015-07-30,2015,CIN,PIT,15,5,15-5,CIN,9,true,52,41,93,154,216,370,27,15,42,3,3:37
415193,2015-07-31,2015,TEX,SFN,6,3,6-3,TEX,9,true,33,36,69,133,112,245,10,10,20,1,2:33
415183,2015-07-31,2015,PHI,ATL,9,3,9-3,PHI,9,true,41,37,78,121,148,269,18,10,28,2,2:39 (:33 delay)
415187,2015-07-31,2015,BAL,DET,8,7,8-7,BAL,9,true,39,41,80,155,145,300,16,17,33,6,3:30
415195,2015-07-31,2015,NYN,WAS,2,1,2-1,NYN,12,false,42,44,86,193,172,365,10,8,18,3,3:59
415181,2015-07-31,2015,LAN,ANA,5,3,5-3,LAN,9,true,36,34,70,134,116,250,13,8,21,1,2:43
415185,2015-07-31,2015,OAK,CLE,1,2,2-1,CLE,9,false,30,37,67,141,127,268,2,11,13,3,2:34
415186,2015-07-31,2015,SLN,COL,7,0,7-0,SLN,9,true,42,35,77,133,160,293,19,7,26,1,3:05
415184,2015-07-31,2015,MIL,CHN,1,4,4-1,CHN,9,false,36,39,75,158,151,309,10,12,22,2,3:18
415192,2015-07-31,2015,MIN,SEA,1,6,6-1,SEA,9,false,30,41,71,132,101,233,2,14,16,1,2:23
415190,2015-07-31,2015,CIN,PIT,4,5,5-4,PIT,9,false,41,38,79,149,164,313,16,13,29,1,3:14
415188,2015-07-31,2015,TOR,KCA,7,6,7-6,TOR,11,false,47,41,88,136,178,314,18,11,29,3,3:23
415182,2015-07-31,2015,HOU,ARI,4,6,6-4,ARI,10,false,38,45,83,167,152,319,9,16,25,4,3:41
415194,2015-07-31,2015,BOS,TBA,7,5,7-5,BOS,9,true,37,45,82,180,145,325,11,17,28,1,3:13
415191,2015-07-31,2015,MIA,SDN,3,8,8-3,SDN,11,false,40,47,87,205,148,353,7,18,25,1,3:41
415189,2015-07-31,2015,CHA,NYA,6,13,13-6,NYA,9,false,43,53,96,219,192,411,16,27,43,2,3:56
415200,2015-08-01,2015,OAK,CLE,5,1,5-1,OAK,9,true,32,33,65,120,121,241,10,5,15,3,2:24
415207,2015-08-01,2015,MIN,SEA,3,2,3-2,MIN,9,false,35,35,70,126,139,265,11,8,19,1,2:45
415202,2015-08-01,2015,BAL,DET,6,2,6-2,BAL,9,true,34,32,66,132,125,257,11,6,17,1,2:36
415201,2015-08-01,2015,SLN,COL,2,6,6-2,COL,9,false,34,41,75,141,126,267,8,16,24,4,3:00
415206,2015-08-01,2015,MIA,SDN,3,5,5-3,SDN,9,false,34,37,71,125,119,244,6,10,16,2,2:31
415199,2015-08-01,2015,MIL,CHN,2,4,4-2,CHN,9,false,34,37,71,151,126,277,8,11,19,3,2:55
415210,2015-08-01,2015,NYN,WAS,3,2,3-2,NYN,9,true,33,35,68,155,128,283,11,8,19,2,2:49
415204,2015-08-01,2015,CHA,NYA,8,2,8-2,CHA,9,true,38,36,74,151,138,289,15,10,25,3,2:58
415197,2015-08-01,2015,HOU,ARI,9,2,9-2,HOU,9,true,39,34,73,160,149,309,17,6,23,2,3:12
415196,2015-08-01,2015,LAN,ANA,3,1,3-1,LAN,9,true,34,32,66,139,135,274,10,6,16,1,2:46
415203,2015-08-01,2015,TOR,KCA,6,7,7-6,KCA,9,false,38,37,75,128,140,268,11,11,22,0,2:30
415205,2015-08-01,2015,CIN,PIT,4,3,4-3,CIN,9,true,35,38,73,152,138,290,11,11,22,1,2:58
415198,2015-08-01,2015,PHI,ATL,12,2,12-2,PHI,9,true,42,33,75,139,157,296,19,6,25,2,2:52
415209,2015-08-01,2015,BOS,TBA,11,7,11-7,BOS,9,true,44,42,86,157,180,337,21,16,37,2,3:39
415208,2015-08-01,2015,TEX,SFN,7,9,9-7,SFN,11,false,48,45,93,148,185,333,16,15,31,7,3:44
415220,2015-08-02,2015,CIN,PIT,0,3,3-0,PIT,9,false,35,34,69,132,122,254,8,6,14,1,2:49
415223,2015-08-02,2015,TEX,SFN,2,1,2-1,TEX,9,true,33,32,65,97,112,209,11,5,16,3,2:19
415217,2015-08-02,2015,BAL,DET,1,6,6-1,DET,9,false,30,36,66,148,99,247,5,10,15,2,2:32
415216,2015-08-02,2015,SLN,COL,3,2,3-2,SLN,9,false,34,36,70,143,155,298,12,9,21,1,3:16
415225,2015-08-02,2015,NYN,WAS,5,2,5-2,NYN,9,true,34,34,68,125,127,252,10,8,18,0,2:42
415212,2015-08-02,2015,HOU,ARI,4,1,4-1,HOU,9,true,37,36,73,124,144,268,13,10,23,0,2:54
415218,2015-08-02,2015,TOR,KCA,5,2,5-2,TOR,9,true,38,33,71,131,157,288,15,7,22,3,3:02
415213,2015-08-02,2015,PHI,ATL,2,6,6-2,ATL,9,false,37,41,78,140,128,268,11,15,26,1,2:48
415221,2015-08-02,2015,MIA,SDN,5,2,5-2,MIA,9,false,35,37,72,167,137,304,11,10,21,2,3:05
415214,2015-08-02,2015,MIL,CHN,3,4,4-3,CHN,9,false,36,38,74,161,155,316,8,13,21,1,3:12
415211,2015-08-02,2015,LAN,ANA,5,3,5-3,LAN,10,false,40,39,79,141,158,299,13,9,22,1,3:19
415215,2015-08-02,2015,OAK,CLE,2,1,2-1,OAK,10,false,39,38,77,142,158,300,11,11,22,3,3:14
415224,2015-08-02,2015,BOS,TBA,3,4,4-3,TBA,9,false,36,40,76,167,158,325,10,13,23,2,3:10
415219,2015-08-02,2015,CHA,NYA,3,12,12-3,NYA,9,false,35,45,80,179,134,313,11,17,28,2,3:09
415222,2015-08-02,2015,MIN,SEA,1,4,4-1,SEA,11,false,39,44,83,169,124,293,6,14,20,3,3:12
415231,2015-08-03,2015,TOR,MIN,5,1,5-1,TOR,9,true,36,32,68,129,143,272,12,5,17,0,2:37
415229,2015-08-03,2015,ANA,CLE,5,4,5-4,ANA,9,true,37,37,74,146,124,270,13,10,23,4,3:02
415227,2015-08-03,2015,OAK,BAL,2,9,9-2,BAL,9,false,34,42,76,176,120,296,8,16,24,2,2:47
415226,2015-08-03,2015,WAS,ARI,4,6,6-4,ARI,9,false,37,36,73,139,122,261,11,11,22,1,2:42
415234,2015-08-03,2015,COL,SEA,7,8,8-7,SEA,9,false,46,40,86,158,155,313,20,15,35,4,3:19
415236,2015-08-03,2015,CHA,TBA,4,5,5-4,TBA,9,false,35,44,79,173,133,306,9,18,27,2,3:07
415233,2015-08-03,2015,MIL,SDN,5,13,13-5,SDN,9,false,39,46,85,158,163,321,13,19,32,1,3:06
415232,2015-08-03,2015,MIA,NYN,1,12,12-1,NYN,9,false,34,49,83,193,113,306,7,22,29,1,3:03
415230,2015-08-03,2015,TEX,HOU,12,9,12-9,TEX,9,true,44,42,86,151,183,334,20,15,35,3,3:19
415235,2015-08-03,2015,ATL,SFN,9,8,9-8,ATL,12,false,52,51,103,182,170,352,21,19,40,3,3:53
415243,2015-08-04,2015,DET,KCA,1,5,5-1,KCA,9,false,34,39,73,132,124,256,9,12,21,0,2:41
415245,2015-08-04,2015,TOR,MIN,3,1,3-1,TOR,9,true,34,32,66,128,142,270,11,5,16,2,2:36
415250,2015-08-04,2015,CIN,SLN,3,2,3-2,CIN,9,true,32,36,68,130,129,259,9,10,19,1,2:24
415238,2015-08-04,2015,OAK,BAL,5,0,5-0,OAK,9,true,35,35,70,139,134,273,14,9,23,1,2:51
415247,2015-08-04,2015,MIL,SDN,4,1,4-1,MIL,9,true,38,35,73,148,139,287,17,7,24,4,3:09
415242,2015-08-04,2015,TEX,HOU,4,3,4-3,TEX,9,true,37,37,74,156,142,298,13,11,24,3,3:19
415239,2015-08-04,2015,NYA,BOS,13,3,13-3,NYA,9,true,43,35,78,143,184,327,18,9,27,6,3:26
415237,2015-08-04,2015,WAS,ARI,5,4,5-4,WAS,9,true,36,36,72,154,168,322,14,8,22,2,3:13 (:30 delay)
415246,2015-08-04,2015,MIA,NYN,1,5,5-1,NYN,9,false,36,41,77,181,134,315,10,14,24,2,3:08
415251,2015-08-04,2015,CHA,TBA,3,11,11-3,TBA,9,false,35,45,80,176,134,310,8,19,27,2,2:53
415240,2015-08-04,2015,PIT,CHN,0,5,5-0,CHN,9,false,31,47,78,188,126,314,7,22,29,2,3:15
415249,2015-08-04,2015,ATL,SFN,3,8,8-3,SFN,9,false,37,42,79,154,161,315,10,17,27,4,3:15
415244,2015-08-04,2015,PHI,LAN,6,2,6-2,PHI,9,true,37,42,79,181,141,322,14,16,30,2,3:31
415241,2015-08-04,2015,ANA,CLE,0,2,2-0,CLE,12,false,39,46,85,174,136,310,4,14,18,1,3:32
415248,2015-08-04,2015,COL,SEA,4,10,10-4,SEA,9,false,38,46,84,161,137,298,13,19,32,3,3:22
415258,2015-08-05,2015,DET,KCA,2,1,2-1,DET,9,true,31,35,66,136,114,250,7,9,16,1,2:38
415254,2015-08-05,2015,NYA,BOS,1,2,2-1,BOS,9,false,34,35,69,165,129,294,8,8,16,0,2:51
415256,2015-08-05,2015,ANA,CLE,4,3,4-3,ANA,9,false,35,35,70,132,163,295,9,10,19,3,2:59
415264,2015-08-05,2015,ATL,SFN,1,6,6-1,SFN,9,false,35,41,76,132,141,273,8,15,23,2,2:52
415257,2015-08-05,2015,TEX,HOU,4,3,4-3,TEX,9,true,34,39,73,178,134,312,9,13,22,3,3:23
415255,2015-08-05,2015,PIT,CHN,7,5,7-5,PIT,9,true,38,37,75,133,151,284,15,11,26,4,3:05
415260,2015-08-05,2015,TOR,MIN,9,7,9-7,TOR,9,true,39,38,77,136,161,297,14,12,26,2,3:06
415262,2015-08-05,2015,MIL,SDN,8,5,8-5,MIL,9,true,36,37,73,148,150,298,13,11,24,2,2:57
415261,2015-08-05,2015,MIA,NYN,6,8,8-6,NYN,9,false,39,41,80,162,137,299,12,15,27,4,3:07
415253,2015-08-05,2015,OAK,BAL,3,7,7-3,BAL,10,false,41,42,83,151,168,319,13,15,28,4,3:33
415259,2015-08-05,2015,PHI,LAN,3,4,4-3,LAN,9,false,36,43,79,192,152,344,8,19,27,0,3:12
415252,2015-08-05,2015,WAS,ARI,4,11,11-4,ARI,9,false,37,50,87,196,158,354,10,23,33,3,3:56
415266,2015-08-05,2015,CHA,TBA,6,5,6-5,CHA,10,false,41,44,85,167,168,335,17,17,34,2,3:20
415265,2015-08-05,2015,CIN,SLN,3,4,4-3,SLN,13,false,53,49,102,199,203,402,14,12,26,3,4:14
415263,2015-08-05,2015,COL,SEA,7,5,7-5,COL,11,false,44,51,95,208,162,370,14,19,33,4,4:06
415268,2015-08-06,2015,NYA,BOS,2,1,2-1,NYA,9,true,33,37,70,149,115,264,10,10,20,0,2:54
415273,2015-08-06,2015,TOR,MIN,9,3,9-3,TOR,9,true,40,34,74,118,155,273,19,7,26,2,2:39
415276,2015-08-06,2015,CIN,SLN,0,3,3-0,SLN,9,false,37,36,73,145,145,290,10,11,21,1,2:59
415274,2015-08-06,2015,MIL,SDN,10,1,10-1,MIL,9,true,42,31,73,129,160,289,18,5,23,0,2:52
415275,2015-08-06,2015,CHN,SFN,5,4,5-4,CHN,9,true,37,35,72,156,156,312,13,8,21,3,3:22
415272,2015-08-06,2015,ATL,MIA,9,8,9-8,ATL,9,true,39,44,83,164,127,291,16,18,34,1,3:18
415267,2015-08-06,2015,WAS,ARI,8,3,8-3,WAS,9,true,43,38,81,136,171,307,18,11,29,2,3:32
415270,2015-08-06,2015,DET,KCA,8,6,8-6,DET,9,false,39,42,81,163,168,331,16,16,32,3,3:26
415271,2015-08-06,2015,PHI,LAN,8,10,10-8,LAN,9,false,41,43,84,173,163,336,14,17,31,2,3:28
415269,2015-08-06,2015,OAK,HOU,4,5,5-4,HOU,10,false,41,41,82,162,168,330,11,11,22,2,3:37
415282,2015-08-07,2015,OAK,HOU,3,1,3-1,OAK,9,true,35,31,66,107,113,220,13,5,18,1,2:20
415280,2015-08-07,2015,ARI,CIN,2,0,2-0,ARI,9,true,29,32,61,104,127,231,7,7,14,0,2:33
415279,2015-08-07,2015,KCA,CHA,3,2,3-2,KCA,9,true,33,36,69,144,129,273,10,10,20,1,3:00
415289,2015-08-07,2015,MIL,SLN,0,6,6-0,SLN,9,false,36,38,74,148,145,293,10,12,22,0,2:50
415290,2015-08-07,2015,SEA,TEX,4,3,4-3,SEA,9,true,34,35,69,145,138,283,12,9,21,2,2:55
415291,2015-08-07,2015,NYA,TOR,1,2,2-1,TOR,10,false,37,41,78,159,135,294,10,11,21,2,3:02
415284,2015-08-07,2015,ATL,MIA,6,3,6-3,ATL,9,true,35,36,71,135,131,266,10,10,20,3,2:53
415277,2015-08-07,2015,ANA,BAL,8,4,8-4,ANA,9,true,40,38,78,130,143,273,17,13,30,4,2:58
415286,2015-08-07,2015,TBA,NYN,3,4,4-3,NYN,9,false,36,37,73,148,152,300,10,9,19,4,3:00
415278,2015-08-07,2015,DET,BOS,2,7,7-2,BOS,9,false,39,43,82,171,157,328,14,17,31,3,3:30
415281,2015-08-07,2015,WAS,COL,4,5,5-4,COL,9,false,39,37,76,151,171,322,13,10,23,1,3:17
415285,2015-08-07,2015,CLE,MIN,9,10,10-9,MIN,9,false,43,44,87,155,159,314,17,18,35,4,3:24
415283,2015-08-07,2015,PIT,LAN,5,4,5-4,PIT,10,false,44,41,85,170,161,331,20,12,32,2,3:42
415287,2015-08-07,2015,SDN,PHI,3,4,4-3,PHI,12,false,51,47,98,192,189,381,16,11,27,2,4:13
415288,2015-08-07,2015,CHN,SFN,7,3,7-3,CHN,9,true,38,35,73,137,153,290,14,11,25,3,3:13
415296,2015-08-08,2015,WAS,COL,6,1,6-1,WAS,9,true,38,30,68,110,144,254,17,3,20,1,2:38
415297,2015-08-08,2015,OAK,HOU,2,1,2-1,OAK,9,true,32,37,69,133,148,281,8,11,19,2,2:51
415304,2015-08-08,2015,MIL,SLN,0,3,3-0,SLN,9,false,32,34,66,138,132,270,7,7,14,0,2:45
415302,2015-08-08,2015,SDN,PHI,2,4,4-2,PHI,9,false,35,34,69,140,133,273,10,9,19,1,2:55
415292,2015-08-08,2015,ANA,BAL,0,5,5-0,BAL,9,false,34,38,72,147,132,279,8,13,21,1,2:55
415306,2015-08-08,2015,NYA,TOR,0,6,6-0,TOR,9,false,33,37,70,157,134,291,6,10,16,1,2:57
415294,2015-08-08,2015,KCA,CHA,7,6,7-6,KCA,9,true,35,39,74,132,122,254,11,14,25,3,2:45
415299,2015-08-08,2015,ATL,MIA,7,2,7-2,ATL,9,true,39,38,77,134,146,280,17,12,29,2,2:51
415293,2015-08-08,2015,DET,BOS,7,6,7-6,DET,9,true,37,41,78,164,142,306,14,14,28,1,3:11
415301,2015-08-08,2015,TBA,NYN,5,4,5-4,TBA,9,true,37,38,75,143,153,296,14,10,24,0,3:03
415295,2015-08-08,2015,ARI,CIN,1,4,4-1,CIN,9,false,36,36,72,141,143,284,9,9,18,0,2:58
415298,2015-08-08,2015,PIT,LAN,6,5,6-5,PIT,9,true,34,43,77,167,145,312,12,18,30,0,3:42
415303,2015-08-08,2015,CHN,SFN,8,6,8-6,CHN,9,true,39,39,78,142,161,303,19,12,31,5,3:14
415300,2015-08-08,2015,CLE,MIN,17,4,17-4,CLE,9,true,51,36,87,143,214,357,27,12,39,6,3:34
415305,2015-08-08,2015,SEA,TEX,3,11,11-3,TEX,11,false,45,50,95,200,192,392,14,22,36,1,4:11
415315,2015-08-09,2015,CLE,MIN,8,1,8-1,CLE,9,true,39,30,69,100,146,246,16,4,20,0,2:37
415319,2015-08-09,2015,MIL,SLN,5,4,5-4,MIL,9,true,31,35,66,118,100,218,11,8,19,2,2:31
415320,2015-08-09,2015,SEA,TEX,4,2,4-2,SEA,9,true,30,39,69,146,104,250,6,12,18,0,2:34
415316,2015-08-09,2015,TBA,NYN,4,3,4-3,TBA,9,true,33,37,70,153,100,253,10,11,21,1,2:38
415321,2015-08-09,2015,NYA,TOR,0,2,2-0,TOR,9,false,34,35,69,153,123,276,8,9,17,4,2:59
415309,2015-08-09,2015,KCA,CHA,5,4,5-4,KCA,9,true,37,35,72,147,134,281,14,9,23,2,3:01
415318,2015-08-09,2015,CHN,SFN,2,0,2-0,CHN,9,true,30,38,68,155,132,287,6,11,17,1,3:13
415308,2015-08-09,2015,DET,BOS,2,7,7-2,BOS,9,false,36,42,78,174,139,313,10,16,26,4,3:22
415317,2015-08-09,2015,SDN,PHI,3,5,5-3,PHI,9,false,37,40,77,142,149,291,9,14,23,2,2:56
415311,2015-08-09,2015,WAS,COL,4,6,6-4,COL,9,false,42,40,82,132,157,289,13,14,27,3,3:24
415312,2015-08-09,2015,OAK,HOU,5,4,5-4,OAK,9,false,40,36,76,161,148,309,18,10,28,5,3:35
415310,2015-08-09,2015,ARI,CIN,4,3,4-3,ARI,10,false,43,39,82,150,155,305,19,10,29,3,3:21
415313,2015-08-09,2015,PIT,LAN,13,6,13-6,PIT,9,true,48,42,90,141,175,316,24,19,43,1,3:39
415307,2015-08-09,2015,ANA,BAL,5,4,5-4,ANA,11,false,50,42,92,164,223,387,21,11,32,2,4:03
415314,2015-08-09,2015,ATL,MIA,1,4,4-1,MIA,9,false,33,42,75,172,122,294,6,15,21,2,3:15
415326,2015-08-10,2015,KCA,DET,4,0,4-0,KCA,9,true,35,31,66,116,146,262,14,4,18,2,2:43
415322,2015-08-10,2015,CHA,ANA,8,2,8-2,CHA,9,true,37,35,72,124,132,256,14,9,23,2,2:45
415323,2015-08-10,2015,SEA,BAL,2,3,3-2,BAL,9,false,34,34,68,143,147,290,7,8,15,1,2:36
415324,2015-08-10,2015,SDN,CIN,2,1,2-1,SDN,9,true,34,38,72,158,135,293,11,11,22,1,2:56
415328,2015-08-10,2015,LAN,WAS,3,8,8-3,WAS,9,false,38,41,79,157,143,300,10,16,26,1,2:45
415327,2015-08-10,2015,ARI,PHI,13,3,13-3,ARI,9,true,44,37,81,126,168,294,22,10,32,2,3:01
415325,2015-08-10,2015,NYN,COL,4,2,4-2,NYN,9,true,34,32,66,116,122,238,9,6,15,1,2:28
415330,2015-08-11,2015,TBA,ATL,2,0,2-0,TBA,9,true,30,31,61,90,92,182,8,6,14,2,2:02
415336,2015-08-11,2015,SFN,HOU,3,1,3-1,SFN,9,true,35,31,66,105,141,246,12,5,17,2,2:36
415339,2015-08-11,2015,TOR,OAK,4,2,4-2,TOR,9,true,33,34,67,109,142,251,7,8,15,2,2:35
415341,2015-08-11,2015,SLN,PIT,4,3,4-3,SLN,9,true,39,35,74,125,129,254,14,10,24,0,2:40
415329,2015-08-11,2015,CHA,ANA,3,0,3-0,CHA,9,true,30,34,64,142,134,276,7,7,14,2,2:38
415340,2015-08-11,2015,ARI,PHI,13,1,13-1,ARI,9,true,44,35,79,116,143,259,20,9,29,1,2:43
415334,2015-08-11,2015,NYN,COL,4,0,4-0,NYN,9,true,38,31,69,110,143,253,16,5,21,1,2:47
415343,2015-08-11,2015,LAN,WAS,5,0,5-0,LAN,9,true,35,35,70,150,133,283,12,8,20,1,2:58
415342,2015-08-11,2015,MIN,TEX,3,2,3-2,MIN,9,false,36,36,72,144,176,320,11,10,21,4,3:19
415335,2015-08-11,2015,KCA,DET,6,1,6-1,KCA,9,true,35,37,72,139,152,291,11,11,22,2,3:01
415333,2015-08-11,2015,SDN,CIN,11,6,11-6,SDN,9,true,41,38,79,139,153,292,16,13,29,2,2:44
415337,2015-08-11,2015,CHN,MIL,6,3,6-3,CHN,9,true,41,35,76,132,186,318,17,8,25,4,3:10
415331,2015-08-11,2015,SEA,BAL,6,5,6-5,SEA,10,false,46,40,86,149,191,340,18,10,28,5,3:29
415332,2015-08-11,2015,MIA,BOS,5,4,5-4,MIA,10,false,49,38,87,148,191,339,22,10,32,4,3:30
415338,2015-08-11,2015,CLE,NYA,5,4,5-4,CLE,16,false,66,57,123,212,259,471,22,11,33,1,5:04
415358,2015-08-12,2015,LAN,WAS,3,0,3-0,LAN,9,true,30,30,60,109,121,230,7,3,10,1,2:20
415349,2015-08-12,2015,NYN,COL,3,0,3-0,NYN,9,true,32,34,66,128,131,259,9,7,16,0,2:35
415353,2015-08-12,2015,CLE,NYA,2,1,2-1,CLE,9,true,35,34,69,134,149,283,13,9,22,1,2:54
415352,2015-08-12,2015,CHN,MIL,3,2,3-2,CHN,10,false,34,37,71,118,128,246,7,7,14,2,2:55
415355,2015-08-12,2015,ARI,PHI,6,7,7-6,PHI,9,false,43,39,82,130,141,271,17,13,30,4,3:34
415356,2015-08-12,2015,SLN,PIT,4,2,4-2,SLN,9,true,35,38,73,144,139,283,11,13,24,1,2:49
415354,2015-08-12,2015,TOR,OAK,10,3,10-3,TOR,9,true,38,35,73,135,153,288,15,11,26,1,2:39
415350,2015-08-12,2015,KCA,DET,4,7,7-4,DET,9,false,37,41,78,130,141,271,11,14,25,3,3:09
415357,2015-08-12,2015,MIN,TEX,11,1,11-1,MIN,9,true,45,32,77,133,183,316,20,6,26,2,2:53
415345,2015-08-12,2015,TBA,ATL,9,6,9-6,TBA,9,true,40,37,77,158,157,315,16,12,28,3,3:12
415346,2015-08-12,2015,SEA,BAL,3,0,3-0,SEA,9,true,32,29,61,116,126,242,8,3,11,0,2:29
415351,2015-08-12,2015,SFN,HOU,0,2,2-0,HOU,9,false,32,35,67,147,119,266,6,11,17,5,2:54
415348,2015-08-12,2015,SDN,CIN,3,7,7-3,CIN,9,false,32,41,73,154,143,297,8,16,24,2,2:58
415344,2015-08-12,2015,CHA,ANA,3,2,3-2,CHA,13,false,50,55,105,201,187,388,16,18,34,4,4:44
415347,2015-08-12,2015,MIA,BOS,14,6,14-6,MIA,9,true,43,40,83,185,159,344,19,17,36,3,3:07
415364,2015-08-13,2015,TOR,OAK,4,2,4-2,TOR,9,true,29,35,64,120,124,244,6,10,16,2,2:25
415367,2015-08-13,2015,SFN,WAS,3,1,3-1,SFN,9,true,34,36,70,137,133,270,11,9,20,1,2:51
415366,2015-08-13,2015,MIN,TEX,5,6,6-5,TEX,9,false,38,38,76,132,144,276,12,13,25,3,2:59
415361,2015-08-13,2015,NYN,COL,12,3,12-3,NYN,9,true,39,32,71,120,166,286,15,8,23,2,2:55
415362,2015-08-13,2015,CHN,MIL,9,2,9-2,CHN,9,true,39,38,77,141,171,312,16,11,27,3,3:09
415365,2015-08-13,2015,SLN,PIT,5,10,10-5,PIT,9,false,39,43,82,163,147,310,14,18,32,2,3:06
415360,2015-08-13,2015,LAN,CIN,3,10,10-3,CIN,9,false,40,43,83,171,159,330,14,18,32,3,3:32
415359,2015-08-13,2015,KCA,ANA,6,7,7-6,ANA,9,false,43,42,85,183,164,347,16,14,30,2,3:45
415363,2015-08-13,2015,CLE,NYA,6,8,8-6,NYA,9,false,42,43,85,173,170,343,16,16,32,5,3:35
415377,2015-08-14,2015,MIL,PHI,3,1,3-1,MIL,9,true,28,38,66,125,107,232,4,12,16,0,2:30
415372,2015-08-14,2015,MIN,CLE,1,6,6-1,CLE,9,false,28,40,68,134,98,232,2,15,17,1,2:26
415374,2015-08-14,2015,SLN,MIA,3,1,3-1,SLN,9,true,32,34,66,108,114,222,8,9,17,1,2:24
415371,2015-08-14,2015,LAN,CIN,5,3,5-3,LAN,9,true,36,33,69,110,144,254,15,8,23,1,2:39
415373,2015-08-14,2015,HOU,DET,5,1,5-1,HOU,9,true,35,34,69,126,153,279,12,7,19,1,3:10
415369,2015-08-14,2015,ATL,ARI,3,2,3-2,ATL,9,true,35,33,68,145,140,285,15,7,22,1,2:59
415368,2015-08-14,2015,KCA,ANA,4,1,4-1,KCA,9,true,37,38,75,142,138,280,12,12,24,2,3:00
415382,2015-08-14,2015,SFN,WAS,8,5,8-5,SFN,9,true,39,39,78,128,135,263,16,10,26,6,3:01
415375,2015-08-14,2015,TOR,NYA,3,4,4-3,NYA,9,false,37,39,76,131,140,271,10,13,23,1,3:14
415379,2015-08-14,2015,COL,SDN,5,9,9-5,SDN,9,false,41,40,81,139,158,297,14,16,30,3,3:10
415378,2015-08-14,2015,NYN,PIT,2,3,3-2,PIT,10,false,40,41,81,149,148,297,11,14,25,2,3:20
415370,2015-08-14,2015,CHA,CHN,5,6,6-5,CHN,9,false,41,38,79,150,174,324,15,12,27,2,3:20
415381,2015-08-14,2015,TEX,TBA,5,3,5-3,TEX,9,true,34,37,71,130,130,260,12,14,26,2,2:55
415380,2015-08-14,2015,BOS,SEA,15,1,15-1,BOS,9,true,47,36,83,160,181,341,23,9,32,2,3:30
415376,2015-08-14,2015,BAL,OAK,8,6,8-6,BAL,13,false,55,58,113,216,201,417,19,22,41,3,4:27 (:10 delay)
415387,2015-08-15,2015,MIN,CLE,4,1,4-1,MIN,9,true,31,35,66,135,109,244,7,9,16,1,2:27
415389,2015-08-15,2015,SLN,MIA,6,2,6-2,SLN,9,true,35,36,71,123,130,253,14,10,24,1,2:35
415392,2015-08-15,2015,MIL,PHI,4,2,4-2,MIL,9,true,35,38,73,132,116,248,12,11,23,2,2:58
415386,2015-08-15,2015,LAN,CIN,8,3,8-3,LAN,9,true,38,35,73,133,149,282,17,9,26,1,2:48
415390,2015-08-15,2015,TOR,NYA,1,4,4-1,NYA,9,false,35,40,75,166,112,278,8,13,21,1,2:57
415383,2015-08-15,2015,KCA,ANA,9,4,9-4,KCA,9,true,43,36,79,131,153,284,19,12,31,2,2:55
415391,2015-08-15,2015,BAL,OAK,4,3,4-3,BAL,9,false,31,34,65,128,117,245,8,10,18,0,2:25
415394,2015-08-15,2015,COL,SDN,5,7,7-5,SDN,9,false,36,40,76,150,138,288,12,14,26,2,3:13
415397,2015-08-15,2015,SFN,WAS,12,6,12-6,SFN,9,true,42,39,81,123,159,282,18,13,31,2,3:04
415396,2015-08-15,2015,TEX,TBA,12,4,12-4,TEX,9,true,42,39,81,168,148,316,18,13,31,2,3:10
415385,2015-08-15,2015,CHA,CHN,3,6,6-3,CHN,9,false,38,41,79,190,141,331,10,16,26,3,3:35
415384,2015-08-15,2015,ATL,ARI,4,8,8-4,ARI,9,false,38,42,80,152,140,292,10,16,26,4,3:00
415388,2015-08-15,2015,HOU,DET,2,4,4-2,DET,11,false,41,45,86,152,169,321,10,13,23,2,3:43
415395,2015-08-15,2015,BOS,SEA,22,10,22-10,BOS,9,true,57,43,100,190,170,360,33,17,50,5,3:21
415393,2015-08-15,2015,NYN,PIT,3,5,5-3,PIT,14,false,52,54,106,187,190,377,11,15,26,1,4:02
415412,2015-08-16,2015,SFN,WAS,5,0,5-0,SFN,9,true,32,31,63,112,104,216,9,4,13,1,2:17
415409,2015-08-16,2015,COL,SDN,5,0,5-0,COL,9,true,31,32,63,106,113,219,9,6,15,1,2:31
415401,2015-08-16,2015,LAN,CIN,2,1,2-1,LAN,9,true,31,34,65,146,113,259,9,8,17,2,2:41
415405,2015-08-16,2015,TOR,NYA,3,1,3-1,TOR,9,true,33,31,64,123,144,267,11,6,17,2,2:41
415399,2015-08-16,2015,ATL,ARI,2,1,2-1,ATL,10,false,38,36,74,148,138,286,14,7,21,3,3:13
415400,2015-08-16,2015,CHA,CHN,3,1,3-1,CHA,9,true,35,34,69,146,146,292,11,6,17,3,2:46
415407,2015-08-16,2015,MIL,PHI,6,1,6-1,MIL,9,true,36,37,73,140,135,275,11,10,21,5,3:07
415404,2015-08-16,2015,SLN,MIA,4,6,6-4,MIA,9,false,35,38,73,135,148,283,8,11,19,4,3:13
415398,2015-08-16,2015,KCA,ANA,4,3,4-3,KCA,10,false,41,37,78,148,151,299,14,7,21,0,3:12
415411,2015-08-16,2015,TEX,TBA,5,3,5-3,TEX,9,true,36,39,75,145,159,304,12,13,25,1,3:04
415408,2015-08-16,2015,NYN,PIT,1,8,8-1,PIT,9,false,35,46,81,180,154,334,8,21,29,3,3:23 (:42 delay)
415402,2015-08-16,2015,MIN,CLE,4,1,4-1,MIN,9,true,35,36,71,131,123,254,12,9,21,2,2:48
415403,2015-08-16,2015,HOU,DET,6,5,6-5,HOU,9,false,37,40,77,161,145,306,13,12,25,4,3:25
415410,2015-08-16,2015,BOS,SEA,8,10,10-8,SEA,12,false,54,58,112,197,225,422,22,22,44,5,4:24
415406,2015-08-16,2015,BAL,OAK,18,2,18-2,BAL,9,true,51,37,88,152,169,321,29,10,39,3,3:09
415415,2015-08-17,2015,ANA,CHA,2,1,2-1,ANA,9,true,29,36,65,142,104,246,7,10,17,0,2:32
415414,2015-08-17,2015,SDN,ATL,5,3,5-3,SDN,9,true,33,35,68,149,132,281,13,9,22,2,2:58
415421,2015-08-17,2015,SLN,SFN,2,1,2-1,SLN,9,true,35,34,69,119,148,267,13,8,21,2,2:40
415417,2015-08-17,2015,MIL,MIA,2,6,6-2,MIA,9,false,38,40,78,138,138,276,11,13,24,1,2:51
415413,2015-08-17,2015,PIT,ARI,1,4,4-1,ARI,9,false,37,34,71,134,161,295,10,10,20,3,3:27
415420,2015-08-17,2015,TEX,SEA,4,3,4-3,TEX,9,false,40,36,76,126,135,261,17,12,29,1,2:51
415416,2015-08-17,2015,BOS,CLE,2,8,8-2,CLE,9,false,35,40,75,159,146,305,9,13,22,1,3:12
415422,2015-08-17,2015,HOU,TBA,2,9,9-2,TBA,9,false,38,46,84,180,156,336,10,19,29,2,3:23
415418,2015-08-17,2015,NYA,MIN,8,7,8-7,NYA,10,false,43,46,89,186,179,365,16,18,34,5,4:13
415419,2015-08-17,2015,BAL,OAK,4,2,4-2,BAL,9,true,36,33,69,122,124,246,9,7,16,2,2:35
415425,2015-08-18,2015,ANA,CHA,5,3,5-3,ANA,9,true,32,32,64,128,119,247,7,8,15,1,2:29
415433,2015-08-18,2015,TEX,SEA,2,3,3-2,SEA,9,false,32,36,68,153,124,277,6,9,15,1,2:44
415424,2015-08-18,2015,SDN,ATL,9,0,9-0,SDN,9,true,40,36,76,151,158,309,19,11,30,2,3:14
415435,2015-08-18,2015,HOU,TBA,3,2,3-2,HOU,10,false,38,40,78,137,161,298,14,11,25,1,3:14
415434,2015-08-18,2015,SLN,SFN,0,2,2-0,SFN,9,false,31,40,71,157,146,303,4,15,19,3,3:09 (:31 delay)
415432,2015-08-18,2015,BAL,NYN,3,5,5-3,NYN,9,false,37,40,77,168,136,304,10,12,22,3,2:59 (:46 delay)
415431,2015-08-18,2015,NYA,MIN,8,4,8-4,NYA,9,true,39,35,74,135,166,301,15,10,25,5,3:16
415436,2015-08-18,2015,PHI,TOR,5,8,8-5,TOR,9,false,37,45,82,166,145,311,14,16,30,2,3:10
415427,2015-08-18,2015,CHN,DET,8,10,10-8,DET,9,false,41,48,89,174,147,321,16,23,39,5,3:36 (2:17 delay)
415429,2015-08-18,2015,OAK,LAN,5,4,5-4,OAK,10,false,42,45,87,179,158,337,14,16,30,4,3:45
415437,2015-08-18,2015,COL,WAS,6,15,15-6,WAS,9,false,42,52,94,203,150,353,15,26,41,3,3:45
415430,2015-08-18,2015,MIL,MIA,6,9,9-6,MIA,9,false,43,45,88,179,173,352,16,18,34,4,3:38
415428,2015-08-18,2015,CIN,KCA,1,3,3-1,KCA,13,false,49,51,100,219,220,439,12,17,29,1,4:39
415423,2015-08-18,2015,PIT,ARI,9,8,9-8,PIT,15,false,63,64,127,222,243,465,22,21,43,3,5:11
415426,2015-08-18,2015,BOS,CLE,9,1,9-1,BOS,9,true,42,32,74,121,156,277,19,6,25,3,2:56
415440,2015-08-19,2015,ANA,CHA,1,0,1-0,ANA,9,true,34,33,67,128,128,256,10,8,18,1,2:56
415446,2015-08-19,2015,NYA,MIN,4,3,4-3,NYA,9,true,32,34,66,159,112,271,10,7,17,1,2:34
415444,2015-08-19,2015,OAK,LAN,5,2,5-2,OAK,9,true,33,31,64,130,118,248,12,4,16,3,2:34
415451,2015-08-19,2015,PHI,TOR,7,4,7-4,PHI,9,true,37,34,71,116,124,240,13,7,20,0,2:24
415449,2015-08-19,2015,SLN,SFN,4,3,4-3,SLN,9,true,35,36,71,125,127,252,11,11,22,4,2:54
415439,2015-08-19,2015,SDN,ATL,3,2,3-2,SDN,9,true,34,36,70,137,135,272,11,12,23,1,2:43
415452,2015-08-19,2015,COL,WAS,1,4,4-1,WAS,9,false,29,43,72,173,109,282,2,19,21,0,2:57
415438,2015-08-19,2015,PIT,ARI,4,1,4-1,PIT,9,true,35,33,68,128,134,262,15,7,22,1,2:51
415448,2015-08-19,2015,TEX,SEA,7,2,7-2,TEX,9,true,40,34,74,131,147,278,17,9,26,2,2:39
415441,2015-08-19,2015,BOS,CLE,6,4,6-4,BOS,9,true,33,37,70,169,115,284,9,12,21,2,3:09
415447,2015-08-19,2015,BAL,NYN,5,4,5-4,BAL,9,false,35,37,72,157,140,297,12,13,25,3,3:01
415445,2015-08-19,2015,MIL,MIA,8,7,8-7,MIL,9,true,43,42,85,158,140,298,19,16,35,4,3:11
415443,2015-08-19,2015,CIN,KCA,3,4,4-3,KCA,9,false,39,41,80,178,180,358,14,16,30,2,3:38 (1:37 delay)
415442,2015-08-19,2015,CHN,DET,8,15,15-8,DET,9,false,42,52,94,179,175,354,15,25,40,5,3:48
415450,2015-08-19,2015,HOU,TBA,3,2,3-2,HOU,13,false,48,48,96,181,177,358,13,11,24,3,4:04
415461,2015-08-20,2015,HOU,TBA,0,1,1-0,TBA,9,false,28,36,64,142,98,240,2,10,12,0,2:32
415462,2015-08-20,2015,DET,TEX,4,0,4-0,DET,9,true,35,31,66,116,144,260,13,3,16,0,2:47
415463,2015-08-20,2015,COL,WAS,3,2,3-2,COL,9,true,36,34,70,132,129,261,14,8,22,2,2:47
415460,2015-08-20,2015,PIT,SFN,4,0,4-0,PIT,9,true,34,37,71,127,127,254,11,11,22,1,2:51
415457,2015-08-20,2015,BOS,KCA,4,1,4-1,BOS,9,true,35,34,69,142,146,288,12,7,19,2,2:49
415456,2015-08-20,2015,NYA,CLE,2,3,3-2,CLE,9,false,35,36,71,157,143,300,8,11,19,0,3:07
415458,2015-08-20,2015,BAL,MIN,2,15,15-2,MIN,9,false,37,48,85,183,120,303,12,22,34,1,2:51 (2:31 delay)
415454,2015-08-20,2015,CHN,ATL,7,1,7-1,CHN,9,true,36,37,73,160,145,305,13,10,23,2,2:59
415453,2015-08-20,2015,CIN,ARI,4,5,5-4,ARI,9,false,36,42,78,180,147,327,11,15,26,1,3:21
415455,2015-08-20,2015,ANA,CHA,2,8,8-2,CHA,9,false,36,41,77,164,135,299,11,16,27,3,3:21
415459,2015-08-20,2015,MIA,PHI,9,7,9-7,MIA,9,true,40,42,82,184,169,353,18,16,34,3,3:33
415477,2015-08-21,2015,DET,TEX,0,2,2-0,TEX,9,false,33,32,65,142,122,264,9,7,16,3,3:08
415468,2015-08-21,2015,BOS,KCA,7,2,7-2,BOS,9,true,38,31,69,120,131,251,14,5,19,0,2:31
415469,2015-08-21,2015,HOU,LAN,3,0,3-0,HOU,9,true,30,30,60,134,118,252,7,3,10,0,2:31
415473,2015-08-21,2015,MIA,PHI,1,7,7-1,PHI,9,false,34,41,75,149,115,264,9,15,24,0,2:36
415465,2015-08-21,2015,CHN,ATL,5,3,5-3,CHN,9,true,36,39,75,144,121,265,12,10,22,4,2:53
415476,2015-08-21,2015,OAK,TBA,1,2,2-1,TBA,9,false,37,36,73,123,156,279,9,11,20,2,2:52
415471,2015-08-21,2015,BAL,MIN,3,4,4-3,MIN,9,false,32,42,74,175,128,303,6,15,21,2,3:06
415464,2015-08-21,2015,CIN,ARI,3,6,6-3,ARI,9,false,37,42,79,150,124,274,10,16,26,1,3:02
415478,2015-08-21,2015,ANA,TOR,2,9,9-2,TOR,9,false,34,45,79,176,124,300,7,16,23,3,3:07
415474,2015-08-21,2015,PIT,SFN,4,6,6-4,SFN,9,false,38,42,80,151,148,299,13,17,30,2,3:12
415466,2015-08-21,2015,SEA,CHA,4,11,11-4,CHA,9,false,33,46,79,187,132,319,6,21,27,2,3:06
415475,2015-08-21,2015,SDN,SLN,9,3,9-3,SDN,9,true,40,39,79,176,140,316,16,12,28,3,3:07
415467,2015-08-21,2015,NYA,CLE,3,7,7-3,CLE,9,false,38,42,80,170,151,321,10,15,25,4,3:39
415470,2015-08-21,2015,WAS,MIL,3,10,10-3,MIL,9,false,36,44,80,173,157,330,10,17,27,3,3:24
415472,2015-08-21,2015,COL,NYN,9,14,14-9,NYN,9,false,42,48,90,176,149,325,16,21,37,2,3:34
415484,2015-08-22,2015,HOU,LAN,3,1,3-1,HOU,9,true,27,34,61,131,107,238,3,8,11,0,2:28
415489,2015-08-22,2015,PIT,SFN,3,2,3-2,PIT,9,false,29,35,64,136,112,248,5,8,13,0,2:34
415491,2015-08-22,2015,OAK,TBA,4,5,5-4,TBA,9,false,36,35,71,132,115,247,10,10,20,1,2:37
415485,2015-08-22,2015,WAS,MIL,6,1,6-1,WAS,9,true,36,34,70,107,143,250,14,8,22,1,2:44
415488,2015-08-22,2015,MIA,PHI,2,4,4-2,PHI,9,false,35,38,73,135,147,282,9,12,21,3,2:50
415486,2015-08-22,2015,BAL,MIN,2,3,3-2,MIN,9,false,38,38,76,149,139,288,12,12,24,4,3:01
415482,2015-08-22,2015,NYA,CLE,6,2,6-2,NYA,9,true,37,36,73,146,150,296,13,10,23,1,2:52
415492,2015-08-22,2015,DET,TEX,3,5,5-3,TEX,9,false,38,36,74,143,143,286,12,10,22,2,2:55
415490,2015-08-22,2015,SDN,SLN,8,0,8-0,SDN,9,true,40,37,77,151,142,293,15,10,25,6,3:11
415493,2015-08-22,2015,ANA,TOR,3,15,15-3,TOR,9,false,34,49,83,197,127,324,7,24,31,2,3:16
415480,2015-08-22,2015,CHN,ATL,9,7,9-7,CHN,9,true,37,39,76,132,132,264,13,11,24,4,2:42
415483,2015-08-22,2015,BOS,KCA,3,6,6-3,KCA,9,false,41,41,82,169,181,350,14,15,29,3,3:29
415481,2015-08-22,2015,SEA,CHA,3,6,6-3,CHA,10,false,42,45,87,172,166,338,13,16,29,2,3:23
415487,2015-08-22,2015,COL,NYN,9,14,14-9,NYN,9,false,43,50,93,175,159,334,16,25,41,4,3:27
415479,2015-08-22,2015,CIN,ARI,7,11,11-7,ARI,9,false,45,43,88,156,186,342,18,16,34,3,3:41
415502,2015-08-23,2015,COL,NYN,1,5,5-1,NYN,9,false,32,39,71,141,113,254,7,13,20,0,2:42
415503,2015-08-23,2015,MIA,PHI,0,2,2-0,PHI,9,false,30,37,67,162,109,271,5,12,17,1,2:40
415494,2015-08-23,2015,CIN,ARI,0,4,4-0,ARI,9,false,32,38,70,143,124,267,8,11,19,1,2:53
415507,2015-08-23,2015,DET,TEX,2,4,4-2,TEX,9,false,38,37,75,150,135,285,11,13,24,1,3:01
415499,2015-08-23,2015,HOU,LAN,3,2,3-2,HOU,10,false,36,38,74,133,141,274,10,11,21,1,3:16
415500,2015-08-23,2015,WAS,MIL,9,5,9-5,WAS,9,true,39,38,77,164,148,312,17,13,30,2,3:03
415506,2015-08-23,2015,OAK,TBA,8,2,8-2,OAK,9,true,36,36,72,144,143,287,13,11,24,3,2:58
415498,2015-08-23,2015,BOS,KCA,6,8,8-6,KCA,9,false,38,42,80,169,139,308,12,16,28,4,3:40
415508,2015-08-23,2015,ANA,TOR,5,12,12-5,TOR,9,false,37,48,85,177,128,305,14,21,35,1,3:03
415495,2015-08-23,2015,CHN,ATL,9,3,9-3,CHN,9,true,44,38,82,142,190,332,19,11,30,2,2:57
415504,2015-08-23,2015,PIT,SFN,5,2,5-2,PIT,9,true,39,40,79,167,143,310,16,12,28,2,3:32
415497,2015-08-23,2015,NYA,CLE,3,4,4-3,CLE,9,false,38,42,80,173,156,329,11,20,31,6,3:37
415505,2015-08-23,2015,SDN,SLN,3,10,10-3,SLN,9,false,41,43,84,199,170,369,14,17,31,2,3:29
415501,2015-08-23,2015,BAL,MIN,3,4,4-3,MIN,12,false,51,46,97,190,214,404,16,7,23,3,4:24
415496,2015-08-23,2015,SEA,CHA,8,6,8-6,SEA,9,true,39,35,74,132,132,264,17,9,26,4,2:48
414602,2015-08-24,2015,CHN,CLE,2,1,2-1,CHN,9,false,32,32,64,103,140,243,6,9,15,2,2:38
414647,2015-08-24,2015,CIN,DET,12,5,12-5,CIN,9,true,41,42,83,179,169,348,18,17,35,3,3:23
415512,2015-08-24,2015,NYA,HOU,1,0,1-0,NYA,9,false,32,35,67,126,126,252,10,8,18,1,2:47
415511,2015-08-24,2015,ATL,COL,5,3,5-3,ATL,9,true,38,33,71,124,127,251,15,7,22,3,2:43
415510,2015-08-24,2015,CHA,BOS,4,5,5-4,BOS,9,false,34,41,75,159,121,280,9,16,25,3,3:10
415514,2015-08-24,2015,SEA,OAK,5,11,11-5,OAK,9,false,35,43,78,154,137,291,10,17,27,1,3:09
414647,2015-08-24,2015,CIN,DET,12,5,12-5,CIN,9,true,41,42,83,179,169,348,18,17,35,3,3:23
415513,2015-08-24,2015,PHI,NYN,7,16,16-7,NYN,9,false,43,50,93,181,177,358,16,23,39,2,3:33
415509,2015-08-24,2015,KCA,BAL,8,3,8-3,KCA,9,true,39,30,69,99,119,218,15,5,20,1,2:18
414602,2015-08-24,2015,CHN,CLE,2,1,2-1,CHN,9,false,32,32,64,103,140,243,6,9,15,2,2:38
415516,2015-08-24,2015,ARI,SLN,3,5,5-3,SLN,9,false,41,41,82,151,161,312,17,13,30,2,3:19
415515,2015-08-24,2015,MIA,PIT,2,5,5-2,PIT,9,false,35,45,80,179,132,311,10,19,29,3,3:21
415528,2015-08-25,2015,MIA,PIT,5,2,5-2,MIA,9,true,33,36,69,123,128,251,11,11,22,2,2:48
415524,2015-08-25,2015,CLE,MIL,11,6,11-6,CLE,9,true,41,34,75,127,156,283,17,7,24,2,2:54
415519,2015-08-25,2015,CHA,BOS,5,4,5-4,CHA,9,true,37,34,71,149,125,274,16,8,24,2,3:00
415517,2015-08-25,2015,DET,ANA,7,8,8-7,ANA,9,false,44,41,85,155,156,311,16,17,33,5,3:27
415521,2015-08-25,2015,ATL,COL,1,5,5-1,COL,9,false,38,41,79,147,158,305,13,12,25,2,3:08
415522,2015-08-25,2015,NYA,HOU,1,15,15-1,HOU,9,false,32,51,83,187,121,308,5,23,28,1,3:05
415523,2015-08-25,2015,CIN,LAN,1,5,5-1,LAN,9,false,36,38,74,163,149,312,12,11,23,3,3:04
415527,2015-08-25,2015,SEA,OAK,6,5,6-5,SEA,9,true,39,44,83,153,124,277,16,18,34,3,3:05
415531,2015-08-25,2015,TEX,TOR,5,6,6-5,TOR,9,false,40,39,79,150,152,302,14,13,27,3,3:02
415530,2015-08-25,2015,ARI,SLN,1,9,9-1,SLN,9,false,34,47,81,184,137,321,8,19,27,1,3:10
415520,2015-08-25,2015,SFN,CHN,5,8,8-5,CHN,9,false,40,39,79,140,175,315,12,14,26,3,3:08
415518,2015-08-25,2015,KCA,BAL,3,2,3-2,KCA,9,true,34,37,71,135,147,282,12,10,22,5,2:57
415529,2015-08-25,2015,WAS,SDN,8,3,8-3,WAS,9,true,42,33,75,145,169,314,18,8,26,3,3:08
415526,2015-08-25,2015,PHI,NYN,5,6,6-5,NYN,9,false,38,40,78,162,175,337,10,13,23,4,3:31
415525,2015-08-25,2015,TBA,MIN,7,11,11-7,MIN,9,false,46,43,89,167,164,331,20,17,37,2,3:24
415532,2015-08-26,2015,DET,ANA,5,0,5-0,DET,9,true,37,28,65,112,165,277,14,3,17,1,2:48
415543,2015-08-26,2015,MIA,PIT,2,7,7-2,PIT,9,false,32,41,73,152,122,274,6,14,20,1,2:31
415533,2015-08-26,2015,KCA,BAL,5,8,8-5,BAL,9,false,38,39,77,148,134,282,14,14,28,3,2:47
415540,2015-08-26,2015,TBA,MIN,3,5,5-3,MIN,9,false,39,42,81,152,137,289,14,14,28,4,3:21
415542,2015-08-26,2015,SEA,OAK,8,2,8-2,SEA,9,true,42,34,76,126,178,304,18,7,25,2,3:00
415544,2015-08-26,2015,WAS,SDN,5,6,6-5,SDN,9,false,38,38,76,145,152,297,12,12,24,3,3:07
415541,2015-08-26,2015,PHI,NYN,4,9,9-4,NYN,9,false,40,42,82,148,159,307,13,14,27,4,3:16
415537,2015-08-26,2015,NYA,HOU,2,6,6-2,HOU,9,false,36,39,75,172,155,327,9,14,23,3,3:26
415546,2015-08-26,2015,TEX,TOR,4,12,12-4,TOR,9,false,38,47,85,186,144,330,12,21,33,3,3:19
415536,2015-08-26,2015,ATL,COL,3,6,6-3,COL,9,false,43,41,84,146,182,328,20,17,37,3,3:18
415539,2015-08-26,2015,CLE,MIL,6,2,6-2,CLE,9,true,41,37,78,167,169,336,19,10,29,3,3:39
415535,2015-08-26,2015,SFN,CHN,4,2,4-2,SFN,9,true,33,34,67,122,119,241,9,9,18,3,2:39
415534,2015-08-26,2015,CHA,BOS,0,3,3-0,BOS,9,false,33,37,70,150,120,270,6,11,17,0,2:31
415545,2015-08-26,2015,ARI,SLN,1,3,3-1,SLN,9,false,33,36,69,131,117,248,9,9,18,1,2:35
415538,2015-08-26,2015,CIN,LAN,4,7,7-4,LAN,9,false,38,41,79,170,146,316,11,14,25,5,3:16
415547,2015-08-27,2015,DET,ANA,0,2,2-0,ANA,9,false,28,34,62,128,119,247,3,10,13,1,2:39
415553,2015-08-27,2015,MIA,PIT,1,2,2-1,PIT,9,false,32,36,68,135,118,253,6,13,19,1,2:46
415548,2015-08-27,2015,KCA,BAL,5,3,5-3,KCA,9,true,36,38,74,147,123,270,13,10,23,0,2:46 (1:35 delay)
415550,2015-08-27,2015,CIN,LAN,0,1,1-0,LAN,9,false,34,36,70,150,136,286,7,14,21,0,2:54
415555,2015-08-27,2015,CHA,SEA,4,2,4-2,CHA,9,true,33,36,69,133,114,247,10,10,20,3,2:39
415549,2015-08-27,2015,SFN,CHN,9,1,9-1,SFN,9,true,36,32,68,144,131,275,16,5,21,1,2:36
415554,2015-08-27,2015,WAS,SDN,4,2,4-2,WAS,9,true,39,33,72,128,161,289,17,6,23,1,3:01
415551,2015-08-27,2015,TBA,MIN,5,4,5-4,TBA,9,true,34,37,71,164,122,286,11,11,22,4,2:49
415557,2015-08-27,2015,TEX,TOR,4,1,4-1,TEX,9,true,38,37,75,176,165,341,16,13,29,3,3:40
415556,2015-08-27,2015,ARI,SLN,3,5,5-3,SLN,9,false,38,40,78,139,173,312,12,15,27,4,3:24
415552,2015-08-27,2015,PHI,NYN,5,9,9-5,NYN,13,false,51,62,113,236,187,423,14,24,38,4,4:32
415558,2015-08-28,2015,CLE,ANA,3,1,3-1,CLE,9,true,35,30,65,110,124,234,13,8,21,3,2:34
415570,2015-08-28,2015,PHI,SDN,7,1,7-1,PHI,9,true,36,31,67,104,145,249,14,4,18,2,2:38
415564,2015-08-28,2015,TOR,DET,5,3,5-3,TOR,9,true,36,34,70,114,132,246,14,7,21,1,2:25
415567,2015-08-28,2015,WAS,MIA,3,4,4-3,MIA,9,false,35,35,70,112,145,257,10,8,18,3,2:49
415566,2015-08-28,2015,TBA,KCA,2,3,3-2,KCA,9,false,36,37,73,152,130,282,10,11,21,2,3:01
415563,2015-08-28,2015,PIT,COL,5,3,5-3,PIT,9,true,38,33,71,132,160,292,16,8,24,1,3:10
415568,2015-08-28,2015,ATL,NYA,4,15,15-4,NYA,9,false,37,50,87,199,147,346,10,26,36,2,3:19
415559,2015-08-28,2015,TEX,BAL,4,1,4-1,TEX,9,true,32,33,65,129,114,243,10,7,17,1,2:23
415561,2015-08-28,2015,LAN,CHN,4,1,4-1,LAN,9,true,34,31,65,117,131,248,11,4,15,1,2:28
415562,2015-08-28,2015,MIL,CIN,5,0,5-0,MIL,9,true,34,33,67,137,128,265,10,9,19,1,2:51
415569,2015-08-28,2015,ARI,OAK,6,4,6-4,ARI,9,true,35,35,70,146,127,273,10,9,19,2,2:56
415571,2015-08-28,2015,CHA,SEA,0,2,2-0,SEA,9,false,31,39,70,156,113,269,5,12,17,2,2:52
415572,2015-08-28,2015,SFN,SLN,5,4,5-4,SFN,9,false,43,34,77,122,161,283,17,8,25,2,3:02
415560,2015-08-28,2015,NYN,BOS,4,6,6-4,BOS,10,false,48,40,88,175,210,385,20,10,30,4,3:59
415565,2015-08-28,2015,MIN,HOU,3,0,3-0,MIN,9,true,30,37,67,172,116,288,7,10,17,1,2:49
415582,2015-08-29,2015,WAS,MIA,5,1,5-1,WAS,9,true,32,33,65,139,108,247,11,8,19,0,2:25
415584,2015-08-29,2015,ARI,OAK,2,3,3-2,OAK,9,false,35,37,72,130,110,240,10,12,22,1,2:40
415574,2015-08-29,2015,TEX,BAL,4,3,4-3,TEX,9,true,36,37,73,125,117,242,16,10,26,4,2:33
415585,2015-08-29,2015,PHI,SDN,4,3,4-3,PHI,9,true,32,38,70,136,130,266,10,10,20,2,2:56
415583,2015-08-29,2015,ATL,NYA,1,3,3-1,NYA,9,false,38,39,77,161,131,292,12,14,26,2,3:04
415573,2015-08-29,2015,CLE,ANA,8,3,8-3,CLE,9,true,37,37,74,134,151,285,14,10,24,2,2:58 (:38 delay)
415580,2015-08-29,2015,MIN,HOU,1,4,4-1,HOU,9,false,35,42,77,180,136,316,9,14,23,2,3:22
415576,2015-08-29,2015,LAN,CHN,5,2,5-2,LAN,9,true,37,38,75,166,136,302,12,13,25,4,3:23
415586,2015-08-29,2015,CHA,SEA,6,7,7-6,SEA,9,false,44,44,88,196,172,368,18,17,35,5,4:16
415577,2015-08-29,2015,MIL,CIN,9,12,12-9,CIN,9,false,44,45,89,163,195,358,18,20,38,4,3:59
415575,2015-08-29,2015,NYN,BOS,1,3,3-1,BOS,9,false,33,38,71,156,126,282,8,10,18,1,2:51
415587,2015-08-29,2015,SFN,SLN,0,6,6-0,SLN,9,false,34,41,75,168,129,297,10,18,28,3,3:11
415578,2015-08-29,2015,PIT,COL,4,3,4-3,PIT,9,true,35,37,72,140,154,294,13,10,23,2,3:09
415581,2015-08-29,2015,TBA,KCA,3,6,6-3,KCA,9,false,36,44,80,189,119,308,10,15,25,4,3:20
415579,2015-08-29,2015,TOR,DET,15,1,15-1,TOR,9,true,48,35,83,140,184,324,26,8,34,2,3:25
415588,2015-08-30,2015,CLE,ANA,9,2,9-2,CLE,9,true,39,35,74,127,133,260,17,9,26,1,2:40
415590,2015-08-30,2015,NYN,BOS,5,4,5-4,NYN,9,true,37,37,74,154,119,273,13,11,24,3,2:56
415594,2015-08-30,2015,TOR,DET,9,2,9-2,TOR,9,true,39,36,75,127,157,284,15,10,25,2,2:38
415592,2015-08-30,2015,MIL,CIN,4,1,4-1,MIL,9,true,33,34,67,129,123,252,12,9,21,2,2:38
415591,2015-08-30,2015,LAN,CHN,0,2,2-0,CHN,9,false,29,41,70,139,116,255,1,15,16,1,2:42
415589,2015-08-30,2015,TEX,BAL,6,0,6-0,TEX,9,true,38,31,69,116,152,268,15,4,19,2,2:41
415593,2015-08-30,2015,PIT,COL,0,5,5-0,COL,9,false,33,38,71,129,130,259,5,12,17,2,2:55
415597,2015-08-30,2015,WAS,MIA,7,4,7-4,WAS,9,true,38,37,75,117,154,271,17,11,28,2,3:05
415596,2015-08-30,2015,TBA,KCA,3,2,3-2,TBA,9,true,34,35,69,137,139,276,11,9,20,0,2:57
415595,2015-08-30,2015,MIN,HOU,7,5,7-5,MIN,9,true,37,38,75,150,152,302,13,14,27,2,3:03
415602,2015-08-30,2015,SFN,SLN,5,7,7-5,SLN,9,false,37,41,78,149,138,287,12,16,28,5,3:08
415600,2015-08-30,2015,PHI,SDN,4,9,9-4,SDN,9,false,35,46,81,179,141,320,12,19,31,2,3:13
415598,2015-08-30,2015,ATL,NYA,6,20,20-6,NYA,9,false,45,57,102,202,175,377,18,31,49,5,3:46
415599,2015-08-30,2015,ARI,OAK,4,7,7-4,OAK,11,false,48,54,102,190,189,379,14,24,38,2,4:03
415601,2015-08-30,2015,CHA,SEA,6,5,6-5,CHA,11,false,54,47,101,200,193,393,22,16,38,4,4:01
415613,2015-08-31,2015,SDN,TEX,7,0,7-0,SDN,9,true,39,33,72,126,138,264,15,6,21,1,2:39
415609,2015-08-31,2015,NYN,PHI,3,1,3-1,NYN,9,true,29,33,62,125,104,229,6,8,14,0,2:23
415606,2015-08-31,2015,TOR,CLE,2,4,4-2,CLE,9,false,38,35,73,130,144,274,13,9,22,1,2:56
415610,2015-08-31,2015,HOU,SEA,8,3,8-3,HOU,9,true,37,35,72,146,140,286,14,9,23,0,2:48
415608,2015-08-31,2015,BOS,NYA,4,3,4-3,BOS,9,true,35,44,79,170,142,312,12,18,30,2,3:44
415604,2015-08-31,2015,COL,ARI,5,4,5-4,COL,9,false,43,37,80,129,164,293,18,11,29,3,3:30
415612,2015-08-31,2015,BAL,TBA,3,6,6-3,TBA,9,false,41,37,78,129,178,307,13,11,24,1,3:03
415614,2015-08-31,2015,SLN,WAS,8,5,8-5,SLN,9,true,38,41,79,159,148,307,18,15,33,1,3:07
415611,2015-08-31,2015,LAN,SFN,5,4,5-4,LAN,14,false,57,59,116,231,221,452,21,19,40,4,5:29
415603,2015-08-31,2015,OAK,ANA,11,5,11-5,OAK,9,true,39,40,79,160,168,328,15,15,30,6,3:34 (:10 delay)
415605,2015-08-31,2015,CHN,CIN,6,13,13-6,CIN,9,false,37,47,84,189,147,336,12,20,32,4,3:22
415607,2015-08-31,2015,ATL,MIA,0,4,4-0,MIA,9,false,32,37,69,144,148,292,8,11,19,2,2:54
414027,2015-09-01,2015,COL,ARI,4,6,6-4,ARI,9,false,37,39,76,135,123,258,13,16,29,4,3:02
414027,2015-09-01,2015,COL,ARI,4,6,6-4,ARI,9,false,37,39,76,135,123,258,13,16,29,4,3:02
415621,2015-09-01,2015,ATL,MIA,1,7,7-1,MIA,9,false,37,41,78,157,121,278,12,14,26,2,2:47
415622,2015-09-01,2015,BOS,NYA,1,3,3-1,NYA,9,false,35,33,68,121,135,256,9,6,15,2,2:41
415626,2015-09-01,2015,LAN,SFN,2,1,2-1,LAN,9,true,34,33,67,129,122,251,10,6,16,2,2:47
415624,2015-09-01,2015,MIL,PIT,7,4,7-4,MIL,9,true,35,34,69,126,164,290,14,8,22,2,2:55
415617,2015-09-01,2015,MIN,CHA,8,6,8-6,MIN,9,true,41,39,80,136,152,288,16,13,29,4,3:06
415618,2015-09-01,2015,CHN,CIN,5,4,5-4,CHN,9,true,36,34,70,141,163,304,12,8,20,3,3:03
415627,2015-09-01,2015,BAL,TBA,2,11,11-2,TBA,9,false,33,47,80,178,129,307,7,21,28,2,3:01
415619,2015-09-01,2015,TOR,CLE,5,3,5-3,TOR,10,false,36,41,77,147,133,280,9,12,21,1,3:06
415625,2015-09-01,2015,HOU,SEA,5,7,7-5,SEA,9,false,40,41,81,187,149,336,14,16,30,2,3:25
415616,2015-09-01,2015,COL,ARI,3,5,5-3,ARI,9,false,35,39,74,154,141,295,9,12,21,2,3:08
415620,2015-09-01,2015,KCA,DET,5,6,6-5,DET,9,false,39,39,78,153,145,298,12,13,25,3,3:12
415615,2015-09-01,2015,OAK,ANA,2,6,6-2,ANA,9,false,36,38,74,157,136,293,9,13,22,2,3:04
415629,2015-09-01,2015,SLN,WAS,8,5,8-5,SLN,9,false,44,42,86,163,164,327,19,14,33,3,3:28
415623,2015-09-01,2015,NYN,PHI,8,14,14-8,PHI,9,false,42,44,86,153,165,318,16,16,32,3,3:17
415628,2015-09-01,2015,SDN,TEX,6,8,8-6,TEX,9,false,43,42,85,162,179,341,17,15,32,5,3:40
415641,2015-09-02,2015,LAN,SFN,2,1,2-1,LAN,9,true,29,32,61,132,89,221,7,7,14,0,2:31
415632,2015-09-02,2015,MIN,CHA,3,0,3-0,MIN,9,true,33,31,64,113,139,252,11,3,14,3,2:34
415634,2015-09-02,2015,TOR,CLE,5,1,5-1,TOR,9,true,36,29,65,92,154,246,12,4,16,3,2:34
415635,2015-09-02,2015,KCA,DET,12,1,12-1,KCA,9,true,41,33,74,125,136,261,20,7,27,2,2:47
415640,2015-09-02,2015,HOU,SEA,3,8,8-3,SEA,9,false,36,46,82,196,143,339,11,21,32,5,3:40
415636,2015-09-02,2015,ATL,MIA,3,7,7-3,MIA,9,false,37,40,77,143,148,291,12,15,27,0,3:05
415644,2015-09-02,2015,SLN,WAS,3,4,4-3,WAS,9,false,43,37,80,143,160,303,16,10,26,3,3:34
415630,2015-09-02,2015,OAK,ANA,4,9,9-4,ANA,9,false,37,42,79,149,120,269,10,14,24,2,2:53
415639,2015-09-02,2015,MIL,PIT,9,4,9-4,MIL,9,true,41,35,76,134,166,300,18,9,27,3,3:07
415633,2015-09-02,2015,CHN,CIN,4,7,7-4,CIN,9,false,37,41,78,144,165,309,11,13,24,3,3:10
415631,2015-09-02,2015,COL,ARI,9,4,9-4,COL,9,true,42,38,80,129,148,277,19,13,32,5,3:38
415642,2015-09-02,2015,BAL,TBA,7,6,7-6,BAL,11,false,40,47,87,164,151,315,13,18,31,4,3:36
415643,2015-09-02,2015,SDN,TEX,3,4,4-3,TEX,10,false,39,45,84,189,143,332,10,15,25,0,3:33
415637,2015-09-02,2015,BOS,NYA,8,13,13-8,NYA,9,false,45,44,89,168,179,347,18,20,38,6,3:33
415638,2015-09-02,2015,NYN,PHI,9,4,9-4,NYN,9,true,40,37,77,134,137,271,19,11,30,1,2:53
415650,2015-09-03,2015,COL,SFN,11,3,11-3,COL,9,true,42,32,74,103,145,248,19,7,26,2,2:48 (:21 delay)
415649,2015-09-03,2015,MIL,PIT,5,3,5-3,MIL,9,true,36,39,75,152,123,275,15,12,27,2,3:12
415648,2015-09-03,2015,SDN,LAN,10,7,10-7,SDN,9,true,38,40,78,144,138,282,16,13,29,4,3:22
415646,2015-09-03,2015,MIN,CHA,4,6,6-4,CHA,9,false,39,41,80,164,151,315,11,16,27,4,3:26
415645,2015-09-03,2015,WAS,ATL,15,1,15-1,WAS,9,true,50,33,83,136,190,326,27,8,35,3,3:02
415647,2015-09-03,2015,KCA,DET,15,7,15-7,KCA,9,true,47,44,91,174,178,352,25,17,42,3,3:58
415663,2015-09-04,2015,COL,SFN,2,1,2-1,COL,9,true,32,33,65,129,122,251,9,9,18,4,2:52
415664,2015-09-04,2015,NYA,TBA,5,2,5-2,NYA,9,true,30,38,68,128,132,260,6,12,18,4,2:36
415655,2015-09-04,2015,DET,CLE,1,8,8-1,CLE,9,false,32,41,73,162,104,266,5,17,22,1,2:40
415654,2015-09-04,2015,KCA,CHA,1,12,12-1,CHA,9,false,33,44,77,151,121,272,8,19,27,1,2:40
415658,2015-09-04,2015,HOU,MIN,8,0,8-0,HOU,9,true,37,33,70,127,131,258,14,8,22,1,2:35
415660,2015-09-04,2015,BOS,PHI,7,5,7-5,BOS,9,true,36,40,76,169,121,290,12,16,28,4,3:22
415665,2015-09-04,2015,ANA,TEX,5,2,5-2,ANA,9,true,36,39,75,134,138,272,13,17,30,2,2:58
415652,2015-09-04,2015,WAS,ATL,5,2,5-2,WAS,10,false,41,42,83,141,176,317,17,14,31,3,3:23
415653,2015-09-04,2015,TOR,BAL,2,10,10-2,BAL,9,false,41,44,85,128,159,287,15,16,31,3,2:56
415656,2015-09-04,2015,SDN,LAN,4,8,8-4,LAN,9,false,33,46,79,196,142,338,6,19,25,2,3:33
415662,2015-09-04,2015,OAK,SEA,8,11,11-8,SEA,9,false,43,41,84,177,150,327,19,16,35,5,3:38
415661,2015-09-04,2015,SLN,PIT,3,9,9-3,PIT,9,false,37,46,83,171,166,337,10,20,30,3,3:21
415651,2015-09-04,2015,CHN,ARI,14,5,14-5,CHN,9,true,44,42,86,180,181,361,20,14,34,2,3:40
415659,2015-09-04,2015,MIA,NYN,6,5,6-5,MIA,11,false,48,51,99,185,175,360,18,21,39,2,3:49
415657,2015-09-05,2015,CIN,MIL,3,7,7-3,MIL,9,false,37,40,77,151,155,306,12,14,26,1,3:11 (1:33 delay)
415666,2015-09-05,2015,CHN,ARI,2,0,2-0,CHN,9,true,32,31,63,126,138,264,9,6,15,0,2:34
415675,2015-09-05,2015,BOS,PHI,9,2,9-2,BOS,9,true,40,32,72,110,151,261,17,5,22,2,2:24
415670,2015-09-05,2015,DET,CLE,6,0,6-0,DET,9,true,37,33,70,133,143,276,14,7,21,2,2:53
415668,2015-09-05,2015,TOR,BAL,5,1,5-1,TOR,9,true,36,33,69,127,130,257,12,8,20,0,2:42
415673,2015-09-05,2015,HOU,MIN,2,3,3-2,MIN,9,false,38,34,72,145,145,290,12,8,20,0,2:45
415676,2015-09-05,2015,SLN,PIT,4,1,4-1,SLN,9,true,36,38,74,151,128,279,12,10,22,0,2:56
415669,2015-09-05,2015,KCA,CHA,1,6,6-1,CHA,9,false,36,39,75,141,132,273,10,14,24,2,2:52
415657,2015-09-05,2015,CIN,MIL,3,7,7-3,MIL,9,false,37,40,77,151,155,306,12,14,26,1,3:11 (1:33 delay)
415671,2015-09-05,2015,SDN,LAN,0,2,2-0,LAN,9,false,34,41,75,157,120,277,8,15,23,0,3:04
415674,2015-09-05,2015,MIA,NYN,0,7,7-0,NYN,9,false,33,40,73,153,100,253,9,15,24,1,2:30
415678,2015-09-05,2015,COL,SFN,3,7,7-3,SFN,9,false,34,44,78,154,133,287,7,20,27,3,3:08
415679,2015-09-05,2015,NYA,TBA,2,3,3-2,TBA,9,false,38,40,78,169,159,328,11,14,25,5,3:35
415677,2015-09-05,2015,OAK,SEA,3,8,8-3,SEA,9,false,32,44,76,170,114,284,7,21,28,1,2:57
415672,2015-09-05,2015,CIN,MIL,6,8,8-6,MIL,9,false,42,44,86,158,163,321,16,19,35,2,3:27
415667,2015-09-05,2015,WAS,ATL,8,2,8-2,WAS,9,true,37,38,75,163,154,317,13,10,23,3,3:07
415680,2015-09-05,2015,ANA,TEX,1,2,2-1,TEX,9,false,31,39,70,156,129,285,5,13,18,1,2:45
415685,2015-09-06,2015,DET,CLE,0,4,4-0,CLE,9,false,30,37,67,135,119,254,5,11,16,0,2:50
415690,2015-09-06,2015,BOS,PHI,6,2,6-2,BOS,9,true,36,38,74,138,153,291,13,12,25,0,2:57
415695,2015-09-06,2015,ANA,TEX,7,0,7-0,ANA,9,true,37,33,70,140,128,268,17,8,25,2,2:46
415694,2015-09-06,2015,NYA,TBA,6,4,6-4,NYA,9,true,37,40,77,141,131,272,13,13,26,3,3:07
415691,2015-09-06,2015,SLN,PIT,1,7,7-1,PIT,9,false,34,40,74,128,128,256,7,16,23,2,2:44
415692,2015-09-06,2015,OAK,SEA,2,3,3-2,SEA,9,false,38,34,72,135,126,261,11,10,21,3,3:00
415687,2015-09-06,2015,CIN,MIL,6,3,6-3,CIN,9,true,41,36,77,128,149,277,18,10,28,1,3:02
415688,2015-09-06,2015,HOU,MIN,8,5,8-5,HOU,9,true,38,37,75,135,148,283,15,10,25,4,2:55
415682,2015-09-06,2015,WAS,ATL,8,4,8-4,WAS,9,true,41,38,79,137,164,301,15,11,26,3,3:06
415684,2015-09-06,2015,KCA,CHA,5,7,7-5,CHA,9,false,35,42,77,179,132,311,8,16,24,1,3:01
415689,2015-09-06,2015,MIA,NYN,4,3,4-3,MIA,9,false,39,35,74,158,149,307,14,13,27,3,3:20
415686,2015-09-06,2015,SDN,LAN,1,5,5-1,LAN,9,false,36,42,78,182,142,324,10,16,26,2,3:32
415681,2015-09-06,2015,CHN,ARI,6,4,6-4,CHN,9,true,36,36,72,136,137,273,12,11,23,4,3:01
415683,2015-09-06,2015,TOR,BAL,10,4,10-4,TOR,9,true,41,37,78,146,158,304,18,12,30,3,3:22
415693,2015-09-06,2015,COL,SFN,4,7,7-4,SFN,9,false,36,43,79,166,136,302,10,18,28,5,3:18
415696,2015-09-07,2015,PHI,ATL,2,7,7-2,ATL,9,false,33,41,74,139,121,260,7,17,24,0,2:32
415699,2015-09-07,2015,CHA,CLE,2,3,3-2,CLE,9,false,36,35,71,124,129,253,9,9,18,1,2:34
415706,2015-09-07,2015,CIN,PIT,3,1,3-1,CIN,9,true,31,34,65,117,124,241,7,9,16,2,2:38
415710,2015-09-07,2015,BOS,TOR,11,4,11-4,BOS,9,true,42,34,76,131,138,269,19,11,30,4,2:48
415709,2015-09-07,2015,SEA,TEX,0,3,3-0,TEX,9,false,34,36,70,148,134,282,9,12,21,3,3:00
415708,2015-09-07,2015,DET,TBA,5,4,5-4,DET,9,true,35,40,75,146,129,275,14,14,28,3,2:57
415707,2015-09-07,2015,ARI,SFN,6,1,6-1,ARI,9,true,37,37,74,144,129,273,17,10,27,1,2:54
415704,2015-09-07,2015,KCA,MIN,2,6,6-2,MIN,9,false,34,44,78,171,131,302,10,17,27,1,3:02
415698,2015-09-07,2015,SLN,CHN,0,9,9-0,CHN,9,false,34,42,76,150,133,283,10,16,26,1,2:47
415703,2015-09-07,2015,MIA,MIL,1,9,9-1,MIL,9,false,32,47,79,177,130,307,6,21,27,2,3:01
415701,2015-09-07,2015,OAK,HOU,10,9,10-9,OAK,9,true,42,40,82,136,185,321,19,13,32,6,3:53
415697,2015-09-07,2015,NYA,BAL,8,6,8-6,NYA,9,true,39,41,80,161,156,317,14,15,29,1,3:10
415700,2015-09-07,2015,SDN,COL,4,6,6-4,COL,9,false,38,36,74,144,149,293,14,10,24,3,3:19
415705,2015-09-07,2015,WAS,NYN,5,8,8-5,NYN,9,false,40,40,80,174,143,317,15,13,28,6,3:26
415702,2015-09-07,2015,ANA,LAN,5,7,7-5,LAN,9,false,40,49,89,185,153,338,13,23,36,9,3:52
415711,2015-09-08,2015,PHI,ATL,5,0,5-0,PHI,9,true,31,36,67,120,115,235,11,10,21,3,2:30
415716,2015-09-08,2015,OAK,HOU,4,0,4-0,OAK,9,true,33,34,67,124,121,245,10,7,17,0,2:33
415715,2015-09-08,2015,SDN,COL,2,1,2-1,SDN,9,false,36,32,68,119,139,258,11,6,17,0,2:40
415714,2015-09-08,2015,CHA,CLE,7,4,7-4,CHA,9,true,37,38,75,144,130,274,15,10,25,3,2:54 (1:04 delay)
415722,2015-09-08,2015,ARI,SFN,2,6,6-2,SFN,9,false,31,39,70,148,112,260,5,12,17,4,2:49
415712,2015-09-08,2015,NYA,BAL,1,2,2-1,BAL,9,false,35,35,70,118,160,278,8,10,18,2,2:58
415719,2015-09-08,2015,KCA,MIN,4,2,4-2,KCA,9,true,31,32,63,118,101,219,8,7,15,0,2:29
415725,2015-09-08,2015,BOS,TOR,1,5,5-1,TOR,10,false,35,44,79,169,132,301,6,16,22,5,3:23
415717,2015-09-08,2015,ANA,LAN,4,6,6-4,LAN,9,false,37,41,78,148,146,294,10,14,24,3,3:12
415720,2015-09-08,2015,WAS,NYN,7,8,8-7,NYN,9,false,40,40,80,176,137,313,14,14,28,4,3:20
415724,2015-09-08,2015,SEA,TEX,6,9,9-6,TEX,9,false,37,43,80,175,141,316,11,14,25,4,3:12
415721,2015-09-08,2015,CIN,PIT,3,7,7-3,PIT,9,false,39,42,81,160,169,329,12,15,27,1,3:19
415713,2015-09-08,2015,SLN,CHN,5,8,8-5,CHN,9,false,39,42,81,167,150,317,14,16,30,3,3:07
415718,2015-09-08,2015,MIA,MIL,6,4,6-4,MIA,9,true,37,44,81,195,150,345,14,18,32,4,3:37
415723,2015-09-08,2015,DET,TBA,8,7,8-7,DET,13,false,54,54,108,202,202,404,17,17,34,9,5:03
415732,2015-09-09,2015,ANA,LAN,3,2,3-2,ANA,9,true,32,33,65,122,127,249,9,8,17,2,2:50
415737,2015-09-09,2015,ARI,SFN,2,1,2-1,ARI,9,true,33,36,69,143,106,249,10,12,22,5,2:49
415733,2015-09-09,2015,MIA,MIL,5,2,5-2,MIA,9,true,34,31,65,116,152,268,12,7,19,1,2:43
415727,2015-09-09,2015,NYA,BAL,3,5,5-3,BAL,9,false,32,42,74,162,118,280,5,15,20,4,3:01
415735,2015-09-09,2015,WAS,NYN,3,5,5-3,NYN,9,false,35,35,70,117,127,244,9,9,18,1,2:37
415739,2015-09-09,2015,SEA,TEX,6,0,6-0,SEA,9,true,35,32,67,128,110,238,13,5,18,2,2:26
415738,2015-09-09,2015,DET,TBA,0,8,8-0,TBA,9,false,34,41,75,156,139,295,9,17,26,3,3:04
415726,2015-09-09,2015,PHI,ATL,1,8,8-1,ATL,9,false,34,49,83,154,129,283,7,26,33,2,2:52
415729,2015-09-09,2015,CHA,CLE,4,6,6-4,CLE,9,false,36,40,76,145,151,296,8,14,22,3,2:58
415728,2015-09-09,2015,SLN,CHN,4,3,4-3,SLN,9,true,32,39,71,147,130,277,8,12,20,2,2:47
415736,2015-09-09,2015,CIN,PIT,4,5,5-4,PIT,9,false,37,36,73,126,171,297,10,10,20,2,3:04
415730,2015-09-09,2015,SDN,COL,11,4,11-4,SDN,9,true,42,40,82,147,174,321,21,15,36,1,3:16
415731,2015-09-09,2015,OAK,HOU,5,11,11-5,HOU,9,false,38,46,84,182,158,340,11,18,29,3,3:38
415740,2015-09-09,2015,BOS,TOR,10,4,10-4,BOS,9,true,40,37,77,171,161,332,19,12,31,4,3:31
415734,2015-09-09,2015,KCA,MIN,2,3,3-2,MIN,12,false,46,47,93,179,185,364,12,14,26,2,4:03
415023,2015-09-10,2015,SDN,COL,3,4,4-3,COL,9,false,35,32,67,113,149,262,9,5,14,0,2:47
415746,2015-09-10,2015,SEA,TEX,5,0,5-0,SEA,9,true,34,34,68,123,113,236,11,9,20,0,2:24
415023,2015-09-10,2015,SDN,COL,3,4,4-3,COL,9,false,35,32,67,113,149,262,9,5,14,0,2:47
415742,2015-09-10,2015,CLE,DET,7,5,7-5,CLE,9,true,40,39,79,136,119,255,15,15,30,4,3:11
415744,2015-09-10,2015,ATL,NYN,2,7,7-2,NYN,9,false,36,42,78,174,131,305,10,18,28,2,3:05 (2:20 delay)
415745,2015-09-10,2015,CIN,SLN,11,0,11-0,CIN,9,true,43,36,79,152,168,320,18,11,29,3,3:16
415743,2015-09-10,2015,PIT,MIL,4,6,6-4,MIL,13,false,53,56,109,199,212,411,18,18,36,4,4:44
415758,2015-09-11,2015,TEX,OAK,4,0,4-0,TEX,9,true,35,29,64,97,124,221,11,2,13,1,2:20
415762,2015-09-11,2015,MIA,WAS,2,1,2-1,MIA,9,true,30,37,67,161,107,268,8,11,19,3,2:43
415741,2015-09-11,2015,PHI,CHN,3,7,7-3,CHN,9,false,34,43,77,144,130,274,8,15,23,5,2:56
415752,2015-09-11,2015,ANA,HOU,3,2,3-2,ANA,9,true,32,33,65,137,138,275,9,8,17,0,2:43
415749,2015-09-11,2015,PHI,CHN,1,5,5-1,CHN,9,false,36,40,76,163,125,288,9,12,21,1,2:54
415741,2015-09-11,2015,PHI,CHN,3,7,7-3,CHN,9,false,34,43,77,144,130,274,8,15,23,5,2:56
415760,2015-09-11,2015,CIN,SLN,4,2,4-2,CIN,9,true,36,37,73,138,121,259,13,12,25,0,2:30 (1:07 delay)
415759,2015-09-11,2015,SFN,SDN,9,1,9-1,SFN,9,true,44,32,76,118,179,297,21,5,26,3,3:02
415755,2015-09-11,2015,PIT,MIL,6,3,6-3,PIT,9,true,38,35,73,142,148,290,14,10,24,2,3:12
415757,2015-09-11,2015,ATL,NYN,1,5,5-1,NYN,9,false,38,41,79,156,140,296,11,17,28,3,3:10
415750,2015-09-11,2015,SEA,COL,2,4,4-2,COL,9,false,38,39,77,141,144,285,12,13,25,4,3:11
415748,2015-09-11,2015,TBA,BOS,8,4,8-4,TBA,9,true,37,42,79,196,139,335,13,16,29,4,3:26
415756,2015-09-11,2015,CHA,MIN,2,6,6-2,MIN,9,false,34,43,77,186,134,320,9,19,28,1,2:58
415761,2015-09-11,2015,NYA,TOR,5,11,11-5,TOR,9,false,38,45,83,172,168,340,10,19,29,3,3:39
415753,2015-09-11,2015,BAL,KCA,14,8,14-8,BAL,9,true,45,43,88,164,207,371,20,15,35,8,3:59
415754,2015-09-11,2015,ARI,LAN,12,4,12-4,ARI,9,true,43,38,81,157,171,328,18,11,29,1,3:23
415760,2015-09-11,2015,CIN,SLN,4,2,4-2,CIN,9,true,36,37,73,138,121,259,13,12,25,0,2:30 (1:07 delay)
415777,2015-09-12,2015,MIA,WAS,2,0,2-0,MIA,9,true,34,31,65,134,107,241,14,5,19,3,2:28
415765,2015-09-12,2015,SEA,COL,7,2,7-2,SEA,9,true,37,34,71,122,144,266,12,7,19,4,2:37
415770,2015-09-12,2015,PIT,MIL,10,2,10-2,PIT,9,true,42,35,77,126,153,279,19,9,28,2,2:55
415772,2015-09-12,2015,ATL,NYN,4,6,6-4,NYN,9,false,32,40,72,140,131,271,6,16,22,3,2:57
415764,2015-09-12,2015,PHI,CHN,7,5,7-5,PHI,9,false,36,39,75,142,148,290,10,12,22,4,3:12 (:50 delay)
415763,2015-09-12,2015,TBA,BOS,4,10,10-4,BOS,9,false,36,44,80,164,151,315,10,17,27,0,2:56
415774,2015-09-12,2015,SFN,SDN,8,0,8-0,SFN,9,true,39,28,67,111,157,268,16,1,17,1,2:35
415769,2015-09-12,2015,ARI,LAN,5,9,9-5,LAN,9,false,42,47,89,188,163,351,17,20,37,3,3:52
415768,2015-09-12,2015,BAL,KCA,6,14,14-6,KCA,9,false,45,45,90,183,183,366,20,20,40,5,3:40 (3:02 delay)
415747,2015-09-12,2015,NYA,TOR,7,10,10-7,TOR,9,false,43,46,89,182,176,358,16,19,35,4,3:31 (:33 delay)
415747,2015-09-12,2015,NYA,TOR,7,10,10-7,TOR,9,false,43,46,89,182,176,358,16,19,35,4,3:31 (:33 delay)
415776,2015-09-12,2015,NYA,TOR,5,9,9-5,TOR,11,false,46,49,95,209,190,399,14,18,32,9,4:32
415767,2015-09-12,2015,ANA,HOU,3,2,3-2,ANA,9,true,36,34,70,123,138,261,12,8,20,0,2:41
415775,2015-09-12,2015,CIN,SLN,5,1,5-1,CIN,9,true,37,34,71,158,139,297,12,8,20,2,3:02
415771,2015-09-12,2015,CHA,MIN,8,2,8-2,CHA,9,true,42,37,79,172,160,332,17,10,27,7,3:29
415773,2015-09-12,2015,TEX,OAK,3,5,5-3,OAK,9,false,41,40,81,169,165,334,14,13,27,5,3:26
415792,2015-09-13,2015,MIA,WAS,0,5,5-0,WAS,9,false,32,43,75,151,120,271,6,17,23,1,2:50
415784,2015-09-13,2015,ARI,LAN,3,4,4-3,LAN,9,false,33,43,76,154,126,280,8,17,25,1,2:56
415783,2015-09-13,2015,BAL,KCA,8,2,8-2,BAL,9,true,38,33,71,135,142,277,15,7,22,2,2:37
415781,2015-09-13,2015,CLE,DET,7,2,7-2,CLE,9,true,37,39,76,163,144,307,16,13,29,4,3:20
415782,2015-09-13,2015,ANA,HOU,3,5,5-3,HOU,9,false,33,43,76,169,132,301,6,17,23,3,3:14
415779,2015-09-13,2015,PHI,CHN,7,4,7-4,PHI,9,true,38,40,78,170,143,313,17,11,28,0,3:04
415780,2015-09-13,2015,SEA,COL,2,3,3-2,COL,9,false,33,39,72,162,140,302,9,12,21,2,3:13
415790,2015-09-13,2015,CIN,SLN,2,9,9-2,SLN,9,false,36,47,83,194,143,337,11,19,30,2,3:18
415751,2015-09-13,2015,CLE,DET,2,9,9-2,DET,9,false,37,45,82,182,178,360,11,20,31,3,3:52
415785,2015-09-13,2015,PIT,MIL,7,6,7-6,PIT,11,false,46,47,93,169,173,342,14,17,31,1,3:47 (:21 delay)
415751,2015-09-13,2015,CLE,DET,2,9,9-2,DET,9,false,37,45,82,182,178,360,11,20,31,3,3:52
415778,2015-09-13,2015,TBA,BOS,0,2,2-0,BOS,13,false,47,51,98,191,187,378,10,16,26,4,4:05
415787,2015-09-13,2015,ATL,NYN,7,10,10-7,NYN,10,false,48,48,96,184,150,334,17,20,37,5,3:38
415791,2015-09-13,2015,NYA,TOR,5,0,5-0,NYA,9,true,33,30,63,128,121,249,9,4,13,2,2:40
415789,2015-09-13,2015,SFN,SDN,10,3,10-3,SFN,9,true,41,34,75,120,169,289,17,7,24,4,3:00
415786,2015-09-13,2015,CHA,MIN,0,7,7-0,MIN,9,false,32,44,76,186,128,314,6,18,24,1,2:57
415788,2015-09-13,2015,TEX,OAK,12,4,12-4,TEX,9,true,45,41,86,192,168,360,20,13,33,7,3:52
415796,2015-09-14,2015,LAN,COL,4,1,4-1,LAN,9,true,36,33,69,135,140,275,14,7,21,3,3:02
415798,2015-09-14,2015,TEX,HOU,5,3,5-3,TEX,9,true,34,41,75,155,116,271,10,13,23,3,3:03
415794,2015-09-14,2015,BAL,BOS,2,0,2-0,BAL,9,true,36,35,71,147,152,299,12,8,20,4,2:56
415800,2015-09-14,2015,NYN,MIA,4,3,4-3,NYN,9,true,34,35,69,138,136,274,13,10,23,0,2:50
415795,2015-09-14,2015,SFN,CIN,5,3,5-3,SFN,9,true,33,38,71,139,138,277,9,11,20,3,2:52
415799,2015-09-14,2015,CLE,KCA,8,3,8-3,CLE,9,true,40,39,79,146,162,308,17,13,30,2,3:21
415797,2015-09-14,2015,MIN,DET,7,1,7-1,MIN,9,true,39,38,77,138,154,292,17,11,28,2,2:56
415793,2015-09-14,2015,SEA,ANA,10,1,10-1,SEA,9,true,42,31,73,125,168,293,17,6,23,2,2:59
415801,2015-09-14,2015,TBA,NYA,1,4,4-1,NYA,9,false,35,34,69,130,159,289,8,10,18,4,3:08
415803,2015-09-14,2015,ARI,SDN,3,10,10-3,SDN,9,false,39,43,82,180,141,321,12,17,29,2,3:29
415804,2015-09-14,2015,PHI,WAS,7,8,8-7,WAS,11,false,47,49,96,193,173,366,13,19,32,3,3:54
415802,2015-09-14,2015,CHA,OAK,8,7,8-7,CHA,14,false,67,56,123,222,273,495,29,13,42,3,5:09
415228,2015-09-15,2015,PIT,CHN,5,4,5-4,PIT,9,true,35,35,70,139,138,277,12,8,20,3,2:51
415819,2015-09-15,2015,PHI,WAS,0,4,4-0,WAS,9,false,29,38,67,144,115,259,2,12,14,1,2:35
415812,2015-09-15,2015,CLE,KCA,0,2,2-0,KCA,9,false,36,31,67,110,135,245,9,5,14,1,2:34
415807,2015-09-15,2015,PIT,CHN,1,2,2-1,CHN,9,false,32,38,70,139,111,250,7,11,18,1,2:44
415818,2015-09-15,2015,ATL,TOR,3,2,3-2,ATL,9,false,34,37,71,156,122,278,12,10,22,4,2:45
415805,2015-09-15,2015,SEA,ANA,3,4,4-3,ANA,9,false,36,35,71,120,140,260,10,9,19,0,2:40
415813,2015-09-15,2015,NYN,MIA,3,9,9-3,MIA,9,false,40,40,80,147,162,309,14,18,32,3,3:16
415228,2015-09-15,2015,PIT,CHN,5,4,5-4,PIT,9,true,35,35,70,139,138,277,12,8,20,3,2:51
415817,2015-09-15,2015,MIL,SLN,1,3,3-1,SLN,10,false,37,41,78,179,147,326,10,12,22,1,3:14
415816,2015-09-15,2015,ARI,SDN,6,4,6-4,ARI,9,true,37,39,76,158,157,315,14,13,27,6,3:31
415814,2015-09-15,2015,TBA,NYA,6,3,6-3,TBA,9,true,38,38,76,160,154,314,16,9,25,4,3:14
415811,2015-09-15,2015,TEX,HOU,6,5,6-5,TEX,9,false,41,41,82,159,164,323,18,15,33,8,3:46
415810,2015-09-15,2015,MIN,DET,4,5,5-4,DET,9,false,40,38,78,151,153,304,15,13,28,5,3:29
415806,2015-09-15,2015,BAL,BOS,6,5,6-5,BAL,13,false,48,53,101,218,173,391,12,18,30,7,4:20
415815,2015-09-15,2015,CHA,OAK,6,17,17-6,OAK,9,false,41,55,96,230,146,376,17,28,45,3,3:31
415808,2015-09-15,2015,SFN,CIN,8,9,9-8,CIN,10,false,46,45,91,175,196,371,17,16,33,5,4:02
415809,2015-09-15,2015,LAN,COL,4,5,5-4,COL,16,false,63,60,123,207,246,453,20,13,33,5,5:23
415824,2015-09-16,2015,LAN,COL,2,0,2-0,LAN,9,true,31,29,60,92,103,195,7,2,9,0,2:08
415820,2015-09-16,2015,SEA,ANA,3,1,3-1,SEA,9,true,30,34,64,130,107,237,10,7,17,2,2:40
415827,2015-09-16,2015,CLE,KCA,5,1,5-1,CLE,9,true,37,35,72,132,158,290,14,8,22,1,2:47
415828,2015-09-16,2015,NYN,MIA,0,6,6-0,MIA,9,false,32,39,71,137,133,270,5,15,20,3,2:46
415831,2015-09-16,2015,ARI,SDN,3,4,4-3,SDN,9,false,35,36,71,158,124,282,10,10,20,2,2:50
415834,2015-09-16,2015,PHI,WAS,2,12,12-2,WAS,9,false,33,44,77,160,133,293,7,21,28,0,2:49
415829,2015-09-16,2015,TBA,NYA,1,3,3-1,NYA,9,false,38,37,75,157,144,301,11,10,21,2,3:07
415821,2015-09-16,2015,BAL,BOS,1,10,10-1,BOS,9,false,36,43,79,155,139,294,9,16,25,2,2:51
415833,2015-09-16,2015,ATL,TOR,1,9,9-1,TOR,9,false,37,45,82,175,137,312,11,19,30,2,3:08
415823,2015-09-16,2015,SFN,CIN,5,3,5-3,SFN,9,true,39,40,79,142,150,292,16,15,31,4,3:10
415830,2015-09-16,2015,CHA,OAK,9,4,9-4,CHA,9,true,38,39,77,166,133,299,14,13,27,2,2:56
415832,2015-09-16,2015,MIL,SLN,4,5,5-4,SLN,9,false,36,42,78,180,129,309,9,15,24,1,3:05
415826,2015-09-16,2015,TEX,HOU,14,3,14-3,TEX,9,true,43,37,80,134,155,289,19,12,31,1,2:41
415822,2015-09-16,2015,PIT,CHN,2,3,3-2,CHN,12,false,41,51,92,192,173,365,9,17,26,1,4:17
415825,2015-09-16,2015,MIN,DET,4,7,7-4,DET,12,false,47,49,96,183,199,382,13,17,30,4,4:17 (:56 delay)
415843,2015-09-17,2015,ATL,TOR,0,5,5-0,TOR,9,false,30,40,70,152,108,260,5,14,19,0,2:36
415842,2015-09-17,2015,MIL,SLN,3,6,6-3,SLN,9,false,35,40,75,137,118,255,10,13,23,3,2:51
415841,2015-09-17,2015,CHA,OAK,2,4,4-2,OAK,9,false,37,34,71,127,148,275,11,9,20,0,2:46
415836,2015-09-17,2015,TBA,BAL,3,4,4-3,BAL,9,false,37,35,72,138,154,292,11,9,20,2,2:56
415839,2015-09-17,2015,CLE,KCA,4,8,8-4,KCA,9,false,43,43,86,148,148,296,14,15,29,4,3:20
415838,2015-09-17,2015,TEX,HOU,8,2,8-2,TEX,9,true,39,36,75,123,152,275,16,11,27,2,3:03
415840,2015-09-17,2015,WAS,MIA,4,6,6-4,MIA,9,false,38,37,75,132,169,301,11,11,22,4,3:13
415837,2015-09-17,2015,PIT,CHN,6,9,9-6,CHN,9,false,37,48,85,165,136,301,12,23,35,3,3:05
415835,2015-09-17,2015,MIN,ANA,8,11,11-8,ANA,9,false,44,48,92,187,185,372,15,21,36,4,3:56
415848,2015-09-18,2015,CLE,CHA,12,1,12-1,CLE,9,true,43,37,80,128,150,278,19,10,29,2,2:46
415845,2015-09-18,2015,SFN,ARI,0,2,2-0,ARI,9,false,33,34,67,131,144,275,8,9,17,3,2:56
415847,2015-09-18,2015,TOR,BOS,6,1,6-1,TOR,9,true,35,33,68,131,137,268,11,9,20,0,2:32
415852,2015-09-18,2015,NYN,NYA,5,1,5-1,NYN,9,true,33,38,71,149,123,272,9,11,20,2,2:56
415846,2015-09-18,2015,TBA,BAL,8,6,8-6,TBA,9,true,39,35,74,149,147,296,18,10,28,3,2:51
415856,2015-09-18,2015,COL,SDN,7,4,7-4,COL,9,true,36,40,76,155,163,318,12,12,24,2,3:12
415857,2015-09-18,2015,TEX,SEA,1,3,3-1,SEA,9,false,37,35,72,141,164,305,12,12,24,4,3:15
415849,2015-09-18,2015,MIL,CIN,3,5,5-3,CIN,9,false,38,43,81,175,149,324,12,18,30,3,3:20
415851,2015-09-18,2015,WAS,MIA,5,4,5-4,WAS,10,false,44,41,85,158,166,324,19,14,33,4,3:22
415858,2015-09-18,2015,CHN,SLN,8,3,8-3,CHN,9,true,46,36,82,131,203,334,24,9,33,7,3:26
415850,2015-09-18,2015,DET,KCA,5,4,5-4,DET,12,false,52,45,97,159,201,360,20,12,32,2,4:09 (:23 delay)
415854,2015-09-18,2015,ATL,PHI,2,1,2-1,ATL,9,true,29,40,69,176,90,266,7,12,19,3,2:58
415855,2015-09-18,2015,LAN,PIT,6,2,6-2,LAN,9,true,35,35,70,124,131,255,14,8,22,3,2:48
415853,2015-09-18,2015,HOU,OAK,3,4,4-3,OAK,9,false,34,38,72,159,137,296,7,11,18,1,3:13
415861,2015-09-19,2015,TBA,BAL,1,2,2-1,BAL,9,false,33,35,68,115,122,237,8,10,18,0,2:29
415859,2015-09-19,2015,MIN,ANA,2,5,5-2,ANA,9,false,36,36,72,132,125,257,9,12,21,2,2:56
415867,2015-09-19,2015,NYN,NYA,0,5,5-0,NYA,9,false,34,36,70,139,158,297,8,9,17,4,3:11
415862,2015-09-19,2015,TOR,BOS,6,7,7-6,BOS,9,false,41,43,84,155,161,316,16,17,33,8,3:08
415869,2015-09-19,2015,ATL,PHI,2,1,2-1,ATL,9,true,33,30,63,129,118,247,10,5,15,1,2:21
415844,2015-09-19,2015,MIN,ANA,3,4,4-3,ANA,12,false,45,50,95,195,189,384,11,15,26,7,4:15
415863,2015-09-19,2015,CLE,CHA,3,4,4-3,CHA,9,false,36,39,75,165,134,299,11,11,22,5,3:19
415866,2015-09-19,2015,WAS,MIA,5,2,5-2,WAS,9,true,37,37,74,138,134,272,14,12,26,2,2:45
415870,2015-09-19,2015,LAN,PIT,2,3,3-2,PIT,9,false,32,36,68,129,125,254,8,14,22,2,2:47
415860,2015-09-19,2015,SFN,ARI,0,6,6-0,ARI,9,false,34,48,82,161,121,282,8,22,30,1,3:02
415864,2015-09-19,2015,MIL,CIN,7,9,9-7,CIN,9,false,40,44,84,177,159,336,15,17,32,2,3:39
415872,2015-09-19,2015,TEX,SEA,10,1,10-1,TEX,9,true,47,35,82,132,180,312,24,7,31,4,3:09
415868,2015-09-19,2015,HOU,OAK,10,6,10-6,HOU,9,true,40,40,80,163,151,314,20,15,35,6,3:44
415873,2015-09-19,2015,CHN,SLN,5,4,5-4,CHN,9,true,37,42,79,152,154,306,14,15,29,4,3:11
415844,2015-09-19,2015,MIN,ANA,3,4,4-3,ANA,12,false,45,50,95,195,189,384,11,15,26,7,4:15
415871,2015-09-19,2015,COL,SDN,10,2,10-2,COL,9,true,45,35,80,149,166,315,23,10,33,4,3:05
415865,2015-09-19,2015,DET,KCA,6,5,6-5,DET,11,false,47,44,91,185,182,367,20,14,34,2,4:06
415883,2015-09-20,2015,HOU,OAK,5,1,5-1,HOU,9,true,35,32,67,127,127,254,12,6,18,0,2:37
415884,2015-09-20,2015,ATL,PHI,2,1,2-1,ATL,9,false,35,33,68,112,128,240,14,7,21,1,2:33
415875,2015-09-20,2015,SFN,ARI,5,1,5-1,SFN,9,true,34,33,67,113,142,255,10,9,19,4,2:57
415885,2015-09-20,2015,LAN,PIT,3,4,4-3,PIT,9,false,32,40,72,144,136,280,6,17,23,2,3:03
415888,2015-09-20,2015,CHN,SLN,3,4,4-3,SLN,9,false,38,34,72,159,150,309,13,9,22,4,3:26
415886,2015-09-20,2015,COL,SDN,4,10,10-4,SDN,9,false,36,43,79,147,161,308,9,16,25,1,3:06
415887,2015-09-20,2015,TEX,SEA,2,9,9-2,SEA,9,false,36,45,81,176,148,324,9,23,32,3,3:16
415881,2015-09-20,2015,WAS,MIA,13,3,13-3,WAS,9,true,41,36,77,137,145,282,18,9,27,2,2:57
415879,2015-09-20,2015,MIL,CIN,8,4,8-4,MIL,9,true,45,37,82,141,155,296,21,10,31,2,3:08
415878,2015-09-20,2015,CLE,CHA,6,3,6-3,CLE,9,true,38,37,75,152,166,318,15,12,27,2,3:15
415877,2015-09-20,2015,TOR,BOS,3,4,4-3,BOS,9,false,36,40,76,143,143,286,9,12,21,2,2:51
415876,2015-09-20,2015,TBA,BAL,7,6,7-6,TBA,9,false,43,41,84,138,171,309,19,13,32,3,3:18
415874,2015-09-20,2015,MIN,ANA,8,1,8-1,MIN,9,true,42,35,77,137,164,301,19,8,27,2,3:02
415880,2015-09-20,2015,DET,KCA,3,10,10-3,KCA,9,false,38,48,86,182,159,341,10,24,34,1,3:23
415882,2015-09-20,2015,NYN,NYA,2,11,11-2,NYA,9,false,36,46,82,184,154,338,11,17,28,3,3:35
414769,2015-09-21,2015,DET,CHA,0,2,2-0,CHA,9,false,28,32,60,122,88,210,1,9,10,0,2:12
415894,2015-09-21,2015,SLN,CIN,2,1,2-1,SLN,9,true,34,34,68,122,113,235,10,10,20,2,2:34
415889,2015-09-21,2015,HOU,ANA,6,3,6-3,HOU,9,true,35,37,72,151,150,301,14,11,25,4,3:02
415891,2015-09-21,2015,NYN,ATL,4,0,4-0,NYN,9,true,37,34,71,125,163,288,18,7,25,2,2:51
415895,2015-09-21,2015,CHN,MIL,9,5,9-5,CHN,9,true,43,37,80,151,151,302,21,9,30,2,3:08
415897,2015-09-21,2015,COL,PIT,3,9,9-3,PIT,9,false,40,45,85,150,146,296,15,18,33,5,3:25
415898,2015-09-21,2015,BOS,TBA,8,7,8-7,BOS,9,true,41,45,86,162,170,332,17,20,37,5,3:47
414769,2015-09-21,2015,DET,CHA,0,2,2-0,CHA,9,false,28,32,60,122,88,210,1,9,10,0,2:12
415893,2015-09-21,2015,DET,CHA,2,3,3-2,CHA,9,false,35,35,70,138,153,291,9,10,19,1,2:55
415890,2015-09-21,2015,LAN,ARI,4,8,8-4,ARI,9,false,40,49,89,146,155,301,14,22,36,5,3:23
415896,2015-09-21,2015,TOR,NYA,4,2,4-2,TOR,9,true,38,35,73,156,158,314,15,7,22,4,3:15
415906,2015-09-22,2015,CHN,MIL,4,0,4-0,CHN,9,true,33,31,64,123,119,242,10,4,14,0,2:22
415900,2015-09-22,2015,LAN,ARI,0,8,8-0,ARI,9,false,34,37,71,143,137,280,8,12,20,3,2:55
415903,2015-09-22,2015,DET,CHA,2,1,2-1,DET,10,false,37,32,69,131,154,285,11,3,14,1,2:55
415911,2015-09-22,2015,SDN,SFN,2,4,4-2,SFN,9,false,38,36,74,171,163,334,12,12,24,2,3:38
415902,2015-09-22,2015,WAS,BAL,1,4,4-1,BAL,9,false,37,37,74,137,159,296,9,9,18,2,2:51
415913,2015-09-22,2015,OAK,TEX,6,8,8-6,TEX,9,false,41,44,85,179,153,332,13,16,29,4,3:38
415912,2015-09-22,2015,BOS,TBA,2,5,5-2,TBA,9,false,35,36,71,121,135,256,11,11,22,3,2:43
415901,2015-09-22,2015,NYN,ATL,2,6,6-2,ATL,9,false,36,37,73,136,137,273,8,12,20,3,2:56
415905,2015-09-22,2015,MIN,CLE,3,1,3-1,MIN,9,true,37,34,71,129,152,281,13,7,20,1,2:47
415908,2015-09-22,2015,MIA,PHI,2,6,6-2,PHI,9,false,33,43,76,173,110,283,10,16,26,1,2:43
415910,2015-09-22,2015,KCA,SEA,2,11,11-2,SEA,9,false,37,44,81,170,132,302,9,19,28,1,2:50
415904,2015-09-22,2015,SLN,CIN,3,1,3-1,SLN,9,true,35,37,72,147,158,305,13,14,27,1,3:06
415899,2015-09-22,2015,HOU,ANA,3,4,4-3,ANA,9,false,41,35,76,140,160,300,17,9,26,6,3:21
415909,2015-09-22,2015,COL,PIT,3,6,6-3,PIT,9,false,34,45,79,169,129,298,9,19,28,3,3:22
415907,2015-09-22,2015,TOR,NYA,4,6,6-4,NYA,10,false,42,46,88,182,158,340,15,18,33,4,3:39
415921,2015-09-23,2015,CHN,MIL,1,4,4-1,MIL,9,false,31,37,68,129,132,261,5,10,15,4,2:38
415928,2015-09-23,2015,OAK,TEX,3,10,10-3,TEX,9,false,36,40,76,157,141,298,9,15,24,1,2:52
415923,2015-09-23,2015,MIA,PHI,4,3,4-3,MIA,11,false,46,40,86,146,172,318,16,9,25,2,3:20
415925,2015-09-23,2015,KCA,SEA,4,3,4-3,KCA,10,false,48,40,88,176,182,358,21,10,31,5,3:44
415924,2015-09-23,2015,COL,PIT,7,13,13-7,PIT,9,false,40,52,92,206,125,331,13,25,38,4,3:38
415920,2015-09-23,2015,MIN,CLE,4,2,4-2,MIN,9,true,36,31,67,114,139,253,14,7,21,3,2:46
415915,2015-09-23,2015,LAN,ARI,4,1,4-1,LAN,9,true,31,31,62,105,121,226,7,5,12,3,2:32
415922,2015-09-23,2015,TOR,NYA,4,0,4-0,TOR,9,true,37,33,70,119,156,275,13,7,20,2,2:52
415919,2015-09-23,2015,SLN,CIN,10,2,10-2,SLN,9,true,40,32,72,126,144,270,17,6,23,1,2:48
415917,2015-09-23,2015,WAS,BAL,3,4,4-3,BAL,9,false,35,39,74,151,138,289,9,13,22,2,3:03
415927,2015-09-23,2015,BOS,TBA,2,6,6-2,TBA,9,false,40,43,83,153,161,314,13,17,30,8,3:30
415916,2015-09-23,2015,NYN,ATL,3,6,6-3,ATL,9,false,37,38,75,119,129,248,12,14,26,3,2:45
415926,2015-09-23,2015,SDN,SFN,5,4,5-4,SDN,9,false,42,35,77,156,163,319,18,9,27,6,3:36
415914,2015-09-23,2015,HOU,ANA,5,6,6-5,ANA,9,false,40,41,81,164,175,339,15,14,29,7,3:53
415918,2015-09-23,2015,DET,CHA,7,4,7-4,DET,9,true,35,35,70,140,142,282,14,10,24,1,2:58
415931,2015-09-24,2015,MIN,CLE,3,6,6-3,CLE,9,false,37,42,79,157,122,279,12,17,29,6,3:00
415937,2015-09-24,2015,SDN,SFN,5,4,5-4,SDN,9,false,36,40,76,150,145,295,12,17,29,6,3:33
415934,2015-09-24,2015,MIA,PHI,1,0,1-0,MIA,9,true,30,33,63,130,104,234,6,8,14,1,2:34
415938,2015-09-24,2015,BOS,TBA,2,4,4-2,TBA,9,false,31,36,67,136,122,258,6,12,18,1,2:39
415930,2015-09-24,2015,NYA,CHA,3,2,3-2,NYA,9,true,33,39,72,149,120,269,9,14,23,2,2:46
415933,2015-09-24,2015,CIN,NYN,4,6,6-4,NYN,9,false,38,40,78,163,132,295,12,13,25,2,3:04
415935,2015-09-24,2015,COL,PIT,4,5,5-4,PIT,9,false,39,40,79,147,139,286,13,15,28,1,2:58
415929,2015-09-24,2015,LAN,ARI,6,3,6-3,LAN,9,true,40,36,76,156,152,308,16,9,25,4,3:21
415892,2015-09-24,2015,WAS,BAL,4,5,5-4,BAL,9,false,39,39,78,163,152,315,16,14,30,2,3:05
415892,2015-09-24,2015,WAS,BAL,4,5,5-4,BAL,9,false,39,39,78,163,152,315,16,14,30,2,3:05
415936,2015-09-24,2015,KCA,SEA,10,4,10-4,KCA,9,true,44,38,82,138,182,320,22,12,34,5,3:23
415939,2015-09-24,2015,OAK,TEX,1,8,8-1,TEX,9,false,34,46,80,193,131,324,10,20,30,1,3:20
415932,2015-09-24,2015,SLN,MIL,7,3,7-3,SLN,9,true,37,38,75,157,142,299,16,12,28,2,3:03
415949,2015-09-25,2015,WAS,PHI,2,8,8-2,PHI,9,false,35,39,74,149,127,276,8,12,20,0,2:30
415950,2015-09-25,2015,CHN,PIT,2,3,3-2,PIT,9,false,36,34,70,139,141,280,10,7,17,1,3:01
415947,2015-09-25,2015,DET,MIN,6,4,6-4,DET,9,true,37,34,71,128,164,292,15,6,21,3,3:16
415942,2015-09-25,2015,BOS,BAL,7,0,7-0,BOS,9,true,35,30,65,116,148,264,12,3,15,3,2:42
415953,2015-09-25,2015,TOR,TBA,5,3,5-3,TOR,9,true,40,33,73,109,171,280,16,6,22,2,2:44
415943,2015-09-25,2015,NYA,CHA,2,5,5-2,CHA,9,false,37,39,76,149,134,283,14,14,28,4,3:10
415944,2015-09-25,2015,KCA,CLE,0,6,6-0,CLE,9,false,29,41,70,169,113,282,3,14,17,1,2:43
415952,2015-09-25,2015,OAK,SFN,5,4,5-4,OAK,9,true,35,38,73,146,125,271,11,13,24,2,2:49
415946,2015-09-25,2015,SLN,MIL,3,4,4-3,MIL,9,false,37,35,72,125,143,268,11,10,21,4,3:19
415940,2015-09-25,2015,SDN,ARI,3,6,6-3,ARI,9,false,36,36,72,125,151,276,9,9,18,2,2:57
415951,2015-09-25,2015,ANA,SEA,8,4,8-4,ANA,9,true,39,40,79,149,130,279,16,14,30,4,3:09
415945,2015-09-25,2015,COL,LAN,7,4,7-4,COL,9,true,37,39,76,171,135,306,12,14,26,2,3:12
415948,2015-09-25,2015,CIN,NYN,5,12,12-5,NYN,9,false,39,43,82,158,147,305,12,16,28,4,3:15
415954,2015-09-25,2015,HOU,TEX,2,6,6-2,TEX,9,false,40,42,82,159,158,317,13,16,29,6,3:49
415941,2015-09-25,2015,MIA,ATL,12,11,12-11,MIA,9,true,41,45,86,179,137,316,22,20,42,5,3:19
415955,2015-09-26,2015,SDN,ARI,3,0,3-0,SDN,9,true,34,31,65,107,138,245,10,5,15,2,2:56
415966,2015-09-26,2015,ANA,SEA,3,2,3-2,ANA,9,false,34,35,69,138,125,263,11,10,21,3,2:53
415965,2015-09-26,2015,CHN,PIT,0,4,4-0,PIT,9,false,34,40,74,160,126,286,7,12,19,3,2:58
415958,2015-09-26,2015,NYA,CHA,2,1,2-1,NYA,9,true,34,32,66,120,157,277,13,6,19,1,2:44
415960,2015-09-26,2015,COL,LAN,8,6,8-6,COL,9,false,39,36,75,130,126,256,18,12,30,3,2:59
415961,2015-09-26,2015,SLN,MIL,5,1,5-1,SLN,9,true,35,33,68,110,145,255,13,7,20,0,2:35
415959,2015-09-26,2015,KCA,CLE,5,9,9-5,CLE,9,false,36,40,76,172,114,286,10,14,24,4,3:03
415956,2015-09-26,2015,MIA,ATL,6,2,6-2,MIA,9,true,38,37,75,133,146,279,18,11,29,4,2:55
415962,2015-09-26,2015,DET,MIN,2,6,6-2,MIN,9,false,37,37,74,128,155,283,12,11,23,0,3:02
415957,2015-09-26,2015,BOS,BAL,8,0,8-0,BOS,9,true,40,36,76,135,174,309,13,10,23,5,2:56
415969,2015-09-26,2015,HOU,TEX,9,7,9-7,HOU,9,true,40,41,81,158,137,295,15,15,30,4,3:21
415968,2015-09-26,2015,TOR,TBA,10,8,10-8,TOR,9,true,42,39,81,148,163,311,18,11,29,5,3:17
415963,2015-09-26,2015,CIN,NYN,2,10,10-2,NYN,9,false,40,42,82,174,138,312,14,17,31,1,2:57
415964,2015-09-26,2015,WAS,PHI,2,1,2-1,WAS,12,false,48,44,92,178,185,363,16,11,27,2,3:50
415967,2015-09-26,2015,OAK,SFN,10,14,14-10,SFN,9,false,46,49,95,160,151,311,19,24,43,9,3:32
415981,2015-09-27,2015,ANA,SEA,3,2,3-2,ANA,9,true,31,32,63,130,98,228,9,7,16,3,2:34
415970,2015-09-27,2015,SDN,ARI,2,4,4-2,ARI,9,false,36,41,77,154,161,315,11,16,27,2,3:24
415979,2015-09-27,2015,WAS,PHI,5,12,12-5,PHI,9,false,36,48,84,169,134,303,10,21,31,5,3:02
415973,2015-09-27,2015,NYA,CHA,6,1,6-1,NYA,9,true,45,32,77,155,173,328,20,8,28,3,3:20
415975,2015-09-27,2015,COL,LAN,12,5,12-5,COL,9,true,43,44,87,162,134,296,20,18,38,5,3:21
415976,2015-09-27,2015,SLN,MIL,4,8,8-4,MIL,9,false,40,42,82,138,159,297,14,17,31,2,3:10
415972,2015-09-27,2015,BOS,BAL,2,0,2-0,BOS,9,true,30,34,64,133,119,252,9,6,15,2,2:28
415980,2015-09-27,2015,CHN,PIT,4,0,4-0,CHN,9,true,36,29,65,112,135,247,13,3,16,3,2:52
415974,2015-09-27,2015,KCA,CLE,3,0,3-0,KCA,9,true,33,30,63,123,141,264,10,4,14,2,2:53
415984,2015-09-27,2015,HOU,TEX,4,2,4-2,HOU,9,true,33,32,65,149,121,270,9,5,14,1,3:01
415983,2015-09-27,2015,TOR,TBA,5,4,5-4,TOR,9,false,38,34,72,123,149,272,13,8,21,3,2:55
415971,2015-09-27,2015,MIA,ATL,9,5,9-5,MIA,9,true,39,39,78,127,144,271,12,17,29,3,2:50
415977,2015-09-27,2015,DET,MIN,1,7,7-1,MIN,9,false,36,41,77,160,134,294,10,15,25,1,2:57
415978,2015-09-27,2015,CIN,NYN,1,8,8-1,NYN,9,false,35,44,79,164,138,302,8,14,22,1,2:49
415982,2015-09-27,2015,OAK,SFN,4,5,5-4,SFN,9,false,37,41,78,135,147,282,12,13,25,6,3:11
414387,2015-09-28,2015,CHN,KCA,1,0,1-0,CHN,11,false,34,38,72,154,134,288,5,7,12,1,2:49
414922,2015-09-28,2015,WAS,CIN,5,1,5-1,WAS,9,true,37,32,69,119,139,258,14,6,20,0,2:37
415992,2015-09-28,2015,BAL,TOR,3,4,4-3,TOR,9,false,32,37,69,139,103,242,5,12,17,3,2:36
415987,2015-09-28,2015,SEA,HOU,2,3,3-2,HOU,9,false,31,37,68,154,131,285,6,12,18,3,2:55
414922,2015-09-28,2015,WAS,CIN,5,1,5-1,WAS,9,true,37,32,69,119,139,258,14,6,20,0,2:37
415991,2015-09-28,2015,PIT,SLN,0,3,3-0,SLN,9,false,43,32,75,105,190,295,17,7,24,1,3:34
415990,2015-09-28,2015,ANA,OAK,5,4,5-4,ANA,9,false,35,38,73,152,138,290,13,12,25,6,3:23
415988,2015-09-28,2015,SFN,LAN,3,2,3-2,SFN,12,false,45,46,91,147,163,310,15,11,26,6,3:59
415989,2015-09-28,2015,CLE,MIN,2,4,4-2,MIN,9,false,33,38,71,142,124,266,6,12,18,2,2:59
415985,2015-09-28,2015,NYA,BOS,1,5,5-1,BOS,9,false,38,38,76,128,146,274,11,13,24,4,2:56
414387,2015-09-28,2015,CHN,KCA,1,0,1-0,CHN,11,false,34,38,72,154,134,288,5,7,12,1,2:49
415986,2015-09-28,2015,TEX,DET,4,7,7-4,DET,9,false,40,46,86,181,167,348,14,20,34,2,3:37
416007,2015-09-29,2015,ATL,WAS,2,1,2-1,ATL,9,true,29,34,63,125,119,244,7,10,17,2,2:30
416000,2015-09-29,2015,TBA,MIA,4,2,4-2,TBA,9,true,34,35,69,124,122,246,9,10,19,1,2:27
415993,2015-09-29,2015,NYA,BOS,4,10,10-4,BOS,9,false,36,41,77,156,130,286,9,14,23,0,2:57
416003,2015-09-29,2015,PHI,NYN,4,3,4-3,PHI,9,true,34,42,76,156,111,267,12,14,26,2,2:46
415994,2015-09-29,2015,CIN,CHN,1,4,4-1,CHN,9,false,31,44,75,169,121,290,4,17,21,2,2:48 (2:31 delay)
416004,2015-09-29,2015,ANA,OAK,8,1,8-1,ANA,9,true,40,34,74,136,154,290,17,7,24,2,2:53
415997,2015-09-29,2015,SEA,HOU,6,4,6-4,SEA,9,true,36,38,74,152,160,312,12,10,22,5,3:10
415999,2015-09-29,2015,SFN,LAN,0,8,8-0,LAN,9,false,29,42,71,168,104,272,2,13,15,2,2:43
415998,2015-09-29,2015,CHA,KCA,4,2,4-2,CHA,9,true,35,36,71,142,155,297,13,10,23,1,2:48
416001,2015-09-29,2015,SDN,MIL,3,4,4-3,MIL,9,false,36,36,72,143,137,280,11,11,22,1,2:56
415996,2015-09-29,2015,TEX,DET,7,6,7-6,TEX,9,true,39,38,77,150,165,315,14,12,26,4,3:13
415995,2015-09-29,2015,ARI,COL,4,3,4-3,ARI,11,false,43,43,86,162,165,327,13,13,26,3,3:31
416016,2015-09-30,2015,SDN,MIL,0,5,5-0,MIL,9,false,34,40,74,150,140,290,11,15,26,1,3:00
416006,2015-09-30,2015,BAL,TOR,8,1,8-1,BAL,9,true,36,32,68,119,141,260,12,7,19,2,2:23
416002,2015-09-30,2015,CLE,MIN,10,2,10-2,CLE,9,true,39,36,75,131,145,276,16,9,25,2,2:52
416022,2015-09-30,2015,ATL,WAS,2,0,2-0,ATL,9,true,32,34,66,123,99,222,8,10,18,0,2:12
416005,2015-09-30,2015,PIT,SLN,8,2,8-2,PIT,9,true,38,34,72,127,151,278,16,8,24,0,2:44
416014,2015-09-30,2015,SFN,LAN,5,0,5-0,SFN,9,true,33,30,63,104,145,249,12,5,17,2,2:35
416006,2015-09-30,2015,BAL,TOR,8,1,8-1,BAL,9,true,36,32,68,119,141,260,12,7,19,2,2:23
416005,2015-09-30,2015,PIT,SLN,8,2,8-2,PIT,9,true,38,34,72,127,151,278,16,8,24,0,2:44
416011,2015-09-30,2015,TEX,DET,6,2,6-2,TEX,9,true,34,36,70,139,141,280,12,13,25,4,3:13
416017,2015-09-30,2015,CLE,MIN,1,7,7-1,MIN,9,false,36,39,75,153,148,301,10,13,23,2,3:05
416015,2015-09-30,2015,TBA,MIA,6,4,6-4,TBA,9,true,37,38,75,155,134,289,15,13,28,4,2:53
416002,2015-09-30,2015,CLE,MIN,10,2,10-2,CLE,9,true,39,36,75,131,145,276,16,9,25,2,2:52
416012,2015-09-30,2015,SEA,HOU,6,7,7-6,HOU,9,false,41,41,82,152,132,284,15,16,31,7,3:29
416010,2015-09-30,2015,ARI,COL,3,1,3-1,ARI,9,true,38,36,74,147,143,290,14,10,24,5,2:58
416013,2015-09-30,2015,CHA,KCA,3,5,5-3,KCA,10,false,44,41,85,137,176,313,15,9,24,0,3:13
416020,2015-09-30,2015,PIT,SLN,1,11,11-1,SLN,9,false,32,46,78,173,117,290,7,20,27,2,2:55
416009,2015-09-30,2015,CIN,CHN,3,10,10-3,CHN,9,false,32,46,78,178,132,310,5,20,25,2,3:00
416018,2015-09-30,2015,PHI,NYN,7,5,7-5,PHI,9,true,39,39,78,172,170,342,16,12,28,9,3:59
416021,2015-09-30,2015,BAL,TOR,2,15,15-2,TOR,9,false,35,55,90,210,125,335,9,28,37,3,3:17
416008,2015-09-30,2015,NYA,BOS,5,9,9-5,BOS,11,false,53,48,101,200,215,415,24,14,38,6,4:10
416019,2015-09-30,2015,ANA,OAK,7,8,8-7,OAK,9,false,43,42,85,182,163,345,19,13,32,8,3:39
416032,2015-10-01,2015,PHI,NYN,3,0,3-0,PHI,9,true,30,33,63,141,113,254,6,7,13,1,2:23
416031,2015-10-01,2015,CLE,MIN,2,4,4-2,MIN,9,false,34,34,68,140,138,278,8,9,17,2,2:47
416029,2015-10-01,2015,TBA,MIA,4,1,4-1,TBA,9,true,39,34,73,119,132,251,16,7,23,1,2:29
416028,2015-10-01,2015,SFN,LAN,2,3,3-2,LAN,9,false,32,37,69,153,102,255,5,10,15,2,2:33
416030,2015-10-01,2015,SDN,MIL,3,1,3-1,SDN,9,true,33,33,66,144,154,298,13,7,20,1,3:05
416034,2015-10-01,2015,ATL,WAS,0,3,3-0,WAS,9,false,35,34,69,132,144,276,9,7,16,2,2:47
416025,2015-10-01,2015,CIN,CHN,3,5,5-3,CHN,9,false,39,37,76,146,150,296,12,11,23,3,2:55
416026,2015-10-01,2015,ARI,COL,8,6,8-6,ARI,9,true,37,40,77,136,139,275,15,14,29,2,3:10
416024,2015-10-01,2015,NYA,BOS,4,1,4-1,NYA,9,true,34,36,70,163,142,305,13,12,25,0,3:10
416023,2015-10-01,2015,TEX,ANA,5,3,5-3,TEX,9,true,37,35,72,140,148,288,16,9,25,5,3:14
416027,2015-10-01,2015,CHA,KCA,4,6,6-4,KCA,9,false,37,42,79,145,159,304,12,17,29,3,3:21
416033,2015-10-01,2015,BAL,TOR,6,4,6-4,BAL,9,true,42,38,80,157,164,321,18,14,32,5,3:12 (3:25 delay)
416040,2015-10-02,2015,CHA,DET,2,1,2-1,CHA,9,true,30,33,63,117,94,211,8,7,15,1,2:13
416035,2015-10-02,2015,TEX,ANA,1,2,2-1,ANA,9,false,34,33,67,128,125,253,6,7,13,1,2:49
416036,2015-10-02,2015,CLE,BOS,8,2,8-2,CLE,9,true,41,34,75,135,165,300,19,9,28,2,3:00
416047,2015-10-02,2015,ATL,SLN,4,0,4-0,ATL,9,true,40,35,75,152,150,302,15,9,24,2,2:58
416048,2015-10-02,2015,TBA,TOR,4,8,8-4,TOR,9,false,35,44,79,173,138,311,10,18,28,5,3:07
416041,2015-10-02,2015,ARI,HOU,5,21,21-5,HOU,9,false,41,57,98,214,168,382,15,28,43,1,3:52
416038,2015-10-02,2015,PIT,CIN,6,4,6-4,PIT,12,false,47,51,98,203,212,415,13,14,27,3,4:23
416045,2015-10-02,2015,SEA,OAK,2,4,4-2,OAK,9,false,35,37,72,133,127,260,10,11,21,0,2:45
416046,2015-10-02,2015,LAN,SDN,6,2,6-2,LAN,9,true,34,33,67,120,132,252,11,7,18,1,2:32
416042,2015-10-02,2015,MIN,KCA,1,3,3-1,KCA,9,false,33,40,73,161,127,288,8,13,21,3,2:55
416037,2015-10-02,2015,MIL,CHN,1,6,6-1,CHN,9,false,33,41,74,170,117,287,5,16,21,3,3:01
416039,2015-10-02,2015,SFN,COL,3,9,9-3,COL,9,false,38,38,76,132,158,290,11,11,22,3,3:00 (:11 delay)
416049,2015-10-03,2015,NYN,WAS,1,3,3-1,WAS,9,false,35,34,69,138,155,293,9,8,17,2,2:44
416049,2015-10-03,2015,NYN,WAS,1,3,3-1,WAS,9,false,35,34,69,138,155,293,9,8,17,2,2:44
416059,2015-10-03,2015,BAL,NYA,4,3,4-3,BAL,9,true,32,36,68,146,114,260,10,11,21,0,2:31
416044,2015-10-03,2015,BAL,NYA,9,2,9-2,BAL,9,true,45,37,82,158,167,325,22,10,32,3,3:15
416044,2015-10-03,2015,BAL,NYA,9,2,9-2,BAL,9,true,45,37,82,158,167,325,22,10,32,3,3:15
416043,2015-10-03,2015,PHI,MIA,2,5,5-2,MIA,9,false,35,39,74,140,112,252,9,15,24,0,2:35
416061,2015-10-03,2015,LAN,SDN,2,1,2-1,LAN,9,true,27,34,61,120,96,216,6,7,13,0,2:10
416064,2015-10-03,2015,NYN,WAS,0,2,2-0,WAS,9,false,28,34,62,130,109,239,0,6,6,0,2:14
416050,2015-10-03,2015,TEX,ANA,10,11,11-10,ANA,9,false,43,47,90,199,169,368,16,22,38,10,4:06
416051,2015-10-03,2015,CLE,BOS,2,0,2-0,CLE,9,true,34,31,65,120,131,251,10,6,16,2,2:41 (:30 delay)
416052,2015-10-03,2015,MIL,CHN,0,1,1-0,CHN,9,false,29,40,69,150,118,268,3,13,16,0,2:49
416057,2015-10-03,2015,MIN,KCA,1,5,5-1,KCA,9,false,36,40,76,157,128,285,10,13,23,3,3:01
416043,2015-10-03,2015,PHI,MIA,2,5,5-2,MIA,9,false,35,39,74,140,112,252,9,15,24,0,2:35
416054,2015-10-03,2015,SFN,COL,3,2,3-2,SFN,9,true,31,34,65,151,111,262,9,8,17,3,2:50
416063,2015-10-03,2015,TBA,TOR,4,3,4-3,TBA,9,false,34,38,72,141,136,277,8,12,20,4,3:00
416055,2015-10-03,2015,CHA,DET,4,3,4-3,CHA,9,false,39,38,77,132,177,309,13,12,25,2,3:15
416056,2015-10-03,2015,ARI,HOU,2,6,6-2,HOU,9,false,35,43,78,175,113,288,9,16,25,3,3:26
416058,2015-10-03,2015,PHI,MIA,6,7,7-6,MIA,9,false,41,43,84,171,170,341,15,16,31,3,3:19
416053,2015-10-03,2015,PIT,CIN,1,3,3-1,CIN,9,false,34,35,69,139,137,276,7,10,17,3,3:01
416060,2015-10-03,2015,SEA,OAK,5,7,7-5,OAK,13,false,51,58,109,228,188,416,13,22,35,3,4:31
416077,2015-10-04,2015,ATL,SLN,6,0,6-0,ATL,9,true,32,35,67,128,112,240,9,8,17,1,2:14
416062,2015-10-04,2015,ATL,SLN,2,0,2-0,ATL,9,true,32,30,62,107,130,237,11,5,16,1,2:19
416075,2015-10-04,2015,SEA,OAK,3,2,3-2,SEA,9,true,34,34,68,144,124,268,11,9,20,1,2:45
416067,2015-10-04,2015,MIL,CHN,1,3,3-1,CHN,9,false,31,37,68,159,110,269,5,12,17,0,2:44
416065,2015-10-04,2015,TEX,ANA,9,2,9-2,TEX,9,true,39,33,72,108,160,268,15,6,21,4,2:53
416070,2015-10-04,2015,CHA,DET,0,6,6-0,DET,9,false,32,42,74,169,123,292,5,15,20,0,2:45
416076,2015-10-04,2015,LAN,SDN,6,3,6-3,LAN,9,true,39,36,75,142,153,295,16,9,25,4,3:02
416069,2015-10-04,2015,SFN,COL,3,7,7-3,COL,9,false,40,39,79,132,136,268,16,11,27,6,3:05
416078,2015-10-04,2015,TBA,TOR,12,3,12-3,TBA,9,true,38,40,78,164,165,329,14,15,29,3,3:09
416072,2015-10-04,2015,MIN,KCA,1,6,6-1,KCA,9,false,40,44,84,166,174,340,13,17,30,2,3:11
416062,2015-10-04,2015,ATL,SLN,2,0,2-0,ATL,9,true,32,30,62,107,130,237,11,5,16,1,2:19
416066,2015-10-04,2015,CLE,BOS,3,1,3-1,CLE,9,true,33,37,70,160,118,278,11,10,21,3,2:46
416068,2015-10-04,2015,PIT,CIN,4,0,4-0,PIT,9,true,37,34,71,137,151,288,14,9,23,0,3:03
416079,2015-10-04,2015,NYN,WAS,1,0,1-0,NYN,9,true,30,31,61,144,134,278,8,4,12,1,2:34
416071,2015-10-04,2015,ARI,HOU,5,3,5-3,ARI,9,true,39,39,78,158,144,302,14,14,28,4,3:19
416074,2015-10-04,2015,BAL,NYA,9,4,9-4,BAL,9,true,41,42,83,152,187,339,19,15,34,7,3:39
416073,2015-10-04,2015,PHI,MIA,7,2,7-2,PHI,9,true,38,36,74,135,124,259,16,9,25,2,2:29