API Key,Date,Year,Home Team,Away Team,Home Score,Away Score,Final Score,Winning Team,# Innings,End Top Inning?,Home Team PA #,Away Team PA #,Total Number PA,Homne Team # Pitches,Away Team # Pitches,Total # Pitches,Home Team Baserunners,Away Team Baserunners,Total # Baserunners,Pitching Changes,Time
446877,2016-04-03,2016,PIT,SLN,4,1,4-1,PIT,9,true,36,38,74,141,144,285,15,11,26,0,3:02
446873,2016-04-03,2016,KCA,NYN,4,3,4-3,KCA,9,true,33,39,72,177,114,291,11,13,24,2,3:13
446911,2016-04-03,2016,TBA,TOR,3,5,5-3,TOR,9,false,36,38,74,158,118,276,8,10,18,2,2:51
452866,2016-04-03,2016,ANA,CHN,6,4,6-4,ANA,9,true,36,33,69,128,124,252,11,8,19,1,2:33
446878,2016-04-04,2016,TBA,TOR,3,5,5-3,TOR,9,false,39,36,75,140,140,280,12,9,21,3,2:58
446874,2016-04-04,2016,CIN,PHI,6,2,6-2,CIN,9,true,33,34,67,134,133,267,10,7,17,4,2:56
446871,2016-04-04,2016,SDN,LAN,0,15,15-0,LAN,9,false,33,49,82,180,139,319,6,23,29,2,3:10
446876,2016-04-04,2016,TEX,SEA,3,2,3-2,TEX,9,true,34,34,68,133,120,253,8,8,16,0,2:38
446889,2016-04-04,2016,ANA,CHN,0,9,9-0,CHN,9,false,30,44,74,188,109,297,4,19,23,0,3:08
446868,2016-04-04,2016,OAK,CHA,3,4,4-3,CHA,9,false,36,36,72,159,133,292,10,10,20,3,2:56
446872,2016-04-04,2016,BAL,MIN,3,2,3-2,BAL,9,false,41,35,76,128,150,278,15,8,23,2,2:48 (2:51 delay)
446879,2016-04-04,2016,ATL,WAS,3,4,4-3,WAS,10,false,38,43,81,169,155,324,10,13,23,3,3:23
446875,2016-04-04,2016,MIL,SFN,3,12,12-3,SFN,9,false,37,46,83,187,165,352,13,20,33,1,3:35
446869,2016-04-04,2016,ARI,COL,5,10,10-5,COL,9,false,42,47,89,200,162,362,15,20,35,4,4:11
446884,2016-04-05,2016,SDN,LAN,0,3,3-0,LAN,9,false,29,35,64,132,115,247,2,8,10,0,2:36
446880,2016-04-05,2016,ANA,CHN,1,6,6-1,CHN,9,false,32,36,68,124,119,243,4,9,13,3,2:34
446896,2016-04-05,2016,KCA,NYN,0,2,2-0,NYN,9,false,32,38,70,157,124,281,4,11,15,1,2:51
446870,2016-04-05,2016,NYA,HOU,3,5,5-3,HOU,9,false,33,38,71,161,137,298,8,10,18,2,3:17
446881,2016-04-05,2016,OAK,CHA,4,5,5-4,CHA,9,false,39,40,79,144,150,294,12,13,25,5,3:28
446886,2016-04-05,2016,TEX,SEA,2,10,10-2,SEA,9,false,39,42,81,144,161,305,13,17,30,2,3:30
446867,2016-04-05,2016,CLE,BOS,2,6,6-2,BOS,9,false,35,43,78,166,146,312,8,18,26,2,3:13
446883,2016-04-05,2016,MIA,DET,7,8,8-7,DET,11,false,46,47,93,168,180,348,14,16,30,0,3:47
446885,2016-04-05,2016,MIL,SFN,1,2,2-1,SFN,9,false,32,35,67,109,122,231,6,10,16,1,2:29
446867,2016-04-05,2016,CLE,BOS,2,6,6-2,BOS,9,false,35,43,78,166,146,312,8,18,26,2,3:13
446882,2016-04-05,2016,ARI,COL,11,6,11-6,ARI,9,true,44,36,80,129,168,297,20,10,30,2,3:14
446910,2016-04-05,2016,PIT,SLN,6,5,6-5,PIT,11,false,44,45,89,167,174,341,14,13,27,1,3:27
446870,2016-04-05,2016,NYA,HOU,3,5,5-3,HOU,9,false,33,38,71,161,137,298,8,10,18,2,3:17
446887,2016-04-05,2016,TBA,TOR,3,2,3-2,TBA,9,true,31,40,71,174,112,286,8,13,21,4,3:07
446897,2016-04-06,2016,CIN,PHI,3,2,3-2,CIN,9,false,33,33,66,123,123,246,8,7,15,0,2:23
446901,2016-04-06,2016,TBA,TOR,5,3,5-3,TBA,9,true,35,35,70,153,126,279,12,9,21,3,2:47
446890,2016-04-06,2016,OAK,CHA,2,1,2-1,OAK,9,true,34,35,69,139,121,260,10,10,20,0,2:54
446902,2016-04-06,2016,ATL,WAS,1,3,3-1,WAS,9,false,34,36,70,132,126,258,11,11,22,1,2:53
446899,2016-04-06,2016,TEX,SEA,5,9,9-5,SEA,9,false,35,43,78,170,131,301,9,20,29,3,2:56
446891,2016-04-06,2016,ARI,COL,3,4,4-3,COL,9,false,38,32,70,112,130,242,10,8,18,3,2:39
446898,2016-04-06,2016,MIL,SFN,4,3,4-3,MIL,9,true,38,35,73,143,150,293,16,11,27,4,3:19
446894,2016-04-06,2016,SDN,LAN,0,7,7-0,LAN,9,false,32,40,72,171,121,292,5,14,19,0,2:57
446900,2016-04-06,2016,PIT,SLN,5,1,5-1,PIT,9,true,39,33,72,145,160,305,18,6,24,4,3:08
446888,2016-04-06,2016,CLE,BOS,7,6,7-6,CLE,9,true,38,40,78,158,159,317,15,13,28,5,3:29 (:12 delay)
446895,2016-04-06,2016,BAL,MIN,4,2,4-2,BAL,9,true,38,38,76,175,151,326,16,11,27,1,3:11
446892,2016-04-06,2016,MIA,DET,3,7,7-3,DET,9,false,40,43,83,190,160,350,15,17,32,3,3:22
446893,2016-04-06,2016,NYA,HOU,16,6,16-6,NYA,9,true,49,40,89,143,234,377,24,14,38,3,3:45
446908,2016-04-07,2016,BAL,MIN,4,2,4-2,BAL,9,true,31,34,65,133,124,257,8,9,17,1,2:32 (:21 delay)
446906,2016-04-07,2016,NYA,HOU,8,5,8-5,NYA,9,true,37,36,73,153,137,290,13,9,22,1,3:00 (:12 delay)
446907,2016-04-07,2016,SFN,LAN,12,6,12-6,SFN,9,true,43,39,82,126,137,263,20,13,33,4,3:07
446904,2016-04-07,2016,ARI,CHN,6,14,14-6,CHN,9,false,36,52,88,195,124,319,10,25,35,3,3:29
446917,2016-04-07,2016,WAS,MIA,4,6,6-4,MIA,9,false,42,43,85,175,174,349,15,17,32,2,3:32 (1:25 delay)
446905,2016-04-07,2016,OAK,CHA,1,6,6-1,CHA,9,false,35,40,75,161,139,300,7,11,18,3,3:06
448298,2016-04-07,2016,ANA,TEX,4,3,4-3,ANA,9,false,40,34,74,134,154,288,16,7,23,5,3:11
446909,2016-04-07,2016,CIN,PHI,10,6,10-6,CIN,9,true,40,41,81,148,164,312,17,15,32,2,3:04
446925,2016-04-08,2016,BAL,TBA,6,1,6-1,BAL,9,true,34,33,67,142,139,281,12,8,20,0,2:46
446914,2016-04-08,2016,CHA,CLE,1,7,7-1,CLE,9,false,32,38,70,152,133,285,8,11,19,1,2:45 (:16 delay)
446924,2016-04-08,2016,ATL,SLN,4,7,7-4,SLN,9,false,38,39,77,130,144,274,12,14,26,3,3:00
446921,2016-04-08,2016,NYN,PHI,7,2,7-2,NYN,9,true,39,34,73,130,159,289,14,8,22,4,3:09
446915,2016-04-08,2016,MIL,HOU,6,4,6-4,MIL,9,true,33,37,70,162,142,304,11,12,23,1,3:08
446922,2016-04-08,2016,CIN,PIT,5,6,6-5,PIT,9,false,39,44,83,169,155,324,13,17,30,2,3:24
446926,2016-04-08,2016,ANA,TEX,3,7,7-3,TEX,9,false,38,44,82,181,135,316,12,18,30,3,3:30
446920,2016-04-08,2016,SEA,OAK,2,3,3-2,OAK,9,false,35,37,72,147,141,288,7,10,17,1,2:55
446916,2016-04-08,2016,SFN,LAN,3,2,3-2,SFN,10,false,33,40,73,144,135,279,7,11,18,2,2:58
446923,2016-04-08,2016,COL,SDN,6,13,13-6,SDN,9,false,41,51,92,194,173,367,15,25,40,3,3:48
446919,2016-04-08,2016,DET,NYA,4,0,4-0,DET,9,true,36,32,68,133,148,281,13,7,20,1,2:44
446913,2016-04-08,2016,ARI,CHN,3,2,3-2,ARI,9,false,34,35,69,134,132,266,11,10,21,1,2:48
446918,2016-04-08,2016,KCA,MIN,4,3,4-3,KCA,9,true,37,40,77,178,145,323,13,14,27,2,3:14
446912,2016-04-08,2016,TOR,BOS,7,8,8-7,BOS,9,false,42,41,83,158,165,323,15,14,29,3,3:24
446927,2016-04-09,2016,TOR,BOS,4,8,8-4,BOS,9,false,36,43,79,165,143,308,8,15,23,0,2:48
446933,2016-04-09,2016,KCA,MIN,7,0,7-0,KCA,9,true,40,35,75,150,170,320,15,9,24,3,3:04
446928,2016-04-09,2016,ARI,CHN,2,4,4-2,CHN,9,false,32,42,74,146,124,270,5,17,22,1,2:46
446931,2016-04-09,2016,SFN,LAN,2,3,3-2,LAN,10,false,37,46,83,166,136,302,8,16,24,2,3:22
446939,2016-04-09,2016,ATL,SLN,2,12,12-2,SLN,9,false,35,53,88,212,137,349,7,24,31,1,3:30
446936,2016-04-09,2016,NYN,PHI,0,1,1-0,PHI,9,false,34,33,67,128,140,268,7,8,15,1,2:44
446941,2016-04-09,2016,ANA,TEX,1,4,4-1,TEX,9,false,32,37,69,133,141,274,8,11,19,1,2:53
446937,2016-04-09,2016,CIN,PIT,5,1,5-1,CIN,9,true,34,37,71,138,150,288,12,13,25,2,3:00
446935,2016-04-09,2016,SEA,OAK,1,6,6-1,OAK,9,false,34,38,72,145,148,293,9,12,21,0,2:54
446929,2016-04-09,2016,CHA,CLE,7,3,7-3,CHA,9,true,38,35,73,130,143,273,14,9,23,2,2:43
446934,2016-04-09,2016,DET,NYA,4,8,8-4,NYA,9,false,37,44,81,169,150,319,11,18,29,3,3:20
446930,2016-04-09,2016,MIL,HOU,4,6,6-4,HOU,9,false,37,37,74,137,154,291,11,13,24,3,3:10
446938,2016-04-09,2016,COL,SDN,3,16,16-3,SDN,9,false,39,50,89,182,140,322,11,25,36,1,3:24
446942,2016-04-10,2016,TOR,BOS,3,0,3-0,TOR,9,true,32,34,66,122,138,260,11,9,20,1,2:27
446947,2016-04-10,2016,WAS,MIA,4,2,4-2,WAS,9,true,38,33,71,125,144,269,18,9,27,2,2:52
446945,2016-04-10,2016,MIL,HOU,3,2,3-2,MIL,9,true,36,33,69,147,137,284,14,8,22,2,3:08
446955,2016-04-10,2016,BAL,TBA,5,3,5-3,BAL,9,true,32,39,71,160,126,286,11,12,23,1,2:53
446951,2016-04-10,2016,NYN,PHI,2,5,5-2,PHI,9,false,32,38,70,152,131,283,5,13,18,1,2:57
446946,2016-04-10,2016,SFN,LAN,9,6,9-6,SFN,9,true,39,41,80,136,152,288,16,14,30,3,3:07
446943,2016-04-10,2016,ARI,CHN,3,7,7-3,CHN,9,false,35,44,79,178,122,300,8,19,27,2,3:21
446952,2016-04-10,2016,CIN,PIT,2,1,2-1,CIN,9,false,33,42,75,184,116,300,12,16,28,0,3:04
446948,2016-04-10,2016,KCA,MIN,4,3,4-3,KCA,10,false,38,44,82,161,155,316,9,16,25,1,3:23
446950,2016-04-10,2016,SEA,OAK,1,2,2-1,OAK,10,false,41,38,79,154,137,291,11,8,19,0,3:03
446953,2016-04-10,2016,COL,SDN,6,3,6-3,COL,9,true,36,35,71,134,120,254,14,9,23,1,2:38
446956,2016-04-10,2016,ANA,TEX,3,1,3-1,ANA,9,true,34,35,69,118,124,242,13,9,22,1,2:43
446954,2016-04-10,2016,ATL,SLN,7,12,12-7,SLN,9,false,47,49,96,193,187,380,22,23,45,5,3:55
446966,2016-04-11,2016,PHI,SDN,3,4,4-3,SDN,9,false,33,34,67,130,137,267,9,8,17,3,2:51
446967,2016-04-11,2016,SEA,TEX,3,7,7-3,TEX,9,false,36,42,78,154,138,292,10,17,27,1,3:00
446964,2016-04-11,2016,SLN,MIL,10,1,10-1,SLN,9,true,44,36,80,141,170,311,21,10,31,1,3:00
446957,2016-04-11,2016,WAS,ATL,6,4,6-4,WAS,9,true,40,36,76,137,150,287,17,12,29,3,3:05
446960,2016-04-11,2016,CHN,CIN,5,3,5-3,CHN,9,true,36,35,71,144,149,293,11,9,20,3,3:03
446962,2016-04-11,2016,OAK,ANA,1,4,4-1,ANA,9,false,37,38,75,128,148,276,13,13,26,4,3:05
446963,2016-04-11,2016,NYN,MIA,3,10,10-3,MIA,9,false,38,47,85,205,160,365,11,20,31,3,3:45
446961,2016-04-11,2016,HOU,KCA,8,2,8-2,HOU,9,true,40,38,78,132,160,292,17,12,29,1,2:59
446959,2016-04-11,2016,MIN,CHA,1,4,4-1,CHA,9,false,34,43,77,162,133,295,9,15,24,2,3:05
446965,2016-04-11,2016,DET,PIT,4,7,7-4,PIT,9,false,34,42,76,179,130,309,8,20,28,1,3:17
446958,2016-04-11,2016,BOS,BAL,7,9,9-7,BAL,9,false,41,40,81,158,172,330,16,14,30,1,3:26
446968,2016-04-12,2016,LAN,ARI,2,4,4-2,ARI,9,false,37,40,77,156,110,266,11,15,26,1,3:00
446980,2016-04-12,2016,SEA,TEX,0,8,8-0,TEX,9,false,34,39,73,152,136,288,6,14,20,1,2:35
446972,2016-04-12,2016,HOU,KCA,2,3,3-2,KCA,9,false,38,35,73,137,179,316,14,9,23,0,3:17
446969,2016-04-12,2016,WAS,ATL,2,1,2-1,WAS,9,true,31,37,68,149,96,245,9,10,19,5,2:47
446976,2016-04-12,2016,TOR,NYA,2,3,3-2,NYA,9,false,36,38,74,151,155,306,10,11,21,2,3:03
446970,2016-04-12,2016,BOS,BAL,5,9,9-5,BAL,9,false,38,43,81,174,158,332,13,18,31,4,3:23
446974,2016-04-12,2016,NYN,MIA,1,2,2-1,MIA,9,false,35,38,73,164,154,318,10,13,23,2,3:17
446971,2016-04-12,2016,TBA,CLE,5,1,5-1,TBA,9,true,31,32,63,129,121,250,9,6,15,1,2:34
446978,2016-04-12,2016,PHI,SDN,3,0,3-0,PHI,9,true,32,35,67,135,133,268,9,9,18,2,2:58
446979,2016-04-12,2016,COL,SFN,2,7,7-2,SFN,9,false,35,39,74,131,128,259,9,14,23,0,2:44
446973,2016-04-12,2016,OAK,ANA,4,5,5-4,ANA,9,false,35,38,73,145,120,265,8,13,21,1,2:41
446977,2016-04-12,2016,DET,PIT,8,2,8-2,DET,9,true,44,34,78,148,187,335,22,9,31,1,3:16
446982,2016-04-13,2016,WAS,ATL,3,0,3-0,WAS,9,true,30,34,64,119,102,221,6,9,15,1,2:12
446986,2016-04-13,2016,TBA,CLE,1,4,4-1,CLE,9,false,32,34,66,137,112,249,6,6,12,0,2:32
446990,2016-04-13,2016,NYN,MIA,2,1,2-1,NYN,9,true,31,37,68,150,134,284,10,11,21,3,2:53
446981,2016-04-13,2016,LAN,ARI,3,1,3-1,LAN,9,true,35,33,68,128,140,268,11,9,20,3,3:12
446994,2016-04-13,2016,COL,SFN,10,6,10-6,COL,9,true,45,36,81,126,159,285,23,10,33,2,3:07
446993,2016-04-13,2016,PHI,SDN,2,1,2-1,PHI,9,true,31,36,67,147,108,255,10,8,18,0,2:36
446988,2016-04-13,2016,HOU,KCA,2,4,4-2,KCA,9,false,37,38,75,146,135,281,10,11,21,2,3:03
446984,2016-04-13,2016,MIN,CHA,0,3,3-0,CHA,9,false,36,35,71,130,151,281,10,9,19,4,2:51
446995,2016-04-13,2016,SEA,TEX,4,2,4-2,SEA,10,false,42,37,79,157,164,321,12,8,20,1,3:20
446992,2016-04-13,2016,TOR,NYA,7,2,7-2,TOR,9,true,37,36,73,142,144,286,14,11,25,0,2:43
446975,2016-04-13,2016,SLN,MIL,4,6,6-4,MIL,9,false,34,39,73,145,138,283,8,12,20,1,2:49
446985,2016-04-13,2016,CHN,CIN,9,2,9-2,CHN,9,true,43,35,78,121,188,309,19,11,30,2,3:03
446989,2016-04-13,2016,OAK,ANA,1,5,5-1,ANA,9,false,34,43,77,157,128,285,6,17,23,4,3:03
446987,2016-04-13,2016,PIT,DET,3,7,7-3,DET,9,false,34,41,75,170,142,312,9,15,24,2,3:12
446983,2016-04-13,2016,BOS,BAL,4,2,4-2,BOS,9,true,34,39,73,167,143,310,12,14,26,2,3:13
446997,2016-04-14,2016,WAS,ATL,6,2,6-2,WAS,9,true,31,33,64,114,126,240,7,7,14,1,2:29
447000,2016-04-14,2016,CHN,CIN,8,1,8-1,CHN,9,true,39,36,75,131,173,304,16,10,26,1,3:07
447005,2016-04-14,2016,PHI,SDN,3,0,3-0,PHI,9,true,32,30,62,113,142,255,8,3,11,0,2:27
447003,2016-04-14,2016,HOU,KCA,2,6,6-2,KCA,9,false,31,40,71,135,124,259,7,14,21,2,2:41
447002,2016-04-14,2016,PIT,DET,4,7,7-4,DET,9,false,43,38,81,138,178,316,17,14,31,1,3:20
446996,2016-04-14,2016,LAN,ARI,5,2,5-2,LAN,9,true,34,33,67,141,118,259,13,7,20,2,2:36
446991,2016-04-14,2016,SLN,MIL,7,0,7-0,SLN,9,true,38,29,67,104,151,255,15,2,17,0,2:29
446998,2016-04-14,2016,TEX,BAL,6,3,6-3,TEX,9,true,35,37,72,155,124,279,12,12,24,2,2:47
447004,2016-04-14,2016,TOR,NYA,4,2,4-2,TOR,9,true,35,33,68,118,121,239,11,6,17,1,2:22
447006,2016-04-14,2016,COL,SFN,11,6,11-6,COL,9,true,40,40,80,158,168,326,18,11,29,3,3:26
447001,2016-04-14,2016,TBA,CLE,0,6,6-0,CLE,9,false,34,46,80,192,154,346,8,20,28,1,3:20
446999,2016-04-14,2016,MIN,CHA,1,3,3-1,CHA,9,false,34,37,71,138,142,280,7,10,17,3,3:00
447011,2016-04-15,2016,SLN,CIN,14,3,14-3,SLN,9,true,44,35,79,111,151,262,18,8,26,0,2:31
447019,2016-04-15,2016,NYA,SEA,1,7,7-1,SEA,9,false,40,41,81,152,165,317,13,16,29,3,3:18
447012,2016-04-15,2016,CHN,COL,1,6,6-1,COL,9,false,34,41,75,144,144,288,8,16,24,2,2:59
447010,2016-04-15,2016,TBA,CHA,0,1,1-0,CHA,9,false,30,33,63,117,106,223,2,7,9,0,2:23
447013,2016-04-15,2016,HOU,DET,1,0,1-0,HOU,9,true,32,32,64,113,130,243,11,6,17,0,2:34
447018,2016-04-15,2016,LAN,SFN,7,3,7-3,LAN,9,true,37,33,70,138,130,268,11,5,16,1,2:45
447014,2016-04-15,2016,OAK,KCA,2,4,4-2,KCA,9,false,37,42,79,182,146,328,10,17,27,3,3:15
447009,2016-04-15,2016,TEX,BAL,5,11,11-5,BAL,9,false,35,40,75,168,140,308,9,16,25,2,2:47
447007,2016-04-15,2016,SDN,ARI,2,3,3-2,ARI,9,false,37,36,73,128,128,256,13,12,25,3,3:08
447015,2016-04-15,2016,MIN,ANA,5,4,5-4,MIN,9,true,36,38,74,144,160,304,13,14,27,5,3:29
447020,2016-04-15,2016,BOS,TOR,5,3,5-3,BOS,9,true,38,33,71,146,166,312,15,7,22,3,3:02
447021,2016-04-15,2016,PHI,WAS,1,9,9-1,WAS,9,false,35,46,81,172,131,303,7,19,26,1,3:11
447016,2016-04-15,2016,PIT,MIL,4,8,8-4,MIL,9,false,40,47,87,181,135,316,12,22,34,2,3:30
447008,2016-04-15,2016,MIA,ATL,3,6,6-3,ATL,9,false,43,36,79,128,145,273,18,11,29,6,3:05
447017,2016-04-15,2016,CLE,NYN,5,6,6-5,NYN,9,false,45,43,88,159,160,319,17,17,34,6,3:37
447036,2016-04-16,2016,PHI,WAS,1,8,8-1,WAS,9,false,35,37,72,129,137,266,8,12,20,0,2:37
447033,2016-04-16,2016,LAN,SFN,3,4,4-3,SFN,9,false,35,40,75,164,147,311,8,17,25,4,3:32
447024,2016-04-16,2016,TEX,BAL,8,4,8-4,TEX,9,true,39,40,79,142,144,286,19,13,32,2,2:48
447030,2016-04-16,2016,MIN,ANA,6,4,6-4,MIN,9,true,36,37,73,122,153,275,13,12,25,1,2:55
447023,2016-04-16,2016,MIA,ATL,4,6,6-4,ATL,9,false,40,38,78,110,159,269,13,12,25,3,2:55
447027,2016-04-16,2016,CHN,COL,6,2,6-2,CHN,9,true,36,32,68,119,139,258,13,8,21,2,2:39
447026,2016-04-16,2016,SLN,CIN,8,9,9-8,CIN,9,false,44,44,88,138,167,305,16,19,35,2,3:12
447029,2016-04-16,2016,OAK,KCA,5,3,5-3,OAK,9,true,39,38,77,165,141,306,15,11,26,2,3:02
447032,2016-04-16,2016,CLE,NYN,7,5,7-5,CLE,9,true,37,38,75,155,125,280,14,12,26,2,2:54
447028,2016-04-16,2016,HOU,DET,3,5,5-3,DET,9,false,34,43,77,163,134,297,10,16,26,1,3:17
447035,2016-04-16,2016,BOS,TOR,4,2,4-2,BOS,9,true,33,32,65,135,118,253,11,7,18,0,2:43
447031,2016-04-16,2016,PIT,MIL,5,0,5-0,PIT,9,true,37,33,70,138,150,288,15,8,23,0,2:52
447025,2016-04-16,2016,TBA,CHA,7,2,7-2,TBA,9,true,38,34,72,124,141,265,16,8,24,5,2:52
447034,2016-04-16,2016,NYA,SEA,2,3,3-2,SEA,9,false,43,38,81,157,175,332,16,11,27,1,3:21
447022,2016-04-16,2016,SDN,ARI,5,3,5-3,SDN,14,false,59,58,117,233,238,471,21,17,38,2,5:25
447048,2016-04-17,2016,LAN,SFN,3,1,3-1,LAN,9,true,30,33,63,129,104,233,9,9,18,2,2:42
447040,2016-04-17,2016,TBA,CHA,3,2,3-2,TBA,9,true,30,34,64,137,121,258,8,7,15,2,2:36
447037,2016-04-17,2016,SDN,ARI,3,7,7-3,ARI,9,false,35,37,72,117,131,248,9,12,21,1,2:37
447042,2016-04-17,2016,CHN,COL,0,2,2-0,COL,9,false,32,32,64,129,124,253,5,7,12,1,2:38
447047,2016-04-17,2016,CLE,NYN,0,6,6-0,NYN,9,false,32,39,71,145,115,260,5,11,16,1,2:32
447041,2016-04-17,2016,SLN,CIN,4,3,4-3,SLN,9,true,36,34,70,122,139,261,11,10,21,2,2:44
447043,2016-04-17,2016,HOU,DET,5,4,5-4,HOU,9,true,35,37,72,142,150,292,11,9,20,4,3:13
447051,2016-04-17,2016,PHI,WAS,3,2,3-2,PHI,10,false,37,40,77,157,144,301,9,13,22,2,3:24
447038,2016-04-17,2016,MIA,ATL,5,6,6-5,ATL,10,false,40,44,84,174,151,325,10,15,25,5,3:29
447045,2016-04-17,2016,MIN,ANA,3,2,3-2,MIN,12,false,51,44,95,164,183,347,20,7,27,5,4:02
447046,2016-04-17,2016,PIT,MIL,9,3,9-3,PIT,9,true,47,36,83,138,181,319,25,10,35,3,3:31
447044,2016-04-17,2016,OAK,KCA,3,2,3-2,OAK,9,true,31,35,66,136,116,252,8,8,16,1,2:37
447049,2016-04-17,2016,NYA,SEA,4,3,4-3,NYA,9,true,35,33,68,119,115,234,11,6,17,0,2:34
447050,2016-04-17,2016,BOS,TOR,3,5,5-3,TOR,9,false,35,43,78,176,136,312,8,17,25,1,3:09
447053,2016-04-18,2016,SLN,CHN,0,5,5-0,CHN,9,false,34,37,71,107,127,234,7,11,18,1,2:32
447057,2016-04-18,2016,BOS,TOR,3,4,4-3,TOR,9,false,33,38,71,166,130,296,8,16,24,3,3:12
447056,2016-04-18,2016,MIN,MIL,7,4,7-4,MIN,6,false,32,26,58,88,132,220,15,8,23,1,2:21 (2:06 delay)
447058,2016-04-18,2016,MIA,WAS,6,1,6-1,MIA,9,true,37,38,75,148,120,268,13,13,26,1,2:43
447055,2016-04-18,2016,CHA,ANA,0,7,7-0,ANA,9,false,33,41,74,171,130,301,6,15,21,1,2:58
447052,2016-04-18,2016,SFN,ARI,7,9,9-7,ARI,11,false,51,50,101,182,223,405,20,20,40,3,4:35
447054,2016-04-18,2016,CIN,COL,1,5,5-1,COL,9,false,32,36,68,141,112,253,6,10,16,2,2:41
447067,2016-04-18,2016,PHI,NYN,2,5,5-2,NYN,9,false,36,39,75,146,132,278,10,13,23,0,2:51
447070,2016-04-19,2016,CLE,SEA,3,2,3-2,CLE,9,true,36,36,72,140,133,273,15,9,24,3,2:56
447061,2016-04-19,2016,CIN,COL,4,3,4-3,CIN,9,true,33,34,67,135,129,264,11,7,18,3,2:52
447072,2016-04-19,2016,BAL,TOR,3,4,4-3,TOR,9,false,35,39,74,163,132,295,9,14,23,1,2:50
447060,2016-04-19,2016,SLN,CHN,1,2,2-1,CHN,9,false,36,38,74,159,136,295,12,12,24,1,3:20
447082,2016-04-19,2016,PHI,NYN,1,11,11-1,NYN,9,false,36,44,80,170,143,313,11,16,27,1,3:03
447065,2016-04-19,2016,ATL,LAN,8,1,8-1,ATL,9,true,40,35,75,139,138,277,15,9,24,3,2:57
447066,2016-04-19,2016,MIN,MIL,5,6,6-5,MIL,9,false,40,39,79,153,168,321,14,13,27,4,3:23
447062,2016-04-19,2016,KCA,DET,8,6,8-6,KCA,9,true,37,45,82,184,141,325,14,17,31,2,3:08
447073,2016-04-19,2016,MIA,WAS,0,7,7-0,WAS,9,false,33,39,72,134,120,254,7,13,20,2,2:38
447069,2016-04-19,2016,SDN,PIT,5,4,5-4,SDN,9,true,42,41,83,169,196,365,19,15,34,4,4:01
447064,2016-04-19,2016,CHA,ANA,5,0,5-0,CHA,9,true,35,32,67,128,141,269,12,6,18,2,2:46
447063,2016-04-19,2016,TEX,HOU,7,5,7-5,TEX,9,true,37,38,75,182,136,318,15,11,26,2,3:22
447059,2016-04-19,2016,SFN,ARI,0,3,3-0,ARI,9,false,37,40,77,148,148,296,11,16,27,2,3:08
447071,2016-04-19,2016,BOS,TBA,0,3,3-0,TBA,10,false,32,43,75,179,126,305,3,13,16,2,3:25
447068,2016-04-19,2016,NYA,OAK,2,3,3-2,OAK,11,false,43,44,87,162,169,331,11,12,23,1,3:30
447088,2016-04-20,2016,MIA,WAS,1,3,3-1,WAS,9,false,31,34,65,122,116,238,7,9,16,1,2:33
447074,2016-04-20,2016,SFN,ARI,1,2,2-1,ARI,9,false,35,34,69,118,139,257,8,9,17,2,2:54
447079,2016-04-20,2016,CHA,ANA,2,1,2-1,CHA,9,true,32,31,63,141,142,283,10,5,15,3,2:59
447075,2016-04-20,2016,SLN,CHN,5,3,5-3,SLN,9,true,35,36,71,140,123,263,13,9,22,2,2:40 (3:21 delay)
447078,2016-04-20,2016,TEX,HOU,2,1,2-1,TEX,9,true,35,37,72,144,146,290,9,13,22,3,3:10
447080,2016-04-20,2016,ATL,LAN,3,5,5-3,LAN,10,false,41,43,84,162,169,331,11,16,27,5,3:54 (:01 delay)
447087,2016-04-20,2016,BAL,TOR,4,3,4-3,BAL,10,false,38,43,81,196,169,365,14,16,30,1,3:22
447076,2016-04-20,2016,CIN,COL,6,5,6-5,CIN,9,false,34,37,71,144,129,273,9,12,21,3,2:55
447085,2016-04-20,2016,CLE,SEA,1,2,2-1,SEA,9,false,33,34,67,140,141,281,6,6,12,1,2:48
447086,2016-04-20,2016,BOS,TBA,7,3,7-3,BOS,9,true,38,36,74,138,145,283,16,9,25,2,3:02
447077,2016-04-20,2016,KCA,DET,2,3,3-2,DET,9,false,38,39,77,142,153,295,13,13,26,2,3:08
447083,2016-04-20,2016,NYA,OAK,2,5,5-2,OAK,9,false,35,39,74,149,142,291,9,15,24,1,2:57
447084,2016-04-20,2016,SDN,PIT,8,2,8-2,SDN,9,true,38,40,78,155,155,310,17,13,30,2,2:59
447096,2016-04-20,2016,PHI,NYN,5,4,5-4,PHI,11,false,45,49,94,191,173,364,15,17,32,2,4:03
447081,2016-04-20,2016,MIL,MIN,10,5,10-5,MIL,9,true,41,40,81,136,187,323,19,15,34,3,3:22
447091,2016-04-21,2016,KCA,DET,4,0,4-0,KCA,9,true,36,33,69,130,134,264,15,6,21,0,2:52
447093,2016-04-21,2016,CHA,ANA,2,3,3-2,ANA,9,false,34,36,70,133,135,268,9,14,23,0,2:48
447095,2016-04-21,2016,MIL,MIN,1,8,8-1,MIN,9,false,33,45,78,171,124,295,6,20,26,2,3:18
447090,2016-04-21,2016,CIN,CHN,0,16,16-0,CHN,9,false,29,52,81,198,119,317,4,24,28,0,2:56
447094,2016-04-21,2016,ATL,LAN,1,2,2-1,LAN,10,false,39,45,84,175,138,313,12,15,27,1,3:28
447089,2016-04-21,2016,SFN,ARI,2,6,6-2,ARI,9,false,34,39,73,129,139,268,9,14,23,4,3:10
447092,2016-04-21,2016,TEX,HOU,7,4,7-4,TEX,9,true,37,36,73,152,128,280,15,9,24,1,2:42
447098,2016-04-21,2016,SDN,PIT,1,11,11-1,PIT,9,false,33,45,78,178,141,319,6,19,25,1,3:15
447097,2016-04-21,2016,NYA,OAK,3,7,7-3,OAK,9,false,39,39,78,160,164,324,13,13,26,2,3:18
447102,2016-04-21,2016,MIA,WAS,5,1,5-1,MIA,9,true,35,32,67,123,132,255,13,5,18,0,2:38
447101,2016-04-21,2016,BAL,TOR,3,2,3-2,BAL,9,true,40,35,75,148,159,307,17,9,26,1,3:09
447099,2016-04-21,2016,CLE,SEA,7,10,10-7,SEA,10,false,42,49,91,178,168,346,14,22,36,5,3:56
447100,2016-04-21,2016,BOS,TBA,8,12,12-8,TBA,9,false,47,51,98,186,188,374,20,25,45,6,4:16
447106,2016-04-22,2016,DET,CLE,1,2,2-1,CLE,9,false,32,35,67,159,112,271,5,8,13,1,2:46
447115,2016-04-22,2016,SDN,SLN,4,1,4-1,SDN,9,true,34,35,69,137,115,252,12,9,21,0,2:35
447107,2016-04-22,2016,COL,LAN,7,5,7-5,COL,9,true,35,38,73,145,143,288,12,12,24,3,3:27
447103,2016-04-22,2016,KCA,BAL,4,2,4-2,KCA,9,true,32,33,65,141,121,262,9,6,15,0,2:31
447111,2016-04-22,2016,TOR,OAK,5,8,8-5,OAK,9,false,38,44,82,159,148,307,13,19,32,3,3:21
447104,2016-04-22,2016,HOU,BOS,2,6,6-2,BOS,9,false,39,40,79,159,167,326,13,17,30,2,3:28
447112,2016-04-22,2016,MIL,PHI,2,5,5-2,PHI,9,false,36,37,73,145,134,279,9,12,21,0,2:48
447117,2016-04-22,2016,CHA,TEX,5,0,5-0,CHA,9,true,35,31,66,119,141,260,11,7,18,1,2:41
447116,2016-04-22,2016,NYA,TBA,6,3,6-3,NYA,9,true,35,40,75,134,134,268,13,12,25,3,3:02
447105,2016-04-22,2016,CIN,CHN,1,8,8-1,CHN,9,false,32,40,72,172,123,295,7,14,21,1,3:03
447113,2016-04-22,2016,ARI,PIT,7,8,8-7,PIT,9,false,43,39,82,150,148,298,17,15,32,3,3:12
447108,2016-04-22,2016,SFN,MIA,8,1,8-1,SFN,9,true,44,34,78,136,172,308,23,8,31,2,3:09
447114,2016-04-22,2016,ANA,SEA,2,5,5-2,SEA,10,false,35,41,76,166,124,290,7,14,21,2,3:23
447110,2016-04-22,2016,ATL,NYN,3,6,6-3,NYN,9,false,40,39,79,152,167,319,13,13,26,2,3:21 (:56 delay)
447109,2016-04-22,2016,WAS,MIN,8,4,8-4,WAS,9,true,39,38,77,130,136,266,16,10,26,2,2:51
447124,2016-04-23,2016,WAS,MIN,2,0,2-0,WAS,9,true,32,33,65,148,117,265,9,6,15,1,2:39
447131,2016-04-23,2016,NYA,TBA,3,2,3-2,NYA,9,false,38,32,70,119,161,280,10,7,17,2,2:55
447122,2016-04-23,2016,COL,LAN,1,4,4-1,LAN,9,false,34,40,74,170,145,315,7,13,20,2,3:09
447126,2016-04-23,2016,TOR,OAK,9,3,9-3,TOR,9,true,39,33,72,120,149,269,16,9,25,0,2:38
447118,2016-04-23,2016,KCA,BAL,3,8,8-3,BAL,9,false,35,43,78,158,132,290,8,18,26,4,3:04
447119,2016-04-23,2016,HOU,BOS,8,3,8-3,HOU,9,true,41,38,79,144,159,303,19,11,30,3,3:28
447129,2016-04-23,2016,ANA,SEA,4,2,4-2,ANA,9,true,33,36,69,142,122,264,11,10,21,2,2:45
447125,2016-04-23,2016,ATL,NYN,2,8,8-2,NYN,9,false,37,47,84,166,138,304,11,20,31,3,3:00
447128,2016-04-23,2016,ARI,PIT,7,1,7-1,ARI,9,true,37,34,71,123,144,267,12,8,20,2,2:58
447130,2016-04-23,2016,SDN,SLN,2,11,11-2,SLN,9,false,37,45,82,183,127,310,11,21,32,3,3:06
447132,2016-04-23,2016,CHA,TEX,4,3,4-3,CHA,11,false,48,43,91,179,192,371,20,11,31,2,3:57
447120,2016-04-23,2016,CIN,CHN,13,5,13-5,CIN,9,true,40,43,83,186,164,350,20,16,36,3,3:19
447123,2016-04-23,2016,SFN,MIA,7,2,7-2,SFN,9,true,37,34,71,108,148,256,19,9,28,2,2:46
447121,2016-04-23,2016,DET,CLE,1,10,10-1,CLE,9,false,29,43,72,162,118,280,2,17,19,3,2:41
447127,2016-04-23,2016,MIL,PHI,6,10,10-6,PHI,9,false,40,47,87,200,187,387,14,20,34,2,4:00
447141,2016-04-24,2016,TOR,OAK,6,3,6-3,TOR,9,true,39,33,72,130,142,272,17,8,25,4,2:44
447142,2016-04-24,2016,MIL,PHI,8,5,8-5,MIL,9,true,36,36,72,130,141,271,12,11,23,1,2:49
447133,2016-04-24,2016,KCA,BAL,6,1,6-1,KCA,9,true,37,33,70,115,147,262,14,6,20,2,2:42
447136,2016-04-24,2016,DET,CLE,3,6,6-3,CLE,9,false,37,41,78,157,149,306,11,17,28,4,3:20
447144,2016-04-24,2016,ANA,SEA,4,9,9-4,SEA,9,false,33,39,72,145,117,262,8,13,21,3,2:43
447147,2016-04-24,2016,CHA,TEX,4,1,4-1,CHA,9,true,34,37,71,157,130,287,13,11,24,1,2:52
447140,2016-04-24,2016,ATL,NYN,2,3,3-2,NYN,9,false,38,35,73,149,132,281,12,12,24,3,2:56
447135,2016-04-24,2016,CIN,CHN,0,9,9-0,CHN,9,false,32,44,76,175,135,310,5,19,24,2,3:08
447145,2016-04-24,2016,SDN,SLN,5,8,8-5,SLN,9,false,41,46,87,183,173,356,13,20,33,1,3:35
447138,2016-04-24,2016,SFN,MIA,4,5,5-4,MIA,9,false,42,41,83,143,159,302,18,17,35,4,3:14
447134,2016-04-24,2016,HOU,BOS,5,7,7-5,BOS,12,false,53,56,109,219,218,437,16,22,38,4,5:03
447137,2016-04-24,2016,COL,LAN,10,12,12-10,LAN,9,false,47,48,95,171,171,342,21,21,42,6,4:02
447146,2016-04-24,2016,NYA,TBA,1,8,8-1,TBA,9,false,34,42,76,178,120,298,8,15,23,0,2:50
447143,2016-04-24,2016,ARI,PIT,10,12,12-10,PIT,13,false,62,64,126,249,261,510,25,29,54,2,5:25
447139,2016-04-24,2016,WAS,MIN,6,5,6-5,WAS,16,false,65,62,127,243,273,516,21,15,36,5,5:56
447153,2016-04-25,2016,SEA,HOU,3,2,3-2,SEA,9,true,33,37,70,156,134,290,11,12,23,0,2:40
447157,2016-04-25,2016,DET,OAK,7,3,7-3,DET,9,true,37,38,75,132,136,268,13,11,24,3,2:39
447155,2016-04-25,2016,LAN,MIA,2,3,3-2,MIA,9,false,36,37,73,146,136,282,9,11,20,3,2:51
447154,2016-04-25,2016,ANA,KCA,6,1,6-1,ANA,9,true,35,36,71,151,137,288,15,9,24,1,2:59
447148,2016-04-25,2016,TBA,BAL,2,0,2-0,TBA,9,true,34,32,66,122,134,256,11,5,16,4,2:37
447156,2016-04-25,2016,TEX,NYA,1,3,3-1,NYA,9,false,30,38,68,140,117,257,5,12,17,2,2:46
447149,2016-04-25,2016,ATL,BOS,0,1,1-0,BOS,9,false,33,36,69,139,134,273,7,9,16,1,2:55
447159,2016-04-25,2016,SFN,SDN,5,4,5-4,SFN,9,true,39,40,79,165,177,342,16,13,29,5,3:47
447152,2016-04-25,2016,MIN,CLE,4,3,4-3,MIN,9,false,33,40,73,172,143,315,10,16,26,4,3:24
447151,2016-04-25,2016,NYN,CIN,5,3,5-3,NYN,9,true,37,37,74,150,141,291,13,10,23,2,3:11
447160,2016-04-25,2016,ARI,SLN,12,7,12-7,ARI,9,true,46,38,84,126,176,302,24,12,36,4,3:26
447158,2016-04-25,2016,COL,PIT,1,6,6-1,PIT,9,false,39,38,77,143,153,296,12,12,24,2,2:59 (:30 delay)
447150,2016-04-25,2016,TOR,CHA,5,7,7-5,CHA,9,false,42,42,84,167,159,326,17,16,33,6,3:24
447168,2016-04-26,2016,LAN,MIA,3,6,6-3,MIA,9,false,38,40,78,150,144,294,11,13,24,2,3:02
447163,2016-04-26,2016,TOR,CHA,1,10,10-1,CHA,9,false,32,44,76,166,113,279,6,18,24,2,2:35
447175,2016-04-26,2016,ARI,SLN,2,8,8-2,SLN,9,false,33,43,76,156,122,278,7,18,25,1,2:47
447164,2016-04-26,2016,NYN,CIN,4,3,4-3,NYN,9,true,34,38,72,146,137,283,12,14,26,1,2:58
447174,2016-04-26,2016,SFN,SDN,1,0,1-0,SFN,9,true,33,32,65,119,112,231,10,8,18,0,2:28
447166,2016-04-26,2016,SEA,HOU,11,1,11-1,SEA,9,true,39,35,74,144,176,320,15,8,23,0,3:02
447171,2016-04-26,2016,DET,OAK,1,5,5-1,OAK,9,false,32,35,67,124,150,274,6,10,16,1,2:38
447161,2016-04-26,2016,TBA,BAL,3,1,3-1,TBA,9,true,35,33,68,139,141,280,13,10,23,2,2:44
447167,2016-04-26,2016,ANA,KCA,9,4,9-4,ANA,9,true,42,37,79,129,155,284,19,13,32,0,3:02
447162,2016-04-26,2016,ATL,BOS,4,11,11-4,BOS,9,false,39,43,82,153,130,283,11,18,29,1,2:52
447172,2016-04-26,2016,WAS,PHI,3,4,4-3,PHI,9,false,39,39,78,163,140,303,14,14,28,2,3:25
447169,2016-04-26,2016,CHN,MIL,4,3,4-3,CHN,9,true,38,33,71,149,167,316,13,7,20,2,3:09
447170,2016-04-26,2016,TEX,NYA,10,1,10-1,TEX,9,true,39,32,71,113,135,248,18,7,25,0,2:19
447173,2016-04-26,2016,COL,PIT,4,9,9-4,PIT,9,false,38,45,83,183,149,332,14,19,33,1,3:19
447165,2016-04-26,2016,MIN,CLE,6,5,6-5,MIN,9,false,40,33,73,125,148,273,18,6,24,2,2:52
447187,2016-04-27,2016,WAS,PHI,0,3,3-0,PHI,9,false,31,38,69,147,119,266,5,12,17,1,2:59
447179,2016-04-27,2016,NYN,CIN,5,2,5-2,NYN,9,true,37,35,72,147,138,285,11,8,19,1,2:54
447189,2016-04-27,2016,SFN,SDN,13,9,13-9,SFN,9,true,47,38,85,152,177,329,23,12,35,4,3:21
447182,2016-04-27,2016,ANA,KCA,4,2,4-2,ANA,9,true,30,38,68,148,110,258,7,13,20,2,2:51
447183,2016-04-27,2016,LAN,MIA,0,2,2-0,MIA,9,false,33,37,70,157,137,294,7,11,18,4,3:03
447181,2016-04-27,2016,SEA,HOU,4,7,7-4,HOU,9,false,40,39,79,158,171,329,14,13,27,2,3:23
447190,2016-04-27,2016,ARI,SLN,4,11,11-4,SLN,9,false,37,48,85,177,145,322,12,21,33,4,3:32
447177,2016-04-27,2016,TBA,BAL,1,3,3-1,BAL,9,false,34,32,66,137,142,279,7,5,12,1,2:43
447185,2016-04-27,2016,TEX,NYA,3,2,3-2,TEX,9,true,32,34,66,130,120,250,9,9,18,1,2:44
447178,2016-04-27,2016,TOR,CHA,0,4,4-0,CHA,9,false,34,39,73,170,136,306,7,13,20,1,2:52
447176,2016-04-27,2016,BOS,ATL,9,4,9-4,BOS,9,true,40,39,79,146,160,306,17,10,27,1,3:02
447180,2016-04-27,2016,MIN,CLE,5,6,6-5,CLE,9,false,39,41,80,185,142,327,12,15,27,4,3:32 (:35 delay)
447188,2016-04-27,2016,COL,PIT,8,9,9-8,PIT,12,false,56,54,110,250,205,455,22,19,41,3,4:58
447186,2016-04-27,2016,DET,OAK,9,4,9-4,DET,9,true,41,37,78,147,177,324,18,10,28,3,3:23
447193,2016-04-28,2016,LAN,MIA,3,5,5-3,MIA,9,false,38,38,76,135,146,281,13,11,24,2,2:51
447198,2016-04-28,2016,ARI,SLN,3,0,3-0,ARI,9,true,32,33,65,123,131,254,10,6,16,0,2:25
447191,2016-04-28,2016,BOS,ATL,3,5,5-3,ATL,9,false,39,42,81,142,146,288,13,18,31,4,3:22
447196,2016-04-28,2016,WAS,PHI,0,3,3-0,PHI,9,false,33,35,68,142,126,268,7,10,17,2,2:59 (:36 delay)
447195,2016-04-28,2016,DET,OAK,7,3,7-3,DET,9,true,39,41,80,162,156,318,16,15,31,3,3:04
447194,2016-04-28,2016,CHN,MIL,7,2,7-2,CHN,9,true,45,39,84,181,199,380,21,13,34,2,3:45
447192,2016-04-28,2016,BAL,CHA,10,2,10-2,BAL,9,true,42,40,82,162,165,327,19,13,32,2,3:10
447202,2016-04-29,2016,PHI,CLE,4,3,4-3,PHI,11,false,40,41,81,179,143,322,14,10,24,2,3:20
447199,2016-04-29,2016,CHN,ATL,6,1,6-1,CHN,9,true,35,34,69,125,135,260,15,9,24,2,2:38
447201,2016-04-29,2016,PIT,CIN,4,1,4-1,PIT,9,true,32,34,66,137,128,265,11,7,18,1,2:41
447212,2016-04-29,2016,TBA,TOR,1,6,6-1,TOR,9,false,37,37,74,152,140,292,11,11,22,2,2:43
447210,2016-04-29,2016,LAN,SDN,1,5,5-1,SDN,9,false,37,37,74,141,140,281,11,11,22,2,3:01
447204,2016-04-29,2016,MIN,DET,2,9,9-2,DET,9,false,36,45,81,151,157,308,9,22,31,3,3:09
447209,2016-04-29,2016,BOS,NYA,4,2,4-2,BOS,9,true,33,33,66,123,120,243,8,10,18,1,2:50
447206,2016-04-29,2016,SEA,KCA,1,0,1-0,SEA,9,true,31,34,65,137,137,274,8,9,17,2,2:49
447213,2016-04-29,2016,SLN,WAS,4,5,5-4,WAS,9,false,37,35,72,125,133,258,12,9,21,0,2:46
447207,2016-04-29,2016,TEX,ANA,4,2,4-2,TEX,9,true,32,35,67,101,132,233,11,11,22,2,2:35
447205,2016-04-29,2016,OAK,HOU,7,4,7-4,OAK,9,false,35,36,71,157,134,291,13,12,25,4,3:13
447208,2016-04-29,2016,MIL,MIA,3,6,6-3,MIA,9,false,38,38,76,152,162,314,10,15,25,2,3:02
447203,2016-04-29,2016,ARI,COL,0,9,9-0,COL,9,false,33,43,76,173,163,336,9,16,25,2,3:21
447200,2016-04-29,2016,BAL,CHA,6,3,6-3,BAL,9,true,34,34,68,131,116,247,11,9,20,0,2:30
447211,2016-04-29,2016,NYN,SFN,13,1,13-1,NYN,9,true,42,41,83,177,169,346,18,15,33,1,3:17
447218,2016-04-30,2016,ARI,COL,2,5,5-2,COL,9,false,33,41,74,144,143,287,8,18,26,1,3:16
447221,2016-04-30,2016,SEA,KCA,6,0,6-0,SEA,9,true,39,32,71,114,155,269,17,6,23,1,2:28
447219,2016-04-30,2016,MIN,DET,1,4,4-1,DET,9,false,34,36,70,150,138,288,8,9,17,2,2:51
447225,2016-04-30,2016,LAN,SDN,2,5,5-2,SDN,9,false,35,41,76,167,143,310,10,14,24,2,3:06
447227,2016-04-30,2016,TBA,TOR,4,3,4-3,TBA,9,false,36,36,72,153,138,291,13,9,22,3,2:52
447217,2016-04-30,2016,PHI,CLE,4,3,4-3,PHI,9,true,33,37,70,140,126,266,10,10,20,3,3:03
447226,2016-04-30,2016,NYN,SFN,6,5,6-5,NYN,9,true,35,39,74,176,136,312,13,13,26,3,3:09
447228,2016-04-30,2016,SLN,WAS,1,6,6-1,WAS,9,false,37,39,76,132,141,273,10,13,23,2,3:02
447224,2016-04-30,2016,BOS,NYA,8,0,8-0,BOS,9,true,44,33,77,129,204,333,20,6,26,2,3:30
447216,2016-04-30,2016,PIT,CIN,5,1,5-1,PIT,9,true,41,37,78,146,164,310,18,9,27,3,3:17
447223,2016-04-30,2016,MIL,MIA,5,7,7-5,MIA,9,false,35,51,86,197,147,344,9,24,33,3,3:24
447220,2016-04-30,2016,OAK,HOU,2,0,2-0,OAK,9,true,32,32,64,122,125,247,8,8,16,1,2:27
447222,2016-04-30,2016,TEX,ANA,7,2,7-2,TEX,9,true,38,35,73,142,133,275,13,9,22,1,2:55
447215,2016-04-30,2016,BAL,CHA,7,8,8-7,CHA,9,false,43,41,84,169,154,323,19,14,33,5,3:42
447241,2016-05-01,2016,NYN,SFN,1,6,6-1,SFN,9,false,40,36,76,146,156,302,14,11,25,4,3:19
447242,2016-05-01,2016,TBA,TOR,1,5,5-1,TOR,9,false,33,33,66,143,118,261,6,9,15,2,2:34
447240,2016-05-01,2016,LAN,SDN,1,0,1-0,LAN,9,true,28,29,57,101,118,219,6,3,9,1,2:07
447232,2016-05-01,2016,PHI,CLE,2,1,2-1,PHI,9,true,27,33,60,151,110,261,6,8,14,0,2:40
447243,2016-05-01,2016,SLN,WAS,1,6,6-1,WAS,9,false,33,38,71,136,136,272,6,11,17,2,2:47
447239,2016-05-01,2016,BOS,NYA,8,7,8-7,BOS,9,true,40,38,78,133,138,271,17,12,29,2,3:17
447229,2016-05-01,2016,CHN,ATL,3,4,4-3,ATL,10,false,40,38,78,129,164,293,10,10,20,3,3:04
447234,2016-05-01,2016,MIN,DET,5,6,6-5,DET,9,false,40,39,79,155,168,323,14,14,28,3,3:33
447231,2016-05-01,2016,PIT,CIN,5,6,6-5,CIN,11,false,46,46,92,173,177,350,16,15,31,3,3:42
447238,2016-05-01,2016,MIL,MIA,14,5,14-5,MIL,9,true,44,43,87,152,167,319,22,18,40,3,3:21
447233,2016-05-01,2016,ARI,COL,3,6,6-3,COL,9,false,40,39,79,153,143,296,13,12,25,5,3:23
447237,2016-05-01,2016,TEX,ANA,6,9,9-6,ANA,9,false,41,45,86,174,156,330,16,20,36,2,3:33
447230,2016-05-01,2016,BAL,CHA,1,7,7-1,CHA,9,false,40,46,86,161,176,337,14,21,35,4,3:07
447235,2016-05-01,2016,OAK,HOU,1,2,2-1,HOU,9,false,36,36,72,163,122,285,9,10,19,3,2:50
447236,2016-05-01,2016,SEA,KCA,1,4,4-1,KCA,9,false,38,39,77,162,167,329,12,13,25,1,3:14
447251,2016-05-02,2016,OAK,SEA,3,4,4-3,SEA,9,false,34,38,72,133,121,254,8,13,21,4,2:45
447253,2016-05-02,2016,KCA,WAS,0,2,2-0,WAS,9,false,34,36,70,137,140,277,8,11,19,2,3:09
447246,2016-05-02,2016,SDN,COL,2,1,2-1,SDN,9,true,32,35,67,154,132,286,10,12,22,1,3:01
447245,2016-05-02,2016,PIT,CHN,2,7,7-2,CHN,9,false,36,45,81,173,137,310,11,18,29,2,3:18
447250,2016-05-02,2016,CIN,SFN,6,9,9-6,SFN,9,false,36,45,81,167,147,314,10,19,29,4,3:17
447252,2016-05-02,2016,TOR,TEX,1,2,2-1,TEX,9,false,36,36,72,126,154,280,11,11,22,2,2:44
447249,2016-05-02,2016,SLN,PHI,10,3,10-3,SLN,9,true,42,36,78,141,146,287,18,9,27,1,3:01
447247,2016-05-02,2016,MIL,ANA,8,5,8-5,MIL,9,true,39,42,81,149,144,293,19,15,34,2,3:30
447248,2016-05-02,2016,HOU,MIN,2,6,6-2,MIN,9,false,37,38,75,150,151,301,11,13,24,3,3:08
447244,2016-05-02,2016,NYN,ATL,4,1,4-1,NYN,9,true,35,35,70,111,156,267,14,9,23,2,2:31
447255,2016-05-03,2016,NYN,ATL,0,3,3-0,ATL,9,false,30,38,68,139,117,256,4,11,15,1,2:38
447264,2016-05-03,2016,SLN,PHI,0,1,1-0,PHI,9,false,31,33,64,110,144,254,4,8,12,0,2:31
447263,2016-05-03,2016,BAL,NYA,4,1,4-1,BAL,9,true,33,36,69,139,129,268,7,11,18,0,2:43
447256,2016-05-03,2016,CHA,BOS,4,1,4-1,CHA,9,true,35,30,65,115,158,273,13,4,17,1,2:53
447258,2016-05-03,2016,SDN,COL,6,3,6-3,SDN,9,true,34,33,67,146,123,269,11,8,19,1,2:46
447260,2016-05-03,2016,MIL,ANA,5,4,5-4,MIL,9,true,35,35,70,116,139,255,12,12,24,0,2:41
447262,2016-05-03,2016,HOU,MIN,6,4,6-4,HOU,9,true,33,35,68,151,147,298,9,9,18,2,3:01
447254,2016-05-03,2016,MIA,ARI,7,4,7-4,MIA,9,true,38,38,76,132,156,288,14,12,26,2,3:11
447257,2016-05-03,2016,PIT,CHN,1,7,7-1,CHN,9,false,33,43,76,142,135,277,6,17,23,0,2:31
447265,2016-05-03,2016,CIN,SFN,1,3,3-1,SFN,9,false,32,40,72,174,132,306,6,16,22,1,3:05
447259,2016-05-03,2016,CLE,DET,7,3,7-3,CLE,9,true,36,39,75,163,137,300,14,14,28,1,3:12
447268,2016-05-03,2016,KCA,WAS,7,6,7-6,KCA,9,false,38,40,78,164,133,297,13,13,26,3,3:05
447261,2016-05-03,2016,TBA,LAN,5,10,10-5,LAN,9,false,40,43,83,163,155,318,13,16,29,5,3:11
447266,2016-05-03,2016,OAK,SEA,2,8,8-2,SEA,9,false,33,40,73,131,108,239,8,14,22,2,2:38
447267,2016-05-03,2016,TOR,TEX,3,1,3-1,TOR,10,false,42,38,80,144,189,333,16,8,24,3,3:25
447274,2016-05-04,2016,CLE,DET,4,0,4-0,CLE,9,true,30,32,62,111,115,226,9,7,16,0,2:19
447271,2016-05-04,2016,CHA,BOS,2,5,5-2,BOS,9,false,31,39,70,154,121,275,6,15,21,1,2:46
447279,2016-05-04,2016,SLN,PHI,5,4,5-4,SLN,9,false,39,34,73,119,138,257,16,7,23,2,3:03
447282,2016-05-04,2016,TOR,TEX,4,3,4-3,TOR,9,false,35,37,72,130,135,265,10,11,21,0,2:32
447280,2016-05-04,2016,CIN,SFN,7,4,7-4,CIN,9,true,35,38,73,151,122,273,11,12,23,1,2:42
447269,2016-05-04,2016,MIA,ARI,4,3,4-3,MIA,9,true,34,38,72,162,129,291,11,13,24,1,2:48
447283,2016-05-04,2016,KCA,WAS,2,13,13-2,WAS,9,false,34,47,81,168,129,297,7,18,25,1,2:53
447276,2016-05-04,2016,TBA,LAN,8,5,8-5,TBA,9,true,36,41,77,187,140,327,12,15,27,4,3:21
447281,2016-05-04,2016,OAK,SEA,8,9,9-8,SEA,9,false,40,47,87,160,147,307,12,20,32,3,3:10
447277,2016-05-04,2016,HOU,MIN,16,4,16-4,HOU,9,true,46,38,84,150,171,321,21,11,32,3,3:23
447272,2016-05-04,2016,PIT,CHN,2,6,6-2,CHN,9,false,39,43,82,158,157,315,13,18,31,2,3:25
447270,2016-05-04,2016,NYN,ATL,8,0,8-0,NYN,9,true,38,31,69,127,156,283,14,4,18,2,2:28
447275,2016-05-04,2016,MIL,ANA,3,7,7-3,ANA,9,false,39,42,81,164,166,330,13,18,31,2,3:28
447273,2016-05-04,2016,SDN,COL,0,2,2-0,COL,9,false,30,36,66,134,112,246,4,12,16,1,2:36
447278,2016-05-04,2016,BAL,NYA,0,7,7-0,NYA,9,false,35,42,77,161,144,305,11,16,27,2,3:16
447292,2016-05-05,2016,HOU,SEA,3,6,6-3,SEA,9,false,36,41,77,167,136,303,12,16,28,2,3:13
447290,2016-05-05,2016,BAL,NYA,1,0,1-0,BAL,10,false,35,33,68,134,119,253,9,5,14,2,2:50
447287,2016-05-05,2016,CLE,DET,9,4,9-4,CLE,9,true,41,35,76,149,146,295,19,7,26,2,2:54
447291,2016-05-05,2016,SLN,PHI,4,0,4-0,SLN,9,true,33,32,65,123,127,250,12,5,17,2,2:39
447284,2016-05-05,2016,MIA,ARI,4,0,4-0,MIA,9,true,35,33,68,129,144,273,12,7,19,3,2:47
447293,2016-05-05,2016,TOR,TEX,12,2,12-2,TOR,9,true,42,36,78,120,142,262,22,10,32,1,2:33
447289,2016-05-05,2016,SDN,NYN,5,3,5-3,SDN,9,true,36,33,69,122,145,267,13,6,19,2,2:39
447285,2016-05-05,2016,CHA,BOS,3,7,7-3,BOS,9,false,41,44,85,181,179,360,17,19,36,3,3:57
447294,2016-05-05,2016,CHN,WAS,5,2,5-2,CHN,9,true,35,34,69,139,137,276,13,9,22,4,3:05
447288,2016-05-05,2016,CIN,MIL,9,5,9-5,CIN,9,true,37,36,73,141,139,280,12,12,24,1,2:47
447286,2016-05-05,2016,SFN,COL,7,17,17-7,COL,9,false,43,48,91,164,149,313,18,19,37,3,3:25
447304,2016-05-06,2016,MIA,PHI,6,4,6-4,MIA,9,true,35,39,74,137,121,258,12,15,27,0,2:49
447296,2016-05-06,2016,NYA,BOS,3,2,3-2,NYA,9,true,31,41,72,175,112,287,9,15,24,2,3:10
447309,2016-05-06,2016,CHN,WAS,8,6,8-6,CHN,9,true,36,38,74,143,128,271,14,12,26,1,2:46
447305,2016-05-06,2016,SLN,PIT,2,4,4-2,PIT,9,false,37,37,74,133,130,263,10,11,21,1,2:54
447308,2016-05-06,2016,DET,TEX,1,5,5-1,TEX,9,false,31,38,69,120,132,252,4,11,15,0,2:31
447297,2016-05-06,2016,SFN,COL,6,4,6-4,SFN,9,true,36,36,72,133,133,266,12,9,21,1,2:40
447299,2016-05-06,2016,TOR,LAN,5,2,5-2,TOR,9,true,35,38,73,134,157,291,13,13,26,2,2:53
447298,2016-05-06,2016,CLE,KCA,7,1,7-1,CLE,9,true,37,36,73,137,151,288,16,10,26,1,2:44
447306,2016-05-06,2016,HOU,SEA,6,3,6-3,HOU,9,true,37,33,70,122,141,263,13,8,21,2,2:46
447302,2016-05-06,2016,SDN,NYN,2,0,2-0,SDN,9,true,32,34,66,160,134,294,10,8,18,1,3:00
447307,2016-05-06,2016,ANA,TBA,2,5,5-2,TBA,9,false,39,40,79,138,148,286,13,18,31,4,3:06
447295,2016-05-06,2016,ATL,ARI,2,7,7-2,ARI,9,false,34,42,76,174,133,307,11,17,28,2,3:18
447300,2016-05-06,2016,CIN,MIL,5,1,5-1,CIN,9,true,32,39,71,161,131,292,9,14,23,1,2:52
447301,2016-05-06,2016,CHA,MIN,10,4,10-4,CHA,9,true,42,37,79,142,149,291,18,12,30,1,2:54
447317,2016-05-07,2016,SDN,NYN,3,6,6-3,NYN,9,false,36,42,78,159,124,283,9,18,27,1,2:52
447321,2016-05-07,2016,HOU,SEA,2,3,3-2,SEA,10,false,40,41,81,151,164,315,10,12,22,5,3:27
447318,2016-05-07,2016,BAL,OAK,5,2,5-2,BAL,9,true,35,35,70,115,128,243,12,10,22,1,2:32
447313,2016-05-07,2016,CLE,KCA,0,7,7-0,KCA,9,false,33,38,71,135,127,262,8,13,21,2,2:41
447314,2016-05-07,2016,TOR,LAN,2,6,6-2,LAN,9,false,33,36,69,118,142,260,9,9,18,0,2:28
447310,2016-05-07,2016,ATL,ARI,2,4,4-2,ARI,9,false,34,42,76,186,117,303,8,16,24,0,3:17
447311,2016-05-07,2016,NYA,BOS,8,2,8-2,NYA,9,true,38,32,70,119,164,283,15,7,22,1,3:09
447323,2016-05-07,2016,DET,TEX,5,10,10-5,TEX,9,false,44,38,82,143,167,310,19,12,31,5,3:14
447322,2016-05-07,2016,ANA,TBA,2,4,4-2,TBA,9,false,34,38,72,163,123,286,9,10,19,1,3:06
447315,2016-05-07,2016,CIN,MIL,7,13,13-7,MIL,10,false,42,49,91,171,156,327,13,18,31,2,3:38
447320,2016-05-07,2016,SLN,PIT,6,4,6-4,SLN,9,false,37,41,78,162,149,311,13,13,26,1,3:23
447316,2016-05-07,2016,CHA,MIN,7,2,7-2,CHA,9,true,42,35,77,148,173,321,21,8,29,3,2:58
447312,2016-05-07,2016,SFN,COL,2,1,2-1,SFN,13,false,48,50,98,181,184,365,12,15,27,5,4:20
447303,2016-05-07,2016,BAL,OAK,4,8,8-4,OAK,9,false,40,45,85,175,167,342,12,20,32,4,3:17
447303,2016-05-07,2016,BAL,OAK,4,8,8-4,OAK,9,false,40,45,85,175,167,342,12,20,32,4,3:17
447319,2016-05-07,2016,MIA,PHI,3,4,4-3,PHI,9,false,36,34,70,144,153,297,11,8,19,3,3:20
447324,2016-05-07,2016,CHN,WAS,8,5,8-5,CHN,9,true,43,38,81,153,178,331,21,13,34,5,3:32
447326,2016-05-08,2016,NYA,BOS,1,5,5-1,BOS,9,false,29,34,63,144,101,245,4,9,13,1,2:27
447336,2016-05-08,2016,HOU,SEA,5,1,5-1,HOU,9,true,36,33,69,133,149,282,13,6,19,1,2:57
447327,2016-05-08,2016,SFN,COL,0,2,2-0,COL,9,false,34,35,69,138,144,282,11,10,21,2,2:55
447331,2016-05-08,2016,CHA,MIN,3,1,3-1,CHA,9,true,32,36,68,141,113,254,9,10,19,0,2:30
447325,2016-05-08,2016,ATL,ARI,3,5,5-3,ARI,11,false,48,43,91,186,182,368,18,10,28,2,3:48
447329,2016-05-08,2016,TOR,LAN,2,4,4-2,LAN,9,false,34,41,75,167,141,308,6,14,20,4,3:10
447339,2016-05-08,2016,CHN,WAS,4,3,4-3,CHN,13,false,54,63,117,233,215,448,19,26,45,1,4:54
447334,2016-05-08,2016,MIA,PHI,5,6,6-5,PHI,9,false,39,39,78,125,166,291,13,12,25,1,3:10
447330,2016-05-08,2016,CIN,MIL,4,5,5-4,MIL,9,false,35,38,73,161,138,299,9,12,21,1,3:09 (1:55 delay)
447332,2016-05-08,2016,SDN,NYN,3,4,4-3,NYN,9,false,36,42,78,177,155,332,10,16,26,2,3:30
447338,2016-05-08,2016,DET,TEX,3,8,8-3,TEX,9,false,39,45,84,165,157,322,11,19,30,2,3:25
447328,2016-05-08,2016,CLE,KCA,5,4,5-4,CLE,9,true,37,34,71,117,151,268,12,10,22,3,2:57
447335,2016-05-08,2016,SLN,PIT,5,10,10-5,PIT,9,false,41,45,86,193,161,354,15,19,34,4,3:27
447337,2016-05-08,2016,ANA,TBA,1,3,3-1,TBA,9,false,32,36,68,157,119,276,8,11,19,3,2:56
447333,2016-05-08,2016,BAL,OAK,11,3,11-3,BAL,9,true,41,38,79,138,164,302,19,12,31,4,2:59
447343,2016-05-09,2016,HOU,CLE,7,1,7-1,HOU,9,true,37,32,69,119,141,260,13,5,18,2,2:49
447345,2016-05-09,2016,NYA,KCA,6,3,6-3,NYA,9,true,34,38,72,150,121,271,10,12,22,3,2:41
447351,2016-05-09,2016,SEA,TBA,5,2,5-2,SEA,9,true,39,35,74,133,156,289,15,9,24,3,3:05
447344,2016-05-09,2016,WAS,DET,5,4,5-4,WAS,9,false,36,37,73,132,119,251,12,13,25,5,2:57
447352,2016-05-09,2016,SFN,TOR,1,3,3-1,TOR,9,false,36,40,76,171,133,304,9,13,22,0,2:52
447340,2016-05-09,2016,COL,ARI,5,10,10-5,ARI,9,false,42,43,85,144,165,309,16,17,33,0,3:23
447346,2016-05-09,2016,MIA,MIL,4,1,4-1,MIA,9,true,38,37,75,168,141,309,17,13,30,1,3:07
447349,2016-05-09,2016,CIN,PIT,3,2,3-2,CIN,9,true,32,36,68,132,129,261,12,9,21,1,2:37
447342,2016-05-09,2016,TEX,CHA,4,8,8-4,CHA,12,false,50,53,103,187,172,359,14,20,34,3,3:58
447348,2016-05-09,2016,BOS,OAK,14,7,14-7,BOS,9,true,44,41,85,170,177,347,20,14,34,1,3:46
447347,2016-05-09,2016,LAN,NYN,2,4,4-2,NYN,9,false,36,39,75,163,149,312,8,15,23,5,3:08
447362,2016-05-10,2016,ATL,PHI,2,3,3-2,PHI,9,false,34,38,72,122,129,251,8,11,19,0,2:33
447353,2016-05-10,2016,COL,ARI,1,5,5-1,ARI,9,false,33,42,75,144,117,261,5,18,23,2,3:08
447365,2016-05-10,2016,ANA,SLN,1,8,8-1,SLN,9,false,36,45,81,180,131,311,8,18,26,2,2:57
447367,2016-05-10,2016,SFN,TOR,0,4,4-0,TOR,9,false,34,35,69,129,122,251,10,9,19,1,2:29
447355,2016-05-10,2016,TEX,CHA,13,11,13-11,TEX,9,true,43,46,89,186,152,338,21,20,41,5,3:22 (1:18 delay)
447366,2016-05-10,2016,SEA,TBA,6,4,6-4,SEA,9,true,34,36,70,165,124,289,11,9,20,3,2:46
447354,2016-05-10,2016,MIN,BAL,3,5,5-3,BAL,9,false,35,41,76,163,146,309,8,17,25,0,3:01
447356,2016-05-10,2016,HOU,CLE,0,4,4-0,CLE,9,false,33,35,68,137,138,275,8,11,19,1,2:38
447357,2016-05-10,2016,WAS,DET,4,5,5-4,DET,9,false,41,40,81,152,173,325,18,13,31,1,3:16
447361,2016-05-10,2016,BOS,OAK,13,5,13-5,BOS,9,true,44,42,86,151,140,291,21,16,37,3,3:07
447358,2016-05-10,2016,NYA,KCA,10,7,10-7,NYA,9,true,41,38,79,125,181,306,18,11,29,1,3:07
447364,2016-05-10,2016,CHN,SDN,8,7,8-7,CHN,9,true,39,40,79,162,154,316,18,12,30,3,3:13
447360,2016-05-10,2016,LAN,NYN,3,2,3-2,LAN,9,false,36,34,70,137,134,271,12,8,20,1,2:52
447359,2016-05-10,2016,MIA,MIL,2,10,10-2,MIL,9,false,37,49,86,194,142,336,11,21,32,1,3:17
447377,2016-05-11,2016,ATL,PHI,5,1,5-1,ATL,9,true,36,30,66,107,131,238,12,4,16,1,2:20
447372,2016-05-11,2016,WAS,DET,3,2,3-2,WAS,9,true,33,33,66,119,129,248,13,6,19,1,2:38
447374,2016-05-11,2016,MIA,MIL,3,2,3-2,MIA,9,true,29,36,65,134,110,244,6,11,17,1,2:29
447375,2016-05-11,2016,LAN,NYN,3,4,4-3,NYN,9,false,34,40,74,166,107,273,8,14,22,2,3:04
447378,2016-05-11,2016,CIN,PIT,4,5,5-4,PIT,9,false,35,38,73,149,114,263,9,12,21,2,3:04
447379,2016-05-11,2016,CHN,SDN,0,1,1-0,SDN,9,false,36,30,66,121,164,285,9,3,12,1,2:45
447380,2016-05-11,2016,ANA,SLN,2,5,5-2,SLN,9,false,34,36,70,139,131,270,7,11,18,2,3:00
447370,2016-05-11,2016,TEX,CHA,6,5,6-5,TEX,9,true,38,41,79,175,139,314,16,14,30,2,3:07
447373,2016-05-11,2016,NYA,KCA,3,7,7-3,KCA,9,false,38,43,81,176,138,314,11,18,29,2,3:18
447376,2016-05-11,2016,BOS,OAK,13,3,13-3,BOS,9,true,46,39,85,144,168,312,23,12,35,3,3:17
447369,2016-05-11,2016,MIN,BAL,2,9,9-2,BAL,9,false,36,43,79,166,131,297,10,18,28,1,2:54
447368,2016-05-11,2016,COL,ARI,8,7,8-7,COL,9,true,42,39,81,146,168,314,17,13,30,5,3:19
447350,2016-05-11,2016,CHN,SDN,4,7,7-4,SDN,9,false,43,44,87,172,171,343,18,18,36,2,3:15
447381,2016-05-11,2016,SEA,TBA,6,5,6-5,SEA,11,false,44,50,94,202,191,393,15,17,32,5,4:01
447350,2016-05-11,2016,CHN,SDN,4,7,7-4,SDN,9,false,43,44,87,172,171,343,18,18,36,2,3:15
447371,2016-05-11,2016,HOU,CLE,5,3,5-3,HOU,16,false,68,61,129,222,267,489,24,15,39,5,5:09
447382,2016-05-11,2016,SFN,TOR,5,4,5-4,SFN,13,false,58,57,115,224,206,430,22,20,42,4,4:28
447384,2016-05-12,2016,BOS,HOU,11,1,11-1,BOS,9,true,41,35,76,133,146,279,17,8,25,1,2:56
447386,2016-05-12,2016,LAN,NYN,5,0,5-0,LAN,9,true,32,30,62,109,113,222,8,4,12,0,2:13
447390,2016-05-12,2016,ANA,SLN,10,12,12-10,SLN,9,false,45,51,96,203,164,367,19,24,43,7,3:56
447387,2016-05-12,2016,ATL,PHI,4,7,7-4,PHI,10,false,37,43,80,168,123,291,10,15,25,4,3:14 (:10 delay)
447389,2016-05-12,2016,ARI,SFN,2,4,4-2,SFN,9,false,40,37,77,135,153,288,14,11,25,2,3:13
447385,2016-05-12,2016,NYA,KCA,7,3,7-3,NYA,9,true,36,37,73,140,136,276,12,11,23,1,2:45
447388,2016-05-12,2016,MIL,SDN,0,3,3-0,SDN,9,false,33,35,68,115,143,258,10,9,19,0,2:51
447383,2016-05-12,2016,BAL,DET,7,5,7-5,BAL,9,true,39,44,83,162,153,315,15,18,33,4,3:16
447394,2016-05-13,2016,BAL,DET,1,0,1-0,BAL,9,true,29,33,62,125,112,237,7,8,15,0,2:39
447403,2016-05-13,2016,ARI,SFN,1,3,3-1,SFN,9,false,33,34,67,142,128,270,8,12,20,2,3:00
447393,2016-05-13,2016,PHI,CIN,3,2,3-2,PHI,9,true,32,31,63,119,119,238,12,6,18,0,2:37
447405,2016-05-13,2016,TEX,TOR,0,5,5-0,TOR,9,false,30,40,70,172,120,292,4,13,17,2,2:38
447396,2016-05-13,2016,SEA,ANA,6,7,7-6,ANA,9,false,45,43,88,148,177,325,20,17,37,2,3:41
447397,2016-05-13,2016,WAS,MIA,5,3,5-3,WAS,9,true,37,38,75,151,156,307,15,11,26,4,3:19
447391,2016-05-13,2016,KCA,ATL,5,1,5-1,KCA,9,true,36,35,71,111,143,254,13,7,20,1,2:45
447392,2016-05-13,2016,NYA,CHA,1,7,7-1,CHA,9,false,33,44,77,176,99,275,6,17,23,1,2:45
447402,2016-05-13,2016,MIL,SDN,1,0,1-0,MIL,9,true,34,31,65,125,149,274,14,5,19,0,2:56
447400,2016-05-13,2016,TBA,OAK,3,6,6-3,OAK,9,false,40,40,80,173,168,341,13,15,28,0,3:07
447398,2016-05-13,2016,CLE,MIN,7,6,7-6,CLE,9,true,36,41,77,162,139,301,12,14,26,4,3:07
447395,2016-05-13,2016,BOS,HOU,6,7,7-6,HOU,9,false,40,43,83,189,165,354,16,17,33,5,3:49
447401,2016-05-13,2016,CHN,PIT,9,4,9-4,CHN,9,true,38,40,78,152,153,305,15,15,30,3,2:55
447399,2016-05-13,2016,COL,NYN,5,2,5-2,COL,9,true,36,35,71,139,130,269,14,8,22,1,2:48
447404,2016-05-13,2016,LAN,SLN,8,4,8-4,LAN,9,true,41,39,80,140,147,287,14,13,27,4,3:01
446932,2016-05-14,2016,WAS,MIA,6,4,6-4,WAS,9,true,41,40,81,158,156,314,17,14,31,2,3:22
447418,2016-05-14,2016,ARI,SFN,3,5,5-3,SFN,9,false,38,41,79,140,130,270,10,16,26,3,3:05
446932,2016-05-14,2016,WAS,MIA,6,4,6-4,WAS,9,true,41,40,81,158,156,314,17,14,31,2,3:22
447419,2016-05-14,2016,LAN,SLN,5,3,5-3,LAN,9,true,33,35,68,123,133,256,10,6,16,2,2:45
447416,2016-05-14,2016,CHN,PIT,8,2,8-2,CHN,9,true,41,32,73,122,156,278,17,6,23,1,2:42
447407,2016-05-14,2016,NYA,CHA,2,1,2-1,NYA,9,true,30,33,63,128,114,242,7,6,13,1,2:24
447411,2016-05-14,2016,SEA,ANA,7,9,9-7,ANA,9,false,39,43,82,154,159,313,12,18,30,4,3:29
447413,2016-05-14,2016,CLE,MIN,3,6,6-3,MIN,9,false,35,42,77,159,156,315,10,16,26,2,3:08
447415,2016-05-14,2016,TBA,OAK,6,0,6-0,TBA,9,true,38,29,67,106,154,260,15,3,18,2,2:36
447406,2016-05-14,2016,KCA,ATL,0,5,5-0,ATL,9,false,33,38,71,144,118,262,8,16,24,3,2:43
447408,2016-05-14,2016,PHI,CIN,4,3,4-3,PHI,9,true,34,36,70,142,107,249,13,10,23,0,2:45 (:38 delay)
447409,2016-05-14,2016,BAL,DET,9,3,9-3,BAL,9,true,38,35,73,130,129,259,14,9,23,3,2:44
447414,2016-05-14,2016,COL,NYN,7,4,7-4,COL,9,true,39,39,78,145,141,286,16,14,30,3,3:11
447420,2016-05-14,2016,TEX,TOR,6,5,6-5,TEX,10,false,42,40,82,154,152,306,13,11,24,3,3:01
447410,2016-05-14,2016,BOS,HOU,6,5,6-5,BOS,11,false,49,47,96,197,172,369,19,20,39,2,4:13
447417,2016-05-14,2016,MIL,SDN,7,8,8-7,SDN,12,false,59,51,110,194,262,456,23,18,41,4,5:04
447412,2016-05-14,2016,WAS,MIA,1,7,7-1,MIA,9,false,38,43,81,174,150,324,12,17,29,0,2:55
447433,2016-05-15,2016,ARI,SFN,1,2,2-1,SFN,9,false,36,35,71,126,138,264,12,10,22,2,3:00
447428,2016-05-15,2016,CLE,MIN,1,5,5-1,MIN,9,false,37,36,73,150,144,294,10,9,19,1,2:39
447422,2016-05-15,2016,NYA,CHA,7,5,7-5,NYA,9,true,43,41,84,163,161,324,17,15,32,2,3:36
447430,2016-05-15,2016,TBA,OAK,6,7,7-6,OAK,9,false,37,40,77,143,142,285,8,14,22,2,3:05
447425,2016-05-15,2016,BOS,HOU,10,9,10-9,BOS,9,true,42,43,85,169,154,323,17,14,31,2,3:40
447432,2016-05-15,2016,MIL,SDN,3,2,3-2,MIL,9,true,37,34,71,135,146,281,12,7,19,2,2:46
447426,2016-05-15,2016,SEA,ANA,0,3,3-0,ANA,9,false,30,37,67,133,124,257,5,11,16,1,2:55
447429,2016-05-15,2016,COL,NYN,4,3,4-3,COL,9,true,33,36,69,126,123,249,9,13,22,2,2:32
447435,2016-05-15,2016,TEX,TOR,7,6,7-6,TEX,9,true,36,44,80,173,121,294,15,18,33,7,3:29
447434,2016-05-15,2016,LAN,SLN,2,5,5-2,SLN,9,false,33,37,70,152,127,279,9,13,22,3,3:00
447424,2016-05-15,2016,BAL,DET,5,6,6-5,DET,9,false,39,44,83,166,173,339,12,18,30,2,3:38
447427,2016-05-15,2016,WAS,MIA,1,5,5-1,MIA,9,false,38,38,76,149,168,317,11,12,23,2,3:03
447431,2016-05-15,2016,CHN,PIT,1,2,2-1,PIT,9,false,32,38,70,167,114,281,5,12,17,3,2:55
447421,2016-05-15,2016,KCA,ATL,4,2,4-2,KCA,13,false,49,53,102,198,183,381,13,14,27,5,4:16
447423,2016-05-15,2016,PHI,CIN,4,9,9-4,CIN,9,false,47,47,94,193,198,391,19,22,41,2,3:52
447443,2016-05-16,2016,OAK,TEX,3,1,3-1,OAK,9,true,29,33,62,127,118,245,7,6,13,1,2:28
447436,2016-05-16,2016,PIT,ATL,8,5,8-5,PIT,9,true,40,38,78,138,146,284,17,11,28,2,2:55
447442,2016-05-16,2016,TOR,TBA,2,13,13-2,TBA,9,false,37,45,82,170,140,310,12,20,32,1,2:54
447441,2016-05-16,2016,ARI,NYA,12,2,12-2,ARI,9,true,47,35,82,140,161,301,22,10,32,1,3:00
447440,2016-05-16,2016,DET,MIN,10,8,10-8,DET,9,true,40,39,79,134,146,280,18,11,29,2,2:48
447451,2016-05-16,2016,PHI,MIA,3,5,5-3,MIA,9,false,40,44,84,171,141,312,13,19,32,1,3:07
447438,2016-05-16,2016,CLE,CIN,15,6,15-6,CLE,9,true,48,38,86,141,179,320,25,15,40,3,3:13
447439,2016-05-16,2016,LAN,ANA,6,7,7-6,ANA,9,false,41,41,82,161,172,333,14,17,31,2,4:00
447450,2016-05-17,2016,LAN,ANA,5,1,5-1,LAN,9,true,36,31,67,114,98,212,15,4,19,0,2:12
447454,2016-05-17,2016,SDN,SFN,1,5,5-1,SFN,9,false,33,39,72,156,108,264,5,13,18,0,2:47
447452,2016-05-17,2016,DET,MIN,7,2,7-2,DET,9,true,34,36,70,156,114,270,10,10,20,4,2:55
447466,2016-05-17,2016,PHI,MIA,3,1,3-1,PHI,9,true,31,38,69,169,109,278,7,11,18,1,2:53
447457,2016-05-17,2016,OAK,TEX,8,5,8-5,OAK,9,false,41,40,81,114,144,258,16,16,32,2,2:45
447445,2016-05-17,2016,KCA,BOS,8,4,8-4,KCA,9,true,39,36,75,134,151,285,15,11,26,3,2:54
447455,2016-05-17,2016,BAL,SEA,0,10,10-0,SEA,9,false,33,43,76,165,134,299,5,17,22,1,2:41
447453,2016-05-17,2016,ARI,NYA,5,3,5-3,ARI,9,true,35,34,69,133,129,262,11,7,18,1,2:47
447458,2016-05-17,2016,NYN,WAS,2,0,2-0,NYN,9,true,30,30,60,126,113,239,8,5,13,1,2:32
447448,2016-05-17,2016,SLN,COL,1,3,3-1,COL,9,false,36,38,74,135,141,276,9,11,20,1,2:44
447456,2016-05-17,2016,TOR,TBA,2,12,12-2,TBA,9,false,34,48,82,157,135,292,9,20,29,1,2:43
447444,2016-05-17,2016,PIT,ATL,12,9,12-9,PIT,9,true,45,44,89,162,168,330,25,19,44,6,3:36
447447,2016-05-17,2016,CLE,CIN,13,1,13-1,CLE,9,true,50,34,84,122,216,338,26,7,33,3,3:19
447449,2016-05-17,2016,CHA,HOU,5,6,6-5,HOU,11,false,47,50,97,197,186,383,14,17,31,2,3:54
447446,2016-05-17,2016,MIL,CHN,4,2,4-2,MIL,9,true,31,31,62,114,105,219,7,4,11,2,2:10
447465,2016-05-18,2016,ANA,LAN,8,1,8-1,ANA,9,true,42,37,79,126,156,282,17,11,28,3,3:12
447463,2016-05-18,2016,SLN,COL,2,0,2-0,SLN,9,true,34,34,68,140,125,265,11,8,19,2,2:54
447464,2016-05-18,2016,CHA,HOU,3,5,5-3,HOU,9,false,37,41,78,133,151,284,12,18,30,3,2:57
447468,2016-05-18,2016,ARI,NYA,2,4,4-2,NYA,9,false,31,41,72,160,147,307,4,16,20,2,3:12
447469,2016-05-18,2016,SDN,SFN,1,2,2-1,SFN,9,false,33,34,67,144,117,261,6,6,12,0,2:33
447459,2016-05-18,2016,PIT,ATL,1,3,3-1,ATL,9,false,33,38,71,122,105,227,8,13,21,1,2:38
447480,2016-05-18,2016,PHI,MIA,4,2,4-2,PHI,9,true,36,31,67,118,135,253,14,7,21,0,2:29
447460,2016-05-18,2016,KCA,BOS,3,2,3-2,KCA,9,true,29,36,65,150,101,251,6,10,16,1,2:23
447437,2016-05-18,2016,KCA,BOS,2,5,5-2,BOS,9,false,33,42,75,145,131,276,8,18,26,3,3:06
447471,2016-05-18,2016,TOR,TBA,3,6,6-3,TBA,9,false,35,38,73,147,139,286,9,11,20,1,2:48
447437,2016-05-18,2016,KCA,BOS,2,5,5-2,BOS,9,false,33,42,75,145,131,276,8,18,26,3,3:06
447472,2016-05-18,2016,OAK,TEX,8,1,8-1,OAK,9,true,38,33,71,133,128,261,16,6,22,2,2:31
447467,2016-05-18,2016,DET,MIN,6,3,6-3,DET,9,true,37,37,74,141,151,292,15,10,25,1,2:57
447470,2016-05-18,2016,BAL,SEA,5,2,5-2,BAL,9,true,36,38,74,161,141,302,12,11,23,2,2:59
447461,2016-05-18,2016,MIL,CHN,1,2,2-1,CHN,13,false,50,55,105,208,249,457,14,24,38,4,5:00
447473,2016-05-18,2016,NYN,WAS,1,7,7-1,WAS,9,false,34,46,80,217,131,348,7,21,28,4,3:42
447462,2016-05-18,2016,CIN,CLE,7,8,8-7,CLE,12,false,49,51,100,224,205,429,14,15,29,4,4:21
447481,2016-05-19,2016,OAK,NYA,1,4,4-1,NYA,9,false,31,40,71,144,104,248,6,15,21,1,2:39
447485,2016-05-19,2016,NYN,WAS,1,9,9-1,WAS,9,false,36,43,79,163,155,318,9,16,25,1,3:12
447482,2016-05-19,2016,SDN,SFN,1,3,3-1,SFN,9,false,31,38,69,148,125,273,4,11,15,1,2:56
447478,2016-05-19,2016,CHA,HOU,2,1,2-1,CHA,9,true,30,31,61,107,123,230,6,4,10,0,2:11
447483,2016-05-19,2016,BAL,SEA,2,7,7-2,SEA,9,false,34,37,71,135,166,301,8,13,21,1,3:01
447474,2016-05-19,2016,PIT,ATL,8,2,8-2,PIT,9,true,40,35,75,125,166,291,15,9,24,2,2:56
447475,2016-05-19,2016,MIL,CHN,5,3,5-3,MIL,9,true,36,38,74,164,141,305,13,12,25,2,2:58
447479,2016-05-19,2016,ANA,LAN,7,4,7-4,ANA,9,true,37,37,74,135,147,282,15,10,25,3,3:06
447476,2016-05-19,2016,CIN,CLE,2,7,7-2,CLE,9,false,33,42,75,165,109,274,6,15,21,2,2:48
447484,2016-05-19,2016,MIN,TOR,2,3,3-2,TOR,11,false,37,44,81,184,138,322,5,12,17,1,3:07
447477,2016-05-19,2016,SLN,COL,13,7,13-7,SLN,9,true,40,38,78,148,165,313,18,11,29,1,3:16
447498,2016-05-20,2016,HOU,TEX,1,2,2-1,TEX,9,false,32,34,66,136,125,261,6,8,14,0,2:33
447499,2016-05-20,2016,MIN,TOR,3,9,9-3,TOR,9,false,36,42,78,169,125,294,10,16,26,1,2:48
447487,2016-05-20,2016,PHI,ATL,1,7,7-1,ATL,9,false,36,41,77,146,140,286,10,14,24,1,3:00
447494,2016-05-20,2016,NYN,MIL,3,2,3-2,NYN,9,true,35,29,64,108,148,256,12,3,15,2,2:31
447496,2016-05-20,2016,CIN,SEA,3,8,8-3,SEA,9,false,37,43,80,169,131,300,12,18,30,1,3:10 (:45 delay)
447491,2016-05-20,2016,PIT,COL,2,1,2-1,PIT,9,true,32,37,69,137,101,238,8,14,22,0,2:33
447492,2016-05-20,2016,CHA,KCA,1,4,4-1,KCA,9,false,36,38,74,135,145,280,10,12,22,2,2:59
447500,2016-05-20,2016,MIA,WAS,1,4,4-1,WAS,9,false,36,38,74,134,140,274,12,13,25,3,2:53
447497,2016-05-20,2016,DET,TBA,5,7,7-5,TBA,9,false,40,39,79,158,149,307,13,14,27,3,3:26
447490,2016-05-20,2016,BOS,CLE,2,4,4-2,CLE,9,false,35,40,75,149,141,290,9,13,22,1,3:07
447495,2016-05-20,2016,OAK,NYA,3,8,8-3,NYA,9,false,36,47,83,189,138,327,8,19,27,1,3:13
447493,2016-05-20,2016,SDN,LAN,7,6,7-6,SDN,9,false,40,42,82,187,147,334,18,16,34,4,3:25
447488,2016-05-20,2016,ANA,BAL,4,9,9-4,BAL,9,false,39,45,84,174,151,325,11,18,29,4,3:20
447489,2016-05-20,2016,SFN,CHN,1,8,8-1,CHN,9,false,35,40,75,155,130,285,8,14,22,2,3:11
447486,2016-05-20,2016,SLN,ARI,7,11,11-7,ARI,9,false,46,45,91,189,182,371,19,22,41,4,3:46
447513,2016-05-21,2016,HOU,TEX,1,2,2-1,TEX,9,false,30,33,63,117,121,238,5,7,12,0,2:41
447510,2016-05-21,2016,OAK,NYA,1,5,5-1,NYA,9,false,35,38,73,140,116,256,8,11,19,2,2:46
447514,2016-05-21,2016,MIN,TOR,5,3,5-3,MIN,9,true,31,35,66,133,109,242,8,10,18,2,2:19
447503,2016-05-21,2016,ANA,BAL,1,3,3-1,BAL,9,false,39,34,73,124,154,278,13,6,19,3,3:08
447505,2016-05-21,2016,BOS,CLE,9,1,9-1,BOS,9,true,44,34,78,141,174,315,22,6,28,4,3:17
447512,2016-05-21,2016,DET,TBA,5,4,5-4,DET,9,true,34,36,70,147,150,297,11,9,20,1,2:58
447502,2016-05-21,2016,PHI,ATL,0,2,2-0,ATL,9,false,30,38,68,154,123,277,3,12,15,3,2:56
447501,2016-05-21,2016,SLN,ARI,6,2,6-2,SLN,9,true,41,37,78,138,181,319,17,10,27,0,2:53
447515,2016-05-21,2016,MIA,WAS,3,2,3-2,MIA,9,true,38,35,73,162,146,308,15,11,26,2,3:13
447511,2016-05-21,2016,CIN,SEA,0,4,4-0,SEA,9,false,33,40,73,167,134,301,7,12,19,0,2:52
447506,2016-05-21,2016,PIT,COL,1,5,5-1,COL,9,false,38,37,75,143,151,294,13,9,22,2,3:02 (:56 delay)
447504,2016-05-21,2016,SFN,CHN,5,3,5-3,SFN,9,true,37,40,77,171,149,320,14,14,28,4,3:17
447507,2016-05-21,2016,CHA,KCA,1,2,2-1,KCA,9,false,37,36,73,152,144,296,11,11,22,4,3:05
447508,2016-05-21,2016,SDN,LAN,3,2,3-2,SDN,11,false,43,39,82,150,179,329,10,7,17,2,3:39
447509,2016-05-21,2016,NYN,MIL,5,4,5-4,NYN,9,false,38,39,77,181,152,333,16,12,28,1,3:09
447524,2016-05-22,2016,NYN,MIL,3,1,3-1,NYN,9,true,33,34,67,136,150,286,9,8,17,0,2:59
447518,2016-05-22,2016,ANA,BAL,10,2,10-2,ANA,9,true,40,32,72,129,133,262,16,6,22,1,2:33
447520,2016-05-22,2016,BOS,CLE,5,2,5-2,BOS,9,true,41,37,78,162,175,337,18,10,28,3,3:23
447516,2016-05-22,2016,SLN,ARI,2,7,7-2,ARI,9,false,35,41,76,136,127,263,8,16,24,1,2:44
447529,2016-05-22,2016,MIN,TOR,1,3,3-1,TOR,9,false,32,37,69,146,109,255,6,10,16,2,2:29
447527,2016-05-22,2016,DET,TBA,9,4,9-4,DET,9,true,41,37,78,140,147,287,18,11,29,2,3:03
447519,2016-05-22,2016,SFN,CHN,1,0,1-0,SFN,9,true,32,33,65,129,118,247,8,6,14,2,2:33
447517,2016-05-22,2016,PHI,ATL,5,0,5-0,PHI,9,true,38,33,71,114,126,240,16,7,23,1,2:35
447528,2016-05-22,2016,HOU,TEX,2,9,9-2,TEX,9,false,36,39,75,132,129,261,8,15,23,0,2:36
447525,2016-05-22,2016,OAK,NYA,4,5,5-4,NYA,9,false,36,37,73,138,141,279,7,11,18,1,2:55
447522,2016-05-22,2016,CHA,KCA,3,2,3-2,CHA,9,true,34,36,70,127,135,262,11,10,21,2,2:46
447526,2016-05-22,2016,CIN,SEA,4,5,5-4,SEA,9,false,36,41,77,161,126,287,10,18,28,0,2:59
447530,2016-05-22,2016,MIA,WAS,2,8,8-2,WAS,9,false,32,43,75,155,112,267,6,22,28,2,2:56
447523,2016-05-22,2016,SDN,LAN,5,9,9-5,LAN,17,false,65,74,139,269,256,525,16,28,44,2,5:47
446944,2016-05-23,2016,CHA,CLE,1,5,5-1,CLE,9,false,34,36,70,134,142,276,7,10,17,1,2:40
447531,2016-05-23,2016,SLN,CHN,4,3,4-3,SLN,9,false,34,40,74,153,116,269,8,14,22,0,2:48
447547,2016-05-23,2016,TEX,ANA,0,2,2-0,ANA,9,false,36,34,70,131,148,279,10,10,20,3,2:56
447532,2016-05-23,2016,LAN,CIN,1,0,1-0,LAN,9,true,30,29,59,102,107,209,9,3,12,0,2:11
447536,2016-05-23,2016,SEA,OAK,0,5,5-0,OAK,9,false,33,40,73,146,118,264,9,12,21,2,2:40
447537,2016-05-23,2016,DET,PHI,5,4,5-4,DET,9,true,36,38,74,138,146,284,14,14,28,1,3:10
447521,2016-05-23,2016,PIT,COL,6,3,6-3,PIT,9,true,34,35,69,141,108,249,11,8,19,2,3:10
447538,2016-05-23,2016,SFN,SDN,1,0,1-0,SFN,9,false,36,30,66,114,141,255,12,3,15,0,2:37
447521,2016-05-23,2016,PIT,COL,6,3,6-3,PIT,9,true,34,35,69,141,108,249,11,8,19,2,3:10
447535,2016-05-23,2016,WAS,NYN,1,7,7-1,NYN,9,false,34,38,72,137,120,257,8,12,20,0,2:33 (1:07 delay)
447539,2016-05-23,2016,MIA,TBA,7,6,7-6,MIA,9,true,39,42,81,149,147,296,17,17,34,3,3:11
447533,2016-05-23,2016,CHA,CLE,7,6,7-6,CHA,9,true,43,37,80,151,160,311,19,11,30,3,3:10
446944,2016-05-23,2016,CHA,CLE,1,5,5-1,CLE,9,false,34,36,70,134,142,276,7,10,17,1,2:40
447534,2016-05-23,2016,MIN,KCA,4,10,10-4,KCA,9,false,40,45,85,187,154,341,16,19,35,4,3:29 (:41 delay)
447551,2016-05-24,2016,DET,PHI,3,1,3-1,DET,9,true,30,33,63,126,112,238,8,7,15,0,2:38
447544,2016-05-24,2016,CHA,CLE,2,6,6-2,CLE,9,false,33,41,74,167,118,285,7,15,22,1,2:51
447543,2016-05-24,2016,LAN,CIN,8,2,8-2,LAN,9,true,42,31,73,129,178,307,18,4,22,3,3:08
447553,2016-05-24,2016,MIA,TBA,3,4,4-3,TBA,9,false,39,39,78,152,155,307,11,16,27,2,3:21
447562,2016-05-24,2016,TEX,ANA,4,1,4-1,TEX,9,true,32,35,67,137,129,266,10,10,20,0,2:47
447545,2016-05-24,2016,BOS,COL,8,3,8-3,BOS,9,true,42,33,75,133,144,277,19,7,26,1,2:55
447540,2016-05-24,2016,PIT,ARI,12,1,12-1,PIT,9,true,45,39,84,157,182,339,24,14,38,3,3:23
447548,2016-05-24,2016,ATL,MIL,1,2,2-1,MIL,9,false,35,33,68,145,146,291,10,6,16,0,3:08
447550,2016-05-24,2016,SEA,OAK,6,5,6-5,SEA,9,false,37,39,76,151,139,290,14,13,27,5,3:12
447546,2016-05-24,2016,MIN,KCA,4,7,7-4,KCA,9,false,39,41,80,157,151,308,13,15,28,3,3:07
447542,2016-05-24,2016,SLN,CHN,3,12,12-3,CHN,9,false,37,48,85,203,133,336,11,22,33,3,3:10
447552,2016-05-24,2016,SFN,SDN,8,2,8-2,SFN,9,true,38,37,75,145,133,278,16,12,28,1,2:51
447541,2016-05-24,2016,HOU,BAL,3,2,3-2,HOU,13,false,48,52,100,232,190,422,15,14,29,2,4:14
447554,2016-05-24,2016,NYA,TOR,6,0,6-0,NYA,9,true,36,34,70,140,131,271,12,7,19,3,2:40
447549,2016-05-24,2016,WAS,NYN,7,4,7-4,WAS,9,true,36,35,71,146,122,268,13,8,21,1,2:48
447559,2016-05-25,2016,CHA,CLE,3,4,4-3,CLE,9,false,37,38,75,163,135,298,10,11,21,2,3:02
447569,2016-05-25,2016,NYA,TOR,4,8,8-4,TOR,9,false,37,43,80,169,131,300,10,16,26,3,2:59
447555,2016-05-25,2016,PIT,ARI,5,4,5-4,PIT,9,true,37,35,72,118,145,263,12,10,22,2,3:05
447565,2016-05-25,2016,WAS,NYN,0,2,2-0,NYN,9,false,33,33,66,141,120,261,7,7,14,0,2:38
447567,2016-05-25,2016,DET,PHI,5,8,8-5,PHI,9,false,39,41,80,141,140,281,11,15,26,3,3:11
447556,2016-05-25,2016,HOU,BAL,4,3,4-3,HOU,9,true,33,42,75,168,117,285,8,17,25,1,2:58
447561,2016-05-25,2016,MIN,KCA,7,5,7-5,MIN,9,true,37,38,75,136,146,282,15,13,28,2,2:48
447558,2016-05-25,2016,LAN,CIN,3,1,3-1,LAN,9,true,29,32,61,127,116,243,5,6,11,0,2:21
447560,2016-05-25,2016,BOS,COL,10,3,10-3,BOS,9,true,41,38,79,143,156,299,18,12,30,2,3:09
447574,2016-05-25,2016,TEX,ANA,15,9,15-9,TEX,9,true,48,42,90,153,174,327,26,15,41,6,3:34
447566,2016-05-25,2016,SEA,OAK,13,3,13-3,SEA,9,true,41,34,75,117,152,269,18,10,28,1,2:47
447568,2016-05-25,2016,SFN,SDN,4,3,4-3,SFN,10,false,41,39,80,135,162,297,12,12,24,4,3:22
447563,2016-05-25,2016,TBA,MIA,3,4,4-3,MIA,9,false,37,44,81,162,157,319,14,16,30,4,3:22
447557,2016-05-25,2016,SLN,CHN,8,9,9-8,CHN,9,false,44,43,87,184,155,339,16,17,33,1,3:38
447564,2016-05-25,2016,ATL,MIL,2,3,3-2,MIL,13,false,51,56,107,248,200,448,14,22,36,4,4:51
447573,2016-05-26,2016,BOS,COL,2,8,8-2,COL,9,false,36,39,75,136,126,262,10,12,22,3,2:51
447570,2016-05-26,2016,PIT,ARI,8,3,8-3,PIT,9,true,42,43,85,176,167,343,18,18,36,4,3:40
447571,2016-05-26,2016,HOU,BAL,4,2,4-2,HOU,9,true,33,39,72,167,160,327,8,11,19,1,3:03
447577,2016-05-26,2016,WAS,SLN,2,1,2-1,WAS,9,true,31,32,63,135,112,247,8,7,15,0,2:27
447576,2016-05-26,2016,ATL,MIL,2,6,6-2,MIL,9,false,39,40,79,144,159,303,13,16,29,3,3:05 (1:17 delay)
447578,2016-05-26,2016,NYA,TOR,1,3,3-1,TOR,9,false,33,36,69,124,123,247,7,8,15,0,2:34
447575,2016-05-26,2016,TBA,MIA,1,9,9-1,MIA,9,false,36,42,78,177,140,317,9,16,25,1,2:51
447588,2016-05-27,2016,TBA,NYA,1,4,4-1,NYA,9,false,33,34,67,120,125,245,5,7,12,1,2:36
447580,2016-05-27,2016,TOR,BOS,7,5,7-5,TOR,9,true,41,35,76,136,145,281,17,9,26,2,2:53
447593,2016-05-27,2016,WAS,SLN,2,6,6-2,SLN,9,false,36,34,70,119,124,243,10,8,18,0,2:32
447587,2016-05-27,2016,SEA,MIN,2,7,7-2,MIN,9,false,32,40,72,151,126,277,5,14,19,0,2:36
447584,2016-05-27,2016,ANA,HOU,7,2,7-2,ANA,9,true,37,35,72,129,122,251,13,9,22,2,2:38
447590,2016-05-27,2016,TEX,PIT,1,9,9-1,PIT,9,false,38,45,83,172,145,317,11,18,29,1,3:04
447589,2016-05-27,2016,CHN,PHI,6,2,6-2,CHN,9,true,35,38,73,146,149,295,12,12,24,2,3:04 (1:33 delay)
447582,2016-05-27,2016,MIL,CIN,9,5,9-5,MIL,9,true,43,33,76,123,154,277,20,6,26,2,2:53
447579,2016-05-27,2016,CLE,BAL,4,6,6-4,BAL,9,false,38,41,79,147,170,317,15,16,31,1,3:09
447592,2016-05-27,2016,COL,SFN,5,2,5-2,COL,9,true,37,34,71,118,117,235,14,7,21,4,2:42 (:42 delay)
447586,2016-05-27,2016,ATL,MIA,4,2,4-2,ATL,9,true,43,35,78,130,169,299,21,10,31,2,3:13
447585,2016-05-27,2016,NYN,LAN,6,5,6-5,NYN,9,false,37,38,75,144,158,302,13,13,26,2,3:03
447591,2016-05-27,2016,ARI,SDN,3,10,10-3,SDN,9,false,36,48,84,185,139,324,8,23,31,2,3:19
447583,2016-05-27,2016,OAK,DET,1,4,4-1,DET,9,false,34,39,73,134,125,259,7,15,22,2,2:40
447581,2016-05-27,2016,KCA,CHA,7,5,7-5,KCA,9,true,37,36,73,140,122,262,14,9,23,5,2:58
447599,2016-05-28,2016,ANA,HOU,2,4,4-2,HOU,9,false,30,37,67,139,134,273,3,13,16,3,2:46
447602,2016-05-28,2016,SEA,MIN,5,6,6-5,MIN,9,false,42,41,83,181,156,337,19,17,36,5,3:30
447604,2016-05-28,2016,CHN,PHI,4,1,4-1,CHN,9,true,32,32,64,104,131,235,10,6,16,0,2:18
447606,2016-05-28,2016,ARI,SDN,8,7,8-7,ARI,9,true,41,36,77,137,172,309,18,11,29,2,3:21
447600,2016-05-28,2016,NYN,LAN,1,9,9-1,LAN,9,false,33,42,75,140,136,276,7,17,24,3,3:12
447598,2016-05-28,2016,OAK,DET,12,3,12-3,OAK,9,true,41,35,76,129,147,276,18,10,28,2,2:57
447605,2016-05-28,2016,TEX,PIT,5,2,5-2,TEX,9,true,34,36,70,144,150,294,10,8,18,1,3:08
447603,2016-05-28,2016,TBA,NYA,9,5,9-5,TBA,9,true,40,41,81,160,139,299,16,16,32,4,3:15
447601,2016-05-28,2016,ATL,MIA,7,2,7-2,ATL,9,true,35,40,75,155,168,323,10,12,22,3,3:15
447607,2016-05-28,2016,COL,SFN,5,10,10-5,SFN,9,false,41,43,84,132,176,308,14,18,32,6,3:27
447608,2016-05-28,2016,WAS,SLN,4,9,9-4,SLN,9,false,33,43,76,161,125,286,7,18,25,2,3:00
447595,2016-05-28,2016,TOR,BOS,10,9,10-9,TOR,9,false,43,42,85,143,175,318,17,16,33,5,3:37
447596,2016-05-28,2016,KCA,CHA,8,7,8-7,KCA,9,false,44,39,83,137,195,332,20,11,31,2,3:22
447594,2016-05-28,2016,CLE,BAL,11,4,11-4,CLE,9,true,44,39,83,163,154,317,18,13,31,2,3:02 (:22 delay)
447597,2016-05-28,2016,MIL,CIN,6,7,7-6,CIN,9,false,41,42,83,170,164,334,15,16,31,4,3:46
447618,2016-05-29,2016,TBA,NYA,1,2,2-1,NYA,9,false,36,29,65,125,144,269,8,2,10,0,2:45
447615,2016-05-29,2016,NYN,LAN,2,4,4-2,LAN,9,false,32,41,73,146,133,279,5,13,18,1,3:05
447613,2016-05-29,2016,OAK,DET,4,2,4-2,OAK,9,true,36,34,70,128,141,269,13,8,21,2,2:48
447619,2016-05-29,2016,CHN,PHI,7,2,7-2,CHN,9,true,38,35,73,123,151,274,16,10,26,3,2:50
447617,2016-05-29,2016,SEA,MIN,4,5,5-4,MIN,9,false,35,36,71,155,142,297,10,10,20,1,2:51
447612,2016-05-29,2016,MIL,CIN,5,4,5-4,MIL,9,true,35,36,71,132,139,271,13,13,26,2,3:10
447609,2016-05-29,2016,CLE,BAL,4,6,6-4,BAL,9,false,39,39,78,162,157,319,14,12,26,1,3:14
447623,2016-05-29,2016,WAS,SLN,10,2,10-2,WAS,9,true,38,39,77,159,142,301,15,12,27,3,3:12
447621,2016-05-29,2016,ARI,SDN,6,3,6-3,ARI,9,true,38,34,72,124,142,266,14,7,21,1,2:39
447610,2016-05-29,2016,TOR,BOS,3,5,5-3,BOS,11,false,47,49,96,210,183,393,14,18,32,5,4:07
447611,2016-05-29,2016,KCA,CHA,5,4,5-4,KCA,9,true,37,36,73,154,158,312,16,11,27,1,3:04
447620,2016-05-29,2016,TEX,PIT,6,2,6-2,TEX,9,true,35,37,72,141,128,269,11,9,20,0,2:47
447616,2016-05-29,2016,ATL,MIA,3,7,7-3,MIA,9,false,35,41,76,181,131,312,8,15,23,3,3:18
447622,2016-05-29,2016,COL,SFN,3,8,8-3,SFN,9,false,37,45,82,158,150,308,11,22,33,1,3:25
447614,2016-05-29,2016,ANA,HOU,6,8,8-6,HOU,13,false,59,55,114,220,239,459,23,22,45,3,4:57
447634,2016-05-30,2016,ATL,SFN,5,3,5-3,ATL,9,true,33,36,69,138,123,261,9,9,18,1,2:37
447625,2016-05-30,2016,NYN,CHA,1,0,1-0,NYN,9,true,31,29,60,109,123,232,9,3,12,1,2:34
447638,2016-05-30,2016,PHI,WAS,3,4,4-3,WAS,9,false,34,35,69,117,128,245,8,9,17,1,2:53
447633,2016-05-30,2016,SEA,SDN,9,3,9-3,SEA,9,true,37,37,74,131,143,274,14,11,25,3,2:56
447630,2016-05-30,2016,OAK,MIN,3,2,3-2,OAK,9,true,30,36,66,125,112,237,11,11,22,1,2:32
447635,2016-05-30,2016,MIL,SLN,0,6,6-0,SLN,9,false,33,39,72,150,123,273,7,12,19,1,2:49
447631,2016-05-30,2016,TOR,NYA,4,2,4-2,TOR,9,true,32,34,66,132,120,252,9,9,18,3,2:26
447627,2016-05-30,2016,ANA,DET,5,1,5-1,ANA,9,true,32,32,64,114,139,253,8,6,14,1,2:46
447629,2016-05-30,2016,CHN,LAN,2,0,2-0,CHN,9,true,34,29,63,118,128,246,12,2,14,1,2:40
447632,2016-05-30,2016,MIA,PIT,0,10,10-0,PIT,9,false,28,40,68,161,105,266,3,16,19,1,2:37
447637,2016-05-30,2016,CLE,TEX,2,9,9-2,TEX,9,false,37,40,77,132,129,261,14,12,26,2,2:36
447624,2016-05-30,2016,BAL,BOS,2,7,7-2,BOS,9,false,35,42,77,155,122,277,9,16,25,2,2:54
447628,2016-05-30,2016,ARI,HOU,3,8,8-3,HOU,9,false,33,44,77,179,107,286,6,19,25,1,2:54
447626,2016-05-30,2016,COL,CIN,8,11,11-8,CIN,9,false,44,46,90,178,171,349,18,21,39,2,3:25
447636,2016-05-30,2016,KCA,TBA,6,2,6-2,KCA,9,true,34,37,71,154,129,283,12,10,22,1,3:03
447649,2016-05-31,2016,ATL,SFN,0,4,4-0,SFN,9,false,28,33,61,110,100,210,2,9,11,6,2:29
447647,2016-05-31,2016,MIA,PIT,3,1,3-1,MIA,9,true,36,32,68,134,121,255,12,7,19,1,2:36
447640,2016-05-31,2016,NYN,CHA,4,6,6-4,CHA,9,false,40,42,82,158,131,289,11,13,24,3,3:02
447653,2016-05-31,2016,PHI,WAS,1,5,5-1,WAS,9,false,31,37,68,144,124,268,6,10,16,0,2:54
447650,2016-05-31,2016,MIL,SLN,3,10,10-3,SLN,9,false,35,43,78,202,133,335,9,20,29,1,3:14
447646,2016-05-31,2016,TOR,NYA,4,1,4-1,TOR,9,true,29,35,64,148,118,266,9,8,17,1,2:37
447639,2016-05-31,2016,BAL,BOS,2,6,6-2,BOS,9,false,34,39,73,164,128,292,7,12,19,0,2:48
447652,2016-05-31,2016,CLE,TEX,3,7,7-3,TEX,9,false,36,37,73,141,147,288,11,11,22,2,2:51
447642,2016-05-31,2016,ANA,DET,11,9,11-9,ANA,9,false,40,37,77,165,142,307,22,11,33,3,3:19
447645,2016-05-31,2016,OAK,MIN,7,4,7-4,OAK,9,true,40,41,81,142,173,315,16,15,31,5,3:14
447644,2016-05-31,2016,CHN,LAN,0,5,5-0,LAN,9,false,29,40,69,168,124,292,3,13,16,2,2:57 (:27 delay)
447641,2016-05-31,2016,COL,CIN,17,4,17-4,COL,9,true,46,36,82,131,173,304,24,12,36,2,3:07
447648,2016-05-31,2016,SEA,SDN,16,4,16-4,SEA,9,true,48,33,81,120,202,322,25,7,32,3,3:09
447643,2016-05-31,2016,ARI,HOU,5,8,8-5,HOU,9,false,40,42,82,154,163,317,14,19,33,2,3:11
447651,2016-05-31,2016,KCA,TBA,10,5,10-5,KCA,9,true,44,45,89,188,147,335,23,18,41,2,3:27
447665,2016-06-01,2016,MIL,SLN,3,1,3-1,MIL,9,true,33,30,63,120,109,229,9,4,13,0,2:20
447666,2016-06-01,2016,KCA,TBA,6,3,6-3,KCA,9,true,38,38,76,127,142,269,13,12,25,0,2:45
447659,2016-06-01,2016,CHN,LAN,2,1,2-1,CHN,9,true,30,31,61,113,132,245,7,4,11,0,2:29
447658,2016-06-01,2016,ANA,DET,0,3,3-0,DET,9,false,32,40,72,148,135,283,5,14,19,2,2:55
447661,2016-06-01,2016,TOR,NYA,7,0,7-0,TOR,9,true,37,36,73,131,157,288,15,9,24,2,2:57
447660,2016-06-01,2016,OAK,MIN,5,1,5-1,OAK,9,true,35,37,72,128,138,266,14,11,25,0,2:33
447668,2016-06-01,2016,PHI,WAS,2,7,7-2,WAS,9,false,36,40,76,130,131,261,9,14,23,1,2:45
447662,2016-06-01,2016,MIA,PIT,3,2,3-2,MIA,9,true,36,35,71,156,153,309,12,10,22,2,2:52
447657,2016-06-01,2016,COL,CIN,2,7,7-2,CIN,9,false,36,40,76,161,124,285,10,15,25,1,2:50
447667,2016-06-01,2016,CLE,TEX,5,4,5-4,CLE,11,false,45,44,89,168,166,334,15,12,27,2,3:30
447655,2016-06-01,2016,BAL,BOS,13,9,13-9,BAL,9,true,48,45,93,191,181,372,23,20,43,5,3:58
447654,2016-06-01,2016,HOU,ARI,5,4,5-4,HOU,11,false,46,40,86,180,174,354,13,11,24,2,3:43
447663,2016-06-01,2016,ATL,SFN,5,4,5-4,ATL,11,false,39,46,85,198,142,340,12,14,26,6,3:38
447656,2016-06-01,2016,NYN,CHA,1,2,2-1,CHA,13,false,54,49,103,206,230,436,20,13,33,3,4:41
447664,2016-06-01,2016,SDN,SEA,14,6,14-6,SDN,9,true,46,44,90,171,181,352,20,18,38,1,3:20
446949,2016-06-02,2016,DET,NYA,4,5,5-4,NYA,9,false,39,36,75,106,161,267,15,9,24,3,2:56
447673,2016-06-02,2016,CHN,LAN,7,2,7-2,CHN,9,true,36,30,66,120,136,256,13,6,19,1,2:25
447669,2016-06-02,2016,HOU,ARI,0,3,3-0,ARI,9,false,32,35,67,130,134,264,5,10,15,1,2:36
447672,2016-06-02,2016,CLE,KCA,5,4,5-4,CLE,9,false,40,38,78,132,142,274,14,14,28,2,2:54
447670,2016-06-02,2016,BAL,BOS,12,7,12-7,BAL,9,true,38,40,78,148,132,280,14,14,28,3,2:57
447676,2016-06-02,2016,ATL,SFN,0,6,6-0,SFN,9,false,35,40,75,146,134,280,7,14,21,2,2:49
446949,2016-06-02,2016,DET,NYA,4,5,5-4,NYA,9,false,39,36,75,106,161,267,15,9,24,3,2:56
447671,2016-06-02,2016,COL,CIN,4,11,11-4,CIN,9,false,35,44,79,142,132,274,9,18,27,1,2:44
447674,2016-06-02,2016,PHI,MIL,1,4,4-1,MIL,9,false,33,40,73,159,138,297,6,16,22,3,3:14
447675,2016-06-02,2016,MIA,PIT,4,3,4-3,MIA,12,false,48,47,95,193,182,375,13,13,26,1,3:54
447677,2016-06-02,2016,SDN,SEA,13,16,16-13,SEA,9,false,51,46,97,194,172,366,24,19,43,4,3:50
447678,2016-06-02,2016,MIN,TBA,6,4,6-4,MIN,9,true,41,37,78,109,144,253,20,11,31,1,2:44
447682,2016-06-03,2016,SDN,COL,4,0,4-0,SDN,9,true,32,32,64,135,105,240,7,5,12,0,2:26
447680,2016-06-03,2016,LAN,ATL,4,2,4-2,LAN,9,true,32,35,67,130,126,256,8,10,18,2,2:42
447683,2016-06-03,2016,CLE,KCA,6,1,6-1,CLE,9,true,34,33,67,126,126,252,12,9,21,1,2:25
447679,2016-06-03,2016,CHN,ARI,6,0,6-0,CHN,9,true,38,33,71,137,166,303,18,8,26,2,3:00
447687,2016-06-03,2016,BAL,NYA,6,5,6-5,BAL,9,true,35,36,71,146,136,282,12,12,24,3,3:00
447691,2016-06-03,2016,MIN,TBA,2,4,4-2,TBA,9,false,39,34,73,132,174,306,14,7,21,2,3:03
447686,2016-06-03,2016,MIA,NYN,2,6,6-2,NYN,9,false,35,37,72,154,133,287,8,12,20,1,2:55
447685,2016-06-03,2016,PHI,MIL,6,3,6-3,PHI,9,true,33,36,69,163,108,271,11,10,21,1,3:03
447693,2016-06-03,2016,CIN,WAS,7,2,7-2,CIN,9,true,35,34,69,153,135,288,12,10,22,1,2:55
447681,2016-06-03,2016,DET,CHA,10,3,10-3,DET,9,true,42,37,79,148,167,315,21,11,32,1,3:22
447690,2016-06-03,2016,TEX,SEA,7,3,7-3,TEX,9,true,39,35,74,121,153,274,19,10,29,1,2:52
447689,2016-06-03,2016,SLN,SFN,1,5,5-1,SFN,9,false,36,40,76,149,145,294,10,13,23,5,3:11
447684,2016-06-03,2016,PIT,ANA,2,9,9-2,ANA,9,false,35,49,84,184,145,329,9,26,35,2,3:17
447688,2016-06-03,2016,HOU,OAK,12,2,12-2,HOU,9,true,45,38,83,156,161,317,21,12,33,2,2:59
447692,2016-06-03,2016,BOS,TOR,2,5,5-2,TOR,9,false,39,38,77,159,152,311,12,13,25,3,3:10
447696,2016-06-04,2016,DET,CHA,7,4,7-4,DET,9,true,39,38,77,139,147,286,14,13,27,3,3:09
447694,2016-06-04,2016,CHN,ARI,5,3,5-3,CHN,9,true,35,34,69,130,144,274,11,7,18,3,2:46
447704,2016-06-04,2016,SLN,SFN,7,4,7-4,SLN,9,true,35,35,70,134,124,258,12,9,21,1,2:39
447698,2016-06-04,2016,CLE,KCA,7,1,7-1,CLE,9,true,37,35,72,125,140,265,14,8,22,1,2:48 (:32 delay)
447708,2016-06-04,2016,CIN,WAS,6,3,6-3,CIN,9,true,33,31,64,126,150,276,10,6,16,2,2:38 (1:25 delay)
447706,2016-06-04,2016,MIN,TBA,4,7,7-4,TBA,9,false,39,39,78,146,165,311,13,16,29,1,3:10 (1:10 delay)
447695,2016-06-04,2016,LAN,ATL,4,0,4-0,LAN,9,true,37,33,70,145,152,297,14,8,22,3,3:27
447697,2016-06-04,2016,SDN,COL,4,3,4-3,SDN,9,true,35,41,76,162,132,294,13,15,28,2,3:00
447702,2016-06-04,2016,BAL,NYA,6,8,8-6,NYA,9,false,38,42,80,154,152,306,11,16,27,4,3:25
447699,2016-06-04,2016,PIT,ANA,8,7,8-7,PIT,9,true,42,37,79,117,160,277,19,12,31,2,3:00
447705,2016-06-04,2016,TEX,SEA,10,4,10-4,TEX,9,true,44,40,84,148,166,314,21,13,34,1,3:09
447701,2016-06-04,2016,MIA,NYN,4,6,6-4,NYN,9,false,40,47,87,183,149,332,13,24,37,3,3:39
447703,2016-06-04,2016,HOU,OAK,6,5,6-5,HOU,12,false,48,52,100,193,180,373,17,17,34,3,4:07
447700,2016-06-04,2016,PHI,MIL,3,6,6-3,MIL,9,false,36,43,79,182,131,313,9,16,25,0,3:25
447707,2016-06-04,2016,BOS,TOR,6,4,6-4,BOS,9,true,37,35,72,176,144,320,16,10,26,1,3:08
447722,2016-06-05,2016,BOS,TOR,4,5,5-4,TOR,9,false,36,34,70,144,139,283,9,8,17,2,2:44
447713,2016-06-05,2016,CLE,KCA,7,0,7-0,CLE,9,true,34,31,65,121,128,249,11,5,16,2,2:21 (3:10 delay)
447720,2016-06-05,2016,TEX,SEA,3,2,3-2,TEX,9,true,31,32,63,118,109,227,6,5,11,2,2:30
447716,2016-06-05,2016,MIA,NYN,1,0,1-0,MIA,9,true,28,31,59,125,113,238,5,4,9,0,2:17
447711,2016-06-05,2016,DET,CHA,5,2,5-2,DET,9,true,39,33,72,128,156,284,17,6,23,1,3:09 (:07 delay)
447719,2016-06-05,2016,SLN,SFN,6,3,6-3,SLN,9,true,36,37,73,140,122,262,13,10,23,5,3:05
447709,2016-06-05,2016,CHN,ARI,2,3,3-2,ARI,9,false,35,40,75,178,121,299,8,16,24,2,3:00
447715,2016-06-05,2016,PHI,MIL,8,1,8-1,PHI,9,true,38,40,78,153,141,294,16,14,30,1,3:05
447723,2016-06-05,2016,CIN,WAS,9,10,10-9,WAS,9,false,43,43,86,166,166,332,18,16,34,3,3:27
447721,2016-06-05,2016,MIN,TBA,5,7,7-5,TBA,9,false,43,40,83,172,164,336,17,15,32,2,3:19
447710,2016-06-05,2016,LAN,ATL,12,6,12-6,LAN,9,true,44,39,83,149,188,337,20,14,34,2,3:17
447718,2016-06-05,2016,HOU,OAK,5,2,5-2,HOU,9,true,41,39,80,135,150,285,16,12,28,3,3:05
447714,2016-06-05,2016,PIT,ANA,4,5,5-4,ANA,9,false,42,37,79,134,168,302,19,10,29,2,3:08
447712,2016-06-05,2016,SDN,COL,3,10,10-3,COL,9,false,33,41,74,162,118,280,7,14,21,2,2:56
447717,2016-06-05,2016,BAL,NYA,3,1,3-1,BAL,9,true,37,38,75,143,169,312,14,12,26,2,3:26 (1:37 delay)
447729,2016-06-06,2016,BAL,KCA,4,1,4-1,BAL,9,true,33,33,66,125,111,236,10,7,17,1,2:37
447726,2016-06-06,2016,SEA,CLE,1,3,3-1,CLE,9,false,33,34,67,140,125,265,6,6,12,1,2:30
447727,2016-06-06,2016,LAN,COL,1,6,6-1,COL,9,false,31,37,68,141,113,254,7,14,21,1,2:26
447724,2016-06-06,2016,SDN,ATL,7,2,7-2,SDN,9,true,37,38,75,141,140,281,12,11,23,2,2:57
447730,2016-06-06,2016,NYA,ANA,5,2,5-2,NYA,9,true,31,34,65,113,98,211,9,8,17,1,2:35
447725,2016-06-06,2016,PHI,CHN,4,6,6-4,CHN,9,false,34,43,77,164,118,282,9,15,24,1,3:05
447733,2016-06-06,2016,DET,TOR,11,0,11-0,DET,9,true,43,33,76,134,166,300,19,7,26,1,2:57
447728,2016-06-06,2016,TEX,HOU,6,5,6-5,TEX,9,false,41,40,81,149,132,281,14,12,26,1,3:08
447732,2016-06-06,2016,ARI,TBA,4,6,6-4,TBA,9,false,40,43,83,185,174,359,13,18,31,3,3:30
447741,2016-06-07,2016,NYA,ANA,6,3,6-3,NYA,9,true,35,34,69,118,124,242,12,7,19,3,2:35
447743,2016-06-07,2016,PIT,NYN,3,1,3-1,PIT,9,true,37,35,72,126,155,281,15,8,23,0,2:40
447737,2016-06-07,2016,SEA,CLE,7,1,7-1,SEA,9,true,37,33,70,124,154,278,16,8,24,2,2:38
447739,2016-06-07,2016,TEX,HOU,4,3,4-3,TEX,9,true,34,37,71,161,133,294,11,13,24,1,2:48
447745,2016-06-07,2016,CIN,SLN,7,6,7-6,CIN,9,false,38,38,76,141,146,287,15,12,27,3,2:55
447731,2016-06-07,2016,PIT,NYN,3,1,3-1,PIT,9,true,35,31,66,138,145,283,11,6,17,2,2:48
447734,2016-06-07,2016,SDN,ATL,4,3,4-3,SDN,9,false,38,34,72,121,143,264,14,9,23,1,2:48
447731,2016-06-07,2016,PIT,NYN,3,1,3-1,PIT,9,true,35,31,66,138,145,283,11,6,17,2,2:48
447735,2016-06-07,2016,SFN,BOS,3,5,5-3,BOS,10,false,37,42,79,142,139,281,8,14,22,4,3:04
447738,2016-06-07,2016,LAN,COL,4,3,4-3,LAN,9,false,32,40,72,186,127,313,10,13,23,4,3:17
447742,2016-06-07,2016,MIN,MIA,6,4,6-4,MIN,11,false,41,44,85,183,159,342,10,11,21,3,3:18
447748,2016-06-07,2016,CHA,WAS,5,10,10-5,WAS,9,false,42,45,87,197,196,393,16,19,35,3,3:55
447736,2016-06-07,2016,PHI,CHN,3,2,3-2,PHI,9,true,34,34,68,135,126,261,11,8,19,3,2:45
447744,2016-06-07,2016,MIL,OAK,5,4,5-4,MIL,9,true,32,35,67,142,113,255,8,8,16,0,2:28
447746,2016-06-07,2016,ARI,TBA,5,0,5-0,ARI,9,true,32,31,63,104,106,210,10,5,15,1,2:15
447747,2016-06-07,2016,DET,TOR,3,2,3-2,DET,10,false,37,43,80,185,125,310,10,15,25,3,3:07
447740,2016-06-07,2016,BAL,KCA,9,1,9-1,BAL,9,true,38,41,79,158,118,276,14,14,28,2,2:44
447750,2016-06-08,2016,SFN,BOS,2,1,2-1,SFN,9,true,29,35,64,145,107,252,5,7,12,2,2:45
447752,2016-06-08,2016,SEA,CLE,5,0,5-0,SEA,9,true,34,31,65,130,134,264,12,4,16,1,2:41
447759,2016-06-08,2016,MIL,OAK,4,0,4-0,MIL,9,true,34,30,64,119,131,250,12,3,15,4,2:44
447749,2016-06-08,2016,SDN,ATL,2,4,4-2,ATL,9,false,33,44,77,161,124,285,7,18,25,1,3:01
447755,2016-06-08,2016,BAL,KCA,4,0,4-0,BAL,9,true,32,36,68,138,137,275,8,10,18,2,2:47
447751,2016-06-08,2016,PHI,CHN,1,8,8-1,CHN,9,false,30,40,70,153,125,278,4,15,19,2,2:44 (:19 delay)
447754,2016-06-08,2016,TEX,HOU,1,3,3-1,HOU,9,false,37,37,74,135,143,278,12,12,24,1,2:49
447762,2016-06-08,2016,DET,TOR,2,7,7-2,TOR,9,false,37,37,74,146,157,303,13,12,25,3,2:56
447761,2016-06-08,2016,ARI,TBA,3,6,6-3,TBA,9,false,40,41,81,149,146,295,16,15,31,1,3:00
447756,2016-06-08,2016,NYA,ANA,12,6,12-6,NYA,9,true,45,42,87,153,151,304,19,15,34,4,3:20
447757,2016-06-08,2016,MIN,MIA,7,5,7-5,MIN,9,true,39,41,80,142,141,283,15,15,30,5,3:05
447760,2016-06-08,2016,CIN,SLN,7,12,12-7,SLN,9,false,42,51,93,197,141,338,16,23,39,3,3:21
447763,2016-06-08,2016,CHA,WAS,4,11,11-4,WAS,9,false,38,48,86,212,147,359,12,22,34,3,3:38
447753,2016-06-08,2016,LAN,COL,0,1,1-0,COL,9,false,35,33,68,132,139,271,7,7,14,2,3:04
447758,2016-06-08,2016,PIT,NYN,5,6,6-5,NYN,10,false,46,45,91,171,172,343,16,19,35,1,3:51
447197,2016-06-09,2016,COL,PIT,11,5,11-5,COL,9,true,43,37,80,146,152,298,19,10,29,1,2:53
447771,2016-06-09,2016,CHA,WAS,3,1,3-1,CHA,9,true,31,31,62,112,126,238,7,5,12,1,2:21
447767,2016-06-09,2016,NYA,ANA,6,3,6-3,NYA,9,true,40,36,76,113,146,259,18,10,28,2,2:58
447766,2016-06-09,2016,TEX,HOU,5,3,5-3,TEX,9,true,35,39,74,147,143,290,11,13,24,1,2:51
447197,2016-06-09,2016,COL,PIT,11,5,11-5,COL,9,true,43,37,80,146,152,298,19,10,29,1,2:53
447764,2016-06-09,2016,TOR,BAL,5,6,6-5,BAL,9,false,39,41,80,158,147,305,13,15,28,4,3:12
447768,2016-06-09,2016,MIN,MIA,3,10,10-3,MIA,9,false,35,45,80,159,143,302,11,19,30,4,3:04
447765,2016-06-09,2016,SEA,CLE,3,5,5-3,CLE,9,false,39,42,81,181,158,339,14,15,29,4,3:39
447770,2016-06-09,2016,CIN,SLN,2,3,3-2,SLN,9,false,32,38,70,153,118,271,6,10,16,0,2:56
447769,2016-06-09,2016,MIL,NYN,2,5,5-2,NYN,9,false,33,42,75,154,117,271,10,17,27,2,3:04
447782,2016-06-10,2016,CIN,OAK,2,1,2-1,CIN,9,true,29,37,66,139,95,234,6,15,21,1,2:36
447779,2016-06-10,2016,SFN,LAN,2,3,3-2,LAN,9,false,34,34,68,129,126,255,7,7,14,0,2:35
447774,2016-06-10,2016,ATL,CHN,5,1,5-1,ATL,9,true,40,30,70,130,125,255,16,4,20,3,2:51
447776,2016-06-10,2016,NYA,DET,4,0,4-0,NYA,9,true,33,34,67,131,130,261,12,8,20,1,2:48
447778,2016-06-10,2016,CHA,KCA,7,5,7-5,CHA,9,true,35,39,74,148,128,276,14,13,27,3,3:00
447783,2016-06-10,2016,WAS,PHI,9,6,9-6,WAS,9,true,38,36,74,144,134,278,16,9,25,0,2:53
447775,2016-06-10,2016,ANA,CLE,2,6,6-2,CLE,9,false,31,37,68,144,114,258,4,11,15,1,2:34
447786,2016-06-10,2016,SEA,TEX,7,5,7-5,SEA,9,true,36,36,72,134,151,285,11,11,22,1,2:54
447772,2016-06-10,2016,TOR,BAL,4,3,4-3,TOR,10,false,39,39,78,157,158,315,13,9,22,1,2:54
447773,2016-06-10,2016,MIN,BOS,1,8,8-1,BOS,9,false,36,45,81,172,132,304,10,17,27,2,3:00
447777,2016-06-10,2016,TBA,HOU,4,3,4-3,TBA,9,true,35,41,76,159,142,301,13,18,31,1,3:19
447780,2016-06-10,2016,ARI,MIA,6,8,8-6,MIA,9,false,43,40,83,136,147,283,18,13,31,4,3:10
447784,2016-06-10,2016,COL,SDN,5,7,7-5,SDN,9,false,38,39,77,157,167,324,12,12,24,3,3:23
447781,2016-06-10,2016,MIL,NYN,1,2,2-1,NYN,11,false,40,46,86,150,182,332,9,17,26,3,3:56
447785,2016-06-10,2016,PIT,SLN,3,9,9-3,SLN,12,false,48,52,100,206,185,391,13,19,32,1,4:16
447795,2016-06-11,2016,ARI,MIA,5,3,5-3,ARI,9,true,31,40,71,142,116,258,7,13,20,0,2:33
447800,2016-06-11,2016,PIT,SLN,1,5,5-1,SLN,9,false,33,40,73,144,130,274,9,13,22,1,2:44
447790,2016-06-11,2016,ANA,CLE,4,3,4-3,ANA,9,false,37,36,73,137,123,260,13,9,22,1,2:59
447792,2016-06-11,2016,TBA,HOU,3,4,4-3,HOU,9,false,35,37,72,155,123,278,11,10,21,2,2:52
447791,2016-06-11,2016,NYA,DET,1,6,6-1,DET,9,false,35,38,73,139,138,277,9,12,21,4,3:17 (:05 delay)
447799,2016-06-11,2016,COL,SDN,5,3,5-3,COL,9,true,34,33,67,116,132,248,12,11,23,4,2:37
447793,2016-06-11,2016,CHA,KCA,1,4,4-1,KCA,9,false,34,36,70,129,125,254,8,10,18,1,2:37
447797,2016-06-11,2016,CIN,OAK,2,1,2-1,CIN,9,true,35,36,71,135,136,271,11,10,21,1,2:43
447796,2016-06-11,2016,MIL,NYN,7,4,7-4,MIL,9,true,36,35,71,124,151,275,15,9,24,1,2:54
447789,2016-06-11,2016,ATL,CHN,2,8,8-2,CHN,9,false,37,41,78,154,129,283,8,15,23,0,2:45
447801,2016-06-11,2016,SEA,TEX,1,2,2-1,TEX,11,false,41,45,86,175,123,298,9,16,25,3,3:13
447798,2016-06-11,2016,WAS,PHI,8,0,8-0,WAS,9,true,39,35,74,131,153,284,16,10,26,2,2:56
447787,2016-06-11,2016,TOR,BAL,11,6,11-6,TOR,9,true,43,39,82,134,163,297,22,14,36,2,3:05
447794,2016-06-11,2016,SFN,LAN,5,4,5-4,SFN,10,false,40,44,84,184,163,347,14,17,31,7,4:00
447788,2016-06-11,2016,MIN,BOS,4,15,15-4,BOS,9,false,40,47,87,181,172,353,15,20,35,6,3:45
447815,2016-06-12,2016,PIT,SLN,3,8,8-3,SLN,9,false,32,41,73,141,121,262,6,17,23,1,2:42
447810,2016-06-12,2016,ARI,MIA,6,0,6-0,ARI,9,true,39,29,68,131,144,275,14,5,19,1,2:41
447809,2016-06-12,2016,SFN,LAN,2,1,2-1,SFN,9,true,32,33,65,131,124,255,9,7,16,6,3:01
447811,2016-06-12,2016,MIL,NYN,5,3,5-3,MIL,9,true,35,37,72,156,134,290,10,9,19,2,2:51
447813,2016-06-12,2016,WAS,PHI,5,4,5-4,WAS,9,false,38,33,71,128,154,282,13,7,20,1,2:56
447808,2016-06-12,2016,CHA,KCA,1,3,3-1,KCA,9,false,31,38,69,149,114,263,6,16,22,3,2:43
447806,2016-06-12,2016,NYA,DET,1,4,4-1,DET,9,false,36,38,74,156,136,292,9,11,20,0,2:56
447812,2016-06-12,2016,CIN,OAK,1,6,6-1,OAK,9,false,34,41,75,154,128,282,10,17,27,1,2:50
447816,2016-06-12,2016,SEA,TEX,4,6,6-4,TEX,9,false,39,40,79,171,140,311,14,13,27,2,3:05
447803,2016-06-12,2016,MIN,BOS,7,4,7-4,MIN,10,false,42,40,82,156,161,317,12,13,25,2,3:28
447805,2016-06-12,2016,ANA,CLE,3,8,8-3,CLE,9,false,39,42,81,150,175,325,13,14,27,4,3:28
447804,2016-06-12,2016,ATL,CHN,2,13,13-2,CHN,9,false,36,50,86,194,146,340,8,25,33,3,3:42
447802,2016-06-12,2016,TOR,BAL,10,9,10-9,TOR,9,true,43,44,87,189,167,356,20,18,38,3,3:11
447814,2016-06-12,2016,COL,SDN,2,1,2-1,COL,9,true,33,36,69,137,121,258,9,10,19,2,2:49
447807,2016-06-12,2016,TBA,HOU,5,0,5-0,TBA,9,true,37,32,69,139,144,283,12,5,17,1,2:45
447817,2016-06-13,2016,WAS,CHN,4,1,4-1,WAS,9,true,40,29,69,123,143,266,17,2,19,2,2:44
447819,2016-06-13,2016,KCA,CLE,2,1,2-1,KCA,9,true,34,35,69,121,139,260,12,10,22,0,2:42
447824,2016-06-13,2016,ANA,MIN,4,9,9-4,MIN,9,false,35,43,78,161,145,306,9,14,23,0,2:50
447825,2016-06-13,2016,TOR,PHI,0,7,7-0,PHI,9,false,36,39,75,156,149,305,11,13,24,2,2:55
447826,2016-06-13,2016,OAK,TEX,14,5,14-5,OAK,9,true,44,38,82,143,169,312,22,11,33,3,3:06
447822,2016-06-13,2016,SDN,MIA,4,13,13-4,MIA,9,false,36,52,88,185,139,324,9,26,35,1,3:15
447823,2016-06-13,2016,SFN,MIL,11,5,11-5,SFN,9,true,42,43,85,164,172,336,21,17,38,4,3:38
447818,2016-06-13,2016,ATL,CIN,8,9,9-8,CIN,9,false,41,44,85,187,151,338,15,19,34,0,3:22
447820,2016-06-13,2016,CHA,DET,10,9,10-9,CHA,12,false,56,59,115,226,220,446,23,26,49,4,4:34
447821,2016-06-13,2016,ARI,LAN,3,2,3-2,ARI,9,true,30,39,69,160,129,289,8,12,20,5,3:21
447832,2016-06-14,2016,SLN,HOU,2,5,5-2,HOU,9,false,33,34,67,105,102,207,6,9,15,3,2:18
447827,2016-06-14,2016,BOS,BAL,2,3,3-2,BAL,9,false,36,32,68,117,152,269,10,5,15,1,2:47
447839,2016-06-14,2016,NYN,PIT,0,4,4-0,PIT,9,false,31,37,68,144,107,251,5,10,15,0,2:28
447836,2016-06-14,2016,ANA,MIN,5,4,5-4,ANA,9,true,35,39,74,143,119,262,15,12,27,2,2:55
447830,2016-06-14,2016,KCA,CLE,3,2,3-2,KCA,9,true,33,38,71,166,119,285,9,15,24,2,2:55
447829,2016-06-14,2016,ATL,CIN,1,3,3-1,CIN,9,false,37,35,72,147,139,286,12,6,18,1,2:58
447835,2016-06-14,2016,SFN,MIL,3,2,3-2,SFN,9,true,40,30,70,131,174,305,17,6,23,1,3:21
447834,2016-06-14,2016,SDN,MIA,2,5,5-2,MIA,9,false,36,38,74,155,146,301,9,11,20,0,3:00
447833,2016-06-14,2016,ARI,LAN,4,7,7-4,LAN,9,false,35,40,75,168,126,294,10,13,23,4,3:10
447841,2016-06-14,2016,OAK,TEX,6,10,10-6,TEX,9,false,38,44,82,175,128,303,12,18,30,2,3:08
447840,2016-06-14,2016,TBA,SEA,8,7,8-7,TBA,9,true,38,42,80,170,141,311,14,17,31,4,3:12
447838,2016-06-14,2016,TOR,PHI,11,3,11-3,TOR,9,true,45,34,79,126,174,300,19,8,27,1,2:43
447828,2016-06-14,2016,WAS,CHN,3,4,4-3,CHN,9,false,37,38,75,148,135,283,10,13,23,3,3:03
447837,2016-06-14,2016,COL,NYA,13,10,13-10,COL,9,true,43,46,89,176,158,334,21,20,41,5,3:43
447831,2016-06-14,2016,CHA,DET,8,11,11-8,DET,9,false,38,49,87,206,140,346,12,26,38,1,3:47
447846,2016-06-15,2016,CHA,DET,5,3,5-3,CHA,9,true,38,36,74,145,116,261,16,11,27,2,2:49
447848,2016-06-15,2016,ARI,LAN,2,3,3-2,LAN,9,false,33,35,68,146,138,284,6,10,16,2,2:51
447845,2016-06-15,2016,KCA,CLE,9,4,9-4,KCA,9,true,40,35,75,138,135,273,14,8,22,4,2:47
447842,2016-06-15,2016,BOS,BAL,6,4,6-4,BOS,9,true,39,38,77,131,154,285,17,11,28,2,2:58
447856,2016-06-15,2016,PHI,TOR,2,7,7-2,TOR,9,false,35,40,75,164,135,299,8,15,23,2,2:51
447850,2016-06-15,2016,SFN,MIL,10,1,10-1,SFN,9,true,46,36,82,131,151,282,21,10,31,1,2:56
447849,2016-06-15,2016,SDN,MIA,6,3,6-3,SDN,9,true,38,38,76,143,128,271,15,13,28,1,2:58
447855,2016-06-15,2016,OAK,TEX,5,7,7-5,TEX,9,false,37,38,75,136,172,308,10,13,23,2,3:08
447843,2016-06-15,2016,WAS,CHN,5,4,5-4,WAS,12,false,47,46,93,185,182,367,14,15,29,5,4:17
447851,2016-06-15,2016,ANA,MIN,10,2,10-2,ANA,9,true,43,35,78,153,176,329,19,8,27,2,3:13
447854,2016-06-15,2016,TBA,SEA,3,2,3-2,TBA,13,false,58,51,109,209,236,445,23,15,38,4,4:38
447844,2016-06-15,2016,ATL,CIN,9,8,9-8,ATL,13,false,63,56,119,241,257,498,27,20,47,4,5:18
447852,2016-06-15,2016,COL,NYA,6,3,6-3,COL,9,true,39,34,73,128,140,268,17,7,24,2,2:55
447847,2016-06-15,2016,SLN,HOU,1,4,4-1,HOU,9,false,36,36,72,133,133,266,12,14,26,2,2:56
447853,2016-06-15,2016,NYN,PIT,11,2,11-2,NYN,9,true,45,33,78,136,152,288,21,5,26,2,3:06
447857,2016-06-16,2016,BOS,BAL,1,5,5-1,BAL,9,false,32,40,72,150,119,269,5,14,19,1,2:53
447862,2016-06-16,2016,NYN,PIT,6,4,6-4,NYN,9,true,37,35,72,115,153,268,14,10,24,4,2:55
447864,2016-06-16,2016,OAK,TEX,1,5,5-1,TEX,9,false,30,40,70,162,109,271,3,14,17,2,2:35 (:01 delay)
447861,2016-06-16,2016,MIN,NYA,1,4,4-1,NYA,9,false,38,33,71,135,161,296,11,9,20,1,3:00
447858,2016-06-16,2016,ATL,CIN,7,2,7-2,ATL,9,true,37,38,75,156,140,296,13,12,25,3,2:56
447860,2016-06-16,2016,LAN,MIL,6,8,8-6,MIL,9,false,38,39,77,165,138,303,12,13,25,1,3:18
447859,2016-06-16,2016,KCA,DET,4,10,10-4,DET,9,false,38,43,81,159,133,292,13,16,29,0,3:15
447865,2016-06-16,2016,PHI,TOR,2,13,13-2,TOR,9,false,34,48,82,188,106,294,7,20,27,1,3:04
447863,2016-06-16,2016,TBA,SEA,4,6,6-4,SEA,9,false,42,43,85,177,175,352,15,19,34,1,3:30
447866,2016-06-16,2016,SDN,WAS,5,8,8-5,WAS,9,false,40,42,82,177,157,334,14,15,29,2,3:18
447879,2016-06-17,2016,SLN,TEX,0,1,1-0,TEX,9,false,32,34,66,119,109,228,6,8,14,2,2:23
447869,2016-06-17,2016,CLE,CHA,3,2,3-2,CLE,9,false,32,37,69,148,115,263,9,12,21,1,2:47
447871,2016-06-17,2016,MIA,COL,5,1,5-1,MIA,9,true,36,34,70,158,143,301,13,9,22,2,2:57
447878,2016-06-17,2016,BOS,SEA,4,8,8-4,SEA,9,false,38,39,77,130,121,251,12,13,25,1,2:49
447873,2016-06-17,2016,OAK,ANA,3,2,3-2,OAK,9,false,37,35,72,118,146,264,12,7,19,2,2:51
447877,2016-06-17,2016,TBA,SFN,1,5,5-1,SFN,9,false,30,38,68,165,115,280,4,11,15,0,2:45
447872,2016-06-17,2016,KCA,DET,10,3,10-3,KCA,9,true,43,36,79,151,164,315,20,10,30,3,3:17
447881,2016-06-17,2016,SDN,WAS,5,7,7-5,WAS,9,false,41,38,79,138,163,301,14,13,27,1,3:12
447874,2016-06-17,2016,LAN,MIL,3,2,3-2,LAN,10,false,39,44,83,182,140,322,14,15,29,1,3:37
447875,2016-06-17,2016,MIN,NYA,2,8,8-2,NYA,9,false,35,44,79,175,137,312,9,20,29,1,3:03 (:35 delay)
447867,2016-06-17,2016,PHI,ARI,2,10,10-2,ARI,9,false,35,44,79,167,136,303,8,17,25,1,3:04
447868,2016-06-17,2016,NYN,ATL,1,5,5-1,ATL,9,false,35,43,78,142,157,299,10,16,26,4,3:13
447870,2016-06-17,2016,HOU,CIN,2,4,4-2,CIN,11,false,49,45,94,158,206,364,16,15,31,2,3:57
447876,2016-06-17,2016,CHN,PIT,6,0,6-0,CHN,9,true,44,34,78,155,185,340,23,8,31,3,3:18
447880,2016-06-17,2016,BAL,TOR,3,13,13-3,TOR,9,false,36,43,79,171,139,310,9,18,27,1,2:53
447882,2016-06-18,2016,PHI,ARI,1,4,4-1,ARI,9,false,31,40,71,146,102,248,5,13,18,1,2:37
447895,2016-06-18,2016,BAL,TOR,4,2,4-2,BAL,9,true,34,38,72,141,134,275,12,13,25,0,2:33
447893,2016-06-18,2016,BOS,SEA,6,2,6-2,BOS,9,true,35,34,69,130,142,272,13,9,22,1,2:53
447892,2016-06-18,2016,TBA,SFN,4,6,6-4,SFN,9,false,38,39,77,157,138,295,13,14,27,5,3:13
447890,2016-06-18,2016,MIN,NYA,6,7,7-6,NYA,9,false,36,39,75,147,158,305,9,15,24,4,3:10
447883,2016-06-18,2016,NYN,ATL,3,4,4-3,ATL,9,false,37,36,73,157,135,292,10,12,22,3,3:02
447888,2016-06-18,2016,OAK,ANA,1,7,7-1,ANA,9,false,34,42,76,158,132,290,8,15,23,4,3:05
447894,2016-06-18,2016,SLN,TEX,3,4,4-3,TEX,9,false,36,39,75,159,141,300,12,13,25,2,3:05
447896,2016-06-18,2016,SDN,WAS,7,3,7-3,SDN,9,true,35,38,73,125,163,288,13,12,25,3,3:12
447889,2016-06-18,2016,LAN,MIL,10,6,10-6,LAN,9,true,40,39,79,160,167,327,18,15,33,2,3:28
447891,2016-06-18,2016,CHN,PIT,4,3,4-3,CHN,9,true,37,37,74,138,137,275,16,12,28,4,3:00
447886,2016-06-18,2016,MIA,COL,9,6,9-6,MIA,9,true,44,39,83,178,155,333,22,13,35,2,3:23
447884,2016-06-18,2016,CLE,CHA,13,2,13-2,CLE,9,true,47,35,82,145,185,330,24,8,32,3,3:00
447887,2016-06-18,2016,KCA,DET,16,5,16-5,KCA,9,true,47,37,84,122,171,293,26,12,38,4,3:16
447885,2016-06-18,2016,HOU,CIN,5,4,5-4,HOU,11,false,46,41,87,152,152,304,18,9,27,0,3:05
447904,2016-06-19,2016,LAN,MIL,2,1,2-1,LAN,9,false,35,33,68,125,116,241,11,9,20,1,2:44
447903,2016-06-19,2016,OAK,ANA,0,2,2-0,ANA,9,false,29,34,63,143,95,238,4,9,13,0,2:19
447898,2016-06-19,2016,NYN,ATL,0,6,6-0,ATL,9,false,28,41,69,164,120,284,1,14,15,0,2:51
447900,2016-06-19,2016,HOU,CIN,6,0,6-0,HOU,9,true,34,33,67,134,132,266,13,7,20,1,2:48
447905,2016-06-19,2016,MIN,NYA,7,4,7-4,MIN,9,true,36,35,71,131,153,284,13,7,20,3,3:00
447897,2016-06-19,2016,PHI,ARI,1,5,5-1,ARI,9,false,33,42,75,155,122,277,6,15,21,3,2:59
447908,2016-06-19,2016,BOS,SEA,2,1,2-1,BOS,9,true,37,33,70,123,158,281,18,8,26,1,3:05
447901,2016-06-19,2016,MIA,COL,3,0,3-0,MIA,9,true,32,34,66,134,143,277,9,9,18,1,2:51
447911,2016-06-19,2016,SDN,WAS,6,3,6-3,SDN,9,true,37,33,70,132,147,279,16,8,24,1,2:59
447909,2016-06-19,2016,SLN,TEX,4,5,5-4,TEX,9,false,38,38,76,135,139,274,15,12,27,2,2:58
447910,2016-06-19,2016,BAL,TOR,11,6,11-6,BAL,9,true,42,36,78,162,143,305,21,8,29,5,3:31
447899,2016-06-19,2016,CLE,CHA,3,2,3-2,CLE,10,false,42,39,81,144,147,291,18,11,29,2,3:12
447906,2016-06-19,2016,CHN,PIT,10,5,10-5,CHN,9,true,39,42,81,174,151,325,16,14,30,4,3:23
447902,2016-06-19,2016,KCA,DET,2,1,2-1,KCA,13,false,44,44,88,177,150,327,12,7,19,1,3:32
447907,2016-06-19,2016,TBA,SFN,1,5,5-1,SFN,9,false,37,38,75,165,147,312,9,12,21,2,3:30
447039,2016-06-20,2016,TEX,BAL,4,3,4-3,TEX,9,true,34,42,76,151,149,300,11,18,29,2,3:04
447912,2016-06-20,2016,PHI,ARI,1,3,3-1,ARI,9,false,33,32,65,111,124,235,7,7,14,1,2:40
447916,2016-06-20,2016,PIT,SFN,1,0,1-0,PIT,9,true,29,32,61,107,110,217,7,6,13,1,2:24
447919,2016-06-20,2016,CLE,TBA,7,4,7-4,CLE,9,true,35,33,68,128,115,243,11,6,17,1,2:26
447920,2016-06-20,2016,LAN,WAS,4,1,4-1,LAN,9,true,32,34,66,134,140,274,10,7,17,0,2:50
447918,2016-06-20,2016,CHN,SLN,2,3,3-2,SLN,9,false,38,39,77,157,137,294,13,14,27,2,3:00
447914,2016-06-20,2016,MIA,COL,3,5,5-3,COL,9,false,36,40,76,154,152,306,11,16,27,3,3:17
447039,2016-06-20,2016,TEX,BAL,4,3,4-3,TEX,9,true,34,42,76,151,149,300,11,18,29,2,3:04
447913,2016-06-20,2016,BOS,CHA,1,3,3-1,CHA,10,false,40,40,80,143,161,304,10,11,21,3,3:33
447915,2016-06-20,2016,HOU,ANA,10,7,10-7,HOU,9,true,43,38,81,147,160,307,22,11,33,2,3:13
447917,2016-06-20,2016,DET,SEA,8,7,8-7,DET,12,false,51,54,105,198,196,394,19,22,41,1,4:29
447935,2016-06-21,2016,LAN,WAS,3,2,3-2,LAN,9,true,30,39,69,147,115,262,8,15,23,1,2:44
447933,2016-06-21,2016,CHN,SLN,3,4,4-3,SLN,9,false,37,35,72,132,136,268,13,9,22,2,2:55
447921,2016-06-21,2016,TOR,ARI,2,4,4-2,ARI,9,false,36,33,69,130,130,260,12,6,18,1,2:42
447926,2016-06-21,2016,NYN,KCA,2,1,2-1,NYN,9,true,33,35,68,138,135,273,9,8,17,2,2:56
447923,2016-06-21,2016,BOS,CHA,1,3,3-1,CHA,9,false,36,33,69,135,149,284,9,8,17,2,2:54
447927,2016-06-21,2016,HOU,ANA,3,2,3-2,HOU,9,false,31,34,65,140,125,265,12,7,19,2,2:54
447922,2016-06-21,2016,MIA,ATL,2,3,3-2,ATL,10,false,41,37,78,140,170,310,13,9,22,4,3:16
447925,2016-06-21,2016,NYA,COL,4,8,8-4,COL,9,false,38,45,83,171,145,316,12,18,30,3,3:31
447930,2016-06-21,2016,BAL,SDN,7,10,10-7,SDN,9,false,43,49,92,187,162,349,15,22,37,3,3:44 (:38 delay)
447928,2016-06-21,2016,OAK,MIL,5,3,5-3,OAK,9,true,41,36,77,130,190,320,18,11,29,4,3:32
447929,2016-06-21,2016,MIN,PHI,14,10,14-10,MIN,9,true,45,43,88,155,185,340,21,15,36,2,3:24
447931,2016-06-21,2016,PIT,SFN,4,15,15-4,SFN,9,false,41,52,93,202,165,367,13,27,40,3,3:49
447924,2016-06-21,2016,TEX,CIN,2,8,8-2,CIN,9,false,32,38,70,125,124,249,8,12,20,0,2:29
447932,2016-06-21,2016,DET,SEA,4,2,4-2,DET,9,true,37,36,73,130,116,246,16,10,26,1,2:47
447934,2016-06-21,2016,CLE,TBA,6,0,6-0,CLE,9,true,36,32,68,115,129,244,13,5,18,1,2:36
447937,2016-06-22,2016,MIA,ATL,3,0,3-0,MIA,9,true,32,34,66,130,120,250,9,8,17,1,2:27
447939,2016-06-22,2016,TEX,CIN,6,4,6-4,TEX,9,true,31,39,70,152,125,277,8,12,20,0,2:38
447943,2016-06-22,2016,OAK,MIL,2,4,4-2,MIL,9,false,35,40,75,150,130,280,8,14,22,3,2:53
447942,2016-06-22,2016,HOU,ANA,3,2,3-2,HOU,9,true,32,39,71,143,119,262,12,13,25,2,3:09
447941,2016-06-22,2016,NYN,KCA,4,3,4-3,NYN,9,true,33,35,68,145,161,306,10,9,19,1,3:06
447948,2016-06-22,2016,CHN,SLN,2,7,7-2,SLN,9,false,31,43,74,177,132,309,6,14,20,4,3:02
447949,2016-06-22,2016,CLE,TBA,6,1,6-1,CLE,9,true,35,30,65,113,144,257,11,4,15,1,2:30
447940,2016-06-22,2016,NYA,COL,9,8,9-8,NYA,9,false,42,38,80,159,148,307,19,11,30,4,3:25
447936,2016-06-22,2016,TOR,ARI,5,2,5-2,TOR,9,true,31,38,69,151,133,284,9,12,21,1,2:54
447950,2016-06-22,2016,LAN,WAS,4,3,4-3,LAN,9,false,35,39,74,174,131,305,10,14,24,4,3:35
447946,2016-06-22,2016,PIT,SFN,6,7,7-6,SFN,9,false,38,44,82,158,159,317,12,17,29,1,3:28
447944,2016-06-22,2016,MIN,PHI,6,5,6-5,MIN,9,true,39,37,76,129,141,270,15,12,27,1,2:48 (1:10 delay)
447938,2016-06-22,2016,BOS,CHA,6,8,8-6,CHA,9,false,45,42,87,164,182,346,22,14,36,4,3:38
447947,2016-06-22,2016,DET,SEA,5,1,5-1,DET,9,true,38,33,71,121,139,260,16,6,22,2,2:39
447945,2016-06-22,2016,BAL,SDN,7,2,7-2,BAL,9,true,36,37,73,156,120,276,13,10,23,1,2:43
447955,2016-06-23,2016,ANA,OAK,4,5,5-4,OAK,9,false,37,39,76,152,134,286,12,13,25,1,3:03
447952,2016-06-23,2016,MIA,CHN,4,2,4-2,MIA,9,true,34,37,71,140,128,268,11,11,22,1,2:43
447954,2016-06-23,2016,ATL,NYN,4,3,4-3,ATL,9,true,34,39,73,138,126,264,13,12,25,2,2:54
447956,2016-06-23,2016,MIN,PHI,3,7,7-3,PHI,9,false,36,44,80,157,151,308,9,22,31,2,3:07
447958,2016-06-23,2016,PIT,SFN,3,5,5-3,SFN,9,false,35,36,71,144,166,310,8,11,19,0,3:04
447951,2016-06-23,2016,COL,ARI,6,7,7-6,ARI,9,false,44,43,87,175,168,343,16,18,34,2,3:42
447959,2016-06-23,2016,DET,SEA,5,4,5-4,DET,10,false,45,39,84,149,188,337,18,10,28,2,3:24
447957,2016-06-23,2016,CIN,SDN,4,7,7-4,SDN,9,false,39,39,78,181,170,351,12,13,25,1,3:26
447953,2016-06-23,2016,BOS,CHA,8,7,8-7,BOS,10,false,48,47,95,154,201,355,23,20,43,4,4:25
447967,2016-06-24,2016,ATL,NYN,6,8,8-6,NYN,9,false,37,39,76,130,129,259,12,16,28,3,2:55
447966,2016-06-24,2016,NYA,MIN,5,3,5-3,NYA,9,true,37,35,72,130,149,279,11,9,20,1,2:59
447963,2016-06-24,2016,DET,CLE,5,7,7-5,CLE,9,false,39,38,77,144,153,297,14,13,27,2,3:01
447971,2016-06-24,2016,SEA,SLN,4,3,4-3,SEA,9,false,34,36,70,146,133,279,10,10,20,1,2:52
447972,2016-06-24,2016,BAL,TBA,6,3,6-3,BAL,9,true,33,35,68,160,135,295,9,12,21,2,3:07
447974,2016-06-24,2016,MIL,WAS,5,3,5-3,MIL,9,true,32,41,73,183,145,328,8,14,22,0,3:06
447965,2016-06-24,2016,PIT,LAN,8,6,8-6,PIT,9,true,38,40,78,147,149,296,16,15,31,4,3:17
447973,2016-06-24,2016,CHA,TOR,3,2,3-2,CHA,9,true,37,40,77,168,140,308,13,13,26,1,3:22
447970,2016-06-24,2016,CIN,SDN,4,13,13-4,SDN,9,false,38,45,83,178,147,325,11,19,30,1,3:12
447962,2016-06-24,2016,MIA,CHN,4,5,5-4,CHN,9,false,36,41,77,155,175,330,8,15,23,3,3:24
447968,2016-06-24,2016,ANA,OAK,4,7,7-4,OAK,9,false,40,40,80,155,140,295,13,15,28,3,3:17
447961,2016-06-24,2016,TEX,BOS,7,8,8-7,BOS,9,false,43,40,83,170,173,343,18,16,34,2,3:48
447969,2016-06-24,2016,SFN,PHI,5,4,5-4,SFN,9,true,36,42,78,159,134,293,10,17,27,5,3:21
447964,2016-06-24,2016,KCA,HOU,4,13,13-4,HOU,9,false,38,50,88,172,129,301,13,21,34,2,2:56
447960,2016-06-24,2016,COL,ARI,9,10,10-9,ARI,9,false,52,49,101,170,211,381,24,24,48,8,4:30
446940,2016-06-25,2016,BAL,TBA,5,0,5-0,BAL,9,true,39,33,72,135,139,274,17,6,23,3,2:46
447985,2016-06-25,2016,CIN,SDN,0,3,3-0,SDN,9,false,31,38,69,147,130,277,5,12,17,1,2:44
447978,2016-06-25,2016,DET,CLE,0,6,6-0,CLE,9,false,32,36,68,142,117,259,5,10,15,0,2:43
446940,2016-06-25,2016,BAL,TBA,5,0,5-0,BAL,9,true,39,33,72,135,139,274,17,6,23,3,2:46
447977,2016-06-25,2016,MIA,CHN,9,6,9-6,MIA,9,true,37,43,80,163,153,316,13,18,31,3,3:09
447981,2016-06-25,2016,NYA,MIN,2,1,2-1,NYA,9,true,36,31,67,126,147,273,12,4,16,1,2:44
447986,2016-06-25,2016,SEA,SLN,5,4,5-4,SEA,9,true,38,39,77,149,139,288,15,11,26,2,2:53
447982,2016-06-25,2016,ATL,NYN,0,1,1-0,NYN,11,false,40,40,80,152,131,283,12,10,22,2,3:19
447988,2016-06-25,2016,CHA,TOR,8,10,10-8,TOR,9,false,40,45,85,158,138,296,13,18,31,4,3:14
447983,2016-06-25,2016,ANA,OAK,3,7,7-3,OAK,9,false,42,42,84,150,173,323,15,18,33,4,3:24
447980,2016-06-25,2016,PIT,LAN,6,1,6-1,PIT,9,true,32,34,66,123,148,271,9,8,17,1,2:47
447975,2016-06-25,2016,COL,ARI,11,6,11-6,COL,9,true,42,43,85,178,147,325,20,20,40,1,3:35
447984,2016-06-25,2016,SFN,PHI,2,3,3-2,PHI,9,false,35,32,67,138,124,262,8,7,15,1,2:47
447987,2016-06-25,2016,BAL,TBA,8,6,8-6,BAL,9,true,36,43,79,157,150,307,15,20,35,2,3:15
447979,2016-06-25,2016,KCA,HOU,5,13,13-5,HOU,9,false,44,48,92,179,176,355,20,22,42,3,3:40
447976,2016-06-25,2016,TEX,BOS,10,3,10-3,TEX,9,true,42,36,78,170,175,345,17,11,28,4,3:30
447989,2016-06-25,2016,MIL,WAS,6,5,6-5,MIL,9,true,36,41,77,131,141,272,13,15,28,1,3:05
447995,2016-06-26,2016,PIT,LAN,4,3,4-3,PIT,9,true,33,34,67,116,124,240,12,8,20,0,2:40
448003,2016-06-26,2016,CHA,TOR,5,2,5-2,CHA,9,true,36,31,67,109,145,254,12,7,19,0,2:27
447997,2016-06-26,2016,ATL,NYN,5,2,5-2,ATL,9,true,36,34,70,124,114,238,12,7,19,2,2:39
447994,2016-06-26,2016,KCA,HOU,6,1,6-1,KCA,9,true,36,31,67,123,127,250,13,5,18,2,2:33
448004,2016-06-26,2016,MIL,WAS,2,3,3-2,WAS,9,false,38,37,75,149,137,286,12,10,22,2,3:14
447999,2016-06-26,2016,SFN,PHI,8,7,8-7,SFN,9,false,44,41,85,134,146,280,20,15,35,3,3:16
448002,2016-06-26,2016,BAL,TBA,12,5,12-5,BAL,9,true,42,40,82,147,160,307,20,15,35,0,3:03
447998,2016-06-26,2016,ANA,OAK,7,6,7-6,ANA,9,false,42,40,82,160,173,333,16,14,30,1,3:33
447993,2016-06-26,2016,DET,CLE,3,9,9-3,CLE,9,false,34,40,74,153,112,265,7,15,22,1,2:48
447996,2016-06-26,2016,NYA,MIN,1,7,7-1,MIN,9,false,29,37,66,145,110,255,2,12,14,1,2:24
448000,2016-06-26,2016,CIN,SDN,3,0,3-0,CIN,9,true,36,30,66,130,112,242,13,6,19,0,2:38
447990,2016-06-26,2016,COL,ARI,9,7,9-7,COL,9,false,43,44,87,140,152,292,20,18,38,4,3:35
447992,2016-06-26,2016,MIA,CHN,6,1,6-1,MIA,9,true,39,34,73,131,156,287,14,8,22,3,3:07
448001,2016-06-26,2016,SEA,SLN,6,11,11-6,SLN,9,false,42,48,90,172,173,345,16,20,36,2,3:25
447991,2016-06-26,2016,TEX,BOS,6,2,6-2,TEX,9,true,36,37,73,140,144,284,19,11,30,2,3:04
448013,2016-06-27,2016,KCA,SLN,6,2,6-2,KCA,9,true,37,31,68,111,139,250,13,6,19,0,2:32
448011,2016-06-27,2016,SFN,OAK,3,8,8-3,OAK,9,false,35,41,76,146,122,268,10,18,28,2,2:43
448009,2016-06-27,2016,PIT,LAN,4,5,5-4,LAN,9,false,37,41,78,161,161,322,11,15,26,3,3:32
448015,2016-06-27,2016,COL,TOR,9,5,9-5,COL,9,true,39,34,73,132,147,279,15,7,22,2,2:48
448014,2016-06-27,2016,NYA,TEX,6,9,9-6,TEX,9,false,46,44,90,170,170,340,20,16,36,2,3:43 (3:56 delay)
448007,2016-06-27,2016,ATL,CLE,3,8,8-3,CLE,9,false,38,40,78,142,156,298,12,15,27,3,3:15
448012,2016-06-27,2016,ARI,PHI,0,8,8-0,PHI,9,false,34,45,79,161,146,307,9,18,27,2,3:18
448006,2016-06-27,2016,CIN,CHN,8,11,11-8,CHN,9,false,41,46,87,165,156,321,14,20,34,4,3:22
448008,2016-06-27,2016,ANA,HOU,2,4,4-2,HOU,9,false,36,42,78,165,123,288,12,17,29,3,3:38
448010,2016-06-27,2016,WAS,NYN,11,4,11-4,WAS,9,true,44,40,84,140,169,309,22,15,37,0,3:33
448005,2016-06-27,2016,TBA,BOS,13,7,13-7,TBA,9,true,44,42,86,165,184,349,21,16,37,2,3:29
448019,2016-06-28,2016,ATL,CLE,3,5,5-3,CLE,9,false,31,41,72,146,104,250,6,15,21,1,2:40
448024,2016-06-28,2016,WAS,NYN,5,0,5-0,WAS,9,true,36,34,70,135,130,265,15,8,23,3,2:47 (2:20 delay)
448023,2016-06-28,2016,CHA,MIN,0,4,4-0,MIN,9,false,35,36,71,138,137,275,7,10,17,0,2:51
448026,2016-06-28,2016,ARI,PHI,3,4,4-3,PHI,9,false,38,41,79,165,159,324,15,16,31,1,3:34
448029,2016-06-28,2016,NYA,TEX,1,7,7-1,TEX,9,false,35,39,74,126,117,243,9,13,22,1,2:37
448027,2016-06-28,2016,SEA,PIT,5,2,5-2,SEA,9,true,36,33,69,135,154,289,14,8,22,2,2:53
448016,2016-06-28,2016,SDN,BAL,7,11,11-7,BAL,9,false,41,46,87,158,176,334,15,20,35,2,3:08
448022,2016-06-28,2016,DET,MIA,7,5,7-5,DET,9,true,36,44,80,151,150,301,12,18,30,3,3:00
448028,2016-06-28,2016,KCA,SLN,4,8,8-4,SLN,9,false,40,42,82,150,144,294,13,15,28,1,2:50
448021,2016-06-28,2016,MIL,LAN,5,6,6-5,LAN,9,false,38,44,82,157,148,305,12,19,31,2,3:25
448017,2016-06-28,2016,TBA,BOS,2,8,8-2,BOS,9,false,36,43,79,164,145,309,9,18,27,1,3:11
448020,2016-06-28,2016,ANA,HOU,1,7,7-1,HOU,9,false,36,43,79,180,125,305,9,17,26,1,3:07
448030,2016-06-28,2016,COL,TOR,9,14,14-9,TOR,9,false,44,54,98,198,181,379,16,27,43,3,3:51 (2:41 delay)
448025,2016-06-28,2016,SFN,OAK,11,13,13-11,OAK,9,false,50,48,98,185,167,352,25,20,45,6,3:53
448018,2016-06-28,2016,CIN,CHN,2,7,7-2,CHN,15,false,54,61,115,244,209,453,11,17,28,5,4:43
448034,2016-06-29,2016,ATL,CLE,0,3,3-0,CLE,9,false,35,36,71,128,139,267,9,10,19,1,2:51
448044,2016-06-29,2016,NYA,TEX,9,7,9-7,NYA,9,false,42,39,81,159,149,308,17,12,29,3,3:19
448043,2016-06-29,2016,OAK,SFN,7,1,7-1,OAK,9,true,33,36,69,131,127,258,9,11,20,2,2:44
448031,2016-06-29,2016,SDN,BAL,6,12,12-6,BAL,9,false,39,45,84,158,146,304,13,19,32,3,3:07
448045,2016-06-29,2016,COL,TOR,3,5,5-3,TOR,9,false,38,44,82,175,135,310,13,18,31,1,3:17
448037,2016-06-29,2016,MIL,LAN,7,0,7-0,MIL,9,true,36,30,66,121,145,266,16,4,20,0,2:30
448038,2016-06-29,2016,DET,MIA,10,3,10-3,DET,9,true,42,42,84,160,185,345,18,15,33,1,3:13
448040,2016-06-29,2016,WAS,NYN,4,2,4-2,WAS,9,true,33,34,67,140,139,279,11,7,18,3,3:01
448042,2016-06-29,2016,SEA,PIT,1,8,8-1,PIT,9,false,32,45,77,166,123,289,6,15,21,0,2:47
448039,2016-06-29,2016,CHA,MIN,9,6,9-6,CHA,9,true,38,43,81,161,143,304,14,17,31,4,3:03
448041,2016-06-29,2016,ARI,PHI,8,9,9-8,PHI,10,false,47,50,97,178,171,349,18,20,38,5,3:53
448032,2016-06-29,2016,TBA,BOS,4,0,4-0,TBA,9,true,34,34,68,138,123,261,10,7,17,1,2:49
448035,2016-06-29,2016,ANA,HOU,4,10,10-4,HOU,9,false,43,46,89,160,154,314,16,19,35,2,3:18
448033,2016-06-29,2016,CIN,CHN,2,9,9-2,CHN,9,false,38,44,82,176,161,337,14,19,33,3,3:14
448036,2016-06-29,2016,SLN,KCA,2,3,3-2,KCA,12,false,50,58,108,215,195,410,14,21,35,3,4:28
448049,2016-06-30,2016,TOR,CLE,1,4,4-1,CLE,9,false,32,36,68,118,140,258,6,11,17,1,2:33
448046,2016-06-30,2016,SEA,BAL,5,3,5-3,SEA,9,true,38,35,73,143,159,302,16,9,25,4,3:06
448047,2016-06-30,2016,NYN,CHN,4,3,4-3,NYN,9,true,34,41,75,179,141,320,9,16,25,4,3:22
448051,2016-06-30,2016,SLN,KCA,2,4,4-2,KCA,9,false,36,35,71,138,165,303,10,8,18,0,2:50
448052,2016-06-30,2016,MIL,LAN,1,8,8-1,LAN,9,false,35,44,79,185,140,325,8,19,27,2,3:19
448048,2016-06-30,2016,WAS,CIN,13,4,13-4,WAS,9,true,43,39,82,149,172,321,21,15,36,1,3:07
448056,2016-06-30,2016,NYA,TEX,2,1,2-1,NYA,9,false,36,34,70,144,154,298,11,7,18,1,3:12
448050,2016-06-30,2016,TBA,DET,7,10,10-7,DET,9,false,41,40,81,176,154,330,16,16,32,3,3:25
448053,2016-06-30,2016,ATL,MIA,8,5,8-5,ATL,9,true,41,45,86,204,149,353,18,18,36,3,3:33 (1:08 delay)
448054,2016-06-30,2016,CHA,MIN,6,5,6-5,CHA,9,true,37,35,72,150,144,294,16,10,26,3,3:03
448055,2016-06-30,2016,OAK,SFN,6,12,12-6,SFN,9,false,38,49,87,209,159,368,11,25,36,4,3:43
448059,2016-07-01,2016,HOU,CHA,5,0,5-0,HOU,9,true,33,34,67,131,114,245,10,8,18,0,2:58
448067,2016-07-01,2016,SLN,MIL,7,1,7-1,SLN,9,true,40,35,75,106,137,243,16,8,24,1,2:47
448070,2016-07-01,2016,ARI,SFN,4,6,6-4,SFN,9,false,36,38,74,128,145,273,10,12,22,0,2:52
448071,2016-07-01,2016,MIN,TEX,2,3,3-2,TEX,10,false,37,42,79,177,135,312,10,12,22,1,3:04
448064,2016-07-01,2016,PHI,KCA,4,3,4-3,PHI,9,true,37,36,73,146,149,295,15,10,25,0,3:06
448058,2016-07-01,2016,NYN,CHN,10,2,10-2,NYN,9,true,40,36,76,152,158,310,16,9,25,2,2:56 (1:59 delay)
448057,2016-07-01,2016,SEA,BAL,5,2,5-2,SEA,9,true,36,34,70,118,146,264,12,6,18,0,2:35
448069,2016-07-01,2016,OAK,PIT,3,7,7-3,PIT,9,false,35,37,72,141,142,283,7,11,18,0,2:45
448065,2016-07-01,2016,BOS,ANA,5,4,5-4,BOS,9,true,39,42,81,182,148,330,20,18,38,2,3:36 (1:35 delay)
448068,2016-07-01,2016,SDN,NYA,7,6,7-6,SDN,9,true,36,38,74,146,149,295,13,11,24,4,3:12
448066,2016-07-01,2016,ATL,MIA,5,7,7-5,MIA,12,false,51,55,106,186,171,357,16,22,38,2,4:05
448060,2016-07-01,2016,WAS,CIN,3,2,3-2,WAS,14,false,55,51,106,190,209,399,16,13,29,1,4:30 (:35 delay)
448061,2016-07-01,2016,TOR,CLE,1,2,2-1,CLE,19,false,75,76,151,305,301,606,21,20,41,4,6:13
448062,2016-07-01,2016,LAN,COL,5,0,5-0,LAN,9,true,34,33,67,145,112,257,13,7,20,2,2:53
448063,2016-07-01,2016,TBA,DET,2,10,10-2,DET,9,false,32,45,77,191,123,314,5,18,23,2,3:06
448085,2016-07-02,2016,ARI,SFN,6,5,6-5,ARI,9,true,35,36,71,143,115,258,11,10,21,3,2:55
448083,2016-07-02,2016,SDN,NYA,2,1,2-1,SDN,9,false,32,33,65,122,124,246,10,7,17,1,2:43
448081,2016-07-02,2016,ATL,MIA,9,1,9-1,ATL,9,true,35,37,72,139,116,255,11,10,21,1,2:28
448074,2016-07-02,2016,HOU,CHA,6,7,7-6,CHA,9,false,36,42,78,188,131,319,8,18,26,3,3:09
448077,2016-07-02,2016,LAN,COL,6,1,6-1,LAN,9,true,38,34,72,159,167,326,14,7,21,1,3:11
448079,2016-07-02,2016,PHI,KCA,2,6,6-2,KCA,9,false,36,37,73,160,114,274,9,12,21,1,2:47
448078,2016-07-02,2016,TBA,DET,2,3,3-2,DET,9,false,32,36,68,160,124,284,7,10,17,2,2:53
448084,2016-07-02,2016,OAK,PIT,2,4,4-2,PIT,10,false,42,42,84,150,170,320,13,16,29,0,3:19
448073,2016-07-02,2016,NYN,CHN,4,3,4-3,NYN,9,true,33,37,70,148,140,288,10,10,20,4,3:06
448076,2016-07-02,2016,TOR,CLE,9,6,9-6,TOR,9,true,42,39,81,180,166,346,18,12,30,3,3:19
448086,2016-07-02,2016,MIN,TEX,17,5,17-5,MIN,9,true,46,37,83,140,185,325,20,10,30,3,3:06
448072,2016-07-02,2016,SEA,BAL,12,6,12-6,SEA,9,true,46,40,86,151,182,333,23,14,37,3,3:15
448080,2016-07-02,2016,BOS,ANA,2,21,21-2,ANA,9,false,39,55,94,169,167,336,12,26,38,2,3:38
448075,2016-07-02,2016,WAS,CIN,4,9,9-4,CIN,10,false,40,49,89,170,155,325,9,20,29,5,3:35
448082,2016-07-02,2016,SLN,MIL,3,0,3-0,SLN,9,true,34,33,67,124,119,243,11,10,21,0,2:40 (1:32 delay)
448096,2016-07-03,2016,ATL,MIA,2,5,5-2,MIA,9,false,37,42,79,150,134,284,10,16,26,2,2:59
448098,2016-07-03,2016,SDN,NYA,3,6,6-3,NYA,9,false,35,42,77,142,143,285,9,16,25,2,3:12
448090,2016-07-03,2016,WAS,CIN,12,1,12-1,WAS,9,true,44,34,78,153,163,316,21,7,28,3,3:08
448089,2016-07-03,2016,HOU,CHA,1,4,4-1,CHA,9,false,33,41,74,162,126,288,6,14,20,2,2:58
448094,2016-07-03,2016,PHI,KCA,7,2,7-2,PHI,9,true,35,36,71,139,122,261,12,10,22,1,2:42
448095,2016-07-03,2016,BOS,ANA,10,5,10-5,BOS,9,true,43,38,81,151,183,334,21,15,36,3,3:52
448087,2016-07-03,2016,SEA,BAL,9,4,9-4,SEA,9,true,38,40,78,127,152,279,13,13,26,4,2:53
448092,2016-07-03,2016,LAN,COL,4,1,4-1,LAN,9,true,33,32,65,128,136,264,12,6,18,1,2:52
448100,2016-07-03,2016,ARI,SFN,4,5,5-4,SFN,11,false,45,48,93,185,179,364,12,16,28,1,3:47
448101,2016-07-03,2016,MIN,TEX,5,4,5-4,MIN,9,true,38,37,75,165,144,309,15,11,26,2,3:04
448093,2016-07-03,2016,TBA,DET,1,5,5-1,DET,9,false,36,41,77,177,119,296,10,16,26,4,3:11
448091,2016-07-03,2016,TOR,CLE,17,1,17-1,TOR,9,true,53,32,85,125,209,334,30,5,35,2,3:10
448099,2016-07-03,2016,OAK,PIT,3,6,6-3,PIT,9,false,37,42,79,167,159,326,12,18,30,3,3:35
448088,2016-07-03,2016,NYN,CHN,14,3,14-3,NYN,9,true,52,38,90,123,205,328,28,12,40,2,3:17
448097,2016-07-03,2016,SLN,MIL,9,8,9-8,SLN,9,true,43,47,90,199,154,353,19,21,40,4,3:48 (2:15 delay)
448107,2016-07-04,2016,TOR,KCA,6,2,6-2,TOR,9,true,34,32,66,105,128,233,12,5,17,1,2:10
448102,2016-07-04,2016,PHI,ATL,8,2,8-2,PHI,9,true,37,37,74,125,117,242,13,9,22,1,2:27
448108,2016-07-04,2016,TBA,ANA,4,2,4-2,TBA,9,true,32,40,72,154,141,295,9,12,21,2,3:12
448103,2016-07-04,2016,LAN,BAL,7,5,7-5,LAN,9,true,38,37,75,140,157,297,15,10,25,2,3:12
448110,2016-07-04,2016,WAS,MIL,0,1,1-0,MIL,9,false,32,36,68,157,136,293,6,8,14,1,3:01
448115,2016-07-04,2016,HOU,SEA,2,1,2-1,HOU,9,true,34,31,65,116,115,231,13,6,19,2,2:26
448109,2016-07-04,2016,NYN,MIA,8,6,8-6,NYN,9,true,40,43,83,162,171,333,19,19,38,2,3:38
448116,2016-07-04,2016,BOS,TEX,12,5,12-5,BOS,9,true,48,41,89,163,190,353,25,16,41,2,3:40
448105,2016-07-04,2016,SFN,COL,3,1,3-1,SFN,9,true,30,35,65,139,120,259,6,8,14,4,2:56
448112,2016-07-04,2016,MIN,OAK,1,3,3-1,OAK,9,false,36,37,73,162,134,296,9,10,19,2,2:50
448113,2016-07-04,2016,SLN,PIT,2,4,4-2,PIT,9,false,39,38,77,148,143,291,13,13,26,2,2:54 (1:26 delay)
448106,2016-07-04,2016,CLE,DET,5,3,5-3,CLE,9,true,36,36,72,147,128,275,13,12,25,3,3:20 (2:21 delay)
448111,2016-07-04,2016,CHA,NYA,8,2,8-2,CHA,9,true,42,40,82,150,147,297,16,10,26,2,3:06
448114,2016-07-04,2016,ARI,SDN,4,8,8-4,SDN,9,false,39,40,79,177,143,320,11,15,26,3,3:25
448104,2016-07-04,2016,CHN,CIN,10,4,10-4,CHN,9,true,46,37,83,146,178,324,21,10,31,2,3:01
448117,2016-07-05,2016,PHI,ATL,5,1,5-1,PHI,9,true,34,29,63,92,126,218,11,6,17,1,2:08
448130,2016-07-05,2016,HOU,SEA,5,2,5-2,HOU,9,true,33,35,68,148,117,265,9,8,17,0,2:34
448118,2016-07-05,2016,LAN,BAL,1,4,4-1,BAL,9,false,34,39,73,164,130,294,8,14,22,1,3:17
448126,2016-07-05,2016,CHA,NYA,0,9,9-0,NYA,9,false,33,50,83,179,117,296,7,23,30,2,3:07
448120,2016-07-05,2016,SFN,COL,3,7,7-3,COL,9,false,39,45,84,180,159,339,11,18,29,5,3:34
448122,2016-07-05,2016,TOR,KCA,8,3,8-3,TOR,9,true,37,35,72,140,148,288,15,10,25,1,2:32
448128,2016-07-05,2016,SLN,PIT,2,5,5-2,PIT,9,false,37,38,75,131,158,289,10,11,21,0,3:07
448121,2016-07-05,2016,CLE,DET,12,1,12-1,CLE,9,true,43,34,77,136,167,303,20,9,29,1,3:05
448124,2016-07-05,2016,NYN,MIA,2,5,5-2,MIA,9,false,34,37,71,138,124,262,7,11,18,0,2:33
448129,2016-07-05,2016,ARI,SDN,7,5,7-5,ARI,9,true,35,39,74,142,134,276,11,15,26,0,2:52
448131,2016-07-05,2016,BOS,TEX,2,7,7-2,TEX,9,false,43,39,82,132,172,304,18,13,31,2,3:21
448125,2016-07-05,2016,WAS,MIL,2,5,5-2,MIL,9,false,37,39,76,141,131,272,14,15,29,2,2:52
448123,2016-07-05,2016,TBA,ANA,5,13,13-5,ANA,9,false,40,48,88,169,154,323,16,20,36,3,3:19
448127,2016-07-05,2016,MIN,OAK,11,4,11-4,MIN,9,true,40,38,78,165,147,312,16,11,27,3,3:08 (2:42 delay)
448119,2016-07-05,2016,CHN,CIN,5,9,9-5,CIN,9,false,40,43,83,167,152,319,13,17,30,0,3:08
448141,2016-07-06,2016,CHA,NYA,5,0,5-0,CHA,9,true,31,35,66,132,129,261,10,9,19,1,2:54
448132,2016-07-06,2016,PHI,ATL,4,3,4-3,PHI,9,true,35,38,73,129,132,261,14,9,23,3,2:54
448136,2016-07-06,2016,CLE,DET,2,12,12-2,DET,9,false,36,41,77,165,138,303,11,14,25,2,3:13
448142,2016-07-06,2016,MIN,OAK,4,0,4-0,MIN,9,true,40,28,68,100,165,265,16,2,18,2,2:44
448137,2016-07-06,2016,TOR,KCA,4,2,4-2,TOR,9,true,33,31,64,99,138,237,9,5,14,0,2:16
448144,2016-07-06,2016,ARI,SDN,6,13,13-6,SDN,9,false,43,44,87,144,167,311,17,17,34,2,3:10
448138,2016-07-06,2016,TBA,ANA,2,7,7-2,ANA,9,false,37,40,77,158,158,316,11,14,25,1,3:18
448143,2016-07-06,2016,SLN,PIT,5,7,7-5,PIT,9,false,39,42,81,168,151,319,13,15,28,1,3:21
448145,2016-07-06,2016,HOU,SEA,9,8,9-8,HOU,9,true,41,42,83,177,176,353,17,17,34,3,3:32
448135,2016-07-06,2016,SFN,COL,5,1,5-1,SFN,9,true,34,31,65,118,120,238,12,6,18,1,2:31
448139,2016-07-06,2016,NYN,MIA,4,2,4-2,NYN,9,true,32,34,66,147,118,265,8,9,17,1,2:40
448140,2016-07-06,2016,WAS,MIL,7,4,7-4,WAS,9,true,36,35,71,129,134,263,14,9,23,2,2:47
448134,2016-07-06,2016,CHN,CIN,3,5,5-3,CIN,9,false,35,37,72,182,138,320,10,11,21,0,2:56
448146,2016-07-06,2016,BOS,TEX,11,6,11-6,BOS,9,true,41,42,83,167,151,318,15,15,30,3,3:19
448133,2016-07-06,2016,LAN,BAL,4,6,6-4,BAL,14,false,62,61,123,277,249,526,26,22,48,2,5:26
447214,2016-07-07,2016,CHN,ATL,3,4,4-3,ATL,11,false,44,44,88,189,178,367,14,10,24,6,3:54 (1:35 delay)
448155,2016-07-07,2016,KCA,SEA,4,3,4-3,KCA,9,false,32,37,69,153,91,244,11,11,22,1,2:37
448151,2016-07-07,2016,HOU,OAK,1,3,3-1,OAK,9,false,32,36,68,131,133,264,5,10,15,1,2:32
448154,2016-07-07,2016,LAN,SDN,0,6,6-0,SDN,9,false,34,40,74,149,135,284,7,14,21,1,2:45
448152,2016-07-07,2016,COL,PHI,11,2,11-2,COL,9,true,39,37,76,137,145,282,15,11,26,2,2:53
448156,2016-07-07,2016,NYN,WAS,9,7,9-7,NYN,9,true,47,40,87,152,181,333,25,14,39,6,3:39
448149,2016-07-07,2016,TEX,MIN,1,10,10-1,MIN,9,false,36,52,88,215,157,372,10,25,35,1,3:37
448153,2016-07-07,2016,SLN,PIT,5,1,5-1,SLN,9,true,31,34,65,139,115,254,8,7,15,2,2:42 (:31 delay)
447214,2016-07-07,2016,CHN,ATL,3,4,4-3,ATL,11,false,44,44,88,189,178,367,14,10,24,6,3:54 (1:35 delay)
448148,2016-07-07,2016,TBA,ANA,1,5,5-1,ANA,9,false,36,38,74,145,149,294,9,12,21,2,3:01
448147,2016-07-07,2016,TOR,DET,5,4,5-4,TOR,9,true,43,36,79,133,156,289,18,11,29,3,3:18
448150,2016-07-07,2016,CLE,NYA,4,5,5-4,NYA,9,false,35,41,76,143,144,287,8,15,23,2,3:00
448160,2016-07-08,2016,MIA,CIN,3,1,3-1,MIA,9,true,31,32,63,119,118,237,9,7,16,0,2:16
448171,2016-07-08,2016,NYN,WAS,1,3,3-1,WAS,9,false,33,35,68,157,132,289,7,9,16,4,3:17 (:37 delay)
448161,2016-07-08,2016,TOR,DET,6,0,6-0,TOR,9,true,38,35,73,146,158,304,17,8,25,2,3:07
448170,2016-07-08,2016,BOS,TBA,6,5,6-5,BOS,9,true,36,40,76,158,151,309,13,13,26,2,3:20
448163,2016-07-08,2016,TEX,MIN,6,5,6-5,TEX,9,true,36,38,74,164,144,308,13,13,26,2,3:14
448165,2016-07-08,2016,HOU,OAK,10,9,10-9,HOU,9,false,41,40,81,160,164,324,16,16,32,3,3:29
448158,2016-07-08,2016,CHA,ATL,8,11,11-8,ATL,9,false,43,45,88,160,169,329,16,21,37,2,3:17
448168,2016-07-08,2016,KCA,SEA,2,3,3-2,SEA,9,false,34,34,68,123,125,248,9,8,17,2,2:41
448162,2016-07-08,2016,BAL,ANA,5,9,9-5,ANA,9,false,42,44,86,150,155,305,14,17,31,2,3:27
448157,2016-07-08,2016,SFN,ARI,6,2,6-2,SFN,9,true,40,37,77,158,157,315,15,11,26,3,3:27
448159,2016-07-08,2016,PIT,CHN,8,4,8-4,PIT,9,true,41,40,81,164,139,303,16,14,30,4,3:23
448167,2016-07-08,2016,LAN,SDN,10,6,10-6,LAN,9,true,43,43,86,177,162,339,22,17,39,3,3:45
448164,2016-07-08,2016,CLE,NYA,10,2,10-2,CLE,9,true,36,33,69,112,160,272,12,7,19,1,2:36
448169,2016-07-08,2016,MIL,SLN,4,3,4-3,MIL,9,false,37,41,78,145,134,279,10,14,24,3,3:05
448166,2016-07-08,2016,COL,PHI,3,5,5-3,PHI,9,false,41,39,80,143,173,316,16,11,27,4,3:36
448182,2016-07-09,2016,LAN,SDN,4,3,4-3,LAN,9,true,34,33,67,130,110,240,11,6,17,2,2:45
448185,2016-07-09,2016,BOS,TBA,4,1,4-1,BOS,9,true,36,33,69,125,139,264,13,7,20,0,2:43
448180,2016-07-09,2016,HOU,OAK,2,3,3-2,OAK,9,false,32,40,72,165,113,278,6,15,21,3,2:52
448173,2016-07-09,2016,CHA,ATL,5,4,5-4,CHA,9,true,34,37,71,145,124,269,12,13,25,2,2:48
448176,2016-07-09,2016,TOR,DET,2,3,3-2,DET,9,false,35,36,71,147,143,290,8,10,18,0,2:47
448183,2016-07-09,2016,KCA,SEA,5,3,5-3,KCA,9,true,37,36,73,147,125,272,14,11,25,2,2:53
448175,2016-07-09,2016,MIA,CIN,4,2,4-2,MIA,9,true,33,36,69,155,139,294,10,10,20,2,2:48
448181,2016-07-09,2016,COL,PHI,8,3,8-3,COL,9,true,36,39,75,138,129,267,13,13,26,1,2:45
448172,2016-07-09,2016,SFN,ARI,4,2,4-2,SFN,9,true,34,38,72,141,131,272,12,10,22,5,3:03
448177,2016-07-09,2016,BAL,ANA,3,2,3-2,BAL,9,true,34,36,70,151,133,284,12,13,25,3,3:14
448184,2016-07-09,2016,MIL,SLN,1,8,8-1,SLN,9,false,36,43,79,186,152,338,11,17,28,2,3:26 (:09 delay)
448178,2016-07-09,2016,TEX,MIN,6,8,8-6,MIN,9,false,40,44,84,189,157,346,15,18,33,1,3:20 (1:10 delay)
448174,2016-07-09,2016,PIT,CHN,12,6,12-6,PIT,9,true,39,44,83,177,174,351,17,18,35,2,3:31
448179,2016-07-09,2016,CLE,NYA,6,7,7-6,NYA,11,false,49,51,100,218,177,395,17,20,37,4,4:18
448186,2016-07-09,2016,NYN,WAS,1,6,6-1,WAS,9,false,35,40,75,148,148,296,8,14,22,1,3:13
448197,2016-07-10,2016,LAN,SDN,3,1,3-1,LAN,9,true,35,31,66,139,130,269,12,4,16,1,2:49
448196,2016-07-10,2016,COL,PHI,3,10,10-3,PHI,9,false,38,44,82,176,151,327,12,18,30,1,3:11
448201,2016-07-10,2016,NYN,WAS,2,3,3-2,WAS,9,false,35,35,70,121,146,267,9,10,19,2,2:41
448189,2016-07-10,2016,PIT,CHN,5,6,6-5,CHN,9,false,37,42,79,141,152,293,10,17,27,3,2:58
448191,2016-07-10,2016,TOR,DET,6,1,6-1,TOR,9,true,41,36,77,119,170,289,19,9,28,3,2:49
448195,2016-07-10,2016,HOU,OAK,2,1,2-1,HOU,10,false,40,35,75,132,158,290,10,6,16,0,3:05
448199,2016-07-10,2016,MIL,SLN,1,5,5-1,SLN,9,false,32,43,75,171,127,298,6,16,22,1,3:00
448192,2016-07-10,2016,BAL,ANA,4,2,4-2,BAL,9,true,39,37,76,145,157,302,17,11,28,2,3:13
448198,2016-07-10,2016,KCA,SEA,5,8,8-5,SEA,9,false,38,44,82,181,134,315,13,18,31,3,3:03
448194,2016-07-10,2016,CLE,NYA,7,11,11-7,NYA,9,false,43,47,90,182,155,337,16,17,33,5,3:35
448193,2016-07-10,2016,TEX,MIN,5,15,15-5,MIN,9,false,39,47,86,183,150,333,15,21,36,2,3:13
448187,2016-07-10,2016,SFN,ARI,4,0,4-0,SFN,9,true,37,28,65,117,155,272,14,2,16,0,2:54
448188,2016-07-10,2016,CHA,ATL,0,2,2-0,ATL,9,false,31,35,66,114,120,234,6,9,15,2,2:22
448200,2016-07-10,2016,BOS,TBA,4,0,4-0,BOS,9,true,33,32,65,121,134,255,9,7,16,1,2:31
448190,2016-07-10,2016,MIA,CIN,7,3,7-3,MIA,9,true,40,36,76,134,174,308,16,10,26,2,3:04
448202,2016-07-12,2016,AAS,NAS,4,2,4-2,AAS,9,true,35,39,74,148,131,279,11,12,23,4,3:05
448214,2016-07-15,2016,WAS,PIT,5,1,5-1,WAS,9,true,35,32,67,125,131,256,12,6,18,2,2:43
448215,2016-07-15,2016,SDN,SFN,4,1,4-1,SDN,9,true,32,31,63,124,130,254,9,6,15,0,2:39
448204,2016-07-15,2016,NYA,BOS,3,5,5-3,BOS,9,false,33,39,72,167,112,279,6,12,18,3,3:05
448213,2016-07-15,2016,PHI,NYN,3,5,5-3,NYN,9,false,35,38,73,148,124,272,7,11,18,5,3:10
448212,2016-07-15,2016,CIN,MIL,5,4,5-4,CIN,9,true,35,39,74,158,132,290,12,12,24,2,3:14
448205,2016-07-15,2016,ANA,CHA,7,0,7-0,ANA,9,true,34,33,67,120,133,253,11,7,18,3,2:39
448206,2016-07-15,2016,MIN,CLE,2,5,5-2,CLE,9,false,32,37,69,157,136,293,6,11,17,2,2:54
448208,2016-07-15,2016,SEA,HOU,3,7,7-3,HOU,9,false,37,36,73,134,162,296,11,13,24,1,2:54
448211,2016-07-15,2016,SLN,MIA,6,7,7-6,MIA,9,false,39,44,83,164,148,312,12,19,31,3,3:24
448207,2016-07-15,2016,ATL,COL,2,11,11-2,COL,9,false,37,44,81,195,138,333,13,16,29,5,3:28
448217,2016-07-15,2016,OAK,TOR,8,7,8-7,OAK,9,true,37,41,78,168,141,309,15,15,30,4,3:09
448210,2016-07-15,2016,ARI,LAN,7,13,13-7,LAN,9,false,39,51,90,189,166,355,12,24,36,3,3:51
448216,2016-07-15,2016,CHN,TEX,6,0,6-0,CHN,9,true,37,34,71,136,140,276,12,8,20,2,2:44
448209,2016-07-15,2016,DET,KCA,4,2,4-2,DET,9,true,35,35,70,135,153,288,11,8,19,2,2:57
448203,2016-07-15,2016,TBA,BAL,3,4,4-3,BAL,9,false,41,35,76,126,170,296,17,8,25,1,3:00
448220,2016-07-16,2016,ANA,CHA,1,0,1-0,ANA,9,true,27,33,60,115,91,206,4,6,10,0,2:20
448218,2016-07-16,2016,TBA,BAL,1,2,2-1,BAL,9,false,33,35,68,114,117,231,7,10,17,3,2:33
448223,2016-07-16,2016,SEA,HOU,1,0,1-0,SEA,9,true,30,32,62,124,127,251,9,5,14,2,2:46
448219,2016-07-16,2016,NYA,BOS,2,5,5-2,BOS,9,false,33,41,74,140,120,260,7,14,21,1,2:56
448228,2016-07-16,2016,PHI,NYN,4,2,4-2,PHI,9,true,37,36,73,132,143,275,13,9,22,3,3:11
448229,2016-07-16,2016,WAS,PIT,6,0,6-0,WAS,9,true,36,33,69,120,136,256,14,8,22,1,2:36 (1:11 delay)
448231,2016-07-16,2016,CHN,TEX,3,1,3-1,CHN,9,true,35,30,65,128,148,276,10,5,15,3,2:47
448225,2016-07-16,2016,ARI,LAN,2,1,2-1,ARI,12,false,43,52,95,199,176,375,15,19,34,2,4:31
448232,2016-07-16,2016,OAK,TOR,5,4,5-4,OAK,9,true,34,37,71,150,128,278,12,11,23,2,2:41
448222,2016-07-16,2016,ATL,COL,3,4,4-3,COL,9,false,37,37,74,152,152,304,11,11,22,4,3:02
448227,2016-07-16,2016,CIN,MIL,1,9,9-1,MIL,9,false,39,43,82,173,127,300,13,17,30,1,3:03
448224,2016-07-16,2016,DET,KCA,4,8,8-4,KCA,9,false,34,44,78,174,135,309,9,19,28,4,3:16
448221,2016-07-16,2016,MIN,CLE,5,4,5-4,MIN,11,false,50,45,95,168,202,370,18,13,31,4,3:50 (2:05 delay)
448226,2016-07-16,2016,SLN,MIA,5,0,5-0,SLN,9,true,36,31,67,120,150,270,12,5,17,0,2:39
448230,2016-07-16,2016,SDN,SFN,7,6,7-6,SDN,10,false,43,44,87,182,179,361,19,15,34,2,4:05
448246,2016-07-17,2016,CHN,TEX,1,4,4-1,TEX,9,false,31,35,66,127,107,234,4,8,12,0,2:17
448243,2016-07-17,2016,PHI,NYN,0,5,5-0,NYN,9,false,28,37,65,148,105,253,2,10,12,0,2:21
448242,2016-07-17,2016,CIN,MIL,1,0,1-0,CIN,9,false,30,33,63,127,128,255,6,6,12,1,2:34
448233,2016-07-17,2016,TBA,BAL,5,2,5-2,TBA,9,true,33,36,69,144,117,261,10,9,19,2,2:32
448234,2016-07-17,2016,NYA,BOS,3,1,3-1,NYA,9,true,38,32,70,129,135,264,14,6,20,3,2:57
448235,2016-07-17,2016,ANA,CHA,8,1,8-1,ANA,9,true,37,33,70,128,134,262,15,8,23,1,2:40
448237,2016-07-17,2016,ATL,COL,1,0,1-0,ATL,9,false,38,33,71,132,154,286,14,9,23,3,3:22
448236,2016-07-17,2016,MIN,CLE,1,6,6-1,CLE,9,false,35,40,75,153,123,276,8,16,24,1,2:46
448245,2016-07-17,2016,SDN,SFN,5,3,5-3,SDN,9,true,37,37,74,136,160,296,13,9,22,4,3:25
448247,2016-07-17,2016,OAK,TOR,3,5,5-3,TOR,9,false,36,41,77,157,137,294,10,15,25,3,3:12
448238,2016-07-17,2016,SEA,HOU,1,8,8-1,HOU,9,false,38,44,82,142,142,284,16,17,33,1,2:55
448240,2016-07-17,2016,ARI,LAN,6,5,6-5,ARI,9,true,35,42,77,152,133,285,13,16,29,2,3:14
448241,2016-07-17,2016,SLN,MIA,3,6,6-3,MIA,9,false,34,44,78,166,142,308,7,19,26,2,3:03
448239,2016-07-17,2016,DET,KCA,4,2,4-2,DET,9,false,35,34,69,109,125,234,12,7,19,0,2:22
448244,2016-07-17,2016,WAS,PIT,1,2,2-1,PIT,18,false,62,68,130,266,275,541,13,18,31,1,5:48
448254,2016-07-18,2016,DET,MIN,1,0,1-0,DET,9,true,28,31,59,140,119,259,6,6,12,0,2:26
448250,2016-07-18,2016,SEA,CHA,4,3,4-3,SEA,9,false,34,37,71,130,122,252,10,12,22,0,2:21
448249,2016-07-18,2016,NYA,BAL,2,1,2-1,NYA,9,true,32,36,68,147,127,274,9,11,20,2,2:57
448251,2016-07-18,2016,KCA,CLE,7,3,7-3,KCA,9,true,37,36,73,141,128,269,17,11,28,2,2:51
448255,2016-07-18,2016,CHN,NYN,5,1,5-1,CHN,9,true,35,35,70,124,150,274,12,10,22,3,2:56
448252,2016-07-18,2016,OAK,HOU,7,4,7-4,OAK,9,true,40,38,78,147,151,298,17,11,28,1,3:06
448253,2016-07-18,2016,PHI,MIA,2,3,3-2,MIA,11,false,39,41,80,142,159,301,7,10,17,1,3:05
448257,2016-07-18,2016,COL,TBA,7,4,7-4,COL,9,true,37,37,74,145,146,291,16,11,27,1,3:12 (:32 delay)
448256,2016-07-18,2016,SLN,SDN,10,2,10-2,SLN,9,true,41,35,76,129,164,293,18,8,26,1,2:55
448248,2016-07-18,2016,CIN,ATL,8,2,8-2,CIN,9,true,38,37,75,150,150,300,15,11,26,2,3:11
448258,2016-07-18,2016,ANA,TEX,9,5,9-5,ANA,9,true,37,38,75,148,134,282,14,12,26,2,3:03
448262,2016-07-19,2016,KCA,CLE,3,7,7-3,CLE,9,false,36,40,76,138,129,267,9,14,23,3,2:46
448260,2016-07-19,2016,NYA,BAL,7,1,7-1,NYA,9,true,36,32,68,122,160,282,15,6,21,2,2:51
448272,2016-07-19,2016,ANA,TEX,8,6,8-6,ANA,9,true,36,42,78,148,126,274,15,15,30,1,3:01
448273,2016-07-19,2016,ARI,TOR,1,5,5-1,TOR,9,false,34,38,72,162,122,284,9,11,20,0,2:58
448263,2016-07-19,2016,OAK,HOU,4,3,4-3,OAK,10,false,43,42,85,159,200,359,17,12,29,5,3:41
448270,2016-07-19,2016,BOS,SFN,4,0,4-0,BOS,9,true,30,32,62,145,122,267,5,8,13,3,2:42
448266,2016-07-19,2016,PIT,MIL,3,2,3-2,PIT,9,false,34,35,69,119,146,265,9,9,18,0,2:49
448271,2016-07-19,2016,COL,TBA,1,10,10-1,TBA,9,false,33,42,75,143,144,287,7,17,24,1,2:54 (2:01 delay)
448267,2016-07-19,2016,DET,MIN,2,6,6-2,MIN,9,false,36,38,74,153,125,278,8,12,20,3,2:55
448264,2016-07-19,2016,WAS,LAN,4,8,8-4,LAN,9,false,36,43,79,164,128,292,9,17,26,2,3:14
448261,2016-07-19,2016,SEA,CHA,1,6,6-1,CHA,9,false,36,38,74,160,150,310,10,15,25,3,3:00
448265,2016-07-19,2016,PHI,MIA,1,2,2-1,MIA,10,false,39,40,79,164,171,335,10,12,22,2,3:26
448259,2016-07-19,2016,CIN,ATL,4,5,5-4,ATL,11,false,46,43,89,154,180,334,17,13,30,4,3:38
448268,2016-07-19,2016,CHN,NYN,1,2,2-1,NYN,9,false,38,36,74,115,152,267,13,9,22,1,3:04
448284,2016-07-20,2016,SLN,SDN,3,2,3-2,SLN,9,true,34,36,70,133,128,261,10,9,19,2,3:03
448282,2016-07-20,2016,DET,MIN,1,4,4-1,MIN,9,false,36,35,71,142,149,291,10,7,17,2,3:05
448277,2016-07-20,2016,KCA,CLE,4,11,11-4,CLE,9,false,36,46,82,206,134,340,9,19,28,3,3:16
448280,2016-07-20,2016,PHI,MIA,4,1,4-1,PHI,9,true,36,31,67,112,129,241,12,5,17,1,2:37
448275,2016-07-20,2016,NYA,BAL,5,0,5-0,NYA,9,true,33,34,67,151,97,248,10,7,17,1,2:40
448274,2016-07-20,2016,CIN,ATL,6,3,6-3,CIN,9,true,38,35,73,126,129,255,16,9,25,0,2:33
448283,2016-07-20,2016,CHN,NYN,6,2,6-2,CHN,9,true,38,35,73,124,140,264,14,11,25,3,2:49
448288,2016-07-20,2016,ARI,TOR,4,10,10-4,TOR,9,false,36,44,80,145,118,263,11,16,27,3,2:52
448279,2016-07-20,2016,WAS,LAN,8,1,8-1,WAS,9,true,35,32,67,130,149,279,11,6,17,2,2:57
448287,2016-07-20,2016,ANA,TEX,7,4,7-4,ANA,9,true,37,41,78,158,110,268,15,14,29,1,2:52
448278,2016-07-20,2016,OAK,HOU,0,7,7-0,HOU,9,false,33,47,80,189,127,316,6,19,25,0,3:06
448285,2016-07-20,2016,BOS,SFN,11,7,11-7,BOS,9,true,43,45,88,181,158,339,19,19,38,6,3:46
448281,2016-07-20,2016,PIT,MIL,5,9,9-5,MIL,9,false,39,45,84,188,161,349,13,21,34,2,3:43
448269,2016-07-20,2016,SLN,SDN,4,2,4-2,SLN,9,true,33,32,65,117,128,245,12,6,18,0,2:32
448269,2016-07-20,2016,SLN,SDN,4,2,4-2,SLN,9,true,33,32,65,117,128,245,12,6,18,0,2:32
448286,2016-07-20,2016,COL,TBA,3,11,11-3,TBA,9,false,39,48,87,174,152,326,11,22,33,1,3:27
448276,2016-07-20,2016,SEA,CHA,6,5,6-5,SEA,11,false,43,47,90,158,154,312,15,14,29,2,3:12
448291,2016-07-21,2016,CHA,DET,1,2,2-1,DET,7,true,26,29,55,117,95,212,10,9,19,1,2:08 (2:05 delay)
448297,2016-07-21,2016,OAK,TBA,3,7,7-3,TBA,9,false,35,36,71,148,132,280,8,10,18,2,2:46
448290,2016-07-21,2016,NYA,BAL,1,4,4-1,BAL,9,false,32,38,70,147,130,277,7,10,17,1,2:52
448293,2016-07-21,2016,PHI,MIA,3,9,9-3,MIA,9,false,32,44,76,168,126,294,4,17,21,0,2:57
448295,2016-07-21,2016,BOS,MIN,13,2,13-2,BOS,9,true,41,33,74,125,155,280,19,6,25,3,2:45
448289,2016-07-21,2016,COL,ATL,7,3,7-3,COL,9,true,38,37,75,140,154,294,15,11,26,4,3:04
448292,2016-07-21,2016,WAS,LAN,3,6,6-3,LAN,9,false,42,36,78,142,190,332,15,9,24,4,3:35
448296,2016-07-21,2016,SLN,SDN,6,5,6-5,SLN,9,false,38,38,76,168,144,312,15,12,27,2,3:18
448294,2016-07-21,2016,PIT,MIL,5,3,5-3,PIT,9,true,36,33,69,136,125,261,14,5,19,1,2:47
448311,2016-07-22,2016,TOR,SEA,1,2,2-1,SEA,9,false,32,39,71,134,134,268,6,12,18,1,2:41
448304,2016-07-22,2016,HOU,ANA,2,1,2-1,HOU,9,true,33,34,67,132,125,257,10,9,19,2,3:02
448306,2016-07-22,2016,BOS,MIN,1,2,2-1,MIN,9,false,32,36,68,146,120,266,6,12,18,2,3:00
448309,2016-07-22,2016,WAS,SDN,3,5,5-3,SDN,9,false,37,37,74,143,135,278,9,11,20,2,2:58
448301,2016-07-22,2016,MIL,CHN,2,5,5-2,CHN,9,false,35,39,74,136,145,281,8,13,21,2,3:07
448299,2016-07-22,2016,CIN,ARI,6,2,6-2,CIN,9,true,40,36,76,136,179,315,20,11,31,1,3:15
448308,2016-07-22,2016,PIT,PHI,0,4,4-0,PHI,9,false,29,42,71,144,100,244,4,16,20,2,2:38
448303,2016-07-22,2016,CHA,DET,5,7,7-5,DET,9,false,39,47,86,203,152,355,12,22,34,4,3:35
448313,2016-07-22,2016,KCA,TEX,3,1,3-1,KCA,9,true,33,34,67,133,121,254,10,8,18,1,2:44
448302,2016-07-22,2016,BAL,CLE,5,1,5-1,BAL,9,true,36,36,72,153,125,278,14,10,24,3,2:52
448300,2016-07-22,2016,COL,ATL,4,3,4-3,COL,9,true,33,37,70,153,141,294,11,12,23,3,3:18
448310,2016-07-22,2016,NYA,SFN,3,2,3-2,NYA,9,true,36,39,75,153,141,294,12,12,24,1,3:17
448312,2016-07-22,2016,OAK,TBA,1,0,1-0,OAK,13,false,46,47,93,174,168,342,12,9,21,3,3:31
448305,2016-07-22,2016,SLN,LAN,4,3,4-3,SLN,16,false,59,64,123,220,224,444,15,17,32,2,5:10
448307,2016-07-22,2016,MIA,NYN,3,5,5-3,NYN,9,false,35,41,76,157,142,299,9,15,24,2,3:07
448327,2016-07-23,2016,OAK,TBA,4,3,4-3,OAK,9,false,35,35,70,102,130,232,10,10,20,0,2:22
448316,2016-07-23,2016,MIL,CHN,6,1,6-1,MIL,9,true,34,34,68,135,151,286,12,8,20,3,2:56
448315,2016-07-23,2016,COL,ATL,8,4,8-4,COL,9,true,37,38,75,139,138,277,13,12,25,3,3:02 (:47 delay)
448318,2016-07-23,2016,CHA,DET,4,3,4-3,CHA,9,false,37,38,75,147,148,295,11,12,23,2,3:15 (2:10 delay)
448318,2016-07-23,2016,CHA,DET,4,3,4-3,CHA,9,false,37,38,75,147,148,295,11,12,23,2,3:15 (2:10 delay)
448320,2016-07-23,2016,SLN,LAN,2,7,7-2,LAN,9,false,32,39,71,141,127,268,6,14,20,1,2:56
448317,2016-07-23,2016,BAL,CLE,5,2,5-2,BAL,9,true,33,34,67,152,129,281,10,10,20,2,2:52 (:14 delay)
448324,2016-07-23,2016,WAS,SDN,3,2,3-2,WAS,9,false,36,34,70,133,137,270,12,8,20,0,3:01
448321,2016-07-23,2016,BOS,MIN,9,11,11-9,MIN,9,false,48,48,96,193,196,389,23,23,46,7,4:11
448323,2016-07-23,2016,PIT,PHI,7,4,7-4,PIT,9,true,35,45,80,177,128,305,11,17,28,3,3:35
448322,2016-07-23,2016,MIA,NYN,7,2,7-2,MIA,9,true,42,40,82,145,164,309,19,13,32,2,3:09
448328,2016-07-23,2016,KCA,TEX,4,7,7-4,TEX,9,false,41,40,81,153,166,319,14,14,28,2,3:14
448326,2016-07-23,2016,TOR,SEA,5,14,14-5,SEA,9,false,38,47,85,185,137,322,11,24,35,2,3:18
448325,2016-07-23,2016,NYA,SFN,1,2,2-1,SFN,12,false,48,46,94,176,215,391,14,12,26,4,4:25
448314,2016-07-23,2016,CIN,ARI,6,1,6-1,CIN,9,true,35,34,69,144,150,294,11,7,18,1,3:00
448319,2016-07-23,2016,HOU,ANA,7,2,7-2,HOU,9,true,38,34,72,144,150,294,16,8,24,0,2:53
448332,2016-07-24,2016,BAL,CLE,5,3,5-3,BAL,9,false,36,36,72,135,135,270,10,10,20,0,2:46
448340,2016-07-24,2016,NYA,SFN,5,2,5-2,NYA,9,true,31,39,70,164,115,279,9,13,22,3,3:06
448337,2016-07-24,2016,MIA,NYN,0,3,3-0,NYN,9,false,35,37,72,146,131,277,8,9,17,2,2:50
448339,2016-07-24,2016,WAS,SDN,6,10,10-6,SDN,9,false,37,44,81,176,143,319,12,18,30,3,3:32
448329,2016-07-24,2016,CIN,ARI,8,9,9-8,ARI,9,false,44,42,86,152,165,317,18,16,34,1,3:32
448335,2016-07-24,2016,SLN,LAN,6,9,9-6,LAN,9,false,37,46,83,199,177,376,10,21,31,3,3:49
448341,2016-07-24,2016,TOR,SEA,2,0,2-0,TOR,9,true,29,32,61,148,114,262,6,7,13,0,2:21
448331,2016-07-24,2016,MIL,CHN,5,6,6-5,CHN,9,false,44,39,83,159,194,353,17,18,35,4,4:08
448342,2016-07-24,2016,OAK,TBA,3,2,3-2,OAK,9,true,36,32,68,112,114,226,12,6,18,2,2:21
448343,2016-07-24,2016,KCA,TEX,1,2,2-1,TEX,9,false,35,38,73,140,145,285,9,14,23,0,3:03
448338,2016-07-24,2016,PIT,PHI,5,4,5-4,PIT,9,true,34,37,71,141,140,281,13,11,24,1,3:08 (1:32 delay)
448330,2016-07-24,2016,COL,ATL,7,2,7-2,COL,9,true,39,39,78,157,148,305,16,14,30,1,2:56
448333,2016-07-24,2016,CHA,DET,5,4,5-4,CHA,9,false,39,37,76,167,138,305,15,10,25,2,3:00
448336,2016-07-24,2016,BOS,MIN,8,7,8-7,BOS,9,true,35,39,74,149,146,295,11,11,22,3,3:15
448334,2016-07-24,2016,HOU,ANA,13,3,13-3,HOU,9,true,42,37,79,122,160,282,19,11,30,1,3:00
448353,2016-07-25,2016,TOR,SDN,4,2,4-2,TOR,9,true,35,34,69,132,126,258,13,8,21,1,2:41
448347,2016-07-25,2016,BAL,COL,3,2,3-2,BAL,10,false,39,36,75,152,145,297,10,9,19,3,3:14
448352,2016-07-25,2016,MIA,PHI,0,4,4-0,PHI,9,false,30,42,72,186,106,292,3,16,19,1,3:03
448348,2016-07-25,2016,BOS,DET,2,4,4-2,DET,9,false,40,36,76,140,175,315,13,10,23,1,3:27
448350,2016-07-25,2016,HOU,NYA,1,2,2-1,NYA,9,false,35,33,68,117,136,253,8,7,15,1,2:41
448351,2016-07-25,2016,TEX,OAK,7,6,7-6,TEX,9,false,40,39,79,123,149,272,14,14,28,1,2:58
448345,2016-07-25,2016,CHA,CHN,5,4,5-4,CHA,9,false,36,42,78,162,146,308,11,16,27,4,3:23
448349,2016-07-25,2016,KCA,ANA,2,6,6-2,ANA,9,false,35,41,76,162,144,306,9,15,24,2,3:05
448344,2016-07-25,2016,MIL,ARI,7,2,7-2,MIL,9,true,38,39,77,155,152,307,16,12,28,1,3:09
448346,2016-07-25,2016,SFN,CIN,5,7,7-5,CIN,9,false,36,39,75,147,149,296,10,12,22,3,3:05
448367,2016-07-26,2016,NYN,SLN,2,3,3-2,SLN,9,false,40,36,76,159,164,323,13,11,24,1,3:18
448354,2016-07-26,2016,NYN,SLN,3,1,3-1,NYN,9,true,34,30,64,117,130,247,10,4,14,0,2:33
448356,2016-07-26,2016,MIN,ATL,0,2,2-0,ATL,9,false,34,33,67,97,142,239,8,7,15,1,2:23
448359,2016-07-26,2016,BAL,COL,3,6,6-3,COL,9,false,35,35,70,129,143,272,9,9,18,1,2:44
448364,2016-07-26,2016,MIA,PHI,5,0,5-0,MIA,9,true,37,31,68,123,132,255,14,5,19,1,2:41
448354,2016-07-26,2016,NYN,SLN,3,1,3-1,NYN,9,true,34,30,64,117,130,247,10,4,14,0,2:33
448368,2016-07-26,2016,LAN,TBA,3,2,3-2,LAN,9,true,31,38,69,161,97,258,5,13,18,3,2:55
448357,2016-07-26,2016,CHA,CHN,3,0,3-0,CHA,9,true,34,35,69,136,150,286,11,8,19,2,2:55
448365,2016-07-26,2016,TOR,SDN,7,6,7-6,TOR,12,false,47,49,96,168,219,387,16,13,29,3,3:58
448363,2016-07-26,2016,TEX,OAK,3,6,6-3,OAK,9,false,35,38,73,147,148,295,9,13,22,3,3:01 (1:02 delay)
448369,2016-07-26,2016,CLE,WAS,7,6,7-6,CLE,9,false,39,39,78,168,144,312,16,13,29,5,3:17
448362,2016-07-26,2016,HOU,NYA,3,6,6-3,NYA,9,false,38,43,81,148,155,303,11,18,29,3,3:03
448355,2016-07-26,2016,MIL,ARI,9,4,9-4,MIL,9,true,38,40,78,146,156,302,18,12,30,4,3:35
448361,2016-07-26,2016,KCA,ANA,0,13,13-0,ANA,9,false,30,54,84,190,115,305,4,27,31,3,3:04
448360,2016-07-26,2016,BOS,DET,8,9,9-8,DET,9,false,40,45,85,152,165,317,14,20,34,3,3:33
448366,2016-07-26,2016,PIT,SEA,4,7,7-4,SEA,9,false,40,41,81,146,157,303,16,15,31,2,3:08
448358,2016-07-26,2016,SFN,CIN,9,7,9-7,SFN,9,true,43,40,83,158,167,325,21,13,34,2,3:20
448377,2016-07-27,2016,HOU,NYA,4,1,4-1,HOU,9,true,33,34,67,128,129,257,11,7,18,0,2:38
448372,2016-07-27,2016,CHN,CHA,8,1,8-1,CHN,9,true,37,33,70,125,152,277,13,7,20,3,2:51
448376,2016-07-27,2016,KCA,ANA,7,5,7-5,KCA,9,true,36,43,79,157,99,256,12,17,29,2,3:15
448375,2016-07-27,2016,BOS,DET,3,4,4-3,DET,9,false,32,41,73,151,123,274,7,16,23,2,2:55
448370,2016-07-27,2016,MIL,ARI,1,8,8-1,ARI,9,false,33,42,75,154,127,281,8,13,21,1,2:56
448379,2016-07-27,2016,MIA,PHI,11,1,11-1,MIA,9,true,44,38,82,132,161,293,23,13,36,3,2:57
448373,2016-07-27,2016,SFN,CIN,1,2,2-1,CIN,9,false,32,33,65,118,108,226,5,6,11,2,2:23
448374,2016-07-27,2016,BAL,COL,1,3,3-1,COL,9,false,34,35,69,148,115,263,9,8,17,2,2:48
448378,2016-07-27,2016,TEX,OAK,4,6,6-4,OAK,9,false,38,36,74,147,126,273,13,9,22,2,2:44
448381,2016-07-27,2016,PIT,SEA,10,1,10-1,PIT,9,true,41,31,72,93,171,264,18,4,22,1,2:41
448384,2016-07-27,2016,CLE,WAS,1,4,4-1,WAS,9,false,36,36,72,149,139,288,9,10,19,4,3:11
448380,2016-07-27,2016,TOR,SDN,4,8,8-4,SDN,9,false,35,39,74,168,132,300,9,14,23,2,2:42
448382,2016-07-27,2016,NYN,SLN,4,5,5-4,SLN,9,false,38,38,76,130,146,276,13,13,26,1,3:07
448383,2016-07-27,2016,LAN,TBA,1,3,3-1,TBA,9,false,35,37,72,170,136,306,9,12,21,2,3:07
448371,2016-07-27,2016,MIN,ATL,7,9,9-7,ATL,9,false,42,44,86,181,158,339,14,20,34,5,3:19
447341,2016-07-28,2016,MIN,BAL,6,2,6-2,MIN,9,true,39,36,75,150,172,322,18,12,30,1,3:00
448389,2016-07-28,2016,TEX,KCA,3,2,3-2,TEX,9,true,28,34,62,138,113,251,5,8,13,0,2:26 (:35 delay)
448391,2016-07-28,2016,MIA,SLN,4,5,5-4,SLN,9,false,33,40,73,151,112,263,8,13,21,0,2:28
448387,2016-07-28,2016,CHN,CHA,3,1,3-1,CHN,9,true,35,33,68,136,147,283,13,7,20,3,2:51
448388,2016-07-28,2016,NYN,COL,1,2,2-1,COL,9,false,37,39,76,149,129,278,12,12,24,3,3:13
448385,2016-07-28,2016,MIL,ARI,6,4,6-4,MIL,9,true,35,37,72,136,148,284,12,10,22,2,2:50
447341,2016-07-28,2016,MIN,BAL,6,2,6-2,MIN,9,true,39,36,75,150,172,322,18,12,30,1,3:00
448390,2016-07-28,2016,ATL,PHI,5,7,7-5,PHI,9,false,46,40,86,148,171,319,21,13,34,2,3:25
448392,2016-07-28,2016,SFN,WAS,2,4,4-2,WAS,9,false,38,44,82,178,169,347,11,20,31,2,3:28
448386,2016-07-28,2016,ANA,BOS,2,1,2-1,ANA,9,false,34,33,67,151,122,273,11,11,22,1,3:05
448404,2016-07-29,2016,MIL,PIT,3,1,3-1,MIL,9,true,35,32,67,106,136,242,12,5,17,1,2:45
448395,2016-07-29,2016,ANA,BOS,2,6,6-2,BOS,9,false,31,39,70,152,107,259,5,14,19,1,2:30
448403,2016-07-29,2016,ATL,PHI,2,1,2-1,ATL,9,true,33,38,71,132,117,249,11,12,23,0,2:43
448394,2016-07-29,2016,TOR,BAL,6,5,6-5,TOR,9,true,35,37,72,139,145,284,11,10,21,0,2:45
448402,2016-07-29,2016,CLE,OAK,5,3,5-3,CLE,9,true,36,39,75,161,132,293,12,10,22,3,2:59
448400,2016-07-29,2016,TEX,KCA,8,3,8-3,TEX,9,true,37,35,72,151,131,282,15,10,25,3,2:50
448401,2016-07-29,2016,TBA,NYA,5,1,5-1,TBA,9,true,38,38,76,148,143,291,14,11,25,4,2:58
448398,2016-07-29,2016,NYN,COL,1,6,6-1,COL,9,false,35,41,76,158,138,296,10,16,26,1,3:07
448407,2016-07-29,2016,SFN,WAS,1,4,4-1,WAS,9,false,36,37,73,136,155,291,12,11,23,4,3:15
448393,2016-07-29,2016,LAN,ARI,9,7,9-7,LAN,9,true,39,37,76,152,139,291,16,11,27,7,3:24
448399,2016-07-29,2016,DET,HOU,14,6,14-6,DET,9,true,41,38,79,166,150,316,17,10,27,3,3:05
448405,2016-07-29,2016,CHN,SEA,12,1,12-1,CHN,9,true,43,39,82,146,167,313,20,12,32,1,3:08 (1:14 delay)
448406,2016-07-29,2016,MIA,SLN,6,11,11-6,SLN,9,false,35,47,82,179,147,326,9,23,32,2,3:03
448396,2016-07-29,2016,MIN,CHA,2,1,2-1,MIN,12,false,47,41,88,154,188,342,15,8,23,2,3:42
448397,2016-07-29,2016,SDN,CIN,0,6,6-0,CIN,9,false,33,44,77,160,141,301,10,18,28,0,2:57
448417,2016-07-30,2016,CLE,OAK,6,3,6-3,CLE,9,true,37,36,73,132,122,254,14,10,24,1,2:39 (:27 delay)
448420,2016-07-30,2016,CHN,SEA,1,4,4-1,SEA,9,false,32,37,69,136,130,266,5,10,15,2,2:37
448408,2016-07-30,2016,LAN,ARI,2,4,4-2,ARI,9,false,36,37,73,139,166,305,11,11,22,4,3:24
448421,2016-07-30,2016,MIA,SLN,11,0,11-0,MIA,9,true,41,36,77,156,153,309,17,9,26,2,3:02
448409,2016-07-30,2016,TOR,BAL,9,1,9-1,TOR,9,true,40,34,74,137,176,313,18,8,26,3,2:52
448411,2016-07-30,2016,MIN,CHA,5,6,6-5,CHA,10,false,43,45,88,147,166,313,14,15,29,2,3:23
448418,2016-07-30,2016,ATL,PHI,5,9,9-5,PHI,9,false,41,47,88,183,151,334,15,20,35,3,3:40
448415,2016-07-30,2016,TEX,KCA,2,1,2-1,TEX,9,false,33,32,65,133,132,265,9,8,17,0,2:41
448414,2016-07-30,2016,DET,HOU,3,2,3-2,DET,9,false,36,33,69,116,144,260,10,6,16,1,2:49
448412,2016-07-30,2016,SDN,CIN,2,1,2-1,SDN,10,false,35,34,69,127,138,265,8,6,14,0,2:44
448413,2016-07-30,2016,NYN,COL,2,7,7-2,COL,9,false,33,39,72,156,128,284,8,13,21,0,3:09 (:38 delay)
448419,2016-07-30,2016,MIL,PIT,5,3,5-3,MIL,9,true,36,36,72,162,149,311,13,11,24,3,3:19
448422,2016-07-30,2016,SFN,WAS,5,3,5-3,SFN,9,true,40,36,76,151,159,310,17,10,27,4,3:29
448416,2016-07-30,2016,TBA,NYA,6,3,6-3,TBA,9,true,32,33,65,143,139,282,9,7,16,1,2:47
448410,2016-07-30,2016,ANA,BOS,5,2,5-2,ANA,9,true,34,40,74,189,112,301,12,13,25,3,3:06
448426,2016-07-31,2016,MIN,CHA,6,4,6-4,MIN,9,true,34,40,74,148,128,276,12,12,24,2,2:39
448428,2016-07-31,2016,NYN,COL,6,4,6-4,NYN,9,true,35,38,73,167,140,307,11,15,26,0,3:06 (:38 delay)
448437,2016-07-31,2016,SFN,WAS,3,1,3-1,SFN,9,true,38,36,74,169,126,295,14,9,23,1,3:12
448430,2016-07-31,2016,TEX,KCA,5,3,5-3,TEX,9,true,32,33,65,118,121,239,12,7,19,3,2:22
448431,2016-07-31,2016,TBA,NYA,5,3,5-3,TBA,9,true,35,37,72,160,127,287,12,13,25,1,3:01
448433,2016-07-31,2016,ATL,PHI,2,1,2-1,ATL,9,true,32,33,65,131,114,245,10,9,19,2,2:43 (:24 delay)
448424,2016-07-31,2016,TOR,BAL,2,6,6-2,BAL,12,false,46,48,94,175,198,373,13,13,26,2,3:47
448436,2016-07-31,2016,MIA,SLN,5,4,5-4,MIA,9,false,36,36,72,131,133,264,14,9,23,0,2:42
448434,2016-07-31,2016,MIL,PIT,4,2,4-2,MIL,9,true,36,33,69,135,160,295,14,7,21,0,3:04
448429,2016-07-31,2016,DET,HOU,11,0,11-0,DET,9,true,38,38,76,152,140,292,15,12,27,0,2:59
448425,2016-07-31,2016,ANA,BOS,3,5,5-3,BOS,9,false,38,40,78,180,141,321,14,12,26,3,3:32
448427,2016-07-31,2016,SDN,CIN,2,3,3-2,CIN,9,false,36,38,74,142,155,297,10,11,21,3,3:09
448423,2016-07-31,2016,LAN,ARI,14,3,14-3,LAN,9,true,46,33,79,135,187,322,21,7,28,4,3:43
448435,2016-07-31,2016,CHN,SEA,7,6,7-6,CHN,12,false,53,51,104,196,223,419,17,16,33,3,4:18
448432,2016-07-31,2016,CLE,OAK,8,0,8-0,CLE,9,true,38,35,73,133,131,264,15,9,24,2,2:43 (:36 delay)
448443,2016-08-01,2016,NYN,NYA,5,6,6-5,NYA,10,false,46,43,89,173,178,351,18,14,32,3,3:47
448439,2016-08-01,2016,TBA,KCA,0,3,3-0,KCA,9,false,29,36,65,138,121,259,2,10,12,1,2:37
448440,2016-08-01,2016,CHN,MIA,5,0,5-0,CHN,9,true,41,33,74,123,163,286,19,11,30,0,2:47
448438,2016-08-01,2016,SEA,BOS,1,2,2-1,BOS,9,false,36,31,67,117,152,269,10,5,15,2,2:42
448441,2016-08-01,2016,SDN,MIL,7,3,7-3,SDN,9,true,41,39,80,179,165,344,19,14,33,2,3:46
448442,2016-08-01,2016,CLE,MIN,5,12,12-5,MIN,9,false,36,49,85,179,149,328,9,23,32,3,3:12
448445,2016-08-01,2016,ARI,WAS,1,14,14-1,WAS,9,false,34,51,85,194,135,329,7,24,31,2,3:23
448444,2016-08-01,2016,HOU,TOR,2,1,2-1,HOU,14,false,49,51,100,238,193,431,11,9,20,2,4:05
448458,2016-08-02,2016,BAL,TEX,5,1,5-1,BAL,9,true,32,32,64,134,124,258,11,6,17,2,2:43
448454,2016-08-02,2016,ANA,OAK,5,4,5-4,ANA,9,true,35,38,73,139,123,262,11,13,24,1,2:45
448451,2016-08-02,2016,SDN,MIL,2,3,3-2,MIL,9,false,34,39,73,139,124,263,8,17,25,2,3:00
448453,2016-08-02,2016,NYN,NYA,7,1,7-1,NYN,9,true,35,35,70,133,123,256,10,9,19,1,2:39
448459,2016-08-02,2016,HOU,TOR,1,2,2-1,TOR,9,false,34,35,69,134,139,273,7,10,17,1,2:40
448450,2016-08-02,2016,CHN,MIA,3,2,3-2,CHN,9,true,35,37,72,141,134,275,13,11,24,2,2:48
448446,2016-08-02,2016,SEA,BOS,5,4,5-4,SEA,9,true,32,36,68,136,114,250,8,9,17,2,2:30
448447,2016-08-02,2016,DET,CHA,11,5,11-5,DET,9,true,44,39,83,128,167,295,21,15,36,0,3:07
448455,2016-08-02,2016,ATL,PIT,3,5,5-3,PIT,9,false,40,35,75,158,169,327,13,9,22,3,3:20
448457,2016-08-02,2016,CIN,SLN,7,5,7-5,CIN,9,false,42,40,82,130,185,315,18,14,32,3,3:22
448456,2016-08-02,2016,PHI,SFN,13,8,13-8,PHI,9,true,42,43,85,163,155,318,18,15,33,2,3:16
448452,2016-08-02,2016,CLE,MIN,6,10,10-6,MIN,9,false,42,43,85,182,151,333,16,19,35,5,3:33
448460,2016-08-02,2016,ARI,WAS,4,10,10-4,WAS,9,false,41,45,86,162,144,306,14,18,32,1,3:18
448449,2016-08-02,2016,COL,LAN,7,3,7-3,COL,9,true,41,35,76,163,173,336,21,9,30,3,3:28 (:38 delay)
448448,2016-08-02,2016,TBA,KCA,2,3,3-2,KCA,9,false,40,35,75,130,169,299,14,9,23,2,3:04
448461,2016-08-03,2016,SEA,BOS,3,1,3-1,SEA,9,true,29,35,64,120,112,232,6,8,14,1,2:16
448473,2016-08-03,2016,BAL,TEX,3,2,3-2,BAL,9,true,31,33,64,135,109,244,8,9,17,0,2:26
448474,2016-08-03,2016,HOU,TOR,1,3,3-1,TOR,9,false,34,37,71,150,114,264,5,9,14,0,2:31
448462,2016-08-03,2016,DET,CHA,2,1,2-1,DET,9,true,30,35,65,133,108,241,7,10,17,1,2:35
448464,2016-08-03,2016,COL,LAN,12,2,12-2,COL,9,true,43,33,76,109,135,244,20,9,29,1,2:31
448472,2016-08-03,2016,CIN,SLN,4,5,5-4,SLN,9,false,37,38,75,145,150,295,12,13,25,0,2:59
448475,2016-08-03,2016,ARI,WAS,3,8,8-3,WAS,9,false,33,46,79,163,119,282,6,21,27,2,2:59
448465,2016-08-03,2016,CHN,MIA,5,4,5-4,CHN,9,false,40,39,79,148,178,326,15,13,28,1,3:19
448469,2016-08-03,2016,ANA,OAK,8,6,8-6,ANA,9,false,40,42,82,169,133,302,16,19,35,4,3:15
448467,2016-08-03,2016,CLE,MIN,5,13,13-5,MIN,9,false,34,47,81,188,134,322,10,22,32,3,3:23
448466,2016-08-03,2016,SDN,MIL,12,3,12-3,SDN,9,true,44,36,80,126,169,295,20,9,29,0,3:02
448463,2016-08-03,2016,TBA,KCA,12,0,12-0,TBA,9,true,47,32,79,154,175,329,22,5,27,1,2:59
448470,2016-08-03,2016,ATL,PIT,8,4,8-4,ATL,9,true,40,37,77,153,161,314,18,10,28,1,3:25
448468,2016-08-03,2016,NYA,NYN,9,5,9-5,NYA,9,true,38,40,78,162,143,305,14,15,29,3,3:02
448471,2016-08-03,2016,PHI,SFN,5,4,5-4,PHI,12,false,48,47,95,172,171,343,15,12,27,4,4:03
448481,2016-08-04,2016,NYA,NYN,1,4,4-1,NYN,9,false,35,36,71,130,123,253,9,8,17,1,2:46
448486,2016-08-04,2016,BAL,TEX,3,5,5-3,TEX,9,false,34,38,72,148,112,260,10,11,21,1,2:26
448477,2016-08-04,2016,DET,CHA,3,6,6-3,CHA,9,false,35,41,76,152,106,258,10,15,25,2,2:50
448485,2016-08-04,2016,CIN,SLN,7,0,7-0,CIN,9,true,35,32,67,122,126,248,13,5,18,2,2:33
448487,2016-08-04,2016,HOU,TOR,1,4,4-1,TOR,9,false,32,34,66,140,133,273,7,8,15,0,2:41
448479,2016-08-04,2016,COL,LAN,2,4,4-2,LAN,9,false,34,40,74,151,153,304,7,15,22,1,3:08
448483,2016-08-04,2016,ATL,PIT,5,2,5-2,ATL,9,true,34,35,69,148,134,282,10,10,20,2,2:55 (1:16 delay)
448478,2016-08-04,2016,TBA,KCA,3,2,3-2,TBA,9,true,34,38,72,130,145,275,10,12,22,1,2:42
448480,2016-08-04,2016,CLE,MIN,9,2,9-2,CLE,9,true,40,36,76,153,180,333,15,12,27,3,3:16
448484,2016-08-04,2016,PHI,SFN,2,3,3-2,SFN,10,false,40,40,80,161,163,324,11,11,22,1,3:30
448476,2016-08-04,2016,SEA,BOS,2,3,3-2,BOS,11,false,46,46,92,177,189,366,16,17,33,2,3:47
448482,2016-08-04,2016,ANA,OAK,6,8,8-6,OAK,10,false,45,43,88,167,191,358,18,13,31,3,3:54
448500,2016-08-05,2016,WAS,SFN,5,1,5-1,WAS,9,true,31,31,62,130,116,246,8,5,13,0,2:26
448488,2016-08-05,2016,SLN,ATL,1,0,1-0,SLN,9,true,32,30,62,107,115,222,9,4,13,1,2:28
448501,2016-08-05,2016,HOU,TEX,5,0,5-0,HOU,9,true,35,32,67,111,99,210,12,5,17,0,2:14
448499,2016-08-05,2016,SDN,PHI,4,5,5-4,PHI,9,false,36,35,71,122,143,265,12,7,19,1,2:55
448498,2016-08-05,2016,DET,NYN,4,3,4-3,DET,9,true,33,33,66,140,131,271,10,6,16,0,2:55
448497,2016-08-05,2016,TBA,MIN,2,6,6-2,MIN,9,false,35,41,76,157,140,297,8,13,21,3,2:57
448492,2016-08-05,2016,PIT,CIN,3,2,3-2,PIT,9,false,33,37,70,154,141,295,11,10,21,0,3:04
448494,2016-08-05,2016,SEA,ANA,6,4,6-4,SEA,9,true,41,32,73,113,152,265,18,6,24,2,2:52
448491,2016-08-05,2016,OAK,CHN,2,7,7-2,CHN,9,false,33,39,72,176,139,315,7,13,20,0,2:56
448490,2016-08-05,2016,LAN,BOS,0,9,9-0,BOS,9,false,31,41,72,152,119,271,4,16,20,2,2:49
448489,2016-08-05,2016,CHA,BAL,5,7,7-5,BAL,9,false,41,42,83,153,160,313,14,16,30,2,3:19
448502,2016-08-05,2016,KCA,TOR,3,4,4-3,TOR,9,false,37,41,78,148,132,280,10,15,25,0,2:40
448495,2016-08-05,2016,COL,MIA,3,5,5-3,MIA,9,false,41,40,81,162,163,325,17,14,31,4,3:24
448496,2016-08-05,2016,ARI,MIL,3,2,3-2,ARI,11,false,43,44,87,169,180,349,12,15,27,2,3:54
448493,2016-08-05,2016,NYA,CLE,13,7,13-7,NYA,9,true,47,41,88,168,178,346,26,16,42,5,3:39
448517,2016-08-06,2016,KCA,TOR,4,2,4-2,KCA,9,true,36,35,71,134,122,256,12,7,19,1,2:36
448507,2016-08-06,2016,PIT,CIN,5,3,5-3,PIT,9,true,35,32,67,110,142,252,13,8,21,1,2:38
448506,2016-08-06,2016,OAK,CHN,0,4,4-0,CHN,9,false,32,40,72,167,120,287,6,12,18,0,2:56
448504,2016-08-06,2016,CHA,BAL,4,2,4-2,CHA,9,true,33,37,70,148,144,292,13,9,22,2,2:56
448516,2016-08-06,2016,HOU,TEX,2,3,3-2,TEX,9,false,39,40,79,147,157,304,14,16,30,2,3:07
448509,2016-08-06,2016,SEA,ANA,8,6,8-6,SEA,9,true,40,37,77,135,148,283,16,13,29,3,3:01
448505,2016-08-06,2016,LAN,BOS,3,0,3-0,LAN,9,true,35,34,69,135,147,282,12,7,19,2,2:54
448514,2016-08-06,2016,SDN,PHI,9,7,9-7,SDN,9,true,41,40,81,166,143,309,19,11,30,3,3:17
448508,2016-08-06,2016,NYA,CLE,2,5,5-2,CLE,9,false,31,41,72,170,117,287,7,17,24,4,2:59
448513,2016-08-06,2016,DET,NYN,6,5,6-5,DET,9,true,37,42,79,163,161,324,15,17,32,1,3:19
448512,2016-08-06,2016,TBA,MIN,7,3,7-3,TBA,9,true,38,37,75,160,163,323,13,11,24,4,3:09
448515,2016-08-06,2016,WAS,SFN,1,7,7-1,SFN,9,false,38,43,81,164,151,315,13,19,32,5,3:29
448503,2016-08-06,2016,SLN,ATL,5,13,13-5,ATL,9,false,40,46,86,164,162,326,14,19,33,3,3:21
448510,2016-08-06,2016,COL,MIA,12,6,12-6,COL,9,true,44,43,87,171,169,340,21,16,37,3,3:25
448511,2016-08-06,2016,ARI,MIL,6,15,15-6,MIL,9,false,41,56,97,196,142,338,12,31,43,3,4:00
448524,2016-08-07,2016,SEA,ANA,3,1,3-1,SEA,9,true,33,35,68,125,110,235,10,7,17,1,2:31
448530,2016-08-07,2016,WAS,SFN,1,0,1-0,WAS,9,true,29,36,65,132,113,245,5,9,14,0,2:43
448523,2016-08-07,2016,NYA,CLE,3,2,3-2,NYA,9,true,31,38,69,160,108,268,8,11,19,2,2:55
448528,2016-08-07,2016,DET,NYN,1,3,3-1,NYN,9,false,38,33,71,115,147,262,15,6,21,3,2:50
448521,2016-08-07,2016,OAK,CHN,1,3,3-1,CHN,9,false,31,38,69,178,119,297,4,15,19,4,2:53
448532,2016-08-07,2016,KCA,TOR,7,1,7-1,KCA,9,true,36,36,72,130,145,275,13,10,23,2,2:39
448525,2016-08-07,2016,COL,MIA,7,10,10-7,MIA,9,false,38,46,84,177,133,310,13,21,34,2,3:29
448529,2016-08-07,2016,SDN,PHI,5,6,6-5,PHI,9,false,33,42,75,160,139,299,7,16,23,1,3:13
448519,2016-08-07,2016,CHA,BAL,2,10,10-2,BAL,9,false,32,48,80,192,118,310,5,23,28,2,2:53
448522,2016-08-07,2016,PIT,CIN,3,7,7-3,CIN,9,false,36,37,73,156,152,308,11,12,23,2,3:17
448520,2016-08-07,2016,LAN,BOS,8,5,8-5,LAN,9,true,39,38,77,147,155,302,16,13,29,4,3:23
448526,2016-08-07,2016,ARI,MIL,9,3,9-3,ARI,9,true,41,37,78,184,143,327,17,12,29,2,3:31
448527,2016-08-07,2016,TBA,MIN,3,6,6-3,MIN,9,false,37,43,80,161,162,323,12,15,27,2,3:29
448518,2016-08-07,2016,SLN,ATL,3,6,6-3,ATL,9,false,39,39,78,154,161,315,13,14,27,1,2:57
448531,2016-08-07,2016,HOU,TEX,3,5,5-3,TEX,11,false,46,51,97,184,160,344,13,18,31,3,3:57
448534,2016-08-08,2016,OAK,BAL,3,2,3-2,OAK,9,true,34,34,68,132,135,267,10,7,17,0,2:29
448537,2016-08-08,2016,MIN,HOU,3,1,3-1,MIN,9,true,34,32,66,130,116,246,12,6,18,0,2:18
448536,2016-08-08,2016,SEA,DET,3,0,3-0,SEA,9,true,30,32,62,123,122,245,8,6,14,1,2:30
448540,2016-08-08,2016,COL,TEX,3,4,4-3,TEX,9,false,35,36,71,136,148,284,10,12,22,1,3:04
448538,2016-08-08,2016,LAN,PHI,9,4,9-4,LAN,9,true,36,38,74,152,127,279,13,10,23,0,2:50
448535,2016-08-08,2016,SLN,CIN,5,4,5-4,SLN,9,false,41,39,80,141,171,312,16,13,29,2,3:10
448539,2016-08-08,2016,TOR,TBA,7,5,7-5,TOR,9,true,43,39,82,147,170,317,19,14,33,3,3:13
448533,2016-08-08,2016,MIL,ATL,3,4,4-3,ATL,12,false,45,45,90,162,175,337,11,13,24,1,3:31
448553,2016-08-08,2016,MIA,SFN,7,8,8-7,SFN,14,false,55,68,123,283,197,480,16,32,48,5,5:34
448549,2016-08-09,2016,CHN,ANA,5,1,5-1,CHN,9,true,33,30,63,114,124,238,10,4,14,0,2:22
448543,2016-08-09,2016,OAK,BAL,2,1,2-1,OAK,9,true,34,31,65,128,133,261,11,5,16,2,2:25
448546,2016-08-09,2016,WAS,CLE,1,3,3-1,CLE,9,false,37,33,70,142,143,285,9,6,15,3,2:55
448541,2016-08-09,2016,NYN,ARI,3,5,5-3,ARI,9,false,34,38,72,184,132,316,8,11,19,2,3:04
448569,2016-08-09,2016,MIA,SFN,2,0,2-0,MIA,9,true,33,34,67,140,147,287,10,7,17,1,2:58
448548,2016-08-09,2016,MIN,HOU,5,7,7-5,HOU,9,false,39,38,77,135,168,303,13,14,27,2,3:04
448554,2016-08-09,2016,TOR,TBA,2,9,9-2,TBA,9,false,35,48,83,183,110,293,9,22,31,0,2:56
448552,2016-08-09,2016,PIT,SDN,6,4,6-4,PIT,9,true,41,36,77,138,170,308,19,13,32,0,3:14 (:36 delay)
448555,2016-08-09,2016,COL,TEX,5,7,7-5,TEX,9,false,41,39,80,159,175,334,15,12,27,3,3:14
448545,2016-08-09,2016,SLN,CIN,4,7,7-4,CIN,9,false,38,42,80,148,138,286,16,17,33,1,2:57
448551,2016-08-09,2016,LAN,PHI,9,3,9-3,LAN,9,true,39,37,76,163,152,315,16,11,27,3,3:17
448542,2016-08-09,2016,MIL,ATL,1,2,2-1,ATL,9,false,32,33,65,137,117,254,8,10,18,3,2:53
448550,2016-08-09,2016,BOS,NYA,5,3,5-3,BOS,9,true,32,39,71,152,150,302,10,12,22,4,3:13
448544,2016-08-09,2016,KCA,CHA,5,7,7-5,CHA,10,false,40,44,84,154,153,307,11,15,26,1,3:05
448547,2016-08-09,2016,SEA,DET,6,5,6-5,SEA,15,false,61,62,123,213,267,480,20,20,40,1,4:51
448560,2016-08-10,2016,SLN,CIN,3,2,3-2,SLN,9,true,35,33,68,90,153,243,12,7,19,2,2:42
448570,2016-08-10,2016,TOR,TBA,7,0,7-0,TOR,9,true,40,33,73,140,173,313,15,7,22,2,3:01
448557,2016-08-10,2016,MIL,ATL,4,3,4-3,MIL,9,true,35,36,71,140,121,261,13,11,24,2,2:50
448567,2016-08-10,2016,LAN,PHI,2,6,6-2,PHI,9,false,38,38,76,162,155,317,12,13,25,3,3:17
448558,2016-08-10,2016,OAK,BAL,1,0,1-0,OAK,9,true,31,33,64,121,126,247,7,7,14,1,2:24
448568,2016-08-10,2016,PIT,SDN,0,4,4-0,SDN,9,false,30,35,65,128,132,260,5,8,13,1,2:57
448580,2016-08-10,2016,MIA,SFN,0,1,1-0,SFN,9,false,34,37,71,153,125,278,8,11,19,2,3:04
448563,2016-08-10,2016,SEA,DET,3,1,3-1,SEA,9,true,36,33,69,146,144,290,13,8,21,1,3:06
448562,2016-08-10,2016,TEX,COL,5,4,5-4,TEX,9,true,41,37,78,168,171,339,17,10,27,4,3:27
448561,2016-08-10,2016,WAS,CLE,7,4,7-4,WAS,9,true,36,37,73,155,124,279,12,11,23,4,2:52
448556,2016-08-10,2016,NYN,ARI,2,3,3-2,ARI,12,false,42,47,89,192,173,365,7,13,20,4,4:03 (:30 delay)
448566,2016-08-10,2016,BOS,NYA,4,9,9-4,NYA,9,false,42,44,86,180,175,355,18,19,37,9,4:15
448565,2016-08-10,2016,CHN,ANA,3,1,3-1,CHN,9,true,33,35,68,135,133,268,8,8,16,2,2:50
448559,2016-08-10,2016,KCA,CHA,3,2,3-2,KCA,14,false,57,56,113,220,204,424,18,17,35,3,4:34
448574,2016-08-11,2016,KCA,CHA,2,1,2-1,KCA,9,true,30,33,63,98,121,219,6,7,13,0,2:25
448572,2016-08-11,2016,MIL,ATL,11,3,11-3,MIL,9,true,39,40,79,127,172,299,19,15,34,1,3:19
448579,2016-08-11,2016,PIT,SDN,4,0,4-0,PIT,9,true,32,33,65,123,119,242,10,7,17,1,2:37
448573,2016-08-11,2016,OAK,BAL,6,9,9-6,BAL,9,false,40,41,81,158,179,337,14,16,30,1,3:10
448578,2016-08-11,2016,BOS,NYA,2,4,4-2,NYA,9,false,38,35,73,134,138,272,13,10,23,0,3:02
448577,2016-08-11,2016,CLE,ANA,14,4,14-4,CLE,9,true,42,36,78,138,184,322,18,10,28,2,3:10 (1:10 delay)
448571,2016-08-11,2016,NYN,ARI,0,9,9-0,ARI,9,false,31,45,76,176,103,279,6,18,24,1,2:52
448564,2016-08-11,2016,MIN,HOU,2,10,10-2,HOU,9,false,37,46,83,174,138,312,9,19,28,1,2:46
448564,2016-08-11,2016,MIN,HOU,2,10,10-2,HOU,9,false,37,46,83,174,138,312,9,19,28,1,2:46
448581,2016-08-11,2016,CHN,SLN,4,3,4-3,CHN,11,false,48,46,94,172,203,375,17,15,32,2,3:55
448576,2016-08-11,2016,MIN,HOU,7,15,15-7,HOU,9,false,40,54,94,164,150,314,15,26,41,4,3:02
448575,2016-08-11,2016,TEX,COL,9,12,12-9,COL,9,false,47,47,94,190,212,402,21,21,42,2,4:03
448590,2016-08-12,2016,MIN,KCA,3,7,7-3,KCA,9,false,33,40,73,150,137,287,6,13,19,2,2:48 (:50 delay)
448582,2016-08-12,2016,BOS,ARI,9,4,9-4,BOS,9,true,37,40,77,136,132,268,12,14,26,1,2:53
448596,2016-08-12,2016,NYA,TBA,6,3,6-3,NYA,9,true,34,34,68,139,129,268,10,8,18,0,2:51 (:30 delay)
448589,2016-08-12,2016,TOR,HOU,3,5,5-3,HOU,9,false,33,44,77,154,130,284,8,18,26,2,2:49
448584,2016-08-12,2016,SFN,BAL,2,5,5-2,BAL,9,false,33,39,72,150,148,298,7,13,20,4,3:01
448592,2016-08-12,2016,LAN,PIT,1,5,5-1,PIT,9,false,38,34,72,123,146,269,12,7,19,2,2:57
448591,2016-08-12,2016,CLE,ANA,13,3,13-3,CLE,9,true,43,35,78,123,154,277,20,8,28,0,3:13
448595,2016-08-12,2016,CHN,SLN,13,2,13-2,CHN,9,true,44,38,82,151,161,312,20,9,29,1,2:59
448583,2016-08-12,2016,WAS,ATL,5,8,8-5,ATL,9,false,38,41,79,163,147,310,12,16,28,4,3:15
448594,2016-08-12,2016,OAK,SEA,6,3,6-3,OAK,9,true,34,32,66,124,123,247,12,8,20,1,2:19
448585,2016-08-12,2016,MIA,CHA,2,4,4-2,CHA,9,false,35,42,77,163,167,330,8,19,27,3,3:22
448587,2016-08-12,2016,PHI,COL,10,6,10-6,PHI,9,true,42,39,81,159,172,331,17,11,28,1,3:25
448586,2016-08-12,2016,MIL,CIN,4,7,7-4,CIN,9,false,35,45,80,183,165,348,8,18,26,1,3:23
448588,2016-08-12,2016,TEX,DET,8,5,8-5,TEX,9,true,39,38,77,136,141,277,15,10,25,2,3:00 (2:42 delay)
448593,2016-08-12,2016,NYN,SDN,6,8,8-6,SDN,9,false,39,35,74,153,153,306,12,9,21,2,3:07
448606,2016-08-13,2016,CLE,ANA,5,1,5-1,CLE,9,true,35,33,68,133,136,269,14,7,21,1,3:04 (2:11 delay)
448599,2016-08-13,2016,SFN,BAL,6,2,6-2,SFN,9,true,39,37,76,137,160,297,16,10,26,2,2:59
448602,2016-08-13,2016,PHI,COL,6,3,6-3,PHI,9,true,36,41,77,150,138,288,13,16,29,2,3:20
448609,2016-08-13,2016,OAK,SEA,3,4,4-3,SEA,9,false,37,37,74,135,136,271,11,11,22,2,2:58
448605,2016-08-13,2016,MIN,KCA,5,3,5-3,MIN,9,true,38,36,74,131,129,260,14,9,23,1,2:35
448597,2016-08-13,2016,BOS,ARI,6,3,6-3,BOS,9,true,35,37,72,160,140,300,10,12,22,5,3:12
448598,2016-08-13,2016,WAS,ATL,7,6,7-6,WAS,9,true,37,40,77,145,135,280,12,14,26,2,3:07
448603,2016-08-13,2016,TEX,DET,0,2,2-0,DET,9,false,32,42,74,147,130,277,6,20,26,0,2:54
448604,2016-08-13,2016,TOR,HOU,4,2,4-2,TOR,9,true,31,35,66,128,132,260,9,10,19,1,2:35
448611,2016-08-13,2016,NYA,TBA,8,4,8-4,NYA,9,true,36,33,69,104,134,238,12,6,18,1,2:40
448608,2016-08-13,2016,NYN,SDN,3,2,3-2,NYN,11,false,42,36,78,148,160,308,10,6,16,1,3:22
448601,2016-08-13,2016,MIL,CIN,5,11,11-5,CIN,9,false,41,45,86,162,178,340,16,17,33,2,3:29
448610,2016-08-13,2016,CHN,SLN,4,8,8-4,SLN,9,false,36,40,76,148,167,315,12,13,25,2,2:50
448600,2016-08-13,2016,MIA,CHA,7,8,8-7,CHA,9,false,40,45,85,172,148,320,16,18,34,3,3:23
448607,2016-08-13,2016,LAN,PIT,8,4,8-4,LAN,9,true,43,49,92,201,151,352,18,22,40,5,3:54
448613,2016-08-14,2016,WAS,ATL,9,1,9-1,WAS,9,true,37,32,69,116,145,261,12,8,20,1,2:46
448615,2016-08-14,2016,MIA,CHA,5,4,5-4,MIA,9,true,34,38,72,136,122,258,12,12,24,1,2:49
448621,2016-08-14,2016,CLE,ANA,5,4,5-4,CLE,9,true,36,33,69,133,128,261,15,8,23,1,2:47 (1:38 delay)
448623,2016-08-14,2016,NYN,SDN,5,1,5-1,NYN,9,true,34,32,66,137,142,279,12,6,18,2,2:47
448624,2016-08-14,2016,OAK,SEA,4,8,8-4,SEA,9,false,37,42,79,132,134,266,10,16,26,1,2:51
448616,2016-08-14,2016,MIL,CIN,7,3,7-3,MIL,9,true,38,35,73,149,164,313,14,9,23,1,2:52
448626,2016-08-14,2016,NYA,TBA,3,12,12-3,TBA,9,false,35,44,79,154,124,278,10,17,27,2,2:54
448618,2016-08-14,2016,TEX,DET,0,7,7-0,DET,9,false,30,41,71,133,112,245,4,14,18,1,2:26
448619,2016-08-14,2016,TOR,HOU,9,2,9-2,TOR,9,true,40,36,76,118,168,286,16,8,24,4,2:59
448612,2016-08-14,2016,BOS,ARI,16,2,16-2,BOS,9,true,48,33,81,107,161,268,23,7,30,2,2:49
448625,2016-08-14,2016,CHN,SLN,4,6,6-4,SLN,9,false,37,39,76,163,132,295,10,13,23,4,3:02
448617,2016-08-14,2016,PHI,COL,7,6,7-6,PHI,9,true,43,43,86,176,153,329,17,17,34,3,3:33
448614,2016-08-14,2016,SFN,BAL,7,8,8-7,BAL,9,false,46,44,90,159,167,326,19,17,36,3,3:14
448622,2016-08-14,2016,LAN,PIT,3,11,11-3,PIT,9,false,36,48,84,198,162,360,9,21,30,3,3:39
448620,2016-08-14,2016,MIN,KCA,4,11,11-4,KCA,9,false,34,47,81,169,142,311,8,19,27,3,3:07
446903,2016-08-15,2016,CLE,BOS,2,3,3-2,BOS,9,false,34,37,71,139,137,276,9,11,20,3,2:57
446903,2016-08-15,2016,CLE,BOS,2,3,3-2,BOS,9,false,34,37,71,139,137,276,9,11,20,3,2:57
448631,2016-08-15,2016,TBA,SDN,8,2,8-2,TBA,9,true,39,33,72,132,155,287,17,7,24,1,2:50
448627,2016-08-15,2016,DET,KCA,1,3,3-1,KCA,9,false,34,40,74,137,127,264,7,15,22,2,2:58
448632,2016-08-15,2016,ANA,SEA,2,3,3-2,SEA,9,false,36,38,74,160,131,291,9,12,21,3,3:01
448634,2016-08-15,2016,COL,WAS,4,5,5-4,WAS,9,false,37,42,79,162,161,323,12,17,29,3,3:26
448643,2016-08-15,2016,TEX,OAK,5,2,5-2,TEX,9,true,38,32,70,122,157,279,17,7,24,1,2:42
448630,2016-08-15,2016,SFN,PIT,5,8,8-5,PIT,9,false,43,42,85,161,154,315,17,17,34,3,3:27
448633,2016-08-15,2016,NYA,TOR,1,0,1-0,NYA,9,true,39,30,69,147,149,296,15,4,19,0,2:55
448629,2016-08-15,2016,ARI,NYN,10,6,10-6,ARI,9,true,43,42,85,179,150,329,19,17,36,1,3:29
448628,2016-08-15,2016,CIN,MIA,3,6,6-3,MIA,9,false,39,41,80,166,173,339,12,14,26,6,3:41
447184,2016-08-16,2016,CHN,MIL,4,0,4-0,CHN,9,true,35,35,70,159,150,309,11,10,21,2,3:12
448637,2016-08-16,2016,DET,KCA,1,6,6-1,KCA,9,false,31,35,66,130,114,244,5,7,12,3,2:43
448649,2016-08-16,2016,COL,WAS,6,2,6-2,COL,9,true,35,38,73,144,130,274,14,12,26,2,2:54 (2:05 delay)
448639,2016-08-16,2016,CIN,MIA,6,3,6-3,CIN,9,true,35,36,71,137,127,264,13,11,24,1,2:34
448646,2016-08-16,2016,ANA,SEA,7,6,7-6,ANA,9,true,35,41,76,155,135,290,12,15,27,2,3:03
448645,2016-08-16,2016,TBA,SDN,15,1,15-1,TBA,9,true,44,38,82,160,158,318,20,11,31,0,3:18
448647,2016-08-16,2016,HOU,SLN,5,8,8-5,SLN,9,false,41,37,78,160,161,321,14,10,24,2,3:06
448635,2016-08-16,2016,BAL,BOS,3,5,5-3,BOS,9,false,36,38,74,148,145,293,10,13,23,3,3:05
447184,2016-08-16,2016,CHN,MIL,4,0,4-0,CHN,9,true,35,35,70,159,150,309,11,10,21,2,3:12
448641,2016-08-16,2016,ATL,MIN,2,4,4-2,MIN,9,false,37,42,79,188,147,335,10,18,28,5,3:28
448636,2016-08-16,2016,CLE,CHA,3,1,3-1,CLE,9,true,37,35,72,141,153,294,14,9,23,2,3:08
448644,2016-08-16,2016,SFN,PIT,3,4,4-3,PIT,9,false,37,38,75,156,121,277,10,13,23,1,3:12
448638,2016-08-16,2016,PHI,LAN,5,15,15-5,LAN,9,false,36,47,83,208,143,351,9,19,28,2,3:30
448642,2016-08-16,2016,ARI,NYN,5,7,7-5,NYN,9,false,41,39,80,145,173,318,12,15,27,3,3:24
448640,2016-08-16,2016,CHN,MIL,4,1,4-1,CHN,9,true,36,35,71,152,154,306,15,10,25,3,3:21
448658,2016-08-16,2016,TEX,OAK,5,4,5-4,TEX,10,false,41,48,89,185,169,354,14,19,33,2,3:40
448648,2016-08-16,2016,NYA,TOR,6,12,12-6,TOR,9,false,35,45,80,188,136,324,8,19,27,3,3:09 (:42 delay)
448650,2016-08-17,2016,BAL,BOS,1,8,8-1,BOS,7,true,23,33,56,118,84,202,4,16,20,1,2:12 (1:17 delay)
448660,2016-08-17,2016,TBA,SDN,2,0,2-0,TBA,9,true,31,34,65,126,114,240,7,7,14,3,2:32
448655,2016-08-17,2016,CHN,MIL,6,1,6-1,CHN,9,true,37,33,70,152,137,289,14,6,20,1,2:50
448663,2016-08-17,2016,NYA,TOR,4,7,7-4,TOR,9,false,36,41,77,149,121,270,10,13,23,2,2:47
448652,2016-08-17,2016,DET,KCA,1,4,4-1,KCA,9,false,37,36,73,149,131,280,10,11,21,3,2:47
448674,2016-08-17,2016,TEX,OAK,6,2,6-2,TEX,9,true,37,35,72,119,143,262,15,9,24,3,2:54
448654,2016-08-17,2016,CIN,MIA,3,2,3-2,CIN,9,true,36,37,73,162,146,308,15,9,24,2,3:07
448657,2016-08-17,2016,ARI,NYN,13,5,13-5,ARI,9,true,42,40,82,132,155,287,20,13,33,5,2:53
448662,2016-08-17,2016,HOU,SLN,2,8,8-2,SLN,9,false,37,42,79,201,128,329,10,16,26,3,2:59
448653,2016-08-17,2016,PHI,LAN,2,7,7-2,LAN,9,false,39,43,82,161,164,325,14,16,30,2,3:23
448651,2016-08-17,2016,CLE,CHA,7,10,10-7,CHA,9,false,44,39,83,146,187,333,18,14,32,3,3:30
448659,2016-08-17,2016,SFN,PIT,5,6,6-5,PIT,9,false,41,38,79,159,168,327,15,12,27,1,3:21
448661,2016-08-17,2016,ANA,SEA,3,4,4-3,SEA,9,false,42,41,83,153,183,336,19,14,33,3,3:37
448664,2016-08-17,2016,COL,WAS,12,10,12-10,COL,9,true,41,44,85,210,163,373,17,17,34,3,3:52
448656,2016-08-17,2016,ATL,MIN,3,10,10-3,MIN,9,false,36,49,85,213,115,328,12,25,37,3,3:24
448675,2016-08-18,2016,ANA,SEA,6,4,6-4,ANA,9,true,35,36,71,135,125,260,13,10,23,2,2:58
448672,2016-08-18,2016,KCA,MIN,8,1,8-1,KCA,9,true,34,32,66,110,124,234,11,6,17,1,2:15
448667,2016-08-18,2016,CLE,CHA,5,4,5-4,CLE,9,false,36,36,72,148,144,292,14,10,24,2,3:00
448669,2016-08-18,2016,PHI,LAN,5,4,5-4,PHI,9,true,38,36,74,134,150,284,14,10,24,2,2:54
448670,2016-08-18,2016,CIN,MIA,5,4,5-4,CIN,9,true,34,36,70,143,124,267,12,9,21,1,2:40
448673,2016-08-18,2016,SFN,NYN,10,7,10-7,SFN,9,true,42,42,84,165,155,320,22,17,39,6,3:30
448665,2016-08-18,2016,SDN,ARI,9,8,9-8,SDN,9,true,42,45,87,168,163,331,20,19,39,2,3:49
448676,2016-08-18,2016,ATL,WAS,2,8,8-2,WAS,9,false,37,43,80,179,143,322,9,14,23,1,3:32 (1:16 delay)
448668,2016-08-18,2016,BAL,HOU,13,5,13-5,BAL,9,true,42,35,77,131,149,280,19,8,27,2,2:40
448666,2016-08-18,2016,DET,BOS,4,3,4-3,DET,9,true,36,39,75,163,129,292,13,13,26,2,3:23
448671,2016-08-18,2016,CHN,MIL,9,6,9-6,CHN,9,true,40,42,82,161,158,319,16,16,32,2,3:21
448690,2016-08-19,2016,CLE,TOR,3,2,3-2,CLE,9,false,34,33,67,121,141,262,10,7,17,0,2:27
448689,2016-08-19,2016,TBA,TEX,2,6,6-2,TEX,9,false,35,42,77,160,134,294,8,15,23,3,2:56
448680,2016-08-19,2016,BAL,HOU,8,15,15-8,HOU,9,false,39,49,88,169,142,311,12,24,36,4,3:03
448682,2016-08-19,2016,PIT,MIA,5,6,6-5,MIA,9,false,39,47,86,150,161,311,17,25,42,3,3:36
448688,2016-08-19,2016,PHI,SLN,3,4,4-3,SLN,11,false,46,45,91,167,186,353,17,13,30,3,3:54
448687,2016-08-19,2016,CHA,OAK,0,9,9-0,OAK,9,false,28,43,71,155,98,253,2,16,18,1,2:23
448678,2016-08-19,2016,DET,BOS,2,10,10-2,BOS,9,false,33,45,78,158,132,290,6,18,24,1,2:46
448683,2016-08-19,2016,SEA,MIL,7,6,7-6,SEA,9,true,43,40,83,166,152,318,18,15,33,3,3:21
448681,2016-08-19,2016,CIN,LAN,9,2,9-2,CIN,9,true,38,43,81,165,173,338,17,17,34,2,3:39
448685,2016-08-19,2016,SFN,NYN,8,1,8-1,SFN,9,true,39,35,74,136,126,262,17,11,28,4,2:54
448691,2016-08-19,2016,ATL,WAS,6,7,7-6,WAS,9,false,37,44,81,177,165,342,12,17,29,2,3:36
448684,2016-08-19,2016,KCA,MIN,5,4,5-4,KCA,11,false,49,45,94,182,192,374,21,12,33,4,3:44 (3:15 delay)
448686,2016-08-19,2016,ANA,NYA,0,7,7-0,NYA,9,false,34,42,76,132,123,255,7,16,23,4,2:55
448677,2016-08-19,2016,SDN,ARI,7,4,7-4,SDN,10,false,41,49,90,205,139,344,16,23,39,4,3:58
448679,2016-08-19,2016,COL,CHN,7,6,7-6,COL,11,false,44,47,91,183,182,365,14,16,30,2,3:47 (2:10 delay)
448701,2016-08-20,2016,ANA,NYA,1,5,5-1,NYA,9,false,33,37,70,155,123,278,7,9,16,2,2:51
448692,2016-08-20,2016,SDN,ARI,1,2,2-1,ARI,9,false,34,34,68,123,148,271,6,8,14,2,2:52
448699,2016-08-20,2016,KCA,MIN,10,0,10-0,KCA,9,true,42,31,73,124,135,259,19,5,24,1,2:31
448693,2016-08-20,2016,DET,BOS,2,3,3-2,BOS,9,false,34,36,70,139,106,245,8,10,18,2,2:36 (2:31 delay)
448703,2016-08-20,2016,PHI,SLN,4,2,4-2,PHI,9,true,34,34,68,134,138,272,11,10,21,0,2:56
448702,2016-08-20,2016,CHA,OAK,6,2,6-2,CHA,9,true,35,36,71,146,131,277,11,9,20,1,2:33
448698,2016-08-20,2016,SEA,MIL,8,2,8-2,SEA,9,true,37,35,72,123,141,264,15,9,24,2,2:53
448704,2016-08-20,2016,TBA,TEX,8,2,8-2,TBA,9,true,37,37,74,158,132,290,14,11,25,3,2:56
448696,2016-08-20,2016,CIN,LAN,11,1,11-1,CIN,9,true,44,33,77,126,154,280,22,6,28,1,2:53 (1:19 delay)
448705,2016-08-20,2016,CLE,TOR,5,6,6-5,TOR,9,false,34,41,75,154,142,296,7,15,22,1,3:00
448706,2016-08-20,2016,ATL,WAS,9,11,11-9,WAS,9,false,45,45,90,160,154,314,17,20,37,4,3:26
448695,2016-08-20,2016,BAL,HOU,2,12,12-2,HOU,9,false,37,50,87,204,139,343,9,25,34,2,3:21
448697,2016-08-20,2016,PIT,MIA,1,3,3-1,MIA,9,false,32,33,65,109,141,250,6,6,12,0,2:30
448694,2016-08-20,2016,COL,CHN,2,9,9-2,CHN,9,false,34,44,78,176,129,305,8,18,26,2,3:05
448700,2016-08-20,2016,SFN,NYN,5,9,9-5,NYN,9,false,39,42,81,167,151,318,15,17,32,2,3:21
448714,2016-08-21,2016,KCA,MIN,2,1,2-1,KCA,9,true,29,36,65,125,129,254,5,10,15,1,2:25
448716,2016-08-21,2016,ANA,NYA,2,0,2-0,ANA,9,true,32,35,67,141,132,273,10,9,19,1,2:39
448711,2016-08-21,2016,CIN,LAN,0,4,4-0,LAN,9,false,34,37,71,138,145,283,10,12,22,0,2:55
448719,2016-08-21,2016,TBA,TEX,8,4,8-4,TBA,9,true,37,35,72,160,139,299,12,9,21,3,3:01
448709,2016-08-21,2016,COL,CHN,11,4,11-4,COL,9,true,42,33,75,122,180,302,17,8,25,1,3:00
448713,2016-08-21,2016,SEA,MIL,6,7,7-6,MIL,9,false,39,38,77,160,154,314,12,12,24,3,3:13
448707,2016-08-21,2016,SDN,ARI,9,1,9-1,SDN,9,true,37,32,69,128,136,264,14,5,19,1,2:30
448715,2016-08-21,2016,SFN,NYN,0,2,2-0,NYN,9,false,29,32,61,123,111,234,5,6,11,0,2:25
448720,2016-08-21,2016,CLE,TOR,3,2,3-2,CLE,9,true,32,40,72,166,113,279,10,14,24,2,2:53
448717,2016-08-21,2016,CHA,OAK,4,2,4-2,CHA,9,true,35,37,72,136,120,256,12,11,23,3,2:42
448708,2016-08-21,2016,DET,BOS,10,5,10-5,DET,9,true,38,36,74,153,148,301,17,10,27,0,3:09
448721,2016-08-21,2016,ATL,WAS,7,6,7-6,ATL,10,false,43,43,86,170,174,344,16,12,28,3,3:36 (1:04 delay)
448710,2016-08-21,2016,BAL,HOU,3,5,5-3,HOU,9,false,33,38,71,127,112,239,7,12,19,0,2:32 (4:35 delay)
448712,2016-08-21,2016,PIT,MIA,2,3,3-2,MIA,9,false,35,38,73,132,146,278,7,9,16,1,2:55
448718,2016-08-21,2016,PHI,SLN,0,9,9-0,SLN,9,false,35,43,78,181,126,307,11,15,26,1,3:07
448725,2016-08-22,2016,OAK,CLE,0,1,1-0,CLE,9,false,31,34,65,143,112,255,4,8,12,0,2:29
448727,2016-08-22,2016,PIT,HOU,1,3,3-1,HOU,9,false,32,32,64,111,119,230,6,6,12,0,2:17
448729,2016-08-22,2016,SEA,NYA,7,5,7-5,SEA,9,true,34,37,71,146,132,278,13,12,25,5,2:56
448730,2016-08-22,2016,BAL,WAS,4,3,4-3,BAL,9,true,31,37,68,143,121,264,8,11,19,1,2:31
448724,2016-08-22,2016,SDN,CHN,1,5,5-1,CHN,9,false,34,41,75,167,155,322,8,18,26,1,3:19
448722,2016-08-22,2016,ARI,ATL,9,8,9-8,ARI,9,false,39,43,82,153,158,311,17,18,35,2,3:18
448723,2016-08-22,2016,TBA,BOS,2,6,6-2,BOS,9,false,33,43,76,185,137,322,7,18,25,1,3:13
448728,2016-08-22,2016,CIN,LAN,9,18,18-9,LAN,9,false,50,52,102,189,190,379,22,25,47,6,4:02
448726,2016-08-22,2016,MIL,COL,4,2,4-2,MIL,9,true,34,36,70,137,154,291,12,9,21,0,2:54
448744,2016-08-23,2016,CIN,TEX,3,0,3-0,CIN,9,true,31,36,67,146,113,259,9,9,18,0,2:39
448733,2016-08-23,2016,SDN,CHN,3,5,5-3,CHN,9,false,33,42,75,145,134,279,10,14,24,2,2:55
448738,2016-08-23,2016,MIA,KCA,0,1,1-0,KCA,9,false,35,35,70,136,147,283,9,9,18,1,2:50
448734,2016-08-23,2016,OAK,CLE,9,1,9-1,OAK,9,true,40,31,71,150,141,291,16,6,22,1,2:43
448739,2016-08-23,2016,TOR,ANA,7,2,7-2,TOR,9,true,38,35,73,124,157,281,17,10,27,2,2:38
448741,2016-08-23,2016,SEA,NYA,1,5,5-1,NYA,9,false,31,41,72,162,123,285,5,12,17,1,2:45
448736,2016-08-23,2016,MIN,DET,3,8,8-3,DET,9,false,32,41,73,156,112,268,6,18,24,2,2:45
448745,2016-08-23,2016,BAL,WAS,8,1,8-1,BAL,9,true,41,35,76,144,158,302,17,12,29,3,3:12
448737,2016-08-23,2016,PIT,HOU,7,1,7-1,PIT,9,true,37,33,70,98,153,251,14,7,21,0,2:32
448740,2016-08-23,2016,SLN,NYN,4,7,7-4,NYN,9,false,42,41,83,144,171,315,16,16,32,3,3:12
448731,2016-08-23,2016,ARI,ATL,4,7,7-4,ATL,9,false,38,45,83,169,153,322,11,18,29,1,3:23
448732,2016-08-23,2016,TBA,BOS,1,2,2-1,BOS,9,false,34,34,68,172,131,303,10,9,19,2,3:09
448742,2016-08-23,2016,CHA,PHI,9,1,9-1,CHA,9,true,37,34,71,144,134,278,15,7,22,1,2:38
448743,2016-08-23,2016,LAN,SFN,9,5,9-5,LAN,9,true,41,38,79,152,158,310,17,14,31,5,3:36
448735,2016-08-23,2016,MIL,COL,6,4,6-4,MIL,9,true,37,43,80,172,156,328,14,16,30,2,3:29
448759,2016-08-24,2016,LAN,SFN,1,0,1-0,LAN,9,true,29,35,64,133,119,252,6,8,14,2,2:47
448758,2016-08-24,2016,CHA,PHI,3,5,5-3,PHI,9,false,35,39,74,148,120,268,9,12,21,1,2:44
448756,2016-08-24,2016,SLN,NYN,8,1,8-1,SLN,9,true,42,33,75,109,166,275,22,7,29,2,2:55
448754,2016-08-24,2016,MIA,KCA,3,0,3-0,MIA,9,true,32,38,70,150,114,264,8,11,19,1,2:35
448751,2016-08-24,2016,MIL,COL,7,1,7-1,MIL,9,true,38,38,76,142,144,286,14,10,24,2,3:01
448749,2016-08-24,2016,SDN,CHN,3,6,6-3,CHN,9,false,37,37,74,138,150,288,9,10,19,2,2:55
448760,2016-08-24,2016,CIN,TEX,5,6,6-5,TEX,9,false,38,34,72,116,132,248,12,8,20,0,2:44
448752,2016-08-24,2016,MIN,DET,4,9,9-4,DET,9,false,38,42,80,151,153,304,11,17,28,1,3:04
448753,2016-08-24,2016,PIT,HOU,4,5,5-4,HOU,9,false,40,37,77,130,159,289,13,11,24,1,2:56
448746,2016-08-24,2016,ARI,ATL,10,9,10-9,ARI,11,false,53,56,109,233,206,439,23,25,48,4,4:46
448755,2016-08-24,2016,TOR,ANA,2,8,8-2,ANA,9,false,38,47,85,184,163,347,11,24,35,1,3:21
448748,2016-08-24,2016,TBA,BOS,4,3,4-3,TBA,11,false,47,42,89,158,190,348,14,11,25,5,3:41
448747,2016-08-24,2016,WAS,BAL,8,10,10-8,BAL,9,false,43,48,91,175,173,348,18,20,38,4,3:28
448750,2016-08-24,2016,OAK,CLE,5,1,5-1,OAK,9,true,37,37,74,138,133,271,14,12,26,3,2:37
448757,2016-08-24,2016,SEA,NYA,0,5,5-0,NYA,9,false,35,42,77,161,147,308,10,17,27,2,3:18
448762,2016-08-25,2016,WAS,BAL,4,0,4-0,WAS,9,true,34,30,64,110,134,244,10,3,13,1,2:43
448763,2016-08-25,2016,TBA,BOS,2,1,2-1,TBA,9,true,32,33,65,122,122,244,9,10,19,2,2:32
448767,2016-08-25,2016,TOR,ANA,3,6,6-3,ANA,9,false,38,37,75,143,145,288,10,14,24,4,3:06
448765,2016-08-25,2016,MIN,DET,5,8,8-5,DET,9,false,37,45,82,149,138,287,10,19,29,2,2:49
448764,2016-08-25,2016,TEX,CLE,9,0,9-0,TEX,9,true,37,30,67,117,136,253,12,3,15,1,2:34
448761,2016-08-25,2016,ARI,ATL,1,3,3-1,ATL,9,false,32,39,71,161,124,285,5,14,19,0,2:55
448770,2016-08-25,2016,LAN,SFN,0,4,4-0,SFN,9,false,31,38,69,170,134,304,4,11,15,1,3:02
448769,2016-08-25,2016,MIL,PIT,2,3,3-2,PIT,10,false,38,40,78,156,143,299,9,11,20,1,3:20
448766,2016-08-25,2016,MIA,KCA,2,5,5-2,KCA,9,false,40,38,78,149,162,311,11,12,23,2,3:13
448771,2016-08-25,2016,CHA,SEA,7,6,7-6,CHA,9,false,40,38,78,146,162,308,16,11,27,3,3:06
448768,2016-08-25,2016,SLN,NYN,6,10,10-6,NYN,9,false,41,45,86,166,157,323,15,21,36,2,3:28
448785,2016-08-26,2016,CHA,SEA,1,3,3-1,SEA,9,false,33,32,65,120,121,241,10,6,16,1,2:22
448779,2016-08-26,2016,DET,ANA,4,2,4-2,DET,9,true,34,33,67,135,113,248,12,7,19,2,2:50
448781,2016-08-26,2016,SLN,OAK,3,1,3-1,SLN,9,true,32,34,66,134,121,255,9,8,17,1,2:26
448772,2016-08-26,2016,SFN,ATL,7,0,7-0,SFN,9,true,36,36,72,129,131,260,11,10,21,0,2:51
448783,2016-08-26,2016,MIL,PIT,3,5,5-3,PIT,9,false,41,40,81,155,156,311,16,12,28,3,3:26
448776,2016-08-26,2016,TEX,CLE,1,12,12-1,CLE,9,false,35,46,81,163,160,323,9,21,30,2,3:17
448778,2016-08-26,2016,BOS,KCA,3,6,6-3,KCA,9,false,42,38,80,145,178,323,17,13,30,3,3:14
448784,2016-08-26,2016,MIA,SDN,7,6,7-6,MIA,9,false,45,40,85,176,194,370,19,14,33,4,3:52
448777,2016-08-26,2016,WAS,COL,8,5,8-5,WAS,9,true,38,35,73,143,138,281,15,9,24,3,3:04
448773,2016-08-26,2016,NYA,BAL,14,4,14-4,NYA,9,true,44,35,79,142,158,300,20,8,28,1,2:51
448782,2016-08-26,2016,NYN,PHI,9,4,9-4,NYN,9,true,36,37,73,142,144,286,14,11,25,2,2:56
448774,2016-08-26,2016,LAN,CHN,4,6,6-4,CHN,10,false,44,43,87,168,166,334,15,13,28,0,3:38
448780,2016-08-26,2016,TOR,MIN,15,8,15-8,TOR,9,true,45,42,87,173,181,354,20,15,35,3,3:11
448775,2016-08-26,2016,ARI,CIN,4,3,4-3,ARI,11,false,45,49,94,170,179,349,13,20,33,0,3:47
448786,2016-08-26,2016,HOU,TBA,5,4,5-4,HOU,9,false,32,35,67,124,145,269,9,9,18,1,2:39
448787,2016-08-27,2016,SFN,ATL,1,3,3-1,ATL,9,false,33,35,68,130,118,248,6,13,19,2,2:34
448790,2016-08-27,2016,ARI,CIN,0,13,13-0,CIN,9,false,30,47,77,157,108,265,5,19,24,1,2:32
448789,2016-08-27,2016,LAN,CHN,3,2,3-2,LAN,9,true,30,36,66,146,117,263,6,12,18,2,3:08
448796,2016-08-27,2016,SLN,OAK,2,3,3-2,OAK,9,false,33,38,71,151,129,280,6,10,16,3,2:52
448791,2016-08-27,2016,TEX,CLE,7,0,7-0,TEX,9,true,37,36,73,146,143,289,12,9,21,0,2:57
448800,2016-08-27,2016,CHA,SEA,9,3,9-3,CHA,9,true,41,35,76,130,155,285,18,10,28,2,2:51
448801,2016-08-27,2016,HOU,TBA,6,2,6-2,HOU,9,true,39,35,74,134,167,301,19,10,29,1,2:58
448795,2016-08-27,2016,TOR,MIN,8,7,8-7,TOR,9,true,37,39,76,161,148,309,15,13,28,2,3:06
448793,2016-08-27,2016,BOS,KCA,8,3,8-3,BOS,9,true,37,37,74,159,141,300,15,10,25,0,3:03
448797,2016-08-27,2016,NYN,PHI,12,1,12-1,NYN,9,true,43,31,74,134,175,309,20,5,25,1,3:07
448799,2016-08-27,2016,MIA,SDN,0,1,1-0,SDN,9,false,35,36,71,181,121,302,10,10,20,2,3:11
448798,2016-08-27,2016,MIL,PIT,6,9,9-6,PIT,9,false,39,43,82,170,155,325,15,18,33,1,3:21
448794,2016-08-27,2016,DET,ANA,2,3,3-2,ANA,9,false,36,39,75,169,158,327,11,13,24,1,3:17
448788,2016-08-27,2016,NYA,BAL,13,5,13-5,NYA,9,true,51,41,92,161,197,358,27,15,42,5,3:29
448792,2016-08-27,2016,WAS,COL,4,9,9-4,COL,11,false,47,54,101,214,200,414,15,25,40,6,4:49
448814,2016-08-28,2016,MIA,SDN,1,3,3-1,SDN,9,false,30,36,66,131,99,230,9,11,20,0,2:36
448815,2016-08-28,2016,CHA,SEA,4,1,4-1,CHA,9,true,33,34,67,143,115,258,9,8,17,3,2:30
448806,2016-08-28,2016,TEX,CLE,2,1,2-1,TEX,9,true,32,35,67,135,125,260,9,10,19,1,2:43
448813,2016-08-28,2016,MIL,PIT,1,3,3-1,PIT,9,false,32,39,71,151,108,259,6,12,18,1,2:39
448804,2016-08-28,2016,LAN,CHN,1,0,1-0,LAN,9,true,32,35,67,135,150,285,9,8,17,2,3:08
448807,2016-08-28,2016,WAS,COL,3,5,5-3,COL,9,false,34,39,73,151,129,280,7,12,19,2,2:52
448803,2016-08-28,2016,NYA,BAL,0,5,5-0,BAL,9,false,34,39,73,150,149,299,8,13,21,2,3:07
448812,2016-08-28,2016,NYN,PHI,1,5,5-1,PHI,9,false,36,36,72,145,163,308,8,12,20,3,3:08
448811,2016-08-28,2016,SLN,OAK,4,7,7-4,OAK,9,false,34,38,72,126,134,260,8,13,21,1,2:43
448816,2016-08-28,2016,HOU,TBA,4,10,10-4,TBA,9,false,39,44,83,175,156,331,11,17,28,2,3:14
448808,2016-08-28,2016,BOS,KCA,4,10,10-4,KCA,9,false,37,43,80,162,168,330,13,15,28,3,3:25
448810,2016-08-28,2016,TOR,MIN,9,6,9-6,TOR,9,true,39,41,80,149,153,302,17,14,31,3,3:00
448805,2016-08-28,2016,ARI,CIN,11,2,11-2,ARI,9,true,43,30,73,121,176,297,19,5,24,0,2:57
448809,2016-08-28,2016,DET,ANA,0,5,5-0,ANA,9,false,34,37,71,135,148,283,8,13,21,2,3:09
448802,2016-08-28,2016,SFN,ATL,13,4,13-4,SFN,9,true,46,35,81,138,177,315,23,9,32,2,3:13
448818,2016-08-29,2016,ANA,CIN,9,2,9-2,ANA,9,true,39,35,74,123,130,253,16,9,25,1,2:51
448823,2016-08-29,2016,HOU,OAK,6,0,6-0,HOU,9,true,36,35,71,140,155,295,12,10,22,3,2:45
448829,2016-08-29,2016,PHI,WAS,0,4,4-0,WAS,9,false,31,38,69,150,127,277,6,11,17,0,2:58
448827,2016-08-29,2016,BOS,TBA,9,4,9-4,BOS,9,true,41,35,76,140,169,309,18,10,28,1,3:11
448821,2016-08-29,2016,CLE,MIN,1,0,1-0,CLE,10,false,38,41,79,168,134,302,12,12,24,4,3:19
448825,2016-08-29,2016,TEX,SEA,6,3,6-3,TEX,9,true,35,37,72,155,148,303,11,10,21,2,3:18
448828,2016-08-29,2016,BAL,TOR,1,5,5-1,TOR,9,false,32,37,69,152,134,286,6,11,17,1,2:35
448819,2016-08-29,2016,COL,LAN,8,1,8-1,COL,9,true,39,39,78,152,173,325,15,13,28,1,3:36
448820,2016-08-29,2016,NYN,MIA,2,1,2-1,NYN,10,false,39,41,80,182,173,355,12,12,24,1,3:30
448817,2016-08-29,2016,DET,CHA,4,3,4-3,DET,9,true,36,39,75,164,130,294,13,13,26,4,3:20
448822,2016-08-29,2016,KCA,NYA,8,5,8-5,KCA,9,true,36,41,77,148,155,303,13,13,26,5,3:17
448826,2016-08-29,2016,MIL,SLN,5,6,6-5,SLN,9,false,40,44,84,171,171,342,14,17,31,3,3:24
448824,2016-08-29,2016,CHN,PIT,8,7,8-7,CHN,13,false,59,56,115,205,260,465,26,19,45,1,5:03
448843,2016-08-30,2016,BAL,TOR,5,3,5-3,BAL,9,true,35,34,69,139,129,268,11,9,20,2,2:34
448844,2016-08-30,2016,PHI,WAS,2,3,3-2,WAS,9,false,30,36,66,139,114,253,5,10,15,0,2:42
448842,2016-08-30,2016,BOS,TBA,3,4,4-3,TBA,9,false,35,37,72,141,158,299,10,11,21,1,3:11
448839,2016-08-30,2016,ATL,SDN,7,3,7-3,ATL,9,true,40,34,74,124,149,273,19,7,26,1,2:55
448835,2016-08-30,2016,CLE,MIN,5,4,5-4,CLE,9,true,38,39,77,148,145,293,18,13,31,6,3:10
448834,2016-08-30,2016,NYN,MIA,7,4,7-4,NYN,9,true,41,38,79,145,142,287,19,12,31,2,3:04
448830,2016-08-30,2016,SFN,ARI,3,4,4-3,ARI,9,false,39,38,77,148,155,303,13,13,26,2,3:18
448832,2016-08-30,2016,ANA,CIN,4,2,4-2,ANA,9,true,33,38,71,138,118,256,11,12,23,3,2:56
448838,2016-08-30,2016,CHN,PIT,3,0,3-0,CHN,9,true,32,30,62,136,137,273,9,5,14,0,2:36
448837,2016-08-30,2016,HOU,OAK,3,1,3-1,HOU,9,true,29,33,62,139,114,253,6,6,12,0,2:28
448841,2016-08-30,2016,MIL,SLN,1,2,2-1,SLN,10,false,38,37,75,139,157,296,9,9,18,1,3:08
448831,2016-08-30,2016,DET,CHA,8,4,8-4,DET,9,true,40,38,78,159,163,322,16,12,28,2,3:13
448840,2016-08-30,2016,TEX,SEA,8,7,8-7,TEX,9,false,41,43,84,152,157,309,18,16,34,3,3:23
448836,2016-08-30,2016,KCA,NYA,4,5,5-4,NYA,10,false,41,48,89,180,168,348,13,18,31,6,4:07 (:59 delay)
448850,2016-08-31,2016,CLE,MIN,8,4,8-4,CLE,9,true,39,37,76,136,133,269,17,11,28,2,2:45
448859,2016-08-31,2016,PHI,WAS,1,2,2-1,WAS,9,false,30,34,64,151,135,286,4,7,11,3,2:50
448849,2016-08-31,2016,NYN,MIA,5,2,5-2,NYN,9,true,36,35,71,126,140,266,14,7,21,1,2:46
448857,2016-08-31,2016,BOS,TBA,8,6,8-6,BOS,9,true,38,41,79,157,144,301,15,17,32,2,3:10
448847,2016-08-31,2016,ANA,CIN,3,0,3-0,ANA,9,true,31,30,61,94,102,196,8,4,12,0,2:10
448856,2016-08-31,2016,MIL,SLN,3,1,3-1,MIL,9,true,30,34,64,133,116,249,6,6,12,1,2:33
448846,2016-08-31,2016,DET,CHA,3,2,3-2,DET,9,false,36,32,68,139,118,257,13,5,18,0,2:46
448852,2016-08-31,2016,HOU,OAK,4,3,4-3,HOU,9,true,33,38,71,152,134,286,10,10,20,0,2:43
448845,2016-08-31,2016,SFN,ARI,4,2,4-2,SFN,9,true,37,38,75,158,141,299,13,12,25,4,3:33
448848,2016-08-31,2016,COL,LAN,7,0,7-0,COL,9,true,38,34,72,134,138,272,16,8,24,1,2:55
448858,2016-08-31,2016,BAL,TOR,3,5,5-3,TOR,9,false,39,35,74,145,164,309,12,12,24,1,3:12
448854,2016-08-31,2016,ATL,SDN,8,1,8-1,ATL,9,true,41,35,76,153,176,329,21,8,29,2,3:22
448855,2016-08-31,2016,TEX,SEA,14,1,14-1,TEX,9,true,42,37,79,141,165,306,19,11,30,1,3:01
448833,2016-08-31,2016,COL,LAN,8,10,10-8,LAN,9,false,40,45,85,176,159,335,16,18,34,1,3:36
448833,2016-08-31,2016,COL,LAN,8,10,10-8,LAN,9,false,40,45,85,176,159,335,16,18,34,1,3:36
448853,2016-08-31,2016,CHN,PIT,6,5,6-5,CHN,9,true,38,44,82,205,143,348,14,17,31,3,3:48
448851,2016-08-31,2016,KCA,NYA,4,5,5-4,NYA,13,false,49,55,104,216,182,398,11,17,28,5,4:19
448862,2016-09-01,2016,ATL,SDN,9,6,9-6,ATL,9,true,40,35,75,135,135,270,16,8,24,2,2:48
448861,2016-09-01,2016,NYN,MIA,4,6,6-4,MIA,9,false,39,42,81,166,162,328,14,15,29,2,3:25
448863,2016-09-01,2016,CHN,SFN,5,4,5-4,CHN,9,true,37,33,70,111,166,277,14,7,21,3,2:54
448860,2016-09-01,2016,MIN,CHA,8,5,8-5,MIN,9,true,34,45,79,176,139,315,11,19,30,1,3:13
448875,2016-09-02,2016,CHN,SFN,2,1,2-1,CHN,9,true,33,32,65,102,145,247,11,5,16,2,2:37
448876,2016-09-02,2016,CIN,SLN,3,2,3-2,CIN,9,false,42,34,76,122,173,295,18,8,26,1,2:57
448872,2016-09-02,2016,PIT,MIL,0,1,1-0,MIL,9,false,35,35,70,134,145,279,11,9,20,1,3:01
448873,2016-09-02,2016,BAL,NYA,8,0,8-0,BAL,9,true,37,32,69,129,162,291,13,6,19,2,2:52
448871,2016-09-02,2016,CLE,MIA,6,2,6-2,CLE,9,true,39,36,75,137,150,287,15,9,24,1,2:49
448865,2016-09-02,2016,PHI,ATL,4,8,8-4,ATL,9,false,38,44,82,179,148,327,11,18,29,1,3:28
448877,2016-09-02,2016,TBA,TOR,8,3,8-3,TBA,9,true,38,37,75,156,149,305,12,10,22,2,2:52
448874,2016-09-02,2016,LAN,SDN,2,4,4-2,SDN,9,false,40,39,79,164,167,331,14,14,28,4,3:32
448864,2016-09-02,2016,COL,ARI,14,7,14-7,COL,9,true,44,40,84,142,152,294,21,15,36,2,3:11
448869,2016-09-02,2016,TEX,HOU,10,8,10-8,TEX,9,true,41,41,82,167,151,318,19,13,32,7,3:15
448868,2016-09-02,2016,KCA,DET,6,7,7-6,DET,9,false,41,41,82,146,159,305,13,15,28,3,3:28
448870,2016-09-02,2016,SEA,ANA,11,8,11-8,SEA,9,true,45,39,84,164,185,349,21,14,35,3,3:25
448866,2016-09-02,2016,OAK,BOS,2,16,16-2,BOS,9,false,35,51,86,211,134,345,9,23,32,3,3:27
448867,2016-09-02,2016,MIN,CHA,4,11,11-4,CHA,9,false,34,50,84,199,104,303,10,25,35,2,2:59
448878,2016-09-02,2016,NYN,WAS,1,4,4-1,WAS,9,false,35,36,71,151,153,304,8,9,17,3,3:07
448889,2016-09-03,2016,LAN,SDN,5,1,5-1,LAN,9,true,33,34,67,141,109,250,12,7,19,0,2:35
448886,2016-09-03,2016,CLE,MIA,8,3,8-3,CLE,9,true,42,32,74,108,153,261,18,7,25,2,2:38
448888,2016-09-03,2016,BAL,NYA,2,0,2-0,BAL,9,true,35,32,67,154,149,303,13,7,20,0,3:02
448885,2016-09-03,2016,SEA,ANA,3,10,10-3,ANA,9,false,37,44,81,164,133,297,11,18,29,1,2:54
448890,2016-09-03,2016,CHN,SFN,2,3,3-2,SFN,9,false,38,34,72,140,151,291,11,6,17,3,3:13
448883,2016-09-03,2016,KCA,DET,5,2,5-2,KCA,9,true,37,41,78,164,139,303,14,16,30,3,3:14
448891,2016-09-03,2016,CIN,SLN,9,1,9-1,CIN,9,true,44,36,80,132,149,281,23,13,36,3,3:10
448879,2016-09-03,2016,COL,ARI,4,9,9-4,ARI,9,false,37,42,79,149,150,299,12,16,28,3,3:11
448892,2016-09-03,2016,TBA,TOR,7,5,7-5,TBA,9,true,38,39,77,173,148,321,16,12,28,4,3:06
448884,2016-09-03,2016,TEX,HOU,12,4,12-4,TEX,9,true,42,39,81,162,151,313,20,15,35,4,3:27
448893,2016-09-03,2016,NYN,WAS,3,1,3-1,NYN,9,true,34,37,71,135,144,279,12,10,22,5,3:13
448882,2016-09-03,2016,MIN,CHA,11,3,11-3,MIN,9,true,42,35,77,144,179,323,18,8,26,2,3:12
448880,2016-09-03,2016,PHI,ATL,4,6,6-4,ATL,10,false,39,44,83,152,176,328,8,15,23,0,3:27
448887,2016-09-03,2016,PIT,MIL,4,7,7-4,MIL,9,false,40,44,84,146,162,308,16,18,34,5,3:45
448881,2016-09-03,2016,OAK,BOS,2,11,11-2,BOS,9,false,31,49,80,201,121,322,5,21,26,1,3:00
448896,2016-09-04,2016,OAK,BOS,1,0,1-0,OAK,9,false,31,36,67,152,116,268,6,9,15,1,2:39
448904,2016-09-04,2016,LAN,SDN,7,4,7-4,LAN,9,true,38,34,72,137,160,297,15,9,24,2,3:09
448899,2016-09-04,2016,TEX,HOU,6,7,7-6,HOU,9,false,41,44,85,153,147,300,15,17,32,1,3:22
448898,2016-09-04,2016,KCA,DET,5,6,6-5,DET,9,false,37,39,76,145,159,304,12,14,26,3,3:19
448907,2016-09-04,2016,TBA,TOR,3,5,5-3,TOR,9,false,37,40,77,172,176,348,10,14,24,3,3:18
448901,2016-09-04,2016,CLE,MIA,6,5,6-5,CLE,9,false,42,40,82,156,178,334,17,13,30,4,3:43
448905,2016-09-04,2016,CHN,SFN,3,2,3-2,CHN,13,false,51,48,99,181,186,367,16,9,25,5,4:23
448895,2016-09-04,2016,PHI,ATL,0,2,2-0,ATL,9,false,36,41,77,141,151,292,9,17,26,0,3:14
448902,2016-09-04,2016,PIT,MIL,0,10,10-0,MIL,9,false,32,42,74,161,131,292,7,16,23,0,3:10
448908,2016-09-04,2016,NYN,WAS,5,1,5-1,NYN,9,true,33,37,70,141,143,284,10,10,20,2,2:59
448894,2016-09-04,2016,COL,ARI,5,8,8-5,ARI,9,false,39,39,78,139,163,302,13,15,28,2,3:20
448900,2016-09-04,2016,SEA,ANA,2,4,4-2,ANA,9,false,35,35,70,115,146,261,10,12,22,1,3:00
448897,2016-09-04,2016,MIN,CHA,11,13,13-11,CHA,12,false,61,58,119,219,249,468,25,20,45,5,4:46
448906,2016-09-04,2016,CIN,SLN,2,5,5-2,SLN,9,false,39,37,76,153,146,299,16,9,25,1,2:56
448903,2016-09-04,2016,BAL,NYA,2,5,5-2,NYA,9,false,38,38,76,163,159,322,11,14,25,4,3:17
448920,2016-09-05,2016,COL,SFN,6,0,6-0,COL,9,true,35,29,64,103,140,243,12,2,14,1,2:24
448919,2016-09-05,2016,MIA,PHI,2,6,6-2,PHI,9,false,33,37,70,145,131,276,7,12,19,1,2:54
448912,2016-09-05,2016,SDN,BOS,2,1,2-1,SDN,9,true,31,34,65,141,134,275,8,9,17,1,3:01
448923,2016-09-05,2016,NYA,TOR,5,3,5-3,NYA,9,true,33,38,71,151,120,271,10,13,23,3,2:49
448913,2016-09-05,2016,MIL,CHN,2,7,7-2,CHN,9,false,33,41,74,139,138,277,8,14,22,3,2:51
448911,2016-09-05,2016,TBA,BAL,3,7,7-3,BAL,9,false,31,38,69,144,114,258,4,11,15,0,2:35
448909,2016-09-05,2016,LAN,ARI,10,2,10-2,LAN,9,true,38,34,72,142,165,307,14,7,21,2,3:12
448918,2016-09-05,2016,CIN,NYN,0,5,5-0,NYN,9,false,34,36,70,153,146,299,9,12,21,2,3:05
448910,2016-09-05,2016,WAS,ATL,6,4,6-4,WAS,9,true,35,42,77,142,139,281,13,14,27,0,2:59
448917,2016-09-05,2016,OAK,ANA,7,10,10-7,ANA,9,false,45,46,91,165,183,348,18,20,38,2,3:44
448921,2016-09-05,2016,PIT,SLN,6,12,12-6,SLN,9,false,39,49,88,180,145,325,13,21,34,0,3:25
448916,2016-09-05,2016,MIN,KCA,5,11,11-5,KCA,9,false,42,46,88,180,147,327,16,21,37,5,3:24
448915,2016-09-05,2016,CLE,HOU,2,6,6-2,HOU,9,false,36,44,80,192,151,343,10,19,29,6,3:44
448922,2016-09-05,2016,SEA,TEX,14,6,14-6,SEA,9,true,48,38,86,143,209,352,25,12,37,4,3:32
448914,2016-09-05,2016,CHA,DET,3,5,5-3,DET,11,false,45,45,90,175,180,355,12,13,25,1,3:56
448929,2016-09-06,2016,CHA,DET,2,0,2-0,CHA,9,true,32,36,68,134,137,271,11,10,21,2,2:54
448935,2016-09-06,2016,COL,SFN,2,3,3-2,SFN,9,false,33,35,68,137,132,269,7,10,17,4,3:02
448934,2016-09-06,2016,MIA,PHI,3,4,4-3,PHI,9,false,37,42,79,151,148,299,11,16,27,2,3:00
448928,2016-09-06,2016,MIL,CHN,12,5,12-5,MIL,9,true,42,37,79,127,137,264,20,10,30,2,2:49
448930,2016-09-06,2016,CLE,HOU,3,4,4-3,HOU,9,false,36,38,74,152,156,308,9,11,20,2,3:03
448933,2016-09-06,2016,CIN,NYN,3,5,5-3,NYN,9,false,36,39,75,162,140,302,9,14,23,2,3:08
448931,2016-09-06,2016,MIN,KCA,3,10,10-3,KCA,9,false,35,42,77,167,129,296,9,16,25,6,3:07
448926,2016-09-06,2016,TBA,BAL,2,11,11-2,BAL,9,false,37,49,86,189,142,331,10,21,31,0,3:08
448932,2016-09-06,2016,OAK,ANA,3,2,3-2,OAK,9,true,31,31,62,113,113,226,8,6,14,1,2:14
448924,2016-09-06,2016,LAN,ARI,5,2,5-2,LAN,9,true,35,32,67,115,139,254,13,5,18,2,2:49
448927,2016-09-06,2016,SDN,BOS,1,5,5-1,BOS,9,false,36,40,76,162,119,281,9,16,25,2,3:04
448938,2016-09-06,2016,NYA,TOR,7,6,7-6,NYA,9,true,35,44,79,198,113,311,11,19,30,7,3:21
448925,2016-09-06,2016,WAS,ATL,9,7,9-7,WAS,9,true,41,36,77,151,176,327,17,11,28,6,3:38
448936,2016-09-06,2016,PIT,SLN,7,9,9-7,SLN,9,false,42,44,86,161,184,345,14,17,31,2,3:36
448937,2016-09-06,2016,SEA,TEX,7,10,10-7,TEX,9,false,44,52,96,213,152,365,16,24,40,5,3:44
448943,2016-09-07,2016,MIL,CHN,2,1,2-1,MIL,9,true,31,31,62,124,143,267,11,5,16,2,2:54
448953,2016-09-07,2016,NYA,TOR,2,0,2-0,NYA,9,true,35,33,68,143,133,276,12,8,20,1,2:48
448947,2016-09-07,2016,OAK,ANA,4,1,4-1,OAK,9,true,42,30,72,141,166,307,17,4,21,2,3:11
448945,2016-09-07,2016,CLE,HOU,6,5,6-5,CLE,9,true,40,39,79,135,147,282,18,13,31,4,3:06
448950,2016-09-07,2016,COL,SFN,6,5,6-5,COL,9,false,36,40,76,135,154,289,13,15,28,5,3:16
448946,2016-09-07,2016,MIN,KCA,6,5,6-5,MIN,9,true,38,38,76,158,141,299,13,14,27,2,3:08
448949,2016-09-07,2016,MIA,PHI,6,0,6-0,MIA,9,true,36,34,70,168,109,277,14,9,23,2,2:52
448952,2016-09-07,2016,SEA,TEX,8,3,8-3,SEA,9,true,36,36,72,134,148,282,13,11,24,1,2:30
448940,2016-09-07,2016,WAS,ATL,5,4,5-4,WAS,11,false,50,49,99,209,189,398,22,18,40,8,4:39 (:57 delay)
448944,2016-09-07,2016,CHA,DET,7,4,7-4,CHA,9,true,40,36,76,144,150,294,16,13,29,3,3:18 (:45 delay)
448939,2016-09-07,2016,LAN,ARI,3,1,3-1,LAN,9,true,32,39,71,149,123,272,8,13,21,6,3:05
448942,2016-09-07,2016,SDN,BOS,2,7,7-2,BOS,9,false,35,40,75,151,128,279,8,13,21,2,3:01
448951,2016-09-07,2016,PIT,SLN,4,3,4-3,PIT,9,true,35,37,72,161,139,300,12,12,24,1,3:01
448941,2016-09-07,2016,TBA,BAL,7,6,7-6,TBA,9,true,41,41,82,163,182,345,17,14,31,3,3:25
448948,2016-09-07,2016,CIN,NYN,3,6,6-3,NYN,9,false,42,43,85,153,165,318,18,16,34,3,3:29
448956,2016-09-08,2016,CLE,HOU,10,7,10-7,CLE,9,true,38,38,76,142,168,310,16,12,28,4,3:14 (:55 delay)
448954,2016-09-08,2016,PIT,CIN,4,1,4-1,PIT,9,true,41,32,73,94,148,242,20,6,26,0,2:28
448959,2016-09-08,2016,NYA,TBA,5,4,5-4,NYA,9,false,35,40,75,151,127,278,11,14,25,4,3:21
448958,2016-09-08,2016,WAS,PHI,1,4,4-1,PHI,9,false,35,35,70,133,123,256,7,8,15,1,2:48
448960,2016-09-08,2016,SEA,TEX,6,3,6-3,SEA,9,true,37,37,74,163,158,321,16,11,27,3,3:22
448957,2016-09-08,2016,SLN,MIL,5,12,12-5,MIL,9,false,39,46,85,167,140,307,14,22,36,2,3:15
448955,2016-09-08,2016,SDN,COL,14,1,14-1,SDN,9,true,45,37,82,153,198,351,19,11,30,2,3:26
448966,2016-09-09,2016,SDN,COL,1,4,4-1,COL,9,false,33,36,69,143,132,275,8,11,19,2,2:38
448963,2016-09-09,2016,HOU,CHN,0,2,2-0,CHN,9,false,31,36,67,134,123,257,7,9,16,1,2:34
448969,2016-09-09,2016,SLN,MIL,4,3,4-3,SLN,9,true,32,36,68,130,117,247,10,13,23,1,2:34
448961,2016-09-09,2016,DET,BAL,4,3,4-3,DET,9,true,34,33,67,135,147,282,14,7,21,0,2:54
448964,2016-09-09,2016,PIT,CIN,3,4,4-3,CIN,9,false,38,38,76,130,132,262,18,14,32,1,3:01
448965,2016-09-09,2016,MIN,CLE,4,5,5-4,CLE,9,false,36,44,80,152,148,300,10,15,25,2,3:07
448967,2016-09-09,2016,CHA,KCA,7,2,7-2,CHA,9,true,38,39,77,163,138,301,15,10,25,3,3:11
448970,2016-09-09,2016,ATL,NYN,4,6,6-4,NYN,9,false,42,39,81,156,158,314,18,13,31,2,3:17
448973,2016-09-09,2016,OAK,SEA,2,3,3-2,SEA,9,false,34,36,70,158,135,293,8,9,17,1,2:59
448974,2016-09-09,2016,NYA,TBA,7,5,7-5,NYA,9,true,42,42,84,143,203,346,20,16,36,6,3:30 (1:34 delay)
448975,2016-09-09,2016,ANA,TEX,1,2,2-1,TEX,9,false,34,38,72,137,124,261,7,12,19,3,3:22
448968,2016-09-09,2016,MIA,LAN,4,1,4-1,MIA,9,true,35,37,72,143,145,288,11,10,21,4,3:08
448971,2016-09-09,2016,WAS,PHI,5,4,5-4,WAS,9,false,37,38,75,170,140,310,12,13,25,4,3:31
448962,2016-09-09,2016,TOR,BOS,3,13,13-3,BOS,9,false,38,49,87,196,157,353,11,23,34,4,3:23
448972,2016-09-09,2016,ARI,SFN,6,7,7-6,SFN,12,false,51,55,106,242,229,471,17,22,39,7,5:23
448984,2016-09-10,2016,SLN,MIL,5,1,5-1,SLN,9,true,33,34,67,118,127,245,12,11,23,2,2:39
448977,2016-09-10,2016,TOR,BOS,3,2,3-2,TOR,9,true,34,35,69,138,136,274,9,7,16,1,3:03
448986,2016-09-10,2016,WAS,PHI,3,0,3-0,WAS,9,true,33,34,67,150,122,272,10,8,18,4,3:05
448976,2016-09-10,2016,DET,BAL,3,11,11-3,BAL,9,false,39,46,85,189,150,339,12,19,31,1,3:05 (:11 delay)
448989,2016-09-10,2016,NYA,TBA,5,1,5-1,NYA,9,true,32,34,66,119,114,233,7,8,15,2,2:34 (:28 delay)
448978,2016-09-10,2016,HOU,CHN,2,1,2-1,HOU,9,true,32,33,65,159,118,277,9,8,17,0,2:54
448981,2016-09-10,2016,SDN,COL,6,3,6-3,SDN,9,true,35,34,69,139,123,262,11,6,17,1,2:37
448983,2016-09-10,2016,MIA,LAN,0,5,5-0,LAN,9,false,30,36,66,145,131,276,2,11,13,2,2:52
448985,2016-09-10,2016,ATL,NYN,4,3,4-3,ATL,10,false,38,40,78,160,139,299,10,13,23,3,3:24
448988,2016-09-10,2016,OAK,SEA,3,14,14-3,SEA,9,false,38,46,84,185,138,323,11,23,34,2,3:03
448980,2016-09-10,2016,MIN,CLE,2,1,2-1,MIN,12,false,47,47,94,154,176,330,13,13,26,5,3:38
448990,2016-09-10,2016,ANA,TEX,5,8,8-5,TEX,9,false,40,43,83,164,150,314,13,16,29,4,3:40
448982,2016-09-10,2016,CHA,KCA,5,6,6-5,KCA,9,false,41,38,79,152,158,310,16,12,28,3,3:33
448987,2016-09-10,2016,ARI,SFN,3,11,11-3,SFN,9,false,33,49,82,177,130,307,8,25,33,1,3:09
448979,2016-09-10,2016,PIT,CIN,7,8,8-7,CIN,9,false,44,44,88,173,164,337,18,19,37,1,3:36
449001,2016-09-11,2016,WAS,PHI,3,2,3-2,WAS,9,true,30,34,64,129,125,254,7,9,16,4,2:49
448996,2016-09-11,2016,SDN,COL,2,3,3-2,COL,10,false,39,37,76,119,148,267,9,8,17,2,3:03
449003,2016-09-11,2016,OAK,SEA,2,3,3-2,SEA,9,false,34,39,73,159,131,290,11,14,25,2,2:52
448994,2016-09-11,2016,PIT,CIN,0,8,8-0,CIN,9,false,37,42,79,146,129,275,12,19,31,1,2:56
448993,2016-09-11,2016,HOU,CHN,5,9,9-5,CHN,9,false,36,41,77,162,129,291,11,14,25,3,3:07
449002,2016-09-11,2016,ARI,SFN,3,5,5-3,SFN,9,false,38,39,77,160,136,296,12,14,26,4,3:19
449000,2016-09-11,2016,ATL,NYN,3,10,10-3,NYN,9,false,36,42,78,151,120,271,13,16,29,3,2:56
448998,2016-09-11,2016,MIA,LAN,3,0,3-0,MIA,9,true,33,30,63,110,127,237,12,4,16,1,2:26
448999,2016-09-11,2016,SLN,MIL,1,2,2-1,MIL,9,false,34,32,66,146,114,260,6,5,11,1,2:33
449004,2016-09-11,2016,NYA,TBA,2,4,4-2,TBA,9,false,35,37,72,138,141,279,8,10,18,2,2:58
448997,2016-09-11,2016,CHA,KCA,0,2,2-0,KCA,9,false,32,38,70,132,155,287,7,12,19,0,2:59
449005,2016-09-11,2016,ANA,TEX,3,2,3-2,ANA,9,true,32,33,65,124,116,240,10,7,17,2,2:31
448991,2016-09-11,2016,DET,BAL,1,3,3-1,BAL,9,false,35,37,72,164,152,316,9,13,22,0,3:23
448992,2016-09-11,2016,TOR,BOS,8,11,11-8,BOS,9,false,42,44,86,169,168,337,15,18,33,9,3:46
448995,2016-09-11,2016,MIN,CLE,1,7,7-1,CLE,9,false,37,45,82,194,138,332,9,19,28,4,3:13
449017,2016-09-12,2016,SFN,SDN,0,4,4-0,SDN,9,false,35,36,71,132,129,261,8,11,19,2,2:54
449007,2016-09-12,2016,SLN,CHN,1,4,4-1,CHN,9,false,30,36,66,130,112,242,4,11,15,2,2:17
449006,2016-09-12,2016,BOS,BAL,12,2,12-2,BOS,9,true,42,30,72,108,148,256,19,3,22,2,2:40
449010,2016-09-12,2016,NYA,LAN,2,8,8-2,LAN,9,false,36,41,77,161,159,320,9,14,23,3,3:13
449014,2016-09-12,2016,WAS,NYN,8,1,8-1,WAS,9,true,40,37,77,137,154,291,18,10,28,4,3:08
449016,2016-09-12,2016,PHI,PIT,6,2,6-2,PHI,9,true,39,35,74,151,166,317,17,8,25,1,3:18
449009,2016-09-12,2016,ARI,COL,12,9,12-9,ARI,9,true,43,43,86,172,159,331,19,16,35,3,3:42
449019,2016-09-12,2016,TOR,TBA,3,2,3-2,TOR,9,true,31,34,65,117,110,227,7,6,13,1,2:13
449013,2016-09-12,2016,DET,MIN,4,2,4-2,DET,9,true,34,38,72,158,149,307,10,12,22,3,3:04
449018,2016-09-12,2016,ANA,SEA,1,8,8-1,SEA,9,false,35,42,77,165,140,305,9,14,23,2,3:08
449012,2016-09-12,2016,CIN,MIL,3,0,3-0,CIN,9,true,31,35,66,139,130,269,8,9,17,1,2:32
449008,2016-09-12,2016,CHA,CLE,11,4,11-4,CHA,9,true,44,37,81,142,178,320,19,10,29,6,3:30
449015,2016-09-12,2016,KCA,OAK,3,16,16-3,OAK,9,false,35,52,87,210,136,346,9,27,36,4,3:23
449020,2016-09-12,2016,HOU,TEX,3,4,4-3,TEX,12,false,46,45,91,170,185,355,12,13,25,1,3:48
449011,2016-09-12,2016,ATL,MIA,12,7,12-7,ATL,9,true,46,46,92,162,169,331,23,21,44,6,3:35
449035,2016-09-13,2016,HOU,TEX,2,3,3-2,TEX,9,false,30,36,66,127,112,239,5,9,14,0,2:23
449027,2016-09-13,2016,CIN,MIL,6,4,6-4,CIN,9,true,35,34,69,124,130,254,11,7,18,0,2:35
449022,2016-09-13,2016,SLN,CHN,4,2,4-2,SLN,9,true,34,39,73,162,121,283,11,12,23,2,2:51
449023,2016-09-13,2016,CHA,CLE,8,1,8-1,CHA,9,true,37,34,71,124,124,248,13,8,21,2,2:37
449031,2016-09-13,2016,PHI,PIT,3,5,5-3,PIT,9,false,36,39,75,155,138,293,10,16,26,3,3:12
449033,2016-09-13,2016,ANA,SEA,0,8,8-0,SEA,9,false,30,40,70,154,113,267,3,13,16,1,2:37
449025,2016-09-13,2016,NYA,LAN,3,0,3-0,NYA,9,true,34,33,67,131,143,274,13,6,19,4,3:02
449021,2016-09-13,2016,BOS,BAL,3,6,6-3,BAL,9,false,39,41,80,174,134,308,13,15,28,7,3:29
449030,2016-09-13,2016,KCA,OAK,4,5,5-4,OAK,9,false,39,34,73,128,150,278,12,8,20,3,2:56
449029,2016-09-13,2016,WAS,NYN,3,4,4-3,NYN,10,false,39,44,83,150,155,305,9,15,24,2,3:22
449026,2016-09-13,2016,ATL,MIA,5,7,7-5,MIA,9,false,40,41,81,138,160,298,14,15,29,5,3:24
449028,2016-09-13,2016,DET,MIN,1,8,8-1,MIN,9,false,35,43,78,157,125,282,9,18,27,1,2:48
449024,2016-09-13,2016,ARI,COL,11,4,11-4,ARI,9,true,48,37,85,151,186,337,26,10,36,3,3:28
449034,2016-09-13,2016,TOR,TBA,2,6,6-2,TBA,9,false,36,39,75,152,159,311,11,15,26,6,3:10
449032,2016-09-13,2016,SFN,SDN,4,6,6-4,SDN,9,false,41,42,83,160,136,296,17,17,34,2,3:27
449048,2016-09-14,2016,ANA,SEA,1,2,2-1,SEA,9,false,34,34,68,121,120,241,8,7,15,3,3:01
449044,2016-09-14,2016,WAS,NYN,1,0,1-0,WAS,9,true,29,33,62,123,108,231,9,8,17,1,2:30
449038,2016-09-14,2016,CHA,CLE,1,6,6-1,CLE,9,false,33,39,72,145,122,267,6,13,19,2,2:48
449047,2016-09-14,2016,SFN,SDN,1,3,3-1,SDN,9,false,31,39,70,140,122,262,6,12,18,4,2:51
449043,2016-09-14,2016,DET,MIN,9,6,9-6,DET,9,true,39,35,74,124,156,280,14,8,22,2,2:54
449036,2016-09-14,2016,BOS,BAL,0,1,1-0,BAL,9,false,32,31,63,126,135,261,5,5,10,0,2:35
449049,2016-09-14,2016,TOR,TBA,1,8,8-1,TBA,9,false,34,43,77,174,133,307,6,16,22,5,2:58
449040,2016-09-14,2016,NYA,LAN,0,2,2-0,LAN,9,false,33,34,67,151,132,283,5,6,11,1,2:57 (1:00 delay)
449046,2016-09-14,2016,PHI,PIT,6,2,6-2,PHI,9,true,39,37,76,146,120,266,15,15,30,4,2:57
449042,2016-09-14,2016,CIN,MIL,0,7,7-0,MIL,9,false,34,39,73,176,120,296,9,12,21,0,3:01
449045,2016-09-14,2016,KCA,OAK,0,8,8-0,OAK,9,false,33,48,81,200,119,319,7,21,28,2,2:56
449041,2016-09-14,2016,ATL,MIA,5,7,7-5,MIA,9,false,36,37,73,140,139,279,12,11,23,4,3:04
449037,2016-09-14,2016,SLN,CHN,0,7,7-0,CHN,9,false,29,40,69,157,121,278,4,14,18,0,2:37
449050,2016-09-14,2016,HOU,TEX,8,4,8-4,HOU,9,true,37,38,75,157,148,305,16,10,26,4,3:08
449039,2016-09-14,2016,ARI,COL,11,6,11-6,ARI,9,true,47,42,89,176,190,366,22,17,39,7,3:49
449058,2016-09-15,2016,SFN,SLN,6,2,6-2,SFN,9,true,39,33,72,105,134,239,17,6,23,2,2:33
449052,2016-09-15,2016,ARI,LAN,7,3,7-3,ARI,9,true,33,37,70,119,143,262,9,11,20,2,2:39
449054,2016-09-15,2016,DET,MIN,1,5,5-1,MIN,9,false,37,38,75,148,151,299,12,14,26,3,3:04
449056,2016-09-15,2016,KCA,OAK,5,14,14-5,OAK,9,false,37,49,86,202,127,329,10,21,31,2,3:19
449059,2016-09-15,2016,BAL,TBA,6,7,7-6,TBA,9,false,41,41,82,163,160,323,14,15,29,4,3:27
449057,2016-09-15,2016,PHI,PIT,2,15,15-2,PIT,9,false,32,43,75,178,118,296,5,16,21,2,2:54
449053,2016-09-15,2016,CHN,MIL,4,5,5-4,MIL,9,false,40,36,76,136,161,297,15,9,24,2,3:10
449051,2016-09-15,2016,CHA,CLE,2,1,2-1,CHA,9,false,35,37,72,150,167,317,12,10,22,3,3:12
449060,2016-09-15,2016,ANA,TOR,2,7,7-2,TOR,9,false,37,40,77,178,133,311,9,16,25,3,3:15
449055,2016-09-15,2016,BOS,NYA,7,5,7-5,BOS,9,false,41,44,85,171,149,320,15,18,33,3,3:52
449067,2016-09-16,2016,NYN,MIN,3,0,3-0,NYN,9,true,35,33,68,124,137,261,12,7,19,1,2:41
449073,2016-09-16,2016,BAL,TBA,5,4,5-4,BAL,9,true,38,35,73,124,151,275,14,10,24,2,2:44
449068,2016-09-16,2016,BOS,NYA,7,4,7-4,BOS,9,true,35,39,74,151,122,273,16,14,30,5,3:13
449061,2016-09-16,2016,KCA,CHA,4,7,7-4,CHA,9,false,35,41,76,173,119,292,8,15,23,1,3:00
449075,2016-09-16,2016,ATL,WAS,2,7,7-2,WAS,9,false,38,40,78,158,135,293,11,17,28,3,3:14
449064,2016-09-16,2016,ARI,LAN,2,3,3-2,LAN,9,false,40,35,75,144,174,318,13,10,23,3,3:32
449074,2016-09-16,2016,ANA,TOR,0,5,5-0,TOR,9,false,40,41,81,160,141,301,13,17,30,4,3:15
449072,2016-09-16,2016,SFN,SLN,8,2,8-2,SFN,9,true,37,38,75,154,131,285,13,12,25,2,2:57
449071,2016-09-16,2016,COL,SDN,8,7,8-7,COL,9,false,43,39,82,146,174,320,17,14,31,4,3:31 (:38 delay)
449062,2016-09-16,2016,CLE,DET,11,4,11-4,CLE,9,true,42,37,79,134,180,314,20,10,30,1,3:31
449070,2016-09-16,2016,CIN,PIT,7,9,9-7,PIT,10,false,41,48,89,192,163,355,11,20,31,3,3:55 (:31 delay)
449069,2016-09-16,2016,TEX,OAK,7,6,7-6,TEX,9,false,42,39,81,147,138,285,16,13,29,1,3:02
449065,2016-09-16,2016,PHI,MIA,4,3,4-3,PHI,13,false,53,57,110,216,207,423,19,19,38,4,4:43
449063,2016-09-16,2016,SEA,HOU,0,6,6-0,HOU,9,false,32,42,74,164,132,296,6,14,20,2,2:58
449066,2016-09-16,2016,CHN,MIL,5,4,5-4,CHN,10,false,39,40,79,139,143,282,16,12,28,2,3:13
447363,2016-09-17,2016,CIN,PIT,4,10,10-4,PIT,9,false,39,48,87,196,144,340,13,22,35,1,3:20 (1:02 delay)
449078,2016-09-17,2016,SEA,HOU,1,2,2-1,HOU,9,false,34,33,67,118,142,260,8,7,15,0,2:33
449086,2016-09-17,2016,COL,SDN,8,0,8-0,COL,9,true,38,31,69,113,153,266,15,4,19,2,2:53
449079,2016-09-17,2016,ARI,LAN,2,6,6-2,LAN,9,false,34,41,75,149,135,284,7,16,23,4,3:12
447363,2016-09-17,2016,CIN,PIT,4,10,10-4,PIT,9,false,39,48,87,196,144,340,13,22,35,1,3:20 (1:02 delay)
449082,2016-09-17,2016,NYN,MIN,3,2,3-2,NYN,12,false,49,50,99,213,191,404,16,14,30,3,4:15
449080,2016-09-17,2016,PHI,MIA,8,0,8-0,PHI,9,true,40,30,70,106,144,250,17,5,22,1,2:42
449089,2016-09-17,2016,ANA,TOR,6,1,6-1,ANA,9,true,34,40,74,162,117,279,10,14,24,3,3:08
449076,2016-09-17,2016,KCA,CHA,3,2,3-2,KCA,9,true,31,37,68,141,105,246,8,9,17,1,2:36
449088,2016-09-17,2016,BAL,TBA,2,5,5-2,TBA,9,false,33,38,71,157,114,271,8,10,18,3,3:00
449087,2016-09-17,2016,SFN,SLN,2,3,3-2,SLN,9,false,36,36,72,148,122,270,10,12,22,4,2:53
449083,2016-09-17,2016,BOS,NYA,6,5,6-5,BOS,9,true,37,37,74,165,138,303,14,11,25,5,3:36
449081,2016-09-17,2016,CHN,MIL,3,11,11-3,MIL,9,false,36,41,77,159,146,305,11,15,26,0,3:02
449084,2016-09-17,2016,TEX,OAK,2,11,11-2,OAK,9,false,33,44,77,159,119,278,7,17,24,2,2:52
449077,2016-09-17,2016,CLE,DET,1,0,1-0,CLE,10,false,41,36,77,158,174,332,15,9,24,3,3:53 (:10 delay)
449090,2016-09-17,2016,ATL,WAS,7,3,7-3,ATL,9,true,38,38,76,173,155,328,17,11,28,1,3:26
449085,2016-09-17,2016,CIN,PIT,3,7,7-3,PIT,9,false,34,47,81,197,144,341,9,20,29,3,3:29
449102,2016-09-18,2016,SFN,SLN,0,3,3-0,SLN,9,false,34,33,67,117,114,231,7,10,17,4,2:49
449105,2016-09-18,2016,ATL,WAS,6,2,6-2,ATL,7,false,35,27,62,98,141,239,18,8,26,4,2:36 (2:57 delay)
449096,2016-09-18,2016,CHN,MIL,1,3,3-1,MIL,9,false,39,35,74,130,134,264,12,8,20,1,2:37
449091,2016-09-18,2016,KCA,CHA,10,3,10-3,KCA,9,true,40,38,78,137,129,266,17,13,30,1,3:04
449100,2016-09-18,2016,CIN,PIT,7,4,7-4,CIN,9,true,40,38,78,155,131,286,16,11,27,0,2:52
449099,2016-09-18,2016,TEX,OAK,2,5,5-2,OAK,9,false,38,40,78,142,152,294,13,14,27,4,3:11
449103,2016-09-18,2016,BAL,TBA,2,1,2-1,BAL,9,true,34,35,69,150,143,293,9,10,19,1,3:01
449104,2016-09-18,2016,ANA,TOR,4,0,4-0,ANA,9,true,39,34,73,145,146,291,14,9,23,3,3:25
449101,2016-09-18,2016,COL,SDN,6,3,6-3,COL,9,true,40,35,75,147,159,306,16,9,25,3,3:20
449092,2016-09-18,2016,CLE,DET,5,9,9-5,DET,9,false,35,44,79,159,147,306,8,19,27,3,3:38
449095,2016-09-18,2016,PHI,MIA,4,5,5-4,MIA,9,false,38,38,76,144,162,306,13,11,24,3,3:16
449097,2016-09-18,2016,NYN,MIN,3,2,3-2,NYN,9,true,32,37,69,153,113,266,10,10,20,4,2:58
449098,2016-09-18,2016,BOS,NYA,5,4,5-4,BOS,9,true,37,40,77,138,156,294,13,13,26,4,3:31
449093,2016-09-18,2016,SEA,HOU,7,3,7-3,SEA,9,true,38,33,71,127,138,265,16,7,23,4,2:33
449094,2016-09-18,2016,ARI,LAN,10,9,10-9,ARI,12,false,59,53,112,209,206,415,26,17,43,7,4:29
447572,2016-09-19,2016,KCA,CHA,8,3,8-3,KCA,9,true,39,36,75,106,152,258,15,10,25,1,2:35
449110,2016-09-19,2016,OAK,HOU,2,4,4-2,HOU,9,false,32,35,67,129,124,253,6,10,16,4,2:41
449113,2016-09-19,2016,COL,SLN,3,5,5-3,SLN,9,false,40,38,78,115,171,286,13,12,25,2,3:01
449112,2016-09-19,2016,LAN,SFN,2,1,2-1,LAN,9,false,32,30,62,117,136,253,8,4,12,4,2:58
449106,2016-09-19,2016,SDN,ARI,3,2,3-2,SDN,9,true,34,34,68,126,142,268,11,9,20,2,2:46
449111,2016-09-19,2016,TEX,ANA,3,2,3-2,TEX,9,false,38,34,72,104,155,259,17,6,23,2,3:00 (:38 delay)
449108,2016-09-19,2016,BAL,BOS,2,5,5-2,BOS,9,false,32,37,69,152,89,241,5,12,17,3,2:33
449115,2016-09-19,2016,MIA,WAS,4,3,4-3,MIA,9,true,34,34,68,124,153,277,10,9,19,2,2:50
447572,2016-09-19,2016,KCA,CHA,8,3,8-3,KCA,9,true,39,36,75,106,152,258,15,10,25,1,2:35
449109,2016-09-19,2016,CHN,CIN,5,2,5-2,CHN,9,true,34,35,69,140,120,260,10,8,18,1,2:42
449114,2016-09-19,2016,SEA,TOR,2,3,3-2,TOR,9,false,35,39,74,160,143,303,8,13,21,4,3:03
449107,2016-09-19,2016,NYN,ATL,3,7,7-3,ATL,9,false,37,44,81,189,142,331,10,17,27,2,3:11
449130,2016-09-20,2016,MIA,WAS,1,0,1-0,MIA,9,true,30,31,61,127,98,225,6,4,10,0,2:11
449118,2016-09-20,2016,BAL,BOS,2,5,5-2,BOS,9,false,35,39,74,141,134,275,8,12,20,5,3:14
449120,2016-09-20,2016,CHN,CIN,6,1,6-1,CHN,9,true,40,36,76,128,172,300,18,10,28,1,2:58
449119,2016-09-20,2016,PHI,CHA,7,6,7-6,PHI,9,true,38,38,76,164,137,301,15,15,30,2,3:20
449128,2016-09-20,2016,COL,SLN,5,10,10-5,SLN,9,false,39,46,85,167,144,311,14,20,34,3,3:21
449117,2016-09-20,2016,NYN,ATL,4,5,5-4,ATL,9,false,39,40,79,159,153,312,12,15,27,5,3:28
449121,2016-09-20,2016,MIN,DET,1,8,8-1,DET,9,false,31,41,72,159,118,277,5,14,19,1,2:46
449116,2016-09-20,2016,SDN,ARI,5,2,5-2,SDN,9,true,34,33,67,129,150,279,13,6,19,1,2:57 (1:10 delay)
449123,2016-09-20,2016,CLE,KCA,2,1,2-1,CLE,9,false,36,32,68,120,137,257,9,6,15,4,2:45
449122,2016-09-20,2016,OAK,HOU,1,2,2-1,HOU,10,false,37,39,76,135,151,286,8,11,19,1,3:01
449125,2016-09-20,2016,TBA,NYA,3,5,5-3,NYA,9,false,34,41,75,145,148,293,6,15,21,2,2:49
449126,2016-09-20,2016,MIL,PIT,3,6,6-3,PIT,9,false,36,39,75,158,149,307,10,15,25,3,3:08
449127,2016-09-20,2016,LAN,SFN,0,2,2-0,SFN,9,false,37,38,75,163,145,308,11,14,25,3,3:36
449129,2016-09-20,2016,SEA,TOR,2,10,10-2,TOR,9,false,37,44,81,179,164,343,10,19,29,2,3:33
449124,2016-09-20,2016,TEX,ANA,5,4,5-4,TEX,9,true,38,42,80,164,144,308,17,18,35,4,3:22
449135,2016-09-21,2016,CHN,CIN,9,2,9-2,CHN,9,true,45,34,79,113,182,295,22,8,30,4,3:12
449140,2016-09-21,2016,TBA,NYA,5,11,11-5,NYA,9,false,36,47,83,168,147,315,10,20,30,3,3:06
449142,2016-09-21,2016,LAN,SFN,9,3,9-3,LAN,9,true,37,36,73,153,140,293,15,9,24,1,3:03
449139,2016-09-21,2016,TEX,ANA,4,5,5-4,ANA,9,false,37,38,75,128,130,258,11,12,23,2,2:46
449134,2016-09-21,2016,PHI,CHA,8,3,8-3,PHI,9,true,40,35,75,121,145,266,17,10,27,1,2:43
449131,2016-09-21,2016,SDN,ARI,2,3,3-2,ARI,9,false,36,31,67,116,160,276,11,6,17,2,2:50
449133,2016-09-21,2016,BAL,BOS,1,5,5-1,BOS,9,false,34,37,71,155,113,268,6,10,16,4,2:55
449138,2016-09-21,2016,CLE,KCA,4,3,4-3,CLE,9,true,38,35,73,149,164,313,18,10,28,4,3:20
449143,2016-09-21,2016,COL,SLN,11,1,11-1,COL,9,true,38,38,76,148,132,280,15,11,26,1,2:43
449141,2016-09-21,2016,MIL,PIT,1,4,4-1,PIT,9,false,34,38,72,128,142,270,8,11,19,0,2:51
449137,2016-09-21,2016,OAK,HOU,5,6,6-5,HOU,9,false,38,39,77,144,162,306,11,12,23,5,3:13
449132,2016-09-21,2016,NYN,ATL,3,4,4-3,ATL,9,false,39,38,77,136,147,283,15,11,26,5,3:17
449145,2016-09-21,2016,MIA,WAS,3,8,8-3,WAS,9,false,33,39,72,179,135,314,6,12,18,2,3:10
449144,2016-09-21,2016,SEA,TOR,2,1,2-1,SEA,12,false,48,45,93,203,208,411,13,12,25,6,4:23
449147,2016-09-22,2016,BAL,BOS,3,5,5-3,BOS,9,false,36,42,78,185,126,311,9,16,25,2,3:19
449136,2016-09-22,2016,MIN,DET,2,9,9-2,DET,9,false,34,41,75,165,148,313,8,17,25,3,3:09
449155,2016-09-22,2016,SDN,SFN,1,2,2-1,SFN,9,false,33,36,69,124,139,263,6,9,15,2,2:55
449152,2016-09-22,2016,TBA,NYA,2,0,2-0,TBA,9,true,30,38,68,147,118,265,9,11,20,1,2:37
449154,2016-09-22,2016,MIL,PIT,3,1,3-1,MIL,9,true,30,33,63,132,124,256,7,8,15,2,2:39
449150,2016-09-22,2016,CLE,KCA,5,2,5-2,CLE,9,true,33,34,67,138,135,273,11,8,19,1,2:40
449151,2016-09-22,2016,HOU,ANA,0,2,2-0,ANA,9,false,32,34,66,135,130,265,9,8,17,1,2:41
449136,2016-09-22,2016,MIN,DET,2,9,9-2,DET,9,false,34,41,75,165,148,313,8,17,25,3,3:09
449149,2016-09-22,2016,MIN,DET,2,4,4-2,DET,9,false,35,36,71,149,167,316,9,10,19,0,3:10
449148,2016-09-22,2016,LAN,COL,7,4,7-4,LAN,9,true,39,34,73,116,152,268,17,8,25,2,2:56
449146,2016-09-22,2016,MIA,ATL,3,6,6-3,ATL,9,false,37,37,74,152,142,294,11,11,22,1,2:46
449153,2016-09-22,2016,NYN,PHI,9,8,9-8,NYN,11,false,47,50,97,214,195,409,16,19,35,7,4:23
449169,2016-09-23,2016,OAK,TEX,0,3,3-0,TEX,9,false,34,32,66,97,144,241,10,5,15,0,2:19
449160,2016-09-23,2016,MIL,CIN,5,4,5-4,MIL,9,true,35,36,71,127,130,257,12,9,21,3,2:48
449158,2016-09-23,2016,TBA,BOS,1,2,2-1,BOS,9,false,34,40,74,151,142,293,9,15,24,3,2:52
449168,2016-09-23,2016,CHN,SLN,5,0,5-0,CHN,9,true,39,30,69,127,167,294,15,7,22,4,2:53
449159,2016-09-23,2016,CLE,CHA,10,4,10-4,CLE,9,true,42,34,76,125,166,291,17,9,26,4,3:02
449162,2016-09-23,2016,DET,KCA,8,3,8-3,DET,9,true,41,38,79,143,167,310,16,12,28,2,3:10
449157,2016-09-23,2016,MIA,ATL,2,3,3-2,ATL,9,false,33,39,72,169,147,316,7,16,23,1,3:08
449163,2016-09-23,2016,HOU,ANA,6,10,10-6,ANA,9,false,38,45,83,179,137,316,13,20,33,4,3:24
449167,2016-09-23,2016,MIN,SEA,1,10,10-1,SEA,9,false,32,47,79,209,122,331,6,20,26,3,3:04 (:36 delay)
449165,2016-09-23,2016,NYN,PHI,10,5,10-5,NYN,9,true,39,42,81,169,150,319,14,15,29,6,3:40
449166,2016-09-23,2016,SDN,SFN,7,2,7-2,SDN,9,true,34,36,70,137,123,260,12,9,21,3,2:54
449170,2016-09-23,2016,PIT,WAS,6,5,6-5,PIT,11,false,51,50,101,198,205,403,20,16,36,6,4:36
449164,2016-09-23,2016,TOR,NYA,9,0,9-0,TOR,9,true,42,33,75,137,158,295,21,6,27,1,3:06
449161,2016-09-23,2016,LAN,COL,5,2,5-2,LAN,9,true,38,36,74,151,179,330,16,10,26,1,3:39 (:37 delay)
449156,2016-09-23,2016,BAL,ARI,3,2,3-2,BAL,12,false,50,45,95,184,186,370,17,11,28,2,4:00
449172,2016-09-24,2016,MIA,ATL,6,4,6-4,MIA,9,true,39,37,76,141,160,301,17,11,28,2,3:21
449174,2016-09-24,2016,CLE,CHA,1,8,8-1,CHA,9,false,37,43,80,179,148,327,12,16,28,3,3:28
449182,2016-09-24,2016,MIN,SEA,3,2,3-2,MIN,9,true,28,33,61,110,87,197,4,5,9,0,2:06
449181,2016-09-24,2016,SDN,SFN,6,9,9-6,SFN,10,false,39,48,87,173,150,323,9,16,25,4,3:43
449177,2016-09-24,2016,DET,KCA,4,7,7-4,KCA,9,false,45,41,86,157,183,340,19,13,32,4,3:50
449171,2016-09-24,2016,BAL,ARI,6,1,6-1,BAL,9,true,38,34,72,118,149,267,16,7,23,2,2:36
449184,2016-09-24,2016,OAK,TEX,0,5,5-0,TEX,9,false,35,37,72,124,145,269,8,10,18,2,2:58
449179,2016-09-24,2016,TOR,NYA,3,0,3-0,TOR,9,true,33,30,63,139,117,256,11,6,17,0,2:34
449173,2016-09-24,2016,TBA,BOS,4,6,6-4,BOS,9,false,38,35,73,135,158,293,12,10,22,5,3:10
449175,2016-09-24,2016,MIL,CIN,1,6,6-1,CIN,9,false,34,42,76,154,137,291,8,19,27,1,3:01
449185,2016-09-24,2016,PIT,WAS,1,6,6-1,WAS,9,false,39,43,82,161,156,317,12,16,28,3,3:28
449178,2016-09-24,2016,HOU,ANA,4,10,10-4,ANA,9,false,39,43,82,174,153,327,13,17,30,5,3:32
449176,2016-09-24,2016,LAN,COL,14,1,14-1,LAN,9,true,47,32,79,120,196,316,23,6,29,2,3:04
449183,2016-09-24,2016,CHN,SLN,4,10,10-4,SLN,9,false,37,45,82,177,155,332,11,19,30,3,3:19
449180,2016-09-24,2016,NYN,PHI,8,10,10-8,PHI,9,false,44,47,91,187,185,372,17,23,40,2,3:47
449199,2016-09-25,2016,OAK,TEX,7,1,7-1,OAK,9,true,38,31,69,106,127,233,16,5,21,2,2:31
449193,2016-09-25,2016,HOU,ANA,4,1,4-1,HOU,9,true,30,34,64,134,122,256,11,9,20,0,2:23
449189,2016-09-25,2016,CLE,CHA,0,3,3-0,CHA,9,false,32,36,68,153,120,273,5,8,13,2,2:46
449190,2016-09-25,2016,MIL,CIN,2,4,4-2,CIN,9,false,33,35,68,120,136,256,7,11,18,0,2:41
449186,2016-09-25,2016,BAL,ARI,2,1,2-1,BAL,9,true,31,35,66,154,132,286,8,8,16,0,2:43
449198,2016-09-25,2016,CHN,SLN,3,1,3-1,CHN,9,true,36,35,71,146,142,288,15,8,23,3,3:09
449197,2016-09-25,2016,MIN,SEA,3,4,4-3,SEA,9,false,38,37,75,148,142,290,13,9,22,3,3:03
449196,2016-09-25,2016,SDN,SFN,4,3,4-3,SDN,9,true,34,37,71,128,155,283,13,10,23,4,3:05
449191,2016-09-25,2016,LAN,COL,4,3,4-3,LAN,10,false,44,38,82,157,153,310,15,11,26,4,3:33
449192,2016-09-25,2016,DET,KCA,9,12,12-9,KCA,9,false,48,46,94,173,184,357,22,20,42,3,3:51
449200,2016-09-25,2016,PIT,WAS,7,10,10-7,WAS,9,false,38,46,84,186,168,354,12,21,33,6,4:01
449188,2016-09-25,2016,TBA,BOS,2,3,3-2,BOS,10,false,40,41,81,210,184,394,11,14,25,4,4:01
449194,2016-09-25,2016,TOR,NYA,4,3,4-3,TOR,9,false,39,37,76,146,167,313,16,10,26,2,3:19
449195,2016-09-25,2016,NYN,PHI,17,0,17-0,NYN,9,true,50,32,82,133,201,334,27,5,32,3,3:32
449208,2016-09-26,2016,ANA,OAK,2,1,2-1,ANA,9,true,32,32,64,142,113,255,10,6,16,0,2:35
449205,2016-09-26,2016,TEX,MIL,3,8,8-3,MIL,9,false,36,38,74,118,144,262,9,13,22,1,2:51
449210,2016-09-26,2016,CHA,TBA,7,1,7-1,CHA,9,true,37,38,75,150,151,301,13,14,27,2,3:04
449207,2016-09-26,2016,TOR,NYA,5,7,7-5,NYA,9,false,42,40,82,134,159,293,16,14,30,7,3:22
449204,2016-09-26,2016,DET,CLE,4,7,7-4,CLE,9,false,38,42,80,158,148,306,13,14,27,2,3:25
449203,2016-09-26,2016,SLN,CIN,2,15,15-2,CIN,9,false,32,51,83,172,106,278,6,25,31,2,2:48
449201,2016-09-26,2016,WAS,ARI,4,14,14-4,ARI,9,false,38,44,82,168,161,329,14,16,30,2,3:21 (:20 delay)
449202,2016-09-26,2016,PIT,CHN,2,12,12-2,CHN,9,false,38,52,90,233,159,392,11,25,36,2,3:34
449206,2016-09-26,2016,MIA,NYN,7,3,7-3,MIA,9,true,40,40,80,172,154,326,17,13,30,4,3:28
449209,2016-09-26,2016,HOU,SEA,3,4,4-3,SEA,11,false,42,51,93,189,178,367,12,20,32,0,3:52
449211,2016-09-27,2016,WAS,ARI,4,2,4-2,WAS,9,true,30,35,65,128,112,240,6,8,14,1,2:40
449212,2016-09-27,2016,TOR,BAL,5,1,5-1,TOR,9,true,34,37,71,136,132,268,12,11,23,0,2:39
449213,2016-09-27,2016,NYA,BOS,6,4,6-4,NYA,9,true,35,39,74,146,100,246,15,13,28,4,3:09
449222,2016-09-27,2016,ANA,OAK,8,1,8-1,ANA,9,true,35,33,68,130,120,250,13,9,22,1,2:34
449224,2016-09-27,2016,HOU,SEA,8,4,8-4,HOU,9,true,37,37,74,143,116,259,14,12,26,3,2:55
449216,2016-09-27,2016,DET,CLE,12,0,12-0,DET,9,true,41,31,72,122,161,283,23,5,28,2,3:01
449218,2016-09-27,2016,SDN,LAN,7,1,7-1,SDN,9,true,33,38,71,156,131,287,10,11,21,2,3:02
449219,2016-09-27,2016,TEX,MIL,6,4,6-4,TEX,9,true,36,40,76,158,136,294,13,15,28,2,3:10
449225,2016-09-27,2016,CHA,TBA,13,6,13-6,CHA,9,true,44,40,84,139,168,307,19,12,31,1,2:57
449217,2016-09-27,2016,SFN,COL,12,3,12-3,SFN,9,true,45,36,81,128,160,288,23,9,32,3,3:05
449223,2016-09-27,2016,ATL,PHI,7,6,7-6,ATL,9,true,37,45,82,165,141,306,14,20,34,3,3:02 (2:24 delay)
449215,2016-09-27,2016,SLN,CIN,12,5,12-5,SLN,9,true,41,41,82,149,184,333,18,14,32,2,3:17
449214,2016-09-27,2016,PIT,CHN,4,6,6-4,CHN,9,false,42,44,86,190,185,375,17,16,33,4,3:49
449220,2016-09-27,2016,KCA,MIN,4,3,4-3,KCA,11,false,40,46,86,198,162,360,14,15,29,6,3:45
449221,2016-09-27,2016,MIA,NYN,1,12,12-1,NYN,9,false,33,51,84,184,132,316,7,27,34,5,3:20
449226,2016-09-28,2016,WAS,ARI,0,3,3-0,ARI,6,true,19,26,45,112,74,186,6,12,18,1,1:55 (1:42 delay)
449240,2016-09-28,2016,CHA,TBA,1,0,1-0,CHA,9,true,31,29,60,103,121,224,8,3,11,2,2:10 (1:37 delay)
449232,2016-09-28,2016,SFN,COL,0,2,2-0,COL,9,false,30,36,66,141,124,265,7,11,18,3,2:55
449234,2016-09-28,2016,TEX,MIL,8,5,8-5,TEX,9,true,38,35,73,129,143,272,13,11,24,1,2:59
449227,2016-09-28,2016,TOR,BAL,2,3,3-2,BAL,9,false,37,38,75,151,147,298,12,12,24,4,3:04
449230,2016-09-28,2016,SLN,CIN,1,2,2-1,CIN,9,false,36,39,75,166,121,287,11,10,21,2,2:48
449238,2016-09-28,2016,ATL,PHI,12,2,12-2,ATL,9,true,41,34,75,137,135,272,18,8,26,1,2:45
449233,2016-09-28,2016,SDN,LAN,6,5,6-5,SDN,9,true,33,36,69,121,141,262,12,10,22,2,2:45
449229,2016-09-28,2016,PIT,CHN,8,4,8-4,PIT,9,true,39,37,76,149,152,301,16,9,25,3,3:05
449237,2016-09-28,2016,ANA,OAK,8,6,8-6,ANA,9,true,41,38,79,157,158,315,15,11,26,2,3:18
449235,2016-09-28,2016,KCA,MIN,5,2,5-2,KCA,9,true,35,37,72,164,133,297,12,11,23,4,2:58
449231,2016-09-28,2016,DET,CLE,6,3,6-3,DET,5,false,24,26,50,114,96,210,10,12,22,1,2:02 (1:57 delay)
449228,2016-09-28,2016,NYA,BOS,5,3,5-3,NYA,9,false,34,39,73,144,162,306,9,16,25,3,3:28
449239,2016-09-28,2016,HOU,SEA,4,12,12-4,SEA,9,false,39,48,87,179,140,319,13,24,37,3,3:12
449236,2016-09-28,2016,MIA,NYN,2,5,5-2,NYN,9,false,37,42,79,156,143,299,11,15,26,2,2:57
449244,2016-09-29,2016,PIT,CHN,1,1,1-1,CHN,6,true,19,20,39,57,71,128,4,4,8,1,1:15 (1:23 delay)
449242,2016-09-29,2016,TOR,BAL,0,4,4-0,BAL,9,false,32,38,70,121,143,264,6,11,17,3,2:35
449250,2016-09-29,2016,SEA,OAK,3,2,3-2,SEA,9,true,37,35,72,127,152,279,14,9,23,4,2:54
449243,2016-09-29,2016,NYA,BOS,5,1,5-1,NYA,9,true,39,31,70,124,163,287,15,6,21,4,3:17
449241,2016-09-29,2016,WAS,ARI,5,3,5-3,WAS,9,true,35,36,71,156,117,273,11,9,20,3,2:55
449247,2016-09-29,2016,SFN,COL,7,2,7-2,SFN,9,true,41,37,78,143,143,286,17,12,29,5,3:15
449251,2016-09-29,2016,ATL,PHI,5,2,5-2,ATL,9,true,37,36,73,146,158,304,15,10,25,5,3:18
449252,2016-09-29,2016,CHA,TBA,3,5,5-3,TBA,9,false,35,41,76,171,140,311,10,16,26,2,3:15 (:35 delay)
449249,2016-09-29,2016,KCA,MIN,6,7,7-6,MIN,9,false,40,42,82,162,137,299,16,16,32,4,3:16
449245,2016-09-29,2016,SLN,CIN,4,3,4-3,SLN,9,false,39,40,79,171,140,311,13,15,28,1,3:16
449248,2016-09-29,2016,SDN,LAN,4,9,9-4,LAN,9,false,42,44,86,159,163,322,16,17,33,2,3:38
449263,2016-09-30,2016,SEA,OAK,5,1,5-1,SEA,9,true,32,33,65,144,122,266,8,7,15,1,2:35
449266,2016-09-30,2016,TEX,TBA,3,1,3-1,TEX,9,true,34,35,69,142,131,273,11,6,17,3,3:00
449260,2016-09-30,2016,COL,MIL,4,1,4-1,COL,9,true,31,38,69,139,111,250,10,14,24,1,2:30
449254,2016-09-30,2016,CIN,CHN,3,7,7-3,CHN,9,false,33,37,70,143,133,276,6,12,18,2,2:39
449265,2016-09-30,2016,ARI,SDN,5,3,5-3,ARI,9,true,31,39,70,148,119,267,8,12,20,2,2:51
449255,2016-09-30,2016,KCA,CLE,2,7,7-2,CLE,9,false,31,40,71,159,110,269,5,15,20,2,2:36
449261,2016-09-30,2016,CHA,MIN,7,3,7-3,CHA,9,true,38,36,74,139,167,306,14,11,25,3,2:56
449257,2016-09-30,2016,ANA,HOU,7,1,7-1,ANA,9,true,34,35,69,135,139,274,10,10,20,1,2:40
449264,2016-09-30,2016,SLN,PIT,7,0,7-0,SLN,9,true,36,33,69,123,143,266,13,6,19,1,2:42 (:47 delay)
449256,2016-09-30,2016,ATL,DET,2,6,6-2,DET,9,false,36,42,78,153,155,308,9,15,24,3,3:21
449253,2016-09-30,2016,NYA,BAL,1,8,8-1,BAL,9,false,36,46,82,182,155,337,9,18,27,1,3:26
449262,2016-09-30,2016,PHI,NYN,1,5,5-1,NYN,9,false,36,37,73,161,129,290,10,10,20,2,2:53
449259,2016-09-30,2016,WAS,MIA,4,7,7-4,MIA,9,false,36,44,80,141,153,294,10,17,27,3,3:08 (1:43 delay)
449258,2016-09-30,2016,SFN,LAN,9,3,9-3,SFN,9,true,43,35,78,128,170,298,19,10,29,3,3:15
449267,2016-09-30,2016,BOS,TOR,5,3,5-3,BOS,9,true,37,43,80,160,165,325,12,16,28,2,3:25
449273,2016-10-01,2016,SFN,LAN,3,0,3-0,SFN,9,true,34,30,64,110,107,217,10,4,14,0,2:15
449281,2016-10-01,2016,TEX,TBA,1,4,4-1,TBA,9,false,33,35,68,124,135,259,5,7,12,1,2:39
449276,2016-10-01,2016,CHA,MIN,0,6,6-0,MIN,9,false,33,36,69,138,141,279,7,8,15,1,2:32
449279,2016-10-01,2016,SLN,PIT,4,3,4-3,SLN,9,true,35,36,71,153,131,284,13,9,22,2,3:12
449280,2016-10-01,2016,ARI,SDN,9,5,9-5,ARI,9,true,35,39,74,137,127,264,14,12,26,3,2:46
449272,2016-10-01,2016,ANA,HOU,0,3,3-0,HOU,9,false,34,41,75,161,123,284,7,15,22,2,2:55
449268,2016-10-01,2016,NYA,BAL,7,3,7-3,NYA,9,true,38,38,76,140,160,300,16,13,29,4,2:54
449274,2016-10-01,2016,WAS,MIA,2,1,2-1,WAS,9,true,32,35,67,164,119,283,11,10,21,3,3:03
449282,2016-10-01,2016,BOS,TOR,3,4,4-3,TOR,9,false,37,37,74,171,149,320,11,11,22,3,3:29
449271,2016-10-01,2016,ATL,DET,5,3,5-3,ATL,9,true,35,36,71,135,122,257,11,10,21,3,2:51
449277,2016-10-01,2016,PHI,NYN,3,5,5-3,NYN,9,false,35,39,74,149,133,282,9,15,24,2,3:01
449269,2016-10-01,2016,CIN,CHN,7,4,7-4,CIN,9,true,39,36,75,147,180,327,16,11,27,0,3:08
449270,2016-10-01,2016,KCA,CLE,3,6,6-3,CLE,9,false,38,43,81,177,150,327,11,17,28,2,3:22
449275,2016-10-01,2016,COL,MIL,3,4,4-3,MIL,10,false,42,41,83,156,160,316,14,12,26,1,3:26
449278,2016-10-01,2016,SEA,OAK,8,9,9-8,OAK,10,false,50,47,97,162,201,363,20,19,39,5,4:01
449286,2016-10-02,2016,ATL,DET,1,0,1-0,ATL,9,true,30,32,62,132,119,251,8,6,14,0,2:47
449285,2016-10-02,2016,KCA,CLE,2,3,3-2,CLE,9,false,32,35,67,129,110,239,7,8,15,2,2:26
449295,2016-10-02,2016,ARI,SDN,3,2,3-2,ARI,9,false,36,34,70,120,116,236,12,7,19,1,2:37
449292,2016-10-02,2016,PHI,NYN,5,2,5-2,PHI,9,true,36,35,71,144,106,250,12,10,22,3,2:39
449283,2016-10-02,2016,NYA,BAL,2,5,5-2,BAL,9,false,37,33,70,127,126,253,11,8,19,2,2:32
449293,2016-10-02,2016,SEA,OAK,2,3,3-2,OAK,9,false,33,35,68,132,137,269,7,11,18,0,2:34
449287,2016-10-02,2016,ANA,HOU,8,1,8-1,ANA,9,true,39,34,73,120,151,271,15,8,23,2,2:42
449297,2016-10-02,2016,BOS,TOR,1,2,2-1,TOR,9,false,34,38,72,150,139,289,8,13,21,3,3:14
449294,2016-10-02,2016,SLN,PIT,10,4,10-4,SLN,9,true,42,39,81,138,158,296,16,13,29,2,3:12
449291,2016-10-02,2016,CHA,MIN,3,6,6-3,MIN,9,false,38,41,79,163,155,318,11,14,25,2,3:01
449288,2016-10-02,2016,SFN,LAN,7,1,7-1,SFN,9,true,43,32,75,120,165,285,21,6,27,2,3:04
449289,2016-10-02,2016,WAS,MIA,10,7,10-7,WAS,9,true,41,42,83,164,152,316,19,19,38,4,3:36
449290,2016-10-02,2016,COL,MIL,4,6,6-4,MIL,10,false,46,44,90,160,162,322,17,15,32,2,3:23
449284,2016-10-02,2016,CIN,CHN,4,7,7-4,CHN,9,false,36,44,80,200,156,356,10,18,28,2,3:18
449296,2016-10-02,2016,TEX,TBA,4,6,6-4,TBA,10,false,46,46,92,186,202,388,17,16,33,2,4:00