API Key,Date,Year,Home Team,Away Team,Home Score,Away Score,Final Score,Winning Team,# Innings,End Top Inning?,Home Team PA #,Away Team PA #,Total Number PA,Homne Team # Pitches,Away Team # Pitches,Total # Pitches,Home Team Baserunners,Away Team Baserunners,Total # Baserunners,Pitching Changes,Time
490106,2017-04-02,2017,TBA,NYA,7,3,7-3,TBA,9,true,40,39,79,143,141,284,16,11,27,3,3:21
490110,2017-04-02,2017,ARI,SFN,6,5,6-5,ARI,9,false,38,41,79,168,124,292,13,16,29,3,3:23
490099,2017-04-02,2017,SLN,CHN,4,3,4-3,SLN,9,false,44,36,80,143,194,337,20,10,30,2,3:33
490111,2017-04-03,2017,HOU,SEA,3,0,3-0,HOU,9,true,30,34,64,122,104,226,7,8,15,1,2:29
490105,2017-04-03,2017,WAS,MIA,4,2,4-2,WAS,9,true,34,33,67,110,145,255,12,6,18,1,2:47
490103,2017-04-03,2017,MIN,KCA,7,1,7-1,MIN,9,true,39,30,69,117,149,266,16,5,21,2,2:47
490108,2017-04-03,2017,BOS,PIT,5,3,5-3,BOS,9,true,35,38,73,144,133,277,12,11,23,2,3:03
490109,2017-04-03,2017,LAN,SDN,14,3,14-3,LAN,9,true,44,33,77,115,146,261,23,5,28,2,2:52
490104,2017-04-03,2017,OAK,ANA,4,2,4-2,OAK,9,true,37,36,73,154,138,292,15,12,27,2,2:56
490107,2017-04-03,2017,CIN,PHI,3,4,4-3,PHI,9,false,37,40,77,170,117,287,12,16,28,2,3:04
490098,2017-04-03,2017,NYN,ATL,6,0,6-0,NYN,9,true,39,33,72,133,155,288,15,7,22,3,3:13
490101,2017-04-03,2017,MIL,COL,5,7,7-5,COL,9,false,38,37,75,146,155,301,14,13,27,2,3:26
490100,2017-04-03,2017,TEX,CLE,5,8,8-5,CLE,9,false,37,40,77,151,155,306,11,14,25,3,3:21
490112,2017-04-03,2017,BAL,TOR,3,2,3-2,BAL,11,false,41,48,89,179,152,331,11,17,28,4,3:41
490119,2017-04-04,2017,HOU,SEA,2,1,2-1,HOU,9,true,29,38,67,129,110,239,8,10,18,1,2:41
490136,2017-04-04,2017,SLN,CHN,1,2,2-1,CHN,9,false,34,38,72,128,130,258,8,11,19,0,2:57
490117,2017-04-04,2017,LAN,SDN,0,4,4-0,SDN,9,false,30,37,67,148,110,258,7,13,20,0,2:44
490115,2017-04-04,2017,OAK,ANA,6,7,7-6,ANA,9,false,37,37,74,136,174,310,12,12,24,1,3:17
490116,2017-04-04,2017,TBA,NYA,0,5,5-0,NYA,9,false,35,39,74,159,153,312,8,12,20,1,3:07
490102,2017-04-04,2017,CHA,DET,3,6,6-3,DET,9,false,37,39,76,158,153,311,11,13,24,4,3:30
490114,2017-04-04,2017,MIL,COL,5,6,6-5,COL,9,false,36,43,79,166,152,318,11,21,32,3,3:34
490118,2017-04-04,2017,ARI,SFN,4,8,8-4,SFN,9,false,38,48,86,183,154,337,11,19,30,2,3:26
490102,2017-04-04,2017,CHA,DET,3,6,6-3,DET,9,false,37,39,76,158,153,311,11,13,24,4,3:30
490113,2017-04-04,2017,TEX,CLE,3,4,4-3,CLE,9,false,34,37,71,148,121,269,9,13,22,4,3:14
490129,2017-04-05,2017,CIN,PHI,2,0,2-0,CIN,9,true,29,32,61,133,99,232,6,5,11,1,2:25 (:50 delay)
490131,2017-04-05,2017,LAN,SDN,3,1,3-1,LAN,9,true,34,32,66,116,142,258,10,7,17,2,2:43
490128,2017-04-05,2017,TBA,NYA,4,1,4-1,TBA,9,true,33,35,68,148,134,282,10,10,20,4,3:17
490127,2017-04-05,2017,WAS,MIA,6,4,6-4,WAS,9,true,36,39,75,154,149,303,15,14,29,3,3:06
490125,2017-04-05,2017,MIN,KCA,9,1,9-1,MIN,9,true,40,33,73,142,173,315,17,8,25,4,3:06
490122,2017-04-05,2017,TEX,CLE,6,9,9-6,CLE,9,false,37,40,77,153,154,307,12,14,26,4,3:25
490132,2017-04-05,2017,ARI,SFN,8,6,8-6,ARI,9,true,40,39,79,150,152,302,16,12,28,4,3:15
490130,2017-04-05,2017,BOS,PIT,3,0,3-0,BOS,12,false,45,42,87,184,169,353,14,6,20,1,3:53
490120,2017-04-05,2017,NYN,ATL,1,3,3-1,ATL,12,false,43,50,93,203,161,364,9,17,26,2,3:51
490126,2017-04-05,2017,OAK,ANA,0,5,5-0,ANA,9,false,34,40,74,147,145,292,7,16,23,3,3:15
490134,2017-04-05,2017,BAL,TOR,3,1,3-1,BAL,9,true,29,34,63,138,97,235,5,8,13,0,2:23
490133,2017-04-05,2017,HOU,SEA,5,3,5-3,HOU,13,false,55,53,108,206,216,422,16,14,30,5,4:25
490123,2017-04-05,2017,MIL,COL,6,1,6-1,MIL,9,true,31,37,68,173,132,305,11,12,23,1,3:03
490121,2017-04-06,2017,SLN,CHN,4,6,6-4,CHN,9,false,38,42,80,167,152,319,10,14,24,3,3:18
490142,2017-04-06,2017,CIN,PHI,7,4,7-4,CIN,9,true,38,36,74,162,133,295,15,12,27,1,3:05
490144,2017-04-06,2017,LAN,SDN,10,2,10-2,LAN,9,true,44,35,79,132,175,307,20,8,28,2,3:14
490141,2017-04-06,2017,WAS,MIA,3,4,4-3,MIA,10,false,42,44,86,163,150,313,17,19,36,1,3:26 (2:23 delay)
490146,2017-04-06,2017,HOU,SEA,2,4,4-2,SEA,9,false,36,38,74,143,139,282,11,12,23,1,2:57
490139,2017-04-06,2017,MIN,KCA,5,3,5-3,MIN,9,true,40,39,79,145,154,299,17,14,31,4,3:14
490135,2017-04-06,2017,NYN,ATL,6,2,6-2,NYN,9,true,34,32,66,113,115,228,11,6,17,1,2:28
490147,2017-04-06,2017,TBA,TOR,2,5,5-2,TOR,9,false,34,37,71,138,122,260,11,10,21,3,2:56
490140,2017-04-06,2017,OAK,ANA,5,1,5-1,OAK,9,true,33,35,68,141,124,265,9,8,17,2,2:44
490121,2017-04-06,2017,SLN,CHN,4,6,6-4,CHN,9,false,38,42,80,167,152,319,10,14,24,3,3:18
490137,2017-04-06,2017,MIL,COL,1,2,2-1,COL,9,false,36,34,70,133,162,295,11,7,18,1,3:07
490145,2017-04-06,2017,ARI,SFN,9,3,9-3,ARI,9,true,39,36,75,158,141,299,16,9,25,3,3:00
490138,2017-04-06,2017,CHA,DET,11,2,11-2,CHA,9,true,42,36,78,166,177,343,17,10,27,2,3:31
490151,2017-04-07,2017,SLN,CIN,0,2,2-0,CIN,9,false,31,35,66,116,120,236,5,10,15,0,2:17
490156,2017-04-07,2017,CHA,MIN,1,3,3-1,MIN,9,false,36,36,72,126,138,264,9,9,18,1,2:59
490159,2017-04-07,2017,SDN,SFN,7,6,7-6,SDN,9,true,40,35,75,136,143,279,15,10,25,3,2:58
490153,2017-04-07,2017,HOU,KCA,1,5,5-1,KCA,9,false,33,42,75,171,135,306,9,16,25,3,3:12
490158,2017-04-07,2017,TEX,OAK,10,5,10-5,TEX,9,true,40,36,76,159,136,295,15,10,25,1,2:56
490157,2017-04-07,2017,BAL,NYA,6,5,6-5,BAL,9,true,33,39,72,176,132,308,8,14,22,4,3:20
490155,2017-04-07,2017,NYN,MIA,2,7,7-2,MIA,9,false,37,43,80,175,133,308,11,17,28,2,3:06
490150,2017-04-07,2017,MIL,CHN,2,1,2-1,MIL,11,false,42,43,85,182,171,353,11,13,24,3,3:58
490149,2017-04-07,2017,DET,BOS,6,5,6-5,DET,9,true,36,41,77,175,145,320,17,14,31,5,3:35
490148,2017-04-07,2017,PIT,ATL,5,4,5-4,PIT,9,true,42,38,80,139,178,317,16,12,28,2,3:18
490152,2017-04-07,2017,ARI,CLE,7,3,7-3,ARI,9,true,39,38,77,156,156,312,16,10,26,3,3:19
490162,2017-04-07,2017,PHI,WAS,6,7,7-6,WAS,9,false,39,41,80,178,149,327,13,17,30,2,3:34
490160,2017-04-07,2017,ANA,SEA,5,1,5-1,ANA,9,true,36,35,71,139,123,262,14,7,21,2,2:56
490154,2017-04-07,2017,COL,LAN,2,1,2-1,COL,9,true,31,34,65,140,127,267,7,8,15,1,3:00
490161,2017-04-07,2017,TBA,TOR,10,8,10-8,TBA,9,true,43,44,87,193,165,358,20,16,36,6,3:53
490164,2017-04-08,2017,DET,BOS,4,1,4-1,DET,9,true,31,35,66,143,133,276,10,10,20,1,3:05
490171,2017-04-08,2017,CHA,MIN,6,2,6-2,CHA,9,true,34,37,71,125,143,268,12,11,23,2,2:56
490168,2017-04-08,2017,HOU,KCA,3,7,7-3,KCA,9,false,35,36,71,131,113,244,12,9,21,1,2:42
490173,2017-04-08,2017,TEX,OAK,1,6,6-1,OAK,9,false,30,40,70,160,119,279,3,12,15,1,2:59
490172,2017-04-08,2017,BAL,NYA,5,4,5-4,BAL,9,true,38,40,78,165,129,294,16,15,31,3,3:35
490165,2017-04-08,2017,MIL,CHN,6,11,11-6,CHN,9,false,37,49,86,199,148,347,10,24,34,2,3:28
490163,2017-04-08,2017,PIT,ATL,6,4,6-4,PIT,9,true,37,43,80,140,131,271,15,21,36,1,3:00
490175,2017-04-08,2017,ANA,SEA,5,4,5-4,ANA,9,true,36,35,71,139,134,273,14,9,23,1,3:05
490177,2017-04-08,2017,PHI,WAS,17,3,17-3,PHI,9,true,45,36,81,144,196,340,20,12,32,1,3:15
490170,2017-04-08,2017,NYN,MIA,1,8,8-1,MIA,9,false,34,48,82,194,156,350,6,21,27,2,3:25
490166,2017-04-08,2017,SLN,CIN,10,4,10-4,SLN,9,true,46,34,80,132,176,308,23,8,31,1,2:47
490174,2017-04-08,2017,SDN,SFN,2,1,2-1,SDN,9,true,34,33,67,124,114,238,9,6,15,1,2:24
490176,2017-04-08,2017,TBA,TOR,3,2,3-2,TBA,11,false,49,40,89,158,168,326,19,9,28,2,3:55
490167,2017-04-08,2017,ARI,CLE,11,2,11-2,ARI,9,true,41,33,74,144,167,311,19,7,26,3,3:15
490169,2017-04-08,2017,COL,LAN,4,2,4-2,COL,9,true,33,35,68,161,124,285,9,10,19,1,2:59
490188,2017-04-09,2017,TEX,OAK,8,1,8-1,TEX,9,true,40,39,79,152,148,300,14,13,27,2,3:16
490186,2017-04-09,2017,CHA,MIN,1,4,4-1,MIN,9,false,38,35,73,131,150,281,11,9,20,4,3:07
490183,2017-04-09,2017,HOU,KCA,5,4,5-4,HOU,12,false,51,45,96,166,193,359,23,10,33,2,3:49
490178,2017-04-09,2017,PIT,ATL,6,5,6-5,PIT,10,false,38,45,83,153,126,279,15,15,30,0,3:14
490192,2017-04-09,2017,PHI,WAS,4,3,4-3,PHI,9,false,37,37,74,150,139,289,12,10,22,1,3:24
490180,2017-04-09,2017,MIL,CHN,4,7,7-4,CHN,9,false,33,42,75,162,128,290,6,16,22,2,3:00
490190,2017-04-09,2017,ANA,SEA,10,9,10-9,ANA,9,false,41,39,80,148,153,301,18,11,29,3,3:27
490184,2017-04-09,2017,COL,LAN,6,10,10-6,LAN,9,false,39,46,85,190,148,338,11,20,31,1,3:49
490181,2017-04-09,2017,SLN,CIN,0,8,8-0,CIN,9,false,32,43,75,154,134,288,7,17,24,2,2:44
490182,2017-04-09,2017,ARI,CLE,3,2,3-2,ARI,9,true,33,38,71,152,119,271,9,10,19,2,3:02
490189,2017-04-09,2017,SDN,SFN,3,5,5-3,SFN,9,false,39,39,78,145,143,288,13,12,25,0,2:57
490179,2017-04-09,2017,DET,BOS,5,7,7-5,BOS,9,false,42,40,82,134,151,285,16,18,34,3,3:27
490185,2017-04-09,2017,NYN,MIA,5,2,5-2,NYN,9,true,34,31,65,131,117,248,9,5,14,0,2:44
490191,2017-04-09,2017,TBA,TOR,7,2,7-2,TBA,9,true,37,31,68,144,162,306,14,5,19,1,2:57
490187,2017-04-09,2017,BAL,NYA,3,7,7-3,NYA,9,false,36,46,82,202,137,339,10,20,30,3,3:22
490198,2017-04-10,2017,PHI,NYN,3,4,4-3,NYN,9,false,38,35,73,121,155,276,14,10,24,3,2:59
490200,2017-04-10,2017,COL,SDN,3,5,5-3,SDN,9,false,35,36,71,142,143,285,11,12,23,2,2:53
490199,2017-04-10,2017,KCA,OAK,0,2,2-0,OAK,9,false,33,34,67,132,138,270,7,8,15,0,2:50
490197,2017-04-10,2017,CHN,LAN,3,2,3-2,CHN,9,false,39,37,76,158,151,309,14,10,24,4,3:37 (1:56 delay)
490193,2017-04-10,2017,SFN,ARI,4,1,4-1,SFN,9,true,36,32,68,108,139,247,11,5,16,1,2:38
490202,2017-04-10,2017,NYA,TBA,8,1,8-1,NYA,9,true,37,29,66,106,117,223,11,2,13,2,2:37
490196,2017-04-10,2017,SEA,HOU,6,0,6-0,SEA,9,true,38,35,73,131,157,288,16,9,25,1,2:56
490195,2017-04-10,2017,PIT,CIN,1,7,7-1,CIN,9,false,36,42,78,167,149,316,9,14,23,2,3:05
490194,2017-04-10,2017,DET,BOS,2,1,2-1,DET,9,true,30,34,64,150,109,259,6,7,13,1,2:44 (:36 delay)
490201,2017-04-10,2017,WAS,SLN,14,6,14-6,WAS,9,true,49,39,88,157,190,347,26,10,36,3,3:47
490210,2017-04-11,2017,DET,MIN,2,1,2-1,DET,9,true,31,35,66,148,111,259,7,9,16,2,2:39
490206,2017-04-11,2017,CLE,CHA,2,1,2-1,CLE,10,false,39,35,74,141,178,319,14,6,20,3,3:37
490208,2017-04-11,2017,SEA,HOU,5,7,7-5,HOU,9,false,40,42,82,158,171,329,15,17,32,3,3:29
490213,2017-04-11,2017,WAS,SLN,8,3,8-3,WAS,9,true,41,35,76,126,153,279,16,9,25,0,2:55
490205,2017-04-11,2017,BOS,BAL,8,1,8-1,BOS,9,true,40,34,74,130,162,292,18,7,25,2,3:15
490209,2017-04-11,2017,TOR,MIL,3,4,4-3,MIL,9,false,37,40,77,176,158,334,10,12,22,1,3:31
490212,2017-04-11,2017,COL,SDN,3,2,3-2,COL,9,true,31,34,65,127,111,238,6,7,13,0,2:24
490211,2017-04-11,2017,PHI,NYN,4,14,14-4,NYN,9,false,37,52,89,206,149,355,10,26,36,3,3:38
490214,2017-04-11,2017,ANA,TEX,6,5,6-5,ANA,10,false,45,42,87,155,152,307,18,13,31,1,3:33
490207,2017-04-11,2017,PIT,CIN,2,6,6-2,CIN,9,false,40,39,79,140,157,297,12,12,24,1,3:04 (1:09 delay)
490204,2017-04-11,2017,MIA,ATL,8,4,8-4,MIA,9,true,35,38,73,157,130,287,13,11,24,0,2:54
490203,2017-04-11,2017,SFN,ARI,3,4,4-3,ARI,9,false,43,41,84,160,163,323,17,14,31,2,3:18
490216,2017-04-12,2017,MIA,ATL,4,5,5-4,ATL,9,false,37,35,72,119,136,255,9,11,20,0,2:51 (:27 delay)
490226,2017-04-12,2017,COL,SDN,0,6,6-0,SDN,9,false,35,38,73,120,146,266,9,14,23,3,2:49
490221,2017-04-12,2017,CHN,LAN,0,2,2-0,LAN,9,false,32,38,70,171,139,310,8,11,19,2,3:20
490218,2017-04-12,2017,CLE,CHA,1,2,2-1,CHA,9,false,35,34,69,138,155,293,7,7,14,1,2:58
490227,2017-04-12,2017,WAS,SLN,1,6,6-1,SLN,9,false,34,41,75,156,141,297,8,13,21,4,3:14
490219,2017-04-12,2017,PIT,CIN,2,9,9-2,CIN,9,false,35,44,79,159,130,289,9,18,27,2,2:54
490225,2017-04-12,2017,KCA,OAK,3,8,8-3,OAK,9,false,37,43,80,160,152,312,10,18,28,3,3:07
490215,2017-04-12,2017,SFN,ARI,6,2,6-2,SFN,9,true,40,38,78,148,159,307,15,11,26,3,3:21
490222,2017-04-12,2017,TOR,MIL,0,2,2-0,MIL,9,false,31,34,65,100,111,211,8,8,16,0,2:14
490229,2017-04-12,2017,ANA,TEX,3,8,8-3,TEX,9,false,35,42,77,154,116,270,7,17,24,3,2:59
490220,2017-04-12,2017,SEA,HOU,5,10,10-5,HOU,9,false,38,46,84,148,147,295,10,24,34,1,3:12
490224,2017-04-12,2017,PHI,NYN,4,5,5-4,NYN,9,false,34,37,71,157,136,293,8,12,20,2,3:13
490223,2017-04-12,2017,DET,MIN,5,3,5-3,DET,9,true,33,34,67,156,104,260,9,9,18,0,2:48
490217,2017-04-12,2017,BOS,BAL,5,12,12-5,BAL,9,false,43,43,86,175,190,365,16,19,35,4,3:46
490228,2017-04-12,2017,NYA,TBA,8,4,8-4,NYA,9,true,39,38,77,159,154,313,13,12,25,5,3:33
490238,2017-04-13,2017,NYA,TBA,3,2,3-2,NYA,9,true,34,35,69,146,133,279,13,9,22,2,2:59
490239,2017-04-13,2017,ANA,TEX,3,8,8-3,TEX,9,false,36,41,77,162,136,298,10,14,24,0,3:14
490143,2017-04-13,2017,BOS,PIT,4,3,4-3,BOS,9,true,34,37,71,160,133,293,12,12,24,3,3:15
490230,2017-04-13,2017,TOR,BAL,1,2,2-1,BAL,9,false,35,33,68,120,141,261,9,7,16,1,2:45
490143,2017-04-13,2017,BOS,PIT,4,3,4-3,BOS,9,true,34,37,71,160,133,293,12,12,24,3,3:15
490233,2017-04-13,2017,CHN,LAN,4,0,4-0,CHN,9,true,34,36,70,136,134,270,14,10,24,2,3:01
490237,2017-04-13,2017,KCA,OAK,3,1,3-1,KCA,9,true,36,33,69,130,133,263,11,7,18,1,2:39
490234,2017-04-13,2017,CIN,MIL,1,5,5-1,MIL,9,false,32,36,68,119,121,240,5,12,17,0,2:25
490235,2017-04-13,2017,DET,MIN,5,11,11-5,MIN,9,false,38,45,83,176,167,343,12,19,31,2,3:31
490231,2017-04-13,2017,CLE,CHA,4,10,10-4,CHA,9,false,42,46,88,156,172,328,16,19,35,4,3:32
490232,2017-04-13,2017,SFN,COL,1,3,3-1,COL,9,false,33,36,69,146,112,258,8,9,17,3,2:50
490236,2017-04-13,2017,MIA,NYN,8,9,9-8,NYN,16,false,69,66,135,253,256,509,23,19,42,2,5:38
490246,2017-04-14,2017,KCA,ANA,7,1,7-1,KCA,9,true,34,34,68,138,124,262,11,8,19,0,2:37
490251,2017-04-14,2017,ATL,SDN,5,2,5-2,ATL,9,true,35,36,71,143,122,265,13,12,25,1,2:57
490242,2017-04-14,2017,MIN,CHA,1,2,2-1,CHA,9,false,35,34,69,126,138,264,10,10,20,3,3:06 (:36 delay)
490254,2017-04-14,2017,SEA,TEX,2,1,2-1,SEA,9,true,34,34,68,113,150,263,13,8,21,4,3:05
490243,2017-04-14,2017,SFN,COL,8,2,8-2,SFN,9,true,38,33,71,109,170,279,13,7,20,1,2:49
490250,2017-04-14,2017,CHN,PIT,2,4,4-2,PIT,9,false,40,36,76,140,174,314,12,13,25,1,3:15
490245,2017-04-14,2017,OAK,HOU,2,7,7-2,HOU,9,false,36,44,80,156,136,292,9,16,25,2,3:07
490252,2017-04-14,2017,NYA,SLN,4,3,4-3,NYA,9,true,36,37,73,153,131,284,13,10,23,1,2:54
490244,2017-04-14,2017,CLE,DET,6,7,7-6,DET,9,false,45,40,85,169,183,352,16,14,30,3,4:00
490240,2017-04-14,2017,LAN,ARI,7,1,7-1,LAN,9,true,40,32,72,115,160,275,17,6,23,2,3:06
490253,2017-04-14,2017,BOS,TBA,5,10,10-5,TBA,9,false,44,44,88,174,156,330,18,17,35,3,3:37
490248,2017-04-14,2017,MIA,NYN,3,2,3-2,MIA,9,false,38,40,78,154,144,298,14,14,28,2,3:26
490249,2017-04-14,2017,WAS,PHI,3,2,3-2,WAS,10,false,40,37,77,145,159,304,15,9,24,0,3:18
490247,2017-04-14,2017,CIN,MIL,4,10,10-4,MIL,9,false,37,45,82,185,145,330,10,19,29,1,3:21
490241,2017-04-14,2017,TOR,BAL,4,6,6-4,BAL,9,false,38,39,77,160,157,317,11,13,24,2,3:18
490257,2017-04-15,2017,MIN,CHA,6,0,6-0,MIN,9,true,40,29,69,107,135,242,17,2,19,1,2:26
490256,2017-04-15,2017,TOR,BAL,2,1,2-1,TOR,9,false,31,36,67,131,115,246,8,10,18,2,2:39
490263,2017-04-15,2017,MIA,NYN,5,4,5-4,MIA,9,true,32,34,66,129,125,254,8,7,15,2,2:30
490255,2017-04-15,2017,LAN,ARI,8,4,8-4,LAN,9,true,42,35,77,141,135,276,18,6,24,4,3:03
490269,2017-04-15,2017,SEA,TEX,5,0,5-0,SEA,9,true,34,29,63,127,119,246,12,3,15,1,2:24
490258,2017-04-15,2017,SFN,COL,0,5,5-0,COL,9,false,30,41,71,143,105,248,3,14,17,1,2:26
490262,2017-04-15,2017,CIN,MIL,7,5,7-5,CIN,9,true,40,39,79,154,147,301,18,13,31,1,3:10
490260,2017-04-15,2017,OAK,HOU,6,10,10-6,HOU,9,false,41,44,85,189,176,365,14,18,32,5,3:55
490264,2017-04-15,2017,WAS,PHI,2,4,4-2,PHI,9,false,32,33,65,139,124,263,5,7,12,0,2:39
490268,2017-04-15,2017,BOS,TBA,2,1,2-1,BOS,9,true,32,33,65,143,116,259,9,8,17,1,2:54
490261,2017-04-15,2017,KCA,ANA,3,2,3-2,KCA,9,true,31,38,69,142,144,286,8,13,21,2,3:16
490266,2017-04-15,2017,ATL,SDN,4,2,4-2,ATL,9,true,33,36,69,116,117,233,11,10,21,1,2:20
490267,2017-04-15,2017,NYA,SLN,3,2,3-2,NYA,9,true,39,35,74,133,160,293,13,8,21,2,3:05
490265,2017-04-15,2017,CHN,PIT,7,8,8-7,PIT,9,false,41,38,79,163,154,317,13,12,25,2,3:25
490259,2017-04-15,2017,CLE,DET,13,6,13-6,CLE,9,true,46,40,86,143,167,310,23,13,36,2,3:36
490273,2017-04-16,2017,SFN,COL,3,4,4-3,COL,9,false,33,35,68,130,112,242,7,8,15,3,2:46
490274,2017-04-16,2017,CLE,DET,1,4,4-1,DET,9,false,34,36,70,142,149,291,10,13,23,2,3:15
490277,2017-04-16,2017,CIN,MIL,2,4,4-2,MIL,9,false,34,38,72,166,131,297,9,10,19,1,2:56
490281,2017-04-16,2017,ATL,SDN,9,2,9-2,ATL,9,true,36,32,68,122,136,258,15,6,21,2,2:46
490272,2017-04-16,2017,MIN,CHA,1,3,3-1,CHA,10,false,40,42,82,139,162,301,11,12,23,0,3:15
490282,2017-04-16,2017,NYA,SLN,9,3,9-3,NYA,9,true,39,38,77,137,170,307,20,11,31,2,3:17
490279,2017-04-16,2017,WAS,PHI,6,4,6-4,WAS,9,false,39,39,78,150,146,296,14,12,26,2,3:11
490278,2017-04-16,2017,MIA,NYN,4,2,4-2,MIA,9,false,36,37,73,163,125,288,13,10,23,1,2:58
490280,2017-04-16,2017,CHN,PIT,1,6,6-1,PIT,9,false,36,38,74,158,131,289,10,14,24,1,3:02
490276,2017-04-16,2017,KCA,ANA,1,0,1-0,KCA,9,false,34,30,64,119,131,250,9,4,13,1,2:37
490283,2017-04-16,2017,BOS,TBA,7,5,7-5,BOS,9,true,40,36,76,164,156,320,21,10,31,3,3:46
490284,2017-04-16,2017,SEA,TEX,8,7,8-7,SEA,9,false,40,42,82,146,164,310,18,16,34,6,3:39
490271,2017-04-16,2017,TOR,BAL,4,11,11-4,BAL,9,false,39,46,85,160,181,341,14,17,31,4,3:30
490270,2017-04-16,2017,LAN,ARI,1,3,3-1,ARI,9,false,34,37,71,150,141,291,8,13,21,4,3:22
490291,2017-04-17,2017,SLN,PIT,2,1,2-1,SLN,9,true,28,35,63,128,78,206,5,8,13,0,2:14
490289,2017-04-17,2017,SEA,MIA,6,1,6-1,SEA,9,true,35,32,67,124,141,265,12,5,17,0,2:31
490290,2017-04-17,2017,CHN,MIL,3,6,6-3,MIL,9,false,37,37,74,139,154,293,12,11,23,0,3:00
490285,2017-04-17,2017,LAN,ARI,2,4,4-2,ARI,9,false,36,40,76,158,135,293,9,16,25,1,3:07
490293,2017-04-17,2017,BOS,TBA,4,3,4-3,BOS,9,true,35,39,74,154,137,291,12,14,26,2,3:07
490288,2017-04-17,2017,HOU,ANA,3,0,3-0,HOU,9,true,32,36,68,140,113,253,11,8,19,0,2:36
490292,2017-04-17,2017,ATL,SDN,5,4,5-4,ATL,9,false,38,39,77,133,114,247,14,13,27,3,2:48
490294,2017-04-17,2017,OAK,TEX,0,7,7-0,TEX,9,false,30,41,71,160,121,281,5,15,20,2,2:46 (:10 delay)
490286,2017-04-17,2017,NYA,CHA,7,4,7-4,NYA,9,true,34,37,71,132,137,269,10,14,24,3,2:49
490287,2017-04-17,2017,MIN,CLE,1,3,3-1,CLE,9,false,40,40,80,127,155,282,13,14,27,2,2:58
490306,2017-04-18,2017,SLN,PIT,2,1,2-1,SLN,9,true,30,37,67,145,99,244,6,11,17,1,2:31
490303,2017-04-18,2017,SEA,MIA,0,5,5-0,MIA,9,false,31,37,68,126,124,250,4,10,14,0,2:33
490309,2017-04-18,2017,ATL,WAS,1,3,3-1,WAS,9,false,36,36,72,138,161,299,10,11,21,2,3:09
490301,2017-04-18,2017,TBA,DET,5,1,5-1,TBA,9,true,38,32,70,143,145,288,15,5,20,3,3:19
490308,2017-04-18,2017,OAK,TEX,4,2,4-2,OAK,9,true,33,31,64,111,142,253,10,3,13,3,2:48
490304,2017-04-18,2017,CHN,MIL,9,7,9-7,CHN,9,true,40,38,78,154,138,292,18,11,29,2,3:00
490307,2017-04-18,2017,KCA,SFN,1,2,2-1,SFN,11,false,45,45,90,163,158,321,15,14,29,4,3:37
490298,2017-04-18,2017,NYA,CHA,1,4,4-1,CHA,9,false,32,31,63,119,107,226,7,3,10,1,2:16
490295,2017-04-18,2017,SDN,ARI,2,11,11-2,ARI,9,false,34,48,82,196,131,327,9,18,27,4,3:20
490302,2017-04-18,2017,HOU,ANA,2,5,5-2,ANA,9,false,36,38,74,153,147,300,12,12,24,1,3:05
490300,2017-04-18,2017,LAN,COL,3,4,4-3,COL,9,false,42,36,78,141,166,307,16,10,26,2,3:17
490299,2017-04-18,2017,MIN,CLE,4,11,11-4,CLE,9,false,39,43,82,160,148,308,12,16,28,3,3:15
490297,2017-04-18,2017,TOR,BOS,7,8,8-7,BOS,9,false,45,43,88,167,177,344,18,18,36,4,3:48
490296,2017-04-18,2017,CIN,BAL,9,3,9-3,CIN,9,true,43,36,79,133,184,317,19,9,28,1,3:05
490305,2017-04-18,2017,NYN,PHI,2,6,6-2,PHI,10,false,39,48,87,209,159,368,9,16,25,4,3:58
490321,2017-04-19,2017,SLN,PIT,2,1,2-1,SLN,9,true,32,35,67,138,125,263,10,8,18,1,2:40
490311,2017-04-19,2017,CIN,BAL,0,2,2-0,BAL,9,false,33,35,68,119,120,239,6,10,16,1,2:28
490312,2017-04-19,2017,TOR,BOS,3,0,3-0,TOR,9,true,33,34,67,137,122,259,7,8,15,1,2:45
490320,2017-04-19,2017,NYN,PHI,5,4,5-4,NYN,9,true,34,37,71,132,114,246,11,12,23,2,2:37
490316,2017-04-19,2017,TBA,DET,8,7,8-7,TBA,9,false,42,40,82,167,153,320,18,17,35,2,3:44
490310,2017-04-19,2017,SDN,ARI,1,0,1-0,SDN,9,true,29,31,60,121,96,217,6,5,11,0,2:13
490315,2017-04-19,2017,LAN,COL,4,2,4-2,LAN,9,true,34,35,69,129,124,253,9,8,17,3,2:55
490317,2017-04-19,2017,HOU,ANA,5,1,5-1,HOU,9,true,33,33,66,118,127,245,12,9,21,2,2:47
490323,2017-04-19,2017,OAK,TEX,9,1,9-1,OAK,9,true,38,34,72,121,145,266,17,7,24,1,2:47
490324,2017-04-19,2017,ATL,WAS,4,14,14-4,WAS,9,false,35,52,87,203,130,333,10,28,38,2,3:32
490319,2017-04-19,2017,CHN,MIL,7,4,7-4,CHN,9,false,40,39,79,164,191,355,13,13,26,2,3:30 (:55 delay)
490313,2017-04-19,2017,NYA,CHA,9,1,9-1,NYA,9,true,36,34,70,123,134,257,14,8,22,2,2:40
490318,2017-04-19,2017,SEA,MIA,10,5,10-5,SEA,9,true,45,41,86,138,185,323,23,18,41,4,3:32
490322,2017-04-19,2017,KCA,SFN,2,0,2-0,KCA,9,true,33,31,64,122,126,248,11,5,16,0,2:28
490326,2017-04-20,2017,CIN,BAL,1,2,2-1,BAL,10,false,32,35,67,143,130,273,3,7,10,0,2:37
490329,2017-04-20,2017,TBA,DET,8,1,8-1,TBA,9,true,39,34,73,132,156,288,15,7,22,1,3:02
490335,2017-04-20,2017,ATL,WAS,2,3,3-2,WAS,9,false,37,34,71,106,132,238,10,7,17,3,2:41
490325,2017-04-20,2017,SDN,ARI,4,1,4-1,SDN,9,true,29,36,65,134,108,242,5,9,14,1,2:24
490330,2017-04-20,2017,TEX,KCA,1,0,1-0,TEX,13,false,45,46,91,187,173,360,10,9,19,2,3:47
490331,2017-04-20,2017,HOU,ANA,2,1,2-1,HOU,9,true,29,35,64,139,110,249,5,10,15,1,2:37
490332,2017-04-20,2017,NYN,PHI,4,6,6-4,PHI,9,false,37,41,78,159,141,300,12,13,25,1,3:14
490333,2017-04-20,2017,OAK,SEA,9,6,9-6,OAK,9,true,38,38,76,154,159,313,15,12,27,3,3:09
490327,2017-04-20,2017,TOR,BOS,1,4,4-1,BOS,10,false,36,40,76,176,132,308,6,11,17,1,3:07
490328,2017-04-20,2017,MIN,CLE,2,6,6-2,CLE,9,false,36,44,80,186,156,342,9,19,28,7,3:36
490334,2017-04-20,2017,MIL,SLN,7,5,7-5,MIL,9,true,36,41,77,169,135,304,13,15,28,3,3:08
490342,2017-04-21,2017,TEX,KCA,6,2,6-2,TEX,9,true,34,34,68,120,141,261,10,9,19,1,2:45
490347,2017-04-21,2017,OAK,SEA,3,1,3-1,OAK,9,true,33,35,68,146,120,266,13,10,23,2,2:51
490337,2017-04-21,2017,BAL,BOS,2,0,2-0,BAL,9,true,33,33,66,142,136,278,9,8,17,4,3:20
490341,2017-04-21,2017,TBA,HOU,3,6,6-3,HOU,9,false,35,39,74,154,132,286,9,14,23,1,3:16
490346,2017-04-21,2017,COL,SFN,6,5,6-5,COL,9,true,38,41,79,130,149,279,14,15,29,3,2:59
490336,2017-04-21,2017,PHI,ATL,4,3,4-3,PHI,9,true,35,34,69,119,114,233,12,7,19,0,2:38 (:24 delay)
490340,2017-04-21,2017,MIN,DET,6,3,6-3,MIN,9,true,34,36,70,130,150,280,11,9,20,3,2:59
490348,2017-04-21,2017,MIL,SLN,3,6,6-3,SLN,9,false,38,38,76,127,167,294,11,15,26,0,2:56
490343,2017-04-21,2017,ARI,LAN,13,5,13-5,ARI,9,true,46,37,83,143,168,311,24,11,35,5,3:28
490344,2017-04-21,2017,SDN,MIA,5,3,5-3,SDN,9,true,36,34,70,125,125,250,14,7,21,1,2:28
490338,2017-04-21,2017,CIN,CHN,5,6,6-5,CHN,11,false,47,48,95,179,204,383,17,16,33,1,3:57
490345,2017-04-21,2017,PIT,NYA,6,3,6-3,PIT,9,true,36,41,77,179,139,318,12,12,24,3,3:19
490350,2017-04-21,2017,NYN,WAS,3,4,4-3,WAS,11,false,44,44,88,180,172,352,13,13,26,2,3:43
490339,2017-04-21,2017,CHA,CLE,0,3,3-0,CLE,9,false,29,34,63,161,110,271,5,10,15,2,2:45
490349,2017-04-21,2017,ANA,TOR,7,8,8-7,TOR,13,false,59,59,118,248,244,492,19,20,39,4,5:36
490356,2017-04-22,2017,TBA,HOU,6,3,6-3,TBA,9,true,38,34,72,127,141,268,14,9,23,4,3:05
490363,2017-04-22,2017,MIL,SLN,1,4,4-1,SLN,9,false,34,42,76,148,147,295,10,15,25,0,3:16
490361,2017-04-22,2017,COL,SFN,12,3,12-3,COL,9,true,42,35,77,130,152,282,18,9,27,3,3:01
490364,2017-04-22,2017,ANA,TOR,5,4,5-4,ANA,9,true,35,35,70,122,109,231,13,12,25,3,2:35
490360,2017-04-22,2017,PIT,NYA,5,11,11-5,NYA,9,false,40,45,85,165,143,308,13,17,30,5,3:17
490357,2017-04-22,2017,TEX,KCA,2,1,2-1,TEX,9,false,33,33,66,121,126,247,11,7,18,1,2:38
490352,2017-04-22,2017,BAL,BOS,4,2,4-2,BAL,9,true,35,37,72,143,109,252,12,10,22,2,2:47 (:28 delay)
490359,2017-04-22,2017,SDN,MIA,3,6,6-3,MIA,11,false,44,42,86,157,157,314,13,10,23,2,3:13
490355,2017-04-22,2017,MIN,DET,4,5,5-4,DET,9,false,39,47,86,189,150,339,13,19,32,5,4:00
490353,2017-04-22,2017,CIN,CHN,8,12,12-8,CHN,9,false,41,45,86,192,157,349,14,19,33,1,3:24
490351,2017-04-22,2017,PHI,ATL,4,3,4-3,PHI,10,false,40,40,80,172,155,327,14,11,25,1,3:32
490362,2017-04-22,2017,OAK,SEA,4,3,4-3,OAK,9,true,34,38,72,145,137,282,11,13,24,3,3:07
490358,2017-04-22,2017,ARI,LAN,11,5,11-5,ARI,9,true,41,40,81,170,140,310,17,16,33,3,3:20
490354,2017-04-22,2017,CHA,CLE,0,7,7-0,CLE,9,false,30,42,72,168,123,291,4,14,18,3,3:09
490365,2017-04-22,2017,NYN,WAS,1,3,3-1,WAS,9,false,32,41,73,155,129,284,5,16,21,3,3:01
490376,2017-04-23,2017,COL,SFN,8,0,8-0,COL,9,true,35,35,70,115,132,247,12,9,21,1,2:46
490375,2017-04-23,2017,PIT,NYA,2,1,2-1,PIT,9,true,33,36,69,135,127,262,12,9,21,0,2:39
490368,2017-04-23,2017,CIN,CHN,7,5,7-5,CIN,9,true,35,35,70,119,128,247,9,9,18,2,2:26
490370,2017-04-23,2017,MIN,DET,4,13,13-4,DET,9,false,36,45,81,180,140,320,9,19,28,4,3:17
490373,2017-04-23,2017,ARI,LAN,2,6,6-2,LAN,9,false,34,39,73,143,123,266,8,14,22,1,2:54
490367,2017-04-23,2017,BAL,BOS,2,6,6-2,BOS,9,false,39,41,80,156,161,317,12,18,30,5,3:34
490374,2017-04-23,2017,SDN,MIA,3,7,7-3,MIA,9,false,34,41,75,149,118,267,9,14,23,2,2:42
490372,2017-04-23,2017,TEX,KCA,5,2,5-2,TEX,9,true,36,32,68,127,145,272,14,6,20,2,3:00
490380,2017-04-23,2017,NYN,WAS,3,6,6-3,WAS,9,false,33,35,68,130,129,259,7,9,16,1,2:43
490366,2017-04-23,2017,PHI,ATL,5,2,5-2,PHI,9,true,33,36,69,131,123,254,10,9,19,2,2:38
490377,2017-04-23,2017,OAK,SEA,1,11,11-1,SEA,9,false,33,44,77,181,142,323,6,18,24,2,3:11
490379,2017-04-23,2017,ANA,TOR,2,6,6-2,TOR,9,false,33,37,70,173,99,272,9,13,22,1,2:51
490369,2017-04-23,2017,CHA,CLE,6,2,6-2,CHA,9,true,41,37,78,163,164,327,16,12,28,1,3:12
490378,2017-04-23,2017,MIL,SLN,4,6,6-4,SLN,9,false,39,40,79,156,156,312,11,17,28,2,3:15
490371,2017-04-23,2017,TBA,HOU,4,6,6-4,HOU,10,false,42,43,85,162,163,325,11,17,28,1,3:39
490388,2017-04-24,2017,ANA,TOR,2,1,2-1,ANA,9,true,33,35,68,149,124,273,11,12,23,2,3:02
490384,2017-04-24,2017,SFN,LAN,2,1,2-1,SFN,9,true,33,31,64,111,151,262,11,6,17,2,2:57
490389,2017-04-24,2017,COL,WAS,8,4,8-4,COL,9,true,38,36,74,135,131,266,14,10,24,3,3:00
490385,2017-04-24,2017,TEX,MIN,2,3,3-2,MIN,9,false,35,37,72,148,131,279,10,12,22,2,3:01
490386,2017-04-24,2017,ARI,SDN,7,6,7-6,ARI,9,true,37,39,76,156,135,291,13,11,24,1,3:05
490387,2017-04-24,2017,BAL,TBA,6,3,6-3,BAL,9,true,36,40,76,172,124,296,13,14,27,4,3:16 (:19 delay)
490381,2017-04-24,2017,PIT,CHN,3,14,14-3,CHN,9,false,39,52,91,190,144,334,13,28,41,2,3:22
490382,2017-04-24,2017,MIL,CIN,11,7,11-7,MIL,9,true,40,44,84,192,144,336,15,15,30,2,3:24
490383,2017-04-24,2017,CHA,KCA,12,1,12-1,CHA,9,true,41,31,72,120,179,299,18,3,21,1,2:47
490391,2017-04-25,2017,PIT,CHN,0,1,1-0,CHN,9,false,34,31,65,115,148,263,8,4,12,0,2:44
490399,2017-04-25,2017,ANA,OAK,2,1,2-1,ANA,11,false,38,39,77,156,137,293,7,8,15,0,3:12
490395,2017-04-25,2017,SFN,LAN,1,2,2-1,LAN,9,false,36,37,73,128,124,252,9,12,21,2,2:59
490402,2017-04-25,2017,BAL,TBA,0,2,2-0,TBA,9,false,32,38,70,147,138,285,5,13,18,2,2:52
490400,2017-04-25,2017,ARI,SDN,9,3,9-3,ARI,9,true,42,39,81,150,159,309,19,12,31,2,3:02
490394,2017-04-25,2017,CHA,KCA,10,5,10-5,CHA,9,true,42,38,80,167,159,326,19,12,31,2,3:21
490401,2017-04-25,2017,DET,SEA,19,9,19-9,DET,9,true,55,48,103,167,201,368,32,24,56,3,3:43
490403,2017-04-25,2017,SLN,TOR,5,6,6-5,TOR,11,false,45,48,93,184,187,371,14,14,28,1,3:46
490392,2017-04-25,2017,MIL,CIN,9,1,9-1,MIL,9,true,41,38,79,141,153,294,18,11,29,2,2:59
490397,2017-04-25,2017,TEX,MIN,1,8,8-1,MIN,9,false,31,44,75,176,129,305,7,21,28,2,3:04
490404,2017-04-25,2017,COL,WAS,12,15,15-12,WAS,9,false,45,47,92,178,151,329,18,20,38,2,3:26 (1:06 delay)
490393,2017-04-25,2017,CLE,HOU,2,4,4-2,HOU,9,false,34,38,72,143,117,260,9,13,22,1,2:46
490413,2017-04-26,2017,BOS,NYA,1,3,3-1,NYA,9,false,34,40,74,166,146,312,8,12,20,2,3:16
490410,2017-04-26,2017,SFN,LAN,4,3,4-3,SFN,10,false,37,41,78,148,147,295,9,11,20,3,3:11
490415,2017-04-26,2017,ARI,SDN,5,8,8-5,SDN,9,false,42,41,83,157,157,314,17,15,32,2,3:14
490414,2017-04-26,2017,ANA,OAK,8,5,8-5,ANA,9,true,42,40,82,162,149,311,17,14,31,2,3:30
490405,2017-04-26,2017,NYN,ATL,2,8,8-2,ATL,9,false,36,47,83,177,138,315,9,20,29,4,3:19
490411,2017-04-26,2017,PHI,MIA,7,4,7-4,PHI,9,true,35,36,71,134,135,269,12,10,22,1,2:41
490416,2017-04-26,2017,DET,SEA,0,8,8-0,SEA,9,false,33,46,79,197,133,330,6,18,24,1,3:18
490412,2017-04-26,2017,TEX,MIN,14,3,14-3,TEX,9,true,46,37,83,134,192,326,25,13,38,4,3:37
490407,2017-04-26,2017,MIL,CIN,9,4,9-4,MIL,9,true,41,38,79,143,142,285,19,11,30,4,2:53
490409,2017-04-26,2017,CHA,KCA,5,2,5-2,CHA,9,true,33,40,73,145,131,276,9,12,21,2,2:58
490417,2017-04-26,2017,BAL,TBA,5,4,5-4,BAL,11,false,46,47,93,180,183,363,18,15,33,4,4:08
490408,2017-04-26,2017,CLE,HOU,7,6,7-6,CLE,9,true,37,40,77,176,144,320,15,12,27,2,3:12
490419,2017-04-26,2017,COL,WAS,4,11,11-4,WAS,9,false,38,45,83,156,169,325,13,19,32,2,3:23
490406,2017-04-26,2017,PIT,CHN,6,5,6-5,PIT,9,true,36,45,81,188,137,325,14,19,33,4,3:22
490426,2017-04-27,2017,ARI,SDN,6,2,6-2,ARI,9,true,34,31,65,116,124,240,11,5,16,1,2:21
490422,2017-04-27,2017,SFN,LAN,1,5,5-1,LAN,10,false,38,42,80,160,152,312,12,13,25,5,3:28
490418,2017-04-27,2017,SLN,TOR,6,4,6-4,SLN,9,true,41,36,77,141,149,290,18,10,28,1,2:56
490429,2017-04-27,2017,COL,WAS,5,16,16-5,WAS,9,false,39,53,92,196,153,349,13,28,41,2,3:25
490424,2017-04-27,2017,BOS,NYA,0,3,3-0,NYA,9,false,29,34,63,120,97,217,3,10,13,1,2:21
490421,2017-04-27,2017,CLE,HOU,4,3,4-3,CLE,9,true,34,40,74,142,134,276,12,15,27,2,2:50 (:15 delay)
490428,2017-04-27,2017,SLN,TOR,8,4,8-4,SLN,11,false,48,46,94,170,152,322,24,14,38,1,3:32
490423,2017-04-27,2017,PHI,MIA,3,2,3-2,PHI,9,true,33,37,70,139,137,276,12,10,22,3,3:15
490418,2017-04-27,2017,SLN,TOR,6,4,6-4,SLN,9,true,41,36,77,141,149,290,18,10,28,1,2:56
490425,2017-04-27,2017,ANA,OAK,2,1,2-1,ANA,9,true,29,34,63,134,106,240,7,6,13,1,2:30
490427,2017-04-27,2017,DET,SEA,1,2,2-1,SEA,9,false,35,35,70,158,125,283,7,9,16,2,3:22 (:45 delay)
490420,2017-04-27,2017,NYN,ATL,5,7,7-5,ATL,9,false,36,42,78,157,122,279,11,16,27,2,2:56
490439,2017-04-28,2017,HOU,OAK,9,4,9-4,HOU,9,true,41,37,78,134,140,274,16,9,25,1,2:58
490436,2017-04-28,2017,TEX,ANA,3,6,6-3,ANA,9,false,33,40,73,150,134,284,7,14,21,0,3:12
490430,2017-04-28,2017,MIL,ATL,8,10,10-8,ATL,9,false,40,42,82,155,156,311,15,16,31,1,3:18
490435,2017-04-28,2017,ARI,COL,1,3,3-1,COL,9,false,35,36,71,128,140,268,9,9,18,2,2:53
490437,2017-04-28,2017,KCA,MIN,4,6,6-4,MIN,9,false,37,37,74,164,141,305,11,9,20,7,3:20
490443,2017-04-28,2017,CLE,SEA,1,3,3-1,SEA,9,false,34,31,65,121,143,264,6,6,12,2,2:36
490433,2017-04-28,2017,DET,CHA,3,7,7-3,CHA,9,false,37,42,79,145,148,293,11,16,27,2,3:25
490432,2017-04-28,2017,BOS,CHN,5,4,5-4,BOS,9,true,36,41,77,157,148,305,16,14,30,3,3:28
490434,2017-04-28,2017,SLN,CIN,7,5,7-5,SLN,9,true,38,40,78,160,136,296,15,14,29,3,3:08
490438,2017-04-28,2017,WAS,NYN,5,7,7-5,NYN,9,false,39,43,82,153,160,313,14,18,32,2,3:24
490440,2017-04-28,2017,LAN,PHI,5,3,5-3,LAN,9,true,37,35,72,142,136,278,13,8,21,2,3:02
490441,2017-04-28,2017,MIA,PIT,2,12,12-2,PIT,9,false,40,51,91,212,152,364,13,27,40,2,3:31
490431,2017-04-28,2017,NYA,BAL,14,11,14-11,NYA,10,false,48,50,98,152,185,337,21,20,41,4,3:41
490442,2017-04-28,2017,SFN,SDN,4,3,4-3,SFN,9,true,35,33,68,120,104,224,10,8,18,0,2:26
490444,2017-04-28,2017,TOR,TBA,4,7,7-4,TBA,9,false,41,40,81,146,152,298,14,14,28,4,3:16
490447,2017-04-29,2017,BOS,CHN,4,7,7-4,CHN,9,false,36,41,77,157,135,292,11,13,24,3,3:00
490459,2017-04-29,2017,TOR,TBA,4,1,4-1,TOR,9,true,31,38,69,156,115,271,9,11,20,1,3:02
490458,2017-04-29,2017,CLE,SEA,4,3,4-3,CLE,9,true,33,34,67,153,128,281,9,7,16,2,2:42
490454,2017-04-29,2017,HOU,OAK,1,2,2-1,OAK,9,false,34,37,71,137,114,251,9,11,20,3,2:49
490448,2017-04-29,2017,DET,CHA,4,6,6-4,CHA,10,false,40,44,84,184,148,332,11,15,26,2,3:36
490450,2017-04-29,2017,ARI,COL,6,7,7-6,COL,9,false,39,42,81,168,154,322,12,17,29,4,3:38
490445,2017-04-29,2017,MIL,ATL,3,11,11-3,ATL,9,false,36,44,80,154,132,286,12,21,33,0,3:06
490453,2017-04-29,2017,WAS,NYN,3,5,5-3,NYN,9,false,38,34,72,127,160,287,13,8,21,2,3:17
490446,2017-04-29,2017,NYA,BAL,12,4,12-4,NYA,9,true,40,41,81,167,165,332,16,13,29,3,3:12
490457,2017-04-29,2017,SFN,SDN,4,12,12-4,SDN,9,false,39,45,84,193,162,355,12,18,30,2,3:32
490456,2017-04-29,2017,MIA,PIT,0,4,4-0,PIT,9,false,29,37,66,143,95,238,3,11,14,1,2:31
490455,2017-04-29,2017,LAN,PHI,6,5,6-5,LAN,9,false,39,43,82,163,157,320,13,17,30,1,3:27
490451,2017-04-29,2017,TEX,ANA,6,3,6-3,TEX,9,true,36,38,74,169,125,294,13,10,23,0,3:03
490470,2017-04-30,2017,LAN,PHI,5,3,5-3,LAN,9,true,36,37,73,147,140,287,15,11,26,2,3:06
490467,2017-04-30,2017,KCA,MIN,5,7,7-5,MIN,9,false,39,44,83,170,130,300,12,17,29,4,3:11
490462,2017-04-30,2017,BOS,CHN,6,2,6-2,BOS,9,true,34,36,70,153,152,305,11,9,20,3,3:28
490466,2017-04-30,2017,TEX,ANA,2,5,5-2,ANA,9,false,35,42,77,137,160,297,9,17,26,4,3:23
490460,2017-04-30,2017,MIL,ATL,4,3,4-3,MIL,9,true,31,34,65,126,115,241,5,9,14,1,2:35
490463,2017-04-30,2017,DET,CHA,7,3,7-3,DET,9,true,39,37,76,163,133,296,18,11,29,2,3:24
490471,2017-04-30,2017,MIA,PIT,10,3,10-3,MIA,9,true,43,38,81,170,161,331,21,14,35,3,3:36
490472,2017-04-30,2017,SFN,SDN,2,5,5-2,SDN,12,false,45,50,95,173,154,327,10,12,22,2,3:23
490469,2017-04-30,2017,HOU,OAK,7,2,7-2,HOU,9,true,36,38,74,137,134,271,12,11,23,2,2:58
490468,2017-04-30,2017,WAS,NYN,23,5,23-5,WAS,9,true,54,38,92,153,202,355,32,11,43,2,3:37
490464,2017-04-30,2017,SLN,CIN,4,5,5-4,CIN,9,false,38,45,83,175,151,326,13,19,32,2,3:20
490465,2017-04-30,2017,ARI,COL,2,0,2-0,ARI,13,false,51,48,99,199,183,382,16,9,25,2,4:02
490473,2017-04-30,2017,CLE,SEA,12,4,12-4,CLE,9,true,41,35,76,138,151,289,18,12,30,3,2:58
490474,2017-04-30,2017,TOR,TBA,3,1,3-1,TOR,9,true,34,34,68,146,131,277,11,9,20,5,3:02
490461,2017-04-30,2017,NYA,BAL,4,7,7-4,BAL,11,false,53,51,104,209,228,437,21,19,40,2,4:37
490481,2017-05-01,2017,CIN,PIT,4,3,4-3,CIN,10,false,37,36,73,142,163,305,9,8,17,1,3:13
490483,2017-05-01,2017,MIA,TBA,2,4,4-2,TBA,9,false,33,40,73,175,128,303,6,13,19,3,3:14
490485,2017-05-01,2017,NYA,TOR,1,7,7-1,TOR,9,false,36,40,76,160,144,304,8,15,23,1,2:58
490479,2017-05-01,2017,ATL,NYN,5,7,7-5,NYN,9,false,37,39,76,132,131,263,12,16,28,3,3:00
490477,2017-05-01,2017,DET,CLE,7,1,7-1,DET,9,true,41,37,78,151,170,321,17,11,28,1,3:14
490475,2017-05-01,2017,BOS,BAL,2,5,5-2,BAL,9,false,35,36,71,160,140,300,11,7,18,2,3:10
490478,2017-05-01,2017,SLN,MIL,5,7,7-5,MIL,10,false,43,41,84,137,163,300,18,15,33,1,3:09
490480,2017-05-01,2017,CHN,PHI,2,10,10-2,PHI,9,false,35,42,77,157,149,306,8,17,25,1,3:06 (1:25 delay)
490482,2017-05-01,2017,LAN,SFN,3,4,4-3,SFN,9,false,34,34,68,139,129,268,7,9,16,1,2:52
490484,2017-05-01,2017,HOU,TEX,6,2,6-2,HOU,9,true,38,34,72,153,125,278,13,9,22,4,2:59
490476,2017-05-01,2017,KCA,CHA,6,1,6-1,KCA,9,true,36,36,72,141,125,266,14,9,23,1,2:36
490489,2017-05-02,2017,DET,CLE,5,2,5-2,DET,9,true,34,38,72,166,119,285,11,11,22,2,3:14
490492,2017-05-02,2017,SLN,MIL,2,1,2-1,SLN,9,true,34,34,68,129,158,287,10,6,16,2,2:47
490498,2017-05-02,2017,MIA,TBA,1,3,3-1,TBA,9,false,37,45,82,179,138,317,11,19,30,1,3:22
490496,2017-05-02,2017,CIN,PIT,3,12,12-3,PIT,9,false,37,45,82,177,137,314,10,19,29,1,3:00
490500,2017-05-02,2017,NYA,TOR,11,5,11-5,NYA,9,true,43,40,83,147,176,323,20,13,33,3,3:31
490493,2017-05-02,2017,ATL,NYN,9,7,9-7,ATL,9,true,40,40,80,141,140,281,19,14,33,3,2:55
490490,2017-05-02,2017,SDN,COL,6,2,6-2,SDN,9,true,34,34,68,145,142,287,10,7,17,3,2:56
490487,2017-05-02,2017,BOS,BAL,5,2,5-2,BOS,9,true,34,32,66,127,126,253,12,5,17,1,2:33
490488,2017-05-02,2017,KCA,CHA,0,6,6-0,CHA,9,false,32,40,72,165,116,281,6,15,21,1,2:43
490494,2017-05-02,2017,MIN,OAK,9,1,9-1,MIN,9,true,38,36,74,144,140,284,15,9,24,0,2:48
490499,2017-05-02,2017,HOU,TEX,8,7,8-7,HOU,9,true,38,39,77,151,142,293,14,12,26,5,3:13
490486,2017-05-02,2017,WAS,ARI,3,6,6-3,ARI,9,false,40,41,81,185,191,376,14,17,31,1,3:48
490491,2017-05-02,2017,SEA,ANA,4,6,6-4,ANA,11,false,47,52,99,212,199,411,14,21,35,5,4:40
490497,2017-05-02,2017,LAN,SFN,13,5,13-5,LAN,9,true,43,40,83,173,158,331,21,13,34,1,3:23
490495,2017-05-02,2017,CHN,PHI,8,3,8-3,CHN,9,true,39,36,75,156,168,324,17,10,27,0,3:24
490513,2017-05-03,2017,LAN,SFN,1,4,4-1,SFN,11,false,38,50,88,188,140,328,7,20,27,1,3:50
490501,2017-05-03,2017,WAS,ARI,2,1,2-1,WAS,9,true,30,38,68,159,129,288,7,12,19,0,2:52
490514,2017-05-03,2017,HOU,TEX,10,1,10-1,HOU,9,true,40,34,74,150,143,293,16,10,26,1,3:01
490503,2017-05-03,2017,KCA,CHA,6,1,6-1,KCA,9,true,34,32,66,137,126,263,11,3,14,2,2:43
490504,2017-05-03,2017,DET,CLE,2,3,3-2,CLE,9,false,35,37,72,131,142,273,9,11,20,1,3:03
490502,2017-05-03,2017,BOS,BAL,4,2,4-2,BOS,9,true,36,39,75,168,139,307,12,11,23,3,3:24
490512,2017-05-03,2017,CIN,PIT,7,2,7-2,CIN,9,true,37,39,76,154,140,294,14,13,27,0,2:48
490506,2017-05-03,2017,SEA,ANA,8,7,8-7,SEA,9,true,38,40,78,144,140,284,16,13,29,5,3:19
490511,2017-05-03,2017,CHN,PHI,5,4,5-4,CHN,9,true,37,36,73,129,155,284,14,10,24,2,3:09
490507,2017-05-03,2017,TBA,MIA,6,10,10-6,MIA,9,false,40,47,87,191,169,360,12,20,32,1,3:33
490515,2017-05-03,2017,NYA,TOR,8,6,8-6,NYA,9,true,42,39,81,153,174,327,20,13,33,4,3:39
490510,2017-05-03,2017,MIN,OAK,7,4,7-4,MIN,9,true,40,38,78,148,179,327,16,13,29,2,3:17
490509,2017-05-03,2017,ATL,NYN,5,16,16-5,NYN,9,false,41,52,93,181,183,364,14,26,40,1,3:34
490505,2017-05-03,2017,SDN,COL,3,11,11-3,COL,9,false,35,45,80,162,130,292,8,15,23,1,2:53
490523,2017-05-04,2017,SLN,MIL,4,5,5-4,MIL,9,false,42,45,87,175,163,338,16,21,37,2,3:29
490522,2017-05-04,2017,TBA,MIA,5,1,5-1,TBA,9,true,37,38,75,167,158,325,12,12,24,1,3:22
490526,2017-05-04,2017,CHN,PHI,5,4,5-4,CHN,13,false,54,57,111,225,185,410,22,22,44,2,4:22
490528,2017-05-04,2017,HOU,TEX,4,10,10-4,TEX,9,false,47,42,89,159,197,356,20,15,35,3,3:52
490517,2017-05-04,2017,BOS,BAL,3,8,8-3,BAL,9,false,36,46,82,167,140,307,10,21,31,1,3:21
490527,2017-05-04,2017,CIN,PIT,4,2,4-2,CIN,9,true,34,35,69,128,120,248,13,8,21,0,2:40 (:56 delay)
490518,2017-05-04,2017,KCA,CHA,3,8,8-3,CHA,9,false,35,42,77,168,129,297,8,16,24,3,3:00
490516,2017-05-04,2017,WAS,ARI,4,2,4-2,WAS,9,true,40,34,74,131,171,302,17,7,24,2,3:18
490521,2017-05-04,2017,SEA,ANA,11,3,11-3,SEA,9,true,43,37,80,124,154,278,22,10,32,0,2:53
490520,2017-05-04,2017,SDN,COL,2,3,3-2,COL,11,false,47,45,92,168,174,342,14,16,30,3,4:13
490525,2017-05-04,2017,MIN,OAK,5,8,8-5,OAK,9,false,39,48,87,194,168,362,12,23,35,2,3:48
490537,2017-05-05,2017,PIT,MIL,4,0,4-0,PIT,9,true,34,35,69,138,115,253,10,8,18,1,2:41 (2:27 delay)
490540,2017-05-05,2017,ATL,SLN,0,10,10-0,SLN,9,false,37,48,85,184,137,321,11,22,33,0,3:13
490534,2017-05-05,2017,ANA,HOU,6,7,7-6,HOU,10,false,38,41,79,145,136,281,12,14,26,2,3:05
490529,2017-05-05,2017,COL,ARI,3,6,6-3,ARI,9,false,37,38,75,140,137,277,10,11,21,1,2:56
490532,2017-05-05,2017,KCA,CLE,3,1,3-1,KCA,9,true,36,32,68,134,151,285,13,6,19,3,2:50
490538,2017-05-05,2017,CHN,NYA,2,3,3-2,NYA,9,false,35,39,74,171,147,318,7,15,22,1,3:17
490539,2017-05-05,2017,CIN,SFN,13,3,13-3,CIN,9,true,52,35,87,144,181,325,30,9,39,2,3:15 (1:50 delay)
490533,2017-05-05,2017,OAK,DET,2,7,7-2,DET,9,false,38,41,79,151,116,267,11,15,26,1,2:54
490535,2017-05-05,2017,SDN,LAN,2,8,8-2,LAN,9,false,36,43,79,175,167,342,10,18,28,6,4:11
490542,2017-05-05,2017,TBA,TOR,4,8,8-4,TOR,9,false,41,38,79,171,157,328,13,12,25,5,3:32
490541,2017-05-05,2017,SEA,TEX,1,3,3-1,TEX,13,false,52,50,102,206,202,408,19,12,31,1,5:02
490536,2017-05-05,2017,NYN,MIA,8,7,8-7,NYN,9,true,37,46,83,173,133,306,16,21,37,3,3:14
490543,2017-05-05,2017,PHI,WAS,2,4,4-2,WAS,9,false,40,42,82,156,175,331,14,16,30,2,3:20
490530,2017-05-05,2017,MIN,BOS,4,3,4-3,MIN,9,false,38,38,76,143,152,295,13,12,25,4,3:24
490531,2017-05-05,2017,BAL,CHA,4,2,4-2,BAL,9,true,36,39,75,161,135,296,11,15,26,6,3:17
490544,2017-05-06,2017,COL,ARI,9,1,9-1,COL,9,true,39,34,73,136,141,277,16,8,24,1,3:04
490551,2017-05-06,2017,NYN,MIA,11,3,11-3,NYN,9,true,43,37,80,126,149,275,17,12,29,3,2:48 (:39 delay)
490550,2017-05-06,2017,SDN,LAN,2,10,10-2,LAN,9,false,39,42,81,168,160,328,12,18,30,3,3:26
490549,2017-05-06,2017,ANA,HOU,2,1,2-1,ANA,9,false,32,36,68,140,116,256,8,12,20,0,2:47
490557,2017-05-06,2017,TBA,TOR,6,1,6-1,TBA,9,true,35,30,65,125,144,269,10,4,14,0,2:42
490553,2017-05-06,2017,CHN,NYA,6,11,11-6,NYA,9,false,40,45,85,187,155,342,12,20,32,3,3:19
490556,2017-05-06,2017,SEA,TEX,8,2,8-2,SEA,9,true,41,35,76,134,149,283,17,8,25,2,3:12
490558,2017-05-06,2017,PHI,WAS,2,6,6-2,WAS,9,false,35,37,72,142,161,303,13,10,23,1,3:01
490555,2017-05-06,2017,ATL,SLN,3,5,5-3,SLN,9,false,33,41,74,165,123,288,6,14,20,0,2:59
490546,2017-05-06,2017,BAL,CHA,6,5,6-5,BAL,9,true,39,37,76,156,151,307,14,10,24,1,3:04 (:43 delay)
490552,2017-05-06,2017,PIT,MIL,2,1,2-1,PIT,10,false,37,34,71,139,128,267,13,5,18,0,2:58
490547,2017-05-06,2017,KCA,CLE,1,3,3-1,CLE,9,false,32,39,71,147,113,260,5,13,18,1,2:37
490548,2017-05-06,2017,OAK,DET,6,5,6-5,OAK,9,false,35,45,80,199,132,331,9,15,24,4,3:28
490545,2017-05-06,2017,MIN,BOS,1,11,11-1,BOS,9,false,34,49,83,179,136,315,8,22,30,2,3:03
490554,2017-05-06,2017,CIN,SFN,14,2,14-2,CIN,9,true,46,36,82,131,171,302,21,10,31,1,2:46
490559,2017-05-07,2017,COL,ARI,5,2,5-2,COL,9,true,33,31,64,122,125,247,10,7,17,3,2:35 (1:22 delay)
490572,2017-05-07,2017,TBA,TOR,1,2,2-1,TOR,9,false,34,33,67,104,137,241,6,7,13,0,2:46
490561,2017-05-07,2017,BAL,CHA,4,0,4-0,BAL,9,true,38,38,76,158,134,292,14,11,25,1,3:04
490563,2017-05-07,2017,OAK,DET,8,6,8-6,OAK,9,false,40,38,78,159,159,318,15,11,26,3,3:41
490566,2017-05-07,2017,NYN,MIA,0,7,7-0,MIA,9,false,32,43,75,168,111,279,5,16,21,2,2:40
490567,2017-05-07,2017,PIT,MIL,2,6,6-2,MIL,9,false,37,39,76,134,157,291,11,12,23,4,3:07
490569,2017-05-07,2017,CIN,SFN,4,0,4-0,CIN,9,true,33,32,65,119,134,253,9,6,15,0,2:28
490564,2017-05-07,2017,ANA,HOU,3,5,5-3,HOU,9,false,36,35,71,118,159,277,10,9,19,1,3:00
490562,2017-05-07,2017,KCA,CLE,0,1,1-0,CLE,9,false,34,35,69,130,146,276,8,9,17,3,2:51
490560,2017-05-07,2017,MIN,BOS,6,17,17-6,BOS,9,false,39,52,91,184,181,365,13,28,41,5,3:46
490571,2017-05-07,2017,SEA,TEX,4,3,4-3,SEA,9,true,34,37,71,142,146,288,12,9,21,4,3:09
490573,2017-05-07,2017,PHI,WAS,6,5,6-5,PHI,10,false,43,43,86,175,174,349,17,13,30,4,3:51
490570,2017-05-07,2017,ATL,SLN,4,6,6-4,SLN,14,false,57,56,113,208,190,398,22,15,37,0,4:06
490568,2017-05-07,2017,CHN,NYA,4,5,5-4,NYA,18,false,76,70,146,294,289,583,26,15,41,1,6:05
490582,2017-05-08,2017,BAL,WAS,6,4,6-4,BAL,9,true,37,36,73,160,148,308,14,10,24,0,2:54
490577,2017-05-08,2017,OAK,ANA,3,2,3-2,OAK,11,false,38,44,82,148,154,302,6,11,17,0,3:06
490623,2017-05-08,2017,MIA,SLN,4,9,9-4,SLN,9,false,33,45,78,181,130,311,9,16,25,1,2:47
490581,2017-05-08,2017,SDN,TEX,5,1,5-1,SDN,9,true,36,34,70,146,127,273,12,8,20,1,2:38
490579,2017-05-08,2017,LAN,PIT,12,1,12-1,LAN,9,true,43,34,77,154,170,324,19,7,26,0,3:08
490580,2017-05-08,2017,NYN,SFN,4,3,4-3,NYN,9,false,41,35,76,142,174,316,16,8,24,4,3:22
490576,2017-05-08,2017,TBA,KCA,3,7,7-3,KCA,9,false,39,41,80,171,150,321,13,16,29,2,3:18
490578,2017-05-08,2017,CIN,NYA,4,10,10-4,NYA,9,false,37,48,85,193,134,327,12,23,35,1,3:28
490575,2017-05-08,2017,TOR,CLE,4,2,4-2,TOR,9,true,32,35,67,146,159,305,11,11,22,1,2:55
490591,2017-05-09,2017,CIN,NYA,5,3,5-3,CIN,9,true,37,38,75,152,126,278,13,14,27,0,2:49
490593,2017-05-09,2017,NYN,SFN,6,1,6-1,NYN,9,true,37,33,70,129,137,266,13,7,20,2,2:38
490583,2017-05-09,2017,HOU,ATL,8,3,8-3,HOU,9,true,35,37,72,136,134,270,11,10,21,2,2:41
490595,2017-05-09,2017,MIA,SLN,5,6,6-5,SLN,9,false,36,37,73,137,146,283,12,13,25,2,2:56
490589,2017-05-09,2017,OAK,ANA,3,7,7-3,ANA,9,false,39,37,76,134,157,291,14,11,25,2,3:07
490586,2017-05-09,2017,TOR,CLE,0,6,6-0,CLE,9,false,29,40,69,147,120,267,4,14,18,3,2:46
490584,2017-05-09,2017,MIL,BOS,11,7,11-7,MIL,9,true,38,43,81,209,140,349,17,18,35,3,3:38
490596,2017-05-09,2017,SDN,TEX,0,11,11-0,TEX,9,false,30,44,74,167,104,271,5,18,23,0,2:33
490590,2017-05-09,2017,CHA,MIN,2,7,7-2,MIN,9,false,35,41,76,165,141,306,9,14,23,3,2:58
490594,2017-05-09,2017,PHI,SEA,9,10,10-9,SEA,9,false,43,50,93,185,154,339,19,22,41,3,3:48
490574,2017-05-09,2017,COL,CHN,10,4,10-4,COL,9,true,41,39,80,154,146,300,18,13,31,1,3:01
490585,2017-05-09,2017,COL,CHN,1,8,8-1,CHN,9,false,37,41,78,151,144,295,10,13,23,2,3:01
490588,2017-05-09,2017,TBA,KCA,6,7,7-6,KCA,12,false,52,52,104,188,191,379,21,18,39,5,4:24
490574,2017-05-09,2017,COL,CHN,10,4,10-4,COL,9,true,41,39,80,154,146,300,18,13,31,1,3:01
490597,2017-05-09,2017,BAL,WAS,5,4,5-4,BAL,12,false,50,46,96,173,178,351,17,14,31,4,3:53
490592,2017-05-09,2017,LAN,PIT,4,3,4-3,LAN,10,false,45,35,80,146,161,307,16,6,22,4,3:38
490587,2017-05-09,2017,ARI,DET,3,7,7-3,DET,9,false,39,41,80,155,149,304,13,16,29,5,3:22
490598,2017-05-10,2017,HOU,ATL,4,2,4-2,HOU,9,true,35,34,69,142,138,280,13,10,23,0,2:49
490604,2017-05-10,2017,TBA,KCA,12,1,12-1,TBA,9,true,43,35,78,122,127,249,21,9,30,0,2:49
490603,2017-05-10,2017,ARI,DET,7,1,7-1,ARI,9,true,41,30,71,119,130,249,19,6,25,0,2:37
490607,2017-05-10,2017,LAN,PIT,5,2,5-2,LAN,9,true,33,32,65,110,122,232,12,5,17,1,2:37
490601,2017-05-10,2017,COL,CHN,3,0,3-0,COL,9,true,32,31,63,113,119,232,8,4,12,1,2:14 (:50 delay)
490608,2017-05-10,2017,TEX,SDN,4,3,4-3,TEX,9,true,35,38,73,143,139,282,16,11,27,2,3:24
490599,2017-05-10,2017,WAS,BAL,7,6,7-6,WAS,9,false,43,38,81,138,192,330,20,13,33,2,3:17
490600,2017-05-10,2017,MIL,BOS,7,4,7-4,MIL,9,true,37,40,77,165,142,307,14,16,30,4,3:37
490605,2017-05-10,2017,OAK,ANA,3,1,3-1,OAK,9,true,34,34,68,148,153,301,11,7,18,2,2:55
490611,2017-05-10,2017,MIA,SLN,5,7,7-5,SLN,9,false,43,43,86,160,208,368,18,17,35,2,3:46
490602,2017-05-10,2017,TOR,CLE,8,7,8-7,TOR,9,false,42,40,82,163,184,347,17,15,32,4,3:31
490610,2017-05-10,2017,PHI,SEA,6,11,11-6,SEA,9,false,43,51,94,180,174,354,16,25,41,1,3:40
490609,2017-05-10,2017,NYN,SFN,5,6,6-5,SFN,9,false,43,43,86,160,158,318,15,15,30,6,3:33
490621,2017-05-11,2017,TEX,SDN,5,2,5-2,TEX,9,false,33,36,69,120,117,237,10,12,22,2,2:39
490617,2017-05-11,2017,TBA,KCA,0,6,6-0,KCA,9,false,29,38,67,170,119,289,5,12,17,1,2:41
490620,2017-05-11,2017,ARI,PIT,2,1,2-1,ARI,9,true,31,28,59,128,113,241,8,3,11,0,2:34
490613,2017-05-11,2017,MIL,BOS,1,4,4-1,BOS,9,false,32,40,72,171,138,309,6,14,20,3,3:29
490619,2017-05-11,2017,CHA,MIN,6,7,7-6,MIN,9,false,39,38,77,154,158,312,12,12,24,4,3:27
490615,2017-05-11,2017,ANA,DET,1,7,7-1,DET,9,false,35,41,76,153,142,295,7,15,22,0,3:00
490622,2017-05-11,2017,TOR,SEA,7,2,7-2,TOR,9,true,36,37,73,145,136,281,13,10,23,0,2:45
490614,2017-05-11,2017,SFN,CIN,2,3,3-2,CIN,9,false,38,35,73,124,133,257,12,10,22,1,2:36
490616,2017-05-11,2017,NYA,HOU,2,3,3-2,HOU,9,false,38,38,76,144,153,297,11,12,23,2,3:09
490618,2017-05-11,2017,COL,LAN,10,7,10-7,COL,9,true,44,43,87,148,166,314,20,17,37,3,3:23
490629,2017-05-12,2017,NYA,HOU,1,5,5-1,HOU,9,false,35,40,75,148,141,289,7,13,20,1,3:09
490626,2017-05-12,2017,SLN,CHN,2,3,3-2,CHN,9,false,36,39,75,147,166,313,10,11,21,2,3:01
490630,2017-05-12,2017,COL,LAN,2,6,6-2,LAN,9,false,33,37,70,145,120,265,9,13,22,2,2:53
490628,2017-05-12,2017,ANA,DET,7,0,7-0,ANA,9,true,40,32,72,132,140,272,17,6,23,1,3:04
490625,2017-05-12,2017,KCA,BAL,3,2,3-2,KCA,9,true,34,36,70,122,164,286,12,11,23,0,2:37
490632,2017-05-12,2017,MIL,NYN,7,4,7-4,MIL,9,true,41,36,77,149,149,298,19,12,31,2,3:08
490631,2017-05-12,2017,CLE,MIN,0,1,1-0,MIN,9,false,35,32,67,118,124,242,8,7,15,2,2:30
490638,2017-05-12,2017,BOS,TBA,4,5,5-4,TBA,9,false,37,38,75,150,147,297,9,11,20,5,3:24
490633,2017-05-12,2017,TEX,OAK,5,2,5-2,TEX,9,false,35,34,69,146,115,261,12,9,21,1,2:58
490635,2017-05-12,2017,ARI,PIT,11,4,11-4,ARI,9,true,43,36,79,127,161,288,20,9,29,1,2:57
490637,2017-05-12,2017,TOR,SEA,4,0,4-0,TOR,9,true,34,34,68,130,99,229,11,7,18,4,2:36
490624,2017-05-12,2017,MIA,ATL,4,8,8-4,ATL,9,false,39,43,82,171,149,320,13,20,33,2,3:11
490636,2017-05-12,2017,CHA,SDN,3,6,6-3,SDN,9,false,37,41,78,149,133,282,10,14,24,3,3:16
490627,2017-05-12,2017,SFN,CIN,3,2,3-2,SFN,17,false,58,69,127,269,222,491,13,22,35,2,5:28
490643,2017-05-13,2017,ANA,DET,3,4,4-3,DET,9,false,37,36,73,137,146,283,11,10,21,1,3:14
490648,2017-05-13,2017,TEX,OAK,6,5,6-5,TEX,9,true,37,36,73,139,165,304,14,12,26,2,3:26
490647,2017-05-13,2017,MIL,NYN,11,4,11-4,MIL,9,true,44,40,84,173,158,331,20,14,34,1,3:27
490649,2017-05-13,2017,WAS,PHI,6,4,6-4,WAS,9,false,39,39,78,200,155,355,14,14,28,4,3:34
490641,2017-05-13,2017,SLN,CHN,5,3,5-3,SLN,9,true,34,37,71,127,151,278,13,10,23,2,2:51
490653,2017-05-13,2017,BOS,TBA,6,3,6-3,BOS,9,true,33,32,65,153,147,300,10,5,15,1,2:54
490645,2017-05-13,2017,COL,LAN,0,4,4-0,LAN,9,false,34,37,71,160,141,301,8,11,19,1,3:18
490640,2017-05-13,2017,KCA,BAL,4,3,4-3,KCA,9,true,38,35,73,147,157,304,15,8,23,1,3:04
490642,2017-05-13,2017,SFN,CIN,3,1,3-1,SFN,9,true,31,39,70,145,98,243,8,12,20,1,2:33
490652,2017-05-13,2017,TOR,SEA,7,2,7-2,TOR,9,true,38,40,78,154,140,294,12,16,28,4,3:25
490650,2017-05-13,2017,ARI,PIT,3,4,4-3,PIT,9,false,37,39,76,142,146,288,11,14,25,1,3:00
490646,2017-05-13,2017,CLE,MIN,1,4,4-1,MIN,9,false,32,35,67,155,125,280,5,11,16,2,2:57
490639,2017-05-13,2017,MIA,ATL,1,3,3-1,ATL,9,false,34,37,71,132,135,267,7,11,18,0,2:49
490651,2017-05-13,2017,CHA,SDN,5,4,5-4,CHA,9,false,38,37,75,160,148,308,13,10,23,4,3:16
490654,2017-05-14,2017,MIA,ATL,3,1,3-1,MIA,9,true,32,40,72,119,114,233,10,17,27,1,2:27
490658,2017-05-14,2017,ANA,DET,4,1,4-1,ANA,9,true,35,31,66,132,132,264,12,7,19,4,3:09
490664,2017-05-14,2017,WAS,PHI,3,4,4-3,PHI,9,false,37,38,75,168,121,289,12,14,26,3,3:02
490663,2017-05-14,2017,TEX,OAK,6,4,6-4,TEX,9,true,35,39,74,130,125,255,14,14,28,4,2:51
490655,2017-05-14,2017,KCA,BAL,9,8,9-8,KCA,9,true,44,47,91,175,182,357,19,20,39,5,3:31
490656,2017-05-14,2017,SLN,CHN,5,0,5-0,SLN,9,true,37,33,70,130,133,263,14,8,22,0,2:38
490667,2017-05-14,2017,TOR,SEA,3,2,3-2,TOR,9,false,37,35,72,128,164,292,12,9,21,3,3:17
490661,2017-05-14,2017,CLE,MIN,8,3,8-3,CLE,9,true,40,36,76,151,160,311,17,10,27,3,3:00
490634,2017-05-14,2017,WAS,PHI,6,5,6-5,WAS,9,true,36,39,75,149,157,306,13,13,26,2,3:34
490644,2017-05-14,2017,NYA,HOU,7,10,10-7,HOU,9,false,43,41,84,169,188,357,17,13,30,5,3:49
490659,2017-05-14,2017,NYA,HOU,11,6,11-6,NYA,9,true,40,41,81,181,158,339,15,15,30,4,3:20
490657,2017-05-14,2017,SFN,CIN,8,3,8-3,SFN,9,true,39,36,75,146,133,279,14,11,25,2,2:55
490660,2017-05-14,2017,COL,LAN,9,6,9-6,COL,9,true,36,44,80,174,144,318,16,18,34,5,3:38
490666,2017-05-14,2017,CHA,SDN,9,3,9-3,CHA,9,true,41,35,76,148,155,303,18,10,28,2,3:16
490634,2017-05-14,2017,WAS,PHI,6,5,6-5,WAS,9,true,36,39,75,149,157,306,13,13,26,2,3:34
490662,2017-05-14,2017,MIL,NYN,11,9,11-9,MIL,9,true,42,42,84,163,180,343,18,17,35,5,3:33
490644,2017-05-14,2017,NYA,HOU,7,10,10-7,HOU,9,false,43,41,84,169,188,357,17,13,30,5,3:49
490665,2017-05-14,2017,ARI,PIT,4,6,6-4,PIT,10,false,49,46,95,191,190,381,22,16,38,1,4:08
490668,2017-05-14,2017,BOS,TBA,2,11,11-2,TBA,9,false,38,48,86,203,167,370,10,22,32,6,4:32
490669,2017-05-15,2017,TOR,ATL,6,10,10-6,ATL,9,false,43,46,89,157,159,316,15,21,36,4,3:15
490676,2017-05-15,2017,CLE,TBA,8,7,8-7,CLE,9,true,41,45,86,175,133,308,19,19,38,4,3:33
490675,2017-05-15,2017,SEA,OAK,6,5,6-5,SEA,9,true,35,41,76,166,147,313,11,15,26,4,3:14
490671,2017-05-15,2017,MIA,HOU,2,7,7-2,HOU,9,false,38,40,78,148,146,294,14,16,30,1,2:57
490674,2017-05-15,2017,ARI,NYN,7,3,7-3,ARI,9,true,39,37,76,136,151,287,17,10,27,4,3:02
490672,2017-05-15,2017,SFN,LAN,8,4,8-4,SFN,9,true,37,37,74,162,143,305,12,12,24,5,3:09
490670,2017-05-15,2017,ANA,CHA,5,3,5-3,ANA,9,true,34,35,69,137,152,289,10,8,18,3,3:01
490673,2017-05-15,2017,SDN,MIL,6,5,6-5,SDN,10,false,43,41,84,152,166,318,18,13,31,2,3:37
490686,2017-05-16,2017,ARI,NYN,5,4,5-4,ARI,9,true,34,35,69,144,138,282,13,8,21,3,2:52
490690,2017-05-16,2017,CLE,TBA,4,6,6-4,TBA,9,false,35,39,74,159,137,296,9,13,22,2,3:12
490687,2017-05-16,2017,KCA,NYA,1,7,7-1,NYA,9,false,37,43,80,172,126,298,11,16,27,1,3:02
490685,2017-05-16,2017,SDN,MIL,2,6,6-2,MIL,9,false,34,39,73,138,130,268,9,13,22,1,2:41
490684,2017-05-16,2017,SFN,LAN,2,1,2-1,SFN,9,true,33,34,67,132,133,265,12,9,21,1,2:47
490688,2017-05-16,2017,SEA,OAK,6,9,9-6,OAK,9,false,38,44,82,167,159,326,14,18,32,3,3:25
490682,2017-05-16,2017,MIN,COL,3,7,7-3,COL,9,false,37,38,75,135,150,285,11,11,22,3,3:13
490689,2017-05-16,2017,TEX,PHI,5,1,5-1,TEX,9,true,35,33,68,112,128,240,11,6,17,0,2:44
490677,2017-05-16,2017,TOR,ATL,5,9,9-5,ATL,9,false,37,42,79,147,140,287,12,18,30,3,3:07
490681,2017-05-16,2017,CHN,CIN,9,5,9-5,CHN,9,true,40,40,80,168,141,309,18,13,31,2,3:07
490679,2017-05-16,2017,SLN,BOS,3,6,6-3,BOS,9,false,36,37,73,150,157,307,10,10,20,3,3:21
490678,2017-05-16,2017,DET,BAL,11,13,13-11,BAL,13,false,65,63,128,242,255,497,30,24,54,7,5:19
490683,2017-05-16,2017,MIA,HOU,2,12,12-2,HOU,9,false,34,47,81,186,126,312,6,19,25,2,3:00
490691,2017-05-16,2017,PIT,WAS,4,8,8-4,WAS,9,false,38,41,79,161,178,339,11,16,27,4,3:30
490680,2017-05-16,2017,ANA,CHA,7,6,7-6,ANA,11,false,48,45,93,153,187,340,21,13,34,3,4:01
490704,2017-05-17,2017,CLE,TBA,4,7,7-4,TBA,9,false,37,39,76,135,146,281,10,14,24,4,3:20
490706,2017-05-17,2017,PIT,WAS,6,1,6-1,PIT,9,true,37,32,69,134,143,277,15,6,21,2,3:03
490699,2017-05-17,2017,SDN,MIL,1,3,3-1,MIL,9,false,35,36,71,136,144,280,8,9,17,0,2:51
490700,2017-05-17,2017,ARI,NYN,5,4,5-4,ARI,11,false,43,46,89,186,159,345,13,15,28,2,3:30
490698,2017-05-17,2017,SFN,LAN,1,6,6-1,LAN,9,false,30,38,68,139,118,257,4,11,15,0,2:37
490694,2017-05-17,2017,ANA,CHA,12,8,12-8,ANA,9,true,41,42,83,146,156,302,19,17,36,5,3:28
490702,2017-05-17,2017,SEA,OAK,4,0,4-0,SEA,9,true,34,31,65,125,153,278,9,4,13,1,2:39
490705,2017-05-17,2017,ATL,TOR,8,4,8-4,ATL,9,true,37,36,73,148,138,286,12,10,22,2,2:59
490695,2017-05-17,2017,CHN,CIN,7,5,7-5,CHN,9,true,37,39,76,167,154,321,13,12,25,2,3:06
490703,2017-05-17,2017,TEX,PHI,9,3,9-3,TEX,9,true,43,34,77,114,146,260,23,11,34,1,2:48
490697,2017-05-17,2017,MIA,HOU,0,3,3-0,HOU,9,false,36,40,76,150,144,294,9,12,21,1,2:52
490692,2017-05-17,2017,DET,BAL,5,4,5-4,DET,9,true,37,39,76,144,153,297,14,12,26,2,3:15
490693,2017-05-17,2017,SLN,BOS,4,5,5-4,BOS,13,false,52,53,105,197,194,391,17,17,34,2,4:20
490701,2017-05-17,2017,KCA,NYA,7,11,11-7,NYA,9,false,40,46,86,182,156,338,14,21,35,3,3:23
490696,2017-05-18,2017,MIN,COL,2,0,2-0,MIN,9,true,37,32,69,124,156,280,14,7,21,1,2:52
490717,2017-05-18,2017,PIT,WAS,10,4,10-4,PIT,9,true,41,37,78,150,176,326,18,10,28,3,3:17
490707,2017-05-18,2017,DET,BAL,6,5,6-5,DET,9,true,36,36,72,140,127,267,15,9,24,1,2:53
490709,2017-05-18,2017,SEA,CHA,5,4,5-4,SEA,9,false,38,38,76,149,135,284,14,11,25,0,3:02
490713,2017-05-18,2017,SDN,MIL,2,4,4-2,MIL,9,false,35,38,73,137,140,277,10,14,24,1,3:01
490696,2017-05-18,2017,MIN,COL,2,0,2-0,MIN,9,true,37,32,69,124,156,280,14,7,21,1,2:52
490712,2017-05-18,2017,LAN,MIA,7,2,7-2,LAN,9,true,40,36,76,137,151,288,22,11,33,3,3:16
490716,2017-05-18,2017,ATL,TOR,0,9,9-0,TOR,9,false,35,43,78,165,140,305,8,17,25,2,3:02 (:37 delay)
490710,2017-05-18,2017,CHN,CIN,9,5,9-5,CHN,9,true,41,42,83,155,156,311,19,14,33,2,3:03
490714,2017-05-18,2017,KCA,NYA,5,1,5-1,KCA,9,true,31,36,67,141,117,258,8,9,17,0,2:34
490708,2017-05-18,2017,OAK,BOS,8,3,8-3,OAK,9,true,37,35,72,145,163,308,16,9,25,1,3:09
490711,2017-05-18,2017,MIN,COL,1,5,5-1,COL,9,false,37,35,72,130,159,289,11,11,22,3,2:53
490715,2017-05-18,2017,TEX,PHI,8,4,8-4,TEX,9,true,39,35,74,134,184,318,16,8,24,3,3:12
490724,2017-05-19,2017,NYN,ANA,3,0,3-0,NYN,9,true,35,36,71,143,130,273,10,11,21,1,2:53
490730,2017-05-19,2017,DET,TEX,3,5,5-3,TEX,9,false,40,36,76,148,183,331,12,12,24,1,3:23
490727,2017-05-19,2017,TBA,NYA,5,4,5-4,TBA,9,true,40,35,75,119,158,277,16,11,27,4,3:18
490725,2017-05-19,2017,LAN,MIA,7,2,7-2,LAN,9,true,36,36,72,122,141,263,13,12,25,1,2:58
490718,2017-05-19,2017,SDN,ARI,1,10,10-1,ARI,9,false,34,49,83,215,134,349,8,23,31,2,3:12
490720,2017-05-19,2017,SEA,CHA,1,2,2-1,CHA,10,false,33,39,72,140,123,263,2,10,12,0,2:46
490728,2017-05-19,2017,PIT,PHI,2,7,7-2,PHI,9,false,32,38,70,136,125,261,4,11,15,1,2:54
490719,2017-05-19,2017,OAK,BOS,3,2,3-2,OAK,10,false,34,42,76,166,139,305,8,14,22,0,3:12
490723,2017-05-19,2017,MIN,KCA,4,3,4-3,MIN,10,false,42,41,83,154,162,316,15,12,27,1,3:20
490729,2017-05-19,2017,SLN,SFN,5,6,6-5,SFN,9,false,37,45,82,168,123,291,13,21,34,4,3:15 (:46 delay)
490721,2017-05-19,2017,HOU,CLE,3,5,5-3,CLE,9,false,34,40,74,162,142,304,7,14,21,4,3:02
490732,2017-05-19,2017,ATL,WAS,7,4,7-4,ATL,9,true,42,38,80,161,177,338,20,12,32,2,3:32
490731,2017-05-19,2017,BAL,TOR,5,3,5-3,BAL,10,false,42,41,83,169,156,325,13,13,26,0,3:29 (1:27 delay)
490726,2017-05-19,2017,CHN,MIL,3,6,6-3,MIL,9,false,35,46,81,209,144,353,7,19,26,1,3:27 (1:59 delay)
490722,2017-05-19,2017,CIN,COL,6,12,12-6,COL,9,false,39,50,89,203,164,367,13,24,37,1,3:38
490735,2017-05-20,2017,SEA,CHA,1,16,16-1,CHA,9,false,31,47,78,166,126,292,8,21,29,1,2:52
490733,2017-05-20,2017,SDN,ARI,1,9,9-1,ARI,9,false,37,45,82,170,146,316,10,19,29,2,2:56
490747,2017-05-20,2017,ATL,WAS,5,2,5-2,ATL,9,true,36,35,71,160,159,319,13,8,21,1,3:20 (1:50 delay)
490736,2017-05-20,2017,HOU,CLE,0,3,3-0,CLE,9,false,30,35,65,125,134,259,5,9,14,2,2:35
490746,2017-05-20,2017,BAL,TOR,7,5,7-5,BAL,9,true,40,38,78,159,150,309,19,13,32,4,3:22
490743,2017-05-20,2017,PIT,PHI,6,3,6-3,PIT,9,true,39,35,74,107,162,269,15,9,24,2,2:52
490745,2017-05-20,2017,DET,TEX,9,3,9-3,DET,9,true,37,35,72,146,148,294,13,7,20,1,2:58
490734,2017-05-20,2017,OAK,BOS,8,3,8-3,OAK,9,true,40,35,75,145,196,341,16,7,23,1,3:22
490742,2017-05-20,2017,TBA,NYA,9,5,9-5,TBA,9,true,43,37,80,157,177,334,20,10,30,4,3:50
490744,2017-05-20,2017,SLN,SFN,1,3,3-1,SFN,13,false,48,45,93,151,169,320,11,8,19,2,3:42 (:42 delay)
490740,2017-05-20,2017,LAN,MIA,6,10,10-6,MIA,9,false,38,44,82,175,159,334,11,18,29,3,3:27
490739,2017-05-20,2017,NYN,ANA,7,5,7-5,NYN,9,true,39,42,81,179,146,325,16,17,33,5,3:37
490737,2017-05-20,2017,CIN,COL,12,8,12-8,CIN,9,true,45,43,88,158,165,323,22,19,41,3,3:32
490762,2017-05-21,2017,ATL,WAS,2,3,3-2,WAS,9,false,33,35,68,111,133,244,7,7,14,1,2:50
490755,2017-05-21,2017,LAN,MIA,6,3,6-3,LAN,9,true,39,35,74,118,151,269,16,9,25,1,2:46
490757,2017-05-21,2017,TBA,NYA,2,3,3-2,NYA,9,false,32,38,70,158,146,304,6,10,16,4,3:26
490753,2017-05-21,2017,MIN,KCA,4,6,6-4,KCA,9,false,41,42,83,163,174,337,15,18,33,3,3:21
490759,2017-05-21,2017,SLN,SFN,8,3,8-3,SLN,9,true,37,37,74,158,137,295,15,10,25,2,2:53
490758,2017-05-21,2017,PIT,PHI,1,0,1-0,PIT,9,true,32,33,65,150,108,258,11,5,16,2,2:45
490738,2017-05-21,2017,MIN,KCA,8,4,8-4,MIN,9,true,40,34,74,113,156,269,17,9,26,0,2:29
490761,2017-05-21,2017,BAL,TOR,1,3,3-1,TOR,9,false,35,34,69,133,135,268,9,8,17,1,2:31
490748,2017-05-21,2017,SDN,ARI,5,1,5-1,SDN,9,true,34,32,66,96,117,213,12,5,17,0,2:16
490750,2017-05-21,2017,SEA,CHA,1,8,8-1,CHA,9,false,32,42,74,160,118,278,9,16,25,2,2:46
490738,2017-05-21,2017,MIN,KCA,8,4,8-4,MIN,9,true,40,34,74,113,156,269,17,9,26,0,2:29
490751,2017-05-21,2017,HOU,CLE,6,8,8-6,CLE,9,false,36,42,78,165,158,323,10,16,26,2,3:06
490749,2017-05-21,2017,OAK,BOS,3,12,12-3,BOS,9,false,34,46,80,182,115,297,7,21,28,2,3:11
490760,2017-05-21,2017,DET,TEX,2,5,5-2,TEX,9,false,38,43,81,150,153,303,11,20,31,2,3:35
490752,2017-05-21,2017,CIN,COL,4,6,6-4,COL,9,false,38,42,80,146,138,284,13,16,29,3,3:14
490756,2017-05-21,2017,CHN,MIL,13,6,13-6,CHN,9,true,44,44,88,165,164,329,21,17,38,2,3:32
490754,2017-05-21,2017,NYN,ANA,5,12,12-5,ANA,9,false,35,47,82,182,138,320,9,23,32,2,3:17
490765,2017-05-22,2017,PHI,COL,1,8,8-1,COL,9,false,30,41,71,157,128,285,3,14,17,2,3:03
490766,2017-05-22,2017,HOU,DET,1,0,1-0,HOU,9,true,34,29,63,119,134,253,11,4,15,1,2:45
490764,2017-05-22,2017,CIN,CLE,5,1,5-1,CIN,9,true,33,35,68,143,95,238,10,9,19,2,2:39
490768,2017-05-22,2017,TBA,ANA,2,3,3-2,ANA,9,false,35,38,73,162,153,315,10,15,25,4,3:37
490771,2017-05-22,2017,CHN,SFN,4,6,6-4,SFN,9,false,36,40,76,165,127,292,12,14,26,4,2:59
490769,2017-05-22,2017,BAL,MIN,7,14,14-7,MIN,9,false,42,51,93,190,146,336,16,24,40,3,3:31
490770,2017-05-22,2017,ATL,PIT,5,2,5-2,ATL,9,true,39,38,77,165,152,317,17,12,29,3,3:23
490767,2017-05-22,2017,NYA,KCA,4,2,4-2,NYA,9,true,32,35,67,141,123,264,9,8,17,1,2:42
490763,2017-05-22,2017,ARI,CHA,5,1,5-1,ARI,9,true,33,31,64,105,131,236,10,5,15,3,2:39
490777,2017-05-23,2017,TBA,ANA,0,4,4-0,ANA,9,false,32,37,69,132,126,258,6,14,20,3,2:56
490782,2017-05-23,2017,CHN,SFN,4,1,4-1,CHN,9,true,29,29,58,99,120,219,6,4,10,0,2:05 (1:05 delay)
490783,2017-05-23,2017,WAS,SEA,10,1,10-1,WAS,9,true,38,30,68,115,138,253,17,5,22,0,2:28
490784,2017-05-23,2017,LAN,SLN,2,1,2-1,LAN,13,false,46,42,88,165,209,374,8,4,12,1,4:05
490775,2017-05-23,2017,HOU,DET,6,2,6-2,HOU,9,true,37,35,72,166,127,293,13,9,22,2,3:01
490785,2017-05-23,2017,BOS,TEX,11,6,11-6,BOS,9,true,43,38,81,145,170,315,21,14,35,3,3:23
490781,2017-05-23,2017,NYN,SDN,9,3,9-3,NYN,9,true,38,37,75,167,144,311,15,11,26,2,2:56
490779,2017-05-23,2017,BAL,MIN,0,2,2-0,MIN,9,false,31,35,66,129,105,234,4,9,13,0,2:23
490774,2017-05-23,2017,PHI,COL,2,8,8-2,COL,9,false,38,36,74,140,147,287,13,12,25,0,2:44
490780,2017-05-23,2017,ATL,PIT,6,5,6-5,ATL,9,false,41,45,86,152,136,288,20,20,40,2,3:03 (3:12 delay)
490772,2017-05-23,2017,ARI,CHA,5,4,5-4,ARI,9,true,31,39,70,135,117,252,9,14,23,4,2:56
490773,2017-05-23,2017,CIN,CLE,7,8,8-7,CLE,9,false,43,40,83,153,169,322,18,12,30,3,3:16
490786,2017-05-23,2017,MIL,TOR,3,4,4-3,TOR,9,false,37,37,74,140,149,289,11,12,23,2,3:02
490778,2017-05-23,2017,OAK,MIA,9,11,11-9,MIA,9,false,43,47,90,197,178,375,16,21,37,4,3:46
490776,2017-05-23,2017,NYA,KCA,2,6,6-2,KCA,9,false,37,35,72,147,133,280,12,8,20,2,2:47
490798,2017-05-24,2017,WAS,SEA,5,1,5-1,WAS,9,true,35,35,70,131,107,238,13,9,22,1,2:28
490794,2017-05-24,2017,BAL,MIN,3,4,4-3,MIN,9,false,35,40,75,156,123,279,9,13,22,1,3:00
490792,2017-05-24,2017,TBA,ANA,5,2,5-2,TBA,9,true,33,33,66,127,132,259,12,6,18,1,2:52
490800,2017-05-24,2017,BOS,TEX,9,4,9-4,BOS,9,true,39,35,74,119,167,286,19,8,27,3,2:59
490787,2017-05-24,2017,ARI,CHA,8,6,8-6,ARI,9,true,34,39,73,174,116,290,12,14,26,2,3:02
490796,2017-05-24,2017,NYN,SDN,5,6,6-5,SDN,9,false,44,40,84,150,187,337,17,14,31,3,3:28
490791,2017-05-24,2017,NYA,KCA,3,0,3-0,NYA,9,true,33,31,64,127,122,249,9,5,14,2,2:40
490797,2017-05-24,2017,CHN,SFN,5,4,5-4,CHN,9,true,36,38,74,161,116,277,14,11,25,3,3:05
490788,2017-05-24,2017,CLE,CIN,3,4,4-3,CIN,9,false,39,39,78,159,148,307,15,11,26,1,3:07 (2:01 delay)
490789,2017-05-24,2017,PHI,COL,2,7,7-2,COL,9,false,34,41,75,147,161,308,9,16,25,1,3:09
490795,2017-05-24,2017,ATL,PIT,5,12,12-5,PIT,10,false,44,52,96,213,160,373,15,22,37,3,4:02
490793,2017-05-24,2017,OAK,MIA,4,1,4-1,OAK,9,true,35,34,69,124,129,253,13,6,19,0,2:38
490799,2017-05-24,2017,LAN,SLN,1,6,6-1,SLN,9,false,30,43,73,170,108,278,4,18,22,1,2:44
490790,2017-05-24,2017,HOU,DET,3,6,6-3,DET,9,false,36,37,73,141,135,276,8,13,21,1,2:52
490801,2017-05-24,2017,MIL,TOR,4,8,8-4,TOR,9,false,34,38,72,130,150,280,9,11,20,2,2:51
490808,2017-05-25,2017,ATL,PIT,4,9,9-4,PIT,9,false,38,43,81,150,110,260,12,18,30,1,2:41
490802,2017-05-25,2017,MIL,ARI,0,4,4-0,ARI,9,false,30,36,66,145,125,270,4,11,15,1,2:45
490807,2017-05-25,2017,TBA,ANA,4,0,4-0,TBA,9,true,37,35,72,128,135,263,13,10,23,1,3:04
490810,2017-05-25,2017,CHN,SFN,5,1,5-1,CHN,9,true,33,33,66,110,137,247,10,8,18,0,2:33
490813,2017-05-25,2017,BOS,TEX,6,2,6-2,BOS,9,true,38,33,71,153,157,310,17,5,22,2,3:23 (:28 delay)
490805,2017-05-25,2017,HOU,DET,7,6,7-6,HOU,9,true,38,44,82,173,145,318,15,21,36,3,3:30
490809,2017-05-25,2017,NYN,SDN,3,4,4-3,SDN,9,false,39,42,81,180,170,350,14,15,29,2,3:16
490812,2017-05-25,2017,LAN,SLN,7,3,7-3,LAN,9,true,35,37,72,129,154,283,13,14,27,1,3:03
490811,2017-05-25,2017,WAS,SEA,2,4,4-2,SEA,9,false,36,39,75,173,142,315,9,15,24,5,3:18
490804,2017-05-25,2017,PHI,COL,2,1,2-1,PHI,11,false,42,43,85,161,155,316,12,12,24,2,3:39
490822,2017-05-26,2017,PIT,NYN,1,8,8-1,NYN,9,false,34,44,78,169,123,292,7,16,23,2,2:57
490815,2017-05-26,2017,SFN,ATL,0,2,2-0,ATL,9,false,34,36,70,117,118,235,8,12,20,1,2:40
490816,2017-05-26,2017,HOU,BAL,2,0,2-0,HOU,9,true,34,33,67,127,120,247,10,7,17,1,2:31
490818,2017-05-26,2017,PHI,CIN,2,5,5-2,CIN,9,false,33,36,69,134,121,255,7,9,16,1,2:34
490817,2017-05-26,2017,LAN,CHN,4,0,4-0,LAN,9,true,31,31,62,137,128,265,9,6,15,0,2:49
490826,2017-05-26,2017,COL,SLN,10,0,10-0,COL,9,true,38,28,66,110,131,241,16,5,21,2,2:25
490819,2017-05-26,2017,CHA,DET,8,2,8-2,CHA,9,true,41,37,78,163,171,334,19,8,27,3,3:42 (1:25 delay)
490827,2017-05-26,2017,MIN,TBA,2,5,5-2,TBA,9,false,34,36,70,161,126,287,7,9,16,4,3:04
490823,2017-05-26,2017,NYA,OAK,1,4,4-1,OAK,9,false,34,37,71,144,149,293,8,10,18,1,3:09
490820,2017-05-26,2017,CLE,KCA,4,6,6-4,KCA,9,false,36,39,75,133,152,285,9,13,22,3,2:57
490825,2017-05-26,2017,BOS,SEA,3,0,3-0,BOS,9,true,38,34,72,143,154,297,15,9,24,1,3:11
490828,2017-05-26,2017,TOR,TEX,7,6,7-6,TOR,9,true,37,42,79,159,156,315,14,15,29,5,3:30
490814,2017-05-26,2017,MIL,ARI,2,4,4-2,ARI,10,false,40,42,82,154,149,303,14,12,26,1,3:24
490821,2017-05-26,2017,MIA,ANA,8,5,8-5,MIA,9,true,40,39,79,156,147,303,20,11,31,3,3:13
490824,2017-05-26,2017,WAS,SDN,5,1,5-1,WAS,9,true,36,32,68,112,132,244,13,6,19,1,2:25
490832,2017-05-27,2017,LAN,CHN,5,0,5-0,LAN,9,true,37,32,69,123,145,268,12,5,17,0,2:41
490831,2017-05-27,2017,HOU,BAL,5,2,5-2,HOU,9,true,37,34,71,132,144,276,15,9,24,3,2:56
490838,2017-05-27,2017,NYA,OAK,3,2,3-2,NYA,9,true,31,37,68,151,153,304,8,11,19,4,3:14
490830,2017-05-27,2017,SFN,ATL,6,3,6-3,SFN,9,true,35,37,72,127,125,252,13,12,25,2,2:31
490842,2017-05-27,2017,MIN,TBA,5,3,5-3,MIN,9,true,40,37,77,150,172,322,17,11,28,3,3:35
490833,2017-05-27,2017,PHI,CIN,4,3,4-3,PHI,9,false,31,39,70,156,123,279,8,13,21,1,2:47
490836,2017-05-27,2017,MIA,ANA,2,5,5-2,ANA,9,false,34,40,74,143,129,272,10,14,24,3,3:03
490835,2017-05-27,2017,CLE,KCA,2,5,5-2,KCA,9,false,39,41,80,152,144,296,14,17,31,4,3:06
490829,2017-05-27,2017,MIL,ARI,6,1,6-1,MIL,9,true,32,32,64,144,135,279,9,7,16,2,2:52
490124,2017-05-27,2017,CHA,DET,3,4,4-3,DET,9,false,36,43,79,176,151,327,10,17,27,3,3:14
490841,2017-05-27,2017,COL,SLN,0,3,3-0,SLN,9,false,35,39,74,150,162,312,7,14,21,1,3:15
490843,2017-05-27,2017,TOR,TEX,3,1,3-1,TOR,9,true,38,33,71,146,145,291,13,7,20,3,3:16
490837,2017-05-27,2017,PIT,NYN,5,4,5-4,PIT,10,false,45,44,89,164,177,341,18,13,31,3,3:33
490124,2017-05-27,2017,CHA,DET,3,4,4-3,DET,9,false,36,43,79,176,151,327,10,17,27,3,3:14
490840,2017-05-27,2017,BOS,SEA,6,0,6-0,BOS,9,true,35,32,67,109,124,233,13,5,18,1,2:23
490839,2017-05-27,2017,WAS,SDN,3,0,3-0,WAS,9,true,35,33,68,132,146,278,12,4,16,0,2:49
490834,2017-05-27,2017,CHA,DET,3,0,3-0,CHA,9,true,32,39,71,185,96,281,10,13,23,0,2:54
490124,2017-05-27,2017,CHA,DET,3,4,4-3,DET,9,false,36,43,79,176,151,327,10,17,27,3,3:14
490848,2017-05-28,2017,PHI,CIN,4,8,8-4,CIN,9,false,36,38,74,137,141,278,13,13,26,0,2:50
490849,2017-05-28,2017,CHA,DET,7,3,7-3,CHA,9,true,36,34,70,130,120,250,13,6,19,2,2:44 (:30 delay)
490855,2017-05-28,2017,BOS,SEA,0,5,5-0,SEA,9,false,32,41,73,155,118,273,8,17,25,4,3:14
490845,2017-05-28,2017,SFN,ATL,7,1,7-1,SFN,9,true,35,36,71,152,109,261,11,10,21,0,2:29
490853,2017-05-28,2017,NYA,OAK,9,5,9-5,NYA,9,true,38,36,74,155,141,296,14,10,24,2,3:09
490844,2017-05-28,2017,MIL,ARI,9,5,9-5,MIL,9,true,42,39,81,155,149,304,18,13,31,3,3:08
490854,2017-05-28,2017,WAS,SDN,3,5,5-3,SDN,9,false,39,42,81,144,161,305,12,16,28,2,3:19 (1:20 delay)
490852,2017-05-28,2017,PIT,NYN,2,7,7-2,NYN,9,false,39,41,80,157,162,319,13,14,27,0,3:13
490847,2017-05-28,2017,LAN,CHN,9,4,9-4,LAN,9,true,39,42,81,183,161,344,16,14,30,3,3:28
490858,2017-05-28,2017,TOR,TEX,1,3,3-1,TEX,9,false,34,39,73,146,129,275,9,12,21,0,2:53
490846,2017-05-28,2017,HOU,BAL,8,4,8-4,HOU,9,true,36,37,73,163,146,309,13,9,22,0,2:58
490856,2017-05-28,2017,COL,SLN,8,4,8-4,COL,9,true,36,39,75,144,129,273,11,12,23,3,2:52
490850,2017-05-28,2017,CLE,KCA,10,1,10-1,CLE,9,true,45,32,77,111,180,291,22,6,28,1,2:48
490851,2017-05-28,2017,MIA,ANA,9,2,9-2,MIA,9,true,41,38,79,158,162,320,17,12,29,2,3:28
490857,2017-05-28,2017,MIN,TBA,6,8,8-6,TBA,15,false,68,71,139,289,264,553,28,28,56,4,6:26
490865,2017-05-29,2017,MIN,HOU,8,16,16-8,HOU,9,false,40,50,90,193,155,348,14,24,38,3,3:44 (:10 delay)
490868,2017-05-29,2017,BAL,NYA,3,2,3-2,BAL,9,true,35,33,68,119,154,273,10,9,19,1,2:54
490861,2017-05-29,2017,CHA,BOS,5,4,5-4,CHA,9,true,33,36,69,150,159,309,10,9,19,0,3:16
490860,2017-05-29,2017,ANA,ATL,3,6,6-3,ATL,9,false,36,36,72,127,123,250,10,10,20,2,2:50
490866,2017-05-29,2017,SLN,LAN,1,5,5-1,LAN,9,false,34,36,70,129,145,274,8,11,19,1,2:50
490859,2017-05-29,2017,PIT,ARI,4,3,4-3,PIT,9,false,33,37,70,129,150,279,11,10,21,3,3:02
490870,2017-05-29,2017,MIA,PHI,4,1,4-1,MIA,9,true,33,33,66,139,121,260,12,7,19,1,2:37
490871,2017-05-29,2017,COL,SEA,5,6,6-5,SEA,9,false,35,43,78,175,133,308,10,19,29,6,3:25
490869,2017-05-29,2017,CLE,OAK,5,3,5-3,CLE,9,true,36,35,71,141,135,276,11,9,20,1,2:50
490862,2017-05-29,2017,SDN,CHN,5,2,5-2,SDN,9,true,33,40,73,176,120,296,10,15,25,1,2:59
490873,2017-05-29,2017,SFN,WAS,0,3,3-0,WAS,9,false,36,37,73,141,152,293,11,10,21,3,3:03
490867,2017-05-29,2017,NYN,MIL,4,2,4-2,NYN,9,true,34,35,69,140,145,285,11,8,19,1,2:50
490872,2017-05-29,2017,TEX,TBA,8,10,10-8,TBA,9,false,43,42,85,155,176,331,18,17,35,5,3:48
490864,2017-05-29,2017,KCA,DET,7,10,10-7,DET,9,false,41,43,84,155,163,318,15,18,33,4,3:40
490863,2017-05-29,2017,TOR,CIN,17,2,17-2,TOR,9,true,54,34,88,138,183,321,31,8,39,2,3:06
490875,2017-05-30,2017,ANA,ATL,9,3,9-3,ANA,9,true,41,33,74,113,145,258,13,9,22,2,2:47
490877,2017-05-30,2017,SDN,CHN,6,2,6-2,SDN,9,true,36,38,74,166,119,285,12,11,23,2,2:52
490878,2017-05-30,2017,TOR,CIN,6,4,6-4,TOR,9,true,34,40,74,168,134,302,12,14,26,1,2:53
490885,2017-05-30,2017,MIA,PHI,7,2,7-2,MIA,9,true,40,33,73,134,170,304,15,6,21,4,3:07
490887,2017-05-30,2017,TEX,TBA,9,5,9-5,TEX,9,true,39,38,77,129,145,274,15,12,27,4,3:14
490886,2017-05-30,2017,COL,SEA,4,10,10-4,SEA,9,false,37,46,83,147,130,277,12,23,35,2,3:11
490883,2017-05-30,2017,BAL,NYA,3,8,8-3,NYA,9,false,40,45,85,170,150,320,12,19,31,5,3:19
490879,2017-05-30,2017,KCA,DET,1,0,1-0,KCA,9,true,31,30,61,118,137,255,8,4,12,1,2:45
490874,2017-05-30,2017,PIT,ARI,0,3,3-0,ARI,9,false,30,34,64,99,115,214,4,8,12,0,2:10
490880,2017-05-30,2017,MIN,HOU,2,7,7-2,HOU,9,false,37,41,78,164,131,295,10,17,27,0,3:01
490884,2017-05-30,2017,CLE,OAK,9,4,9-4,CLE,9,true,36,38,74,149,137,286,15,11,26,3,2:58
490876,2017-05-30,2017,CHA,BOS,7,13,13-7,BOS,9,false,43,47,90,201,187,388,17,21,38,3,3:53
490881,2017-05-30,2017,SLN,LAN,4,9,9-4,LAN,9,false,37,47,84,206,157,363,11,20,31,2,3:55
490888,2017-05-30,2017,SFN,WAS,3,6,6-3,WAS,9,false,40,44,84,194,156,350,13,17,30,1,3:32
490882,2017-05-30,2017,NYN,MIL,5,4,5-4,NYN,12,false,48,54,102,229,193,422,16,19,35,3,4:24
490892,2017-05-31,2017,SDN,CHN,2,1,2-1,SDN,9,true,32,33,65,121,113,234,9,6,15,0,2:25
490903,2017-05-31,2017,SFN,WAS,1,3,3-1,WAS,9,false,31,39,70,156,100,256,5,13,18,0,2:45
490900,2017-05-31,2017,CLE,OAK,1,3,3-1,OAK,9,false,31,34,65,135,125,260,4,8,12,1,2:30
490893,2017-05-31,2017,TOR,CIN,5,4,5-4,TOR,9,true,32,38,70,153,134,287,10,11,21,1,2:53
490894,2017-05-31,2017,SEA,COL,5,0,5-0,SEA,9,true,35,30,65,122,154,276,12,4,16,2,2:46
490899,2017-05-31,2017,BAL,NYA,10,4,10-4,BAL,9,true,39,42,81,165,148,313,16,16,32,3,3:18 (:14 delay)
490891,2017-05-31,2017,CHA,BOS,1,4,4-1,BOS,9,false,35,36,71,140,130,270,7,11,18,0,2:59
490902,2017-05-31,2017,TEX,TBA,5,7,7-5,TBA,10,false,41,46,87,164,155,319,12,15,27,1,3:45
490890,2017-05-31,2017,ANA,ATL,2,1,2-1,ANA,9,true,31,33,64,119,115,234,9,7,16,1,2:49
490895,2017-05-31,2017,KCA,DET,5,6,6-5,DET,9,false,38,40,78,149,147,296,12,14,26,2,3:19
490901,2017-05-31,2017,MIA,PHI,10,2,10-2,MIA,9,true,42,38,80,165,168,333,18,12,30,1,3:16
490889,2017-05-31,2017,PIT,ARI,5,6,6-5,ARI,14,false,55,61,116,253,197,450,17,21,38,1,4:40 (1:33 delay)
490898,2017-05-31,2017,NYN,MIL,1,7,7-1,MIL,9,false,38,45,83,190,138,328,12,19,31,0,3:17
490897,2017-05-31,2017,SLN,LAN,2,1,2-1,SLN,9,true,29,34,63,123,105,228,7,8,15,0,2:19
490896,2017-05-31,2017,MIN,HOU,6,17,17-6,HOU,9,false,41,52,93,181,187,368,15,27,42,3,3:35
490911,2017-06-01,2017,CLE,OAK,8,0,8-0,CLE,9,true,38,30,68,119,144,263,14,4,18,2,2:56
490904,2017-06-01,2017,MIA,ARI,2,3,3-2,ARI,9,false,34,36,70,147,126,273,8,10,18,3,3:00
490908,2017-06-01,2017,NYN,MIL,1,2,2-1,MIL,9,false,32,38,70,153,139,292,6,15,21,2,3:02
490910,2017-06-01,2017,TOR,NYA,2,12,12-2,NYA,9,false,32,46,78,180,132,312,7,18,25,4,3:10
490905,2017-06-01,2017,BAL,BOS,7,5,7-5,BAL,9,true,34,36,70,143,129,272,10,10,20,2,2:38
490907,2017-06-01,2017,SLN,LAN,2,0,2-0,SLN,9,true,34,34,68,159,149,308,11,9,20,1,3:07
490909,2017-06-01,2017,ANA,MIN,2,4,4-2,MIN,9,false,36,40,76,143,129,272,11,14,25,3,3:19
490906,2017-06-01,2017,SEA,COL,3,6,6-3,COL,9,false,41,40,81,173,156,329,16,15,31,0,3:28
490920,2017-06-02,2017,ANA,MIN,5,11,11-5,MIN,9,false,36,44,80,156,147,303,11,17,28,3,3:19
490916,2017-06-02,2017,KCA,CLE,4,0,4-0,KCA,9,true,33,31,64,103,109,212,9,8,17,1,2:19
490924,2017-06-02,2017,CHN,SLN,3,2,3-2,CHN,9,true,33,34,67,138,137,275,11,9,20,3,2:47
490918,2017-06-02,2017,TEX,HOU,1,7,7-1,HOU,9,false,34,41,75,151,127,278,7,13,20,0,2:58 (2:06 delay)
490914,2017-06-02,2017,BAL,BOS,3,2,3-2,BAL,9,true,33,31,64,137,150,287,10,5,15,3,2:59
490921,2017-06-02,2017,TOR,NYA,7,5,7-5,TOR,9,true,39,39,78,156,142,298,15,12,27,2,3:13
490912,2017-06-02,2017,MIA,ARI,7,5,7-5,MIA,9,true,37,36,73,158,147,305,13,10,23,5,3:00
490915,2017-06-02,2017,DET,CHA,15,5,15-5,DET,9,true,46,36,82,132,158,290,24,9,33,2,3:01
490917,2017-06-02,2017,SDN,COL,8,5,8-5,SDN,9,true,38,42,80,159,136,295,15,15,30,3,3:02
490925,2017-06-02,2017,SEA,TBA,12,4,12-4,SEA,9,true,41,39,80,151,173,324,16,12,28,1,3:09
490923,2017-06-02,2017,PHI,SFN,0,10,10-0,SFN,9,false,32,54,86,205,112,317,7,25,32,2,2:55
490919,2017-06-02,2017,MIL,LAN,1,2,2-1,LAN,12,false,45,45,90,170,183,353,9,13,22,0,3:57
490922,2017-06-02,2017,NYN,PIT,7,12,12-7,PIT,9,false,39,46,85,179,156,335,13,20,33,2,3:18
490926,2017-06-02,2017,OAK,WAS,3,13,13-3,WAS,9,false,36,50,86,202,132,334,11,23,34,2,3:15
490913,2017-06-02,2017,CIN,ATL,3,2,3-2,CIN,10,false,36,41,77,151,153,304,9,14,23,1,3:03
490927,2017-06-03,2017,MIA,ARI,3,0,3-0,MIA,9,true,36,27,63,98,140,238,15,2,17,1,2:31
490936,2017-06-03,2017,TOR,NYA,0,7,7-0,NYA,9,false,35,37,72,137,151,288,8,9,17,1,3:00
490932,2017-06-03,2017,SDN,COL,1,10,10-1,COL,9,false,31,45,76,171,122,293,5,19,24,1,2:52
490939,2017-06-03,2017,CHN,SLN,5,3,5-3,CHN,9,true,32,34,66,146,116,262,9,10,19,1,2:35
490937,2017-06-03,2017,NYN,PIT,4,2,4-2,NYN,9,true,33,41,74,168,135,303,11,13,24,1,3:06
490931,2017-06-03,2017,KCA,CLE,12,5,12-5,KCA,9,true,42,36,78,140,175,315,16,9,25,3,3:14
490938,2017-06-03,2017,PHI,SFN,5,3,5-3,PHI,9,true,34,36,70,142,141,283,12,12,24,2,2:50
490930,2017-06-03,2017,DET,CHA,10,1,10-1,DET,9,true,39,35,74,133,151,284,16,11,27,2,3:14
490935,2017-06-03,2017,ANA,MIN,7,2,7-2,ANA,9,true,39,37,76,158,136,294,17,11,28,2,3:18
490933,2017-06-03,2017,TEX,HOU,5,6,6-5,HOU,9,false,41,42,83,146,180,326,13,15,28,3,3:46
490940,2017-06-03,2017,SEA,TBA,9,2,9-2,SEA,9,true,38,33,71,158,135,293,18,7,25,0,2:59
490929,2017-06-03,2017,BAL,BOS,2,5,5-2,BOS,9,false,35,38,73,179,138,317,9,13,22,2,3:22
490941,2017-06-03,2017,OAK,WAS,10,4,10-4,OAK,9,true,42,42,84,164,174,338,17,14,31,3,3:33
490934,2017-06-03,2017,MIL,LAN,8,10,10-8,LAN,9,false,42,45,87,168,197,365,15,18,33,2,4:07
490928,2017-06-03,2017,CIN,ATL,5,6,6-5,ATL,12,false,56,52,108,205,207,412,19,19,38,2,4:20
490955,2017-06-04,2017,SEA,TBA,7,1,7-1,SEA,9,true,36,32,68,105,157,262,13,5,18,1,2:41
490951,2017-06-04,2017,TOR,NYA,3,2,3-2,TOR,9,true,32,32,64,132,111,243,9,7,16,0,2:27
490947,2017-06-04,2017,SDN,COL,1,3,3-1,COL,9,false,30,41,71,169,107,276,3,16,19,1,3:06
490952,2017-06-04,2017,NYN,PIT,1,11,11-1,PIT,9,false,33,45,78,165,121,286,10,18,28,0,2:54
490954,2017-06-04,2017,CHN,SLN,7,6,7-6,CHN,9,true,37,37,74,169,137,306,15,11,26,2,3:00
490946,2017-06-04,2017,KCA,CLE,0,8,8-0,CLE,9,false,34,41,75,201,130,331,9,17,26,3,2:58 (1:50 delay)
490949,2017-06-04,2017,MIL,LAN,3,0,3-0,MIL,9,true,35,33,68,154,167,321,11,6,17,2,3:12
490942,2017-06-04,2017,MIA,ARI,6,5,6-5,MIA,9,true,41,40,81,153,164,317,16,14,30,4,3:32
490948,2017-06-04,2017,TEX,HOU,2,7,7-2,HOU,9,false,37,41,78,180,151,331,10,14,24,3,3:18
490944,2017-06-04,2017,BAL,BOS,3,7,7-3,BOS,9,false,36,40,76,149,149,298,10,14,24,2,3:06
490956,2017-06-04,2017,OAK,WAS,10,11,11-10,WAS,9,false,39,42,81,169,142,311,12,17,29,4,3:12
490953,2017-06-04,2017,PHI,SFN,9,7,9-7,PHI,9,true,37,39,76,162,150,312,14,13,27,4,3:28
490950,2017-06-04,2017,ANA,MIN,2,3,3-2,MIN,9,false,34,35,69,142,137,279,11,9,20,2,3:13
490943,2017-06-04,2017,CIN,ATL,8,13,13-8,ATL,9,false,41,48,89,165,161,326,15,22,37,1,3:23
490945,2017-06-04,2017,DET,CHA,7,4,7-4,DET,9,false,41,42,83,176,166,342,19,18,37,6,4:07
490958,2017-06-05,2017,CHN,MIA,3,1,3-1,CHN,9,true,30,32,62,117,105,222,6,7,13,1,2:16
490963,2017-06-05,2017,LAN,WAS,2,4,4-2,WAS,9,false,36,37,73,133,156,289,9,8,17,1,3:05
490957,2017-06-05,2017,KCA,HOU,3,7,7-3,HOU,9,false,38,38,76,144,153,297,11,13,24,4,3:09
490960,2017-06-05,2017,MIL,SFN,2,7,7-2,SFN,9,false,32,43,75,161,130,291,6,20,26,1,3:05
490962,2017-06-05,2017,OAK,TOR,5,3,5-3,OAK,9,true,32,38,70,171,130,301,8,11,19,1,3:05
490961,2017-06-05,2017,CIN,SLN,4,2,4-2,CIN,9,true,30,34,64,140,123,263,8,11,19,1,2:35
490959,2017-06-05,2017,ATL,PHI,4,11,11-4,PHI,9,false,37,43,80,170,154,324,12,17,29,2,3:18
490975,2017-06-06,2017,MIL,SFN,5,2,5-2,MIL,9,true,35,35,70,131,114,245,13,10,23,2,2:35
490972,2017-06-06,2017,ATL,PHI,1,3,3-1,PHI,9,false,34,34,68,119,111,230,8,9,17,2,2:42
490978,2017-06-06,2017,LAN,WAS,1,2,2-1,WAS,9,false,35,33,68,130,137,267,6,7,13,1,2:57
490977,2017-06-06,2017,OAK,TOR,4,1,4-1,OAK,9,true,31,36,67,146,115,261,9,12,21,2,2:45
490968,2017-06-06,2017,DET,ANA,3,5,5-3,ANA,9,false,38,36,74,148,141,289,13,11,24,2,3:14
490969,2017-06-06,2017,CHN,MIA,10,2,10-2,CHN,9,true,42,34,76,148,151,299,17,7,24,4,3:01
490967,2017-06-06,2017,KCA,HOU,9,7,9-7,KCA,9,false,42,44,86,152,157,309,16,16,32,4,3:10
490966,2017-06-06,2017,COL,CLE,11,3,11-3,COL,9,true,39,33,72,123,157,280,19,8,27,2,2:54
490976,2017-06-06,2017,CIN,SLN,13,1,13-1,CIN,9,true,42,33,75,137,169,306,19,8,27,1,2:47
490973,2017-06-06,2017,BAL,PIT,6,5,6-5,BAL,10,false,40,42,82,181,144,325,11,14,25,3,3:25
490964,2017-06-06,2017,NYA,BOS,4,5,5-4,BOS,9,false,39,35,74,123,204,327,13,8,21,3,3:35
490971,2017-06-06,2017,TEX,NYN,10,8,10-8,TEX,9,true,42,48,90,173,154,327,19,23,42,1,3:19
490965,2017-06-06,2017,TBA,CHA,2,4,4-2,CHA,9,false,40,36,76,147,171,318,16,11,27,3,3:29
490974,2017-06-06,2017,ARI,SDN,10,2,10-2,ARI,9,true,39,35,74,141,165,306,14,8,22,2,2:52
490970,2017-06-06,2017,SEA,MIN,12,3,12-3,SEA,9,true,42,41,83,175,186,361,18,15,33,3,3:26
490993,2017-06-07,2017,LAN,WAS,2,1,2-1,LAN,9,true,30,35,65,121,128,249,5,8,13,2,2:45
490980,2017-06-07,2017,TBA,CHA,3,1,3-1,TBA,9,true,35,32,67,129,133,262,12,6,18,3,2:53
490985,2017-06-07,2017,SEA,MIN,6,5,6-5,SEA,9,false,35,35,70,118,143,261,9,9,18,1,2:43
490979,2017-06-07,2017,NYA,BOS,8,0,8-0,NYA,9,true,39,31,70,105,142,247,16,5,21,1,2:42
490990,2017-06-07,2017,MIL,SFN,6,3,6-3,MIL,9,true,35,36,71,132,129,261,11,10,21,0,2:41
490983,2017-06-07,2017,DET,ANA,4,0,4-0,DET,9,true,36,30,66,129,143,272,12,5,17,2,2:58
490987,2017-06-07,2017,ATL,PHI,14,1,14-1,ATL,9,true,42,34,76,131,155,286,18,9,27,2,2:58
490991,2017-06-07,2017,CIN,SLN,6,4,6-4,CIN,9,true,34,37,71,138,130,268,12,13,25,2,2:45
490986,2017-06-07,2017,TEX,NYN,3,4,4-3,NYN,9,false,36,36,72,155,132,287,11,9,20,1,3:10
490982,2017-06-07,2017,KCA,HOU,7,5,7-5,KCA,9,true,37,43,80,156,142,298,13,15,28,4,3:11
490984,2017-06-07,2017,CHN,MIA,5,6,6-5,MIA,9,false,41,38,79,152,162,314,14,11,25,2,3:06
490981,2017-06-07,2017,COL,CLE,8,1,8-1,COL,9,true,43,34,77,134,169,303,21,8,29,5,3:27
490989,2017-06-07,2017,ARI,SDN,7,4,7-4,ARI,9,true,38,40,78,179,184,363,15,13,28,2,3:48
490992,2017-06-07,2017,OAK,TOR,5,7,7-5,TOR,10,false,39,42,81,171,166,337,9,12,21,1,3:20
490988,2017-06-07,2017,BAL,PIT,9,6,9-6,BAL,11,false,46,49,95,199,194,393,17,18,35,3,4:08
490612,2017-06-08,2017,WAS,BAL,6,1,6-1,WAS,9,true,40,31,71,119,160,279,16,4,20,1,2:56
490612,2017-06-08,2017,WAS,BAL,6,1,6-1,WAS,9,true,40,31,71,119,160,279,16,4,20,1,2:56
491000,2017-06-08,2017,SEA,MIN,1,2,2-1,MIN,9,false,36,37,73,143,128,271,10,11,21,1,2:51
491001,2017-06-08,2017,ATL,PHI,3,1,3-1,ATL,9,true,34,32,66,140,111,251,14,5,19,1,2:40
490997,2017-06-08,2017,KCA,HOU,1,6,6-1,HOU,9,false,31,38,69,137,114,251,5,11,16,1,2:39
490995,2017-06-08,2017,TBA,CHA,7,5,7-5,TBA,9,true,36,39,75,155,144,299,14,13,27,3,3:09
491002,2017-06-08,2017,ARI,SDN,15,3,15-3,ARI,9,true,43,39,82,132,165,297,21,12,33,2,2:59
490998,2017-06-08,2017,DET,ANA,4,11,11-4,ANA,9,false,42,43,85,134,168,302,17,18,35,2,3:24
490999,2017-06-08,2017,PIT,MIA,1,7,7-1,MIA,9,false,35,41,76,167,142,309,8,15,23,1,3:06
490994,2017-06-08,2017,NYA,BOS,9,1,9-1,NYA,9,true,43,35,78,153,160,313,19,8,27,2,3:27
491004,2017-06-08,2017,CIN,SLN,5,2,5-2,CIN,9,true,38,32,70,122,117,239,16,6,22,0,2:21
491003,2017-06-08,2017,MIL,SFN,5,9,9-5,SFN,10,false,47,51,98,207,188,395,18,23,41,5,4:22
490996,2017-06-08,2017,CHN,COL,1,4,4-1,COL,9,false,33,35,68,142,140,282,8,8,16,0,2:44
491005,2017-06-09,2017,NYA,BAL,8,2,8-2,NYA,9,true,39,34,73,125,141,266,15,7,22,1,2:45
491007,2017-06-09,2017,LAN,CIN,7,2,7-2,LAN,9,true,38,35,73,158,147,305,16,8,24,2,3:02
491019,2017-06-09,2017,SEA,TOR,4,2,4-2,SEA,9,true,33,37,70,151,117,268,11,13,24,1,2:53
491016,2017-06-09,2017,TBA,OAK,13,4,13-4,TBA,9,true,41,38,79,161,163,324,17,11,28,1,3:16
491006,2017-06-09,2017,CLE,CHA,7,3,7-3,CLE,9,true,37,38,75,144,139,283,14,12,26,1,3:00 (:36 delay)
491010,2017-06-09,2017,SDN,KCA,6,3,6-3,SDN,9,true,39,34,73,136,146,282,20,9,29,3,2:51
491015,2017-06-09,2017,ATL,NYN,3,2,3-2,ATL,9,false,36,35,71,140,163,303,13,9,22,4,3:11
491013,2017-06-09,2017,ARI,MIL,6,8,8-6,MIL,9,false,41,46,87,170,149,319,13,21,34,5,3:38
491018,2017-06-09,2017,WAS,TEX,2,5,5-2,TEX,9,false,37,45,82,150,123,273,11,17,28,2,3:00
491012,2017-06-09,2017,PIT,MIA,7,12,12-7,MIA,9,false,46,46,92,143,170,313,20,20,40,2,3:25
491008,2017-06-09,2017,CHN,COL,3,5,5-3,COL,9,false,41,38,79,161,182,343,14,14,28,0,3:42
491014,2017-06-09,2017,SFN,MIN,0,4,4-0,MIN,9,false,31,37,68,130,91,221,5,12,17,0,2:27
491017,2017-06-09,2017,SLN,PHI,3,2,3-2,SLN,9,true,36,35,71,134,125,259,15,10,25,0,2:43
491011,2017-06-09,2017,HOU,ANA,4,9,9-4,ANA,9,false,34,44,78,181,116,297,9,20,29,1,3:20
491009,2017-06-09,2017,BOS,DET,5,3,5-3,BOS,9,true,36,39,75,185,141,326,14,13,27,2,3:36
490524,2017-06-10,2017,ATL,NYN,1,6,6-1,NYN,9,false,38,42,80,142,143,285,8,17,25,4,3:05
491026,2017-06-10,2017,HOU,ANA,3,1,3-1,HOU,9,true,33,33,66,124,130,254,12,6,18,2,2:52
491033,2017-06-10,2017,SLN,PHI,7,0,7-0,SLN,9,true,35,32,67,107,142,249,13,5,18,1,2:28
491035,2017-06-10,2017,SEA,TOR,2,4,4-2,TOR,9,false,36,35,71,133,120,253,9,10,19,1,2:44
491029,2017-06-10,2017,SFN,MIN,2,3,3-2,MIN,9,false,36,35,71,131,137,268,10,7,17,1,2:43
491030,2017-06-10,2017,ATL,NYN,1,8,8-1,NYN,9,false,34,44,78,146,128,274,7,17,24,1,2:41
491021,2017-06-10,2017,CLE,CHA,3,5,5-3,CHA,9,false,34,39,73,136,123,259,7,17,24,3,2:59
491028,2017-06-10,2017,ARI,MIL,3,2,3-2,ARI,9,true,35,31,66,109,125,234,13,5,18,1,2:43
491023,2017-06-10,2017,CHN,COL,1,9,9-1,COL,9,false,34,42,76,168,124,292,7,18,25,3,3:09
491027,2017-06-10,2017,PIT,MIA,7,6,7-6,PIT,9,true,41,40,81,144,160,304,19,13,32,1,3:11
491020,2017-06-10,2017,NYA,BAL,16,3,16-3,NYA,9,true,46,33,79,120,185,305,24,7,31,3,3:11
491032,2017-06-10,2017,TBA,OAK,2,7,7-2,OAK,9,false,34,44,78,167,128,295,9,17,26,0,3:06
491025,2017-06-10,2017,SDN,KCA,6,12,12-6,KCA,9,false,40,44,84,166,173,339,14,19,33,6,3:44
491031,2017-06-10,2017,TBA,OAK,6,5,6-5,TBA,10,false,39,48,87,171,168,339,13,19,32,4,3:56
491034,2017-06-10,2017,WAS,TEX,3,6,6-3,TEX,11,false,43,43,86,193,197,390,12,13,25,4,4:14
490524,2017-06-10,2017,ATL,NYN,1,6,6-1,NYN,9,false,38,42,80,142,143,285,8,17,25,4,3:05
491022,2017-06-10,2017,LAN,CIN,5,4,5-4,LAN,9,false,38,36,74,135,141,276,12,9,21,2,3:04
491024,2017-06-10,2017,BOS,DET,11,3,11-3,BOS,9,true,46,36,82,138,191,329,25,9,34,2,3:39
491046,2017-06-11,2017,ATL,NYN,1,2,2-1,NYN,9,false,35,37,72,130,119,249,9,13,22,1,3:01
491041,2017-06-11,2017,SDN,KCA,3,8,8-3,KCA,9,false,35,36,71,132,127,259,8,8,16,1,2:27
491048,2017-06-11,2017,SLN,PHI,6,5,6-5,SLN,9,true,35,40,75,151,145,296,13,16,29,1,3:09
491049,2017-06-11,2017,WAS,TEX,1,5,5-1,TEX,9,false,30,35,65,146,116,262,4,7,11,2,2:53
491043,2017-06-11,2017,PIT,MIA,3,1,3-1,PIT,9,true,36,32,68,113,119,232,14,4,18,2,2:32
491039,2017-06-11,2017,CHN,COL,7,5,7-5,CHN,9,true,37,39,76,153,161,314,14,12,26,3,3:20
491038,2017-06-11,2017,LAN,CIN,9,7,9-7,LAN,9,true,40,41,81,147,133,280,16,14,30,2,2:58
491047,2017-06-11,2017,TBA,OAK,5,4,5-4,TBA,9,true,35,40,75,162,149,311,13,14,27,3,3:26
491044,2017-06-11,2017,ARI,MIL,11,1,11-1,ARI,9,true,40,36,76,139,188,327,17,9,26,5,3:26
491037,2017-06-11,2017,CLE,CHA,4,2,4-2,CLE,9,true,34,35,69,134,152,286,10,11,21,2,3:16
491040,2017-06-11,2017,BOS,DET,3,8,8-3,DET,9,false,42,43,85,180,171,351,19,17,36,1,4:06
491045,2017-06-11,2017,SFN,MIN,13,8,13-8,SFN,9,true,45,45,90,178,158,336,22,18,40,4,3:43
491036,2017-06-11,2017,NYA,BAL,14,3,14-3,NYA,9,true,46,37,83,171,169,340,24,12,36,4,3:38
491042,2017-06-11,2017,HOU,ANA,6,12,12-6,ANA,9,false,42,43,85,179,153,332,15,17,32,4,3:39
491050,2017-06-11,2017,SEA,TOR,0,4,4-0,TOR,9,false,38,38,76,151,154,305,11,12,23,3,3:01
491053,2017-06-12,2017,NYN,CHN,6,1,6-1,NYN,9,true,36,33,69,116,118,234,14,10,24,1,2:23
491059,2017-06-12,2017,HOU,TEX,1,6,6-1,TEX,9,false,34,37,71,148,136,284,7,12,19,2,3:23
491052,2017-06-12,2017,CHA,BAL,10,7,10-7,CHA,9,true,40,42,82,181,147,328,16,20,36,4,3:29
491058,2017-06-12,2017,MIN,SEA,3,14,14-3,SEA,9,false,35,51,86,182,141,323,8,24,32,2,3:22
491057,2017-06-12,2017,BOS,PHI,6,5,6-5,BOS,11,false,47,49,96,205,158,363,20,16,36,0,4:16
491051,2017-06-12,2017,WAS,ATL,10,11,11-10,ATL,9,false,47,45,92,181,161,342,22,16,38,4,3:49
491056,2017-06-12,2017,ANA,NYA,3,5,5-3,NYA,9,false,36,46,82,175,131,306,8,20,28,4,3:40
491054,2017-06-12,2017,SDN,CIN,9,3,9-3,SDN,9,true,39,36,75,129,142,271,16,10,26,2,2:39
491055,2017-06-12,2017,PIT,COL,7,2,7-2,PIT,9,true,42,39,81,153,138,291,18,15,33,2,3:11
490508,2017-06-13,2017,SLN,MIL,6,0,6-0,SLN,9,true,36,36,72,146,174,320,12,10,22,1,3:03
491062,2017-06-13,2017,CHA,BAL,6,1,6-1,CHA,9,true,36,35,71,133,137,270,13,11,24,1,2:54
491070,2017-06-13,2017,MIA,OAK,8,1,8-1,MIA,9,true,39,32,71,136,145,281,15,5,20,1,2:57
490508,2017-06-13,2017,SLN,MIL,6,0,6-0,SLN,9,true,36,36,72,146,174,320,12,10,22,1,3:03
491064,2017-06-13,2017,SDN,CIN,6,2,6-2,SDN,9,true,38,38,76,134,131,265,14,12,26,2,2:35
491067,2017-06-13,2017,CLE,LAN,5,7,7-5,LAN,9,false,37,44,81,179,145,324,10,18,28,5,3:27
491069,2017-06-13,2017,ANA,NYA,3,2,3-2,ANA,11,false,45,46,91,182,176,358,14,13,27,4,4:14
491073,2017-06-13,2017,TOR,TBA,1,8,8-1,TBA,9,false,37,42,79,175,139,314,10,18,28,2,3:15
491061,2017-06-13,2017,WAS,ATL,10,5,10-5,WAS,9,true,39,41,80,155,132,287,16,18,34,4,3:16
491072,2017-06-13,2017,MIN,SEA,20,7,20-7,MIN,9,true,51,41,92,130,166,296,30,14,44,4,3:04
491063,2017-06-13,2017,NYN,CHN,3,14,14-3,CHN,9,false,35,49,84,196,132,328,8,25,33,2,3:07
491065,2017-06-13,2017,PIT,COL,5,2,5-2,PIT,9,true,34,35,69,137,115,252,12,8,20,0,2:42
491060,2017-06-13,2017,DET,ARI,6,7,7-6,ARI,9,false,39,42,81,174,155,329,12,19,31,4,3:48
491066,2017-06-13,2017,SFN,KCA,1,8,8-1,KCA,9,false,34,44,78,141,119,260,7,21,28,1,2:38
491068,2017-06-13,2017,SLN,MIL,5,8,8-5,MIL,9,false,39,41,80,163,134,297,16,14,30,3,3:19
491071,2017-06-13,2017,BOS,PHI,4,3,4-3,BOS,12,false,50,52,102,214,180,394,20,19,39,1,4:24
491074,2017-06-13,2017,HOU,TEX,2,4,4-2,TEX,9,false,34,38,72,154,135,289,9,11,20,2,3:07
491080,2017-06-14,2017,SDN,CIN,4,2,4-2,SDN,9,true,36,31,67,102,137,239,14,7,21,0,2:26
491075,2017-06-14,2017,DET,ARI,1,2,2-1,ARI,9,false,35,31,66,126,133,259,8,7,15,0,2:45
491085,2017-06-14,2017,ANA,NYA,7,5,7-5,ANA,9,true,39,39,78,145,131,276,15,16,31,2,3:23
491078,2017-06-14,2017,PHI,BOS,3,7,7-3,BOS,9,false,37,39,76,137,148,285,10,16,26,3,3:26
491088,2017-06-14,2017,TOR,TBA,7,6,7-6,TOR,9,true,39,39,78,144,146,290,15,11,26,1,3:07
491084,2017-06-14,2017,SLN,MIL,6,7,7-6,MIL,9,false,38,40,78,148,159,307,12,14,26,1,3:09 (1:50 delay)
491079,2017-06-14,2017,NYN,CHN,9,4,9-4,NYN,9,true,42,37,79,133,160,293,17,10,27,2,3:02
491083,2017-06-14,2017,CLE,LAN,4,6,6-4,LAN,9,false,37,40,77,162,158,320,11,14,25,5,3:35 (:50 delay)
491089,2017-06-14,2017,HOU,TEX,13,2,13-2,HOU,9,true,46,36,82,137,190,327,25,10,35,3,3:37
491076,2017-06-14,2017,WAS,ATL,2,13,13-2,ATL,9,false,33,47,80,196,114,310,8,22,30,2,3:17
491086,2017-06-14,2017,MIA,OAK,11,6,11-6,MIA,9,true,42,43,85,181,162,343,18,16,34,3,3:31
491087,2017-06-14,2017,MIN,SEA,4,6,6-4,SEA,9,false,37,44,81,160,126,286,11,16,27,3,3:06
491077,2017-06-14,2017,CHA,BAL,6,10,10-6,BAL,9,false,40,42,82,167,163,330,14,15,29,1,3:22 (1:30 delay)
491082,2017-06-14,2017,SFN,KCA,2,7,7-2,KCA,9,false,40,46,86,153,137,290,13,19,32,2,3:03
491081,2017-06-14,2017,PIT,COL,1,5,5-1,COL,9,false,36,37,73,136,142,278,11,10,21,3,3:19
491091,2017-06-15,2017,PHI,BOS,1,0,1-0,PHI,9,true,29,34,63,139,110,249,5,8,13,0,2:25
491092,2017-06-15,2017,ANA,KCA,2,7,7-2,KCA,9,false,33,45,78,142,120,262,7,18,25,2,2:48
491099,2017-06-15,2017,NYN,WAS,3,8,8-3,WAS,9,false,33,41,74,149,129,278,6,14,20,1,2:52
491097,2017-06-15,2017,MIN,SEA,6,2,6-2,MIN,9,true,37,33,70,121,143,264,15,7,22,0,2:45
491098,2017-06-15,2017,DET,TBA,5,3,5-3,DET,9,false,39,39,78,143,155,298,14,14,28,1,3:29
491090,2017-06-15,2017,CHA,BAL,5,2,5-2,CHA,9,true,41,38,79,174,154,328,18,12,30,4,3:35
491094,2017-06-15,2017,SLN,MIL,4,6,6-4,MIL,9,false,37,39,76,162,163,325,12,14,26,1,3:14
491096,2017-06-15,2017,COL,SFN,10,9,10-9,COL,9,false,43,48,91,186,156,342,20,24,44,3,3:55
491093,2017-06-15,2017,CLE,LAN,12,5,12-5,CLE,9,true,43,40,83,157,202,359,20,14,34,4,3:32
491095,2017-06-15,2017,OAK,NYA,8,7,8-7,OAK,10,false,49,50,99,206,176,382,21,22,43,5,4:29
491105,2017-06-16,2017,ANA,KCA,1,3,3-1,KCA,9,false,31,36,67,116,139,255,4,10,14,0,2:38
491101,2017-06-16,2017,HOU,BOS,1,2,2-1,BOS,9,false,34,35,69,120,153,273,12,9,21,1,3:11
491106,2017-06-16,2017,CIN,LAN,1,3,3-1,LAN,9,false,31,40,71,164,103,267,6,15,21,0,2:45
491104,2017-06-16,2017,MIN,CLE,1,8,8-1,CLE,9,false,33,42,75,135,143,278,7,18,25,2,2:50
491107,2017-06-16,2017,ATL,MIA,0,5,5-0,MIA,9,false,30,40,70,147,116,263,4,14,18,2,2:44
491113,2017-06-16,2017,DET,TBA,13,4,13-4,DET,9,true,41,35,76,142,141,283,17,11,28,2,3:05
491111,2017-06-16,2017,TEX,SEA,10,4,10-4,TEX,9,true,42,36,78,147,158,305,18,10,28,3,3:07
491112,2017-06-16,2017,BAL,SLN,2,11,11-2,SLN,9,false,33,43,76,171,131,302,8,19,27,1,2:55
491114,2017-06-16,2017,NYN,WAS,2,7,7-2,WAS,9,false,33,43,76,145,144,289,9,18,27,1,2:56
491108,2017-06-16,2017,OAK,NYA,7,6,7-6,OAK,9,true,36,40,76,168,142,310,15,14,29,1,3:13
491100,2017-06-16,2017,PHI,ARI,4,5,5-4,ARI,9,false,35,41,76,159,124,283,7,15,22,2,3:12
491110,2017-06-16,2017,COL,SFN,10,8,10-8,COL,9,true,39,38,77,145,142,287,16,13,29,1,3:09
491109,2017-06-16,2017,MIL,SDN,6,5,6-5,MIL,10,false,38,41,79,166,143,309,13,10,23,2,3:16
491102,2017-06-16,2017,PIT,CHN,5,9,9-5,CHN,9,false,39,41,80,146,162,308,12,16,28,3,3:31
491103,2017-06-16,2017,TOR,CHA,4,11,11-4,CHA,9,false,34,43,77,153,138,291,11,17,28,2,3:05
490314,2017-06-17,2017,MIN,CLE,2,6,6-2,CLE,9,false,34,43,77,162,139,301,8,18,26,3,2:58 (1:15 delay)
491116,2017-06-17,2017,HOU,BOS,7,1,7-1,HOU,9,true,35,30,65,112,128,240,12,4,16,0,2:34
491118,2017-06-17,2017,TOR,CHA,2,5,5-2,CHA,9,false,32,38,70,120,128,248,7,11,18,2,2:44
491125,2017-06-17,2017,COL,SFN,5,1,5-1,COL,9,true,40,38,78,147,124,271,18,14,32,1,3:01
491126,2017-06-17,2017,TEX,SEA,10,4,10-4,TEX,9,true,37,38,75,152,133,285,12,11,23,1,2:54
491115,2017-06-17,2017,PHI,ARI,1,5,5-1,ARI,9,false,41,40,81,161,161,322,14,14,28,4,3:25 (:50 delay)
490314,2017-06-17,2017,MIN,CLE,2,6,6-2,CLE,9,false,34,43,77,162,139,301,8,18,26,3,2:58 (1:15 delay)
491119,2017-06-17,2017,MIN,CLE,3,9,9-3,CLE,9,false,35,47,82,192,136,328,9,21,30,2,3:20
491122,2017-06-17,2017,ATL,MIA,8,7,8-7,ATL,10,false,47,44,91,171,172,343,20,16,36,3,3:48
491127,2017-06-17,2017,BAL,SLN,15,7,15-7,BAL,9,true,45,43,88,190,171,361,21,15,36,4,3:27
491124,2017-06-17,2017,MIL,SDN,5,7,7-5,SDN,11,false,42,46,88,174,161,335,9,13,22,2,3:46
491120,2017-06-17,2017,ANA,KCA,9,0,9-0,ANA,9,true,38,31,69,138,133,271,16,3,19,1,2:51
491117,2017-06-17,2017,PIT,CHN,4,3,4-3,PIT,9,true,34,35,69,117,139,256,11,10,21,2,2:54
491128,2017-06-17,2017,DET,TBA,2,3,3-2,TBA,9,false,38,36,74,135,149,284,10,12,22,2,3:23
491123,2017-06-17,2017,OAK,NYA,5,2,5-2,OAK,9,true,40,36,76,158,161,319,16,8,24,0,3:17
491129,2017-06-17,2017,NYN,WAS,4,7,7-4,WAS,9,false,38,41,79,144,176,320,15,15,30,5,3:32
491121,2017-06-17,2017,CIN,LAN,2,10,10-2,LAN,9,false,39,45,84,168,172,340,13,17,30,2,3:28
491139,2017-06-18,2017,MIL,SDN,2,1,2-1,MIL,9,true,32,34,66,118,115,233,11,9,20,0,2:37
491138,2017-06-18,2017,OAK,NYA,4,3,4-3,OAK,9,true,32,35,67,135,135,270,9,9,18,1,2:55
491134,2017-06-18,2017,MIN,CLE,2,5,5-2,CLE,9,false,34,41,75,153,132,285,9,16,25,2,3:01
491141,2017-06-18,2017,TEX,SEA,3,7,7-3,SEA,9,false,36,41,77,189,137,326,10,16,26,5,3:43
491140,2017-06-18,2017,COL,SFN,7,5,7-5,COL,9,false,39,40,79,159,147,306,15,15,30,2,3:16
491135,2017-06-18,2017,ANA,KCA,3,7,7-3,KCA,9,false,39,42,81,173,140,313,15,16,31,4,3:28
491144,2017-06-18,2017,NYN,WAS,5,1,5-1,NYN,9,true,39,34,73,123,142,265,15,6,21,0,2:50
491143,2017-06-18,2017,DET,TBA,1,9,9-1,TBA,9,false,34,40,74,139,141,280,8,13,21,1,3:05 (:31 delay)
491133,2017-06-18,2017,TOR,CHA,7,3,7-3,TOR,9,true,40,36,76,137,142,279,17,9,26,4,3:01
491132,2017-06-18,2017,PIT,CHN,1,7,7-1,CHN,9,false,32,40,72,139,133,272,6,14,20,1,2:48
491137,2017-06-18,2017,ATL,MIA,5,4,5-4,ATL,9,false,38,38,76,140,138,278,15,13,28,2,2:53
491142,2017-06-18,2017,BAL,SLN,8,5,8-5,BAL,9,true,37,36,73,135,159,294,14,11,25,3,2:58
491131,2017-06-18,2017,HOU,BOS,5,6,6-5,BOS,9,false,45,37,82,137,192,329,21,12,33,4,4:08
491136,2017-06-18,2017,CIN,LAN,7,8,8-7,LAN,9,false,42,42,84,155,163,318,15,15,30,1,3:20
491130,2017-06-18,2017,PHI,ARI,4,5,5-4,ARI,10,false,44,44,88,187,196,383,17,16,33,2,4:12
491148,2017-06-19,2017,SEA,DET,6,2,6-2,SEA,9,true,36,38,74,149,142,291,14,12,26,3,3:16
491150,2017-06-19,2017,LAN,NYN,10,6,10-6,LAN,9,true,44,38,82,164,177,341,20,12,32,2,3:27
491146,2017-06-19,2017,TBA,CIN,3,7,7-3,CIN,9,false,35,43,78,164,133,297,9,18,27,2,3:08
491147,2017-06-19,2017,BAL,CLE,0,12,12-0,CLE,9,false,30,52,82,212,108,320,3,25,28,2,2:57 (:29 delay)
491153,2017-06-19,2017,ATL,SFN,9,0,9-0,ATL,9,true,39,32,71,104,142,246,16,6,22,2,2:46 (:44 delay)
491145,2017-06-19,2017,KCA,BOS,4,2,4-2,KCA,9,true,36,40,76,122,142,264,12,13,25,3,3:11
491152,2017-06-19,2017,CHN,SDN,3,2,3-2,CHN,9,true,31,40,71,173,126,299,11,13,24,2,3:06
491151,2017-06-19,2017,MIL,PIT,1,8,8-1,PIT,9,false,34,42,76,173,134,307,8,15,23,2,3:18
491149,2017-06-19,2017,OAK,HOU,1,4,4-1,HOU,9,false,33,37,70,142,145,287,7,11,18,2,2:56
491155,2017-06-19,2017,MIA,WAS,8,7,8-7,MIA,9,false,40,42,82,156,165,321,18,16,34,3,3:31
491154,2017-06-19,2017,TEX,TOR,6,7,7-6,TOR,9,false,41,43,84,184,161,345,14,16,30,3,3:48
491167,2017-06-20,2017,ATL,SFN,3,6,6-3,SFN,9,false,36,35,71,112,140,252,10,9,19,5,2:56
491170,2017-06-20,2017,MIA,WAS,3,12,12-3,WAS,9,false,36,44,80,162,122,284,10,19,29,1,3:02
491163,2017-06-20,2017,NYA,ANA,3,8,8-3,ANA,9,false,36,42,78,163,160,323,9,15,24,2,3:26
491159,2017-06-20,2017,TBA,CIN,6,5,6-5,TBA,9,true,36,42,78,153,162,315,13,15,28,2,3:20
491166,2017-06-20,2017,CHN,SDN,4,0,4-0,CHN,9,true,35,35,70,131,121,252,17,9,26,1,2:38
491168,2017-06-20,2017,PHI,SLN,1,8,8-1,SLN,11,false,40,47,87,177,156,333,9,16,25,2,3:28
491156,2017-06-20,2017,COL,ARI,4,3,4-3,COL,9,true,33,37,70,141,108,249,10,11,21,3,2:45
491157,2017-06-20,2017,KCA,BOS,3,8,8-3,BOS,9,false,31,42,73,178,116,294,5,16,21,2,2:54
491165,2017-06-20,2017,MIL,PIT,3,7,7-3,PIT,9,false,41,41,82,148,161,309,14,15,29,1,3:13
491161,2017-06-20,2017,SEA,DET,5,4,5-4,SEA,10,false,41,39,80,147,169,316,16,10,26,3,3:42
491162,2017-06-20,2017,OAK,HOU,4,8,8-4,HOU,9,false,38,45,83,183,134,317,12,19,31,1,3:28
491158,2017-06-20,2017,MIN,CHA,9,7,9-7,MIN,9,true,42,48,90,168,164,332,17,21,38,3,3:33
491169,2017-06-20,2017,TEX,TOR,6,1,6-1,TEX,9,true,32,37,69,156,123,279,10,11,21,4,3:06
491164,2017-06-20,2017,LAN,NYN,12,0,12-0,LAN,9,true,46,33,79,135,179,314,22,8,30,2,3:01
491160,2017-06-20,2017,BAL,CLE,6,5,6-5,BAL,9,true,35,43,78,194,132,326,12,19,31,6,3:40
491185,2017-06-21,2017,MIA,WAS,2,1,2-1,MIA,9,true,29,32,61,152,121,273,5,7,12,1,2:39
491173,2017-06-21,2017,MIN,CHA,4,2,4-2,MIN,9,true,40,32,72,107,148,255,18,6,24,2,3:02
491172,2017-06-21,2017,KCA,BOS,6,4,6-4,KCA,9,true,35,36,71,151,141,292,13,9,22,4,3:07
491177,2017-06-21,2017,OAK,HOU,1,5,5-1,HOU,9,false,34,40,74,141,135,276,9,12,21,2,3:06
491182,2017-06-21,2017,ATL,SFN,5,3,5-3,ATL,11,false,40,42,82,155,125,280,8,10,18,1,3:16 (1:15 delay)
491180,2017-06-21,2017,MIL,PIT,4,3,4-3,MIL,9,true,34,39,73,176,122,298,11,15,26,2,3:13
491174,2017-06-21,2017,TBA,CIN,8,3,8-3,TBA,9,true,39,38,77,154,139,293,18,11,29,5,3:16
491181,2017-06-21,2017,CHN,SDN,2,3,3-2,SDN,9,false,30,39,69,177,127,304,4,14,18,4,3:09
491179,2017-06-21,2017,LAN,NYN,8,2,8-2,LAN,9,true,37,38,75,158,153,311,14,10,24,1,3:12
491178,2017-06-21,2017,NYA,ANA,8,4,8-4,NYA,9,true,39,36,75,148,143,291,17,10,27,3,3:14
491184,2017-06-21,2017,TEX,TOR,5,7,7-5,TOR,9,false,38,40,78,173,136,309,11,15,26,3,3:20
491176,2017-06-21,2017,SEA,DET,7,5,7-5,SEA,9,true,36,39,75,156,155,311,13,15,28,3,3:16
491175,2017-06-21,2017,BAL,CLE,1,5,5-1,CLE,9,false,36,41,77,183,138,321,9,14,23,4,3:16 (:44 delay)
491183,2017-06-21,2017,PHI,SLN,6,7,7-6,SLN,10,false,48,42,90,168,180,348,20,14,34,2,3:29
491171,2017-06-21,2017,COL,ARI,5,16,16-5,ARI,9,false,39,51,90,175,141,316,13,26,39,1,3:28
491190,2017-06-22,2017,SEA,DET,9,6,9-6,SEA,9,true,35,37,72,153,142,295,13,11,24,1,2:58
491195,2017-06-22,2017,ATL,SFN,12,11,12-11,ATL,9,true,41,48,89,186,156,342,17,21,38,4,3:37 (1:26 delay)
491191,2017-06-22,2017,OAK,HOU,9,12,12-9,HOU,9,false,43,45,88,156,189,345,17,17,34,2,3:24
491189,2017-06-22,2017,BAL,CLE,3,6,6-3,CLE,9,false,40,42,82,178,181,359,16,17,33,3,3:35
491196,2017-06-22,2017,PHI,SLN,5,1,5-1,PHI,9,true,33,32,65,127,117,244,13,6,19,1,2:31
491194,2017-06-22,2017,MIL,PIT,4,2,4-2,MIL,9,true,34,33,67,140,113,253,14,8,22,0,2:57
491197,2017-06-22,2017,TEX,TOR,11,4,11-4,TEX,9,true,41,38,79,137,154,291,17,14,31,1,3:07
491193,2017-06-22,2017,LAN,NYN,6,3,6-3,LAN,9,true,38,38,76,167,157,324,16,12,28,6,3:33
491186,2017-06-22,2017,COL,ARI,3,10,10-3,ARI,9,false,34,42,76,169,137,306,8,15,23,2,3:06
491187,2017-06-22,2017,MIA,CHN,1,11,11-1,CHN,9,false,32,46,78,182,115,297,7,21,28,0,2:54
491192,2017-06-22,2017,NYA,ANA,5,10,10-5,ANA,9,false,36,42,78,152,166,318,10,15,25,2,3:24
491188,2017-06-22,2017,MIN,CHA,0,9,9-0,CHA,9,false,33,47,80,180,148,328,7,20,27,5,3:21 (4:50 delay)
491208,2017-06-23,2017,CHA,OAK,0,3,3-0,OAK,9,false,32,38,70,162,110,272,8,12,20,4,2:59
491210,2017-06-23,2017,SLN,PIT,3,4,4-3,PIT,9,false,38,36,74,143,166,309,13,8,21,3,3:08
491204,2017-06-23,2017,BOS,ANA,9,4,9-4,BOS,9,true,36,36,72,140,152,292,13,11,24,2,3:07
491211,2017-06-23,2017,NYA,TEX,2,1,2-1,NYA,10,false,36,38,74,159,135,294,8,9,17,1,3:32 (1:42 delay)
491207,2017-06-23,2017,SFN,NYN,4,11,11-4,NYN,9,false,37,47,84,179,138,317,11,22,33,1,3:13
491199,2017-06-23,2017,MIA,CHN,2,0,2-0,MIA,9,true,30,34,64,135,114,249,6,10,16,1,2:30
491202,2017-06-23,2017,SDN,DET,1,0,1-0,SDN,9,true,30,33,63,143,113,256,7,8,15,0,2:36
491201,2017-06-23,2017,LAN,COL,6,1,6-1,LAN,9,true,39,32,71,140,153,293,16,5,21,0,2:55
491209,2017-06-23,2017,ARI,PHI,1,6,6-1,PHI,9,false,34,41,75,153,135,288,8,13,21,1,2:54
491206,2017-06-23,2017,CLE,MIN,0,5,5-0,MIN,9,false,38,36,74,156,154,310,9,10,19,2,3:11
491212,2017-06-23,2017,KCA,TOR,5,4,5-4,KCA,9,false,37,42,79,154,165,319,10,16,26,5,3:16
491205,2017-06-23,2017,ATL,MIL,5,4,5-4,ATL,9,true,38,41,79,172,148,320,12,15,27,0,3:18
491198,2017-06-23,2017,TBA,BAL,15,5,15-5,TBA,9,true,46,38,84,127,176,303,20,12,32,2,3:19
491203,2017-06-23,2017,SEA,HOU,13,3,13-3,SEA,9,true,44,38,82,146,166,312,20,12,32,2,3:17
491200,2017-06-23,2017,WAS,CIN,6,5,6-5,WAS,10,false,48,44,92,150,200,350,22,16,38,3,3:51
491227,2017-06-24,2017,KCA,TOR,3,2,3-2,KCA,9,true,33,34,67,126,126,252,9,9,18,0,2:26
491222,2017-06-24,2017,SFN,NYN,2,5,5-2,NYN,9,false,34,39,73,154,120,274,7,15,22,2,2:52
491219,2017-06-24,2017,BOS,ANA,3,6,6-3,ANA,9,false,36,39,75,145,160,305,9,12,21,2,3:34
491213,2017-06-24,2017,TBA,BAL,3,8,8-3,BAL,9,false,35,44,79,166,137,303,12,16,28,2,3:10
491214,2017-06-24,2017,MIA,CHN,3,5,5-3,CHN,9,false,31,37,68,137,131,268,5,12,17,1,2:55
491223,2017-06-24,2017,CHA,OAK,2,10,10-2,OAK,9,false,35,50,85,200,128,328,6,22,28,2,3:22
491215,2017-06-24,2017,WAS,CIN,18,3,18-3,WAS,9,true,51,37,88,136,206,342,26,11,37,1,3:22
491217,2017-06-24,2017,SDN,DET,7,3,7-3,SDN,9,true,35,35,70,127,121,248,11,7,18,2,2:51
491220,2017-06-24,2017,ATL,MIL,3,1,3-1,ATL,9,true,34,34,68,128,132,260,10,8,18,1,2:57
491225,2017-06-24,2017,SLN,PIT,3,7,7-3,PIT,9,false,37,39,76,145,156,301,12,13,25,1,3:00
491226,2017-06-24,2017,NYA,TEX,1,8,8-1,TEX,9,false,32,40,72,166,118,284,6,13,19,1,3:03
491216,2017-06-24,2017,LAN,COL,4,0,4-0,LAN,9,true,39,33,72,138,163,301,16,6,22,1,3:18
491224,2017-06-24,2017,ARI,PHI,9,2,9-2,ARI,9,true,41,37,78,141,148,289,16,12,28,4,3:05
491221,2017-06-24,2017,CLE,MIN,2,4,4-2,MIN,9,false,38,36,74,144,165,309,13,9,22,2,3:13
491218,2017-06-24,2017,SEA,HOU,2,5,5-2,HOU,9,false,36,40,76,134,143,277,10,14,24,4,3:09
491236,2017-06-25,2017,CLE,MIN,0,4,4-0,MIN,9,false,37,38,75,134,135,269,10,12,22,1,2:55
491229,2017-06-25,2017,MIA,CHN,4,2,4-2,MIA,9,true,33,40,73,144,125,269,9,15,24,1,2:51
491240,2017-06-25,2017,SLN,PIT,8,4,8-4,SLN,9,true,40,35,75,139,177,316,17,9,26,3,3:11
491232,2017-06-25,2017,SDN,DET,5,7,7-5,DET,9,false,37,41,78,143,152,295,12,17,29,1,3:12
491230,2017-06-25,2017,WAS,CIN,2,6,6-2,CIN,9,false,36,39,75,158,139,297,10,14,24,2,3:07
491235,2017-06-25,2017,ATL,MIL,0,7,7-0,MIL,9,false,34,40,74,169,134,303,9,13,22,1,3:01
491228,2017-06-25,2017,TBA,BAL,5,8,8-5,BAL,9,false,40,41,81,147,158,305,16,17,33,4,3:15
491241,2017-06-25,2017,NYA,TEX,6,7,7-6,TEX,9,false,40,37,77,149,169,318,14,11,25,1,3:20
491242,2017-06-25,2017,KCA,TOR,2,8,8-2,TOR,9,false,35,47,82,184,139,323,10,19,29,3,3:21
491234,2017-06-25,2017,BOS,ANA,2,4,4-2,ANA,9,false,34,37,71,152,105,257,9,13,22,3,2:50
491233,2017-06-25,2017,SEA,HOU,2,8,8-2,HOU,9,false,38,39,77,145,165,310,11,14,25,3,3:21
491238,2017-06-25,2017,CHA,OAK,3,5,5-3,OAK,9,false,33,41,74,183,130,313,7,15,22,6,3:33
491239,2017-06-25,2017,ARI,PHI,2,1,2-1,ARI,11,false,41,42,83,168,168,336,11,12,23,1,3:50
491231,2017-06-25,2017,LAN,COL,12,6,12-6,LAN,9,true,43,41,84,176,197,373,20,14,34,5,4:19
491237,2017-06-25,2017,SFN,NYN,2,8,8-2,NYN,9,false,37,50,87,191,171,362,12,24,36,3,3:44
490449,2017-06-26,2017,SLN,CIN,8,2,8-2,SLN,9,true,40,36,76,130,140,270,18,10,28,1,2:49
491245,2017-06-26,2017,LAN,ANA,0,4,4-0,ANA,9,false,34,37,71,134,119,253,8,12,20,1,2:53
490449,2017-06-26,2017,SLN,CIN,8,2,8-2,SLN,9,true,40,36,76,130,140,270,18,10,28,1,2:49
491248,2017-06-26,2017,ARI,PHI,6,1,6-1,ARI,9,true,39,36,75,159,163,322,16,9,25,1,3:11
491247,2017-06-26,2017,CHA,NYA,5,6,6-5,NYA,9,false,41,42,83,167,158,325,14,14,28,3,3:28
491246,2017-06-26,2017,BOS,MIN,4,1,4-1,BOS,9,true,35,31,66,141,130,271,13,6,19,3,2:55
491244,2017-06-26,2017,SFN,COL,9,2,9-2,SFN,9,true,42,37,79,162,170,332,18,10,28,2,3:22
491243,2017-06-26,2017,WAS,CHN,4,5,5-4,CHN,9,false,40,42,82,171,157,328,13,18,31,5,3:54
491249,2017-06-26,2017,CLE,TEX,15,9,15-9,CLE,9,true,49,40,89,174,172,346,26,14,40,5,3:37
491255,2017-06-27,2017,LAN,ANA,4,0,4-0,LAN,9,true,31,31,62,108,127,235,8,5,13,1,2:30
491264,2017-06-27,2017,CLE,TEX,1,2,2-1,TEX,9,false,32,32,64,148,141,289,6,6,12,1,2:52
491263,2017-06-27,2017,PIT,TBA,2,4,4-2,TBA,10,false,37,37,74,129,132,261,10,8,18,1,3:05
491250,2017-06-27,2017,SDN,ATL,0,3,3-0,ATL,9,false,36,34,70,125,148,273,9,9,18,1,2:45
491261,2017-06-27,2017,SEA,PHI,2,8,8-2,PHI,9,false,34,41,75,139,135,274,9,15,24,1,3:02
491251,2017-06-27,2017,TOR,BAL,1,3,3-1,BAL,9,false,34,38,72,150,150,300,9,12,21,2,3:00
491252,2017-06-27,2017,WAS,CHN,6,1,6-1,WAS,9,true,39,30,69,137,154,291,16,4,20,2,3:09
491259,2017-06-27,2017,CHA,NYA,4,3,4-3,CHA,9,false,39,38,77,151,163,314,14,12,26,3,3:25
491256,2017-06-27,2017,CIN,MIL,8,6,8-6,CIN,9,true,37,39,76,152,138,290,14,14,28,2,2:55
491260,2017-06-27,2017,HOU,OAK,4,6,6-4,OAK,9,false,41,39,80,167,153,320,17,12,29,3,3:30
491258,2017-06-27,2017,MIA,NYN,6,3,6-3,MIA,9,true,36,37,73,163,141,304,14,11,25,3,3:03
491254,2017-06-27,2017,DET,KCA,5,3,5-3,DET,9,true,36,38,74,151,155,306,11,12,23,2,3:14
491257,2017-06-27,2017,BOS,MIN,9,2,9-2,BOS,9,true,41,35,76,151,182,333,19,9,28,1,3:18 (2:06 delay)
491262,2017-06-27,2017,ARI,SLN,6,5,6-5,ARI,10,false,45,43,88,150,176,326,17,13,30,1,3:22
491253,2017-06-27,2017,SFN,COL,4,3,4-3,SFN,14,false,55,54,109,204,195,399,15,19,34,4,4:45
491279,2017-06-28,2017,CLE,TEX,5,3,5-3,CLE,9,true,38,35,73,149,148,297,17,8,25,2,3:04
491273,2017-06-28,2017,MIA,NYN,0,8,8-0,NYN,9,false,34,40,74,162,140,302,9,14,23,2,2:57
491269,2017-06-28,2017,DET,KCA,2,8,8-2,KCA,9,false,33,43,76,136,114,250,8,19,27,1,2:46
491270,2017-06-28,2017,ANA,LAN,3,2,3-2,ANA,9,false,37,35,72,136,133,269,10,9,19,1,3:11
491266,2017-06-28,2017,TOR,BAL,4,0,4-0,TOR,9,true,33,33,66,141,146,287,11,7,18,1,2:27
491267,2017-06-28,2017,WAS,CHN,8,4,8-4,WAS,9,true,39,35,74,143,141,284,15,8,23,1,2:50
491271,2017-06-28,2017,CIN,MIL,4,3,4-3,CIN,9,true,34,36,70,151,145,296,11,11,22,2,2:56
491278,2017-06-28,2017,PIT,TBA,6,2,6-2,PIT,9,true,34,40,74,146,143,289,11,14,25,0,3:01
491268,2017-06-28,2017,SFN,COL,5,3,5-3,SFN,9,true,32,38,70,146,142,288,10,11,21,5,3:05
491272,2017-06-28,2017,BOS,MIN,1,4,4-1,MIN,9,false,39,38,77,160,152,312,12,12,24,3,3:14
491275,2017-06-28,2017,HOU,OAK,11,8,11-8,HOU,9,true,42,37,79,158,159,317,20,9,29,4,3:27
491274,2017-06-28,2017,CHA,NYA,3,12,12-3,NYA,9,false,39,45,84,193,176,369,12,19,31,2,3:51
491276,2017-06-28,2017,SEA,PHI,4,5,5-4,PHI,9,false,38,36,74,169,172,341,13,11,24,1,3:24
491277,2017-06-28,2017,ARI,SLN,3,4,4-3,SLN,9,false,38,37,75,151,149,300,12,13,25,2,3:18
491265,2017-06-28,2017,SDN,ATL,7,4,7-4,SDN,9,true,41,35,76,115,166,281,17,10,27,1,2:55
491284,2017-06-29,2017,ANA,LAN,2,6,6-2,LAN,9,false,36,38,74,135,125,260,9,10,19,3,3:06
491292,2017-06-29,2017,CLE,TEX,5,1,5-1,CLE,9,true,36,31,67,127,129,256,12,5,17,1,2:41
491282,2017-06-29,2017,WAS,CHN,4,5,5-4,CHN,9,false,37,38,75,125,153,278,12,13,25,4,3:12
491286,2017-06-29,2017,BOS,MIN,6,3,6-3,BOS,9,true,35,34,69,162,137,299,12,7,19,2,3:24
491285,2017-06-29,2017,CIN,MIL,3,11,11-3,MIL,9,false,35,44,79,163,144,307,9,18,27,1,3:15
491283,2017-06-29,2017,DET,KCA,7,3,7-3,DET,9,true,36,32,68,109,139,248,13,7,20,1,2:33
491288,2017-06-29,2017,CHA,NYA,4,3,4-3,CHA,9,true,35,38,73,117,139,256,10,13,23,2,3:01 (2:50 delay)
491281,2017-06-29,2017,TOR,BAL,0,2,2-0,BAL,9,false,31,36,67,122,114,236,4,10,14,1,2:20
491280,2017-06-29,2017,SDN,ATL,6,0,6-0,SDN,9,true,36,32,68,125,122,247,13,5,18,1,2:40
491291,2017-06-29,2017,PIT,TBA,4,0,4-0,PIT,9,true,35,37,72,138,130,268,13,11,24,2,2:54
491289,2017-06-29,2017,HOU,OAK,6,1,6-1,HOU,9,true,36,39,75,172,148,320,14,12,26,1,3:08
491287,2017-06-29,2017,MIA,NYN,3,6,6-3,NYN,9,false,34,36,70,145,126,271,10,9,19,1,2:43
491290,2017-06-29,2017,ARI,SLN,4,10,10-4,SLN,9,false,34,44,78,180,135,315,8,18,26,0,3:18
491300,2017-06-30,2017,KCA,MIN,8,1,8-1,KCA,9,true,37,34,71,121,135,256,12,7,19,1,2:39
491293,2017-06-30,2017,OAK,ATL,1,3,3-1,ATL,9,false,33,32,65,126,133,259,6,6,12,1,2:45
491302,2017-06-30,2017,NYN,PHI,2,1,2-1,NYN,9,true,32,32,64,137,134,271,10,5,15,2,2:38
491304,2017-06-30,2017,ANA,SEA,0,10,10-0,SEA,9,false,33,43,76,134,129,263,8,19,27,1,2:45
491307,2017-06-30,2017,SLN,WAS,8,1,8-1,SLN,9,true,42,32,74,113,170,283,18,10,28,1,2:54
491299,2017-06-30,2017,MIL,MIA,3,2,3-2,MIL,9,true,31,37,68,140,137,277,8,11,19,0,3:14
491301,2017-06-30,2017,HOU,NYA,4,13,13-4,NYA,9,false,36,48,84,182,121,303,9,21,30,3,3:20
491297,2017-06-30,2017,ARI,COL,3,6,6-3,COL,9,false,39,40,79,173,144,317,11,13,24,2,3:31
491306,2017-06-30,2017,CHA,TEX,8,7,8-7,CHA,9,false,38,42,80,189,134,323,14,18,32,3,3:42
491298,2017-06-30,2017,SDN,LAN,4,10,10-4,LAN,9,false,39,48,87,192,165,357,12,24,36,3,3:27
491294,2017-06-30,2017,TOR,BOS,4,7,7-4,BOS,11,false,46,57,103,241,204,445,14,30,44,3,4:44
491305,2017-06-30,2017,BAL,TBA,4,6,6-4,TBA,10,false,35,43,78,174,152,326,5,16,21,3,3:37
491295,2017-06-30,2017,CIN,CHN,5,0,5-0,CIN,9,true,34,32,66,134,133,267,13,5,18,1,2:37
491303,2017-06-30,2017,PIT,SFN,5,13,13-5,SFN,9,false,42,51,93,189,176,365,16,25,41,5,4:01
490519,2017-07-01,2017,DET,CLE,7,4,7-4,DET,9,true,40,35,75,147,140,287,20,8,28,4,2:59
490452,2017-07-01,2017,KCA,MIN,5,10,10-5,MIN,9,false,36,45,81,172,147,319,11,18,29,3,3:28
490519,2017-07-01,2017,DET,CLE,7,4,7-4,DET,9,true,40,35,75,147,140,287,20,8,28,4,2:59
491309,2017-07-01,2017,TOR,BOS,1,7,7-1,BOS,9,false,37,41,78,155,149,304,10,16,26,1,2:54
491315,2017-07-01,2017,KCA,MIN,11,6,11-6,KCA,9,true,42,48,90,224,148,372,19,21,40,2,3:39
491313,2017-07-01,2017,SDN,LAN,0,8,8-0,LAN,9,false,32,45,77,168,122,290,5,20,25,1,2:59
491310,2017-07-01,2017,CIN,CHN,5,3,5-3,CIN,9,true,37,36,73,149,144,293,18,11,29,2,3:02
491322,2017-07-01,2017,SLN,WAS,2,1,2-1,SLN,9,true,30,36,66,163,135,298,6,10,16,2,2:53
491311,2017-07-01,2017,DET,CLE,1,4,4-1,CLE,9,false,35,35,70,139,145,284,7,9,16,1,3:17
491321,2017-07-01,2017,CHA,TEX,4,10,10-4,TEX,9,false,33,45,78,194,130,324,7,19,26,4,3:26
490452,2017-07-01,2017,KCA,MIN,5,10,10-5,MIN,9,false,36,45,81,172,147,319,11,18,29,3,3:28
491317,2017-07-01,2017,NYN,PHI,7,6,7-6,NYN,9,true,33,42,75,183,111,294,13,14,27,4,3:21 (:57 delay)
491318,2017-07-01,2017,PIT,SFN,1,2,2-1,SFN,11,false,49,41,90,158,196,354,17,9,26,2,4:00
491320,2017-07-01,2017,BAL,TBA,3,10,10-3,TBA,9,false,37,44,81,175,167,342,11,17,28,1,3:23 (1:12 delay)
491319,2017-07-01,2017,ANA,SEA,4,0,4-0,ANA,9,true,32,30,62,105,114,219,11,4,15,2,2:32
491312,2017-07-01,2017,ARI,COL,6,2,6-2,ARI,9,true,37,33,70,124,107,231,13,6,19,3,2:38
491316,2017-07-01,2017,HOU,NYA,7,6,7-6,HOU,9,true,35,37,72,159,146,305,12,13,25,4,3:25
491308,2017-07-01,2017,OAK,ATL,3,4,4-3,ATL,9,false,38,37,75,152,144,296,12,9,21,2,3:16
491314,2017-07-01,2017,MIL,MIA,8,4,8-4,MIL,9,true,40,37,77,147,172,319,15,10,25,1,3:01
491333,2017-07-02,2017,PIT,SFN,3,5,5-3,SFN,9,false,34,36,70,141,130,271,7,9,16,3,2:55
491325,2017-07-02,2017,CIN,CHN,2,6,6-2,CHN,9,false,35,40,75,166,142,308,8,15,23,2,3:08
491336,2017-07-02,2017,CHA,TEX,6,5,6-5,CHA,9,true,34,41,75,165,152,317,13,13,26,2,3:43
491334,2017-07-02,2017,ANA,SEA,3,5,5-3,SEA,9,false,33,38,71,164,137,301,8,13,21,3,3:10
491335,2017-07-02,2017,BAL,TBA,7,1,7-1,BAL,9,true,35,33,68,136,122,258,10,7,17,1,2:39
491332,2017-07-02,2017,NYN,PHI,1,7,7-1,PHI,9,false,33,41,74,146,128,274,6,14,20,2,2:53
491328,2017-07-02,2017,SDN,LAN,5,3,5-3,SDN,9,true,35,42,77,177,135,312,14,15,29,4,3:37
491337,2017-07-02,2017,SLN,WAS,2,7,7-2,WAS,9,false,36,43,79,164,150,314,8,21,29,0,2:57
491330,2017-07-02,2017,KCA,MIN,6,2,6-2,KCA,9,true,39,37,76,169,140,309,16,11,27,2,3:08
491331,2017-07-02,2017,HOU,NYA,8,1,8-1,HOU,9,true,42,37,79,188,140,328,17,11,28,2,3:29
491327,2017-07-02,2017,ARI,COL,4,3,4-3,ARI,9,false,35,39,74,138,144,282,11,13,24,3,3:04
491324,2017-07-02,2017,TOR,BOS,1,15,15-1,BOS,9,false,34,50,84,198,157,355,8,25,33,2,3:34
491329,2017-07-02,2017,MIL,MIA,3,10,10-3,MIA,9,false,37,52,89,214,150,364,10,28,38,2,3:43
491326,2017-07-02,2017,DET,CLE,8,11,11-8,CLE,9,false,44,49,93,220,164,384,16,23,39,3,3:55
491323,2017-07-02,2017,OAK,ATL,3,4,4-3,ATL,12,false,51,45,96,186,202,388,17,13,30,5,4:11
491338,2017-07-03,2017,MIL,BAL,8,1,8-1,MIL,9,true,37,34,71,144,137,281,14,8,22,1,2:35
491344,2017-07-03,2017,SLN,MIA,14,6,14-6,SLN,9,true,44,43,87,174,167,341,22,16,38,1,3:17
491342,2017-07-03,2017,SEA,KCA,1,3,3-1,KCA,9,false,33,34,67,119,126,245,6,7,13,2,2:28
491341,2017-07-03,2017,COL,CIN,5,3,5-3,COL,9,true,36,33,69,113,148,261,13,8,21,1,2:48
491343,2017-07-03,2017,MIN,ANA,9,5,9-5,MIN,9,true,42,38,80,136,140,276,19,13,32,0,3:00
491346,2017-07-03,2017,PHI,PIT,4,0,4-0,PHI,9,true,31,33,64,123,116,239,8,5,13,0,2:36
491340,2017-07-03,2017,OAK,CHA,2,7,7-2,CHA,9,false,37,47,84,190,148,338,9,20,29,2,3:33
491339,2017-07-03,2017,TEX,BOS,5,7,7-5,BOS,11,false,43,50,93,193,180,373,11,18,29,3,4:07
491347,2017-07-03,2017,NYA,TOR,6,3,6-3,NYA,9,true,35,36,71,157,139,296,13,11,24,1,3:11
491345,2017-07-03,2017,WAS,NYN,3,2,3-2,WAS,9,false,37,35,72,139,160,299,12,10,22,5,3:18
491354,2017-07-04,2017,SEA,KCA,3,7,7-3,KCA,9,false,38,39,77,133,145,278,13,11,24,1,2:55
491358,2017-07-04,2017,PHI,PIT,0,3,3-0,PIT,9,false,38,35,73,133,154,287,11,9,20,2,3:01 (:22 delay)
491351,2017-07-04,2017,OAK,CHA,7,6,7-6,OAK,9,false,35,39,74,144,153,297,11,13,24,5,3:09
491352,2017-07-04,2017,COL,CIN,1,8,8-1,CIN,9,false,35,41,76,150,142,292,10,14,24,1,2:58
491350,2017-07-04,2017,TEX,BOS,4,11,11-4,BOS,9,false,41,49,90,183,176,359,14,22,36,2,3:56
491360,2017-07-04,2017,DET,SFN,5,3,5-3,DET,9,true,33,33,66,117,108,225,10,6,16,1,2:23
491349,2017-07-04,2017,MIL,BAL,6,2,6-2,MIL,9,true,33,33,66,116,121,237,11,8,19,0,2:25
491355,2017-07-04,2017,MIN,ANA,5,4,5-4,MIN,9,true,38,36,74,145,147,292,15,12,27,2,3:20
491359,2017-07-04,2017,CLE,SDN,0,1,1-0,SDN,9,false,34,32,66,121,153,274,8,6,14,1,2:59
491362,2017-07-04,2017,NYA,TOR,1,4,4-1,TOR,9,false,34,38,72,152,163,315,7,12,19,3,3:08
491357,2017-07-04,2017,WAS,NYN,11,4,11-4,WAS,9,true,42,40,82,145,144,289,19,14,33,2,3:17
491353,2017-07-04,2017,ATL,HOU,4,16,16-4,HOU,9,false,38,49,87,185,147,332,12,26,38,2,3:39 (:18 delay)
491356,2017-07-04,2017,SLN,MIA,2,5,5-2,MIA,9,false,37,37,74,157,154,311,10,11,21,1,3:04
491348,2017-07-04,2017,LAN,ARI,4,3,4-3,LAN,9,true,36,36,72,162,168,330,12,9,21,3,3:26
491361,2017-07-04,2017,CHN,TBA,5,6,6-5,TBA,9,false,42,37,79,143,189,332,17,12,29,1,3:25
491376,2017-07-05,2017,CHN,TBA,7,3,7-3,CHN,9,true,39,34,73,125,159,284,18,10,28,2,3:10
491366,2017-07-05,2017,OAK,CHA,7,4,7-4,OAK,9,true,36,33,69,155,188,343,14,7,21,3,3:24
491374,2017-07-05,2017,CLE,SDN,2,6,6-2,SDN,9,false,38,42,80,166,147,313,14,16,30,3,3:21
491373,2017-07-05,2017,PHI,PIT,2,5,5-2,PIT,9,false,37,40,77,163,153,316,11,12,23,1,3:16
491377,2017-07-05,2017,NYA,TOR,6,7,7-6,TOR,9,false,38,43,81,168,177,345,13,17,30,4,3:28
491363,2017-07-05,2017,LAN,ARI,1,0,1-0,LAN,9,true,31,34,65,120,135,255,9,7,16,1,2:56
491364,2017-07-05,2017,MIL,BAL,4,0,4-0,MIL,9,true,33,37,70,148,120,268,8,10,18,3,3:04
491365,2017-07-05,2017,TEX,BOS,8,2,8-2,TEX,9,true,38,33,71,127,157,284,14,6,20,1,2:52 (1:26 delay)
491375,2017-07-05,2017,DET,SFN,4,5,5-4,SFN,9,false,37,40,77,150,137,287,11,18,29,3,3:18
491371,2017-07-05,2017,SLN,MIA,6,9,9-6,MIA,9,false,40,43,83,158,154,312,13,19,32,3,3:19
491367,2017-07-05,2017,COL,CIN,5,3,5-3,COL,9,true,34,40,74,161,141,302,10,14,24,4,3:24
491370,2017-07-05,2017,MIN,ANA,1,2,2-1,ANA,9,false,37,34,71,117,151,268,10,9,19,0,2:54
491368,2017-07-05,2017,ATL,HOU,4,10,10-4,HOU,9,false,36,44,80,161,148,309,9,20,29,3,3:21 (:26 delay)
491369,2017-07-05,2017,SEA,KCA,6,9,9-6,KCA,10,false,39,46,85,202,143,345,11,15,26,3,3:34
490741,2017-07-06,2017,CHN,MIL,2,11,11-2,MIL,9,false,33,48,81,198,144,342,8,22,30,2,3:11
491386,2017-07-06,2017,PHI,PIT,3,6,6-3,PIT,9,false,30,40,70,145,123,268,9,13,22,2,2:58 (:47 delay)
491382,2017-07-06,2017,COL,CIN,3,6,6-3,CIN,9,false,34,42,76,152,136,288,9,18,27,1,3:04
491379,2017-07-06,2017,WAS,ATL,2,5,5-2,ATL,9,false,38,42,80,155,159,314,13,16,29,2,3:10 (3:05 delay)
491381,2017-07-06,2017,TBA,BOS,4,1,4-1,TBA,9,true,33,36,69,143,130,273,10,11,21,0,2:43
491378,2017-07-06,2017,LAN,ARI,5,4,5-4,LAN,9,false,40,36,76,134,150,284,20,10,30,3,3:07
491380,2017-07-06,2017,MIN,BAL,6,4,6-4,MIN,9,true,36,41,77,165,132,297,11,13,24,1,3:03
491387,2017-07-06,2017,CLE,SDN,11,2,11-2,CLE,9,true,43,32,75,118,179,297,18,5,23,4,3:08
491384,2017-07-06,2017,SLN,MIA,4,3,4-3,SLN,9,true,38,42,80,155,144,299,15,17,32,2,3:11
491388,2017-07-06,2017,DET,SFN,6,2,6-2,DET,9,true,35,33,68,123,133,256,13,6,19,1,2:38
491385,2017-07-06,2017,SEA,OAK,4,7,7-4,OAK,9,false,36,40,76,161,125,286,13,15,28,3,2:56
490741,2017-07-06,2017,CHN,MIL,2,11,11-2,MIL,9,false,33,48,81,198,144,342,8,22,30,2,3:11
491383,2017-07-06,2017,TOR,HOU,7,4,7-4,TOR,9,true,40,39,79,148,173,321,16,14,30,4,3:18
491403,2017-07-07,2017,PHI,SDN,3,4,4-3,SDN,9,false,38,36,74,130,136,266,11,9,20,1,2:41 (1:34 delay)
491401,2017-07-07,2017,SEA,OAK,7,2,7-2,SEA,9,true,35,32,67,129,135,264,13,7,20,2,2:39
491397,2017-07-07,2017,TEX,ANA,10,0,10-0,TEX,9,true,39,28,67,109,164,273,16,4,20,2,2:49
491393,2017-07-07,2017,ARI,CIN,6,3,6-3,ARI,9,true,35,35,70,147,138,285,12,9,21,2,2:57
491396,2017-07-07,2017,LAN,KCA,4,1,4-1,LAN,9,true,37,33,70,133,135,268,14,7,21,1,2:59
491400,2017-07-07,2017,SLN,NYN,5,6,6-5,NYN,9,false,35,41,76,142,129,271,10,14,24,2,2:47
491398,2017-07-07,2017,SFN,MIA,1,6,6-1,MIA,9,false,32,41,73,139,129,268,6,18,24,2,2:40
491394,2017-07-07,2017,CLE,DET,11,2,11-2,CLE,9,true,45,34,79,113,184,297,24,11,35,2,3:21
491392,2017-07-07,2017,COL,CHA,12,4,12-4,COL,9,true,41,37,78,137,176,313,18,13,31,3,3:08
491391,2017-07-07,2017,TBA,BOS,3,8,8-3,BOS,9,false,40,42,82,175,154,329,16,15,31,2,3:24
491402,2017-07-07,2017,CHN,PIT,6,1,6-1,CHN,9,true,39,40,79,179,168,347,15,13,28,3,3:46
491390,2017-07-07,2017,MIN,BAL,9,6,9-6,MIN,9,true,38,38,76,140,158,298,15,13,28,4,3:13
491389,2017-07-07,2017,WAS,ATL,5,4,5-4,WAS,10,false,41,40,81,148,164,312,14,14,28,3,3:28
491399,2017-07-07,2017,NYA,MIL,4,9,9-4,MIL,9,false,39,45,84,183,177,360,11,20,31,5,3:57 (:51 delay)
491395,2017-07-07,2017,TOR,HOU,2,12,12-2,HOU,9,false,32,45,77,171,151,322,8,19,27,1,3:00
491406,2017-07-08,2017,TBA,BOS,1,0,1-0,TBA,9,true,32,34,66,141,111,252,8,7,15,1,2:41
491415,2017-07-08,2017,SLN,NYN,4,1,4-1,SLN,9,true,38,34,72,124,159,283,16,7,23,4,3:07
491417,2017-07-08,2017,CHN,PIT,2,4,4-2,PIT,9,false,33,38,71,143,126,269,6,12,18,4,2:59
491409,2017-07-08,2017,CLE,DET,4,0,4-0,CLE,9,true,38,32,70,136,154,290,16,6,22,2,3:15
491405,2017-07-08,2017,MIN,BAL,1,5,5-1,BAL,9,false,39,38,77,134,166,300,13,12,25,2,3:04
491412,2017-07-08,2017,TEX,ANA,5,2,5-2,TEX,9,true,37,38,75,149,153,302,15,12,27,1,3:13
491404,2017-07-08,2017,WAS,ATL,0,13,13-0,ATL,9,false,36,48,84,184,126,310,8,21,29,1,3:12
491411,2017-07-08,2017,LAN,KCA,5,4,5-4,LAN,10,false,40,43,83,161,164,325,13,14,27,4,3:43
491418,2017-07-08,2017,PHI,SDN,1,2,2-1,SDN,9,false,32,34,66,122,117,239,7,7,14,1,2:30
491413,2017-07-08,2017,SFN,MIA,4,5,5-4,MIA,9,false,39,38,77,129,148,277,12,11,23,3,3:01
491407,2017-07-08,2017,COL,CHA,4,5,5-4,CHA,9,false,38,37,75,125,151,276,12,13,25,2,3:09
491410,2017-07-08,2017,TOR,HOU,7,2,7-2,TOR,9,true,38,33,71,129,143,272,15,10,25,0,2:44
491414,2017-07-08,2017,NYA,MIL,5,3,5-3,NYA,9,false,34,35,69,131,128,259,9,9,18,1,2:36
491416,2017-07-08,2017,SEA,OAK,3,4,4-3,OAK,9,false,35,41,76,148,138,286,9,15,24,0,2:54
491408,2017-07-08,2017,ARI,CIN,0,7,7-0,CIN,9,false,34,40,74,166,146,312,6,13,19,1,3:00
491426,2017-07-09,2017,LAN,KCA,5,2,5-2,LAN,9,true,30,33,63,99,112,211,6,6,12,0,2:16
491430,2017-07-09,2017,SLN,NYN,6,0,6-0,SLN,9,true,36,29,65,117,140,257,12,4,16,1,2:28
491431,2017-07-09,2017,SEA,OAK,4,0,4-0,SEA,9,true,31,33,64,137,116,253,10,7,17,3,2:39
491427,2017-07-09,2017,TEX,ANA,0,3,3-0,ANA,9,false,33,35,68,125,142,267,8,11,19,2,3:08
491423,2017-07-09,2017,ARI,CIN,1,2,2-1,CIN,9,false,36,37,73,143,136,279,12,11,23,1,2:53
491421,2017-07-09,2017,TBA,BOS,5,3,5-3,TBA,9,true,35,39,74,144,142,286,11,13,24,2,3:07
491433,2017-07-09,2017,PHI,SDN,7,1,7-1,PHI,9,true,33,39,72,135,132,267,10,12,22,0,2:45
491422,2017-07-09,2017,COL,CHA,10,0,10-0,COL,9,true,41,31,72,132,163,295,18,5,23,4,3:13
491432,2017-07-09,2017,CHN,PIT,3,14,14-3,PIT,9,false,40,48,88,173,140,313,16,21,37,2,3:14
491419,2017-07-09,2017,WAS,ATL,10,5,10-5,WAS,9,true,42,36,78,135,182,317,19,10,29,4,3:32
491429,2017-07-09,2017,NYA,MIL,3,5,5-3,MIL,9,false,40,40,80,172,174,346,13,14,27,7,3:59
491420,2017-07-09,2017,MIN,BAL,5,11,11-5,BAL,9,false,38,44,82,165,154,319,10,17,27,2,3:11
491424,2017-07-09,2017,CLE,DET,3,5,5-3,DET,9,false,38,43,81,182,146,328,13,17,30,4,3:49
491425,2017-07-09,2017,TOR,HOU,1,19,19-1,HOU,9,false,38,54,92,209,144,353,12,26,38,2,3:24
491428,2017-07-09,2017,SFN,MIA,8,10,10-8,MIA,11,false,48,57,105,202,187,389,16,26,42,5,4:10
491434,2017-07-11,2017,NAS,AAS,1,2,2-1,AAS,10,false,39,40,79,153,159,312,12,11,23,0,3:16
491449,2017-07-14,2017,CIN,WAS,0,5,5-0,WAS,9,false,35,39,74,160,132,292,9,13,22,3,2:55
491438,2017-07-14,2017,NYN,COL,14,2,14-2,NYN,9,true,49,34,83,129,197,326,26,8,34,1,3:21
491436,2017-07-14,2017,BAL,CHN,8,9,9-8,CHN,9,false,45,38,83,154,189,343,18,12,30,3,3:42 (:49 delay)
491448,2017-07-14,2017,DET,TOR,2,7,7-2,TOR,9,false,38,45,83,219,162,381,12,18,30,2,3:48
491446,2017-07-14,2017,ANA,TBA,1,2,2-1,TBA,10,false,39,35,74,133,142,275,9,6,15,2,3:04
491447,2017-07-14,2017,KCA,TEX,3,5,5-3,TEX,9,false,33,38,71,157,107,264,9,10,19,1,2:58
491437,2017-07-14,2017,OAK,CLE,5,0,5-0,OAK,9,true,33,33,66,152,125,277,9,5,14,2,2:48
491445,2017-07-14,2017,PIT,SLN,5,2,5-2,PIT,9,false,40,33,73,135,140,275,19,6,25,0,3:06
491442,2017-07-14,2017,MIL,PHI,9,6,9-6,MIL,9,true,38,42,80,166,142,308,12,15,27,3,3:10
491443,2017-07-14,2017,SDN,SFN,4,5,5-4,SFN,9,false,42,41,83,145,160,305,16,17,33,3,3:27
491444,2017-07-14,2017,CHA,SEA,2,4,4-2,SEA,9,false,32,39,71,146,139,285,5,14,19,1,2:50
491435,2017-07-14,2017,ATL,ARI,4,3,4-3,ATL,9,true,34,39,73,151,142,293,9,14,23,1,3:02
491441,2017-07-14,2017,BOS,NYA,5,4,5-4,BOS,9,false,41,34,75,136,181,317,17,8,25,0,3:27
491439,2017-07-14,2017,MIA,LAN,4,6,6-4,LAN,9,false,37,36,73,145,139,284,11,12,23,1,3:00
491440,2017-07-14,2017,HOU,MIN,10,5,10-5,HOU,9,true,44,43,87,183,179,362,21,15,36,3,3:42
491462,2017-07-15,2017,KCA,TEX,0,1,1-0,TEX,9,false,32,30,62,100,116,216,6,5,11,3,2:32
491457,2017-07-15,2017,MIL,PHI,3,2,3-2,MIL,9,true,34,33,67,130,126,256,10,8,18,1,2:44 (:20 delay)
491461,2017-07-15,2017,ANA,TBA,3,6,6-3,TBA,9,false,36,42,78,141,126,267,11,17,28,1,3:00
491452,2017-07-15,2017,OAK,CLE,5,3,5-3,OAK,9,false,31,35,66,138,130,268,7,9,16,2,2:35
491463,2017-07-15,2017,DET,TOR,11,1,11-1,DET,9,true,43,29,72,115,175,290,21,3,24,2,2:47
491458,2017-07-15,2017,SDN,SFN,5,3,5-3,SDN,9,false,34,37,71,141,130,271,10,11,21,1,2:53
491453,2017-07-15,2017,NYN,COL,9,3,9-3,NYN,9,true,37,36,73,136,147,283,12,10,22,3,3:00
491455,2017-07-15,2017,HOU,MIN,2,4,4-2,MIN,9,false,40,41,81,145,157,302,14,16,30,3,3:21
491460,2017-07-15,2017,PIT,SLN,0,4,4-0,SLN,9,false,36,35,71,140,147,287,10,10,20,1,3:00
491459,2017-07-15,2017,CHA,SEA,3,4,4-3,SEA,9,false,39,34,73,146,157,303,12,8,20,2,3:26
491451,2017-07-15,2017,BAL,CHN,3,10,10-3,CHN,9,false,37,45,82,160,134,294,11,21,32,3,3:02
491450,2017-07-15,2017,ATL,ARI,8,5,8-5,ATL,9,true,39,43,82,176,151,327,17,16,33,5,3:28
491454,2017-07-15,2017,MIA,LAN,1,7,7-1,LAN,9,false,35,43,78,190,145,335,10,18,28,1,3:19
491464,2017-07-15,2017,CIN,WAS,7,10,10-7,WAS,9,false,44,44,88,165,181,346,16,18,34,3,3:32
491456,2017-07-15,2017,BOS,NYA,1,4,4-1,NYA,16,false,58,66,124,267,245,512,12,19,31,4,5:50
490398,2017-07-16,2017,BOS,NYA,0,3,3-0,NYA,9,false,37,40,77,150,154,304,11,13,24,1,3:13
491476,2017-07-16,2017,ANA,TBA,4,3,4-3,ANA,9,true,36,34,70,131,126,257,13,11,24,2,3:03
491473,2017-07-16,2017,SDN,SFN,7,1,7-1,SDN,9,true,34,36,70,121,116,237,12,10,22,1,2:39
491467,2017-07-16,2017,OAK,CLE,7,3,7-3,OAK,9,true,38,37,75,142,158,300,16,11,27,4,3:08
491470,2017-07-16,2017,HOU,MIN,5,3,5-3,HOU,9,true,34,32,66,121,136,257,11,6,17,2,2:47
491465,2017-07-16,2017,ATL,ARI,7,1,7-1,ATL,9,true,35,33,68,126,128,254,10,7,17,0,2:47
491466,2017-07-16,2017,BAL,CHN,0,8,8-0,CHN,9,false,30,43,73,160,127,287,4,18,22,2,2:56
491475,2017-07-16,2017,PIT,SLN,4,3,4-3,PIT,9,false,37,40,77,136,130,266,12,15,27,1,3:02
491477,2017-07-16,2017,KCA,TEX,4,3,4-3,KCA,9,false,39,34,73,138,141,279,13,9,22,2,3:11
491469,2017-07-16,2017,MIA,LAN,2,3,3-2,LAN,9,false,35,39,74,162,153,315,9,13,22,2,3:18
491472,2017-07-16,2017,MIL,PHI,2,5,5-2,PHI,9,false,36,40,76,146,148,294,9,14,23,1,3:18
490398,2017-07-16,2017,BOS,NYA,0,3,3-0,NYA,9,false,37,40,77,150,154,304,11,13,24,1,3:13
491474,2017-07-16,2017,CHA,SEA,6,7,7-6,SEA,10,false,41,44,85,141,167,308,12,15,27,5,3:22
491468,2017-07-16,2017,NYN,COL,4,13,13-4,COL,9,false,36,50,86,185,135,320,10,24,34,1,3:26
491479,2017-07-16,2017,CIN,WAS,4,14,14-4,WAS,9,false,41,48,89,181,167,348,12,21,33,1,3:31
491478,2017-07-16,2017,DET,TOR,6,5,6-5,DET,11,false,49,45,94,167,205,372,17,13,30,4,4:16
491471,2017-07-16,2017,BOS,NYA,3,0,3-0,BOS,9,true,31,36,67,127,117,244,8,9,17,1,2:59
491481,2017-07-17,2017,SFN,CLE,3,5,5-3,CLE,9,false,31,39,70,137,95,232,6,10,16,2,2:33
491490,2017-07-17,2017,BAL,TEX,3,1,3-1,BAL,9,true,31,34,65,146,118,264,10,9,19,1,2:55
491492,2017-07-17,2017,CIN,WAS,1,6,6-1,WAS,9,false,32,41,73,162,130,292,7,15,22,0,2:58
491484,2017-07-17,2017,MIN,NYA,4,2,4-2,MIN,9,true,37,36,73,120,150,270,14,13,27,2,3:02
491491,2017-07-17,2017,BOS,TOR,3,4,4-3,TOR,9,false,35,39,74,168,130,298,9,13,22,2,3:18
491480,2017-07-17,2017,ATL,CHN,3,4,4-3,CHN,9,false,35,40,75,151,143,294,10,13,23,1,3:17 (1:03 delay)
491483,2017-07-17,2017,PIT,MIL,4,2,4-2,PIT,9,true,38,40,78,166,127,293,18,14,32,3,3:15
491488,2017-07-17,2017,NYN,SLN,3,6,6-3,SLN,9,false,39,42,81,163,148,311,12,15,27,4,3:20
491486,2017-07-17,2017,COL,SDN,9,6,9-6,COL,9,true,39,42,81,149,141,290,18,16,34,6,3:23
491487,2017-07-17,2017,HOU,SEA,7,9,9-7,SEA,10,false,47,45,92,180,168,348,19,15,34,4,3:49
491485,2017-07-17,2017,MIA,PHI,6,5,6-5,MIA,10,false,46,42,88,179,152,331,21,14,35,4,3:41
491482,2017-07-17,2017,KCA,DET,2,10,10-2,DET,9,false,40,46,86,175,159,334,13,22,35,4,3:29
491489,2017-07-17,2017,OAK,TBA,2,3,3-2,TBA,9,false,33,37,70,135,134,269,5,10,15,0,2:48
491507,2017-07-18,2017,ANA,WAS,3,4,4-3,WAS,9,false,31,38,69,134,127,261,5,13,18,1,2:57
491496,2017-07-18,2017,KCA,DET,3,9,9-3,DET,9,false,39,43,82,142,123,265,13,16,29,1,2:54
491502,2017-07-18,2017,HOU,SEA,6,2,6-2,HOU,9,true,33,34,67,138,126,264,13,7,20,2,3:02
491500,2017-07-18,2017,MIA,PHI,2,5,5-2,PHI,9,false,31,40,71,137,126,263,6,16,22,0,2:41
491503,2017-07-18,2017,NYN,SLN,0,5,5-0,SLN,9,false,31,42,73,156,119,275,4,15,19,2,2:52
491504,2017-07-18,2017,OAK,TBA,3,4,4-3,TBA,9,false,34,36,70,132,145,277,8,9,17,2,2:50
491501,2017-07-18,2017,COL,SDN,9,7,9-7,COL,9,true,40,40,80,157,143,300,17,14,31,2,3:14
491495,2017-07-18,2017,SFN,CLE,2,1,2-1,SFN,10,false,38,37,75,139,158,297,12,9,21,1,3:04
491497,2017-07-18,2017,CHA,LAN,0,1,1-0,LAN,9,false,35,39,74,147,129,276,9,18,27,3,3:21
491499,2017-07-18,2017,MIN,NYA,3,6,6-3,NYA,9,false,42,40,82,145,161,306,15,15,30,4,3:28
491498,2017-07-18,2017,PIT,MIL,4,3,4-3,PIT,9,true,31,38,69,129,127,256,8,15,23,1,2:58
491494,2017-07-18,2017,ATL,CHN,1,5,5-1,CHN,9,false,37,41,78,153,156,309,10,14,24,1,3:01 (2:30 delay)
491505,2017-07-18,2017,BAL,TEX,12,1,12-1,BAL,9,true,46,34,80,134,191,325,22,8,30,2,3:23
491493,2017-07-18,2017,CIN,ARI,2,11,11-2,ARI,9,false,35,45,80,184,128,312,10,22,32,1,3:05
491506,2017-07-18,2017,BOS,TOR,5,4,5-4,BOS,15,false,58,60,118,218,239,457,16,21,37,4,4:59 (1:00 delay)
491521,2017-07-19,2017,BOS,TOR,5,1,5-1,BOS,9,true,34,35,69,150,122,272,12,10,22,1,2:47
491522,2017-07-19,2017,ANA,WAS,7,0,7-0,ANA,9,true,37,29,66,121,152,273,13,2,15,2,2:47
491514,2017-07-19,2017,MIN,NYA,6,1,6-1,MIN,9,true,33,37,70,151,136,287,9,12,21,1,2:58
491517,2017-07-19,2017,HOU,SEA,1,4,4-1,SEA,9,false,36,34,70,142,144,286,10,7,17,2,2:51
491510,2017-07-19,2017,SFN,CLE,5,4,5-4,SFN,9,true,35,40,75,135,157,292,12,15,27,3,3:16
491511,2017-07-19,2017,KCA,DET,4,3,4-3,KCA,9,false,36,37,73,145,130,275,12,10,22,3,3:16
491509,2017-07-19,2017,ATL,CHN,2,8,8-2,CHN,9,false,34,41,75,146,123,269,8,16,24,3,3:05
491513,2017-07-19,2017,PIT,MIL,3,2,3-2,PIT,10,false,41,38,79,141,152,293,16,9,25,0,3:23
491518,2017-07-19,2017,NYN,SLN,7,3,7-3,NYN,9,true,39,41,80,161,126,287,15,14,29,3,2:59
491516,2017-07-19,2017,COL,SDN,18,4,18-4,COL,9,true,49,37,86,156,182,338,25,14,39,1,3:30
491508,2017-07-19,2017,CIN,ARI,4,3,4-3,CIN,11,false,49,44,93,161,198,359,21,11,32,3,3:59
491512,2017-07-19,2017,CHA,LAN,1,9,9-1,LAN,8,true,27,39,66,167,106,273,7,18,25,3,2:58 (:37 delay)
491519,2017-07-19,2017,OAK,TBA,7,2,7-2,OAK,9,true,38,37,75,138,142,280,17,11,28,4,3:08
491520,2017-07-19,2017,BAL,TEX,10,2,10-2,BAL,9,true,37,37,74,144,121,265,13,11,24,2,2:50
491515,2017-07-19,2017,MIA,PHI,3,10,10-3,PHI,9,false,35,52,87,174,144,318,9,28,37,2,3:04
491530,2017-07-20,2017,BAL,TEX,9,7,9-7,BAL,9,true,40,39,79,147,151,298,18,14,32,1,3:11
491531,2017-07-20,2017,BOS,TOR,6,8,8-6,TOR,9,false,40,44,84,173,163,336,15,16,31,5,3:25
491524,2017-07-20,2017,LAN,ATL,3,6,6-3,ATL,9,false,37,38,75,136,134,270,10,13,23,1,2:49
491523,2017-07-20,2017,CIN,ARI,2,12,12-2,ARI,9,false,34,40,74,175,126,301,9,13,22,1,2:47
491529,2017-07-20,2017,NYN,SLN,3,2,3-2,NYN,9,false,34,34,68,133,144,277,8,8,16,1,2:47
491528,2017-07-20,2017,SFN,SDN,2,5,5-2,SDN,9,false,36,36,72,144,142,286,10,11,21,2,2:59
491525,2017-07-20,2017,KCA,DET,16,4,16-4,KCA,9,true,48,39,87,144,187,331,23,13,36,3,3:34
491526,2017-07-20,2017,PIT,MIL,4,2,4-2,PIT,9,true,32,38,70,173,127,300,9,13,22,1,3:03
491527,2017-07-20,2017,SEA,NYA,1,4,4-1,NYA,9,false,40,37,77,157,144,301,13,10,23,1,3:14
491533,2017-07-21,2017,ANA,BOS,2,6,6-2,BOS,9,false,37,36,73,149,163,312,11,10,21,1,3:05
491539,2017-07-21,2017,SEA,NYA,1,5,5-1,NYA,9,false,37,38,75,123,151,274,11,13,24,1,2:50
491532,2017-07-21,2017,LAN,ATL,3,12,12-3,ATL,9,false,35,46,81,163,124,287,9,19,28,1,3:07
491546,2017-07-21,2017,ARI,WAS,6,5,6-5,ARI,9,false,42,39,81,148,167,315,20,12,32,3,3:23
491541,2017-07-21,2017,COL,PIT,5,13,13-5,PIT,9,false,35,52,87,185,137,322,11,28,39,2,3:36
491538,2017-07-21,2017,PHI,MIL,6,1,6-1,PHI,9,true,38,33,71,117,163,280,14,8,22,1,3:02
491536,2017-07-21,2017,BAL,HOU,7,8,8-7,HOU,9,false,41,42,83,132,154,286,14,17,31,3,3:02
491537,2017-07-21,2017,CIN,MIA,1,3,3-1,MIA,9,false,36,37,73,124,141,265,9,12,21,1,2:57 (1:47 delay)
491540,2017-07-21,2017,NYN,OAK,7,5,7-5,NYN,9,true,34,43,77,167,120,287,12,17,29,4,3:14
491543,2017-07-21,2017,CHN,SLN,4,11,11-4,SLN,9,false,40,45,85,196,131,327,13,19,32,3,3:17
491535,2017-07-21,2017,MIN,DET,3,6,6-3,DET,9,false,37,40,77,166,143,309,11,15,26,3,3:34
491544,2017-07-21,2017,TBA,TEX,3,4,4-3,TEX,10,false,37,39,76,143,120,263,7,11,18,1,3:10
491545,2017-07-21,2017,CLE,TOR,13,3,13-3,CLE,9,true,44,39,83,168,164,332,21,14,35,4,3:23
491534,2017-07-21,2017,KCA,CHA,7,6,7-6,KCA,10,false,46,41,87,169,194,363,20,14,34,4,4:10
491542,2017-07-21,2017,SFN,SDN,9,12,12-9,SDN,11,false,49,57,106,233,191,424,16,26,42,5,4:46
491558,2017-07-22,2017,CHN,SLN,3,2,3-2,CHN,9,true,31,32,63,122,118,240,8,6,14,2,2:34
491551,2017-07-22,2017,BAL,HOU,4,8,8-4,HOU,9,false,35,43,78,175,134,309,8,16,24,2,3:28 (:58 delay)
491552,2017-07-22,2017,CIN,MIA,4,5,5-4,MIA,9,false,39,38,77,142,155,297,18,13,31,3,3:12 (1:00 delay)
491557,2017-07-22,2017,SFN,SDN,5,4,5-4,SFN,12,false,52,46,98,184,178,362,16,11,27,1,3:57
491548,2017-07-22,2017,ANA,BOS,7,3,7-3,ANA,9,true,38,35,73,130,158,288,14,9,23,0,3:07
491561,2017-07-22,2017,ARI,WAS,3,4,4-3,WAS,9,false,34,39,73,147,136,283,6,13,19,3,2:56
491559,2017-07-22,2017,TBA,TEX,3,4,4-3,TEX,9,false,37,34,71,132,140,272,11,6,17,1,2:56
491550,2017-07-22,2017,MIN,DET,6,5,6-5,MIN,9,true,41,38,79,143,148,291,19,12,31,4,3:20
491549,2017-07-22,2017,KCA,CHA,7,2,7-2,KCA,9,true,36,37,73,162,155,317,15,11,26,3,3:20
491560,2017-07-22,2017,CLE,TOR,2,1,2-1,CLE,10,false,38,34,72,136,150,286,13,5,18,2,3:01
491554,2017-07-22,2017,SEA,NYA,6,5,6-5,SEA,10,false,40,40,80,168,146,314,14,13,27,3,3:28
491556,2017-07-22,2017,COL,PIT,7,3,7-3,COL,9,true,39,38,77,151,145,296,17,13,30,1,3:07
491555,2017-07-22,2017,NYN,OAK,6,5,6-5,NYN,9,false,40,41,81,158,138,296,16,16,32,2,3:07
491553,2017-07-22,2017,PHI,MIL,8,9,9-8,MIL,9,false,41,43,84,165,153,318,14,18,32,1,3:24 (:26 delay)
491547,2017-07-22,2017,LAN,ATL,6,2,6-2,LAN,9,true,37,36,73,130,125,255,13,9,22,3,2:51
491563,2017-07-23,2017,ANA,BOS,3,2,3-2,ANA,9,true,31,33,64,106,96,202,7,7,14,0,2:13
491572,2017-07-23,2017,SFN,SDN,2,5,5-2,SDN,9,false,36,40,76,150,120,270,9,14,23,1,2:48
491576,2017-07-23,2017,ARI,WAS,2,6,6-2,WAS,9,false,40,39,79,158,181,339,13,12,25,3,3:39
491573,2017-07-23,2017,CHN,SLN,5,3,5-3,CHN,9,true,31,36,67,152,128,280,7,11,18,0,2:50
491570,2017-07-23,2017,NYN,OAK,2,3,3-2,OAK,9,false,36,33,69,129,141,270,8,11,19,0,2:41 (1:01 delay)
491568,2017-07-23,2017,PHI,MIL,6,3,6-3,PHI,9,true,36,34,70,138,144,282,14,8,22,2,3:07
491562,2017-07-23,2017,LAN,ATL,5,4,5-4,LAN,10,false,41,38,79,126,157,283,15,9,24,2,3:05
491569,2017-07-23,2017,SEA,NYA,4,6,6-4,NYA,9,false,34,43,77,156,135,291,8,18,26,2,3:13
491575,2017-07-23,2017,CLE,TOR,8,1,8-1,CLE,9,true,41,33,74,132,162,294,16,8,24,1,2:53
491566,2017-07-23,2017,BAL,HOU,9,7,9-7,BAL,9,true,40,42,82,149,150,299,20,15,35,4,3:24
491571,2017-07-23,2017,COL,PIT,13,3,13-3,COL,9,true,42,42,84,170,139,309,19,15,34,2,3:19
491574,2017-07-23,2017,TBA,TEX,5,6,6-5,TEX,9,false,41,41,82,185,170,355,14,14,28,3,3:54
491565,2017-07-23,2017,MIN,DET,6,9,9-6,DET,9,false,40,47,87,192,185,377,14,21,35,7,4:19
491567,2017-07-23,2017,CIN,MIA,6,3,6-3,CIN,9,true,36,35,71,149,143,292,14,8,22,1,2:58
491564,2017-07-23,2017,KCA,CHA,5,4,5-4,KCA,9,false,34,36,70,118,156,274,12,11,23,4,3:07
490803,2017-07-24,2017,CLE,CIN,6,2,6-2,CLE,9,true,35,32,67,115,137,252,13,7,20,1,2:26
490803,2017-07-24,2017,CLE,CIN,6,2,6-2,CLE,9,true,35,32,67,115,137,252,13,7,20,1,2:26
491584,2017-07-24,2017,TEX,MIA,0,4,4-0,MIA,9,false,35,37,72,123,136,259,10,12,22,0,2:34
491586,2017-07-24,2017,SDN,NYN,3,5,5-3,NYN,9,false,36,40,76,138,121,259,10,17,27,0,2:35
491587,2017-07-24,2017,TOR,OAK,4,2,4-2,TOR,9,true,37,30,67,131,140,271,14,5,19,1,2:37
491582,2017-07-24,2017,PHI,HOU,4,13,13-4,HOU,9,false,40,50,90,195,150,345,14,25,39,2,3:27 (1:52 delay)
491583,2017-07-24,2017,DET,KCA,3,5,5-3,KCA,12,false,48,45,93,178,185,363,12,10,22,2,3:57
491579,2017-07-24,2017,SEA,BOS,4,0,4-0,SEA,9,true,33,31,64,133,128,261,9,4,13,1,2:40
491585,2017-07-24,2017,LAN,MIN,6,4,6-4,LAN,9,true,33,40,73,147,114,261,11,15,26,1,2:57
491578,2017-07-24,2017,TBA,BAL,0,5,5-0,BAL,9,false,35,37,72,145,149,294,11,10,21,1,3:04
491577,2017-07-24,2017,ARI,ATL,10,2,10-2,ARI,9,true,45,31,76,120,174,294,21,5,26,1,3:00
491580,2017-07-24,2017,CHN,CHA,1,3,3-1,CHA,9,false,40,38,78,160,141,301,15,11,26,3,3:17
491588,2017-07-24,2017,SFN,PIT,3,10,10-3,PIT,9,false,40,44,84,170,187,357,15,17,32,1,3:27
491581,2017-07-24,2017,SLN,COL,8,2,8-2,SLN,9,true,39,35,74,132,152,284,18,8,26,2,2:50
491590,2017-07-25,2017,TBA,BAL,5,4,5-4,TBA,9,true,33,40,73,133,130,263,11,14,25,2,2:50
491599,2017-07-25,2017,WAS,MIL,0,8,8-0,MIL,9,false,35,46,81,179,126,305,8,17,25,1,3:05
491598,2017-07-25,2017,TEX,MIA,10,4,10-4,TEX,9,true,42,38,80,143,139,282,21,12,33,1,2:54
491597,2017-07-25,2017,CLE,ANA,11,7,11-7,CLE,11,false,49,48,97,177,195,372,24,18,42,4,4:14
491602,2017-07-25,2017,TOR,OAK,4,1,4-1,TOR,9,true,35,33,68,120,152,272,11,8,19,1,2:55
491593,2017-07-25,2017,NYA,CIN,4,2,4-2,NYA,9,true,33,32,65,128,132,260,11,6,17,2,2:38
491596,2017-07-25,2017,DET,KCA,1,3,3-1,KCA,9,false,36,34,70,122,139,261,11,8,19,1,2:49
491594,2017-07-25,2017,SLN,COL,3,2,3-2,SLN,9,false,36,34,70,145,142,287,12,10,22,2,3:11
491600,2017-07-25,2017,LAN,MIN,6,2,6-2,LAN,9,true,35,36,71,139,138,277,13,8,21,1,3:35
491595,2017-07-25,2017,PHI,HOU,0,5,5-0,HOU,9,false,36,35,71,128,138,266,7,9,16,1,2:44
491592,2017-07-25,2017,CHN,CHA,7,2,7-2,CHN,9,true,44,39,83,152,191,343,21,14,35,2,3:38
491589,2017-07-25,2017,ARI,ATL,3,8,8-3,ATL,9,false,41,41,82,161,167,328,14,15,29,2,3:10
491601,2017-07-25,2017,SDN,NYN,5,6,6-5,NYN,9,false,37,37,74,162,140,302,10,11,21,2,3:05
491603,2017-07-25,2017,SFN,PIT,11,3,11-3,SFN,9,true,43,41,84,149,169,318,19,15,34,1,3:10
491591,2017-07-25,2017,SEA,BOS,6,5,6-5,SEA,13,false,55,54,109,220,253,473,18,15,33,3,4:59
491608,2017-07-26,2017,NYA,CIN,9,5,9-5,NYA,9,true,40,36,76,144,134,278,15,7,22,3,2:52
491606,2017-07-26,2017,SEA,BOS,0,4,4-0,BOS,9,false,35,37,72,146,153,299,8,11,19,3,2:53
491618,2017-07-26,2017,SFN,PIT,2,1,2-1,SFN,9,true,35,33,68,131,127,258,13,8,21,0,2:38
491605,2017-07-26,2017,TBA,BAL,5,1,5-1,TBA,9,true,33,32,65,127,137,264,11,7,18,0,2:46
491617,2017-07-26,2017,TOR,OAK,3,2,3-2,TOR,9,false,31,35,66,159,126,285,9,8,17,3,2:51
491615,2017-07-26,2017,LAN,MIN,6,5,6-5,LAN,9,false,39,36,75,135,156,291,13,8,21,4,3:28
491616,2017-07-26,2017,SDN,NYN,6,3,6-3,SDN,9,true,35,36,71,143,138,281,12,9,21,2,2:47
491610,2017-07-26,2017,PHI,HOU,9,0,9-0,PHI,9,true,43,36,79,146,167,313,19,10,29,0,3:25
491612,2017-07-26,2017,CLE,ANA,10,4,10-4,CLE,9,true,41,39,80,148,160,308,21,14,35,4,3:31
491614,2017-07-26,2017,WAS,MIL,8,5,8-5,WAS,9,true,36,38,74,142,132,274,13,11,24,3,2:58
491607,2017-07-26,2017,CHA,CHN,3,8,8-3,CHN,9,false,33,46,79,221,144,365,7,19,26,4,3:53
491611,2017-07-26,2017,DET,KCA,2,16,16-2,KCA,9,false,34,55,89,199,138,337,10,29,39,4,3:37
491604,2017-07-26,2017,ARI,ATL,10,3,10-3,ARI,9,true,45,42,87,145,187,332,21,16,37,1,3:17
491613,2017-07-26,2017,TEX,MIA,10,22,22-10,MIA,9,false,47,54,101,190,202,392,20,28,48,5,4:02
491609,2017-07-26,2017,SLN,COL,10,5,10-5,SLN,9,true,46,36,82,122,185,307,24,11,35,0,3:23
491619,2017-07-27,2017,SLN,ARI,0,4,4-0,ARI,9,false,33,35,68,146,139,285,7,10,17,0,2:47 (1:02 delay)
491620,2017-07-27,2017,CHA,CHN,3,6,6-3,CHN,9,false,33,37,70,129,120,249,6,12,18,2,2:37
491624,2017-07-27,2017,SDN,NYN,7,5,7-5,SDN,9,true,35,38,73,136,131,267,14,12,26,2,3:04
491622,2017-07-27,2017,CLE,ANA,2,1,2-1,CLE,9,true,33,33,66,127,123,250,11,8,19,1,2:44
491626,2017-07-27,2017,NYA,TBA,6,5,6-5,NYA,11,false,46,45,91,183,171,354,17,12,29,3,3:56
491621,2017-07-27,2017,MIA,CIN,4,1,4-1,MIA,9,true,39,40,79,145,161,306,17,14,31,2,3:18
491625,2017-07-27,2017,TOR,OAK,8,4,8-4,TOR,10,false,42,45,87,173,169,342,14,17,31,2,3:28
491623,2017-07-27,2017,WAS,MIL,15,2,15-2,WAS,9,true,48,33,81,149,184,333,24,7,31,1,3:14
491641,2017-07-28,2017,NYA,TBA,6,1,6-1,NYA,9,true,32,29,61,115,115,230,10,2,12,0,2:23
491640,2017-07-28,2017,LAN,SFN,6,4,6-4,LAN,9,true,34,34,68,122,129,251,11,8,19,2,2:39
491627,2017-07-28,2017,SLN,ARI,1,0,1-0,SLN,9,true,33,34,67,149,126,275,10,8,18,4,3:10
491636,2017-07-28,2017,TOR,ANA,2,7,7-2,ANA,9,false,34,42,76,149,120,269,7,15,22,3,2:47
491631,2017-07-28,2017,MIA,CIN,7,4,7-4,MIA,9,true,43,36,79,134,154,288,18,11,29,2,2:54
491639,2017-07-28,2017,SDN,PIT,3,2,3-2,SDN,9,true,35,32,67,126,140,266,14,6,20,1,2:44
491630,2017-07-28,2017,MIL,CHN,2,1,2-1,MIL,9,true,32,33,65,121,128,249,8,8,16,1,2:34
491634,2017-07-28,2017,DET,HOU,5,6,6-5,HOU,9,false,40,36,76,113,165,278,14,9,23,2,2:54
491628,2017-07-28,2017,PHI,ATL,10,3,10-3,PHI,9,true,39,40,79,141,139,280,16,15,31,2,3:01
491637,2017-07-28,2017,OAK,MIN,3,6,6-3,MIN,9,false,37,43,80,178,142,320,12,18,30,2,3:19
491638,2017-07-28,2017,SEA,NYN,5,7,7-5,NYN,9,false,40,38,78,149,180,329,14,11,25,4,3:21
491629,2017-07-28,2017,TEX,BAL,8,2,8-2,TEX,9,true,36,35,71,145,147,292,12,9,21,2,3:02
491632,2017-07-28,2017,CHA,CLE,3,9,9-3,CLE,9,false,39,46,85,171,161,332,12,23,35,2,3:21
491635,2017-07-28,2017,BOS,KCA,2,4,4-2,KCA,9,false,35,33,68,134,140,274,9,9,18,2,2:44
491649,2017-07-29,2017,DET,HOU,5,3,5-3,DET,9,true,34,33,67,92,133,225,11,9,20,2,2:41
491648,2017-07-29,2017,WAS,COL,2,4,4-2,COL,9,false,30,36,66,160,118,278,3,11,14,0,2:49
491646,2017-07-29,2017,MIA,CIN,7,3,7-3,MIA,9,true,37,36,73,125,145,270,14,10,24,3,2:32
491651,2017-07-29,2017,TOR,ANA,5,6,6-5,ANA,9,false,37,38,75,142,142,284,11,11,22,0,2:52
491655,2017-07-29,2017,LAN,SFN,2,1,2-1,LAN,9,true,32,33,65,130,115,245,11,9,20,2,2:43
491652,2017-07-29,2017,OAK,MIN,5,4,5-4,OAK,9,false,37,41,78,174,148,322,15,15,30,1,3:22
491656,2017-07-29,2017,NYA,TBA,5,4,5-4,NYA,9,false,37,39,76,157,147,304,13,12,25,3,3:22
491653,2017-07-29,2017,SEA,NYN,3,2,3-2,SEA,9,true,33,38,71,150,154,304,11,13,24,4,3:12
491654,2017-07-29,2017,SDN,PIT,4,2,4-2,SDN,9,true,31,34,65,154,105,259,9,9,18,2,2:50
491642,2017-07-29,2017,SLN,ARI,1,7,7-1,ARI,9,false,33,44,77,181,118,299,6,18,24,2,3:12
491644,2017-07-29,2017,TEX,BAL,0,4,4-0,BAL,9,false,34,41,75,161,121,282,10,14,24,1,3:08
491643,2017-07-29,2017,PHI,ATL,4,3,4-3,PHI,11,false,45,46,91,171,192,363,14,16,30,1,3:50
491647,2017-07-29,2017,CHA,CLE,4,5,5-4,CLE,9,false,41,46,87,181,144,325,15,17,32,3,3:46
491645,2017-07-29,2017,MIL,CHN,1,2,2-1,CHN,11,false,45,46,91,180,190,370,13,15,28,3,4:05
491650,2017-07-29,2017,BOS,KCA,9,8,9-8,BOS,10,false,47,47,94,222,211,433,20,19,39,5,4:45
491633,2017-07-30,2017,WAS,COL,3,1,3-1,WAS,9,true,29,32,61,139,109,248,5,6,11,0,2:31
491633,2017-07-30,2017,WAS,COL,3,1,3-1,WAS,9,true,29,32,61,139,109,248,5,6,11,0,2:31
491669,2017-07-30,2017,SDN,PIT,1,7,7-1,PIT,9,false,35,40,75,166,124,290,9,14,23,0,2:49
491668,2017-07-30,2017,SEA,NYN,9,1,9-1,SEA,9,true,40,37,77,151,159,310,15,11,26,0,2:55
491665,2017-07-30,2017,BOS,KCA,3,5,5-3,KCA,9,false,37,40,77,160,138,298,12,14,26,3,3:13
491661,2017-07-30,2017,MIA,CIN,4,6,6-4,CIN,9,false,33,45,78,173,132,305,7,18,25,1,3:04
491670,2017-07-30,2017,LAN,SFN,3,2,3-2,LAN,11,false,49,40,89,141,172,313,21,14,35,4,3:54
491664,2017-07-30,2017,DET,HOU,13,1,13-1,DET,9,true,46,37,83,150,168,318,23,11,34,2,3:26
491660,2017-07-30,2017,MIL,CHN,2,4,4-2,CHN,9,false,35,37,72,129,120,249,10,11,21,2,2:49
491657,2017-07-30,2017,SLN,ARI,3,2,3-2,SLN,9,true,34,37,71,158,146,304,10,10,20,3,3:06
491662,2017-07-30,2017,CHA,CLE,3,1,3-1,CHA,9,false,31,36,67,153,124,277,6,10,16,2,2:56
491658,2017-07-30,2017,PHI,ATL,2,1,2-1,PHI,9,false,38,37,75,139,152,291,14,13,27,2,3:20
491671,2017-07-30,2017,NYA,TBA,3,5,5-3,TBA,9,false,40,43,83,182,167,349,12,18,30,6,3:51
491666,2017-07-30,2017,TOR,ANA,11,10,11-10,TOR,9,false,41,43,84,167,173,340,18,19,37,3,3:38
491659,2017-07-30,2017,TEX,BAL,6,10,10-6,BAL,9,false,40,40,80,162,186,348,12,16,28,4,3:47
491663,2017-07-30,2017,WAS,COL,6,10,10-6,COL,9,false,42,45,87,176,163,339,15,20,35,2,3:48
491667,2017-07-30,2017,OAK,MIN,6,5,6-5,OAK,12,false,50,51,101,204,183,387,16,16,32,3,4:06
491680,2017-07-31,2017,MIA,WAS,0,1,1-0,WAS,9,false,31,31,62,115,115,230,6,4,10,1,2:12
491673,2017-07-31,2017,BOS,CLE,6,2,6-2,BOS,9,true,40,34,74,125,138,263,18,9,27,3,2:47
491675,2017-07-31,2017,BAL,KCA,2,1,2-1,BAL,9,false,36,32,68,119,136,255,11,7,18,0,2:33
491679,2017-07-31,2017,CHA,TOR,7,6,7-6,CHA,9,false,40,37,77,141,148,289,13,12,25,1,3:01
491676,2017-07-31,2017,OAK,SFN,8,5,8-5,OAK,9,true,43,38,81,139,176,315,21,12,33,5,3:26
491674,2017-07-31,2017,NYA,DET,7,3,7-3,NYA,9,true,36,44,80,197,121,318,11,16,27,2,3:23
491678,2017-07-31,2017,HOU,TBA,14,7,14-7,HOU,9,true,47,41,88,164,154,318,22,14,36,2,3:24
491672,2017-07-31,2017,PHI,ATL,7,6,7-6,PHI,9,true,38,42,80,164,155,319,14,15,29,2,3:13
491677,2017-07-31,2017,TEX,SEA,4,6,6-4,SEA,9,false,39,41,80,145,151,296,12,17,29,3,3:16
491685,2017-08-01,2017,BAL,KCA,7,2,7-2,BAL,9,true,40,33,73,116,168,284,18,6,24,1,2:54
491695,2017-08-01,2017,MIA,WAS,7,6,7-6,MIA,9,true,36,40,76,163,131,294,13,14,27,2,3:05
491689,2017-08-01,2017,ANA,PHI,7,1,7-1,ANA,9,true,38,37,75,141,160,301,15,11,26,0,3:20
491687,2017-08-01,2017,SDN,MIN,3,0,3-0,SDN,9,true,28,32,60,139,95,234,6,5,11,0,2:23
491693,2017-08-01,2017,HOU,TBA,4,6,6-4,TBA,9,false,35,40,75,149,147,296,8,16,24,4,3:27
491691,2017-08-01,2017,TEX,SEA,7,8,8-7,SEA,9,false,42,43,85,137,154,291,15,16,31,6,3:30
491688,2017-08-01,2017,COL,NYN,5,4,5-4,COL,9,false,39,38,77,154,152,306,17,11,28,5,3:24
491684,2017-08-01,2017,NYA,DET,3,4,4-3,DET,9,false,38,36,74,139,139,278,13,11,24,3,2:59
491694,2017-08-01,2017,CHA,TOR,4,8,8-4,TOR,9,false,38,47,85,185,131,316,13,22,35,3,3:22
491690,2017-08-01,2017,OAK,SFN,4,10,10-4,SFN,9,false,36,45,81,142,136,278,10,19,29,0,2:41
491682,2017-08-01,2017,PIT,CIN,1,9,9-1,CIN,9,false,35,46,81,166,134,300,10,18,28,1,3:00
491686,2017-08-01,2017,ATL,LAN,2,3,3-2,LAN,9,false,33,35,68,136,125,261,6,10,16,2,2:54
491692,2017-08-01,2017,MIL,SLN,3,2,3-2,MIL,9,true,35,35,70,148,154,302,12,9,21,2,3:01
491683,2017-08-01,2017,BOS,CLE,12,10,12-10,BOS,9,false,45,43,88,162,167,329,21,16,37,3,3:36
491681,2017-08-01,2017,CHN,ARI,16,4,16-4,CHN,9,true,45,41,86,183,165,348,21,13,34,3,3:27
491699,2017-08-02,2017,NYA,DET,0,2,2-0,DET,9,false,35,35,70,132,122,254,8,8,16,0,2:52 (4:37 delay)
491705,2017-08-02,2017,ANA,PHI,7,0,7-0,ANA,9,true,35,33,68,108,132,240,12,8,20,0,2:33
491702,2017-08-02,2017,SDN,MIN,2,5,5-2,MIN,9,false,32,34,66,123,110,233,5,10,15,0,2:24
491696,2017-08-02,2017,CHN,ARI,0,3,3-0,ARI,9,false,31,36,67,128,139,267,5,10,15,0,2:44
491701,2017-08-02,2017,ATL,LAN,5,3,5-3,ATL,9,true,38,34,72,120,135,255,15,8,23,1,2:55
491700,2017-08-02,2017,BAL,KCA,6,0,6-0,BAL,9,true,35,34,69,133,155,288,12,8,20,0,2:47 (:35 delay)
491706,2017-08-02,2017,TEX,SEA,5,1,5-1,TEX,9,true,32,37,69,155,123,278,9,11,20,1,2:53 (:40 delay)
491704,2017-08-02,2017,SFN,OAK,1,6,6-1,OAK,9,false,33,42,75,159,122,281,8,16,24,1,2:48
491708,2017-08-02,2017,HOU,TBA,0,3,3-0,TBA,9,false,34,40,74,142,128,270,8,13,21,2,3:06
491703,2017-08-02,2017,COL,NYN,5,10,10-5,NYN,9,false,38,40,78,136,140,276,12,14,26,1,3:15
491710,2017-08-02,2017,MIA,WAS,7,0,7-0,MIA,9,true,39,28,67,115,167,282,15,4,19,2,2:54
491697,2017-08-02,2017,PIT,CIN,2,5,5-2,CIN,9,false,36,41,77,179,148,327,9,14,23,2,3:25
491709,2017-08-02,2017,CHA,TOR,1,5,5-1,TOR,9,false,38,41,79,159,151,310,11,14,25,4,3:15
491707,2017-08-02,2017,MIL,SLN,4,5,5-4,SLN,9,false,38,40,78,157,144,301,10,15,25,3,2:58
491717,2017-08-03,2017,CLE,NYA,5,1,5-1,CLE,9,true,34,30,64,106,121,227,8,4,12,0,2:28
491713,2017-08-03,2017,PIT,CIN,6,0,6-0,PIT,9,true,37,34,71,117,132,249,13,7,20,1,2:29
491718,2017-08-03,2017,SFN,OAK,11,2,11-2,SFN,9,true,40,34,74,121,138,259,18,8,26,0,2:28
491720,2017-08-03,2017,KCA,SEA,6,4,6-4,KCA,9,true,35,40,75,145,126,271,13,13,26,4,3:01
491722,2017-08-03,2017,HOU,TBA,3,5,5-3,TBA,9,false,36,42,78,161,149,310,10,13,23,2,3:23
491723,2017-08-03,2017,MIN,TEX,1,4,4-1,TEX,9,false,31,40,71,171,127,298,5,14,19,2,3:04
491721,2017-08-03,2017,MIL,SLN,2,1,2-1,MIL,9,true,35,35,70,150,144,294,12,10,22,1,3:21
491716,2017-08-03,2017,COL,NYN,5,4,5-4,COL,9,false,39,40,79,138,137,275,18,14,32,4,3:03
491715,2017-08-03,2017,ATL,LAN,4,7,7-4,LAN,9,false,38,45,83,183,144,327,13,20,33,1,3:29
491719,2017-08-03,2017,ANA,PHI,5,4,5-4,ANA,9,true,36,40,76,155,137,292,13,15,28,0,3:07
491712,2017-08-03,2017,BOS,CHA,9,5,9-5,BOS,9,true,43,36,79,151,156,307,21,9,30,5,3:26
491714,2017-08-03,2017,BAL,DET,5,7,7-5,DET,9,false,39,36,75,152,147,299,14,11,25,3,3:18 (1:42 delay)
491711,2017-08-03,2017,CHN,ARI,8,10,10-8,ARI,9,false,43,45,88,203,165,368,17,17,34,6,3:59 (2:35 delay)
491724,2017-08-04,2017,SFN,ARI,1,2,2-1,ARI,9,false,33,34,67,128,127,255,8,9,17,0,2:39
491738,2017-08-04,2017,CHN,WAS,2,4,4-2,WAS,9,false,36,36,72,132,140,272,11,10,21,1,2:43
491728,2017-08-04,2017,ATL,MIA,5,3,5-3,ATL,9,true,33,35,68,132,123,255,10,8,18,2,2:40
491726,2017-08-04,2017,BAL,DET,2,5,5-2,DET,9,false,33,35,68,150,130,280,7,8,15,0,2:52
491735,2017-08-04,2017,CIN,SLN,3,2,3-2,CIN,9,true,31,39,70,157,95,252,9,14,23,3,2:48
491736,2017-08-04,2017,MIN,TEX,8,4,8-4,MIN,9,true,39,36,75,106,162,268,17,10,27,1,3:03
491730,2017-08-04,2017,CLE,NYA,7,2,7-2,CLE,9,true,35,38,73,152,139,291,12,13,25,2,2:58
491729,2017-08-04,2017,TBA,MIL,0,2,2-0,MIL,9,false,38,33,71,131,143,274,13,7,20,2,3:04
491727,2017-08-04,2017,NYN,LAN,0,6,6-0,LAN,9,false,33,38,71,154,127,281,6,12,18,1,3:07
491734,2017-08-04,2017,KCA,SEA,2,5,5-2,SEA,9,false,32,35,67,132,129,261,5,11,16,1,2:47
491732,2017-08-04,2017,COL,PHI,4,3,4-3,COL,9,true,39,38,77,146,144,290,17,11,28,5,3:41
491733,2017-08-04,2017,PIT,SDN,10,6,10-6,PIT,9,true,43,42,85,136,173,309,19,15,34,5,3:35 (2:05 delay)
491737,2017-08-04,2017,HOU,TOR,16,7,16-7,HOU,9,true,47,37,84,133,175,308,25,12,37,2,3:05
491731,2017-08-04,2017,ANA,OAK,8,6,8-6,ANA,9,true,43,40,83,157,153,310,19,13,32,4,3:31
491725,2017-08-04,2017,BOS,CHA,3,2,3-2,BOS,11,false,40,45,85,197,162,359,8,13,21,1,3:43
491740,2017-08-05,2017,BOS,CHA,4,1,4-1,BOS,9,true,32,34,66,123,121,244,8,10,18,2,2:41
491751,2017-08-05,2017,MIN,TEX,1,4,4-1,TEX,9,false,30,37,67,152,96,248,5,11,16,1,2:41 (:45 delay)
491747,2017-08-05,2017,COL,PHI,8,5,8-5,COL,9,true,38,39,77,127,142,269,15,13,28,2,2:53
491745,2017-08-05,2017,CLE,NYA,1,2,2-1,NYA,9,false,33,35,68,144,128,272,6,9,15,1,2:58
491743,2017-08-05,2017,ATL,MIA,7,2,7-2,ATL,9,true,37,36,73,144,155,299,13,9,22,4,2:58
491752,2017-08-05,2017,HOU,TOR,3,4,4-3,TOR,10,false,37,44,81,161,138,299,8,14,22,2,3:16
491750,2017-08-05,2017,CIN,SLN,1,4,4-1,SLN,9,false,35,38,73,145,147,292,10,14,24,1,3:01
491744,2017-08-05,2017,TBA,MIL,0,3,3-0,MIL,9,false,34,37,71,172,141,313,7,11,18,1,3:20
491746,2017-08-05,2017,ANA,OAK,0,5,5-0,OAK,9,false,32,41,73,175,140,315,6,14,20,2,3:24
491748,2017-08-05,2017,PIT,SDN,2,5,5-2,SDN,9,false,37,41,78,150,157,307,12,15,27,3,3:13 (:26 delay)
491741,2017-08-05,2017,BAL,DET,5,2,5-2,BAL,9,true,37,35,72,191,131,322,14,9,23,2,3:14
491753,2017-08-05,2017,CHN,WAS,7,4,7-4,CHN,9,true,34,39,73,180,162,342,11,12,23,1,3:31
491742,2017-08-05,2017,NYN,LAN,4,7,7-4,LAN,9,false,37,40,77,158,157,315,10,13,23,4,3:18
491739,2017-08-05,2017,SFN,ARI,5,4,5-4,SFN,10,false,41,47,88,183,164,347,16,17,33,3,3:38 (:08 delay)
491759,2017-08-06,2017,TBA,MIL,2,1,2-1,TBA,9,false,32,35,67,134,109,243,10,10,20,1,2:46
491754,2017-08-06,2017,SFN,ARI,6,3,6-3,SFN,9,true,36,36,72,160,137,297,13,10,23,3,3:03
491765,2017-08-06,2017,CIN,SLN,4,13,13-4,SLN,9,false,38,47,85,164,161,325,14,22,36,1,3:10
491749,2017-08-06,2017,KCA,SEA,9,1,9-1,KCA,9,true,39,32,71,118,138,256,15,5,20,1,2:39
491758,2017-08-06,2017,ATL,MIA,1,4,4-1,MIA,9,false,31,36,67,131,108,239,5,9,14,0,2:29
491755,2017-08-06,2017,BOS,CHA,6,3,6-3,BOS,9,true,36,36,72,114,128,242,16,9,25,3,2:36
491749,2017-08-06,2017,KCA,SEA,9,1,9-1,KCA,9,true,39,32,71,118,138,256,15,5,20,1,2:39
491762,2017-08-06,2017,COL,PHI,2,3,3-2,PHI,9,false,37,37,74,135,131,266,10,12,22,1,3:14
491766,2017-08-06,2017,MIN,TEX,6,5,6-5,MIN,9,true,33,37,70,141,130,271,10,10,20,0,2:53 (:32 delay)
491768,2017-08-06,2017,CHN,WAS,4,9,9-4,WAS,9,false,38,40,78,151,144,295,16,14,30,3,3:06
491760,2017-08-06,2017,CLE,NYA,1,8,8-1,NYA,9,false,30,42,72,157,140,297,3,16,19,2,2:56
491764,2017-08-06,2017,KCA,SEA,7,8,8-7,SEA,9,false,40,42,82,146,146,292,13,15,28,5,3:03
491757,2017-08-06,2017,NYN,LAN,0,8,8-0,LAN,9,false,29,39,68,176,136,312,2,14,16,1,2:59
491767,2017-08-06,2017,HOU,TOR,7,6,7-6,HOU,9,false,44,42,86,156,160,316,18,16,34,3,3:16
491756,2017-08-06,2017,BAL,DET,12,3,12-3,BAL,9,true,43,42,85,157,180,337,21,17,38,4,3:10
491763,2017-08-06,2017,PIT,SDN,5,4,5-4,PIT,12,false,45,50,95,210,151,361,14,14,28,4,4:03
491761,2017-08-06,2017,ANA,OAK,10,11,11-10,OAK,9,false,47,48,95,192,194,386,19,22,41,4,4:12
491771,2017-08-07,2017,PIT,DET,3,0,3-0,PIT,9,true,31,29,60,129,120,249,9,3,12,0,2:37
491769,2017-08-07,2017,ANA,BAL,2,6,6-2,BAL,9,false,33,37,70,116,141,257,7,12,19,0,2:42
491773,2017-08-07,2017,MIN,MIL,5,4,5-4,MIN,9,true,40,37,77,130,163,293,16,11,27,4,3:13
491775,2017-08-07,2017,KCA,SLN,3,11,11-3,SLN,9,false,35,41,76,141,118,259,8,15,23,1,2:32
491774,2017-08-07,2017,CIN,SDN,11,3,11-3,CIN,9,true,37,36,73,144,161,305,14,9,23,3,3:06
491770,2017-08-07,2017,SFN,CHN,3,5,5-3,CHN,9,false,37,41,78,153,118,271,11,15,26,1,2:55
491772,2017-08-07,2017,WAS,MIA,3,2,3-2,WAS,9,true,31,36,67,144,128,272,9,9,18,1,2:58
491776,2017-08-08,2017,ANA,BAL,3,2,3-2,ANA,9,true,31,36,67,119,121,240,8,8,16,2,2:46
491779,2017-08-08,2017,CLE,COL,4,1,4-1,CLE,9,false,36,29,65,116,155,271,11,3,14,2,2:49
491778,2017-08-08,2017,SFN,CHN,6,3,6-3,SFN,9,true,35,37,72,130,138,268,11,10,21,1,2:44
491790,2017-08-08,2017,NYN,TEX,5,4,5-4,NYN,9,true,33,36,69,149,123,272,10,10,20,2,2:51
491786,2017-08-08,2017,ATL,PHI,2,5,5-2,PHI,9,false,34,43,77,167,124,291,9,19,28,0,2:58
491784,2017-08-08,2017,MIN,MIL,11,4,11-4,MIN,9,true,40,40,80,149,161,310,19,15,34,3,3:30
491788,2017-08-08,2017,OAK,SEA,6,7,7-6,SEA,10,false,42,46,88,152,158,310,12,16,28,3,3:20
491789,2017-08-08,2017,KCA,SLN,3,10,10-3,SLN,9,false,35,47,82,185,144,329,9,23,32,1,3:02
491783,2017-08-08,2017,WAS,MIA,3,7,7-3,MIA,9,false,39,40,79,159,124,283,14,14,28,2,3:07
491781,2017-08-08,2017,CHA,HOU,8,5,8-5,CHA,9,true,41,42,83,176,159,335,18,18,36,4,3:37
491782,2017-08-08,2017,ARI,LAN,6,3,6-3,ARI,9,true,36,35,71,128,152,280,14,11,25,2,2:59
491777,2017-08-08,2017,TBA,BOS,0,2,2-0,BOS,9,false,31,38,69,146,127,273,3,13,16,1,2:52
491787,2017-08-08,2017,CIN,SDN,3,7,7-3,SDN,9,false,38,41,79,134,144,278,15,15,30,1,2:56
491780,2017-08-08,2017,PIT,DET,6,3,6-3,PIT,9,true,36,32,68,115,135,250,11,6,17,1,2:36
491785,2017-08-08,2017,TOR,NYA,4,2,4-2,TOR,9,true,36,39,75,151,134,285,13,14,27,3,2:50
491791,2017-08-09,2017,ANA,BAL,5,1,5-1,ANA,9,true,36,31,67,128,158,286,14,5,19,3,3:06
491795,2017-08-09,2017,CHA,HOU,7,1,7-1,CHA,9,true,36,35,71,119,137,256,15,7,22,1,2:54
491797,2017-08-09,2017,ARI,LAN,2,3,3-2,LAN,9,false,35,36,71,133,118,251,9,11,20,1,2:48
491799,2017-08-09,2017,MIL,MIN,0,4,4-0,MIN,9,false,33,40,73,165,133,298,6,14,20,2,3:13
491804,2017-08-09,2017,OAK,SEA,3,6,6-3,SEA,9,false,37,37,74,133,149,282,10,10,20,1,2:58
491803,2017-08-09,2017,CIN,SDN,8,3,8-3,CIN,9,true,40,34,74,142,160,302,15,7,22,1,2:59
491793,2017-08-09,2017,SFN,CHN,3,1,3-1,SFN,9,true,35,34,69,123,135,258,13,7,20,2,2:50
491802,2017-08-09,2017,DET,PIT,10,0,10-0,DET,9,true,43,33,76,123,158,281,19,7,26,2,3:03
491796,2017-08-09,2017,SLN,KCA,8,5,8-5,SLN,9,true,40,40,80,143,167,310,19,16,35,3,3:15
491805,2017-08-09,2017,NYN,TEX,1,5,5-1,TEX,9,false,30,47,77,210,102,312,4,20,24,1,3:07
491798,2017-08-09,2017,WAS,MIA,10,1,10-1,WAS,9,true,44,36,80,134,171,305,25,10,35,1,3:02
491800,2017-08-09,2017,TOR,NYA,5,11,11-5,NYA,9,false,41,46,87,176,178,354,14,20,34,6,3:44
491801,2017-08-09,2017,ATL,PHI,2,3,3-2,PHI,9,false,35,35,70,132,137,269,10,7,17,2,2:55
491792,2017-08-09,2017,TBA,BOS,2,8,8-2,BOS,9,false,32,41,73,165,116,281,6,16,22,2,2:59
491794,2017-08-09,2017,CLE,COL,2,3,3-2,COL,12,false,48,48,96,196,169,365,13,14,27,3,3:59
491815,2017-08-10,2017,TOR,NYA,4,0,4-0,TOR,9,true,32,38,70,151,130,281,9,11,20,0,2:55
491807,2017-08-10,2017,TBA,CLE,4,1,4-1,TBA,9,true,38,32,70,131,144,275,15,6,21,2,2:52
491812,2017-08-10,2017,WAS,MIA,3,2,3-2,WAS,9,true,31,37,68,150,117,267,8,13,21,2,2:51
491806,2017-08-10,2017,OAK,BAL,2,7,7-2,BAL,9,false,39,39,78,150,164,314,12,11,23,2,3:09
491809,2017-08-10,2017,SLN,KCA,8,6,8-6,SLN,9,true,41,42,83,140,166,306,16,19,35,7,3:37
491816,2017-08-10,2017,DET,PIT,5,7,7-5,PIT,9,false,35,41,76,159,129,288,10,15,25,2,3:06
491817,2017-08-10,2017,CIN,SDN,10,3,10-3,CIN,9,true,40,38,78,137,153,290,18,12,30,4,2:57
491813,2017-08-10,2017,MIL,MIN,2,7,7-2,MIN,9,false,35,41,76,149,144,293,9,15,24,2,3:09
491811,2017-08-10,2017,ARI,LAN,6,8,8-6,LAN,9,false,40,41,81,153,178,331,13,13,26,3,3:37
491808,2017-08-10,2017,CHA,HOU,3,2,3-2,CHA,11,false,47,44,91,156,167,323,17,14,31,2,3:41
491814,2017-08-10,2017,PHI,NYN,0,10,10-0,NYN,9,false,30,43,73,161,141,302,5,17,22,1,3:03
491810,2017-08-10,2017,SEA,ANA,3,6,6-3,ANA,9,false,35,39,74,175,129,304,11,13,24,3,3:14
491830,2017-08-11,2017,TOR,PIT,2,4,4-2,PIT,9,false,36,33,69,120,129,249,9,6,15,1,2:41
491823,2017-08-11,2017,TBA,CLE,0,5,5-0,CLE,9,false,32,39,71,145,121,266,5,12,17,0,2:44
491819,2017-08-11,2017,OAK,BAL,5,4,5-4,OAK,9,true,33,36,69,139,139,278,11,12,23,3,2:48
491831,2017-08-11,2017,LAN,SDN,3,4,4-3,SDN,9,false,40,36,76,149,136,285,16,10,26,1,2:59
491827,2017-08-11,2017,SEA,ANA,5,6,6-5,ANA,9,false,36,42,78,153,132,285,11,15,26,4,3:04
491828,2017-08-11,2017,DET,MIN,4,9,9-4,MIN,9,false,38,41,79,151,159,310,12,17,29,4,3:21
491825,2017-08-11,2017,TEX,HOU,6,4,6-4,TEX,9,true,37,39,76,157,136,293,12,13,25,3,3:22
491818,2017-08-11,2017,SLN,ATL,8,5,8-5,SLN,9,true,41,36,77,145,168,313,17,12,29,3,3:08
491824,2017-08-11,2017,MIA,COL,6,3,6-3,MIA,9,true,36,37,73,156,151,307,15,12,27,5,3:24
491829,2017-08-11,2017,PHI,NYN,6,7,7-6,NYN,9,false,44,40,84,140,178,318,17,15,32,5,3:25
491821,2017-08-11,2017,ARI,CHN,3,8,8-3,CHN,9,false,35,42,77,178,141,319,10,18,28,4,3:23
491826,2017-08-11,2017,CHA,KCA,6,3,6-3,CHA,9,true,34,37,71,150,115,265,9,10,19,2,2:49
491820,2017-08-11,2017,NYA,BOS,5,4,5-4,NYA,9,true,37,40,77,158,168,326,13,15,28,3,3:40
491822,2017-08-11,2017,MIL,CIN,10,11,11-10,CIN,9,false,49,49,98,176,199,375,24,25,49,2,3:55
491833,2017-08-12,2017,SLN,ATL,6,5,6-5,SLN,9,true,37,40,77,161,132,293,15,13,28,1,2:52
491845,2017-08-12,2017,TOR,PIT,7,2,7-2,TOR,9,true,38,38,76,128,133,261,14,11,25,2,2:50
491836,2017-08-12,2017,ARI,CHN,6,2,6-2,ARI,9,true,39,40,79,152,138,290,16,11,27,2,3:05
491838,2017-08-12,2017,TBA,CLE,0,3,3-0,CLE,9,false,30,36,66,170,127,297,5,10,15,1,2:57
491840,2017-08-12,2017,TEX,HOU,8,3,8-3,TEX,9,true,38,37,75,147,151,298,18,12,30,2,3:14 (:21 delay)
491835,2017-08-12,2017,NYA,BOS,5,10,10-5,BOS,9,false,38,41,79,150,154,304,11,14,25,2,3:13
491841,2017-08-12,2017,CHA,KCA,4,5,5-4,KCA,9,false,36,37,73,156,143,299,12,12,24,2,3:12
491844,2017-08-12,2017,PHI,NYN,3,1,3-1,PHI,9,true,34,34,68,153,135,288,10,7,17,2,3:04
491839,2017-08-12,2017,MIA,COL,4,3,4-3,MIA,9,true,36,41,77,156,120,276,13,17,30,1,3:07
491843,2017-08-12,2017,DET,MIN,12,11,12-11,DET,9,false,39,49,88,182,146,328,16,22,38,5,3:36
491837,2017-08-12,2017,MIL,CIN,6,5,6-5,MIL,10,false,47,41,88,176,191,367,19,12,31,0,3:46
491834,2017-08-12,2017,OAK,BAL,5,12,12-5,BAL,9,false,41,48,89,175,159,334,14,25,39,3,3:20
491847,2017-08-12,2017,WAS,SFN,3,1,3-1,WAS,9,true,37,36,73,141,157,298,14,9,23,0,3:11 (3:01 delay)
491842,2017-08-12,2017,SEA,ANA,3,6,6-3,ANA,9,false,39,37,76,135,166,301,16,11,27,1,3:11
491846,2017-08-12,2017,LAN,SDN,6,3,6-3,LAN,9,true,38,40,78,168,158,326,14,13,27,1,3:36
491861,2017-08-13,2017,LAN,SDN,6,4,6-4,LAN,9,true,32,34,66,142,106,248,7,6,13,1,2:36
491857,2017-08-13,2017,SEA,ANA,2,4,4-2,ANA,9,false,35,41,76,158,126,284,9,14,23,1,2:59
491855,2017-08-13,2017,TEX,HOU,1,2,2-1,HOU,9,false,37,34,71,126,138,264,12,9,21,2,3:04
491854,2017-08-13,2017,MIA,COL,5,3,5-3,MIA,9,true,34,39,73,151,139,290,11,16,27,2,3:06
491862,2017-08-13,2017,WAS,SFN,2,4,4-2,SFN,9,false,35,40,75,146,140,286,8,13,21,1,3:09
491852,2017-08-13,2017,MIL,CIN,7,4,7-4,MIL,9,true,35,39,74,145,133,278,12,14,26,1,3:07
491851,2017-08-13,2017,ARI,CHN,2,7,7-2,CHN,9,false,35,43,78,174,135,309,9,16,25,4,3:12
491850,2017-08-13,2017,NYA,BOS,2,3,3-2,BOS,10,false,40,41,81,163,170,333,10,11,21,4,3:40
491832,2017-08-13,2017,WAS,SFN,6,2,6-2,WAS,11,false,42,40,82,173,153,326,16,10,26,0,3:31
491849,2017-08-13,2017,OAK,BAL,9,3,9-3,OAK,9,true,35,36,71,131,109,240,10,11,21,3,2:33
491858,2017-08-13,2017,DET,MIN,4,6,6-4,MIN,9,false,43,40,83,163,171,334,14,13,27,3,3:38
491853,2017-08-13,2017,TBA,CLE,3,4,4-3,CLE,9,false,34,37,71,146,131,277,8,12,20,3,3:06
491856,2017-08-13,2017,CHA,KCA,6,14,14-6,KCA,9,false,41,52,93,222,148,370,14,25,39,2,3:38
491848,2017-08-13,2017,SLN,ATL,3,6,6-3,ATL,9,false,39,40,79,146,136,282,14,15,29,2,2:58
491859,2017-08-13,2017,PHI,NYN,2,6,6-2,NYN,9,false,38,40,78,174,155,329,12,12,24,1,3:30
491860,2017-08-13,2017,TOR,PIT,7,1,7-1,TOR,9,true,37,36,73,148,148,296,13,9,22,1,2:51
491832,2017-08-13,2017,WAS,SFN,6,2,6-2,WAS,11,false,42,40,82,173,153,326,16,10,26,0,3:31
491698,2017-08-14,2017,BOS,CLE,3,7,7-3,CLE,9,false,38,43,81,164,158,322,10,16,26,5,3:14
491866,2017-08-14,2017,TEX,DET,6,2,6-2,TEX,9,true,35,37,72,147,126,273,14,11,25,0,2:56
491867,2017-08-14,2017,ARI,HOU,2,0,2-0,ARI,9,true,34,34,68,130,139,269,11,9,20,2,2:48
491698,2017-08-14,2017,BOS,CLE,3,7,7-3,CLE,9,false,38,43,81,164,158,322,10,16,26,5,3:14
491871,2017-08-14,2017,MIA,SFN,8,3,8-3,MIA,9,true,40,37,77,148,136,284,18,12,30,1,2:44
491868,2017-08-14,2017,OAK,KCA,2,6,6-2,KCA,9,false,35,39,74,150,124,274,7,14,21,0,2:40
491869,2017-08-14,2017,NYA,NYN,4,2,4-2,NYA,9,true,33,34,67,149,144,293,10,9,19,3,3:03
491872,2017-08-14,2017,TOR,TBA,2,1,2-1,TOR,9,true,33,37,70,134,140,274,10,10,20,3,2:54
491864,2017-08-14,2017,SEA,BAL,3,11,11-3,BAL,9,false,36,45,81,183,143,326,10,18,28,1,3:06
491865,2017-08-14,2017,CHN,CIN,15,5,15-5,CHN,9,true,49,43,92,180,171,351,25,17,42,3,3:45
491870,2017-08-14,2017,SDN,PHI,7,4,7-4,SDN,9,true,40,41,81,156,151,307,16,14,30,1,3:20
491863,2017-08-14,2017,COL,ATL,3,0,3-0,COL,9,true,34,34,68,116,129,245,13,8,21,1,2:44
491874,2017-08-15,2017,SEA,BAL,3,1,3-1,SEA,9,true,34,32,66,113,149,262,11,7,18,2,2:48
491882,2017-08-15,2017,NYA,NYN,5,4,5-4,NYA,9,true,35,36,71,156,115,271,12,10,22,3,3:07
491881,2017-08-15,2017,WAS,ANA,3,1,3-1,WAS,9,true,34,32,66,126,126,252,11,7,18,0,2:36
491875,2017-08-15,2017,LAN,CHA,6,1,6-1,LAN,9,true,39,34,73,113,158,271,16,7,23,3,3:05
491873,2017-08-15,2017,COL,ATL,3,4,4-3,ATL,9,false,35,35,70,122,150,272,11,8,19,1,2:53
491883,2017-08-15,2017,SDN,PHI,8,4,8-4,SDN,9,true,38,34,72,134,145,279,14,8,22,0,2:48
491879,2017-08-15,2017,ARI,HOU,4,9,9-4,HOU,9,false,38,44,82,170,158,328,12,19,31,1,3:07
491886,2017-08-15,2017,BOS,SLN,10,4,10-4,BOS,9,true,43,36,79,150,137,287,21,13,34,1,2:52
491884,2017-08-15,2017,MIL,PIT,3,1,3-1,MIL,9,true,34,36,70,139,122,261,12,10,22,1,2:53
491878,2017-08-15,2017,TEX,DET,10,4,10-4,TEX,9,true,38,38,76,167,172,339,18,13,31,2,3:23
491887,2017-08-15,2017,TOR,TBA,4,6,6-4,TBA,9,false,36,46,82,164,137,301,9,18,27,2,3:13
491885,2017-08-15,2017,MIA,SFN,4,9,9-4,SFN,9,false,39,40,79,157,143,300,14,16,30,1,3:13
491880,2017-08-15,2017,OAK,KCA,10,8,10-8,OAK,9,true,39,37,76,162,150,312,17,11,28,4,3:16
491877,2017-08-15,2017,MIN,CLE,1,8,8-1,CLE,9,false,30,43,73,163,127,290,3,17,20,2,2:53
491876,2017-08-15,2017,CHN,CIN,1,2,2-1,CIN,9,false,38,39,77,154,144,298,12,14,26,2,3:04
491898,2017-08-16,2017,SDN,PHI,3,0,3-0,SDN,9,true,33,32,65,114,134,248,10,4,14,2,2:30
491899,2017-08-16,2017,MIL,PIT,7,6,7-6,MIL,9,true,35,38,73,151,157,308,11,12,23,2,3:06
491900,2017-08-16,2017,MIA,SFN,8,1,8-1,MIA,9,true,41,36,77,135,151,286,16,10,26,0,2:49
491901,2017-08-16,2017,BOS,SLN,5,4,5-4,BOS,9,false,38,38,76,153,164,317,15,11,26,3,3:35
491890,2017-08-16,2017,SEA,BAL,7,6,7-6,SEA,9,true,39,42,81,156,146,302,19,17,36,4,3:13
491895,2017-08-16,2017,OAK,KCA,6,7,7-6,KCA,9,false,42,46,88,189,171,360,15,22,37,1,3:37
491902,2017-08-16,2017,TOR,TBA,3,2,3-2,TOR,9,true,32,38,70,158,125,283,10,11,21,4,3:10
491896,2017-08-16,2017,WAS,ANA,2,3,3-2,ANA,9,false,37,32,69,118,157,275,10,6,16,2,2:51
491892,2017-08-16,2017,CHN,CIN,7,6,7-6,CHN,9,false,38,38,76,147,152,299,14,12,26,4,3:35
491891,2017-08-16,2017,LAN,CHA,5,4,5-4,LAN,9,false,34,37,71,127,133,260,13,13,26,3,2:59
491888,2017-08-16,2017,HOU,ARI,9,5,9-5,HOU,9,true,41,38,79,153,152,305,18,13,31,4,3:17
491897,2017-08-16,2017,NYN,NYA,3,5,5-3,NYA,9,false,35,40,75,145,152,297,9,13,22,3,3:13
491889,2017-08-16,2017,COL,ATL,17,2,17-2,COL,9,true,49,34,83,137,207,344,25,9,34,2,3:16 (:16 delay)
491894,2017-08-16,2017,TEX,DET,12,6,12-6,TEX,9,true,48,43,91,156,195,351,24,20,44,6,3:52
491903,2017-08-17,2017,HOU,ARI,0,4,4-0,ARI,9,false,32,35,67,133,112,245,5,14,19,3,2:48
491893,2017-08-17,2017,MIN,CLE,4,2,4-2,MIN,9,true,41,32,73,121,150,271,17,6,23,6,3:08
491911,2017-08-17,2017,TOR,TBA,5,3,5-3,TOR,9,true,32,44,76,163,127,290,7,19,26,3,3:01
491906,2017-08-17,2017,CHN,CIN,10,13,13-10,CIN,9,false,42,48,90,191,155,346,16,21,37,3,3:45
491905,2017-08-17,2017,TEX,CHA,9,8,9-8,TEX,9,true,40,43,83,143,183,326,17,16,33,4,3:49
491893,2017-08-17,2017,MIN,CLE,4,2,4-2,MIN,9,true,41,32,73,121,150,271,17,6,23,6,3:08
491909,2017-08-17,2017,SFN,PHI,5,4,5-4,SFN,9,true,37,37,74,140,125,265,15,11,26,1,2:47
491912,2017-08-17,2017,SDN,WAS,1,2,2-1,WAS,9,false,36,36,72,159,110,269,10,11,21,1,3:01
491908,2017-08-17,2017,NYN,NYA,5,7,7-5,NYA,9,false,40,39,79,143,153,296,12,12,24,3,2:55
491904,2017-08-17,2017,COL,ATL,4,10,10-4,ATL,9,false,42,43,85,150,156,306,14,17,31,2,3:27
491907,2017-08-17,2017,MIN,CLE,3,9,9-3,CLE,9,false,38,46,84,183,172,355,13,21,34,7,3:53
491910,2017-08-17,2017,PIT,SLN,7,11,11-7,SLN,9,false,44,46,90,187,168,355,21,21,42,2,3:36 (1:32 delay)
491919,2017-08-18,2017,NYN,MIA,1,3,3-1,MIA,9,false,34,35,69,137,127,264,8,9,17,1,2:53 (1:53 delay)
491924,2017-08-18,2017,TBA,SEA,1,7,7-1,SEA,9,false,34,42,76,141,137,278,7,17,24,1,2:53
491916,2017-08-18,2017,KCA,CLE,1,10,10-1,CLE,9,false,37,44,81,154,129,283,11,17,28,3,2:58
491914,2017-08-18,2017,TEX,CHA,3,4,4-3,CHA,9,false,36,39,75,142,145,287,11,14,25,4,3:25
491915,2017-08-18,2017,ATL,CIN,3,5,5-3,CIN,9,false,38,40,78,155,142,297,12,15,27,1,3:09
491920,2017-08-18,2017,COL,MIL,8,4,8-4,COL,9,true,36,38,74,138,127,265,15,11,26,3,2:55
491918,2017-08-18,2017,DET,LAN,5,8,8-5,LAN,9,false,43,43,86,143,161,304,17,19,36,2,3:20
491921,2017-08-18,2017,BOS,NYA,9,6,9-6,BOS,9,true,39,47,86,200,155,355,16,20,36,6,4:09
491927,2017-08-18,2017,SDN,WAS,1,7,7-1,WAS,9,false,32,40,72,147,116,263,7,14,21,3,2:48
491913,2017-08-18,2017,MIN,ARI,10,3,10-3,MIN,9,true,41,36,77,125,167,292,21,10,31,6,3:06
491922,2017-08-18,2017,HOU,OAK,3,1,3-1,HOU,9,true,32,31,63,140,124,264,8,6,14,1,2:47
491926,2017-08-18,2017,CHN,TOR,7,4,7-4,CHN,9,true,38,38,76,138,143,281,17,12,29,2,3:02
491917,2017-08-18,2017,BAL,ANA,9,7,9-7,BAL,9,false,38,38,76,144,133,277,12,13,25,3,3:13 (:42 delay)
491923,2017-08-18,2017,SFN,PHI,10,2,10-2,SFN,9,true,38,35,73,147,145,292,14,8,22,3,2:52
491925,2017-08-18,2017,PIT,SLN,10,11,11-10,SLN,9,false,43,44,87,171,177,348,18,17,35,4,3:23
491942,2017-08-19,2017,SDN,WAS,3,1,3-1,SDN,9,true,30,33,63,131,131,262,8,5,13,1,2:47
491933,2017-08-19,2017,DET,LAN,0,3,3-0,LAN,9,false,36,35,71,137,148,285,9,10,19,0,2:57
491937,2017-08-19,2017,HOU,OAK,3,0,3-0,HOU,9,true,32,32,64,128,125,253,12,10,22,1,2:47
491928,2017-08-19,2017,MIN,ARI,5,0,5-0,MIN,9,true,38,30,68,123,167,290,15,3,18,1,2:54
491941,2017-08-19,2017,CHN,TOR,4,3,4-3,CHN,9,true,35,36,71,149,144,293,14,9,23,3,3:09
491936,2017-08-19,2017,BOS,NYA,3,4,4-3,NYA,9,false,36,39,75,153,129,282,9,12,21,3,3:09
491932,2017-08-19,2017,BAL,ANA,1,5,5-1,ANA,9,false,36,39,75,154,140,294,10,13,23,4,3:15 (:40 delay)
491931,2017-08-19,2017,KCA,CLE,0,5,5-0,CLE,9,false,35,39,74,159,133,292,10,12,22,2,2:50
491934,2017-08-19,2017,NYN,MIA,8,1,8-1,NYN,9,true,36,35,71,129,152,281,11,13,24,2,2:48
491935,2017-08-19,2017,COL,MIL,3,6,6-3,MIL,9,false,39,40,79,137,148,285,15,14,29,3,3:14
491940,2017-08-19,2017,PIT,SLN,6,4,6-4,PIT,9,true,38,35,73,143,147,290,14,9,23,0,2:49 (1:56 delay)
491939,2017-08-19,2017,TBA,SEA,6,7,7-6,SEA,9,false,38,43,81,172,151,323,11,17,28,4,3:15
491938,2017-08-19,2017,SFN,PHI,9,12,12-9,PHI,9,false,45,44,89,159,167,326,20,17,37,4,3:21
491930,2017-08-19,2017,ATL,CIN,8,11,11-8,CIN,9,false,49,45,94,177,159,336,19,19,38,1,3:35
491929,2017-08-19,2017,TEX,CHA,17,7,17-7,TEX,9,true,50,42,92,158,201,359,28,16,44,2,3:50
491955,2017-08-20,2017,PIT,SLN,6,3,6-3,PIT,9,true,35,39,74,159,126,285,11,13,24,2,2:58
491946,2017-08-20,2017,KCA,CLE,7,4,7-4,KCA,9,true,38,38,76,159,130,289,17,10,27,1,3:02
491943,2017-08-20,2017,MIN,ARI,12,5,12-5,MIN,9,true,42,38,80,137,174,311,17,11,28,1,3:06
491945,2017-08-20,2017,ATL,CIN,8,1,8-1,ATL,9,true,41,41,82,153,150,303,18,17,35,1,3:11
491953,2017-08-20,2017,SFN,PHI,2,5,5-2,PHI,9,false,37,40,77,164,155,319,14,14,28,2,3:14
491956,2017-08-20,2017,CHN,TOR,6,5,6-5,CHN,10,false,43,45,88,172,169,341,13,17,30,3,3:44
491950,2017-08-20,2017,COL,MIL,4,8,8-4,MIL,9,false,43,44,87,171,163,334,17,18,35,5,4:04
491954,2017-08-20,2017,TBA,SEA,3,0,3-0,TBA,9,true,34,31,65,126,131,257,12,5,17,1,2:44
491949,2017-08-20,2017,NYN,MIA,4,6,6-4,MIA,9,false,36,40,76,158,136,294,11,12,23,2,2:53
491947,2017-08-20,2017,BAL,ANA,4,5,5-4,ANA,9,false,37,40,77,164,151,315,11,15,26,3,3:25
491957,2017-08-20,2017,SDN,WAS,1,4,4-1,WAS,9,false,35,40,75,170,150,320,6,13,19,3,3:23
491948,2017-08-20,2017,DET,LAN,6,1,6-1,DET,9,true,33,31,64,128,122,250,9,4,13,0,2:33
491952,2017-08-20,2017,HOU,OAK,2,3,3-2,OAK,9,false,36,40,76,163,134,297,10,16,26,3,3:17
491944,2017-08-20,2017,TEX,CHA,2,3,3-2,CHA,9,false,39,38,77,140,155,295,13,13,26,3,3:20
491951,2017-08-20,2017,BOS,NYA,5,1,5-1,BOS,9,true,40,33,73,141,186,327,18,6,24,2,3:36
490606,2017-08-21,2017,CHA,MIN,2,10,10-2,MIN,9,false,31,41,72,149,110,259,4,17,21,2,2:35
491963,2017-08-21,2017,BAL,OAK,7,3,7-3,BAL,9,true,38,35,73,151,158,309,14,12,26,3,3:12
491962,2017-08-21,2017,CHA,MIN,7,6,7-6,CHA,9,true,34,41,75,175,144,319,11,14,25,4,3:15 (:19 delay)
490606,2017-08-21,2017,CHA,MIN,2,10,10-2,MIN,9,false,31,41,72,149,110,259,4,17,21,2,2:35
491959,2017-08-21,2017,CLE,BOS,5,4,5-4,CLE,9,false,35,38,73,150,149,299,10,12,22,5,3:39
491960,2017-08-21,2017,PIT,LAN,5,6,6-5,LAN,12,false,51,54,105,193,215,408,16,17,33,3,4:35
491961,2017-08-21,2017,SFN,MIL,2,0,2-0,SFN,9,true,37,34,71,136,136,272,13,7,20,0,2:45
491965,2017-08-21,2017,ANA,TEX,3,5,5-3,TEX,9,false,39,37,76,134,151,285,12,10,22,2,3:11
491964,2017-08-21,2017,ATL,SEA,5,6,6-5,SEA,9,false,39,40,79,141,130,271,13,14,27,4,2:59
491958,2017-08-21,2017,NYN,ARI,2,3,3-2,ARI,10,false,42,40,82,157,191,348,15,10,25,5,3:46
490396,2017-08-22,2017,PHI,MIA,4,7,7-4,MIA,9,false,37,43,80,195,157,352,11,17,28,4,3:22
491969,2017-08-22,2017,KCA,COL,3,2,3-2,KCA,9,true,31,35,66,135,119,254,7,7,14,4,2:51
491967,2017-08-22,2017,CLE,BOS,1,9,9-1,BOS,9,false,29,41,70,149,114,263,4,14,18,2,2:41 (1:13 delay)
491976,2017-08-22,2017,SLN,SDN,4,12,12-4,SDN,9,false,37,45,82,171,133,304,11,19,30,3,3:04
491977,2017-08-22,2017,ATL,SEA,4,0,4-0,ATL,9,true,36,36,72,142,148,290,16,10,26,2,3:01
490396,2017-08-22,2017,PHI,MIA,4,7,7-4,MIA,9,false,37,43,80,195,157,352,11,17,28,4,3:22
491974,2017-08-22,2017,DET,NYA,4,13,13-4,NYA,9,false,33,49,82,185,123,308,8,20,28,2,3:14
491973,2017-08-22,2017,CHA,MIN,1,4,4-1,MIN,9,false,34,33,67,139,118,257,9,8,17,0,2:40
491980,2017-08-22,2017,HOU,WAS,3,4,4-3,WAS,9,false,38,34,72,127,162,289,13,7,20,2,3:05
491979,2017-08-22,2017,TBA,TOR,6,5,6-5,TBA,9,true,39,36,75,142,133,275,17,8,25,3,2:54
491966,2017-08-22,2017,NYN,ARI,4,7,7-4,ARI,9,false,35,40,75,168,131,299,10,12,22,4,3:03
491975,2017-08-22,2017,BAL,OAK,4,6,6-4,OAK,9,false,34,43,77,149,157,306,9,16,25,5,3:16
491971,2017-08-22,2017,PHI,MIA,8,12,12-8,MIA,9,false,37,43,80,162,164,326,10,17,27,1,3:06
491970,2017-08-22,2017,PIT,LAN,5,8,8-5,LAN,9,false,37,43,80,169,156,325,14,17,31,1,3:24
491978,2017-08-22,2017,ANA,TEX,10,1,10-1,ANA,9,true,47,38,85,170,182,352,22,12,34,4,3:58
491972,2017-08-22,2017,SFN,MIL,3,4,4-3,MIL,9,false,40,40,80,141,164,305,16,13,29,2,3:15
491968,2017-08-22,2017,CIN,CHN,9,13,13-9,CHN,9,false,44,50,94,200,176,376,18,24,42,3,4:04
491995,2017-08-23,2017,HOU,WAS,6,1,6-1,HOU,9,true,39,32,71,113,139,252,16,7,23,2,2:48
491981,2017-08-23,2017,NYN,ARI,4,2,4-2,NYN,9,true,36,39,75,148,143,291,15,13,28,2,3:15
491993,2017-08-23,2017,ANA,TEX,5,7,7-5,TEX,10,false,41,46,87,164,157,321,12,19,31,2,3:41
491989,2017-08-23,2017,DET,NYA,2,10,10-2,NYA,9,false,38,43,81,152,146,298,11,17,28,1,2:55
491984,2017-08-23,2017,KCA,COL,6,4,6-4,KCA,9,false,40,39,79,167,157,324,16,14,30,3,3:36
491988,2017-08-23,2017,CHA,MIN,4,3,4-3,CHA,9,false,35,33,68,139,120,259,13,6,19,1,2:43
491987,2017-08-23,2017,SFN,MIL,4,2,4-2,SFN,9,true,36,34,70,143,135,278,13,9,22,1,3:08
491986,2017-08-23,2017,PHI,MIA,8,0,8-0,PHI,9,true,39,30,69,122,160,282,16,4,20,1,2:50
491985,2017-08-23,2017,PIT,LAN,1,0,1-0,PIT,10,false,29,41,70,136,99,235,1,14,15,0,2:34
491991,2017-08-23,2017,SLN,SDN,6,2,6-2,SLN,9,true,42,35,77,147,149,296,21,8,29,2,2:53
491983,2017-08-23,2017,CIN,CHN,3,9,9-3,CHN,9,false,34,43,77,165,135,300,8,16,24,1,2:55
491994,2017-08-23,2017,TBA,TOR,6,7,7-6,TOR,9,false,41,39,80,155,154,309,15,13,28,5,3:13
491982,2017-08-23,2017,CLE,BOS,1,6,6-1,BOS,9,false,36,38,74,148,159,307,9,11,20,5,3:11
491992,2017-08-23,2017,ATL,SEA,6,9,9-6,SEA,9,false,43,47,90,144,144,288,17,22,39,3,3:07
491990,2017-08-23,2017,BAL,OAK,8,7,8-7,BAL,12,false,47,54,101,206,195,401,17,19,36,5,4:20
492006,2017-08-24,2017,TBA,TOR,2,0,2-0,TBA,9,true,34,35,69,169,145,314,10,8,18,3,3:21
492001,2017-08-24,2017,PHI,MIA,8,9,9-8,MIA,9,false,42,46,88,152,151,303,17,21,38,1,3:14
491997,2017-08-24,2017,CLE,BOS,13,6,13-6,CLE,9,true,47,39,86,171,174,345,24,14,38,4,3:28
491999,2017-08-24,2017,KCA,COL,2,3,3-2,COL,9,false,36,38,74,127,136,263,11,13,24,3,2:43
492005,2017-08-24,2017,ANA,TEX,0,3,3-0,TEX,9,false,35,34,69,135,133,268,9,8,17,0,2:46
492004,2017-08-24,2017,SLN,SDN,3,4,4-3,SDN,9,false,37,42,79,151,121,272,14,17,31,4,3:06
491998,2017-08-24,2017,CIN,CHN,4,2,4-2,CIN,9,true,36,36,72,127,147,274,14,12,26,1,2:47
492007,2017-08-24,2017,HOU,WAS,4,5,5-4,WAS,11,false,42,43,85,176,163,339,11,9,20,0,3:47
492002,2017-08-24,2017,CHA,MIN,5,1,5-1,CHA,9,true,33,36,69,158,150,308,9,10,19,2,2:53
491996,2017-08-24,2017,NYN,ARI,2,3,3-2,ARI,9,false,40,39,79,165,176,341,15,15,30,4,3:45
492000,2017-08-24,2017,PIT,LAN,2,5,5-2,LAN,9,false,38,47,85,203,148,351,11,22,33,3,3:37
492003,2017-08-24,2017,DET,NYA,10,6,10-6,DET,9,true,44,39,83,154,178,332,21,13,34,7,4:13
492014,2017-08-25,2017,LAN,MIL,3,1,3-1,LAN,9,true,36,30,66,117,157,274,12,4,16,1,3:00
492018,2017-08-25,2017,MIA,SDN,8,6,8-6,MIA,9,true,37,37,74,130,155,285,14,10,24,1,2:53
492008,2017-08-25,2017,BOS,BAL,3,16,16-3,BAL,9,false,37,52,89,199,146,345,8,23,31,1,3:37
492011,2017-08-25,2017,CHA,DET,3,2,3-2,CHA,9,false,34,33,67,116,119,235,14,7,21,0,2:44
492022,2017-08-25,2017,OAK,TEX,3,1,3-1,OAK,9,true,30,34,64,131,113,244,6,10,16,0,2:26
492010,2017-08-25,2017,ATL,COL,5,2,5-2,ATL,9,true,36,32,68,109,130,239,12,6,18,1,2:32
492012,2017-08-25,2017,ANA,HOU,1,2,2-1,HOU,9,false,36,35,71,128,151,279,10,8,18,0,2:56
492019,2017-08-25,2017,ARI,SFN,4,3,4-3,ARI,9,true,33,33,66,146,132,278,10,8,18,3,2:54
492015,2017-08-25,2017,TOR,MIN,1,6,6-1,MIN,9,false,39,42,81,162,127,289,12,15,27,2,3:05
492013,2017-08-25,2017,CLE,KCA,4,0,4-0,CLE,9,true,36,35,71,128,155,283,13,9,22,4,2:44
492016,2017-08-25,2017,WAS,NYN,2,4,4-2,NYN,9,false,37,40,77,158,139,297,10,14,24,2,3:08
492021,2017-08-25,2017,SLN,TBA,3,7,7-3,TBA,9,false,35,47,82,195,138,333,9,22,31,3,3:38
492009,2017-08-25,2017,PHI,CHN,7,1,7-1,PHI,9,true,36,39,75,147,135,282,16,12,28,0,3:00
492017,2017-08-25,2017,CIN,PIT,9,5,9-5,CIN,9,true,42,41,83,174,170,344,17,16,33,3,3:35
492020,2017-08-25,2017,NYA,SEA,1,2,2-1,SEA,11,false,47,44,91,158,205,363,14,11,25,3,3:51
492023,2017-08-26,2017,BOS,BAL,0,7,7-0,BAL,9,false,34,37,71,153,142,295,8,11,19,2,2:58
492026,2017-08-26,2017,CHA,DET,3,6,6-3,DET,9,false,38,42,80,150,141,291,11,14,25,4,3:14
492031,2017-08-26,2017,WAS,NYN,9,4,9-4,WAS,9,true,41,38,79,149,136,285,18,13,31,1,3:03
492025,2017-08-26,2017,ATL,COL,6,7,7-6,COL,9,false,38,43,81,180,119,299,15,17,32,3,3:24
492024,2017-08-26,2017,PHI,CHN,2,17,17-2,CHN,9,false,33,47,80,196,114,310,8,20,28,1,3:03
492035,2017-08-26,2017,NYA,SEA,6,3,6-3,NYA,9,true,38,38,76,149,162,311,15,10,25,2,3:25
492030,2017-08-26,2017,TOR,MIN,10,9,10-9,TOR,9,true,42,39,81,157,155,312,18,12,30,5,3:04
492036,2017-08-26,2017,SLN,TBA,6,4,6-4,SLN,9,false,38,33,71,95,148,243,14,6,20,1,2:30
492028,2017-08-26,2017,CLE,KCA,4,0,4-0,CLE,9,true,33,34,67,147,113,260,9,7,16,1,2:38
492034,2017-08-26,2017,ARI,SFN,2,1,2-1,ARI,9,true,30,33,63,141,124,265,7,6,13,1,2:34
492032,2017-08-26,2017,CIN,PIT,0,1,1-0,PIT,9,false,31,31,62,134,127,261,5,5,10,0,2:28
492027,2017-08-26,2017,ANA,HOU,7,6,7-6,ANA,9,true,33,38,71,153,139,292,10,10,20,2,3:01 (:40 delay)
492029,2017-08-26,2017,LAN,MIL,0,3,3-0,MIL,9,false,32,35,67,147,139,286,5,8,13,0,2:58
492037,2017-08-26,2017,OAK,TEX,8,3,8-3,OAK,9,true,38,39,77,172,158,330,17,13,30,2,3:21
492033,2017-08-26,2017,MIA,SDN,2,1,2-1,MIA,11,false,44,42,86,170,182,352,14,8,22,2,3:53
491372,2017-08-27,2017,WAS,NYN,5,4,5-4,WAS,9,true,33,38,71,166,142,308,10,11,21,3,3:21
492049,2017-08-27,2017,ARI,SFN,11,0,11-0,ARI,9,true,43,31,74,118,167,285,20,7,27,4,3:03
492044,2017-08-27,2017,LAN,MIL,2,3,3-2,MIL,9,false,35,36,71,158,144,302,9,12,21,2,3:31
492050,2017-08-27,2017,NYA,SEA,10,1,10-1,NYA,9,true,44,34,78,119,150,269,19,7,26,1,2:57
492048,2017-08-27,2017,MIA,SDN,6,2,6-2,MIA,9,true,34,36,70,134,111,245,12,10,22,1,2:31
492041,2017-08-27,2017,CHA,DET,7,1,7-1,CHA,9,true,36,35,71,135,135,270,12,9,21,0,2:44
492042,2017-08-27,2017,ANA,HOU,5,7,7-5,HOU,9,false,39,38,77,144,152,296,15,14,29,0,3:16
492051,2017-08-27,2017,SLN,TBA,2,3,3-2,TBA,10,false,40,42,82,155,154,309,10,14,24,3,3:33
492043,2017-08-27,2017,CLE,KCA,12,0,12-0,CLE,9,true,44,32,76,106,167,273,23,6,29,1,2:39
492040,2017-08-27,2017,ATL,COL,0,3,3-0,COL,9,false,34,39,73,158,134,292,10,14,24,3,3:09
492038,2017-08-27,2017,BOS,BAL,1,2,2-1,BAL,9,false,41,35,76,139,183,322,16,8,24,4,3:22
492039,2017-08-27,2017,PHI,CHN,6,3,6-3,PHI,9,true,34,37,71,153,130,283,9,11,20,2,2:54
492052,2017-08-27,2017,OAK,TEX,8,3,8-3,OAK,9,true,41,37,78,145,171,316,17,10,27,5,3:20
491372,2017-08-27,2017,WAS,NYN,5,4,5-4,WAS,9,true,33,38,71,166,142,308,10,11,21,3,3:21
492045,2017-08-27,2017,TOR,MIN,2,7,7-2,MIN,9,false,34,44,78,184,141,325,8,17,25,3,3:18
492047,2017-08-27,2017,CIN,PIT,2,5,5-2,PIT,9,false,40,40,80,163,177,340,13,16,29,1,3:18
492046,2017-08-27,2017,WAS,NYN,5,6,6-5,NYN,9,false,45,40,85,156,183,339,19,13,32,7,3:34
492062,2017-08-28,2017,KCA,TBA,0,12,12-0,TBA,9,false,30,41,71,143,117,260,4,17,21,1,2:43
492059,2017-08-28,2017,CHN,PIT,6,1,6-1,CHN,9,true,39,32,71,123,149,272,17,7,24,1,2:50
492058,2017-08-28,2017,ANA,OAK,3,1,3-1,ANA,9,true,33,35,68,147,120,267,10,9,19,1,2:53
492060,2017-08-28,2017,SDN,SFN,0,3,3-0,SFN,9,false,29,39,68,148,102,250,3,14,17,0,2:31
492056,2017-08-28,2017,COL,DET,3,4,4-3,DET,9,false,41,36,77,152,155,307,15,12,27,3,3:29
492061,2017-08-28,2017,BAL,SEA,7,6,7-6,BAL,9,true,40,38,78,144,128,272,19,13,32,3,3:01
492054,2017-08-28,2017,TOR,BOS,5,6,6-5,BOS,9,false,41,41,82,170,148,318,15,17,32,2,3:23
492057,2017-08-28,2017,WAS,MIA,11,2,11-2,WAS,9,true,41,37,78,142,188,330,17,12,29,1,3:06
492055,2017-08-28,2017,NYA,CLE,2,6,6-2,CLE,9,false,32,36,68,148,120,268,4,10,14,1,2:42
492053,2017-08-28,2017,PHI,ATL,6,1,6-1,PHI,9,true,37,33,70,126,138,264,13,8,21,2,2:52
492074,2017-08-29,2017,BAL,SEA,4,0,4-0,BAL,9,true,33,33,66,116,130,246,12,4,16,0,2:26 (:32 delay)
492073,2017-08-29,2017,SDN,SFN,6,3,6-3,SDN,9,true,36,38,74,125,121,246,13,11,24,0,2:38
492064,2017-08-29,2017,TOR,BOS,0,3,3-0,BOS,9,false,31,35,66,143,149,292,4,10,14,2,2:44
492067,2017-08-29,2017,COL,DET,7,3,7-3,COL,9,true,35,33,68,122,144,266,12,8,20,3,3:08
492069,2017-08-29,2017,WAS,MIA,8,3,8-3,WAS,9,true,38,40,78,152,140,292,19,13,32,3,3:11 (:26 delay)
492065,2017-08-29,2017,MIN,CHA,6,4,6-4,MIN,9,true,35,40,75,150,132,282,13,14,27,3,3:12
492068,2017-08-29,2017,ARI,LAN,7,6,7-6,ARI,9,true,34,40,74,173,138,311,11,13,24,3,3:08
492076,2017-08-29,2017,KCA,TBA,6,2,6-2,KCA,9,true,37,34,71,125,133,258,12,7,19,2,2:57
492071,2017-08-29,2017,ANA,OAK,8,2,8-2,ANA,9,true,37,36,73,142,129,271,13,10,23,4,2:53
492072,2017-08-29,2017,CHN,PIT,4,1,4-1,CHN,9,true,34,35,69,139,125,264,13,9,22,3,2:49
492075,2017-08-29,2017,MIL,SLN,2,10,10-2,SLN,9,false,37,50,87,209,146,355,10,20,30,2,3:33
492070,2017-08-29,2017,CIN,NYN,14,4,14-4,CIN,9,true,48,40,88,166,179,345,25,15,40,4,3:30
492077,2017-08-29,2017,HOU,TEX,2,12,12-2,TEX,9,false,38,46,84,193,140,333,13,19,32,0,3:27
492078,2017-08-30,2017,PHI,ATL,1,9,9-1,ATL,9,false,34,47,81,156,134,290,8,21,29,1,2:49
492066,2017-08-30,2017,NYA,CLE,4,9,9-4,CLE,9,false,36,45,81,194,125,319,11,18,29,3,3:04
492092,2017-08-30,2017,HOU,TEX,1,8,8-1,TEX,9,false,32,43,75,161,120,281,4,18,22,0,2:52
492066,2017-08-30,2017,NYA,CLE,4,9,9-4,CLE,9,false,36,45,81,194,125,319,11,18,29,3,3:04
492085,2017-08-30,2017,CIN,NYN,0,2,2-0,NYN,9,false,32,33,65,116,128,244,8,7,15,1,2:27
492084,2017-08-30,2017,WAS,MIA,4,0,4-0,WAS,9,true,36,33,69,110,150,260,16,8,24,0,2:36
492091,2017-08-30,2017,KCA,TBA,3,5,5-3,TBA,9,false,34,35,69,129,126,255,8,9,17,3,2:39
492089,2017-08-30,2017,BAL,SEA,8,7,8-7,BAL,9,true,39,38,77,129,140,269,16,12,28,6,3:07
492090,2017-08-30,2017,MIL,SLN,6,5,6-5,MIL,9,true,35,35,70,149,126,275,10,8,18,2,2:40
492081,2017-08-30,2017,NYA,CLE,1,2,2-1,CLE,9,false,36,38,74,152,153,305,10,12,22,4,3:12
492083,2017-08-30,2017,ARI,LAN,6,4,6-4,ARI,9,true,37,40,77,156,125,281,14,13,27,3,3:05
492082,2017-08-30,2017,COL,DET,2,6,6-2,DET,9,false,35,41,76,149,145,294,8,16,24,0,3:03
492080,2017-08-30,2017,MIN,CHA,11,1,11-1,MIN,9,true,48,36,84,117,182,299,25,9,34,2,3:17
492063,2017-08-30,2017,PHI,ATL,2,5,5-2,ATL,9,false,37,43,80,145,158,303,10,18,28,4,3:17
492063,2017-08-30,2017,PHI,ATL,2,5,5-2,ATL,9,false,37,43,80,145,158,303,10,18,28,4,3:17
492086,2017-08-30,2017,ANA,OAK,10,8,10-8,ANA,9,true,40,41,81,167,154,321,17,15,32,4,3:34
492087,2017-08-30,2017,CHN,PIT,17,3,17-3,CHN,9,true,47,35,82,145,168,313,22,8,30,2,3:12
492088,2017-08-30,2017,SDN,SFN,5,0,5-0,SDN,9,true,35,37,72,169,137,306,11,12,23,3,3:02
492079,2017-08-30,2017,TOR,BOS,1,7,7-1,BOS,9,false,34,41,75,181,132,313,8,16,24,2,2:58
492102,2017-08-31,2017,MIL,WAS,6,3,6-3,MIL,9,true,38,34,72,119,152,271,16,9,25,0,2:50
492098,2017-08-31,2017,MIA,PHI,2,3,3-2,PHI,9,false,41,37,78,159,148,307,15,11,26,1,3:09
492095,2017-08-31,2017,MIN,CHA,5,4,5-4,MIN,9,false,41,40,81,138,158,296,15,15,30,2,3:17
492101,2017-08-31,2017,BAL,TOR,8,11,11-8,TOR,9,false,43,43,86,153,165,318,17,17,34,3,3:28
492093,2017-08-31,2017,CHN,ATL,6,2,6-2,CHN,9,true,41,36,77,149,162,311,16,10,26,1,2:59
492094,2017-08-31,2017,NYA,BOS,6,2,6-2,NYA,9,true,41,41,82,155,149,304,19,14,33,3,3:44
492099,2017-08-31,2017,SFN,SLN,2,5,5-2,SLN,9,false,35,42,77,166,132,298,9,14,23,3,3:17
492100,2017-08-31,2017,HOU,TEX,5,1,5-1,HOU,9,true,33,35,68,154,122,276,12,9,21,2,3:02
492096,2017-08-31,2017,ARI,LAN,8,1,8-1,ARI,9,true,36,35,71,143,142,285,14,8,22,0,3:02
492097,2017-08-31,2017,CIN,NYN,7,2,7-2,CIN,9,true,38,37,75,137,125,262,14,11,25,2,2:42
491296,2017-09-01,2017,DET,CLE,2,3,3-2,CLE,9,false,39,38,77,169,154,323,13,13,26,2,3:25
491296,2017-09-01,2017,DET,CLE,2,3,3-2,CLE,9,false,39,38,77,169,154,323,13,13,26,2,3:25
492104,2017-09-01,2017,CHN,ATL,2,0,2-0,CHN,9,true,34,31,65,106,145,251,12,5,17,3,2:38
492105,2017-09-01,2017,NYA,BOS,1,4,4-1,BOS,9,false,32,36,68,130,124,254,5,8,13,0,2:44
492113,2017-09-01,2017,MIA,PHI,1,2,2-1,PHI,9,false,32,37,69,128,128,256,7,10,17,1,2:44
492112,2017-09-01,2017,SEA,OAK,3,2,3-2,SEA,9,true,33,35,68,135,124,259,12,10,22,4,2:32
492110,2017-09-01,2017,SDN,LAN,0,1,1-0,LAN,9,false,29,38,67,152,107,259,2,14,16,1,2:57
492103,2017-09-01,2017,COL,ARI,5,9,9-5,ARI,9,false,44,42,86,162,168,330,17,19,36,6,3:48
492116,2017-09-01,2017,BAL,TOR,1,0,1-0,BAL,13,false,48,49,97,216,185,401,12,10,22,3,4:27
492115,2017-09-01,2017,CHA,TBA,1,3,3-1,TBA,9,false,34,35,69,123,118,241,9,7,16,3,2:34
492117,2017-09-01,2017,MIL,WAS,1,0,1-0,MIL,9,true,31,34,65,132,125,257,9,8,17,1,2:39
492108,2017-09-01,2017,MIN,KCA,6,7,7-6,KCA,9,false,40,40,80,154,152,306,12,15,27,5,3:23
492106,2017-09-01,2017,PIT,CIN,3,7,7-3,CIN,9,false,36,38,74,142,169,311,9,13,22,0,3:00
492107,2017-09-01,2017,DET,CLE,0,10,10-0,CLE,9,false,34,46,80,187,133,320,8,20,28,2,3:04
492114,2017-09-01,2017,SFN,SLN,6,11,11-6,SLN,9,false,41,44,85,171,147,318,15,18,33,5,3:23
492109,2017-09-01,2017,TEX,ANA,10,9,10-9,TEX,9,true,44,49,93,189,191,380,19,22,41,7,4:33
490565,2017-09-02,2017,SDN,LAN,6,5,6-5,SDN,9,false,40,37,77,117,179,296,16,14,30,1,3:11
492132,2017-09-02,2017,MIL,WAS,2,3,3-2,WAS,9,false,35,35,70,133,131,264,9,10,19,3,3:01
492118,2017-09-02,2017,COL,ARI,2,6,6-2,ARI,9,false,35,42,77,179,157,336,8,14,22,4,3:38
492127,2017-09-02,2017,SEA,OAK,7,6,7-6,SEA,9,false,41,42,83,193,154,347,15,16,31,5,3:37
492128,2017-09-02,2017,MIA,PHI,10,9,10-9,MIA,9,true,44,45,89,181,170,351,19,19,38,2,3:37
492120,2017-09-02,2017,NYA,BOS,5,1,5-1,NYA,9,true,36,34,70,122,140,262,11,8,19,3,2:58
492129,2017-09-02,2017,SFN,SLN,2,1,2-1,SFN,10,false,33,34,67,151,122,273,8,5,13,3,2:58
492130,2017-09-02,2017,CHA,TBA,5,4,5-4,CHA,9,true,34,40,74,158,130,288,12,14,26,5,3:14 (1:18 delay)
490565,2017-09-02,2017,SDN,LAN,6,5,6-5,SDN,9,false,40,37,77,117,179,296,16,14,30,1,3:11
492122,2017-09-02,2017,DET,CLE,2,5,5-2,CLE,9,false,37,43,80,158,137,295,11,16,27,2,3:02
492121,2017-09-02,2017,PIT,CIN,5,0,5-0,PIT,9,true,39,33,72,142,154,296,15,8,23,1,2:53
492131,2017-09-02,2017,BAL,TOR,2,7,7-2,TOR,9,false,36,39,75,157,139,296,10,12,22,3,3:02
492126,2017-09-02,2017,HOU,NYN,4,1,4-1,HOU,9,true,34,37,71,164,130,294,12,11,23,4,3:15
492123,2017-09-02,2017,MIN,KCA,17,0,17-0,MIN,9,true,46,33,79,115,211,326,23,7,30,2,3:05
492125,2017-09-02,2017,SDN,LAN,7,2,7-2,SDN,9,true,41,37,78,150,178,328,18,11,29,5,3:40
492111,2017-09-02,2017,HOU,NYN,12,8,12-8,HOU,9,true,45,41,86,178,174,352,20,14,34,3,3:27
492119,2017-09-02,2017,CHN,ATL,14,12,14-12,CHN,9,true,44,48,92,198,161,359,20,22,42,6,3:49
492124,2017-09-02,2017,TEX,ANA,4,7,7-4,ANA,10,false,42,45,87,192,188,380,13,15,28,4,4:09
492111,2017-09-02,2017,HOU,NYN,12,8,12-8,HOU,9,true,45,41,86,178,174,352,20,14,34,3,3:27
492134,2017-09-03,2017,CHN,ATL,1,5,5-1,ATL,9,false,33,38,71,132,121,253,8,12,20,0,2:43
492145,2017-09-03,2017,CHA,TBA,6,2,6-2,CHA,9,true,36,33,69,149,119,268,12,6,18,2,2:50
492146,2017-09-03,2017,BAL,TOR,5,4,5-4,BAL,12,false,52,45,97,166,150,316,20,12,32,3,3:40
492137,2017-09-03,2017,DET,CLE,1,11,11-1,CLE,9,false,32,52,84,213,112,325,10,26,36,4,3:16
492143,2017-09-03,2017,MIA,PHI,1,3,3-1,PHI,12,false,42,48,90,183,174,357,7,14,21,0,3:46
492147,2017-09-03,2017,MIL,WAS,7,2,7-2,MIL,9,true,35,32,67,122,152,274,11,6,17,1,2:49
492142,2017-09-03,2017,SEA,OAK,10,2,10-2,SEA,9,true,45,33,78,153,163,316,24,7,31,3,3:21
492136,2017-09-03,2017,PIT,CIN,3,1,3-1,PIT,9,true,34,38,72,132,131,263,10,14,24,1,2:49
492140,2017-09-03,2017,SDN,LAN,6,4,6-4,SDN,9,true,36,34,70,129,134,263,14,7,21,1,2:51
492141,2017-09-03,2017,HOU,NYN,8,6,8-6,HOU,9,true,38,44,82,170,130,300,15,20,35,3,3:14
492144,2017-09-03,2017,SFN,SLN,3,7,7-3,SLN,9,false,36,40,76,138,142,280,10,14,24,2,2:45
492133,2017-09-03,2017,COL,ARI,1,5,5-1,ARI,9,false,37,37,74,138,149,287,11,9,20,3,3:13
492138,2017-09-03,2017,MIN,KCA,4,5,5-4,KCA,9,false,37,37,74,152,154,306,11,13,24,4,3:18
492139,2017-09-03,2017,TEX,ANA,7,6,7-6,TEX,9,true,39,45,84,186,171,357,17,20,37,3,3:49
492135,2017-09-03,2017,NYA,BOS,9,2,9-2,NYA,9,true,42,36,78,158,192,350,18,7,25,4,3:46
492151,2017-09-04,2017,SEA,HOU,2,6,6-2,HOU,9,false,35,41,76,151,128,279,9,16,25,3,2:53
492159,2017-09-04,2017,SDN,SLN,0,2,2-0,SLN,9,false,33,36,69,129,109,238,6,11,17,0,2:23
492150,2017-09-04,2017,CHA,CLE,3,5,5-3,CLE,9,false,36,38,74,156,140,296,11,14,25,3,3:12
492160,2017-09-04,2017,ATL,TEX,2,8,8-2,TEX,9,false,37,40,77,147,149,296,10,15,25,1,2:50
492156,2017-09-04,2017,BAL,NYA,4,7,7-4,NYA,9,false,36,43,79,186,145,331,9,19,28,4,3:25
492155,2017-09-04,2017,TBA,MIN,11,4,11-4,TBA,9,true,41,36,77,164,143,307,19,9,28,5,3:23
492162,2017-09-04,2017,MIA,WAS,2,7,7-2,WAS,9,false,36,39,75,166,152,318,11,12,23,2,3:10
492161,2017-09-04,2017,BOS,TOR,4,10,10-4,TOR,9,false,41,44,85,173,158,331,13,17,30,5,3:25
492158,2017-09-04,2017,COL,SFN,4,3,4-3,COL,9,false,42,33,75,130,172,302,17,7,24,2,3:14
492153,2017-09-04,2017,OAK,ANA,9,11,11-9,ANA,11,false,49,52,101,210,206,416,20,20,40,7,4:38
492154,2017-09-04,2017,CIN,MIL,5,4,5-4,CIN,9,false,37,34,71,139,137,276,11,9,20,2,3:03
492148,2017-09-04,2017,LAN,ARI,0,13,13-0,ARI,9,false,31,42,73,165,130,295,4,16,20,2,3:00
492149,2017-09-04,2017,PIT,CHN,12,0,12-0,PIT,9,true,43,35,78,140,165,305,20,9,29,2,3:05
492152,2017-09-04,2017,DET,KCA,6,7,7-6,KCA,9,false,43,43,86,140,177,317,16,17,33,1,3:13
492157,2017-09-04,2017,NYN,PHI,11,7,11-7,NYN,9,true,41,40,81,167,148,315,16,15,31,4,3:18
492174,2017-09-05,2017,SDN,SLN,4,8,8-4,SLN,9,false,35,39,74,157,132,289,12,13,25,1,2:47
492172,2017-09-05,2017,NYN,PHI,1,9,9-1,PHI,9,false,36,47,83,176,137,313,10,21,31,1,3:04
492171,2017-09-05,2017,BAL,NYA,7,6,7-6,BAL,9,false,38,42,80,173,155,328,12,15,27,3,3:34 (2:14 delay)
492173,2017-09-05,2017,COL,SFN,9,6,9-6,COL,9,true,39,42,81,171,150,321,15,17,32,8,3:31
492167,2017-09-05,2017,DET,KCA,13,2,13-2,DET,9,true,43,36,79,143,163,306,18,10,28,2,3:00
492169,2017-09-05,2017,CIN,MIL,9,3,9-3,CIN,9,true,39,39,78,174,160,334,16,15,31,4,3:26
492168,2017-09-05,2017,OAK,ANA,7,8,8-7,ANA,10,false,48,46,94,199,169,368,19,17,36,5,4:12
492165,2017-09-05,2017,CHA,CLE,4,9,9-4,CLE,9,false,42,45,87,173,172,345,16,20,36,6,3:43
492164,2017-09-05,2017,PIT,CHN,4,3,4-3,PIT,9,true,32,38,70,135,119,254,11,11,22,1,2:35
492177,2017-09-05,2017,MIA,WAS,1,2,2-1,WAS,9,false,34,36,70,135,144,279,7,11,18,1,2:50
492166,2017-09-05,2017,SEA,HOU,1,3,3-1,HOU,9,false,34,36,70,162,134,296,8,9,17,1,3:07
492176,2017-09-05,2017,BOS,TOR,3,2,3-2,BOS,19,false,68,71,139,287,257,544,16,16,32,2,6:00
492163,2017-09-05,2017,LAN,ARI,1,3,3-1,ARI,10,false,34,43,77,178,142,320,7,14,21,1,3:42
492170,2017-09-05,2017,TBA,MIN,2,1,2-1,TBA,9,true,32,31,63,129,103,232,7,6,13,4,2:32
492187,2017-09-06,2017,NYN,PHI,6,3,6-3,NYN,6,false,27,24,51,86,122,208,11,6,17,0,1:53 (:57 delay)
492184,2017-09-06,2017,CIN,MIL,7,1,7-1,CIN,9,true,37,31,68,124,150,274,16,4,20,4,2:44
492191,2017-09-06,2017,BOS,TOR,6,1,6-1,BOS,9,true,38,35,73,129,154,283,15,7,22,2,2:57
492190,2017-09-06,2017,ATL,TEX,5,4,5-4,ATL,9,true,35,41,76,156,135,291,11,15,26,2,3:03
492185,2017-09-06,2017,TBA,MIN,6,10,10-6,MIN,9,false,37,42,79,169,136,305,13,17,30,6,3:17
492188,2017-09-06,2017,COL,SFN,3,11,11-3,SFN,9,false,37,48,85,175,154,329,10,20,30,2,3:32
492175,2017-09-06,2017,ATL,TEX,8,12,12-8,TEX,9,false,44,44,88,166,177,343,17,18,35,2,3:30
492189,2017-09-06,2017,SDN,SLN,1,3,3-1,SLN,9,false,36,35,71,147,140,287,11,10,21,1,2:58
492178,2017-09-06,2017,LAN,ARI,1,3,3-1,ARI,9,false,33,41,74,161,139,300,8,14,22,1,3:18
492192,2017-09-06,2017,MIA,WAS,1,8,8-1,WAS,9,false,37,41,78,152,165,317,11,18,29,0,3:02
492175,2017-09-06,2017,ATL,TEX,8,12,12-8,TEX,9,false,44,44,88,166,177,343,17,18,35,2,3:30
492181,2017-09-06,2017,SEA,HOU,3,5,5-3,HOU,9,false,35,39,74,129,123,252,9,12,21,4,2:46
492179,2017-09-06,2017,PIT,CHN,0,1,1-0,CHN,9,false,33,34,67,127,150,277,8,8,16,0,3:05
492183,2017-09-06,2017,OAK,ANA,3,1,3-1,OAK,9,true,34,37,71,159,137,296,10,10,20,2,3:10
492182,2017-09-06,2017,DET,KCA,2,13,13-2,KCA,9,false,40,47,87,150,148,298,13,22,35,3,3:27
492180,2017-09-06,2017,CHA,CLE,1,5,5-1,CLE,9,false,28,43,71,168,97,265,3,15,18,2,2:48
492194,2017-09-07,2017,NYN,CIN,7,2,7-2,NYN,9,true,40,34,74,122,148,270,18,8,26,0,2:38
492198,2017-09-07,2017,KCA,MIN,2,4,4-2,MIN,9,false,33,41,74,147,115,262,11,16,27,2,2:56
492199,2017-09-07,2017,WAS,PHI,4,3,4-3,WAS,9,true,36,36,72,141,146,287,14,9,23,1,3:09
492193,2017-09-07,2017,PIT,CHN,2,8,8-2,CHN,9,false,40,42,82,140,173,313,14,16,30,1,3:13 (:52 delay)
492196,2017-09-07,2017,LAN,COL,1,9,9-1,COL,9,false,35,48,83,178,164,342,9,23,32,2,3:35
492195,2017-09-07,2017,CHA,CLE,2,11,11-2,CLE,9,false,31,47,78,182,117,299,5,21,26,1,2:58
492197,2017-09-07,2017,ATL,MIA,6,5,6-5,ATL,9,false,41,41,82,155,167,322,17,16,33,3,3:23
492200,2017-09-07,2017,SDN,SLN,3,0,3-0,SDN,9,true,36,37,73,156,147,303,13,12,25,1,3:03
492186,2017-09-07,2017,BAL,NYA,1,9,9-1,NYA,9,false,35,43,78,190,144,334,9,17,26,2,3:19
492186,2017-09-07,2017,BAL,NYA,1,9,9-1,NYA,9,false,35,43,78,190,144,334,9,17,26,2,3:19
492212,2017-09-08,2017,SLN,PIT,4,1,4-1,SLN,9,true,33,35,68,161,124,285,10,10,20,3,2:58
492209,2017-09-08,2017,KCA,MIN,5,8,8-5,MIN,9,false,35,43,78,165,115,280,10,16,26,4,3:05
492205,2017-09-08,2017,OAK,HOU,9,8,9-8,OAK,9,false,39,41,80,150,132,282,17,17,34,2,3:06
492206,2017-09-08,2017,SEA,ANA,4,3,4-3,SEA,9,true,37,34,71,142,166,308,13,8,21,5,3:09
492210,2017-09-08,2017,TEX,NYA,11,5,11-5,TEX,9,true,41,38,79,155,159,314,18,11,29,5,3:23
492214,2017-09-08,2017,CHA,SFN,2,9,9-2,SFN,9,false,37,42,79,173,128,301,9,15,24,4,3:07
492203,2017-09-08,2017,LAN,COL,4,5,5-4,COL,9,false,41,36,77,161,172,333,14,11,25,1,3:32
492213,2017-09-08,2017,ARI,SDN,6,10,10-6,SDN,9,false,40,44,84,148,172,320,12,21,33,6,3:36
492201,2017-09-08,2017,CLE,BAL,5,0,5-0,CLE,9,true,35,33,68,141,148,289,15,7,22,3,2:41
492202,2017-09-08,2017,NYN,CIN,5,1,5-1,NYN,9,true,34,37,71,137,126,263,12,10,22,2,2:42
492215,2017-09-08,2017,BOS,TBA,9,3,9-3,BOS,9,true,39,37,76,149,157,306,15,10,25,3,3:14
492211,2017-09-08,2017,WAS,PHI,11,10,11-10,WAS,9,true,44,44,88,172,149,321,19,19,38,2,3:27
492204,2017-09-08,2017,TOR,DET,4,5,5-4,DET,9,false,35,35,70,133,125,258,11,8,19,2,2:34
492207,2017-09-08,2017,ATL,MIA,1,7,7-1,MIA,9,false,39,42,81,173,163,336,12,17,29,3,3:16
492208,2017-09-08,2017,CHN,MIL,0,2,2-0,MIL,9,false,35,34,69,132,132,264,9,9,18,1,2:51
490275,2017-09-09,2017,OAK,HOU,11,4,11-4,OAK,9,true,39,37,76,119,143,262,16,11,27,3,2:48
492225,2017-09-09,2017,TEX,NYA,1,3,3-1,NYA,9,false,32,39,71,145,121,266,4,13,17,3,2:57
492216,2017-09-09,2017,CLE,BAL,4,2,4-2,CLE,9,true,35,32,67,132,140,272,11,5,16,4,2:52
492223,2017-09-09,2017,CHN,MIL,2,15,15-2,MIL,9,false,35,49,84,183,144,327,8,22,30,1,3:09
492220,2017-09-09,2017,OAK,HOU,11,1,11-1,OAK,9,true,49,34,83,138,222,360,24,9,33,4,3:42
492227,2017-09-09,2017,SLN,PIT,4,3,4-3,SLN,9,true,33,38,71,156,125,281,9,12,21,0,2:55
490275,2017-09-09,2017,OAK,HOU,11,4,11-4,OAK,9,true,39,37,76,119,143,262,16,11,27,3,2:48
492217,2017-09-09,2017,NYN,CIN,6,1,6-1,NYN,9,true,37,37,74,150,141,291,14,11,25,2,2:56
492230,2017-09-09,2017,BOS,TBA,9,0,9-0,BOS,9,true,44,35,79,123,168,291,21,10,31,1,3:05
492221,2017-09-09,2017,SEA,ANA,8,1,8-1,SEA,9,true,37,36,73,147,156,303,13,10,23,2,3:15
492218,2017-09-09,2017,LAN,COL,5,6,6-5,COL,9,false,37,43,80,153,170,323,9,17,26,0,3:29
492226,2017-09-09,2017,WAS,PHI,4,5,5-4,PHI,9,false,36,40,76,162,143,305,9,14,23,2,3:23
492229,2017-09-09,2017,CHA,SFN,13,1,13-1,CHA,9,true,43,32,75,126,168,294,19,6,25,2,2:52
492222,2017-09-09,2017,ATL,MIA,6,5,6-5,ATL,9,false,46,40,86,154,159,313,21,13,34,2,3:21
492219,2017-09-09,2017,TOR,DET,5,4,5-4,TOR,9,true,39,35,74,137,154,291,19,9,28,3,3:03
492228,2017-09-09,2017,ARI,SDN,7,8,8-7,SDN,9,false,44,40,84,154,186,340,20,13,33,4,3:33
492224,2017-09-09,2017,KCA,MIN,5,2,5-2,KCA,9,true,36,37,73,137,110,247,16,14,30,5,2:51
492242,2017-09-10,2017,SLN,PIT,7,0,7-0,SLN,9,true,36,32,68,108,151,259,12,6,18,0,2:35
492244,2017-09-10,2017,CHA,SFN,8,1,8-1,CHA,9,true,36,34,70,132,140,272,14,8,22,0,2:47
492239,2017-09-10,2017,KCA,MIN,11,3,11-3,KCA,9,true,41,37,78,149,138,287,20,11,31,2,2:55
492241,2017-09-10,2017,WAS,PHI,3,2,3-2,WAS,9,true,31,31,62,125,103,228,8,6,14,0,2:16
492231,2017-09-10,2017,CLE,BAL,3,2,3-2,CLE,9,true,31,32,63,143,117,260,6,7,13,3,2:58
492243,2017-09-10,2017,ARI,SDN,3,2,3-2,ARI,9,true,32,35,67,146,125,271,8,8,16,2,2:58
492235,2017-09-10,2017,OAK,HOU,10,2,10-2,OAK,9,true,46,37,83,158,190,348,22,11,33,5,3:48
492232,2017-09-10,2017,NYN,CIN,5,10,10-5,CIN,9,false,41,45,86,179,176,355,16,19,35,3,3:38
492245,2017-09-10,2017,BOS,TBA,1,4,4-1,TBA,9,false,33,39,72,148,145,293,8,12,20,3,3:22
492236,2017-09-10,2017,SEA,ANA,3,5,5-3,ANA,9,false,34,36,70,142,124,266,9,10,19,3,2:45
492238,2017-09-10,2017,CHN,MIL,1,3,3-1,MIL,9,false,35,38,73,161,123,284,9,11,20,0,2:54
492234,2017-09-10,2017,TOR,DET,8,2,8-2,TOR,9,true,40,35,75,147,155,302,17,9,26,1,2:48
492233,2017-09-10,2017,LAN,COL,1,8,8-1,COL,9,false,37,42,79,172,138,310,11,16,27,2,3:16
492237,2017-09-10,2017,ATL,MIA,10,8,10-8,ATL,11,false,51,51,102,177,173,350,22,19,41,5,3:47
492240,2017-09-10,2017,TEX,NYA,7,16,16-7,NYA,9,false,45,50,95,177,194,371,17,23,40,5,3:43
492246,2017-09-11,2017,TOR,BAL,4,3,4-3,TOR,9,true,35,34,69,147,143,290,11,7,18,2,2:44
492251,2017-09-11,2017,TBA,NYA,1,5,5-1,NYA,9,false,37,38,75,175,158,333,11,10,21,2,3:28
492248,2017-09-11,2017,ARI,COL,4,5,5-4,COL,9,false,39,36,75,132,166,298,14,9,23,6,3:40
492247,2017-09-11,2017,KCA,CHA,3,11,11-3,CHA,9,false,36,49,85,190,128,318,9,21,30,5,3:16
492252,2017-09-11,2017,MIL,PIT,0,7,7-0,PIT,9,false,31,40,71,164,137,301,5,14,19,2,3:03
492250,2017-09-11,2017,SFN,LAN,8,6,8-6,SFN,9,true,37,44,81,158,154,312,14,17,31,6,3:22 (3:34 delay)
492249,2017-09-11,2017,CLE,DET,11,0,11-0,CLE,9,true,44,37,81,131,178,309,18,10,28,1,3:12
492253,2017-09-11,2017,TEX,SEA,5,3,5-3,TEX,9,true,34,37,71,152,140,292,11,9,20,1,2:43
492264,2017-09-12,2017,TBA,NYA,2,1,2-1,TBA,9,true,29,32,61,132,94,226,6,5,11,2,2:36
492265,2017-09-12,2017,BOS,OAK,11,1,11-1,BOS,9,true,40,36,76,167,147,314,17,10,27,2,3:06
492268,2017-09-12,2017,TEX,SEA,3,10,10-3,SEA,9,false,38,46,84,166,120,286,13,19,32,2,3:09
492255,2017-09-12,2017,TOR,BAL,3,2,3-2,TOR,9,false,37,33,70,99,139,238,13,6,19,2,2:40
492259,2017-09-12,2017,CLE,DET,2,0,2-0,CLE,9,true,36,30,66,113,156,269,14,5,19,1,2:41
492258,2017-09-12,2017,ARI,COL,2,4,4-2,COL,9,false,35,39,74,142,122,264,9,13,22,3,2:54
492256,2017-09-12,2017,KCA,CHA,4,3,4-3,KCA,9,true,31,40,71,140,114,254,9,14,23,3,2:42
492257,2017-09-12,2017,SLN,CIN,13,4,13-4,SLN,9,true,48,34,82,121,191,312,23,10,33,1,3:04
492267,2017-09-12,2017,MIN,SDN,16,0,16-0,MIN,9,true,44,33,77,126,187,313,20,6,26,2,2:59
492263,2017-09-12,2017,CHN,NYN,8,3,8-3,CHN,9,true,40,39,79,155,173,328,19,13,32,1,3:16
492262,2017-09-12,2017,PHI,MIA,9,8,9-8,PHI,15,false,68,62,130,217,228,445,29,18,47,3,4:57
492261,2017-09-12,2017,SFN,LAN,3,5,5-3,LAN,9,false,41,45,86,178,148,326,15,20,35,2,3:29
492254,2017-09-12,2017,WAS,ATL,0,8,8-0,ATL,9,false,35,42,77,157,141,298,11,15,26,0,2:57
492260,2017-09-12,2017,ANA,HOU,0,1,1-0,HOU,9,false,29,32,61,121,119,240,4,6,10,0,2:51
492266,2017-09-12,2017,MIL,PIT,5,2,5-2,MIL,9,true,35,36,71,156,128,284,13,9,22,3,3:00
492270,2017-09-13,2017,TOR,BAL,1,2,2-1,BAL,9,false,33,37,70,131,123,254,9,11,20,1,2:40
492275,2017-09-13,2017,ANA,HOU,9,1,9-1,ANA,9,true,39,30,69,106,129,235,15,6,21,1,2:28
492280,2017-09-13,2017,BOS,OAK,3,7,7-3,OAK,9,false,37,37,74,167,146,313,12,11,23,2,3:07 (:19 delay)
492282,2017-09-13,2017,MIN,SDN,3,1,3-1,MIN,10,false,40,39,79,157,144,301,13,10,23,6,3:39
492283,2017-09-13,2017,TEX,SEA,1,8,8-1,SEA,9,false,34,42,76,173,129,302,8,18,26,5,3:08
492281,2017-09-13,2017,MIL,PIT,8,2,8-2,MIL,9,true,41,39,80,136,173,309,20,13,33,3,3:26
492278,2017-09-13,2017,CHN,NYN,17,5,17-5,CHN,9,true,51,41,92,179,190,369,28,16,44,4,3:42
492272,2017-09-13,2017,SLN,CIN,0,6,6-0,CIN,9,false,35,36,71,119,142,261,9,11,20,1,2:40
492276,2017-09-13,2017,SFN,LAN,1,4,4-1,LAN,9,false,30,40,70,153,118,271,5,15,20,1,2:58
492273,2017-09-13,2017,ARI,COL,8,2,8-2,ARI,9,true,41,36,77,136,143,279,18,8,26,4,3:00
492277,2017-09-13,2017,PHI,MIA,8,1,8-1,PHI,9,true,38,34,72,121,113,234,14,7,21,0,2:25
492274,2017-09-13,2017,CLE,DET,5,3,5-3,CLE,9,true,33,37,70,143,152,295,10,9,19,2,2:59
492269,2017-09-13,2017,WAS,ATL,2,8,8-2,ATL,9,false,32,44,76,163,112,275,7,19,26,1,3:08
492271,2017-09-13,2017,KCA,CHA,3,5,5-3,CHA,9,false,40,41,81,162,157,319,14,14,28,4,3:23
492279,2017-09-13,2017,TBA,NYA,2,3,3-2,NYA,9,false,38,41,79,170,167,337,12,15,27,4,3:40
492287,2017-09-14,2017,SLN,CIN,5,2,5-2,SLN,9,true,38,33,71,154,144,298,14,7,21,1,2:50
492288,2017-09-14,2017,ARI,COL,7,0,7-0,ARI,9,true,38,30,68,120,158,278,14,6,20,2,2:53
492292,2017-09-14,2017,CHN,NYN,14,6,14-6,CHN,9,true,41,39,80,146,157,303,16,14,30,2,3:06
492289,2017-09-14,2017,ANA,HOU,2,5,5-2,HOU,9,false,35,38,73,151,142,293,8,12,20,3,3:20
492291,2017-09-14,2017,PHI,MIA,10,0,10-0,PHI,9,true,39,37,76,151,150,301,17,12,29,2,3:06
492295,2017-09-14,2017,MIN,TOR,3,2,3-2,MIN,10,false,41,44,85,161,150,311,15,14,29,6,3:29
492290,2017-09-14,2017,CLE,KCA,3,2,3-2,CLE,10,false,41,37,78,131,175,306,18,10,28,3,3:21
492294,2017-09-14,2017,TEX,SEA,4,10,10-4,SEA,9,false,35,48,83,191,144,335,8,21,29,5,3:21
492285,2017-09-14,2017,NYA,BAL,13,5,13-5,NYA,9,true,43,41,84,141,165,306,20,14,34,2,3:14
492286,2017-09-14,2017,DET,CHA,7,17,17-7,CHA,9,false,40,58,98,213,144,357,13,31,44,4,3:42
492284,2017-09-14,2017,WAS,ATL,5,2,5-2,WAS,9,true,33,34,67,146,133,279,11,7,18,0,2:40 (:30 delay)
492293,2017-09-14,2017,BOS,OAK,6,2,6-2,BOS,9,true,34,39,73,188,119,307,11,15,26,4,3:19
492304,2017-09-15,2017,PHI,OAK,0,4,4-0,OAK,9,false,28,37,65,155,118,273,2,10,12,0,2:43
492297,2017-09-15,2017,NYA,BAL,8,2,8-2,NYA,9,true,37,32,69,118,120,238,14,5,19,3,2:38
492310,2017-09-15,2017,MIN,TOR,3,4,4-3,TOR,9,false,35,40,75,141,128,269,8,14,22,2,2:57
492308,2017-09-15,2017,CHN,SLN,8,2,8-2,CHN,9,true,36,35,71,154,137,291,12,11,23,4,3:07
492303,2017-09-15,2017,ATL,NYN,3,2,3-2,ATL,9,true,34,36,70,140,150,290,13,10,23,4,3:05
492299,2017-09-15,2017,DET,CHA,3,2,3-2,DET,9,false,35,37,72,148,142,290,9,10,19,7,3:18
492300,2017-09-15,2017,CLE,KCA,3,4,4-3,KCA,9,false,37,40,77,146,157,303,12,13,25,3,3:11
492296,2017-09-15,2017,SFN,ARI,2,3,3-2,ARI,9,false,32,32,64,119,127,246,6,6,12,0,2:26
492306,2017-09-15,2017,COL,SDN,6,1,6-1,COL,9,true,34,36,70,149,114,263,13,9,22,3,2:50
492309,2017-09-15,2017,ANA,TEX,7,6,7-6,ANA,9,true,35,35,70,127,140,267,12,9,21,6,3:20
492307,2017-09-15,2017,HOU,SEA,5,2,5-2,HOU,9,true,38,36,74,138,152,290,15,10,25,2,3:12
492302,2017-09-15,2017,MIA,MIL,2,10,10-2,MIL,9,false,34,46,80,190,129,319,7,22,29,3,3:23
492305,2017-09-15,2017,CIN,PIT,4,2,4-2,CIN,9,true,38,38,76,170,146,316,16,12,28,3,3:14
492301,2017-09-15,2017,WAS,LAN,0,7,7-0,LAN,9,false,35,39,74,148,148,296,9,12,21,1,3:09
492298,2017-09-15,2017,TBA,BOS,6,13,13-6,BOS,15,false,64,74,138,275,266,541,22,30,52,7,6:05
492324,2017-09-16,2017,ANA,TEX,2,0,2-0,ANA,9,true,31,31,62,129,118,247,9,5,14,2,2:45
492325,2017-09-16,2017,MIN,TOR,2,7,7-2,TOR,9,false,32,41,73,163,113,276,5,16,21,3,2:50
492321,2017-09-16,2017,COL,SDN,16,0,16-0,COL,9,true,45,32,77,124,183,307,24,6,30,2,3:13
492311,2017-09-16,2017,SFN,ARI,0,2,2-0,ARI,9,false,30,34,64,116,116,232,3,9,12,0,2:32
492317,2017-09-16,2017,MIA,MIL,7,4,7-4,MIA,9,true,36,40,76,168,138,306,13,14,27,3,3:03
492315,2017-09-16,2017,CLE,KCA,8,4,8-4,CLE,9,true,38,36,74,123,124,247,15,11,26,1,2:44
492316,2017-09-16,2017,WAS,LAN,2,3,3-2,LAN,9,false,33,38,71,135,111,246,7,13,20,2,2:46
492319,2017-09-16,2017,PHI,OAK,5,3,5-3,PHI,9,true,36,33,69,124,150,274,12,6,18,3,2:56 (1:46 delay)
492318,2017-09-16,2017,ATL,NYN,3,7,7-3,NYN,9,false,37,38,75,140,140,280,11,14,25,0,2:45
492313,2017-09-16,2017,TBA,BOS,1,3,3-1,BOS,9,false,32,35,67,149,116,265,6,8,14,2,2:44
492320,2017-09-16,2017,CIN,PIT,2,1,2-1,CIN,9,true,28,33,61,122,106,228,6,7,13,2,2:23
492322,2017-09-16,2017,HOU,SEA,8,6,8-6,HOU,9,true,39,39,78,142,159,301,15,13,28,3,3:21
492314,2017-09-16,2017,DET,CHA,4,10,10-4,CHA,9,false,39,48,87,178,129,307,12,23,35,2,3:25
492312,2017-09-16,2017,NYA,BAL,9,3,9-3,NYA,9,true,38,40,78,189,157,346,15,14,29,2,3:37
492323,2017-09-16,2017,CHN,SLN,4,1,4-1,CHN,9,true,40,33,73,128,137,265,17,8,25,3,2:49
492337,2017-09-17,2017,HOU,SEA,7,1,7-1,HOU,9,true,38,32,70,127,142,269,13,7,20,1,2:50
492335,2017-09-17,2017,CIN,PIT,5,2,5-2,CIN,9,true,34,33,67,137,131,268,10,7,17,1,2:39
492330,2017-09-17,2017,CLE,KCA,3,2,3-2,CLE,9,true,32,37,69,147,123,270,6,9,15,3,2:59
492340,2017-09-17,2017,MIN,TOR,13,7,13-7,MIN,9,true,45,39,84,135,181,316,20,12,32,5,3:17
492328,2017-09-17,2017,TBA,BOS,3,2,3-2,TBA,9,true,34,31,65,124,138,262,9,5,14,1,2:37
492339,2017-09-17,2017,ANA,TEX,2,4,4-2,TEX,9,false,34,35,69,145,134,279,11,7,18,3,3:22
492333,2017-09-17,2017,ATL,NYN,1,5,5-1,NYN,9,false,35,39,74,154,146,300,6,13,19,2,2:59
492331,2017-09-17,2017,WAS,LAN,7,1,7-1,WAS,9,true,37,37,74,138,173,311,13,9,22,1,3:22
492327,2017-09-17,2017,NYA,BAL,4,6,6-4,BAL,9,false,39,37,76,136,181,317,12,11,23,2,3:15
492336,2017-09-17,2017,COL,SDN,3,4,4-3,SDN,9,false,37,38,75,127,140,267,11,12,23,4,3:00 (1:23 delay)
492326,2017-09-17,2017,SFN,ARI,7,2,7-2,SFN,9,true,37,34,71,138,142,280,16,8,24,4,2:55
492334,2017-09-17,2017,PHI,OAK,3,6,6-3,OAK,9,false,39,36,75,150,151,301,10,9,19,4,3:09
492329,2017-09-17,2017,DET,CHA,12,0,12-0,DET,9,true,40,29,69,121,148,269,19,2,21,2,2:45
492332,2017-09-17,2017,MIA,MIL,3,10,10-3,MIL,9,false,35,46,81,180,113,293,8,22,30,1,3:11
492338,2017-09-17,2017,CHN,SLN,4,3,4-3,CHN,9,true,40,41,81,164,153,317,17,16,33,3,3:44
492345,2017-09-18,2017,NYA,MIN,2,1,2-1,NYA,9,true,35,33,68,133,139,272,10,7,17,5,3:16
492341,2017-09-18,2017,SDN,ARI,4,2,4-2,SDN,9,true,32,38,70,148,129,277,11,12,23,1,3:02
492346,2017-09-18,2017,MIA,NYN,13,1,13-1,MIA,9,true,48,39,87,185,147,332,25,14,39,3,3:22
492347,2017-09-18,2017,DET,OAK,3,8,8-3,OAK,9,false,39,48,87,177,158,335,13,22,35,4,3:39
492342,2017-09-18,2017,BAL,BOS,8,10,10-8,BOS,11,false,49,49,98,197,186,383,18,18,36,7,4:24
492343,2017-09-18,2017,PHI,LAN,4,3,4-3,PHI,9,true,30,35,65,149,123,272,6,9,15,1,2:40
492344,2017-09-18,2017,PIT,MIL,0,3,3-0,MIL,9,false,33,37,70,153,122,275,8,12,20,2,2:52
492354,2017-09-19,2017,TOR,KCA,5,2,5-2,TOR,9,true,31,33,64,121,118,239,8,8,16,3,2:27
492356,2017-09-19,2017,PIT,MIL,0,1,1-0,MIL,9,false,33,36,69,153,127,280,6,11,17,1,3:04
492355,2017-09-19,2017,PHI,LAN,6,2,6-2,PHI,9,true,36,36,72,116,158,274,13,11,24,2,3:23 (:29 delay)
492357,2017-09-19,2017,NYA,MIN,5,2,5-2,NYA,9,true,43,36,79,120,187,307,19,11,30,3,3:30 (1:05 delay)
492349,2017-09-19,2017,BAL,BOS,0,1,1-0,BOS,11,false,41,40,81,152,173,325,8,9,17,1,3:27
492351,2017-09-19,2017,HOU,CHA,3,1,3-1,HOU,9,true,31,37,68,141,114,255,9,9,18,1,2:47
492360,2017-09-19,2017,CIN,SLN,7,8,8-7,SLN,10,false,43,43,86,170,173,343,15,13,28,5,3:23
492350,2017-09-19,2017,TBA,CHN,1,2,2-1,CHN,9,false,29,33,62,139,121,260,2,7,9,3,2:45
492352,2017-09-19,2017,ANA,CLE,3,6,6-3,CLE,9,false,33,41,74,156,145,301,9,18,27,3,3:20
492362,2017-09-19,2017,ATL,WAS,2,4,4-2,WAS,9,false,34,40,74,139,142,281,7,13,20,1,3:01
492348,2017-09-19,2017,SDN,ARI,6,2,6-2,SDN,9,true,36,31,67,134,141,275,13,6,19,0,2:45
492361,2017-09-19,2017,SEA,TEX,1,3,3-1,TEX,9,false,35,35,70,122,153,275,10,10,20,3,2:54
492353,2017-09-19,2017,SFN,COL,4,3,4-3,SFN,9,false,37,38,75,147,117,264,13,16,29,2,2:57
492358,2017-09-19,2017,MIA,NYN,5,4,5-4,MIA,10,false,41,43,84,149,190,339,15,13,28,1,3:22
492359,2017-09-19,2017,DET,OAK,8,9,9-8,OAK,9,false,48,46,94,192,177,369,24,18,42,7,3:58 (:15 delay)
492366,2017-09-20,2017,HOU,CHA,4,3,4-3,HOU,9,true,36,33,69,146,135,281,13,6,19,4,3:08
492377,2017-09-20,2017,ATL,WAS,3,7,7-3,WAS,9,false,33,40,73,154,137,291,6,15,21,3,2:51
492365,2017-09-20,2017,TBA,CHN,8,1,8-1,TBA,9,true,40,34,74,142,171,313,18,9,27,1,3:04
492369,2017-09-20,2017,TOR,KCA,5,15,15-5,KCA,9,false,37,50,87,172,129,301,9,23,32,2,3:01
492371,2017-09-20,2017,PIT,MIL,6,4,6-4,PIT,9,false,37,39,76,140,159,299,12,16,28,5,3:33
492375,2017-09-20,2017,CIN,SLN,2,9,9-2,SLN,9,false,33,44,77,162,131,293,6,18,24,0,2:47
492373,2017-09-20,2017,MIA,NYN,9,2,9-2,MIA,9,true,41,35,76,129,154,283,17,9,26,1,2:42
492368,2017-09-20,2017,SFN,COL,4,0,4-0,SFN,9,true,36,36,72,134,136,270,13,8,21,5,2:52
492364,2017-09-20,2017,BAL,BOS,0,9,9-0,BOS,9,false,32,44,76,194,133,327,6,18,24,1,3:11
492367,2017-09-20,2017,ANA,CLE,5,6,6-5,CLE,9,false,38,42,80,177,145,322,13,17,30,6,3:40
492374,2017-09-20,2017,DET,OAK,2,3,3-2,OAK,9,false,37,37,74,172,140,312,10,9,19,1,3:07
492370,2017-09-20,2017,PHI,LAN,7,5,7-5,PHI,9,true,34,41,75,176,126,302,10,14,24,4,3:18
492363,2017-09-20,2017,SDN,ARI,7,13,13-7,ARI,9,false,43,44,87,165,162,327,17,17,34,4,3:47
492376,2017-09-20,2017,SEA,TEX,6,8,8-6,TEX,9,false,42,41,83,170,158,328,17,13,30,4,3:27
492372,2017-09-20,2017,NYA,MIN,11,3,11-3,NYA,9,true,43,35,78,155,159,314,19,9,28,2,3:20
492380,2017-09-21,2017,ANA,CLE,1,4,4-1,CLE,9,false,34,34,68,141,144,285,10,8,18,5,3:01
492386,2017-09-21,2017,BAL,TBA,3,1,3-1,BAL,9,true,32,34,66,111,109,220,9,9,18,0,2:28
492381,2017-09-21,2017,SDN,COL,3,0,3-0,SDN,9,true,33,33,66,128,119,247,9,8,17,2,2:46
492382,2017-09-21,2017,TOR,KCA,0,1,1-0,KCA,9,false,31,35,66,140,113,253,5,10,15,4,2:39
492388,2017-09-21,2017,ATL,WAS,3,2,3-2,ATL,9,true,30,30,60,108,106,214,7,4,11,0,2:18
492387,2017-09-21,2017,SEA,TEX,2,4,4-2,TEX,9,false,32,37,69,157,120,277,6,9,15,2,2:45
492379,2017-09-21,2017,HOU,CHA,1,3,3-1,CHA,9,false,34,34,68,147,151,298,9,9,18,4,3:17
492383,2017-09-21,2017,PHI,LAN,4,5,5-4,LAN,9,false,39,40,79,147,167,314,12,12,24,3,3:39
492384,2017-09-21,2017,DET,MIN,1,12,12-1,MIN,9,false,35,50,85,213,143,356,7,24,31,3,3:34
492385,2017-09-21,2017,CIN,SLN,5,8,8-5,SLN,9,false,41,47,88,177,143,320,15,22,37,3,3:12
492378,2017-09-21,2017,MIL,CHN,3,5,5-3,CHN,10,false,45,43,88,147,182,329,17,19,36,4,3:57
492394,2017-09-22,2017,HOU,ANA,3,0,3-0,HOU,9,true,29,30,59,136,125,261,5,5,10,1,3:00
492391,2017-09-22,2017,SEA,CLE,3,1,3-1,SEA,9,false,31,31,62,115,132,247,10,4,14,0,2:23
492402,2017-09-22,2017,OAK,TEX,4,1,4-1,OAK,9,true,33,37,70,134,114,248,9,11,20,2,2:37
492396,2017-09-22,2017,DET,MIN,3,7,7-3,MIN,9,false,33,38,71,143,124,267,8,11,19,1,2:52
492393,2017-09-22,2017,CHA,KCA,7,6,7-6,CHA,9,true,36,38,74,140,144,284,13,12,25,5,3:23
492401,2017-09-22,2017,BAL,TBA,3,8,8-3,TBA,9,false,38,42,80,139,147,286,12,18,30,2,3:07
492392,2017-09-22,2017,SDN,COL,1,4,4-1,COL,9,false,34,36,70,120,143,263,8,10,18,3,2:51
492403,2017-09-22,2017,NYN,WAS,7,6,7-6,NYN,9,true,35,41,76,133,130,263,14,13,27,5,3:02
492399,2017-09-22,2017,LAN,SFN,4,2,4-2,LAN,9,true,33,37,70,148,151,299,9,11,20,1,2:55
492398,2017-09-22,2017,ATL,PHI,7,2,7-2,ATL,9,true,38,37,75,157,150,307,15,11,26,1,2:56
492390,2017-09-22,2017,MIL,CHN,4,5,5-4,CHN,10,false,38,44,82,167,165,332,11,18,29,3,4:03
492397,2017-09-22,2017,TOR,NYA,8,1,8-1,TOR,9,true,35,33,68,118,129,247,10,7,17,2,2:32
492395,2017-09-22,2017,ARI,MIA,13,11,13-11,ARI,9,true,45,46,91,179,169,348,21,20,41,5,3:54
492389,2017-09-22,2017,CIN,BOS,4,5,5-4,BOS,9,false,39,36,75,131,119,250,14,10,24,1,2:45
492400,2017-09-22,2017,PIT,SLN,3,4,4-3,SLN,9,false,35,41,76,153,128,281,7,17,24,1,3:16
492409,2017-09-23,2017,HOU,ANA,6,2,6-2,HOU,9,true,35,33,68,109,112,221,13,8,21,2,2:38
492404,2017-09-23,2017,CIN,BOS,0,5,5-0,BOS,9,false,32,40,72,134,146,280,7,16,23,1,2:51
492407,2017-09-23,2017,SDN,COL,5,0,5-0,SDN,9,true,38,36,74,139,145,284,15,9,24,4,3:11
492411,2017-09-23,2017,DET,MIN,4,10,10-4,MIN,9,false,33,44,77,182,125,307,8,17,25,4,3:12
492408,2017-09-23,2017,CHA,KCA,2,8,8-2,KCA,9,false,37,42,79,169,122,291,11,17,28,4,3:02
492415,2017-09-23,2017,PIT,SLN,11,6,11-6,PIT,9,true,43,39,82,166,162,328,21,12,33,5,3:20
492406,2017-09-23,2017,SEA,CLE,4,11,11-4,CLE,9,false,40,45,85,180,183,363,16,15,31,3,3:32
492417,2017-09-23,2017,OAK,TEX,1,0,1-0,OAK,9,true,30,32,62,136,113,249,6,6,12,2,2:38
492414,2017-09-23,2017,LAN,SFN,1,2,2-1,SFN,9,false,31,38,69,134,122,256,7,11,18,2,2:53
492412,2017-09-23,2017,TOR,NYA,1,5,5-1,NYA,9,false,34,35,69,135,134,269,7,12,19,1,2:54
492413,2017-09-23,2017,ATL,PHI,4,2,4-2,ATL,9,true,38,34,72,126,139,265,16,9,25,1,2:50
492405,2017-09-23,2017,MIL,CHN,4,3,4-3,MIL,10,false,40,40,80,132,161,293,12,14,26,3,3:17
492416,2017-09-23,2017,BAL,TBA,6,9,9-6,TBA,9,false,42,38,80,151,155,306,15,12,27,5,3:34
492418,2017-09-23,2017,NYN,WAS,3,4,4-3,WAS,10,false,40,44,84,192,156,348,10,16,26,2,3:38
492410,2017-09-23,2017,ARI,MIA,6,12,12-6,MIA,9,false,37,50,87,216,151,367,11,21,32,5,3:51
492428,2017-09-24,2017,ATL,PHI,0,2,2-0,PHI,9,false,34,33,67,117,140,257,9,9,18,0,2:38
492429,2017-09-24,2017,LAN,SFN,3,1,3-1,LAN,9,true,33,31,64,101,150,251,10,8,18,1,2:34
492421,2017-09-24,2017,SEA,CLE,2,4,4-2,CLE,9,false,36,37,73,144,138,282,8,10,18,3,2:50
492432,2017-09-24,2017,OAK,TEX,8,1,8-1,OAK,9,true,38,30,68,132,146,278,15,4,19,3,2:45
492423,2017-09-24,2017,CHA,KCA,8,1,8-1,CHA,9,true,38,33,71,133,131,264,13,5,18,1,2:42
492427,2017-09-24,2017,TOR,NYA,9,5,9-5,TOR,9,true,41,39,80,159,158,317,18,13,31,5,3:17
492426,2017-09-24,2017,DET,MIN,4,10,10-4,MIN,9,false,38,43,81,167,143,310,12,18,30,3,3:16
492422,2017-09-24,2017,SDN,COL,4,8,8-4,COL,9,false,35,41,76,156,146,302,11,15,26,3,3:02
492433,2017-09-24,2017,NYN,WAS,2,3,3-2,WAS,9,false,37,33,70,140,148,288,11,6,17,1,3:01
492420,2017-09-24,2017,MIL,CHN,0,5,5-0,CHN,9,false,31,36,67,135,116,251,4,12,16,3,2:53
492419,2017-09-24,2017,CIN,BOS,4,5,5-4,BOS,9,false,36,37,73,161,153,314,12,10,22,4,3:11
492431,2017-09-24,2017,BAL,TBA,9,4,9-4,BAL,9,true,38,38,76,144,148,292,14,11,25,5,3:10
492425,2017-09-24,2017,ARI,MIA,3,2,3-2,ARI,9,false,40,34,74,136,161,297,14,11,25,2,3:10
492430,2017-09-24,2017,PIT,SLN,4,1,4-1,PIT,9,true,35,36,71,160,123,283,12,9,21,2,2:56
492424,2017-09-24,2017,HOU,ANA,5,7,7-5,ANA,9,false,39,44,83,185,141,326,13,16,29,5,3:49
490806,2017-09-25,2017,NYA,KCA,11,3,11-3,NYA,9,true,42,35,77,131,144,275,19,10,29,3,2:51
490390,2017-09-25,2017,NYN,ATL,3,2,3-2,NYN,9,true,35,36,71,140,107,247,13,8,21,3,2:49
492442,2017-09-25,2017,BOS,TOR,4,6,6-4,TOR,9,false,35,37,72,148,134,282,10,14,24,3,2:57
492434,2017-09-25,2017,NYN,ATL,2,9,9-2,ATL,9,false,33,43,76,171,118,289,8,18,26,2,3:03
492435,2017-09-25,2017,SLN,CHN,2,10,10-2,CHN,9,false,35,43,78,165,147,312,9,17,26,2,3:11
492438,2017-09-25,2017,COL,MIA,4,5,5-4,MIA,9,false,37,43,80,168,152,320,12,16,28,5,3:30 (:26 delay)
490390,2017-09-25,2017,NYN,ATL,3,2,3-2,NYN,9,true,35,36,71,140,107,247,13,8,21,3,2:49
492441,2017-09-25,2017,OAK,SEA,1,7,7-1,SEA,9,false,31,37,68,144,110,254,7,11,18,1,2:22
490806,2017-09-25,2017,NYA,KCA,11,3,11-3,NYA,9,true,42,35,77,131,144,275,19,10,29,3,2:51
492437,2017-09-25,2017,CHA,ANA,4,2,4-2,CHA,9,true,34,34,68,137,136,273,9,7,16,3,2:59
492443,2017-09-25,2017,PHI,WAS,1,3,3-1,WAS,9,false,36,37,73,155,149,304,9,10,19,1,3:04
492439,2017-09-25,2017,LAN,SDN,9,3,9-3,LAN,9,true,38,35,73,130,181,311,16,8,24,1,3:06
492440,2017-09-25,2017,ARI,SFN,2,9,9-2,SFN,9,false,35,41,76,149,139,288,11,16,27,2,3:09
492436,2017-09-25,2017,TEX,HOU,2,11,11-2,HOU,9,false,40,45,85,168,176,344,12,17,29,2,3:33
492450,2017-09-26,2017,CHA,ANA,3,9,9-3,ANA,9,false,34,40,74,166,112,278,8,15,23,2,2:57
492453,2017-09-26,2017,LAN,SDN,9,2,9-2,LAN,9,true,44,37,81,122,172,294,21,11,32,0,3:23
492454,2017-09-26,2017,ARI,SFN,11,4,11-4,ARI,9,true,42,40,82,155,186,341,17,14,31,4,3:23
492446,2017-09-26,2017,SLN,CHN,8,7,8-7,SLN,9,true,40,44,84,186,164,350,19,16,35,4,3:46
492448,2017-09-26,2017,KCA,DET,2,1,2-1,KCA,9,true,31,29,60,122,125,247,10,8,18,0,2:31
492451,2017-09-26,2017,COL,MIA,6,0,6-0,COL,9,true,37,30,67,120,129,249,19,5,24,1,2:39
492444,2017-09-26,2017,NYN,ATL,4,3,4-3,NYN,9,false,35,41,76,144,129,273,9,15,24,2,2:57
492457,2017-09-26,2017,BOS,TOR,4,9,9-4,TOR,9,false,35,43,78,162,145,307,8,17,25,3,3:04
492445,2017-09-26,2017,PIT,BAL,10,1,10-1,PIT,9,true,37,34,71,133,145,278,14,7,21,0,2:38
492458,2017-09-26,2017,PHI,WAS,4,1,4-1,PHI,9,true,37,33,70,151,158,309,13,7,20,1,2:59
492455,2017-09-26,2017,OAK,SEA,3,6,6-3,SEA,9,false,35,38,73,134,138,272,9,14,23,3,2:45
492456,2017-09-26,2017,NYA,TBA,6,1,6-1,NYA,9,true,41,35,76,111,175,286,18,8,26,1,3:11
492447,2017-09-26,2017,MIL,CIN,7,6,7-6,MIL,9,true,40,41,81,156,164,320,16,15,31,2,3:19
492452,2017-09-26,2017,CLE,MIN,6,8,8-6,MIN,9,false,39,44,83,165,154,319,13,18,31,7,3:35
492449,2017-09-26,2017,TEX,HOU,3,14,14-3,HOU,9,false,35,50,85,191,155,346,9,24,33,2,3:23
492468,2017-09-27,2017,LAN,SDN,10,0,10-0,LAN,9,true,38,34,72,127,144,271,15,6,21,0,2:42
492470,2017-09-27,2017,OAK,SEA,6,5,6-5,OAK,9,false,35,37,72,140,137,277,11,11,22,2,2:50
492469,2017-09-27,2017,ARI,SFN,4,3,4-3,ARI,9,false,37,35,72,155,142,297,13,8,21,3,3:20
492464,2017-09-27,2017,TEX,HOU,2,12,12-2,HOU,9,false,33,45,78,174,141,315,8,18,26,2,3:17
492466,2017-09-27,2017,COL,MIA,15,9,15-9,COL,9,true,47,41,88,154,171,325,27,14,41,4,3:27
492460,2017-09-27,2017,PIT,BAL,5,3,5-3,PIT,9,true,33,37,70,121,117,238,11,12,23,2,2:34
492467,2017-09-27,2017,CLE,MIN,4,2,4-2,CLE,9,true,39,33,72,131,170,301,16,6,22,6,3:09
492471,2017-09-27,2017,NYA,TBA,6,1,6-1,NYA,9,true,37,33,70,137,163,300,12,7,19,3,3:19
492463,2017-09-27,2017,KCA,DET,7,4,7-4,KCA,9,true,35,41,76,163,125,288,15,14,29,5,3:12
492462,2017-09-27,2017,MIL,CIN,0,6,6-0,CIN,9,false,34,41,75,151,145,296,9,14,23,2,3:09
492461,2017-09-27,2017,SLN,CHN,1,5,5-1,CHN,9,false,34,36,70,113,139,252,8,12,20,4,2:41
492459,2017-09-27,2017,NYN,ATL,7,1,7-1,NYN,9,true,43,36,79,134,179,313,17,9,26,1,3:02
492472,2017-09-27,2017,BOS,TOR,10,7,10-7,BOS,9,true,38,38,76,145,163,308,14,12,26,2,2:57
492465,2017-09-27,2017,CHA,ANA,6,4,6-4,CHA,10,false,41,39,80,152,183,335,14,11,25,4,3:58
492473,2017-09-27,2017,PHI,WAS,7,5,7-5,PHI,9,true,39,43,82,186,165,351,17,20,37,5,3:53
492480,2017-09-28,2017,CLE,MIN,5,2,5-2,CLE,9,true,33,36,69,137,117,254,10,10,20,3,2:38
492481,2017-09-28,2017,TEX,OAK,1,4,4-1,OAK,9,false,37,37,74,144,128,272,10,11,21,2,2:50
492479,2017-09-28,2017,CHA,ANA,5,4,5-4,CHA,9,true,36,35,71,115,168,283,15,9,24,4,3:04
492474,2017-09-28,2017,MIA,ATL,7,1,7-1,MIA,9,true,39,34,73,156,149,305,16,8,24,2,3:06
492475,2017-09-28,2017,SLN,CHN,1,2,2-1,CHN,11,false,41,44,85,164,173,337,10,11,21,0,3:32
492477,2017-09-28,2017,KCA,DET,1,4,4-1,DET,9,false,30,37,67,144,109,253,6,12,18,2,2:44
492476,2017-09-28,2017,MIL,CIN,4,3,4-3,MIL,9,true,35,38,73,138,150,288,13,13,26,4,2:56
492482,2017-09-28,2017,WAS,PIT,5,4,5-4,WAS,9,false,41,34,75,136,162,298,18,8,26,2,3:23
492478,2017-09-28,2017,BOS,HOU,2,12,12-2,HOU,9,false,37,50,87,182,140,322,9,24,33,3,3:31
492483,2017-09-28,2017,NYA,TBA,6,9,9-6,TBA,9,false,38,42,80,164,156,320,13,17,30,3,3:29
492488,2017-09-29,2017,CHN,CIN,5,4,5-4,CHN,9,true,35,36,71,149,130,279,12,11,23,2,2:56
492497,2017-09-29,2017,ANA,SEA,6,5,6-5,ANA,9,true,36,40,76,134,147,281,12,15,27,5,3:01
492498,2017-09-29,2017,NYA,TOR,4,0,4-0,NYA,9,true,32,31,63,135,140,275,10,6,16,2,2:51
492484,2017-09-29,2017,KCA,ARI,2,1,2-1,KCA,9,true,34,35,69,150,135,285,13,10,23,3,2:59
492496,2017-09-29,2017,SFN,SDN,8,0,8-0,SFN,9,true,42,35,77,146,173,319,19,10,29,2,3:09 (:06 delay)
492493,2017-09-29,2017,PHI,NYN,6,2,6-2,PHI,9,true,36,37,73,137,133,270,13,11,24,0,2:38
492492,2017-09-29,2017,SLN,MIL,3,5,5-3,MIL,9,false,32,38,70,150,133,283,7,15,22,2,2:44
492487,2017-09-29,2017,CLE,CHA,10,1,10-1,CLE,9,true,43,33,76,126,170,296,19,5,24,4,2:57
492486,2017-09-29,2017,TBA,BAL,7,0,7-0,TBA,9,true,41,31,72,139,167,306,18,6,24,3,3:06
492490,2017-09-29,2017,BOS,HOU,2,3,3-2,HOU,9,false,34,36,70,129,117,246,9,10,19,3,2:47
492494,2017-09-29,2017,TEX,OAK,5,3,5-3,TEX,9,true,35,37,72,144,138,282,11,11,22,3,2:54
492485,2017-09-29,2017,MIA,ATL,6,5,6-5,MIA,9,true,36,40,76,173,135,308,13,16,29,5,3:08
492495,2017-09-29,2017,WAS,PIT,6,1,6-1,WAS,9,true,34,34,68,120,163,283,14,8,22,4,3:06
492491,2017-09-29,2017,COL,LAN,9,1,9-1,COL,9,true,41,34,75,125,195,320,17,8,25,1,3:19
492489,2017-09-29,2017,MIN,DET,6,3,6-3,MIN,9,true,38,38,76,178,151,329,14,12,26,4,3:29
492513,2017-09-30,2017,NYA,TOR,2,1,2-1,NYA,9,true,33,33,66,135,145,280,11,8,19,4,2:57
492502,2017-09-30,2017,CLE,CHA,1,2,2-1,CHA,9,false,34,35,69,134,150,284,8,10,18,3,3:13
492510,2017-09-30,2017,WAS,PIT,1,4,4-1,PIT,9,false,32,36,68,157,114,271,6,10,16,2,2:56
492505,2017-09-30,2017,BOS,HOU,6,3,6-3,BOS,9,true,37,37,74,143,146,289,15,12,27,4,3:19
492511,2017-09-30,2017,SFN,SDN,2,3,3-2,SDN,9,false,38,36,74,142,146,288,12,9,21,1,3:00
492501,2017-09-30,2017,TBA,BAL,4,3,4-3,TBA,9,true,36,37,73,138,143,281,12,11,23,2,2:45
492504,2017-09-30,2017,MIN,DET,2,3,3-2,DET,9,false,37,34,71,144,143,287,11,6,17,3,2:59
492503,2017-09-30,2017,CHN,CIN,9,0,9-0,CHN,9,true,41,35,76,151,180,331,17,10,27,1,3:04
492507,2017-09-30,2017,SLN,MIL,7,6,7-6,SLN,9,true,34,44,78,168,143,311,13,18,31,4,3:13
492506,2017-09-30,2017,COL,LAN,3,5,5-3,LAN,9,false,38,37,75,123,130,253,12,12,24,4,2:59 (:21 delay)
492500,2017-09-30,2017,MIA,ATL,10,2,10-2,MIA,9,true,46,36,82,135,159,294,27,10,37,1,2:59
492508,2017-09-30,2017,PHI,NYN,4,7,7-4,NYN,11,false,44,51,95,207,209,416,11,22,33,6,4:10
492499,2017-09-30,2017,KCA,ARI,4,3,4-3,KCA,9,true,31,39,70,146,128,274,9,12,21,2,2:44
492509,2017-09-30,2017,TEX,OAK,8,4,8-4,TEX,9,true,39,38,77,154,159,313,18,11,29,3,3:14
492512,2017-09-30,2017,ANA,SEA,4,6,6-4,SEA,9,false,41,40,81,148,170,318,14,15,29,5,3:32
492518,2017-10-01,2017,CHN,CIN,1,3,3-1,CIN,9,false,31,37,68,141,112,253,3,11,14,0,2:30
492527,2017-10-01,2017,ANA,SEA,6,2,6-2,ANA,9,true,36,34,70,116,138,254,11,8,19,2,2:38
492516,2017-10-01,2017,TBA,BAL,6,0,6-0,TBA,9,true,37,31,68,128,147,275,14,3,17,1,2:32
492520,2017-10-01,2017,BOS,HOU,3,4,4-3,HOU,9,false,35,38,73,144,129,273,9,12,21,4,3:09
492522,2017-10-01,2017,SLN,MIL,1,6,6-1,MIL,9,false,33,36,69,132,128,260,5,9,14,0,2:24
492519,2017-10-01,2017,MIN,DET,5,1,5-1,MIN,9,true,35,32,67,120,143,263,11,7,18,3,2:36 (:41 delay)
492517,2017-10-01,2017,CLE,CHA,3,1,3-1,CLE,9,true,35,33,68,117,126,243,11,5,16,4,2:37
492528,2017-10-01,2017,NYA,TOR,1,2,2-1,TOR,9,false,32,31,63,119,136,255,6,4,10,2,2:28
492521,2017-10-01,2017,COL,LAN,3,6,6-3,LAN,9,false,38,46,84,201,152,353,14,19,33,1,3:39
492526,2017-10-01,2017,SFN,SDN,5,4,5-4,SFN,9,false,33,39,72,147,140,287,10,14,24,2,2:55
492524,2017-10-01,2017,TEX,OAK,2,5,5-2,OAK,9,false,35,38,73,138,120,258,9,13,22,1,2:37
492525,2017-10-01,2017,WAS,PIT,8,11,11-8,PIT,9,false,51,48,99,208,224,432,24,23,47,5,4:22
492523,2017-10-01,2017,PHI,NYN,11,0,11-0,PHI,9,true,42,35,77,142,175,317,18,8,26,2,3:09
492515,2017-10-01,2017,MIA,ATL,5,8,8-5,ATL,9,false,39,43,82,174,170,344,12,17,29,4,3:19
492514,2017-10-01,2017,KCA,ARI,2,14,14-2,ARI,9,false,37,52,89,203,128,331,8,24,32,4,3:31