API Key,Date,Year,Home Team,Away Team,Home Score,Away Score,Final Score,Winning Team,# Innings,End Top Inning?,Home Team PA #,Away Team PA #,Total Number PA,Homne Team # Pitches,Away Team # Pitches,Total # Pitches,Home Team Baserunners,Away Team Baserunners,Total # Baserunners,Pitching Changes,Time
565221,2019-05-27,2019,CIN,PIT,8,1,8-1,CIN,9,true,36,36,72,144,147,291,13,10,23,0,2:57
566962,2019-03-28,2019,MIN,CLE,2,0,2-0,MIN,9,true,31,30,61,111,92,203,7,3,10,3,2:18
565229,2019-04-13,2019,CIN,SLN,5,2,5-2,CIN,9,true,34,39,73,169,121,290,10,15,25,6,3:08
566275,2019-03-28,2019,SDN,SFN,2,0,2-0,SDN,9,true,28,31,59,108,102,210,7,6,13,2,2:18
567384,2019-05-19,2019,MIA,NYN,3,0,3-0,MIA,9,true,30,28,58,89,104,193,8,3,11,0,1:59
567362,2019-03-31,2019,MIA,COL,3,0,3-0,MIA,9,true,31,32,63,112,112,224,8,6,14,3,2:32
566864,2019-03-28,2019,TOR,DET,0,2,2-0,DET,10,false,33,37,70,137,108,245,3,9,12,0,2:25
567463,2019-04-13,2019,NYA,CHA,4,0,4-0,NYA,9,true,32,29,61,105,124,229,8,1,9,2,2:28
564835,2019-04-07,2019,ARI,BOS,0,1,1-0,BOS,9,false,31,33,64,113,115,228,4,8,12,0,2:29
567460,2019-04-02,2019,NYA,DET,1,3,3-1,DET,9,false,34,38,72,123,121,244,9,12,21,2,2:41
565136,2019-05-03,2019,CHN,SLN,4,0,4-0,CHN,9,true,35,30,65,81,141,222,13,4,17,1,2:28
566301,2019-05-21,2019,SDN,ARI,3,2,3-2,SDN,9,true,29,32,61,114,111,225,5,5,10,0,2:21
566183,2019-04-05,2019,PIT,CIN,2,0,2-0,PIT,9,true,30,30,60,111,103,214,5,5,10,3,2:25
566086,2019-03-28,2019,OAK,ANA,4,0,4-0,OAK,9,true,32,33,65,118,103,221,8,8,16,0,2:18
566187,2019-04-20,2019,PIT,SFN,3,1,3-1,PIT,5,false,20,20,40,79,78,157,5,5,10,0,1:32 (3:08 delay)
565225,2019-04-03,2019,CIN,MIL,0,1,1-0,MIL,9,false,31,34,65,134,125,259,4,8,12,0,2:33
566664,2019-03-28,2019,TBA,HOU,1,5,5-1,HOU,9,false,34,37,71,145,124,269,7,12,19,0,2:38
566766,2019-04-01,2019,TEX,HOU,1,2,2-1,HOU,9,false,28,37,65,143,113,256,2,12,14,1,2:39
566865,2019-03-29,2019,TOR,DET,6,0,6-0,TOR,9,true,34,31,65,114,138,252,10,4,14,0,2:28
567552,2019-03-28,2019,MIL,SLN,5,4,5-4,MIL,9,true,32,34,66,145,127,272,9,7,16,1,2:36
566089,2019-03-31,2019,OAK,ANA,2,1,2-1,OAK,9,true,34,31,65,113,146,259,11,5,16,2,2:40
567065,2019-04-08,2019,PHI,WAS,4,3,4-3,PHI,9,true,35,33,68,129,116,245,12,7,19,2,2:32
565126,2019-04-11,2019,CHN,PIT,2,0,2-0,CHN,9,true,32,33,65,134,120,254,8,6,14,1,2:38 (1:09 delay)
565127,2019-04-12,2019,CHN,ANA,5,1,5-1,CHN,9,true,35,31,66,116,138,254,11,4,15,1,2:29
564839,2019-04-12,2019,ARI,SDN,1,2,2-1,SDN,9,false,31,34,65,128,141,269,4,7,11,2,2:38
566667,2019-03-31,2019,TBA,HOU,3,1,3-1,TBA,9,true,32,29,61,120,110,230,8,4,12,2,2:12
565895,2019-03-28,2019,WAS,NYN,0,2,2-0,NYN,9,false,33,34,67,135,139,274,7,8,15,2,2:44
566278,2019-03-31,2019,SDN,SFN,3,1,3-1,SDN,9,true,37,29,66,129,124,253,15,4,19,1,2:47
566668,2019-04-01,2019,TBA,COL,7,1,7-1,TBA,9,true,37,34,71,133,137,270,13,8,21,5,2:54
566665,2019-03-29,2019,TBA,HOU,4,2,4-2,TBA,9,true,32,36,68,130,133,263,7,11,18,1,2:38
567371,2019-04-17,2019,MIA,CHN,0,6,6-0,CHN,9,false,31,35,66,125,130,255,5,9,14,0,2:25
565220,2019-03-28,2019,CIN,PIT,5,3,5-3,CIN,9,true,34,39,73,167,115,282,9,12,21,5,2:54
566476,2019-04-10,2019,SFN,SDN,1,3,3-1,SDN,9,false,35,35,70,128,114,242,8,9,17,2,2:37
567459,2019-04-01,2019,NYA,DET,3,1,3-1,NYA,9,true,33,36,69,137,134,271,9,9,18,1,2:43
564738,2019-04-08,2019,ANA,MIL,5,2,5-2,ANA,9,true,32,34,66,137,125,262,10,8,18,2,2:40
566570,2019-04-08,2019,SLN,LAN,4,3,4-3,SLN,9,true,30,36,66,132,111,243,7,11,18,2,2:41
566090,2019-04-01,2019,OAK,BOS,7,0,7-0,OAK,9,true,36,31,67,136,126,262,11,6,17,1,2:42
566975,2019-04-29,2019,MIN,HOU,1,0,1-0,MIN,9,true,29,33,62,117,116,233,5,7,12,0,2:31
566567,2019-04-05,2019,SLN,SDN,3,5,5-3,SDN,9,false,33,42,75,170,121,291,6,15,21,0,2:54
566182,2019-04-04,2019,PIT,CIN,2,0,2-0,PIT,9,true,32,37,69,143,116,259,10,11,21,2,2:40
564755,2019-05-18,2019,ANA,KCA,6,3,6-3,ANA,9,true,34,36,70,134,123,257,11,10,21,1,2:42
565512,2019-04-07,2019,DET,KCA,3,1,3-1,DET,9,true,33,33,66,127,146,273,10,9,19,0,2:24
566480,2019-04-14,2019,SFN,COL,0,4,4-0,COL,9,false,29,35,64,145,105,250,2,9,11,0,2:25
566872,2019-04-13,2019,TOR,TBA,3,1,3-1,TOR,9,true,31,34,65,117,134,251,8,10,18,2,2:44
566102,2019-05-07,2019,OAK,CIN,2,0,2-0,OAK,9,true,30,29,59,131,128,259,6,2,8,1,2:25 (1:38 delay)
566988,2019-05-27,2019,MIN,MIL,4,5,5-4,MIL,9,false,41,35,76,140,179,319,14,8,22,2,3:12
566087,2019-03-29,2019,OAK,ANA,2,6,6-2,ANA,9,false,36,39,75,136,139,275,11,15,26,2,2:52
567359,2019-03-28,2019,MIA,COL,3,6,6-3,COL,9,false,34,39,73,149,121,270,6,12,18,1,2:55
566666,2019-03-30,2019,TBA,HOU,3,1,3-1,TBA,9,true,32,36,68,132,123,255,8,11,19,1,2:40
567063,2019-04-06,2019,PHI,MIN,2,6,6-2,MIN,9,false,36,39,75,118,136,254,10,14,24,2,2:50
565240,2019-05-16,2019,CIN,CHN,4,2,4-2,CIN,9,true,38,32,70,127,123,250,15,5,20,1,2:36 (1:51 delay)
567187,2019-05-19,2019,ATL,MIL,2,3,3-2,MIL,10,false,34,37,71,135,117,252,5,9,14,1,2:44
567173,2019-04-29,2019,ATL,SDN,3,1,3-1,ATL,9,true,36,33,69,119,135,254,10,7,17,2,2:33
565327,2019-05-03,2019,CLE,SEA,2,1,2-1,CLE,9,false,32,36,68,147,120,267,7,10,17,2,2:46
565618,2019-04-28,2019,HOU,CLE,4,1,4-1,HOU,9,true,34,37,71,144,110,254,11,10,21,3,2:48
567292,2019-05-31,2019,CHA,CLE,6,1,6-1,CHA,9,true,39,36,75,131,119,250,12,10,22,0,2:41
566091,2019-04-02,2019,OAK,BOS,1,0,1-0,OAK,9,true,30,34,64,123,117,240,7,8,15,0,2:42
566768,2019-04-03,2019,TEX,HOU,4,0,4-0,TEX,9,true,33,34,67,120,142,262,9,8,17,0,2:39
565720,2019-05-02,2019,KCA,TBA,1,3,3-1,TBA,9,false,33,34,67,142,132,274,6,9,15,3,2:33
566964,2019-03-31,2019,MIN,CLE,9,3,9-3,MIN,9,true,39,37,76,155,109,264,18,12,30,2,2:39
565799,2019-03-28,2019,LAN,ARI,12,5,12-5,LAN,9,true,39,35,74,125,144,269,15,9,24,1,2:49
565702,2019-03-28,2019,KCA,CHA,5,3,5-3,KCA,9,true,36,36,72,136,156,292,9,9,18,5,3:12 (1:46 delay)
565804,2019-04-02,2019,LAN,SFN,6,5,6-5,LAN,9,true,34,36,70,131,134,265,11,11,22,1,2:50
565510,2019-04-04,2019,DET,KCA,5,4,5-4,DET,9,true,37,37,74,126,147,273,13,10,23,1,2:47
566088,2019-03-30,2019,OAK,ANA,4,2,4-2,OAK,9,true,34,36,70,146,123,269,10,8,18,3,2:42
566107,2019-05-12,2019,OAK,CLE,3,5,5-3,CLE,9,false,35,36,71,136,138,274,10,12,22,1,2:57
566585,2019-05-08,2019,SLN,PHI,0,5,5-0,PHI,9,false,31,38,69,151,119,270,6,10,16,0,2:41
565533,2019-05-18,2019,DET,OAK,1,4,4-1,OAK,9,false,33,34,67,141,117,258,7,8,15,2,2:40
566400,2019-05-31,2019,SEA,ANA,4,3,4-3,SEA,9,true,29,35,64,149,114,263,6,9,15,2,2:35
567566,2019-04-29,2019,MIL,COL,5,1,5-1,MIL,9,true,34,35,69,136,107,243,10,7,17,3,2:38
566295,2019-05-08,2019,SDN,NYN,3,2,3-2,SDN,9,true,30,35,65,137,124,261,6,9,15,1,2:44
566593,2019-05-25,2019,SLN,ATL,6,3,6-3,SLN,9,true,35,35,70,120,116,236,11,12,23,1,2:40
564740,2019-04-10,2019,ANA,MIL,4,2,4-2,ANA,9,true,30,37,67,145,126,271,7,12,19,2,3:00
565635,2019-05-29,2019,HOU,CHN,1,2,2-1,CHN,9,false,34,35,69,135,120,255,7,10,17,0,2:37
566014,2019-05-26,2019,NYN,DET,4,3,4-3,NYN,9,true,32,35,67,143,107,250,10,8,18,2,2:33
565803,2019-04-01,2019,LAN,SFN,2,4,4-2,SFN,9,false,34,37,71,145,136,281,9,10,19,2,2:59
565227,2019-04-10,2019,CIN,MIA,2,1,2-1,CIN,9,true,30,34,64,155,138,293,8,8,16,1,2:47
567360,2019-03-29,2019,MIA,COL,1,6,6-1,COL,9,false,31,42,73,147,135,282,6,15,21,2,3:04
565704,2019-03-31,2019,KCA,CHA,3,6,6-3,CHA,9,false,34,41,75,155,125,280,7,16,23,3,2:57
566889,2019-05-24,2019,TOR,SDN,3,6,6-3,SDN,9,false,32,38,70,162,122,284,5,11,16,1,2:49
566869,2019-04-02,2019,TOR,BAL,1,2,2-1,BAL,9,false,35,36,71,152,127,279,10,13,23,1,2:45
566109,2019-05-25,2019,OAK,SEA,6,5,6-5,OAK,9,true,35,36,71,139,133,272,13,9,22,1,2:52
566970,2019-04-17,2019,MIN,TOR,4,1,4-1,MIN,9,true,35,34,69,141,140,281,13,9,22,2,2:57
567072,2019-04-26,2019,PHI,MIA,4,0,4-0,PHI,9,true,34,33,67,129,151,280,12,7,19,2,2:47 (1:33 delay)
566198,2019-05-21,2019,PIT,COL,0,5,5-0,COL,9,false,33,40,73,146,124,270,5,14,19,0,2:41
566492,2019-05-20,2019,SFN,ATL,1,4,4-1,ATL,9,false,29,38,67,161,114,275,2,12,14,0,2:23
566473,2019-04-07,2019,SFN,TBA,0,3,3-0,TBA,9,false,32,39,71,153,130,283,7,13,20,4,3:06
565821,2019-05-12,2019,LAN,WAS,6,0,6-0,LAN,9,true,36,29,65,130,148,278,13,2,15,1,2:46
567162,2019-04-07,2019,ATL,MIA,4,3,4-3,ATL,9,false,33,35,68,127,124,251,10,9,19,1,2:33
566963,2019-03-30,2019,MIN,CLE,1,2,2-1,CLE,9,false,32,34,66,141,136,277,7,7,14,2,3:00
567386,2019-05-29,2019,MIA,SFN,4,2,4-2,MIA,9,true,35,35,70,137,108,245,14,8,22,1,2:38
566870,2019-04-03,2019,TOR,BAL,5,3,5-3,TOR,9,true,33,33,66,142,123,265,12,8,20,2,2:42
564753,2019-05-05,2019,ANA,HOU,4,10,10-4,HOU,9,false,34,42,76,139,127,266,7,17,24,2,3:04
566277,2019-03-30,2019,SDN,SFN,2,3,3-2,SFN,9,false,35,39,74,152,134,286,8,14,22,4,3:10
565416,2019-04-08,2019,COL,ATL,6,8,8-6,ATL,9,false,37,42,79,156,121,277,11,17,28,3,2:59
567555,2019-03-31,2019,MIL,SLN,5,4,5-4,MIL,9,false,38,36,74,140,149,289,16,9,25,2,2:54
565242,2019-05-18,2019,CIN,LAN,4,0,4-0,CIN,9,true,33,36,69,144,126,270,8,9,17,0,2:39
566572,2019-04-10,2019,SLN,LAN,7,2,7-2,SLN,9,true,34,33,67,148,118,266,11,7,18,2,2:52
565902,2019-04-14,2019,WAS,PIT,3,4,4-3,PIT,9,false,39,36,75,121,143,264,14,12,26,0,2:47
566281,2019-04-03,2019,SDN,ARI,4,1,4-1,SDN,9,true,34,34,68,138,125,263,11,8,19,1,2:59
564735,2019-04-05,2019,ANA,TEX,3,1,3-1,ANA,9,true,30,35,65,155,120,275,7,9,16,1,2:52
566685,2019-05-12,2019,TBA,NYA,1,7,7-1,NYA,9,false,34,41,75,165,104,269,7,15,22,1,2:55 (:43 delay)
566188,2019-04-21,2019,PIT,SFN,2,3,3-2,SFN,9,false,34,39,73,146,133,279,8,13,21,1,2:47
566987,2019-05-26,2019,MIN,CHA,7,0,7-0,MIN,9,true,32,35,67,158,126,284,8,8,16,2,2:55
567061,2019-03-31,2019,PHI,ATL,5,1,5-1,PHI,9,true,39,36,75,141,156,297,16,11,27,2,3:17
567558,2019-04-07,2019,MIL,CHN,4,2,4-2,MIL,9,true,39,36,75,145,142,287,15,9,24,4,3:04
566279,2019-04-01,2019,SDN,ARI,3,10,10-3,ARI,9,false,34,45,79,161,121,282,8,19,27,1,3:04
564935,2019-04-10,2019,BAL,OAK,3,10,10-3,OAK,9,false,34,42,76,168,129,297,7,16,23,1,2:35
565607,2019-04-06,2019,HOU,OAK,6,0,6-0,HOU,9,true,36,36,72,150,144,294,13,10,23,1,2:47
566486,2019-05-01,2019,SFN,LAN,2,1,2-1,SFN,9,false,31,36,67,165,123,288,7,8,15,1,3:01
564934,2019-04-09,2019,BAL,OAK,2,13,13-2,OAK,9,false,33,45,78,175,113,288,8,18,26,3,2:53
565723,2019-05-12,2019,KCA,PHI,1,6,6-1,PHI,9,false,35,41,76,149,122,271,8,14,22,2,2:37
566868,2019-04-01,2019,TOR,BAL,5,6,6-5,BAL,9,false,34,38,72,156,126,282,8,11,19,2,2:46
567486,2019-05-29,2019,NYA,SDN,7,0,7-0,NYA,9,true,38,34,72,134,155,289,13,7,20,1,2:39
565827,2019-05-30,2019,LAN,NYN,2,0,2-0,LAN,9,true,34,33,67,126,126,252,12,6,18,2,2:47
567564,2019-04-20,2019,MIL,LAN,5,0,5-0,MIL,9,true,34,34,68,155,125,280,11,7,18,2,2:51
567064,2019-04-07,2019,PHI,MIN,2,1,2-1,PHI,9,true,32,33,65,134,133,267,8,7,15,2,2:47
567288,2019-05-27,2019,CHA,KCA,2,1,2-1,CHA,9,false,35,32,67,111,149,260,14,7,21,3,2:56 (3:04 delay)
565241,2019-05-17,2019,CIN,LAN,0,6,6-0,LAN,9,false,30,38,68,121,127,248,4,13,17,0,2:24
565221,2019-05-27,2019,CIN,PIT,8,1,8-1,CIN,9,true,36,36,72,144,147,291,13,10,23,0,2:57
565703,2019-03-30,2019,KCA,CHA,8,6,8-6,KCA,9,true,39,38,77,154,153,307,16,12,28,4,3:16 (:30 delay)
564936,2019-04-11,2019,BAL,OAK,5,8,8-5,OAK,9,false,38,40,78,146,141,287,10,13,23,4,2:50
567269,2019-04-15,2019,CHA,KCA,5,4,5-4,CHA,9,true,37,37,74,148,136,284,14,13,27,0,3:02
565224,2019-04-02,2019,CIN,MIL,3,4,4-3,MIL,9,false,36,40,76,151,141,292,9,15,24,3,3:07
566567,2019-04-05,2019,SLN,SDN,3,5,5-3,SDN,9,false,33,42,75,170,121,291,6,15,21,0,2:54
566776,2019-04-20,2019,TEX,HOU,9,4,9-4,TEX,9,true,38,38,76,124,165,289,14,13,27,2,2:51
564834,2019-04-06,2019,ARI,BOS,5,4,5-4,ARI,9,false,35,38,73,152,125,277,12,13,25,2,3:19
565513,2019-04-09,2019,DET,CLE,2,8,8-2,CLE,9,false,37,37,74,143,129,272,9,12,21,1,2:32
565610,2019-04-09,2019,HOU,NYA,6,3,6-3,HOU,9,true,40,34,74,131,163,294,16,8,24,3,3:15
566787,2019-05-21,2019,TEX,SEA,5,3,5-3,TEX,9,true,37,33,70,145,157,302,13,7,20,1,2:56
565632,2019-05-26,2019,HOU,BOS,1,4,4-1,BOS,9,false,33,37,70,137,147,284,7,8,15,0,3:06
565316,2019-04-01,2019,CLE,CHA,5,3,5-3,CLE,9,true,37,36,73,148,127,275,14,8,22,4,3:02
565029,2019-04-12,2019,BOS,BAL,6,4,6-4,BOS,9,true,36,34,70,139,129,268,12,6,18,5,2:55
566286,2019-04-20,2019,SDN,CIN,2,4,4-2,CIN,9,false,36,37,73,154,139,293,10,11,21,2,3:04
564957,2019-05-28,2019,BAL,DET,0,3,3-0,DET,9,false,35,37,72,131,160,291,9,10,19,2,3:00
565912,2019-05-02,2019,WAS,SLN,2,1,2-1,WAS,9,true,31,38,69,159,122,281,7,12,19,3,3:00 (2:32 delay)
566185,2019-04-07,2019,PIT,CIN,7,5,7-5,PIT,9,true,38,36,74,142,123,265,19,10,29,2,2:54
565994,2019-04-10,2019,NYN,MIN,9,6,9-6,NYN,9,true,39,36,75,134,162,296,16,10,26,3,3:15
565620,2019-05-07,2019,HOU,KCA,2,12,12-2,KCA,9,false,35,45,80,152,126,278,11,18,29,2,2:45
566474,2019-04-08,2019,SFN,SDN,5,6,6-5,SDN,9,false,38,37,75,129,141,270,11,11,22,1,2:55
567087,2019-05-28,2019,PHI,SLN,4,3,4-3,PHI,9,true,31,34,65,169,115,284,8,7,15,1,2:28 (:50 delay)
567363,2019-04-01,2019,MIA,NYN,3,7,7-3,NYN,9,false,36,40,76,166,135,301,10,14,24,1,3:10
566373,2019-03-29,2019,SEA,BOS,6,7,7-6,BOS,9,false,40,38,78,149,146,295,12,12,24,3,3:20
565317,2019-04-03,2019,CLE,CHA,3,8,8-3,CHA,9,false,35,44,79,159,147,306,6,17,23,1,3:01
567263,2019-04-05,2019,CHA,SEA,10,8,10-8,CHA,9,true,40,41,81,162,165,327,15,14,29,4,3:36
567059,2019-03-28,2019,PHI,ATL,10,4,10-4,PHI,9,true,37,36,73,156,148,304,15,13,28,1,3:04
566299,2019-05-19,2019,SDN,PIT,4,6,6-4,PIT,9,false,33,39,72,152,127,279,8,13,21,2,2:56
565518,2019-04-18,2019,DET,CHA,9,7,9-7,DET,9,true,40,42,82,157,130,287,19,12,31,4,3:10
566866,2019-03-30,2019,TOR,DET,3,0,3-0,TOR,9,true,35,36,71,164,135,299,12,10,22,4,3:00
566888,2019-05-23,2019,TOR,BOS,2,8,8-2,BOS,9,false,33,44,77,157,134,291,6,18,24,1,3:01
567554,2019-03-30,2019,MIL,SLN,4,2,4-2,MIL,9,true,38,35,73,145,147,292,14,8,22,2,3:07
567366,2019-04-12,2019,MIA,PHI,1,9,9-1,PHI,9,false,33,44,77,150,133,283,8,19,27,0,2:46
566669,2019-04-02,2019,TBA,COL,4,0,4-0,TBA,9,true,40,29,69,127,171,298,15,4,19,1,2:50
567361,2019-03-30,2019,MIA,COL,7,3,7-3,MIA,9,true,40,36,76,147,139,286,17,9,26,3,3:00
565609,2019-04-08,2019,HOU,NYA,4,3,4-3,HOU,9,true,34,38,72,150,124,274,11,11,22,1,2:59
565809,2019-04-15,2019,LAN,CIN,4,3,4-3,LAN,9,false,37,32,69,121,146,267,12,7,19,1,2:49
564836,2019-04-09,2019,ARI,TEX,5,4,5-4,ARI,9,false,35,37,72,133,127,260,11,9,20,1,2:48
566475,2019-04-09,2019,SFN,SDN,7,2,7-2,SFN,9,true,34,33,67,147,138,285,10,9,19,0,2:39
565032,2019-04-15,2019,BOS,BAL,1,8,8-1,BAL,9,false,32,41,73,172,134,306,7,17,24,2,3:17
566569,2019-04-07,2019,SLN,SDN,4,1,4-1,SLN,9,true,36,34,70,149,150,299,13,8,21,3,3:08
566377,2019-04-02,2019,SEA,ANA,2,1,2-1,SEA,9,true,29,32,61,109,110,219,5,5,10,1,2:16
566965,2019-05-11,2019,MIN,DET,8,3,8-3,MIN,9,true,42,36,78,132,160,292,18,10,28,1,2:45
566689,2019-05-28,2019,TBA,TOR,3,1,3-1,TBA,9,true,35,35,70,127,145,272,12,8,20,2,2:49
566276,2019-03-29,2019,SDN,SFN,4,1,4-1,SDN,9,true,34,37,71,149,142,291,13,10,23,3,3:07
566966,2019-04-13,2019,MIN,DET,4,3,4-3,MIN,9,true,34,37,71,149,143,292,12,11,23,2,3:07
567471,2019-05-03,2019,NYA,MIN,6,3,6-3,NYA,9,true,34,35,69,164,145,309,12,8,20,0,3:08
566011,2019-05-23,2019,NYN,WAS,6,4,6-4,NYN,9,true,34,40,74,150,125,275,12,17,29,0,2:53
565606,2019-04-05,2019,HOU,OAK,3,2,3-2,HOU,9,true,36,36,72,137,150,287,13,10,23,0,3:03
566489,2019-05-12,2019,SFN,CIN,6,5,6-5,SFN,9,true,35,39,74,172,120,292,11,13,24,2,3:01
565515,2019-04-11,2019,DET,CLE,0,4,4-0,CLE,9,false,32,41,73,180,118,298,4,17,21,0,2:47
567484,2019-05-27,2019,NYA,SDN,5,2,5-2,NYA,9,true,35,33,68,124,132,256,11,7,18,1,2:40
567290,2019-05-29,2019,CHA,KCA,8,7,8-7,CHA,9,true,35,42,77,160,126,286,12,18,30,3,3:03
566396,2019-05-27,2019,SEA,TEX,6,2,6-2,SEA,9,true,39,34,73,134,171,305,15,7,22,3,3:14
565897,2019-03-31,2019,WAS,NYN,6,5,6-5,WAS,9,false,38,41,79,152,165,317,13,15,28,4,3:15
564933,2019-04-08,2019,BAL,OAK,12,4,12-4,BAL,9,true,42,39,81,143,163,306,18,13,31,3,3:07
567469,2019-04-20,2019,NYA,KCA,9,2,9-2,NYA,9,true,42,35,77,132,173,305,18,10,28,0,3:00
567088,2019-05-29,2019,PHI,SLN,11,4,11-4,PHI,9,true,44,38,82,137,152,289,21,11,32,3,3:01 (1:39 delay)
564760,2019-05-24,2019,ANA,TEX,3,4,4-3,TEX,9,false,38,40,78,174,132,306,12,12,24,0,3:13
567476,2019-05-08,2019,NYA,SEA,1,10,10-1,SEA,9,false,32,45,77,179,116,295,6,19,25,1,3:07
566008,2019-05-20,2019,NYN,WAS,5,3,5-3,NYN,9,true,37,38,75,150,152,302,14,13,27,3,3:12
565330,2019-05-06,2019,CLE,CHA,1,9,9-1,CHA,9,false,39,40,79,149,141,290,13,15,28,2,3:01
565633,2019-05-27,2019,HOU,CHN,6,5,6-5,HOU,9,true,38,38,76,157,159,316,14,11,25,2,3:12
567456,2019-03-28,2019,NYA,BAL,7,2,7-2,NYA,9,true,39,35,74,135,164,299,18,9,27,2,3:06
564943,2019-05-03,2019,BAL,TBA,0,7,7-0,TBA,9,false,31,43,74,158,114,272,5,19,24,1,2:38
565828,2019-05-31,2019,LAN,PHI,6,3,6-3,LAN,9,true,36,35,71,139,137,276,13,8,21,1,2:59
565537,2019-05-23,2019,DET,MIA,2,5,5-2,MIA,9,false,35,39,74,143,135,278,13,12,25,2,2:58
567291,2019-05-30,2019,CHA,CLE,10,4,10-4,CHA,9,true,39,38,77,152,137,289,16,13,29,3,3:10
565514,2019-04-10,2019,DET,CLE,4,1,4-1,DET,9,true,38,37,75,151,168,319,14,11,25,3,3:14
567184,2019-05-16,2019,ATL,SLN,10,2,10-2,ATL,9,true,42,35,77,148,153,301,22,10,32,3,3:16
565230,2019-04-14,2019,CIN,SLN,5,9,9-5,SLN,9,false,39,43,82,170,133,303,14,18,32,5,3:19
567286,2019-05-18,2019,CHA,TOR,4,1,4-1,CHA,5,true,20,19,39,78,74,152,8,5,13,0,1:31 (3:00 delay)
566372,2019-03-28,2019,SEA,BOS,12,4,12-4,SEA,9,true,43,40,83,142,187,329,18,12,30,2,3:34
565339,2019-05-21,2019,CLE,OAK,3,5,5-3,OAK,9,false,37,40,77,168,157,325,11,14,25,4,3:22
567164,2019-04-12,2019,ATL,NYN,2,6,6-2,NYN,9,false,37,43,80,156,153,309,10,17,27,1,3:07
565027,2019-04-09,2019,BOS,TOR,5,7,7-5,TOR,9,false,38,40,78,164,160,324,11,13,24,4,3:36
564938,2019-04-20,2019,BAL,MIN,5,6,6-5,MIN,9,false,42,40,82,153,151,304,17,13,30,1,3:16
566876,2019-04-26,2019,TOR,OAK,4,2,4-2,TOR,9,false,35,34,69,132,136,268,9,7,16,1,2:50
565516,2019-04-16,2019,DET,PIT,3,5,5-3,PIT,10,false,39,39,78,147,162,309,10,9,19,1,3:03
566479,2019-04-13,2019,SFN,COL,5,2,5-2,SFN,9,true,38,32,70,130,115,245,14,6,20,2,2:48
565335,2019-05-17,2019,CLE,BAL,1,5,5-1,BAL,9,false,36,36,72,140,158,298,7,11,18,4,2:54
566097,2019-04-20,2019,OAK,TOR,1,10,10-1,TOR,9,false,34,46,80,165,129,294,8,19,27,1,3:05
567163,2019-04-11,2019,ATL,NYN,3,6,6-3,NYN,9,false,39,41,80,166,164,330,12,14,26,3,3:14
566280,2019-04-02,2019,SDN,ARI,5,8,8-5,ARI,9,false,39,45,84,150,159,309,12,18,30,1,3:21
565124,2019-04-08,2019,CHN,PIT,10,0,10-0,CHN,9,true,40,36,76,158,173,331,14,11,25,1,3:12
565708,2019-04-09,2019,KCA,SEA,3,6,6-3,SEA,9,false,38,43,81,171,137,308,11,16,27,2,3:17
565608,2019-04-07,2019,HOU,OAK,9,8,9-8,HOU,9,false,47,40,87,148,170,318,23,14,37,2,3:39
564850,2019-05-12,2019,ARI,ATL,3,5,5-3,ATL,9,false,41,39,80,149,163,312,15,14,29,2,3:21
565904,2019-04-17,2019,WAS,SFN,9,6,9-6,WAS,9,true,40,42,82,142,144,286,18,16,34,5,3:07
567373,2019-04-20,2019,MIA,WAS,9,3,9-3,MIA,9,true,41,39,80,138,167,305,16,14,30,1,3:12
566374,2019-03-30,2019,SEA,BOS,6,5,6-5,SEA,9,true,38,41,79,145,167,312,14,12,26,2,3:10
567367,2019-04-13,2019,MIA,PHI,10,3,10-3,MIA,9,true,41,37,78,158,149,307,18,10,28,0,3:01
565226,2019-04-09,2019,CIN,MIA,14,0,14-0,CIN,9,true,45,31,76,127,176,303,24,6,30,0,2:47
566763,2019-03-28,2019,TEX,CHN,4,12,12-4,CHN,9,false,34,46,80,177,132,309,8,22,30,5,3:07
565436,2019-05-25,2019,COL,BAL,6,9,9-6,BAL,9,false,38,43,81,159,150,309,11,20,31,1,3:12
566784,2019-05-18,2019,TEX,SLN,2,8,8-2,SLN,9,false,35,44,79,174,136,310,9,16,25,3,3:14 (2:11 delay)
565040,2019-04-29,2019,BOS,OAK,9,4,9-4,BOS,9,true,41,40,81,160,137,297,18,15,33,4,3:23
567159,2019-04-04,2019,ATL,CHN,9,4,9-4,ATL,9,true,42,37,79,155,170,325,20,10,30,3,3:29
565418,2019-08-26,2019,COL,ATL,3,1,3-1,COL,9,false,32,37,69,165,144,309,10,12,22,1,3:27
567169,2019-04-18,2019,ATL,ARI,1,4,4-1,ARI,9,false,37,44,81,156,161,317,10,16,26,2,3:25
567060,2019-03-30,2019,PHI,ATL,8,6,8-6,PHI,9,true,36,40,76,159,164,323,15,14,29,6,3:27
566886,2019-05-21,2019,TOR,BOS,10,3,10-3,TOR,9,true,40,40,80,161,166,327,17,15,32,3,3:17
567485,2019-05-28,2019,NYA,SDN,4,5,5-4,SDN,9,false,37,42,79,148,149,297,11,17,28,5,3:15
565028,2019-04-11,2019,BOS,TOR,7,6,7-6,BOS,9,false,42,37,79,154,168,322,18,14,32,1,3:21
566200,2019-05-23,2019,PIT,COL,14,6,14-6,PIT,9,true,42,39,81,137,153,290,21,13,34,3,3:01
567482,2019-05-18,2019,NYA,TBA,1,2,2-1,TBA,11,false,40,40,80,156,166,322,10,6,16,1,3:39
566881,2019-05-08,2019,TOR,MIN,1,9,9-1,MIN,9,false,31,48,79,183,128,311,4,21,25,1,3:06
565342,2019-05-24,2019,CLE,TBA,3,1,3-1,CLE,9,true,35,38,73,167,132,299,12,10,22,5,3:20
567161,2019-04-06,2019,ATL,MIA,2,4,4-2,MIA,9,false,43,35,78,135,170,305,17,11,28,2,3:16
566891,2019-05-26,2019,TOR,SDN,10,1,10-1,TOR,9,true,41,36,77,161,165,326,18,11,29,1,3:08
566885,2019-05-20,2019,TOR,BOS,2,12,12-2,BOS,9,false,32,46,78,174,129,303,4,20,24,1,2:56
567462,2019-04-12,2019,NYA,CHA,6,9,9-6,CHA,7,true,30,34,64,137,123,260,12,15,27,4,2:43 (:41 delay)
565807,2019-04-13,2019,LAN,MIL,1,4,4-1,MIL,9,false,32,41,73,153,123,276,8,15,23,2,2:54
565901,2019-04-13,2019,WAS,PIT,3,2,3-2,WAS,9,true,30,37,67,127,116,243,8,10,18,0,2:22
567077,2019-05-03,2019,PHI,WAS,4,2,4-2,PHI,9,true,30,36,66,142,127,269,7,9,16,1,2:42
565318,2019-04-04,2019,CLE,TOR,4,1,4-1,CLE,9,true,36,40,76,166,133,299,13,13,26,2,3:06
566769,2019-04-12,2019,TEX,OAK,6,8,8-6,OAK,9,false,37,38,75,172,155,327,11,13,24,4,3:16
567364,2019-04-02,2019,MIA,NYN,5,6,6-5,NYN,9,false,46,44,90,167,145,312,20,15,35,1,3:23
565616,2019-04-26,2019,HOU,CLE,3,6,6-3,CLE,9,false,41,41,82,163,161,324,13,14,27,3,3:19
565435,2019-05-24,2019,COL,BAL,8,6,8-6,COL,9,false,38,38,76,155,167,322,16,12,28,2,3:17
566867,2019-03-31,2019,TOR,DET,3,4,4-3,DET,11,false,41,48,89,180,139,319,10,16,26,2,3:17
567365,2019-04-03,2019,MIA,NYN,4,6,6-4,NYN,9,false,37,41,78,159,164,323,10,15,25,2,3:07
566093,2019-04-04,2019,OAK,BOS,7,3,7-3,OAK,9,true,40,40,80,160,147,307,18,16,34,2,3:16
566767,2019-04-02,2019,TEX,HOU,6,4,6-4,TEX,9,true,37,42,79,161,152,313,14,18,32,3,3:23
566376,2019-04-01,2019,SEA,ANA,6,3,6-3,SEA,9,true,40,37,77,138,158,296,17,11,28,5,3:20
565228,2019-04-11,2019,CIN,MIA,5,0,5-0,CIN,9,true,35,32,67,144,148,292,13,8,21,1,2:51
566774,2019-04-17,2019,TEX,ANA,5,4,5-4,TEX,9,true,33,41,74,169,146,315,9,15,24,2,3:19
565319,2019-04-05,2019,CLE,TOR,3,2,3-2,CLE,9,false,31,33,64,139,131,270,7,7,14,1,2:42
565323,2019-04-20,2019,CLE,ATL,8,4,8-4,CLE,9,true,41,36,77,136,176,312,17,9,26,2,3:04
565421,2019-04-20,2019,COL,PHI,5,8,8-5,PHI,9,false,42,41,83,153,157,310,16,15,31,4,3:25
564932,2019-04-07,2019,BAL,NYA,3,15,15-3,NYA,9,false,36,50,86,199,148,347,8,25,33,3,3:05
565802,2019-03-31,2019,LAN,ARI,8,7,8-7,LAN,9,true,41,40,81,160,170,330,15,14,29,2,3:29
566765,2019-03-31,2019,TEX,CHN,11,10,11-10,TEX,9,false,41,47,88,174,171,345,17,20,37,6,3:46
565222,2019-03-31,2019,CIN,PIT,0,5,5-0,PIT,9,false,32,44,76,181,139,320,6,18,24,2,3:15
565030,2019-04-13,2019,BOS,BAL,5,9,9-5,BAL,9,false,36,48,84,189,142,331,11,21,32,5,3:39
565705,2019-04-02,2019,KCA,MIN,4,5,5-4,MIN,10,false,40,49,89,179,136,315,12,20,32,2,3:30
564756,2019-05-19,2019,ANA,KCA,1,5,5-1,KCA,9,false,38,41,79,177,156,333,11,14,25,2,3:21
567263,2019-04-05,2019,CHA,SEA,10,8,10-8,CHA,9,true,40,41,81,162,165,327,15,14,29,4,3:36
565915,2019-05-16,2019,WAS,NYN,7,6,7-6,WAS,9,true,40,40,80,161,147,308,18,13,31,2,3:16
567157,2019-04-01,2019,ATL,CHN,8,0,8-0,ATL,9,true,43,37,80,150,169,319,20,13,33,2,3:12
564833,2019-04-05,2019,ARI,BOS,15,8,15-8,ARI,9,true,45,41,86,173,169,342,23,15,38,3,3:23
567575,2019-05-08,2019,MIL,WAS,7,3,7-3,MIL,9,true,42,37,79,160,182,342,17,9,26,2,3:24
566493,2019-05-21,2019,SFN,ATL,4,3,4-3,SFN,9,false,37,39,76,148,150,298,12,14,26,4,3:16
566001,2019-04-29,2019,NYN,CIN,4,5,5-4,CIN,9,false,41,41,82,137,161,298,15,19,34,3,3:15
564955,2019-05-23,2019,BAL,NYA,5,6,6-5,NYA,9,false,37,39,76,152,142,294,11,14,25,3,3:02
564838,2019-04-11,2019,ARI,SDN,6,7,7-6,SDN,9,false,43,37,80,138,171,309,15,12,27,4,3:13
567268,2019-04-10,2019,CHA,TBA,1,9,9-1,TBA,9,false,34,47,81,179,133,312,7,20,27,1,3:00 (1:39 delay)
567464,2019-04-14,2019,NYA,CHA,2,5,5-2,CHA,9,false,33,39,72,173,151,324,6,15,21,3,3:21
565414,2019-04-06,2019,COL,LAN,2,7,7-2,LAN,9,false,36,39,75,149,149,298,10,15,25,5,3:19
566092,2019-04-03,2019,OAK,BOS,3,6,6-3,BOS,9,false,39,39,78,168,161,329,12,12,24,4,3:21
566289,2019-04-24,2019,SDN,SEA,1,0,1-0,SDN,9,true,29,30,59,107,90,197,5,4,9,0,2:05
564855,2019-05-18,2019,ARI,SFN,5,8,8-5,SFN,9,false,38,41,79,176,149,325,10,16,26,2,3:24
565611,2019-04-10,2019,HOU,NYA,8,6,8-6,HOU,9,true,41,40,81,168,172,340,21,13,34,5,3:30
564748,2019-04-25,2019,ANA,NYA,11,5,11-5,ANA,9,true,39,43,82,181,157,338,16,17,33,4,3:49
566770,2019-06-08,2019,TEX,OAK,10,5,10-5,TEX,9,true,43,38,81,138,188,326,18,13,31,0,3:12
566201,2019-05-24,2019,PIT,LAN,2,10,10-2,LAN,9,false,36,44,80,176,156,332,9,18,27,2,3:15
565801,2019-03-30,2019,LAN,ARI,18,5,18-5,LAN,9,true,51,35,86,146,182,328,29,10,39,2,3:14
565051,2019-05-27,2019,BOS,CLE,12,5,12-5,BOS,9,true,42,42,84,154,181,335,19,15,34,2,3:32
565223,2019-04-01,2019,CIN,MIL,3,4,4-3,MIL,9,false,39,41,80,165,155,320,13,18,31,2,3:31
565146,2019-05-20,2019,CHN,PHI,4,5,5-4,PHI,10,false,43,42,85,164,152,316,15,13,28,1,3:34
567186,2019-05-18,2019,ATL,MIL,4,3,4-3,ATL,10,false,39,43,82,155,149,304,13,15,28,3,3:34
565898,2019-04-02,2019,WAS,PHI,2,8,8-2,PHI,9,false,34,45,79,179,146,325,8,21,29,2,3:30 (:41 delay)
564939,2019-04-21,2019,BAL,MIN,3,4,4-3,MIN,9,false,39,40,79,138,152,290,13,13,26,1,3:08
565707,2019-04-08,2019,KCA,SEA,5,13,13-5,SEA,9,false,41,46,87,191,137,328,14,20,34,3,3:17
566379,2019-04-13,2019,SEA,HOU,1,3,3-1,HOU,9,false,31,34,65,129,155,284,4,8,12,0,2:46
564743,2019-04-20,2019,ANA,SEA,5,6,6-5,SEA,9,false,42,41,83,183,163,346,16,14,30,2,3:41
566477,2019-04-11,2019,SFN,COL,1,0,1-0,SFN,9,true,33,30,63,107,128,235,10,4,14,3,2:34
565417,2019-04-09,2019,COL,ATL,1,7,7-1,ATL,9,false,35,38,73,165,140,305,9,12,21,1,3:12
564739,2019-04-09,2019,ANA,MIL,11,8,11-8,ANA,9,true,42,41,83,165,174,339,19,14,33,4,3:50
564931,2019-04-06,2019,BAL,NYA,4,6,6-4,NYA,9,false,42,39,81,179,183,362,13,15,28,7,3:42
564930,2019-04-04,2019,BAL,NYA,4,8,8-4,NYA,9,false,39,41,80,174,164,338,14,16,30,5,3:27
566771,2019-04-14,2019,TEX,OAK,8,7,8-7,TEX,9,true,38,39,77,168,143,311,13,14,27,1,3:05
566981,2019-05-12,2019,MIN,DET,3,5,5-3,DET,9,false,41,38,79,146,162,308,14,12,26,4,3:07
565998,2019-04-26,2019,NYN,MIL,2,10,10-2,MIL,9,false,38,45,83,181,150,331,11,19,30,1,3:20 (2:42 delay)
566380,2019-04-14,2019,SEA,HOU,2,3,3-2,HOU,9,false,30,35,65,117,144,261,4,10,14,1,2:40
567481,2019-05-17,2019,NYA,TBA,4,3,4-3,NYA,9,false,36,40,76,144,142,286,11,13,24,2,3:08 (:35 delay)
565321,2019-04-07,2019,CLE,TOR,3,1,3-1,CLE,9,true,31,31,62,124,122,246,7,5,12,3,2:36
566393,2019-05-17,2019,SEA,MIN,1,7,7-1,MIN,9,false,36,39,75,133,125,258,10,12,22,1,2:36
566571,2019-04-09,2019,SLN,LAN,4,0,4-0,SLN,9,true,36,40,76,176,145,321,11,16,27,3,3:17
565824,2019-05-27,2019,LAN,NYN,9,5,9-5,LAN,9,true,44,42,86,160,167,327,21,17,38,4,3:42
567556,2019-04-05,2019,MIL,CHN,13,10,13-10,MIL,9,true,42,43,85,168,177,345,20,16,36,2,3:36
567189,2019-05-29,2019,ATL,WAS,4,14,14-4,WAS,9,false,34,49,83,206,135,341,7,22,29,2,3:11
567264,2019-04-06,2019,CHA,SEA,2,9,9-2,SEA,9,false,38,45,83,193,152,345,11,21,32,4,3:31
565031,2019-04-14,2019,BOS,BAL,4,0,4-0,BOS,9,true,34,34,68,135,139,274,10,7,17,2,3:07
566184,2019-04-06,2019,PIT,CIN,6,5,6-5,PIT,10,false,42,38,80,134,158,292,15,8,23,2,3:11
566688,2019-05-27,2019,TBA,TOR,8,3,8-3,TBA,9,true,41,35,76,143,165,308,18,9,27,2,3:20
565511,2019-04-06,2019,DET,KCA,7,4,7-4,DET,9,true,40,35,75,128,146,274,17,8,25,2,2:45
565320,2019-04-06,2019,CLE,TOR,7,2,7-2,CLE,9,true,39,39,78,158,162,320,14,12,26,4,3:20
566773,2019-04-16,2019,TEX,ANA,5,0,5-0,TEX,9,true,34,30,64,103,133,236,12,5,17,2,2:31
565413,2019-04-05,2019,COL,LAN,6,10,10-6,LAN,9,false,41,45,86,170,174,344,16,19,35,5,3:52
566181,2019-04-03,2019,PIT,SLN,4,5,5-4,SLN,10,false,45,40,85,158,189,347,15,10,25,3,3:30
567553,2019-03-29,2019,MIL,SLN,5,9,9-5,SLN,9,false,35,49,84,190,151,341,11,23,34,2,3:41
567158,2019-04-03,2019,ATL,CHN,6,4,6-4,ATL,9,true,39,41,80,180,154,334,16,18,34,4,3:32
565991,2019-04-06,2019,NYN,WAS,6,5,6-5,NYN,9,true,35,39,74,179,130,309,14,13,27,3,3:13
565900,2019-04-12,2019,WAS,PIT,3,6,6-3,PIT,10,false,41,42,83,167,156,323,11,12,23,3,3:28
567165,2019-04-13,2019,ATL,NYN,11,7,11-7,ATL,9,true,42,42,84,155,194,349,20,16,36,3,3:34
566592,2019-05-24,2019,SLN,ATL,2,5,5-2,ATL,9,false,35,37,72,142,127,269,8,12,20,3,2:44
565905,2019-04-18,2019,WAS,SFN,4,2,4-2,WAS,9,true,37,33,70,129,135,264,14,7,21,3,2:52
565899,2019-04-03,2019,WAS,PHI,9,8,9-8,WAS,9,false,42,44,86,173,171,344,19,19,38,3,3:53
566789,2019-05-30,2019,TEX,KCA,2,4,4-2,KCA,9,false,34,38,72,177,140,317,8,12,20,1,3:06
567066,2019-04-09,2019,PHI,WAS,6,10,10-6,WAS,10,false,44,46,90,180,160,340,15,17,32,3,3:51
566764,2019-03-30,2019,TEX,CHN,8,6,8-6,TEX,9,true,44,42,86,160,186,346,22,16,38,3,3:47
566387,2019-04-28,2019,SEA,TEX,1,14,14-1,TEX,9,false,36,49,85,168,144,312,11,19,30,1,3:10
566378,2019-04-12,2019,SEA,HOU,6,10,10-6,HOU,9,false,40,45,85,161,157,318,12,19,31,3,3:22
566375,2019-03-31,2019,SEA,BOS,10,8,10-8,SEA,9,true,45,45,90,166,175,341,19,17,36,4,3:39
565714,2019-04-26,2019,KCA,ANA,1,5,5-1,ANA,9,false,31,39,70,167,137,304,8,14,22,2,3:06
565148,2019-05-22,2019,CHN,PHI,8,4,8-4,CHN,9,true,36,43,79,186,135,321,13,16,29,2,3:04
567188,2019-05-28,2019,ATL,WAS,4,5,5-4,WAS,9,false,39,44,83,152,152,304,13,20,33,2,3:21
565896,2019-03-30,2019,WAS,NYN,8,11,11-8,NYN,9,false,42,46,88,188,181,369,14,19,33,5,3:50
564734,2019-04-04,2019,ANA,TEX,4,11,11-4,TEX,9,false,42,45,87,188,187,375,15,21,36,2,3:49
565535,2019-05-21,2019,DET,MIA,4,5,5-4,MIA,11,false,41,47,88,170,178,348,8,15,23,1,3:29
566573,2019-04-11,2019,SLN,LAN,11,7,11-7,SLN,9,true,41,39,80,164,174,338,16,12,28,2,3:12
565706,2019-04-03,2019,KCA,MIN,6,7,7-6,MIN,9,false,39,42,81,174,159,333,12,18,30,4,3:32
565048,2019-05-17,2019,BOS,HOU,1,3,3-1,HOU,9,false,38,36,74,128,158,286,11,9,20,1,3:00
567266,2019-04-08,2019,CHA,TBA,1,5,5-1,TBA,9,false,34,46,80,184,143,327,9,19,28,2,3:25
566294,2019-05-07,2019,SDN,NYN,6,7,7-6,NYN,9,false,41,44,85,180,157,337,17,18,35,3,3:38
567478,2019-05-15,2019,NYA,BAL,3,1,3-1,NYA,9,true,33,34,67,113,124,237,9,8,17,1,2:29
567160,2019-04-05,2019,ATL,MIA,4,0,4-0,ATL,9,true,34,31,65,126,137,263,10,7,17,0,2:35
567557,2019-04-06,2019,MIL,CHN,8,14,14-8,CHN,9,false,41,49,90,203,173,376,13,21,34,3,3:54
567369,2019-04-15,2019,MIA,CHN,2,7,7-2,CHN,9,false,38,44,82,159,148,307,12,18,30,3,3:27
564857,2019-05-31,2019,ARI,NYN,4,5,5-4,NYN,9,false,37,41,78,147,135,282,11,16,27,0,3:14
567385,2019-05-28,2019,MIA,SFN,11,3,11-3,MIA,9,true,41,35,76,130,172,302,18,8,26,2,2:51
565415,2019-04-07,2019,COL,LAN,6,12,12-6,LAN,9,false,43,48,91,199,156,355,17,23,40,5,3:52
565712,2019-04-13,2019,KCA,CLE,3,0,3-0,KCA,9,true,31,30,61,134,120,254,8,4,12,1,2:26
566203,2019-05-26,2019,PIT,LAN,7,11,11-7,LAN,9,false,41,50,91,194,147,341,14,23,37,1,3:44
567487,2019-08-03,2019,NYA,BOS,6,4,6-4,NYA,9,true,40,42,82,198,184,382,18,16,34,3,4:02
565334,2019-05-16,2019,CLE,BAL,14,7,14-7,CLE,9,true,47,40,87,148,205,353,25,14,39,6,3:54
567457,2019-03-30,2019,NYA,BAL,3,5,5-3,BAL,9,false,41,37,78,140,182,322,16,10,26,2,3:24
567488,2019-05-31,2019,NYA,BOS,4,1,4-1,NYA,9,true,32,33,65,140,146,286,10,9,19,0,2:51
567288,2019-05-27,2019,CHA,KCA,2,1,2-1,CHA,9,false,35,32,67,111,149,260,14,7,21,3,2:56 (3:04 delay)
566568,2019-04-06,2019,SLN,SDN,4,6,6-4,SDN,9,false,42,45,87,189,198,387,15,19,34,3,3:37
567067,2019-04-10,2019,PHI,WAS,1,15,15-1,WAS,9,false,36,51,87,217,160,377,11,23,34,4,3:35
565322,2019-04-20,2019,CLE,ATL,7,8,8-7,ATL,9,false,44,42,86,203,189,392,20,16,36,6,3:54
567458,2019-03-31,2019,NYA,BAL,5,7,7-5,BAL,9,false,46,41,87,181,226,407,18,15,33,3,3:48 (3:17 delay)
565128,2019-04-13,2019,CHN,ANA,5,6,6-5,ANA,9,false,43,43,86,184,179,363,16,18,34,5,3:56
564736,2019-04-06,2019,ANA,TEX,5,1,5-1,ANA,9,true,40,34,74,146,172,318,18,8,26,3,3:22
566111,2019-05-27,2019,OAK,ANA,8,5,8-5,OAK,9,true,35,38,73,149,135,284,12,13,25,3,3:06
565805,2019-04-03,2019,LAN,SFN,5,3,5-3,LAN,9,true,36,34,70,115,163,278,12,8,20,3,2:59
567272,2019-04-26,2019,CHA,DET,12,11,12-11,CHA,9,false,47,48,95,202,166,368,26,22,48,5,4:02
565631,2019-05-25,2019,HOU,BOS,4,3,4-3,HOU,9,false,40,39,79,148,150,298,17,13,30,3,3:28
564751,2019-05-02,2019,ANA,TOR,6,2,6-2,ANA,9,true,37,35,72,138,147,285,14,9,23,2,3:01
566282,2019-04-15,2019,SDN,COL,2,5,5-2,COL,9,false,36,36,72,117,134,251,11,10,21,2,2:38
565992,2019-04-07,2019,NYN,WAS,9,12,12-9,WAS,9,false,42,46,88,198,173,371,17,22,39,4,3:42
566972,2019-04-26,2019,MIN,BAL,6,1,6-1,MIN,9,true,36,38,74,163,145,308,11,12,23,2,3:07
566786,2019-05-20,2019,TEX,SEA,10,9,10-9,TEX,9,true,39,42,81,162,140,302,16,15,31,2,2:53
565125,2019-04-10,2019,CHN,PIT,2,5,5-2,PIT,9,false,37,38,75,146,154,300,9,12,21,2,3:10
566383,2019-04-17,2019,SEA,CLE,0,1,1-0,CLE,9,false,31,31,62,128,137,265,5,4,9,0,2:32
567282,2019-05-13,2019,CHA,CLE,5,2,5-2,CHA,9,true,32,32,64,121,122,243,9,5,14,3,2:28
565052,2019-05-28,2019,BOS,CLE,5,7,7-5,CLE,9,false,40,43,83,183,163,346,13,18,31,3,4:03 (1:09 delay)
565719,2019-05-01,2019,KCA,TBA,3,2,3-2,KCA,9,true,31,36,67,128,118,246,8,10,18,2,2:37
566675,2019-04-20,2019,TBA,BOS,5,6,6-5,BOS,9,false,38,39,77,149,158,307,14,14,28,3,3:12
567465,2019-04-16,2019,NYA,BOS,8,0,8-0,NYA,9,true,38,32,70,124,134,258,14,5,19,0,2:23
565132,2019-04-21,2019,CHN,ARI,2,1,2-1,CHN,9,false,33,30,63,111,130,241,10,5,15,1,2:28
565914,2019-05-15,2019,WAS,NYN,5,1,5-1,WAS,9,true,33,32,65,122,119,241,11,5,16,1,2:28
565816,2019-05-07,2019,LAN,ATL,9,0,9-0,LAN,9,true,39,30,69,93,147,240,15,4,19,1,2:42
564752,2019-05-04,2019,ANA,HOU,2,14,14-2,HOU,9,false,39,45,84,179,148,327,12,19,31,2,3:15
565625,2019-05-12,2019,HOU,TEX,15,5,15-5,HOU,9,true,45,41,86,162,161,323,20,13,33,3,3:08
565709,2019-04-10,2019,KCA,SEA,5,6,6-5,SEA,9,false,39,41,80,176,129,305,16,15,31,3,3:17
566497,2019-05-25,2019,SFN,ARI,4,10,10-4,ARI,9,false,40,43,83,140,150,290,14,17,31,2,3:06
567370,2019-04-16,2019,MIA,CHN,0,4,4-0,CHN,9,false,34,38,72,155,119,274,8,16,24,1,2:49
566471,2019-04-05,2019,SFN,TBA,2,5,5-2,TBA,9,false,39,40,79,156,134,290,11,13,24,4,3:06
566482,2019-04-27,2019,SFN,NYA,4,6,6-4,NYA,9,false,36,38,74,138,128,266,9,14,23,1,2:35
566671,2019-04-16,2019,TBA,BAL,4,2,4-2,TBA,9,true,34,33,67,112,149,261,11,7,18,1,2:41
566968,2019-04-15,2019,MIN,TOR,3,5,5-3,TOR,9,false,36,38,74,144,134,278,9,13,22,1,3:00
565990,2019-04-04,2019,NYN,WAS,0,4,4-0,WAS,9,false,34,37,71,167,146,313,6,10,16,3,3:19
565039,2019-04-28,2019,BOS,TBA,2,5,5-2,TBA,9,false,34,35,69,134,126,260,8,10,18,1,2:31
567478,2019-05-15,2019,NYA,BAL,3,1,3-1,NYA,9,true,33,34,67,113,124,237,9,8,17,1,2:29
565129,2019-06-03,2019,CHN,ANA,8,1,8-1,CHN,9,true,38,33,71,133,144,277,14,8,22,2,3:00
566300,2019-05-20,2019,SDN,ARI,2,1,2-1,SDN,9,true,31,35,66,140,110,250,8,9,17,2,2:40
564944,2019-05-04,2019,BAL,TBA,3,0,3-0,BAL,9,true,31,31,62,120,99,219,8,6,14,2,2:19
565333,2019-05-09,2019,CLE,CHA,5,0,5-0,CLE,5,false,30,17,47,63,104,167,16,2,18,1,1:45 (2:34 delay)
565614,2019-04-24,2019,HOU,MIN,7,1,7-1,HOU,9,true,35,32,67,113,131,244,13,5,18,0,2:28
567267,2019-04-09,2019,CHA,TBA,5,10,10-5,TBA,9,false,39,47,86,209,193,402,13,21,34,4,3:56
565149,2019-05-23,2019,CHN,PHI,7,9,9-7,PHI,9,false,44,44,88,188,184,372,19,17,36,5,3:55
565808,2019-04-14,2019,LAN,MIL,7,1,7-1,LAN,9,true,40,32,72,109,144,253,16,6,22,1,2:34
564761,2019-05-25,2019,ANA,TEX,3,2,3-2,ANA,9,false,36,37,73,150,157,307,12,10,22,2,3:11
567270,2019-04-16,2019,CHA,KCA,5,1,5-1,CHA,9,true,34,33,67,141,133,274,11,8,19,1,2:39
566472,2019-04-06,2019,SFN,TBA,6,4,6-4,SFN,9,true,35,38,73,146,137,283,11,11,22,1,2:51
565344,2019-05-26,2019,CLE,TBA,3,6,6-3,TBA,9,false,39,39,78,152,163,315,13,13,26,3,3:18
566104,2019-05-09,2019,OAK,CIN,0,3,3-0,CIN,9,false,35,33,68,110,154,264,10,9,19,2,2:36
566989,2019-05-28,2019,MIN,MIL,5,3,5-3,MIN,9,true,36,34,70,125,114,239,12,8,20,2,2:40
565920,2019-05-25,2019,WAS,MIA,5,0,5-0,WAS,9,true,36,29,65,116,128,244,13,5,18,0,2:25
566788,2019-05-22,2019,TEX,SEA,2,1,2-1,TEX,9,true,30,35,65,146,92,238,10,9,19,2,2:27
566965,2019-05-11,2019,MIN,DET,8,3,8-3,MIN,9,true,42,36,78,132,160,292,18,10,28,1,2:45
566588,2019-05-11,2019,SLN,PIT,1,2,2-1,PIT,9,false,34,32,66,123,146,269,7,5,12,1,2:42 (2:56 delay)
565811,2019-04-17,2019,LAN,CIN,3,2,3-2,LAN,9,true,29,32,61,127,116,243,6,5,11,2,2:37
565822,2019-05-14,2019,LAN,SDN,6,3,6-3,LAN,9,true,35,32,67,126,130,256,10,8,18,1,2:32
565238,2019-05-14,2019,CIN,CHN,1,3,3-1,CHN,9,false,31,39,70,147,110,257,4,12,16,2,2:39
567567,2019-04-30,2019,MIL,COL,4,3,4-3,MIL,9,true,29,34,63,141,96,237,6,8,14,1,2:22
567062,2019-04-05,2019,PHI,MIN,10,4,10-4,PHI,9,true,44,39,83,136,192,328,22,12,34,3,3:31
565033,2019-04-23,2019,BOS,DET,4,7,7-4,DET,9,false,33,41,74,176,112,288,7,17,24,2,2:55
565615,2019-04-25,2019,HOU,CLE,1,2,2-1,CLE,9,false,33,33,66,133,133,266,10,7,17,0,2:40
566875,2019-04-24,2019,TOR,SFN,0,4,4-0,SFN,9,false,30,38,68,141,136,277,4,13,17,2,2:41
565913,2019-05-14,2019,WAS,NYN,2,6,6-2,NYN,9,false,32,39,71,136,122,258,7,13,20,1,2:38
566095,2019-04-17,2019,OAK,HOU,2,1,2-1,OAK,9,true,30,35,65,131,120,251,7,8,15,1,2:29
564841,2019-04-14,2019,ARI,SDN,8,4,8-4,ARI,9,true,36,33,69,130,129,259,14,8,22,1,2:49
566974,2019-04-28,2019,MIN,BAL,4,1,4-1,MIN,9,true,35,33,68,131,146,277,12,5,17,0,2:42
565053,2019-05-29,2019,BOS,CLE,9,14,14-9,CLE,9,false,43,49,92,189,155,344,15,23,38,3,3:42
566670,2019-04-03,2019,TBA,COL,0,1,1-0,COL,11,false,46,38,84,151,158,309,14,7,21,3,3:19
566190,2019-04-23,2019,PIT,ARI,1,2,2-1,ARI,9,false,35,34,69,145,131,276,10,8,18,1,2:53
566099,2019-04-22,2019,OAK,TEX,6,1,6-1,OAK,9,true,34,38,72,157,125,282,10,12,22,1,2:48
567468,2019-04-19,2019,NYA,KCA,6,2,6-2,NYA,9,true,35,37,72,151,128,279,14,11,25,1,2:51
566672,2019-04-17,2019,TBA,BAL,8,1,8-1,TBA,9,true,37,32,69,142,143,285,18,5,23,1,2:43
565903,2019-04-16,2019,WAS,SFN,3,7,7-3,SFN,9,false,38,40,78,161,154,315,13,13,26,3,3:16
566684,2019-05-11,2019,TBA,NYA,7,2,7-2,TBA,9,true,38,32,70,121,147,268,15,8,23,0,2:54
564749,2019-04-30,2019,ANA,TOR,4,3,4-3,ANA,9,true,32,34,66,139,133,272,10,8,18,1,2:56
567289,2019-05-28,2019,CHA,KCA,4,3,4-3,CHA,9,true,36,31,67,122,130,252,13,5,18,0,2:31
566006,2019-05-11,2019,NYN,MIA,4,1,4-1,NYN,9,true,35,35,70,139,128,267,13,8,21,1,2:41
565810,2019-04-16,2019,LAN,CIN,6,1,6-1,LAN,9,true,36,34,70,131,138,269,15,7,22,1,2:51
565710,2019-04-11,2019,KCA,SEA,6,7,7-6,SEA,10,false,46,43,89,171,177,348,14,14,28,1,3:27
567265,2019-04-07,2019,CHA,SEA,5,12,12-5,SEA,9,false,41,44,85,202,155,357,13,16,29,3,3:49
565806,2019-04-12,2019,LAN,MIL,5,8,8-5,MIL,9,false,43,42,85,152,175,327,16,15,31,3,3:54
566575,2019-04-20,2019,SLN,NYN,10,2,10-2,SLN,9,true,41,33,74,109,166,275,18,6,24,2,2:45
565331,2019-05-07,2019,CLE,CHA,0,2,2-0,CHA,9,false,34,37,71,135,144,279,9,11,20,4,2:58
567171,2019-04-27,2019,ATL,COL,5,9,9-5,COL,9,false,38,39,77,128,141,269,13,12,25,3,2:58
566284,2019-04-18,2019,SDN,CIN,1,4,4-1,CIN,9,false,32,32,64,138,138,276,8,6,14,2,2:45
564848,2019-05-10,2019,ARI,ATL,1,2,2-1,ATL,9,false,34,33,67,129,140,269,6,8,14,0,3:00
566003,2019-05-01,2019,NYN,CIN,0,1,1-0,CIN,9,false,33,35,68,135,125,260,6,8,14,4,2:46
566687,2019-05-22,2019,TBA,LAN,8,1,8-1,TBA,9,true,38,35,73,127,147,274,15,9,24,4,2:51
565325,2019-04-23,2019,CLE,MIA,1,3,3-1,MIA,9,false,34,37,71,141,118,259,6,10,16,3,2:42
567580,2019-05-26,2019,MIL,PHI,9,1,9-1,MIL,9,true,39,28,67,107,157,264,16,1,17,2,2:49
565813,2019-04-27,2019,LAN,PIT,3,1,3-1,LAN,9,true,33,34,67,139,119,258,9,7,16,2,2:58
565626,2019-05-20,2019,HOU,CHA,3,0,3-0,HOU,9,true,32,35,67,151,104,255,10,8,18,1,2:40
566287,2019-04-21,2019,SDN,CIN,4,3,4-3,SDN,9,true,32,37,69,134,114,248,9,11,20,3,2:50
565711,2019-04-12,2019,KCA,CLE,8,1,8-1,KCA,9,true,42,38,80,154,159,313,19,13,32,3,3:10
567274,2019-04-28,2019,CHA,DET,4,1,4-1,CHA,9,true,37,33,70,141,141,282,14,6,20,0,2:58
566114,2019-05-31,2019,OAK,HOU,2,3,3-2,HOU,9,false,35,35,70,138,129,267,9,11,20,1,2:52
564946,2019-05-06,2019,BAL,BOS,4,1,4-1,BAL,9,true,35,31,66,129,129,258,11,3,14,2,2:39
564941,2019-04-23,2019,BAL,CHA,9,1,9-1,BAL,9,true,40,32,72,116,158,274,17,7,24,2,2:56
566674,2019-04-19,2019,TBA,BOS,4,6,6-4,BOS,9,false,36,36,72,134,141,275,12,12,24,2,3:04
565150,2019-05-24,2019,CHN,CIN,5,6,6-5,CIN,9,false,38,44,82,167,158,325,12,17,29,5,3:19
567578,2019-05-24,2019,MIL,PHI,4,6,6-4,PHI,9,false,36,40,76,162,176,338,10,13,23,0,3:23
566873,2019-04-14,2019,TOR,TBA,4,8,8-4,TBA,9,false,40,43,83,181,175,356,13,15,28,5,3:41
566283,2019-04-16,2019,SDN,COL,2,8,8-2,COL,9,false,34,43,77,169,125,294,10,15,25,1,3:01
567561,2019-04-17,2019,MIL,SLN,3,6,6-3,SLN,9,false,34,40,74,160,137,297,9,17,26,3,2:55
566285,2019-04-19,2019,SDN,CIN,2,3,3-2,CIN,11,false,40,38,78,124,151,275,7,4,11,1,3:04
564937,2019-04-20,2019,BAL,MIN,7,16,16-7,MIN,9,false,37,46,83,162,142,304,12,19,31,1,2:50
566683,2019-05-10,2019,TBA,NYA,3,4,4-3,NYA,9,false,37,37,74,147,145,292,12,10,22,2,3:05
565233,2019-04-25,2019,CIN,ATL,4,2,4-2,CIN,9,true,32,37,69,156,138,294,12,12,24,2,2:54 (2:42 delay)
565042,2019-05-01,2019,BOS,OAK,7,3,7-3,BOS,9,true,38,35,73,129,139,268,15,8,23,1,2:54
566775,2019-04-19,2019,TEX,HOU,2,7,7-2,HOU,9,false,34,42,76,190,134,324,8,16,24,3,3:16
565911,2019-05-01,2019,WAS,SLN,1,5,5-1,SLN,9,false,37,40,77,145,135,280,10,14,24,1,3:02
566587,2019-05-10,2019,SLN,PIT,1,2,2-1,PIT,9,false,38,35,73,132,132,264,12,10,22,0,2:54
566790,2019-05-31,2019,TEX,KCA,6,2,6-2,TEX,9,true,32,36,68,138,133,271,9,10,19,1,2:36
565917,2019-05-18,2019,WAS,CHN,5,2,5-2,WAS,9,true,39,29,68,100,155,255,17,4,21,2,2:56
565336,2019-05-18,2019,CLE,BAL,4,1,4-1,CLE,9,true,34,31,65,125,139,264,11,4,15,2,2:36
566978,2019-05-02,2019,MIN,HOU,8,2,8-2,MIN,9,true,37,36,73,123,126,249,13,9,22,1,2:32
565613,2019-04-23,2019,HOU,MIN,10,4,10-4,HOU,9,true,40,34,74,130,152,282,17,7,24,3,3:04
565910,2019-04-30,2019,WAS,SLN,2,3,3-2,SLN,9,false,38,38,76,171,125,296,12,11,23,5,3:09
567368,2019-04-14,2019,MIA,PHI,1,3,3-1,PHI,14,false,50,58,108,231,193,424,10,18,28,2,4:38
566967,2019-04-14,2019,MIN,DET,6,4,6-4,MIN,9,true,37,41,78,179,143,322,16,14,30,4,3:19
566094,2019-04-16,2019,OAK,HOU,1,9,9-1,HOU,9,false,34,46,80,187,141,328,9,19,28,2,3:03
567560,2019-04-16,2019,MIL,SLN,8,4,8-4,MIL,9,true,39,39,78,145,155,300,15,14,29,3,3:13
566496,2019-05-24,2019,SFN,ARI,2,18,18-2,ARI,9,false,37,55,92,225,156,381,10,27,37,3,3:35
567562,2019-04-18,2019,MIL,LAN,1,3,3-1,LAN,9,false,33,35,68,164,143,307,7,10,17,1,3:02
566971,2019-04-18,2019,MIN,TOR,4,7,7-4,TOR,9,false,38,36,74,143,139,282,11,10,21,3,3:00
565995,2019-04-22,2019,NYN,PHI,5,1,5-1,NYN,9,true,37,32,69,141,135,276,14,5,19,2,2:46 (1:35 delay)
566381,2019-04-15,2019,SEA,CLE,4,6,6-4,CLE,9,false,38,41,79,169,154,323,12,15,27,7,3:33
566288,2019-04-23,2019,SDN,SEA,6,3,6-3,SDN,9,true,33,38,71,164,117,281,8,13,21,1,2:54
566110,2019-05-26,2019,OAK,SEA,7,1,7-1,OAK,9,true,35,35,70,137,142,279,10,11,21,4,2:38
566677,2019-04-22,2019,TBA,KCA,6,3,6-3,TBA,9,true,33,35,68,131,138,269,11,9,20,2,2:37
565630,2019-05-24,2019,HOU,BOS,4,3,4-3,HOU,9,true,36,36,72,156,127,283,9,10,19,0,2:48
566692,2019-05-31,2019,TBA,MIN,3,5,5-3,MIN,9,false,35,41,76,128,126,254,8,16,24,4,2:48
567474,2019-05-06,2019,NYA,SEA,7,3,7-3,NYA,9,true,32,38,70,161,106,267,10,11,21,2,2:36
566983,2019-05-14,2019,MIN,ANA,4,3,4-3,MIN,9,true,35,37,72,138,119,257,11,14,25,5,3:06
567461,2019-04-03,2019,NYA,DET,1,2,2-1,DET,9,false,35,33,68,128,136,264,9,6,15,1,2:37
567074,2019-04-28,2019,PHI,MIA,5,1,5-1,PHI,9,true,34,32,66,107,143,250,11,7,18,1,2:34
567470,2019-04-21,2019,NYA,KCA,7,6,7-6,NYA,10,false,44,42,86,184,167,351,16,13,29,3,3:29
565727,2019-05-25,2019,KCA,NYA,5,6,6-5,NYA,9,false,36,43,79,165,149,314,11,18,29,2,3:07
565033,2019-04-23,2019,BOS,DET,4,7,7-4,DET,9,false,33,41,74,176,112,288,7,17,24,2,2:55
566969,2019-04-16,2019,MIN,TOR,5,6,6-5,TOR,9,false,36,40,76,159,134,293,12,15,27,3,3:06
566485,2019-04-30,2019,SFN,LAN,3,10,10-3,LAN,9,false,33,42,75,158,142,300,7,15,22,2,2:45
565617,2019-04-27,2019,HOU,CLE,4,3,4-3,HOU,10,false,36,38,74,150,143,293,9,9,18,3,3:12
564742,2019-04-19,2019,ANA,SEA,3,5,5-3,SEA,9,false,36,40,76,173,114,287,12,13,25,3,3:04
564737,2019-04-07,2019,ANA,TEX,7,2,7-2,ANA,9,true,40,36,76,158,169,327,18,13,31,3,3:30
567380,2019-05-14,2019,MIA,TBA,0,4,4-0,TBA,9,false,31,41,72,176,115,291,6,16,22,1,2:52
565135,2019-04-25,2019,CHN,LAN,1,2,2-1,LAN,9,false,36,35,71,146,143,289,11,8,19,3,3:08
564846,2019-05-01,2019,ARI,NYA,3,2,3-2,ARI,9,true,31,37,68,156,130,286,7,12,19,2,3:12
566591,2019-05-22,2019,SLN,KCA,2,8,8-2,KCA,9,false,36,39,75,156,125,281,10,14,24,3,2:44
565131,2019-04-20,2019,CHN,ARI,0,6,6-0,ARI,9,false,32,42,74,159,139,298,7,17,24,1,3:08
566297,2019-05-17,2019,SDN,PIT,3,5,5-3,PIT,9,false,36,38,74,140,141,281,9,12,21,3,3:00
564852,2019-05-14,2019,ARI,PIT,2,6,6-2,PIT,9,false,32,41,73,153,117,270,6,15,21,0,2:45
566007,2019-08-05,2019,NYN,MIA,5,4,5-4,NYN,9,true,35,36,71,134,162,296,12,12,24,2,3:09
566576,2019-04-21,2019,SLN,NYN,6,4,6-4,SLN,9,true,36,39,75,161,133,294,10,11,21,2,3:07
566292,2019-05-05,2019,SDN,LAN,8,5,8-5,SDN,9,false,36,39,75,129,132,261,10,13,23,1,2:58
566303,2019-05-31,2019,SDN,MIA,5,2,5-2,SDN,9,true,36,33,69,119,164,283,12,5,17,3,2:59
565326,2019-04-24,2019,CLE,MIA,6,2,6-2,CLE,9,true,40,34,74,134,149,283,17,7,24,2,2:53
565341,2019-05-23,2019,CLE,TBA,2,7,7-2,TBA,9,false,34,40,74,138,132,270,7,16,23,2,2:47
566584,2019-05-07,2019,SLN,PHI,1,11,11-1,PHI,9,false,33,43,76,151,144,295,7,16,23,1,3:04
565629,2019-05-23,2019,HOU,CHA,0,4,4-0,CHA,9,false,32,41,73,158,107,265,6,14,20,1,2:40
567383,2019-05-18,2019,MIA,NYN,2,0,2-0,MIA,9,true,33,29,62,122,143,265,10,4,14,2,2:38
564958,2019-05-29,2019,BAL,DET,2,4,4-2,DET,9,false,36,34,70,143,131,274,9,7,16,1,2:35
565036,2019-04-25,2019,BOS,DET,7,3,7-3,BOS,9,true,36,37,73,131,147,278,13,10,23,0,2:39
566180,2019-04-01,2019,PIT,SLN,5,6,6-5,SLN,11,false,47,51,98,238,191,429,17,19,36,6,4:50
564840,2019-04-13,2019,ARI,SDN,4,5,5-4,SDN,9,false,41,36,77,150,178,328,16,11,27,2,3:41
565038,2019-04-27,2019,BOS,TBA,1,2,2-1,TBA,9,false,39,35,74,142,164,306,13,10,23,4,3:21
565425,2019-04-24,2019,COL,WAS,9,5,9-5,COL,9,true,43,41,84,140,153,293,21,14,35,1,2:48
565130,2019-04-19,2019,CHN,ARI,5,1,5-1,CHN,9,true,43,35,78,135,182,317,19,9,28,2,3:24
566191,2019-04-24,2019,PIT,ARI,2,11,11-2,ARI,9,false,37,42,79,152,136,288,11,16,27,0,2:49
565422,2019-04-21,2019,COL,PHI,4,1,4-1,COL,9,true,39,38,77,160,135,295,17,12,29,0,2:58 (:33 delay)
567467,2019-04-18,2019,NYA,KCA,1,6,6-1,KCA,9,false,34,39,73,170,142,312,7,12,19,2,3:06
564942,2019-04-24,2019,BAL,CHA,4,3,4-3,BAL,9,true,32,41,73,177,109,286,9,14,23,2,2:56
565996,2019-04-23,2019,NYN,PHI,9,0,9-0,NYN,9,true,41,32,73,136,156,292,16,7,23,0,2:43
567190,2019-05-31,2019,ATL,DET,2,8,8-2,DET,9,false,33,42,75,156,127,283,8,15,23,2,2:52
566302,2019-05-22,2019,SDN,ARI,5,2,5-2,SDN,9,true,38,33,71,127,157,284,18,7,25,2,2:57
566783,2019-05-17,2019,TEX,SLN,7,3,7-3,TEX,9,true,35,37,72,145,154,299,13,10,23,4,2:59
567576,2019-05-21,2019,MIL,CIN,0,3,3-0,CIN,9,false,35,33,68,147,149,296,11,7,18,0,2:39
564744,2019-04-21,2019,ANA,SEA,8,6,8-6,ANA,9,true,39,39,78,155,127,282,17,14,31,2,2:51
566205,2019-05-31,2019,PIT,MIL,9,4,9-4,PIT,9,true,43,35,78,119,154,273,19,8,27,1,2:54
567084,2019-05-17,2019,PHI,COL,5,4,5-4,PHI,9,true,33,34,67,116,140,256,11,6,17,1,2:45 (:36 delay)
567183,2019-05-15,2019,ATL,SLN,4,0,4-0,ATL,9,true,34,34,68,122,133,255,10,9,19,1,2:40
567070,2019-04-17,2019,PHI,NYN,3,2,3-2,PHI,9,true,32,35,67,125,125,250,8,11,19,2,2:52
565532,2019-05-17,2019,DET,OAK,2,7,7-2,OAK,9,false,32,38,70,149,114,263,5,12,17,2,2:28
566574,2019-04-19,2019,SLN,NYN,4,5,5-4,NYN,9,false,42,44,86,160,174,334,15,16,31,5,3:31
565909,2019-04-29,2019,WAS,SLN,3,6,6-3,SLN,9,false,37,40,77,140,177,317,10,14,24,0,3:05
564842,2019-04-26,2019,ARI,CHN,8,3,8-3,ARI,9,true,41,37,78,149,152,301,17,11,28,0,3:04
567565,2019-04-21,2019,MIL,LAN,5,6,6-5,LAN,9,false,37,41,78,161,146,307,11,15,26,2,3:13
565140,2019-05-07,2019,CHN,MIA,5,2,5-2,CHN,9,false,38,37,75,149,158,307,14,9,23,1,3:10
565037,2019-06-08,2019,BOS,TBA,5,1,5-1,BOS,9,true,36,36,72,159,146,305,13,8,21,2,3:21
564953,2019-05-21,2019,BAL,NYA,4,11,11-4,NYA,9,false,37,42,79,171,139,310,10,16,26,0,2:49
566579,2019-04-24,2019,SLN,MIL,5,2,5-2,SLN,9,true,37,34,71,147,145,292,15,9,24,2,2:51
564757,2019-05-20,2019,ANA,MIN,1,3,3-1,MIN,9,false,36,38,74,148,147,295,9,12,21,2,3:28
567375,2019-04-30,2019,MIA,CLE,4,7,7-4,CLE,9,false,38,40,78,147,142,289,11,12,23,1,2:56
564854,2019-05-17,2019,ARI,SFN,7,0,7-0,ARI,9,true,38,37,75,144,131,275,16,10,26,3,3:06
565133,2019-04-23,2019,CHN,LAN,7,2,7-2,CHN,9,true,37,36,73,150,131,281,15,9,24,1,2:56
567283,2019-05-14,2019,CHA,CLE,0,9,9-0,CLE,9,false,34,40,74,172,140,312,7,16,23,4,3:06
566395,2019-05-19,2019,SEA,MIN,7,4,7-4,SEA,9,true,36,38,74,139,140,279,13,11,24,0,3:00
566986,2019-05-25,2019,MIN,CHA,8,1,8-1,MIN,9,true,39,34,73,120,173,293,16,8,24,1,3:16
565134,2019-04-24,2019,CHN,LAN,7,6,7-6,CHN,9,true,34,38,72,167,130,297,12,13,25,2,2:48
565721,2019-05-10,2019,KCA,PHI,5,1,5-1,KCA,9,true,35,35,70,143,145,288,13,9,22,4,3:07
564853,2019-05-15,2019,ARI,PIT,11,1,11-1,ARI,9,true,40,33,73,127,155,282,15,7,22,3,2:58
565718,2019-05-01,2019,KCA,TBA,8,2,8-2,KCA,9,true,37,35,72,121,156,277,15,8,23,1,2:41
565439,2019-05-28,2019,COL,ARI,6,2,6-2,COL,9,true,34,39,73,135,134,269,12,13,25,1,3:02
565151,2019-05-25,2019,CHN,CIN,8,6,8-6,CHN,9,true,39,41,80,134,132,266,16,17,33,3,3:13
566004,2019-05-02,2019,NYN,CIN,1,0,1-0,NYN,9,true,28,31,59,104,118,222,5,5,10,0,2:10
565245,2019-05-28,2019,CIN,PIT,11,6,11-6,CIN,9,true,37,36,73,130,140,270,14,11,25,2,2:42
565728,2019-05-25,2019,KCA,NYA,3,7,7-3,NYA,9,false,33,40,73,140,129,269,6,13,19,1,2:42
564759,2019-05-23,2019,ANA,MIN,7,16,16-7,MIN,9,false,44,50,94,177,184,361,17,23,40,3,3:27
567563,2019-04-19,2019,MIL,LAN,3,5,5-3,LAN,9,false,37,42,79,185,160,345,12,17,29,6,3:47
566973,2019-04-27,2019,MIN,BAL,9,2,9-2,MIN,9,true,39,35,74,146,186,332,14,8,22,1,3:24
564837,2019-04-10,2019,ARI,TEX,2,5,5-2,TEX,9,false,39,41,80,187,159,346,12,12,24,5,3:35
567071,2019-04-25,2019,PHI,MIA,1,3,3-1,MIA,10,false,35,42,77,162,145,307,5,15,20,3,3:35
566392,2019-05-16,2019,SEA,MIN,6,11,11-6,MIN,9,false,36,45,81,188,119,307,9,18,27,1,3:03
566580,2019-04-26,2019,SLN,CIN,1,12,12-1,CIN,9,false,38,44,82,166,128,294,14,17,31,3,2:55
566578,2019-04-23,2019,SLN,MIL,4,3,4-3,SLN,9,true,36,35,71,155,157,312,15,10,25,1,3:00
566488,2019-05-11,2019,SFN,CIN,4,5,5-4,CIN,9,false,38,40,78,158,141,299,11,13,24,0,2:59
564843,2019-04-27,2019,ARI,CHN,1,9,9-1,CHN,9,false,34,42,76,161,139,300,7,18,25,1,3:05
565722,2019-05-11,2019,KCA,PHI,0,7,7-0,PHI,9,false,31,44,75,193,110,303,6,17,23,1,3:01
565419,2019-04-18,2019,COL,PHI,6,2,6-2,COL,9,true,37,35,72,155,136,291,15,8,23,2,3:03
565232,2019-04-24,2019,CIN,ATL,1,3,3-1,ATL,9,false,35,42,77,152,149,301,9,17,26,2,2:58
567089,2019-05-30,2019,PHI,SLN,3,5,5-3,SLN,9,false,37,36,73,141,133,274,14,11,25,3,3:01
567287,2019-05-19,2019,CHA,TOR,2,5,5-2,TOR,9,false,35,37,72,150,145,295,10,10,20,1,3:06
565050,2019-05-19,2019,BOS,HOU,4,3,4-3,BOS,9,true,34,37,71,160,130,290,11,12,23,2,3:02 (:55 delay)
566691,2019-05-30,2019,TBA,MIN,14,3,14-3,TBA,9,true,42,33,75,121,148,269,19,7,26,1,2:44
565337,2019-05-19,2019,CLE,BAL,10,0,10-0,CLE,9,true,42,31,73,107,174,281,18,5,23,2,2:49
564845,2019-04-30,2019,ARI,NYA,3,1,3-1,ARI,9,true,33,31,64,115,122,237,10,6,16,2,2:33
565922,2019-05-27,2019,WAS,MIA,2,3,3-2,MIA,9,false,34,40,74,154,119,273,8,12,20,2,3:00
565231,2019-04-23,2019,CIN,ATL,7,6,7-6,CIN,9,true,42,39,81,147,158,305,19,11,30,5,3:22
565624,2019-05-11,2019,HOU,TEX,11,4,11-4,HOU,9,true,43,36,79,146,166,312,18,10,28,3,3:15
565243,2019-05-19,2019,CIN,LAN,3,8,8-3,LAN,9,false,37,43,80,173,136,309,11,16,27,3,3:03
564754,2019-05-17,2019,ANA,KCA,5,2,5-2,ANA,9,true,36,38,74,155,153,308,15,12,27,2,3:17
565247,2019-05-31,2019,CIN,WAS,9,3,9-3,CIN,9,true,41,36,77,152,142,294,18,10,28,1,2:49
566595,2019-05-31,2019,SLN,CHN,2,1,2-1,SLN,10,false,37,38,75,150,154,304,11,10,21,2,3:24
565814,2019-04-28,2019,LAN,PIT,7,6,7-6,LAN,9,true,36,39,75,152,145,297,12,11,23,1,3:07
565424,2019-04-23,2019,COL,WAS,3,6,6-3,WAS,9,false,35,41,76,175,140,315,7,14,21,4,3:14
566005,2019-05-10,2019,NYN,MIA,11,2,11-2,NYN,9,true,46,41,87,143,165,308,25,13,38,0,3:04
566010,2019-05-22,2019,NYN,WAS,6,1,6-1,NYN,9,true,37,33,70,133,152,285,13,6,19,3,2:59
567579,2019-05-25,2019,MIL,PHI,2,7,7-2,PHI,9,false,31,43,74,179,111,290,6,17,23,0,2:52
566106,2019-05-11,2019,OAK,CLE,3,2,3-2,OAK,9,false,34,38,72,163,153,316,8,13,21,2,3:13
566494,2019-05-22,2019,SFN,ATL,2,9,9-2,ATL,9,false,33,41,74,160,131,291,8,12,20,0,2:48
565343,2019-05-25,2019,CLE,TBA,2,6,6-2,TBA,9,false,35,40,75,142,154,296,9,13,22,1,2:55 (2:48 delay)
567284,2019-05-16,2019,CHA,TOR,4,2,4-2,CHA,9,true,38,34,72,123,157,280,14,7,21,1,3:16
566977,2019-05-01,2019,MIN,HOU,6,2,6-2,MIN,9,true,33,35,68,120,129,249,9,9,18,0,2:28
567466,2019-04-17,2019,NYA,BOS,5,3,5-3,NYA,9,true,33,36,69,122,144,266,8,10,18,2,2:56
567376,2019-05-01,2019,MIA,CLE,4,2,4-2,MIA,9,true,35,34,69,131,107,238,13,9,22,1,2:38
566293,2019-05-06,2019,SDN,NYN,4,0,4-0,SDN,9,true,32,32,64,104,124,228,8,5,13,1,2:14
567480,2019-05-15,2019,NYA,BAL,5,3,5-3,NYA,9,true,33,33,66,112,110,222,8,7,15,2,2:12
565438,2019-05-27,2019,COL,ARI,4,3,4-3,COL,11,false,46,44,90,174,199,373,16,12,28,4,4:23
564937,2019-04-20,2019,BAL,MIN,7,16,16-7,MIN,9,false,37,46,83,162,142,304,12,19,31,1,2:50
565727,2019-05-25,2019,KCA,NYA,5,6,6-5,NYA,9,false,36,43,79,165,149,314,11,18,29,2,3:07
567276,2019-05-01,2019,CHA,BAL,7,6,7-6,CHA,9,false,40,41,81,154,166,320,14,14,28,3,3:22
565612,2019-04-22,2019,HOU,MIN,5,9,9-5,MIN,9,false,41,42,83,154,166,320,15,17,32,1,3:25
567086,2019-05-19,2019,PHI,COL,7,5,7-5,PHI,9,true,39,38,77,134,179,313,17,10,27,4,3:30
565716,2019-04-28,2019,KCA,ANA,3,7,7-3,ANA,9,false,39,36,75,160,143,303,11,11,22,0,3:02
564956,2019-05-27,2019,BAL,DET,5,3,5-3,BAL,9,true,35,38,73,162,132,294,10,11,21,2,2:55
566871,2019-04-12,2019,TOR,TBA,7,11,11-7,TBA,9,false,39,49,88,174,132,306,14,24,38,3,3:21
567382,2019-05-17,2019,MIA,NYN,8,6,8-6,MIA,9,true,36,42,78,138,143,281,10,18,28,2,3:01
565522,2019-05-03,2019,DET,KCA,4,3,4-3,DET,9,true,34,35,69,139,118,257,11,9,20,0,2:33
565623,2019-05-10,2019,HOU,TEX,3,0,3-0,HOU,9,true,31,31,62,124,129,253,8,5,13,0,2:29
567179,2019-04-30,2019,ATL,SDN,3,4,4-3,SDN,9,false,36,32,68,111,136,247,10,7,17,0,2:42
566000,2019-04-28,2019,NYN,MIL,5,2,5-2,NYN,9,true,37,30,67,128,157,285,15,5,20,2,2:52
565997,2019-04-24,2019,NYN,PHI,0,6,6-0,PHI,9,false,36,44,80,170,148,318,10,14,24,2,3:21
567168,2019-04-17,2019,ATL,ARI,2,3,3-2,ARI,10,false,41,41,82,159,164,323,11,10,21,2,3:32
566590,2019-05-22,2019,SLN,KCA,10,3,10-3,SLN,9,true,40,38,78,155,175,330,18,13,31,3,3:30
565340,2019-05-22,2019,CLE,OAK,2,7,7-2,OAK,9,false,40,45,85,163,165,328,14,17,31,1,3:14
565338,2019-05-20,2019,CLE,OAK,4,6,6-4,OAK,9,false,38,41,79,179,138,317,11,16,27,5,3:19
565434,2019-05-12,2019,COL,SDN,10,7,10-7,COL,9,true,40,40,80,148,162,310,19,13,32,3,3:06
564758,2019-05-21,2019,ANA,MIN,3,8,8-3,MIN,9,false,37,41,78,178,130,308,10,15,25,2,3:27
566498,2019-05-26,2019,SFN,ARI,2,6,6-2,ARI,9,false,38,40,78,146,159,305,13,13,26,3,3:17
565628,2019-05-22,2019,HOU,CHA,4,9,9-4,CHA,9,false,38,38,76,164,138,302,16,12,28,3,3:16
565034,2019-04-23,2019,BOS,DET,2,4,4-2,DET,9,false,42,37,79,144,171,315,17,15,32,5,3:29
567479,2019-08-12,2019,NYA,BAL,8,5,8-5,NYA,9,true,35,38,73,166,138,304,11,12,23,1,2:50
567374,2019-04-21,2019,MIA,WAS,0,5,5-0,WAS,9,false,33,37,70,134,136,270,7,12,19,3,2:45
567275,2019-04-29,2019,CHA,BAL,5,3,5-3,CHA,9,true,40,38,78,154,150,304,16,13,29,5,3:18
567572,2019-05-05,2019,MIL,NYN,3,2,3-2,MIL,9,true,30,32,62,136,109,245,7,7,14,3,2:39
566096,2019-04-19,2019,OAK,TOR,1,5,5-1,TOR,9,false,35,36,71,138,123,261,8,10,18,1,2:36
567069,2019-04-16,2019,PHI,NYN,14,3,14-3,PHI,9,true,44,39,83,159,171,330,18,14,32,2,3:07
565441,2019-05-30,2019,COL,ARI,11,10,11-10,COL,10,false,50,45,95,182,185,367,24,18,42,3,3:51
567559,2019-04-15,2019,MIL,SLN,10,7,10-7,MIL,9,true,43,43,86,156,175,331,21,15,36,5,3:51
566483,2019-04-28,2019,SFN,NYA,5,11,11-5,NYA,9,false,37,46,83,184,145,329,9,20,29,1,3:16
567170,2019-04-26,2019,ATL,COL,4,8,8-4,COL,9,false,39,40,79,153,157,310,14,12,26,5,3:21
565437,2019-05-26,2019,COL,BAL,8,7,8-7,COL,9,false,44,42,86,134,157,291,18,13,31,7,3:28
566108,2019-05-24,2019,OAK,SEA,6,2,6-2,OAK,9,true,35,44,79,195,127,322,12,18,30,2,3:25
565528,2019-05-13,2019,DET,HOU,1,8,8-1,HOU,9,false,37,40,77,178,141,319,11,15,26,0,3:03
565426,2019-05-03,2019,COL,ARI,9,10,10-9,ARI,9,false,43,42,85,159,155,314,15,14,29,3,3:24
566202,2019-05-25,2019,PIT,LAN,2,7,7-2,LAN,9,false,37,43,80,157,132,289,11,17,28,0,3:12 (1:48 delay)
566490,2019-05-14,2019,SFN,TOR,3,7,7-3,TOR,9,false,39,43,82,170,155,325,11,17,28,3,3:02
564747,2019-04-24,2019,ANA,NYA,5,6,6-5,NYA,9,false,37,38,75,158,148,306,10,11,21,2,3:29
567076,2019-05-01,2019,PHI,DET,7,3,7-3,PHI,9,true,37,41,78,162,131,293,17,16,33,4,3:16
565536,2019-05-22,2019,DET,MIA,3,6,6-3,MIA,9,false,38,37,75,156,148,304,13,13,26,2,3:01
567085,2019-05-18,2019,PHI,COL,2,1,2-1,PHI,9,true,35,38,73,143,152,295,11,11,22,4,3:18
565718,2019-05-01,2019,KCA,TBA,8,2,8-2,KCA,9,true,37,35,72,121,156,277,15,8,23,1,2:41
566581,2019-04-27,2019,SLN,CIN,6,3,6-3,SLN,9,true,36,34,70,131,118,249,14,9,23,2,2:32
566883,2019-05-11,2019,TOR,CHA,2,7,7-2,CHA,9,false,35,44,79,174,135,309,11,17,28,3,3:20
565328,2019-05-04,2019,CLE,SEA,5,4,5-4,CLE,9,true,32,34,66,117,134,251,11,8,19,2,2:41
566679,2019-04-24,2019,TBA,KCA,2,10,10-2,KCA,9,false,40,43,83,163,136,299,14,21,35,3,3:06
566399,2019-05-30,2019,SEA,ANA,3,9,9-3,ANA,9,false,34,45,79,179,147,326,8,21,29,3,3:21
566012,2019-05-24,2019,NYN,DET,8,9,9-8,DET,9,false,39,45,84,161,149,310,13,18,31,2,3:12
565043,2019-05-10,2019,BOS,SEA,14,1,14-1,BOS,9,true,44,36,80,138,168,306,18,9,27,2,3:02
566686,2019-05-21,2019,TBA,LAN,3,7,7-3,LAN,9,false,37,44,81,166,132,298,11,18,29,5,3:10
565440,2019-05-29,2019,COL,ARI,5,4,5-4,COL,9,true,34,39,73,162,136,298,17,14,31,1,3:11
565918,2019-05-19,2019,WAS,CHN,5,6,6-5,CHN,9,false,37,42,79,157,127,284,11,16,27,4,3:15
565246,2019-05-29,2019,CIN,PIT,2,7,7-2,PIT,9,false,38,42,80,148,134,282,12,16,28,4,3:09 (2:13 delay)
567387,2019-05-30,2019,MIA,SFN,1,3,3-1,SFN,9,false,35,39,74,157,138,295,12,16,28,3,3:05
567180,2019-05-01,2019,ATL,SDN,5,1,5-1,ATL,9,true,34,34,68,122,128,250,10,7,17,2,2:39
565519,2019-04-19,2019,DET,CHA,3,7,7-3,CHA,9,false,35,41,76,147,145,292,10,16,26,2,2:50
566192,2019-04-25,2019,PIT,ARI,0,5,5-0,ARI,9,false,33,37,70,132,139,271,6,11,17,0,2:41 (:31 delay)
564759,2019-05-23,2019,ANA,MIN,7,16,16-7,MIN,9,false,44,50,94,177,184,361,17,23,40,3,3:27
565324,2019-04-21,2019,CLE,ATL,5,11,11-5,ATL,9,false,43,48,91,185,149,334,16,21,37,3,3:22
565907,2019-04-27,2019,WAS,SDN,3,8,8-3,SDN,10,false,41,43,84,183,165,348,11,14,25,5,3:45
564762,2019-05-26,2019,ANA,TEX,7,6,7-6,ANA,9,true,37,41,78,183,140,323,16,12,28,2,3:27
565529,2019-05-14,2019,DET,HOU,4,11,11-4,HOU,9,false,36,47,83,169,150,319,11,19,30,0,2:49
567082,2019-05-15,2019,PHI,MIL,2,5,5-2,MIL,9,false,35,43,78,180,136,316,10,16,26,2,3:20
565047,2019-05-15,2019,BOS,COL,6,5,6-5,BOS,10,false,43,43,86,175,134,309,20,14,34,5,3:44
566980,2019-05-11,2019,MIN,DET,3,5,5-3,DET,9,false,40,39,79,157,169,326,13,11,24,4,3:24
567081,2019-05-14,2019,PHI,MIL,1,6,6-1,MIL,9,false,36,41,77,175,150,325,10,17,27,0,3:11
565442,2019-05-31,2019,COL,TOR,13,6,13-6,COL,9,true,45,41,86,146,162,308,22,16,38,2,3:10
566582,2019-04-28,2019,SLN,CIN,5,2,5-2,SLN,9,true,34,35,69,127,144,271,12,9,21,3,2:53
565521,2019-04-21,2019,DET,CHA,4,3,4-3,DET,9,true,32,33,65,145,134,279,9,7,16,2,2:49
567473,2019-05-05,2019,NYA,MIN,4,1,4-1,NYA,8,false,32,33,65,137,144,281,12,9,21,2,2:53 (1:01 delay)
566979,2019-05-10,2019,MIN,DET,6,0,6-0,MIN,9,true,38,30,68,119,145,264,15,3,18,1,2:36
565235,2019-05-04,2019,CIN,SFN,9,2,9-2,CIN,9,true,36,34,70,141,125,266,14,7,21,1,2:26
565041,2019-04-30,2019,BOS,OAK,5,1,5-1,BOS,9,true,35,33,68,138,133,271,10,6,16,2,2:34
565322,2019-04-20,2019,CLE,ATL,7,8,8-7,ATL,9,false,44,42,86,203,189,392,20,16,36,6,3:54
565713,2019-04-14,2019,KCA,CLE,9,8,9-8,KCA,9,false,42,39,81,159,190,349,19,15,34,6,3:27
565999,2019-04-27,2019,NYN,MIL,6,8,8-6,MIL,9,false,40,44,84,171,164,335,16,21,37,2,3:57
564954,2019-05-22,2019,BAL,NYA,5,7,7-5,NYA,9,false,40,43,83,164,164,328,13,17,30,2,3:18
566298,2019-05-18,2019,SDN,PIT,2,7,7-2,PIT,9,false,39,43,82,169,160,329,13,17,30,4,3:24
565520,2019-08-06,2019,DET,CHA,3,5,5-3,CHA,9,false,39,41,80,165,165,330,12,17,29,3,3:19
565634,2019-05-28,2019,HOU,CHN,9,6,9-6,HOU,9,true,39,42,81,175,147,322,16,15,31,2,3:08
566002,2019-04-30,2019,NYN,CIN,4,3,4-3,NYN,10,false,38,44,82,171,148,319,12,15,27,6,3:24
566100,2019-04-23,2019,OAK,TEX,11,5,11-5,OAK,9,true,45,42,87,159,165,324,21,16,37,3,3:17
565725,2019-05-15,2019,KCA,TEX,1,6,6-1,TEX,9,false,38,42,80,176,135,311,12,17,29,2,3:24
566590,2019-05-22,2019,SLN,KCA,10,3,10-3,SLN,9,true,40,38,78,155,175,330,18,13,31,3,3:30
564959,2019-05-31,2019,BAL,SFN,9,6,9-6,BAL,9,true,37,41,78,163,162,325,15,16,31,3,3:09
566985,2019-05-24,2019,MIN,CHA,11,4,11-4,MIN,9,true,44,38,82,128,184,312,19,11,30,3,3:27
565531,2019-05-16,2019,DET,OAK,3,17,17-3,OAK,9,false,35,50,85,185,126,311,9,22,31,0,2:55
565812,2019-04-26,2019,LAN,PIT,6,2,6-2,LAN,9,true,37,35,72,119,165,284,14,9,23,1,2:52
567372,2019-04-19,2019,MIA,WAS,3,2,3-2,MIA,9,true,37,33,70,132,124,256,11,7,18,4,2:52
566389,2019-05-01,2019,SEA,CHN,0,11,11-0,CHN,9,false,30,43,73,146,122,268,2,15,17,1,2:41
565906,2019-04-26,2019,WAS,SDN,3,4,4-3,SDN,9,false,36,33,69,155,138,293,9,7,16,1,3:02
566678,2019-04-23,2019,TBA,KCA,5,2,5-2,TBA,9,true,36,36,72,132,149,281,13,9,22,3,2:54
566186,2019-04-19,2019,PIT,SFN,4,1,4-1,PIT,9,true,32,34,66,150,126,276,8,10,18,2,2:48 (1:25 delay)
564940,2019-04-22,2019,BAL,CHA,2,12,12-2,CHA,9,false,37,48,85,187,158,345,10,19,29,3,3:26
566189,2019-04-22,2019,PIT,ARI,4,12,12-4,ARI,9,false,41,48,89,174,162,336,15,21,36,4,3:35
566398,2019-05-29,2019,SEA,TEX,7,8,8-7,TEX,9,false,42,43,85,166,158,324,17,15,32,2,3:20
566397,2019-05-28,2019,SEA,TEX,4,11,11-4,TEX,9,false,40,44,84,170,156,326,14,18,32,2,3:17
564952,2019-05-20,2019,BAL,NYA,7,10,10-7,NYA,9,false,46,41,87,152,179,331,20,15,35,3,3:35
566112,2019-05-28,2019,OAK,ANA,4,6,6-4,ANA,9,false,38,40,78,180,166,346,12,14,26,1,3:32
567167,2019-04-16,2019,ATL,ARI,6,9,9-6,ARI,9,false,39,47,86,185,150,335,16,24,40,5,3:36
566976,2019-04-30,2019,MIN,HOU,0,11,11-0,HOU,9,false,34,50,84,200,135,335,8,21,29,2,3:18
567273,2019-07-03,2019,CHA,DET,7,5,7-5,CHA,9,true,37,39,76,162,152,314,16,12,28,3,3:05
567569,2019-05-02,2019,MIL,COL,6,11,11-6,COL,9,false,40,46,86,162,162,324,13,17,30,2,3:24
566382,2019-04-16,2019,SEA,CLE,2,4,4-2,CLE,9,false,37,38,75,150,143,293,10,14,24,2,3:07
564847,2019-05-09,2019,ARI,ATL,3,2,3-2,ARI,10,false,45,37,82,152,164,316,19,9,28,0,3:13
566199,2019-05-22,2019,PIT,COL,3,9,9-3,COL,9,false,36,47,83,179,137,316,11,22,33,2,3:25
566880,2019-05-07,2019,TOR,MIN,0,3,3-0,MIN,9,false,33,37,70,126,119,245,6,11,17,1,2:30
565800,2019-03-29,2019,LAN,ARI,4,5,5-4,ARI,13,false,60,56,116,232,262,494,24,18,42,3,6:05
566384,2019-04-25,2019,SEA,TEX,14,2,14-2,SEA,9,true,47,37,84,149,208,357,23,11,34,4,3:25
565429,2019-05-07,2019,COL,SFN,4,14,14-4,SFN,9,false,39,47,86,202,149,351,13,22,35,1,3:23
567185,2019-05-17,2019,ATL,MIL,12,8,12-8,ATL,9,true,47,42,89,158,183,341,23,15,38,3,3:25
564851,2019-05-13,2019,ARI,PIT,9,3,9-3,ARI,9,true,41,42,83,172,160,332,17,15,32,0,3:27
566098,2019-04-21,2019,OAK,TOR,4,5,5-4,TOR,9,false,37,41,78,168,136,304,13,15,28,4,3:19
564856,2019-05-19,2019,ARI,SFN,2,3,3-2,SFN,10,false,40,40,80,170,161,331,10,10,20,1,3:28
566577,2019-04-22,2019,SLN,MIL,13,5,13-5,SLN,9,true,45,34,79,139,179,318,22,6,28,2,3:12
564947,2019-05-07,2019,BAL,BOS,5,8,8-5,BOS,9,false,36,41,77,192,142,334,10,16,26,2,3:21
565138,2019-05-05,2019,CHN,SLN,13,5,13-5,CHN,9,true,39,41,80,163,141,304,16,14,30,3,3:21
567166,2019-04-14,2019,ATL,NYN,7,3,7-3,ATL,9,true,41,40,81,151,194,345,18,13,31,2,3:36 (:27 delay)
566984,2019-05-15,2019,MIN,ANA,8,7,8-7,MIN,9,true,37,48,85,182,145,327,14,22,36,6,3:41
566877,2019-04-27,2019,TOR,OAK,7,1,7-1,TOR,9,true,41,36,77,139,146,285,17,9,26,1,2:50
566583,2019-05-06,2019,SLN,PHI,6,0,6-0,SLN,9,true,37,31,68,131,148,279,16,6,22,2,2:52
565332,2019-05-08,2019,CLE,CHA,5,3,5-3,CLE,9,false,39,36,75,128,135,263,14,10,24,2,2:50
566882,2019-05-10,2019,TOR,CHA,4,3,4-3,TOR,9,true,35,35,70,138,137,275,11,8,19,4,3:08
566874,2019-04-23,2019,TOR,SFN,6,7,7-6,SFN,9,false,38,37,75,149,140,289,11,10,21,4,3:06
565423,2019-04-22,2019,COL,WAS,7,5,7-5,COL,9,true,37,35,72,162,126,288,14,10,24,1,3:00
565815,2019-05-06,2019,LAN,ATL,5,3,5-3,LAN,9,true,38,32,70,132,138,270,14,5,19,1,2:45
565236,2019-05-05,2019,CIN,SFN,5,6,6-5,SFN,9,false,36,33,69,121,170,291,10,8,18,1,2:38
565627,2019-05-21,2019,HOU,CHA,5,1,5-1,HOU,9,true,36,30,66,120,152,272,14,3,17,1,2:53
565717,2019-04-29,2019,KCA,TBA,5,8,8-5,TBA,9,false,35,42,77,157,123,280,7,17,24,2,2:51
565825,2019-05-28,2019,LAN,NYN,3,7,7-3,NYN,9,false,39,43,82,183,150,333,13,16,29,3,3:22
567271,2019-04-17,2019,CHA,KCA,3,4,4-3,KCA,10,false,47,44,91,165,183,348,18,17,35,5,4:04
566101,2019-04-24,2019,OAK,TEX,6,5,6-5,OAK,9,false,41,36,77,158,165,323,17,10,27,0,3:22
566296,2019-05-16,2019,SDN,PIT,4,3,4-3,SDN,9,true,32,38,70,155,143,298,10,9,19,3,3:05
566484,2019-04-29,2019,SFN,LAN,3,2,3-2,SFN,9,true,38,37,75,156,125,281,16,12,28,3,3:14
567574,2019-05-07,2019,MIL,WAS,6,0,6-0,MIL,9,true,37,36,73,134,149,283,15,9,24,2,3:00
567472,2019-05-04,2019,NYA,MIN,3,7,7-3,MIN,9,false,36,42,78,135,153,288,11,15,26,4,3:06
566196,2019-05-07,2019,PIT,TEX,5,4,5-4,PIT,9,true,36,39,75,153,120,273,14,13,27,1,2:50
567570,2019-05-03,2019,MIL,NYN,3,1,3-1,MIL,9,true,35,35,70,154,134,288,12,10,22,2,3:01
565921,2019-05-26,2019,WAS,MIA,9,6,9-6,WAS,9,true,43,41,84,169,152,321,19,17,36,1,3:06 (:24 delay)
566884,2019-05-12,2019,TOR,CHA,1,5,5-1,CHA,9,false,32,39,71,145,124,269,5,13,18,0,2:47
565619,2019-05-06,2019,HOU,KCA,6,4,6-4,HOU,9,true,37,37,74,151,145,296,15,10,25,3,2:57
567477,2019-05-09,2019,NYA,SEA,3,1,3-1,NYA,9,true,34,32,66,153,130,283,11,7,18,1,2:54
565993,2019-04-09,2019,NYN,MIN,8,14,14-8,MIN,9,false,45,46,91,186,219,405,18,19,37,3,4:08 (:25 delay)
567068,2019-04-15,2019,PHI,NYN,6,7,7-6,NYN,11,false,50,50,100,171,209,380,20,19,39,1,4:29
566390,2019-05-13,2019,SEA,OAK,6,5,6-5,SEA,10,false,42,46,88,173,179,352,14,17,31,1,3:47
566772,2019-04-15,2019,TEX,ANA,12,7,12-7,TEX,9,true,46,44,90,170,188,358,22,17,39,4,3:26
566785,2019-05-19,2019,TEX,SLN,5,4,5-4,TEX,10,false,39,42,81,185,160,345,14,12,26,2,3:41
566676,2019-04-21,2019,TBA,BOS,3,4,4-3,BOS,11,false,42,46,88,171,180,351,10,17,27,2,4:09
567276,2019-05-01,2019,CHA,BAL,7,6,7-6,CHA,9,false,40,41,81,154,166,320,14,14,28,3,3:22
565244,2019-05-27,2019,CIN,PIT,5,8,8-5,PIT,9,false,42,44,86,174,170,344,17,18,35,6,3:51
565724,2019-05-14,2019,KCA,TEX,11,5,11-5,KCA,9,true,43,39,82,175,163,338,20,12,32,4,3:24
567075,2019-04-30,2019,PHI,DET,1,3,3-1,DET,9,false,35,38,73,171,133,304,8,11,19,1,3:10
566388,2019-04-30,2019,SEA,CHN,5,6,6-5,CHN,9,false,41,40,81,145,153,298,16,14,30,4,3:10
564849,2019-05-11,2019,ARI,ATL,4,6,6-4,ATL,9,false,39,39,78,136,135,271,12,14,26,3,3:09
565145,2019-05-12,2019,CHN,MIL,4,1,4-1,CHN,9,true,34,37,71,142,130,272,10,11,21,1,2:55
566391,2019-05-14,2019,SEA,OAK,4,3,4-3,SEA,9,true,33,36,69,136,148,284,10,9,19,3,2:37
566879,2019-05-06,2019,TOR,MIN,0,8,8-0,MIN,9,false,31,41,72,154,125,279,5,16,21,3,2:52
566890,2019-05-25,2019,TOR,SDN,4,19,19-4,SDN,9,false,32,54,86,213,128,341,6,29,35,1,3:04
567577,2019-05-22,2019,MIL,CIN,11,9,11-9,MIL,9,true,43,43,86,185,173,358,18,18,36,5,3:48
565517,2019-04-17,2019,DET,PIT,2,3,3-2,PIT,10,false,39,42,81,162,143,305,10,13,23,2,3:21
566779,2019-05-01,2019,TEX,PIT,5,7,7-5,PIT,9,false,38,40,78,152,147,299,10,13,23,3,3:10
565142,2019-05-09,2019,CHN,MIA,4,1,4-1,CHN,9,true,36,37,73,168,140,308,12,12,24,0,2:59
565527,2019-05-09,2019,DET,ANA,0,13,13-0,ANA,9,false,32,44,76,173,112,285,5,19,24,1,2:44 (:53 delay)
566782,2019-05-05,2019,TEX,TOR,10,2,10-2,TEX,9,true,37,33,70,132,149,281,14,9,23,1,2:50
565621,2019-05-08,2019,HOU,KCA,9,0,9-0,HOU,9,true,39,35,74,139,147,286,15,7,22,1,2:45
567079,2019-05-05,2019,PHI,WAS,7,1,7-1,PHI,9,true,39,34,73,137,168,305,14,8,22,1,3:03
565526,2019-05-08,2019,DET,ANA,10,3,10-3,DET,9,true,39,37,76,148,144,292,14,9,23,1,2:53
565826,2019-05-29,2019,LAN,NYN,9,8,9-8,LAN,9,false,43,42,85,168,176,344,20,16,36,0,3:31
565534,2019-05-19,2019,DET,OAK,3,7,7-3,OAK,9,false,34,42,76,162,133,295,8,17,25,3,2:58 (1:41 delay)
565729,2019-05-26,2019,KCA,NYA,8,7,8-7,KCA,10,false,47,44,91,173,175,348,17,15,32,0,3:17
567278,2019-05-02,2019,CHA,BOS,6,4,6-4,CHA,9,false,35,41,76,168,141,309,11,16,27,2,3:33
565525,2019-05-07,2019,DET,ANA,2,5,5-2,ANA,9,false,33,41,74,165,137,302,6,14,20,2,2:59
567381,2019-05-15,2019,MIA,TBA,0,1,1-0,TBA,9,false,38,35,73,131,149,280,11,11,22,4,3:06
567483,2019-05-19,2019,NYA,TBA,13,5,13-5,NYA,9,true,45,40,85,172,181,353,20,14,34,4,3:27
564741,2019-04-18,2019,ANA,SEA,10,11,11-10,SEA,9,false,45,52,97,199,171,370,20,25,45,4,3:59
565152,2019-05-26,2019,CHN,CIN,2,10,10-2,CIN,9,false,38,46,84,174,172,346,12,20,32,2,3:27
567181,2019-05-02,2019,ATL,SDN,2,11,11-2,SDN,9,false,37,48,85,179,119,298,11,20,31,1,2:53
565622,2019-05-09,2019,HOU,TEX,4,2,4-2,HOU,9,true,37,32,69,144,164,308,15,7,22,2,2:58
566777,2019-04-21,2019,TEX,HOU,11,10,11-10,TEX,9,true,39,44,83,169,134,303,15,17,32,5,3:16
566781,2019-05-04,2019,TEX,TOR,8,5,8-5,TEX,9,true,38,38,76,138,162,300,14,14,28,1,2:59
565237,2019-05-06,2019,CIN,SFN,12,4,12-4,CIN,9,true,46,35,81,134,169,303,23,8,31,2,2:57 (:18 delay)
566487,2019-05-10,2019,SFN,CIN,0,7,7-0,CIN,9,false,38,43,81,147,156,303,11,14,25,1,2:47
567475,2019-05-07,2019,NYA,SEA,5,4,5-4,NYA,9,false,37,39,76,148,147,295,13,12,25,2,3:15 (1:12 delay)
566680,2019-05-06,2019,TBA,ARI,12,1,12-1,TBA,9,true,43,33,76,140,166,306,20,6,26,0,2:54
566491,2019-05-15,2019,SFN,TOR,4,3,4-3,SFN,9,true,34,35,69,148,133,281,11,8,19,0,3:01
565818,2019-05-09,2019,LAN,WAS,0,6,6-0,WAS,9,false,36,40,76,166,146,312,11,13,24,1,3:11
565530,2019-05-15,2019,DET,HOU,1,5,5-1,HOU,9,false,32,40,72,157,129,286,4,13,17,0,2:36
566478,2019-04-12,2019,SFN,COL,3,2,3-2,SFN,18,false,62,67,129,265,238,503,15,15,30,3,5:35
564945,2019-07-13,2019,BAL,TBA,2,1,2-1,BAL,9,true,31,33,64,149,156,305,7,8,15,4,3:02
566385,2019-04-26,2019,SEA,TEX,5,4,5-4,SEA,11,false,46,46,92,204,189,393,15,16,31,1,4:06
565428,2019-05-05,2019,COL,ARI,8,7,8-7,COL,9,true,36,41,77,155,130,285,12,13,25,2,3:09
565919,2019-05-24,2019,WAS,MIA,12,10,12-10,WAS,9,true,43,48,91,178,180,358,20,20,40,7,3:59
564746,2019-04-23,2019,ANA,NYA,5,7,7-5,NYA,9,false,37,46,83,178,140,318,11,19,30,3,3:12
566204,2019-05-30,2019,PIT,MIL,5,11,11-5,MIL,9,false,40,50,90,182,156,338,13,27,40,1,3:39
565143,2019-05-10,2019,CHN,MIL,0,7,7-0,MIL,9,false,35,42,77,149,148,297,11,16,27,5,3:18
565432,2019-05-10,2019,COL,SDN,12,2,12-2,COL,9,true,43,41,84,130,158,288,20,13,33,2,3:10
566290,2019-05-03,2019,SDN,LAN,3,4,4-3,LAN,9,false,35,38,73,154,142,296,8,11,19,2,3:13
567279,2019-05-03,2019,CHA,BOS,1,6,6-1,BOS,9,false,36,42,78,172,156,328,10,17,27,2,3:15
565141,2019-05-08,2019,CHN,MIA,3,2,3-2,CHN,11,false,37,40,77,136,144,280,11,9,20,1,2:59
567377,2019-05-03,2019,MIA,ATL,2,7,7-2,ATL,9,false,38,40,78,161,145,306,12,15,27,3,3:08
564949,2019-05-10,2019,BAL,ANA,3,8,8-3,ANA,9,false,34,42,76,179,126,305,6,16,22,1,3:04 (1:49 delay)
565819,2019-05-10,2019,LAN,WAS,5,0,5-0,LAN,9,true,37,34,71,126,163,289,14,7,21,1,2:58
566194,2019-05-04,2019,PIT,OAK,6,4,6-4,PIT,9,true,40,38,78,149,149,298,18,12,30,1,3:08
567073,2019-04-27,2019,PHI,MIA,12,9,12-9,PHI,9,true,43,45,88,180,183,363,21,20,41,1,3:38
566386,2019-04-27,2019,SEA,TEX,1,15,15-1,TEX,9,false,32,55,87,213,140,353,5,26,31,0,3:11
564750,2019-05-01,2019,ANA,TOR,6,3,6-3,ANA,9,true,41,37,78,149,179,328,15,7,22,3,3:32
567378,2019-05-04,2019,MIA,ATL,2,9,9-2,ATL,9,false,36,47,83,188,113,301,6,19,25,2,3:15
566681,2019-05-07,2019,TBA,ARI,6,3,6-3,TBA,9,true,37,37,74,151,156,307,14,10,24,3,3:19
565524,2019-05-05,2019,DET,KCA,5,2,5-2,DET,10,false,42,40,82,157,165,322,14,9,23,2,3:14
567281,2019-05-05,2019,CHA,BOS,2,9,9-2,BOS,9,false,36,43,79,176,156,332,8,19,27,3,3:33
565049,2019-05-18,2019,BOS,HOU,3,7,7-3,HOU,9,false,36,45,81,186,144,330,10,19,29,2,3:31
567379,2019-05-05,2019,MIA,ATL,1,3,3-1,ATL,10,false,38,39,77,160,156,316,9,10,19,1,3:29
567285,2019-05-17,2019,CHA,TOR,2,10,10-2,TOR,9,false,36,47,83,186,128,314,10,21,31,2,3:14
566009,2019-05-21,2019,NYN,WAS,6,5,6-5,NYN,9,false,38,37,75,153,137,290,14,12,26,5,3:05
564745,2019-04-22,2019,ANA,NYA,3,4,4-3,NYA,14,false,53,53,106,210,195,405,16,12,28,0,4:35
566878,2019-04-28,2019,TOR,OAK,5,4,5-4,TOR,11,false,47,49,96,205,167,372,13,17,30,1,3:56
565035,2019-04-24,2019,BOS,DET,11,4,11-4,BOS,9,true,45,40,85,158,175,333,24,13,37,3,3:24
566197,2019-05-08,2019,PIT,TEX,6,9,9-6,TEX,9,false,38,43,81,184,142,326,11,18,29,1,3:18
565137,2019-05-04,2019,CHN,SLN,6,5,6-5,CHN,9,true,34,43,77,168,122,290,12,17,29,3,3:03
565817,2019-05-08,2019,LAN,ATL,9,4,9-4,LAN,9,true,40,38,78,132,146,278,18,12,30,3,2:58
566594,2019-05-26,2019,SLN,ATL,3,4,4-3,ATL,10,false,43,44,87,204,162,366,11,17,28,5,4:07
566690,2019-05-29,2019,TBA,TOR,4,3,4-3,TBA,11,false,52,47,99,171,187,358,24,17,41,3,4:03
566481,2019-04-26,2019,SFN,NYA,3,7,7-3,NYA,9,false,39,41,80,160,181,341,12,16,28,3,3:26
565147,2019-05-21,2019,CHN,PHI,3,2,3-2,CHN,9,false,43,36,79,155,157,312,18,9,27,3,3:34
565427,2019-05-04,2019,COL,ARI,2,9,9-2,ARI,9,false,33,42,75,147,142,289,6,17,23,0,2:51
565916,2019-05-17,2019,WAS,CHN,6,14,14-6,CHN,9,false,44,52,96,217,175,392,19,27,46,4,4:09
567172,2019-04-28,2019,ATL,COL,8,7,8-7,ATL,9,true,41,41,82,158,175,333,16,14,30,5,3:47
566394,2019-05-18,2019,SEA,MIN,4,18,18-4,MIN,9,false,38,53,91,208,184,392,10,25,35,2,3:50
565523,2019-05-04,2019,DET,KCA,3,15,15-3,KCA,9,false,37,54,91,188,124,312,10,29,39,3,3:00
565044,2019-05-11,2019,BOS,SEA,9,5,9-5,BOS,9,true,44,36,80,143,189,332,21,8,29,2,3:15
565329,2019-05-05,2019,CLE,SEA,0,10,10-0,SEA,9,false,32,42,74,164,148,312,5,18,23,2,2:54
566982,2019-05-13,2019,MIN,ANA,4,5,5-4,ANA,9,false,39,42,81,150,156,306,11,18,29,1,3:14
566673,2019-04-18,2019,TBA,BAL,5,6,6-5,BAL,11,false,46,51,97,203,212,415,14,21,35,3,4:15
566682,2019-05-08,2019,TBA,ARI,2,3,3-2,ARI,13,false,52,52,104,198,224,422,16,17,33,6,4:39
565715,2019-04-27,2019,KCA,ANA,9,4,9-4,KCA,9,true,42,39,81,170,181,351,19,14,33,3,3:40
567568,2019-05-01,2019,MIL,COL,4,11,11-4,COL,9,false,41,43,84,172,194,366,16,18,34,1,3:44
567280,2019-05-04,2019,CHA,BOS,2,15,15-2,BOS,9,false,35,53,88,194,152,346,10,26,36,2,3:34
567573,2019-05-06,2019,MIL,WAS,5,3,5-3,MIL,9,true,41,36,77,170,177,347,14,9,23,2,3:33
564951,2019-05-12,2019,BAL,ANA,5,1,5-1,BAL,9,true,41,34,75,146,175,321,17,8,25,1,3:08 (2:42 delay)
567182,2019-05-14,2019,ATL,SLN,3,14,14-3,SLN,9,false,35,46,81,182,159,341,9,21,30,1,3:00
565420,2019-04-19,2019,COL,PHI,4,3,4-3,COL,12,false,46,58,104,210,185,395,13,24,37,1,4:26
566586,2019-05-09,2019,SLN,PIT,17,4,17-4,SLN,9,true,50,39,89,135,189,324,25,12,37,2,3:30
567277,2019-05-01,2019,CHA,BAL,4,5,5-4,BAL,9,false,39,45,84,189,176,365,10,18,28,5,3:48
565139,2019-05-06,2019,CHN,MIA,5,6,6-5,MIA,9,false,41,38,79,155,177,332,18,12,30,2,3:26
564950,2019-05-11,2019,BAL,ANA,2,7,7-2,ANA,9,false,39,40,79,163,181,344,12,13,25,2,3:34
566013,2019-05-25,2019,NYN,DET,5,4,5-4,NYN,13,false,48,57,105,242,164,406,11,22,33,1,4:11
567080,2019-05-13,2019,PHI,MIL,7,4,7-4,PHI,9,true,38,46,84,199,148,347,13,22,35,4,3:57 (:52 delay)
567083,2019-05-16,2019,PHI,MIL,3,11,11-3,MIL,9,false,34,50,84,203,129,332,6,23,29,1,3:18
566193,2019-05-03,2019,PIT,OAK,1,14,14-1,OAK,9,false,38,50,88,203,152,355,9,23,32,1,3:26 (:41 delay)
566589,2019-05-12,2019,SLN,PIT,6,10,10-6,PIT,9,false,43,46,89,163,166,329,16,23,39,2,3:29
566105,2019-05-10,2019,OAK,CLE,4,3,4-3,OAK,12,false,48,46,94,165,189,354,17,12,29,1,3:41
565430,2019-07-15,2019,COL,SFN,2,19,19-2,SFN,9,false,36,52,88,199,145,344,9,25,34,3,3:15
566887,2019-05-22,2019,TOR,BOS,5,6,6-5,BOS,13,false,53,53,106,211,207,418,15,17,32,1,4:30
565908,2019-04-28,2019,WAS,SDN,7,6,7-6,WAS,11,false,50,46,96,183,194,377,18,14,32,1,4:03
565234,2019-05-03,2019,CIN,SFN,11,12,12-11,SFN,11,false,57,53,110,180,238,418,21,21,42,6,4:29
566495,2019-05-23,2019,SFN,ATL,4,5,5-4,ATL,13,false,53,52,105,216,212,428,14,14,28,2,4:21
566113,2019-05-29,2019,OAK,ANA,7,12,12-7,ANA,11,false,47,60,107,236,182,418,14,28,42,4,4:36
565726,2019-05-16,2019,KCA,TEX,1,16,16-1,TEX,9,false,36,56,92,209,117,326,12,29,41,3,3:14
564844,2019-04-28,2019,ARI,CHN,5,6,6-5,CHN,15,false,61,66,127,273,244,517,19,22,41,5,5:36
565144,2019-05-11,2019,CHN,MIL,2,1,2-1,CHN,15,false,59,52,111,238,229,467,23,13,36,5,4:56
566780,2019-05-03,2019,TEX,TOR,0,1,1-0,TOR,12,false,43,49,92,202,184,386,11,16,27,1,4:00
565431,2019-05-09,2019,COL,SFN,12,11,12-11,COL,9,true,48,44,92,191,195,386,25,16,41,3,3:56
566291,2019-05-04,2019,SDN,LAN,6,7,7-6,LAN,9,false,42,44,86,197,190,387,16,17,33,4,4:12
567078,2019-05-04,2019,PHI,WAS,8,10,10-8,WAS,9,false,45,43,88,162,184,346,17,17,34,3,3:45
566778,2019-04-30,2019,TEX,PIT,4,6,6-4,PIT,11,false,46,50,96,191,220,411,14,17,31,3,4:14
564948,2019-05-08,2019,BAL,BOS,1,2,2-1,BOS,12,false,43,48,91,211,167,378,7,13,20,0,4:01
566195,2019-05-05,2019,PIT,OAK,5,3,5-3,PIT,13,false,47,53,100,213,177,390,11,17,28,1,3:58
566103,2019-05-08,2019,OAK,CIN,5,4,5-4,OAK,13,false,51,53,104,201,212,413,18,16,34,2,3:58
567571,2019-05-04,2019,MIL,NYN,4,3,4-3,MIL,18,false,69,64,133,253,247,500,19,12,31,4,5:22
565823,2019-05-15,2019,LAN,SDN,2,0,2-0,LAN,9,true,37,33,70,131,124,255,12,5,17,3,3:06
565820,2019-05-11,2019,LAN,WAS,2,5,5-2,WAS,9,false,35,36,71,142,139,281,9,9,18,2,2:58
565433,2019-05-11,2019,COL,SDN,3,4,4-3,SDN,9,false,34,38,72,145,122,267,7,12,19,3,3:05
565045,2019-05-12,2019,BOS,SEA,11,2,11-2,BOS,9,true,42,33,75,133,189,322,20,6,26,1,3:23
565046,2019-05-14,2019,BOS,COL,4,5,5-4,COL,11,false,46,41,87,180,180,360,13,8,21,1,3:42
565239,2019-05-15,2019,CIN,CHN,6,5,6-5,CIN,10,false,41,40,81,160,167,327,15,10,25,4,3:27
567294,2019-06-02,2019,CHA,CLE,2,0,2-0,CHA,9,true,30,31,61,118,121,239,8,6,14,2,2:30
565345,2019-06-04,2019,CLE,MIN,5,2,5-2,CLE,9,true,32,33,65,125,102,227,9,7,16,2,2:25
566993,2019-06-14,2019,MIN,KCA,2,0,2-0,MIN,9,true,31,28,59,98,117,215,9,2,11,0,2:21
567095,2019-06-12,2019,PHI,ARI,0,2,2-0,ARI,9,false,30,32,62,92,107,199,3,8,11,1,2:16
567310,2019-07-23,2019,CHA,MIA,1,5,5-1,MIA,9,false,31,33,64,113,119,232,4,6,10,0,2:27
565443,2019-06-01,2019,COL,TOR,4,2,4-2,COL,9,true,31,35,66,124,107,231,8,7,15,2,2:28
565925,2019-06-13,2019,WAS,ARI,0,5,5-0,ARI,9,false,29,35,64,115,98,213,4,10,14,1,2:15 (1:03 delay)
565153,2019-06-04,2019,CHN,COL,6,3,6-3,CHN,9,true,33,34,67,138,123,261,10,7,17,0,2:34
565734,2019-06-08,2019,KCA,CHA,0,2,2-0,CHA,9,false,32,32,64,112,132,244,5,6,11,1,2:26
566020,2019-06-09,2019,NYN,COL,6,1,6-1,NYN,9,true,33,31,64,131,101,232,11,5,16,1,2:32
565262,2019-07-04,2019,CIN,MIL,1,0,1-0,CIN,9,true,31,32,63,122,111,233,9,5,14,2,2:19 (1:09 delay)
565642,2019-06-15,2019,HOU,TOR,7,2,7-2,HOU,9,true,36,34,70,116,123,239,15,8,23,0,2:26
566115,2019-06-01,2019,OAK,HOU,1,5,5-1,HOU,9,false,34,36,70,127,133,260,7,10,17,1,2:37
567090,2019-06-07,2019,PHI,CIN,4,2,4-2,PHI,9,true,32,39,71,142,117,259,8,13,21,2,2:48
566209,2019-06-05,2019,PIT,ATL,7,4,7-4,PIT,9,true,38,34,72,117,132,249,15,8,23,1,2:48 (2:04 delay)
566996,2019-06-17,2019,MIN,BOS,0,2,2-0,BOS,9,false,34,33,67,125,125,250,7,7,14,0,2:43
566795,2019-06-06,2019,TEX,BAL,4,3,4-3,TEX,9,true,32,36,68,138,115,253,10,11,21,1,2:29 (:13 delay)
567311,2019-07-24,2019,CHA,MIA,0,2,2-0,MIA,9,false,35,33,68,109,134,243,8,7,15,0,2:38
567309,2019-07-22,2019,CHA,MIA,9,1,9-1,CHA,9,true,35,31,66,112,145,257,11,5,16,0,2:29
565267,2019-07-20,2019,CIN,SLN,3,2,3-2,CIN,9,true,32,33,65,126,119,245,12,8,20,1,2:36
566499,2019-06-07,2019,SFN,LAN,2,1,2-1,SFN,9,true,32,34,66,146,110,256,10,8,18,0,2:31
565349,2019-06-08,2019,CLE,NYA,8,4,8-4,CLE,9,true,36,35,71,135,121,256,14,7,21,1,2:39
565454,2019-06-29,2019,COL,LAN,5,3,5-3,COL,9,true,32,38,70,139,107,246,8,11,19,1,2:43
566016,2019-06-05,2019,NYN,SFN,7,0,7-0,NYN,9,true,37,31,68,117,154,271,13,6,19,0,2:41
565156,2019-06-07,2019,CHN,SLN,3,1,3-1,CHN,9,true,32,31,63,120,149,269,12,5,17,0,2:39
566797,2019-06-08,2019,TEX,OAK,3,1,3-1,TEX,9,true,32,32,64,109,135,244,8,5,13,1,2:45
566895,2019-06-07,2019,TOR,ARI,2,8,8-2,ARI,9,false,33,39,72,152,126,278,7,13,20,1,2:50
565829,2019-06-01,2019,LAN,PHI,4,3,4-3,LAN,9,false,35,35,70,126,143,269,13,8,21,1,2:48
566503,2019-06-12,2019,SFN,SDN,4,2,4-2,SFN,9,true,34,36,70,135,125,260,10,10,20,1,2:52
565637,2019-06-08,2019,HOU,BAL,1,4,4-1,BAL,9,false,32,37,69,116,120,236,6,10,16,1,2:27
566501,2019-06-09,2019,SFN,LAN,0,1,1-0,LAN,9,false,34,32,66,124,129,253,7,8,15,0,2:31
567505,2019-07-14,2019,NYA,TOR,4,2,4-2,NYA,9,true,34,36,70,121,136,257,12,7,19,2,2:50
566892,2019-06-04,2019,TOR,NYA,4,3,4-3,TOR,9,true,34,41,75,167,129,296,11,15,26,4,3:00
567391,2019-06-10,2019,MIA,SLN,1,4,4-1,SLN,9,false,33,35,68,151,117,268,9,8,17,1,2:49
565347,2019-06-06,2019,CLE,MIN,4,5,5-4,MIN,9,false,35,39,74,138,155,293,6,11,17,3,3:02
566792,2019-06-02,2019,TEX,KCA,5,1,5-1,TEX,9,true,36,38,74,133,134,267,13,12,25,2,2:38
566311,2019-06-08,2019,SDN,WAS,1,4,4-1,WAS,9,false,36,36,72,128,136,264,10,10,20,1,2:39
566322,2019-07-12,2019,SDN,ATL,3,5,5-3,ATL,9,false,39,35,74,123,146,269,15,11,26,1,3:03
566717,2019-07-24,2019,TBA,BOS,3,2,3-2,TBA,9,true,33,32,65,122,143,265,11,5,16,3,3:11
566019,2019-06-08,2019,NYN,COL,5,3,5-3,NYN,9,true,36,38,74,156,125,281,14,11,25,2,2:59
566802,2019-06-20,2019,TEX,CLE,4,2,4-2,TEX,9,true,32,34,66,133,137,270,9,8,17,1,2:35
566018,2019-06-07,2019,NYN,COL,1,5,5-1,COL,9,false,34,39,73,163,134,297,8,12,20,1,3:03
566207,2019-06-02,2019,PIT,MIL,2,4,4-2,MIL,9,false,37,37,74,147,120,267,9,10,19,2,2:41
565075,2019-07-18,2019,BOS,TOR,5,0,5-0,BOS,9,true,36,31,67,136,145,281,12,5,17,2,2:50
565177,2019-07-21,2019,CHN,SDN,1,5,5-1,SDN,9,false,32,38,70,150,124,274,6,12,18,2,2:49 (:32 delay)
567509,2019-07-18,2019,NYA,TBA,6,2,6-2,NYA,9,true,37,33,70,131,147,278,12,8,20,0,2:56 (1:26 delay)
564972,2019-06-30,2019,BAL,CLE,0,2,2-0,CLE,9,false,32,39,71,137,140,277,6,12,18,3,2:51
566700,2019-06-15,2019,TBA,ANA,3,5,5-3,ANA,9,false,34,37,71,145,129,274,7,9,16,1,2:40
565364,2019-07-17,2019,CLE,DET,7,2,7-2,CLE,9,true,36,36,72,140,133,273,14,9,23,4,2:59
567407,2019-07-17,2019,MIA,SDN,2,3,3-2,SDN,9,false,33,38,71,142,130,272,4,14,18,1,2:46
566597,2019-06-02,2019,SLN,CHN,2,1,2-1,SLN,9,true,28,35,63,152,103,255,6,11,17,2,2:38
565844,2019-07-04,2019,LAN,SDN,5,1,5-1,LAN,9,true,34,34,68,141,131,272,10,8,18,1,3:02
565658,2019-07-24,2019,HOU,OAK,4,2,4-2,HOU,9,true,31,35,66,133,114,247,7,8,15,0,2:42
567595,2019-06-29,2019,MIL,PIT,3,1,3-1,MIL,9,true,33,32,65,128,137,265,9,7,16,1,2:52
566609,2019-06-26,2019,SLN,OAK,0,2,2-0,OAK,9,false,33,37,70,142,141,283,6,10,16,1,2:46 (:26 delay)
566017,2019-06-06,2019,NYN,SFN,7,3,7-3,NYN,9,true,39,32,71,131,124,255,18,5,23,2,2:43
567583,2019-06-06,2019,MIL,MIA,5,1,5-1,MIL,9,true,34,35,69,141,128,269,11,8,19,1,2:47
566310,2019-06-07,2019,SDN,WAS,5,4,5-4,SDN,9,false,34,36,70,141,135,276,9,11,20,2,2:46
565154,2019-06-05,2019,CHN,COL,9,8,9-8,CHN,9,true,36,42,78,174,110,284,14,15,29,5,3:22
566309,2019-06-06,2019,SDN,WAS,5,4,5-4,SDN,9,true,35,35,70,141,143,284,13,7,20,2,3:07
565730,2019-06-04,2019,KCA,BOS,3,8,8-3,BOS,9,false,34,41,75,149,138,287,8,14,22,2,3:08
567396,2019-06-16,2019,MIA,PIT,4,5,5-4,PIT,9,false,38,40,78,129,148,277,13,14,27,1,3:09
565037,2019-06-08,2019,BOS,TBA,5,1,5-1,BOS,9,true,36,36,72,159,146,305,13,8,21,2,3:21
565545,2019-06-15,2019,DET,CLE,2,4,4-2,CLE,9,false,33,42,75,153,127,280,7,14,21,1,2:43
565651,2019-07-06,2019,HOU,ANA,4,0,4-0,HOU,9,true,36,34,70,149,134,283,14,8,22,0,2:44
564763,2019-06-04,2019,ANA,OAK,2,4,4-2,OAK,9,false,34,38,72,151,142,293,8,11,19,0,3:04
565249,2019-06-02,2019,CIN,WAS,1,4,4-1,WAS,9,false,32,40,72,166,133,299,5,15,20,2,3:07
566312,2019-06-09,2019,SDN,WAS,2,5,5-2,WAS,9,false,33,36,69,117,149,266,7,10,17,3,2:56
566894,2019-06-06,2019,TOR,NYA,2,6,6-2,NYA,9,false,34,40,74,163,133,296,8,12,20,2,3:07
565731,2019-06-05,2019,KCA,BOS,0,8,8-0,BOS,9,false,29,43,72,169,102,271,3,16,19,1,2:39
567414,2019-07-31,2019,MIA,MIN,4,7,7-4,MIN,9,false,33,39,72,154,116,270,6,14,20,2,2:41
567313,2019-07-26,2019,CHA,MIN,2,6,6-2,MIN,9,false,35,40,75,143,125,268,9,13,22,0,2:50
566810,2019-07-11,2019,TEX,HOU,5,0,5-0,TEX,9,true,38,35,73,139,134,273,15,9,24,1,3:02
565848,2019-07-19,2019,LAN,MIA,2,1,2-1,LAN,9,true,35,35,70,129,146,275,10,8,18,1,3:00
567393,2019-06-12,2019,MIA,SLN,9,0,9-0,MIA,9,true,38,30,68,118,137,255,14,6,20,1,2:34
565737,2019-06-12,2019,KCA,DET,2,3,3-2,DET,9,false,40,36,76,143,142,285,13,9,22,0,2:46 (:24 delay)
565539,2019-06-05,2019,DET,TBA,0,4,4-0,TBA,9,false,32,43,75,170,110,280,5,17,22,0,2:44
566416,2019-07-04,2019,SEA,SLN,4,5,5-4,SLN,9,false,36,37,73,126,123,249,13,14,27,4,2:45
566307,2019-06-04,2019,SDN,PHI,6,9,9-6,PHI,9,false,39,41,80,162,156,318,12,14,26,3,3:03
566915,2019-07-26,2019,TOR,TBA,1,3,3-1,TBA,9,false,33,37,70,144,112,256,7,12,19,4,2:56
566405,2019-06-05,2019,SEA,HOU,14,1,14-1,SEA,9,true,43,35,78,119,182,301,20,8,28,2,2:49
565346,2019-06-05,2019,CLE,MIN,9,7,9-7,CLE,9,true,40,37,77,136,160,296,15,11,26,4,3:26 (1:43 delay)
565363,2019-07-16,2019,CLE,DET,8,0,8-0,CLE,9,true,35,28,63,110,121,231,11,2,13,0,2:23 (2:07 delay)
565735,2019-06-09,2019,KCA,CHA,2,5,5-2,CHA,9,false,35,42,77,140,145,285,9,15,24,1,3:02
566518,2019-07-19,2019,SFN,NYN,1,0,1-0,SFN,10,false,39,35,74,113,165,278,10,5,15,0,2:51
566896,2019-06-08,2019,TOR,ARI,0,6,6-0,ARI,9,false,34,40,74,138,146,284,8,14,22,3,3:09
567582,2019-06-05,2019,MIL,MIA,3,8,8-3,MIA,9,false,34,43,77,177,137,314,10,16,26,0,3:04
566694,2019-06-02,2019,TBA,MIN,7,9,9-7,MIN,9,false,39,39,78,112,181,293,13,16,29,2,3:24
566600,2019-06-06,2019,SLN,CIN,3,1,3-1,SLN,9,true,34,36,70,122,143,265,11,10,21,3,2:58
565054,2019-06-07,2019,BOS,TBA,1,5,5-1,TBA,9,false,33,37,70,150,115,265,6,11,17,0,2:43
567586,2019-06-09,2019,MIL,PIT,5,2,5-2,MIL,9,true,37,35,72,154,121,275,14,8,22,2,2:52
566125,2019-06-22,2019,OAK,TBA,4,2,4-2,OAK,9,true,36,38,74,139,120,259,16,12,28,1,3:02
566021,2019-06-13,2019,NYN,SLN,4,5,5-4,SLN,10,false,37,39,76,172,149,321,8,12,20,1,3:02 (:59 delay)
565355,2019-06-23,2019,CLE,DET,8,3,8-3,CLE,9,true,36,35,71,137,132,269,12,10,22,1,2:33
566304,2019-06-01,2019,SDN,MIA,3,9,9-3,MIA,9,false,33,42,75,167,128,295,7,15,22,1,2:43
565831,2019-06-13,2019,LAN,CHN,7,3,7-3,LAN,9,true,36,36,72,134,148,282,14,11,25,0,2:48
566035,2019-07-25,2019,NYN,SDN,4,0,4-0,NYN,9,true,42,34,76,140,134,274,21,7,28,2,2:49
566791,2019-06-01,2019,TEX,KCA,6,2,6-2,TEX,9,true,40,36,76,142,160,302,15,9,24,2,3:08
565733,2019-06-07,2019,KCA,CHA,6,4,6-4,KCA,9,true,36,38,74,156,127,283,12,12,24,3,3:22
566990,2019-06-11,2019,MIN,SEA,6,5,6-5,MIN,9,true,34,41,75,177,118,295,11,14,25,1,3:02
565655,2019-07-21,2019,HOU,TEX,5,3,5-3,HOU,9,true,34,36,70,161,138,299,11,9,20,2,3:08
565944,2019-07-24,2019,WAS,COL,2,0,2-0,WAS,9,true,32,34,66,153,137,290,8,8,16,2,3:07 (1:41 delay)
565129,2019-06-03,2019,CHN,ANA,8,1,8-1,CHN,9,true,38,33,71,133,144,277,14,8,22,2,3:00
565348,2019-06-07,2019,CLE,NYA,5,2,5-2,CLE,9,true,32,32,64,135,117,252,10,7,17,0,2:23
566306,2019-06-03,2019,SDN,PHI,8,2,8-2,SDN,9,true,40,34,74,130,141,271,17,10,27,1,2:54
564767,2019-06-08,2019,ANA,SEA,12,3,12-3,ANA,9,true,46,35,81,133,154,287,23,9,32,2,3:08
567503,2019-07-12,2019,NYA,TOR,4,0,4-0,NYA,9,true,36,32,68,117,142,259,13,6,19,0,2:41
566139,2019-07-30,2019,OAK,MIL,3,2,3-2,OAK,10,false,39,38,77,141,141,282,11,9,20,3,3:16
565263,2019-07-06,2019,CIN,CLE,2,7,7-2,CLE,9,false,32,43,75,156,120,276,5,18,23,0,2:50
567389,2019-06-08,2019,MIA,ATL,0,1,1-0,ATL,9,false,34,33,67,113,144,257,7,8,15,2,2:57
564862,2019-06-05,2019,ARI,LAN,3,2,3-2,ARI,11,false,40,42,82,154,154,308,11,10,21,0,3:27
567489,2019-06-01,2019,NYA,BOS,5,3,5-3,NYA,9,true,37,40,77,166,151,317,13,15,28,3,3:18
565352,2019-06-12,2019,CLE,CIN,2,7,7-2,CIN,9,false,36,40,76,155,151,306,9,13,22,5,3:07
567092,2019-06-09,2019,PHI,CIN,3,4,4-3,CIN,9,false,34,39,73,149,137,286,8,14,22,5,3:14
565161,2019-06-20,2019,CHN,NYN,7,4,7-4,CHN,9,true,36,36,72,140,152,292,13,11,24,2,2:59
564790,2019-07-31,2019,ANA,DET,1,9,9-1,DET,9,false,36,41,77,157,148,305,11,15,26,1,2:56
567112,2019-07-28,2019,PHI,ATL,9,4,9-4,PHI,9,true,39,37,76,133,157,290,16,11,27,2,3:13
566519,2019-07-20,2019,SFN,NYN,4,11,11-4,NYN,9,false,35,44,79,164,114,278,10,19,29,0,2:50
565356,2019-06-24,2019,CLE,KCA,3,2,3-2,CLE,10,false,40,37,77,130,153,283,14,9,23,2,3:05 (2:23 delay)
567315,2019-07-28,2019,CHA,MIN,1,11,11-1,MIN,9,false,34,43,77,162,124,286,8,15,23,4,3:14
564771,2019-06-25,2019,ANA,CIN,5,1,5-1,ANA,9,true,35,34,69,148,145,293,11,11,22,1,2:56
567412,2019-07-29,2019,MIA,ARI,11,6,11-6,MIA,9,true,38,39,77,151,135,286,14,13,27,2,2:59
564788,2019-07-29,2019,ANA,DET,2,7,7-2,DET,9,false,35,38,73,155,128,283,9,11,20,1,2:53
567608,2019-07-28,2019,MIL,CHN,4,11,11-4,CHN,9,false,35,39,74,141,132,273,7,12,19,2,2:56
567411,2019-07-28,2019,MIA,ARI,5,1,5-1,MIA,9,true,33,35,68,145,142,287,10,10,20,1,3:11
565754,2019-07-26,2019,KCA,CLE,3,8,8-3,CLE,9,false,38,43,81,151,134,285,12,19,31,1,2:56
566403,2019-06-03,2019,SEA,HOU,2,4,4-2,HOU,9,false,39,34,73,118,167,285,12,8,20,0,2:49
565749,2019-07-15,2019,KCA,CHA,5,2,5-2,KCA,9,true,37,39,76,158,132,290,13,13,26,1,3:04
567409,2019-07-26,2019,MIA,ARI,3,2,3-2,MIA,9,false,34,35,69,148,144,292,9,10,19,1,3:10
565538,2019-06-04,2019,DET,TBA,9,6,9-6,DET,9,true,40,37,77,137,156,293,16,12,28,2,3:03
566521,2019-07-22,2019,SFN,CHN,5,4,5-4,SFN,9,true,36,37,73,141,141,282,14,11,25,2,2:50
565638,2019-06-09,2019,HOU,BAL,4,0,4-0,HOU,9,true,33,34,67,148,131,279,9,10,19,3,2:46
566219,2019-07-04,2019,PIT,CHN,3,11,11-3,CHN,9,false,34,44,78,158,124,282,7,18,25,1,3:04
564860,2019-06-03,2019,ARI,LAN,1,3,3-1,LAN,9,false,30,34,64,130,114,244,3,8,11,1,2:26
564961,2019-06-02,2019,BAL,SFN,1,8,8-1,SFN,9,false,34,43,77,156,168,324,6,16,22,0,3:01
566401,2019-06-01,2019,SEA,ANA,3,6,6-3,ANA,9,false,34,42,76,175,130,305,7,17,24,2,3:16
565540,2019-06-06,2019,DET,TBA,1,6,6-1,TBA,9,false,35,41,76,156,145,301,10,16,26,5,3:08
565942,2019-07-24,2019,WAS,COL,3,2,3-2,WAS,9,true,38,39,77,148,149,297,15,12,27,0,3:03
567587,2019-06-20,2019,MIL,CIN,1,7,7-1,CIN,9,false,34,43,77,165,141,306,9,18,27,0,2:58
566904,2019-06-30,2019,TOR,KCA,6,7,7-6,KCA,9,false,38,41,79,153,142,295,11,16,27,2,3:09
567201,2019-06-13,2019,ATL,PIT,6,5,6-5,ATL,9,true,39,40,79,148,137,285,15,15,30,2,3:30
565557,2019-07-20,2019,DET,TOR,5,7,7-5,TOR,9,false,36,39,75,148,136,284,8,14,22,1,2:45 (:59 delay)
566326,2019-07-27,2019,SDN,SFN,5,1,5-1,SDN,9,true,35,37,72,144,152,296,15,10,25,3,3:11
565947,2019-07-27,2019,WAS,LAN,3,9,9-3,LAN,9,false,35,41,76,151,151,302,10,15,25,2,3:06
564778,2019-07-13,2019,ANA,SEA,9,2,9-2,ANA,9,true,37,35,72,159,144,303,15,10,25,2,3:07
566210,2019-06-06,2019,PIT,ATL,6,1,6-1,PIT,9,true,33,38,71,137,141,278,10,11,21,3,2:58
567296,2019-06-11,2019,CHA,WAS,7,5,7-5,CHA,9,true,33,43,76,171,125,296,9,16,25,3,3:19
566118,2019-06-15,2019,OAK,SEA,11,2,11-2,OAK,9,true,42,35,77,125,164,289,19,8,27,3,2:58
565830,2019-06-02,2019,LAN,PHI,8,0,8-0,LAN,9,true,38,33,71,127,151,278,14,8,22,2,2:58
565948,2019-07-28,2019,WAS,LAN,11,4,11-4,WAS,9,true,42,35,77,137,150,287,19,9,28,1,3:09
565251,2019-06-15,2019,CIN,TEX,3,4,4-3,TEX,9,false,34,37,71,144,126,270,8,9,17,1,2:39
566426,2019-07-25,2019,SEA,DET,10,2,10-2,SEA,9,true,41,35,76,138,165,303,17,7,24,0,2:47
565841,2019-06-23,2019,LAN,COL,6,3,6-3,LAN,9,false,37,39,76,119,140,259,11,12,23,2,3:10
565170,2019-07-13,2019,CHN,PIT,10,4,10-4,CHN,9,true,42,37,79,129,158,287,19,11,30,3,3:12
566424,2019-07-23,2019,SEA,TEX,2,7,7-2,TEX,9,false,35,37,72,130,140,270,8,10,18,0,2:39
567392,2019-06-11,2019,MIA,SLN,1,7,7-1,SLN,9,false,35,45,80,187,119,306,8,19,27,2,3:12
565639,2019-06-11,2019,HOU,MIL,10,8,10-8,HOU,9,true,40,42,82,148,156,304,16,16,32,3,2:58
564879,2019-07-22,2019,ARI,BAL,6,3,6-3,ARI,9,true,40,37,77,136,142,278,16,10,26,2,2:55
565926,2019-06-14,2019,WAS,ARI,7,3,7-3,WAS,9,true,35,38,73,150,135,285,10,10,20,2,2:57
566140,2019-07-31,2019,OAK,MIL,2,4,4-2,MIL,9,false,37,38,75,141,160,301,10,12,22,1,2:56
566701,2019-06-16,2019,TBA,ANA,6,5,6-5,TBA,9,true,34,41,75,157,136,293,11,15,26,3,3:07
566596,2019-06-01,2019,SLN,CHN,7,4,7-4,SLN,9,true,36,36,72,155,143,298,13,9,22,2,3:04 (3:37 delay)
566135,2019-07-25,2019,OAK,TEX,3,11,11-3,TEX,9,false,34,43,77,149,141,290,8,17,25,2,2:45
567299,2019-06-15,2019,CHA,NYA,4,8,8-4,NYA,9,false,36,42,78,168,148,316,10,18,28,3,3:27 (:32 delay)
566805,2019-06-23,2019,TEX,CHA,7,4,7-4,TEX,9,true,35,38,73,149,134,283,12,13,25,3,3:07
567298,2019-06-14,2019,CHA,NYA,10,2,10-2,CHA,9,true,41,37,78,153,134,287,19,12,31,4,3:02
566429,2019-07-28,2019,SEA,DET,3,2,3-2,SEA,10,false,38,37,75,125,167,292,10,8,18,2,2:58
564873,2019-07-06,2019,ARI,COL,4,2,4-2,ARI,9,true,38,36,74,137,148,285,17,11,28,1,3:11
565169,2019-07-12,2019,CHN,PIT,4,3,4-3,CHN,9,true,34,34,68,147,143,290,11,7,18,3,3:25
564769,2019-06-10,2019,ANA,LAN,5,3,5-3,ANA,9,true,37,37,74,135,154,289,14,11,25,1,3:19
567011,2019-07-22,2019,MIN,NYA,8,6,8-6,MIN,9,true,36,41,77,149,145,294,11,18,29,2,3:08
565942,2019-07-24,2019,WAS,COL,3,2,3-2,WAS,9,true,38,39,77,148,149,297,15,12,27,0,3:03
565370,2019-07-31,2019,CLE,HOU,10,4,10-4,CLE,9,true,39,39,78,144,154,298,14,13,27,3,3:10
567606,2019-07-26,2019,MIL,CHN,3,2,3-2,MIL,9,true,37,31,68,126,163,289,13,5,18,5,3:09
567091,2019-06-08,2019,PHI,CIN,4,1,4-1,PHI,9,true,33,31,64,105,136,241,11,6,17,0,2:17
565732,2019-06-06,2019,KCA,BOS,5,7,7-5,BOS,9,false,42,41,83,153,157,310,15,17,32,5,3:26
567584,2019-06-07,2019,MIL,PIT,10,4,10-4,MIL,9,true,44,34,78,144,183,327,20,9,29,1,3:33
565541,2019-06-07,2019,DET,MIN,3,6,6-3,MIN,9,false,40,42,82,157,147,304,14,17,31,1,3:24
565923,2019-06-04,2019,WAS,CHA,9,5,9-5,WAS,9,true,39,39,78,167,154,321,16,12,28,3,3:33
564766,2019-06-07,2019,ANA,SEA,2,6,6-2,SEA,9,false,36,41,77,167,160,327,9,14,23,2,3:21
567212,2019-07-06,2019,ATL,MIA,4,5,5-4,MIA,9,false,35,43,78,156,150,306,10,16,26,0,3:19
564978,2019-07-19,2019,BAL,BOS,11,2,11-2,BAL,9,true,43,36,79,138,159,297,18,9,27,1,3:07
564765,2019-06-06,2019,ANA,OAK,4,7,7-4,OAK,9,false,38,43,81,184,144,328,11,15,26,2,3:26
566024,2019-06-16,2019,NYN,SLN,3,4,4-3,SLN,9,false,36,35,71,162,146,308,13,7,20,0,3:09
567094,2019-06-11,2019,PHI,ARI,7,4,7-4,PHI,9,true,39,40,79,155,148,303,16,13,29,1,3:16
565272,2019-07-29,2019,CIN,PIT,11,6,11-6,CIN,9,true,42,37,79,144,150,294,17,12,29,4,3:13
565748,2019-07-14,2019,KCA,DET,8,12,12-8,DET,9,false,38,48,86,172,119,291,12,22,34,3,3:05
564871,2019-06-26,2019,ARI,LAN,8,2,8-2,ARI,9,true,37,35,72,157,140,297,10,9,19,1,3:01
567490,2019-06-02,2019,NYA,BOS,5,8,8-5,BOS,9,false,37,39,76,153,157,310,11,14,25,2,3:30
566796,2019-06-07,2019,TEX,OAK,3,5,5-3,OAK,9,false,39,38,77,160,137,297,13,11,24,1,3:09
567504,2019-07-13,2019,NYA,TOR,1,2,2-1,TOR,9,false,39,37,76,148,158,306,13,10,23,5,3:32
565444,2019-06-02,2019,COL,TOR,5,1,5-1,COL,9,true,36,37,73,146,118,264,14,10,24,1,2:43
567199,2019-06-11,2019,ATL,PIT,7,5,7-5,ATL,9,true,36,36,72,140,148,288,13,14,27,2,3:15 (1:48 delay)
566119,2019-06-16,2019,OAK,SEA,3,6,6-3,SEA,9,false,36,38,74,157,135,292,9,11,20,2,2:56
567508,2019-07-18,2019,NYA,TBA,5,1,5-1,NYA,9,true,34,38,72,166,122,288,12,11,23,3,2:46
567513,2019-07-30,2019,NYA,ARI,2,4,4-2,ARI,9,false,36,38,74,144,154,298,9,12,21,4,3:10
565636,2019-06-07,2019,HOU,BAL,4,3,4-3,HOU,11,false,42,40,82,169,165,334,11,6,17,1,3:13
565351,2019-06-11,2019,CLE,CIN,2,1,2-1,CLE,10,false,38,40,78,151,161,312,11,13,24,2,3:15
565164,2019-06-23,2019,CHN,NYN,5,3,5-3,CHN,9,true,35,34,69,121,161,282,14,10,24,1,2:49
565850,2019-07-21,2019,LAN,MIA,9,0,9-0,LAN,9,true,37,33,70,125,167,292,12,6,18,0,2:41
566505,2019-06-15,2019,SFN,MIL,8,7,8-7,SFN,9,true,42,40,82,159,150,309,19,12,31,2,3:06
566599,2019-08-31,2019,SLN,CIN,10,6,10-6,SLN,9,true,39,38,77,139,161,300,16,11,27,3,3:10
565755,2019-07-27,2019,KCA,CLE,1,9,9-1,CLE,9,false,34,42,76,168,151,319,9,16,25,0,3:04
566305,2019-06-02,2019,SDN,MIA,3,9,9-3,MIA,9,false,33,41,74,168,154,322,6,15,21,1,3:04 (:28 delay)
567192,2019-06-02,2019,ATL,DET,7,4,7-4,ATL,9,true,35,40,75,161,150,311,9,13,22,3,3:18
567405,2019-07-14,2019,MIA,NYN,2,6,6-2,NYN,9,false,41,43,84,145,164,309,16,16,32,1,3:16
567114,2019-07-31,2019,PHI,SFN,1,5,5-1,SFN,9,false,33,39,72,165,130,295,7,13,20,2,3:02
566423,2019-07-22,2019,SEA,TEX,7,3,7-3,SEA,9,true,37,38,75,138,129,267,14,11,25,3,2:50
564962,2019-06-11,2019,BAL,TOR,4,2,4-2,BAL,9,true,37,35,72,169,148,317,15,9,24,2,2:55
567581,2019-06-04,2019,MIL,MIA,0,16,16-0,MIA,9,false,36,50,86,184,150,334,9,23,32,1,3:12
564768,2019-06-09,2019,ANA,SEA,3,9,9-3,SEA,9,false,36,43,79,187,145,332,10,17,27,3,3:17
566798,2019-06-09,2019,TEX,OAK,8,9,9-8,OAK,9,false,44,41,85,152,156,308,17,15,32,1,3:25 (1:05 delay)
567398,2019-06-26,2019,MIA,WAS,5,7,7-5,WAS,9,false,36,42,78,176,147,323,9,15,24,4,3:19
564969,2019-06-26,2019,BAL,SDN,5,10,10-5,SDN,9,false,39,42,81,167,159,326,11,16,27,2,3:18
566598,2019-06-04,2019,SLN,CIN,1,4,4-1,CIN,9,false,36,40,76,150,156,306,10,12,22,2,2:56 (1:20 delay)
566023,2019-06-15,2019,NYN,SLN,8,7,8-7,NYN,9,true,41,42,83,157,140,297,16,17,33,3,3:33
565447,2019-06-12,2019,COL,CHN,1,10,10-1,CHN,9,false,37,45,82,163,126,289,10,20,30,1,2:57
566317,2019-06-29,2019,SDN,SLN,12,2,12-2,SDN,9,true,41,36,77,154,167,321,17,7,24,2,3:05
566616,2019-07-26,2019,SLN,HOU,5,3,5-3,SLN,9,true,36,36,72,157,143,300,12,9,21,2,3:09
565248,2019-06-01,2019,CIN,WAS,2,5,5-2,WAS,9,false,38,37,75,134,161,295,12,10,22,3,2:59
566619,2019-07-30,2019,SLN,CHN,2,1,2-1,SLN,9,true,32,38,70,150,125,275,8,13,21,3,3:05
565155,2019-06-06,2019,CHN,COL,1,3,3-1,COL,9,false,34,34,68,124,121,245,7,7,14,1,2:40
565542,2019-06-08,2019,DET,MIN,9,3,9-3,DET,9,true,44,36,80,148,172,320,21,10,31,0,3:14
565657,2019-07-23,2019,HOU,OAK,3,4,4-3,OAK,11,false,42,43,85,171,139,310,10,11,21,3,3:14
565543,2019-06-09,2019,DET,MIN,2,12,12-2,MIN,9,false,36,49,85,178,147,325,12,22,34,1,3:20
566422,2019-07-21,2019,SEA,ANA,3,9,9-3,ANA,9,false,42,39,81,131,186,317,17,13,30,1,3:15
567218,2019-07-23,2019,ATL,KCA,4,5,5-4,KCA,9,false,43,37,80,166,163,329,16,11,27,3,3:30
566770,2019-06-08,2019,TEX,OAK,10,5,10-5,TEX,9,true,43,38,81,138,188,326,18,13,31,0,3:12
565078,2019-07-27,2019,BOS,NYA,9,5,9-5,BOS,9,true,39,40,79,186,136,322,16,14,30,3,3:34
566308,2019-06-05,2019,SDN,PHI,5,7,7-5,PHI,9,false,42,40,82,158,164,322,16,13,29,4,3:30
566223,2019-07-19,2019,PIT,PHI,1,6,6-1,PHI,9,false,35,46,81,192,134,326,10,20,30,3,3:36
566034,2019-07-24,2019,NYN,SDN,2,7,7-2,SDN,9,false,36,43,79,145,169,314,10,21,31,2,3:20
566117,2019-06-14,2019,OAK,SEA,2,9,9-2,SEA,9,false,38,44,82,160,151,311,12,16,28,1,3:00
565464,2019-07-29,2019,COL,LAN,9,1,9-1,COL,9,true,41,33,74,124,145,269,16,7,23,1,2:51
567507,2019-07-16,2019,NYA,TBA,8,3,8-3,NYA,9,true,34,36,70,132,129,261,13,10,23,4,2:50
567491,2019-06-11,2019,NYA,NYN,12,5,12-5,NYA,9,true,43,38,81,140,167,307,18,9,27,2,3:09
567193,2019-06-10,2019,ATL,PIT,13,7,13-7,ATL,9,true,43,41,84,168,166,334,19,13,32,4,3:35
564858,2019-06-01,2019,ARI,NYN,6,5,6-5,ARI,11,false,45,42,87,163,159,322,16,11,27,3,3:42
565852,2019-07-24,2019,LAN,ANA,2,3,3-2,ANA,9,false,35,35,70,135,153,288,10,9,19,2,3:15
567300,2019-06-16,2019,CHA,NYA,3,10,10-3,NYA,9,false,38,45,83,173,153,326,12,19,31,1,3:06
565463,2019-07-17,2019,COL,SFN,8,11,11-8,SFN,9,false,40,48,88,167,143,310,14,21,35,4,3:28
565448,2019-06-13,2019,COL,SDN,9,6,9-6,COL,9,true,42,40,82,137,176,313,20,13,33,2,3:26
566325,2019-07-26,2019,SDN,SFN,1,2,2-1,SFN,11,false,40,44,84,164,149,313,8,10,18,0,3:32
564782,2019-07-17,2019,ANA,HOU,2,11,11-2,HOU,9,false,37,42,79,161,139,300,11,15,26,2,2:57
566697,2019-06-12,2019,TBA,OAK,2,6,6-2,OAK,9,false,40,41,81,170,145,315,16,16,32,3,3:22
565949,2019-07-29,2019,WAS,ATL,6,3,6-3,WAS,9,true,41,36,77,156,170,326,18,8,26,1,3:23
567307,2019-07-06,2019,CHA,CHN,3,6,6-3,CHN,9,false,39,41,80,175,144,319,11,17,28,6,3:26
565270,2019-07-27,2019,CIN,COL,3,1,3-1,CIN,9,true,31,34,65,124,124,248,10,9,19,3,2:41
565162,2019-06-21,2019,CHN,NYN,4,5,5-4,NYN,9,false,35,37,72,137,150,287,8,12,20,2,3:11
565560,2019-07-24,2019,DET,PHI,0,4,4-0,PHI,9,false,36,39,75,172,167,339,9,13,22,2,3:26
565158,2019-06-09,2019,CHN,SLN,5,1,5-1,CHN,9,true,33,37,70,129,124,253,10,11,21,3,2:48
566696,2019-06-11,2019,TBA,OAK,3,4,4-3,OAK,9,false,34,35,69,133,143,276,7,9,16,0,2:47
564859,2019-06-02,2019,ARI,NYN,7,1,7-1,ARI,9,true,38,32,70,118,137,255,15,6,21,2,2:37
566511,2019-06-29,2019,SFN,ARI,3,4,4-3,ARI,9,false,35,41,76,164,131,295,10,15,25,3,3:18
565055,2019-06-08,2019,BOS,TBA,2,9,9-2,TBA,9,false,33,44,77,201,131,332,6,20,26,1,3:33
566908,2019-07-04,2019,TOR,BOS,7,8,8-7,BOS,9,false,43,39,82,168,161,329,16,12,28,3,3:35
565943,2019-07-23,2019,WAS,COL,11,1,11-1,WAS,9,true,43,37,80,157,165,322,20,11,31,2,3:37
567009,2019-07-20,2019,MIN,OAK,4,5,5-4,OAK,9,false,37,44,81,170,149,319,14,18,32,5,3:30
566618,2019-07-28,2019,SLN,HOU,2,6,6-2,HOU,9,false,40,44,84,171,159,330,12,18,30,1,3:24
566897,2019-06-09,2019,TOR,ARI,2,8,8-2,ARI,9,false,35,44,79,194,135,329,8,17,25,2,3:04
565843,2019-07-03,2019,LAN,ARI,5,4,5-4,LAN,10,false,40,40,80,143,153,296,13,10,23,2,3:19
566031,2019-07-06,2019,NYN,PHI,6,5,6-5,NYN,9,true,38,42,80,154,129,283,16,16,32,4,3:22 (:46 delay)
567191,2019-06-01,2019,ATL,DET,10,5,10-5,ATL,9,true,38,38,76,146,136,282,12,11,23,3,2:51
566136,2019-07-26,2019,OAK,TEX,2,5,5-2,TEX,9,false,35,39,74,162,161,323,8,12,20,2,3:24
564974,2019-07-13,2019,BAL,TBA,4,12,12-4,TBA,9,false,39,44,83,158,156,314,12,17,29,1,3:02
564966,2019-06-15,2019,BAL,BOS,2,7,7-2,BOS,9,false,38,43,81,164,158,322,11,16,27,3,3:19
565924,2019-06-05,2019,WAS,CHA,6,4,6-4,WAS,9,false,37,38,75,136,133,269,12,12,24,3,3:07
566328,2019-07-29,2019,SDN,BAL,8,1,8-1,SDN,9,true,38,40,78,160,133,293,14,11,25,2,2:50
567395,2019-06-15,2019,MIA,PIT,4,3,4-3,MIA,9,true,37,34,71,117,123,240,14,11,25,0,2:46
566015,2019-06-04,2019,NYN,SFN,3,9,9-3,SFN,10,false,41,48,89,186,158,344,13,20,33,2,3:35
566893,2019-06-05,2019,TOR,NYA,11,7,11-7,TOR,9,true,42,40,82,161,179,340,17,13,30,4,3:22
564876,2019-07-19,2019,ARI,MIL,10,7,10-7,ARI,9,true,41,39,80,164,161,325,19,15,34,3,3:44
565081,2019-07-31,2019,BOS,TBA,5,8,8-5,TBA,9,false,41,41,82,167,169,336,13,14,27,4,3:50
565066,2019-06-26,2019,BOS,CHA,7,8,8-7,CHA,9,false,44,41,85,170,160,330,17,16,33,3,3:39
564861,2019-06-04,2019,ARI,LAN,0,9,9-0,LAN,9,false,32,43,75,169,139,308,4,18,22,1,3:07
566817,2019-07-31,2019,TEX,SEA,9,7,9-7,TEX,9,true,43,42,85,173,152,325,20,16,36,3,3:26
567388,2019-06-07,2019,MIA,ATL,1,7,7-1,ATL,9,false,33,44,77,158,115,273,7,18,25,2,2:42
565157,2019-06-08,2019,CHN,SLN,9,4,9-4,CHN,9,true,40,35,75,140,192,332,16,7,23,3,3:27
566327,2019-07-28,2019,SDN,SFN,6,7,7-6,SFN,9,false,35,44,79,152,116,268,10,20,30,1,3:00
565544,2019-06-14,2019,DET,CLE,4,13,13-4,CLE,9,false,37,50,87,194,165,359,10,22,32,1,3:08
564878,2019-07-21,2019,ARI,MIL,4,7,7-4,MIL,9,false,40,39,79,169,165,334,15,13,28,1,3:39
565851,2019-07-23,2019,LAN,ANA,4,5,5-4,ANA,9,false,42,42,84,160,181,341,16,15,31,3,3:54
566225,2019-07-21,2019,PIT,PHI,1,2,2-1,PHI,11,false,43,42,85,172,176,348,13,10,23,0,3:41 (:25 delay)
565465,2019-07-30,2019,COL,LAN,4,9,9-4,LAN,9,false,37,40,77,167,138,305,12,14,26,3,3:12
567408,2019-07-18,2019,MIA,SDN,4,3,4-3,MIA,9,false,40,38,78,168,167,335,14,11,25,1,3:30
567101,2019-06-26,2019,PHI,NYN,5,4,5-4,PHI,10,false,42,43,85,151,146,297,16,14,30,3,3:21
567293,2019-06-01,2019,CHA,CLE,2,5,5-2,CLE,9,false,34,36,70,130,139,269,9,10,19,3,2:50
566021,2019-06-13,2019,NYN,SLN,4,5,5-4,SLN,10,false,37,39,76,172,149,321,8,12,20,1,3:02 (:59 delay)
566613,2019-07-15,2019,SLN,PIT,7,0,7-0,SLN,9,true,37,32,69,100,163,263,14,8,22,2,3:00
567492,2019-06-11,2019,NYA,NYN,4,10,10-4,NYN,9,false,39,44,83,190,144,334,12,17,29,1,3:20
566402,2019-06-02,2019,SEA,ANA,3,13,13-3,ANA,9,false,38,49,87,194,154,348,13,22,35,2,3:22
566221,2019-07-06,2019,PIT,MIL,12,2,12-2,PIT,9,true,44,36,80,140,194,334,22,10,32,0,3:26 (2:30 delay)
565466,2019-07-31,2019,COL,LAN,1,5,5-1,LAN,9,false,32,39,71,163,121,284,7,12,19,2,3:05
566695,2019-06-10,2019,TBA,OAK,6,2,6-2,TBA,9,true,35,35,70,121,138,259,11,8,19,3,2:35
566323,2019-07-13,2019,SDN,ATL,5,7,7-5,ATL,10,false,44,46,90,183,174,357,17,16,33,1,4:05
565758,2019-07-30,2019,KCA,TOR,2,9,9-2,TOR,9,false,43,44,87,178,171,349,16,16,32,1,3:37
566991,2019-06-12,2019,MIN,SEA,6,9,9-6,SEA,10,false,42,50,92,200,158,358,12,19,31,6,3:50
565057,2019-06-10,2019,BOS,TEX,3,4,4-3,TEX,11,false,43,41,84,170,165,335,13,11,24,1,3:25
566504,2019-06-14,2019,SFN,MIL,5,3,5-3,SFN,9,true,33,41,74,162,115,277,11,15,26,2,3:01
565838,2019-06-20,2019,LAN,SFN,9,8,9-8,LAN,9,true,43,40,83,167,155,322,20,12,32,2,3:25
566500,2019-06-08,2019,SFN,LAN,2,7,7-2,LAN,9,false,40,47,87,173,163,336,13,21,34,3,3:41
564770,2019-06-11,2019,ANA,LAN,5,3,5-3,ANA,9,true,35,45,80,189,161,350,12,18,30,3,3:51
566994,2019-06-15,2019,MIN,KCA,5,4,5-4,MIN,9,true,34,40,74,151,126,277,11,11,22,2,3:09
564785,2019-07-26,2019,ANA,BAL,3,9,9-3,BAL,9,false,34,41,75,156,138,294,7,15,22,0,3:00
567219,2019-07-24,2019,ATL,KCA,0,2,2-0,KCA,9,false,32,34,66,151,121,272,6,7,13,0,2:43
566229,2019-07-25,2019,PIT,SLN,3,6,6-3,SLN,9,false,36,38,74,144,115,259,10,10,20,2,2:45
565546,2019-06-16,2019,DET,CLE,0,8,8-0,CLE,9,false,31,45,76,170,117,287,4,21,25,1,2:45
566793,2019-06-04,2019,TEX,BAL,11,12,12-11,BAL,9,false,48,43,91,168,197,365,20,19,39,5,3:42
567108,2019-07-17,2019,PHI,LAN,2,7,7-2,LAN,9,false,36,46,82,203,163,366,9,19,28,3,3:58 (2:37 delay)
566404,2019-06-04,2019,SEA,HOU,5,11,11-5,HOU,9,false,37,44,81,169,180,349,11,19,30,3,3:21
566607,2019-06-23,2019,SLN,ANA,4,6,6-4,ANA,9,false,38,47,85,194,149,343,11,22,33,3,3:42
565950,2019-07-30,2019,WAS,ATL,8,11,11-8,ATL,9,false,44,48,92,181,168,349,17,20,37,3,3:47
566520,2019-07-21,2019,SFN,NYN,3,2,3-2,SFN,12,false,44,44,88,186,164,350,12,9,21,1,3:28
566138,2019-07-28,2019,OAK,TEX,6,5,6-5,OAK,9,false,41,39,80,175,170,345,19,15,34,3,3:38
566698,2019-06-13,2019,TBA,ANA,3,5,5-3,ANA,9,false,38,37,75,139,154,293,12,9,21,1,2:55 (:36 delay)
565350,2019-06-09,2019,CLE,NYA,6,7,7-6,NYA,10,false,41,48,89,200,170,370,10,21,31,4,3:56
565369,2019-07-30,2019,CLE,HOU,0,2,2-0,HOU,9,false,29,35,64,124,130,254,2,10,12,0,2:44
565752,2019-07-18,2019,KCA,CHA,6,5,6-5,KCA,9,true,40,40,80,151,134,285,17,14,31,3,3:03
566427,2019-07-26,2019,SEA,DET,3,2,3-2,SEA,9,false,37,33,70,120,141,261,13,8,21,3,2:51
565060,2019-06-13,2019,BOS,TEX,7,6,7-6,BOS,9,true,36,47,83,212,139,351,11,22,33,3,4:06
567093,2019-06-10,2019,PHI,ARI,8,13,13-8,ARI,9,false,44,46,90,188,176,364,17,20,37,2,3:50 (:30 delay)
565058,2019-06-11,2019,BOS,TEX,5,9,9-5,TEX,9,false,40,44,84,195,171,366,13,17,30,1,3:40
566816,2019-07-30,2019,TEX,SEA,5,8,8-5,SEA,9,false,40,46,86,188,140,328,15,17,32,3,3:16
567510,2019-07-19,2019,NYA,COL,8,2,8-2,NYA,9,true,40,37,77,154,168,322,16,11,27,0,3:15
566428,2019-07-27,2019,SEA,DET,8,1,8-1,SEA,9,true,44,34,78,138,175,313,22,8,30,2,3:02
565450,2019-06-15,2019,COL,SDN,14,8,14-8,COL,9,true,47,44,91,158,174,332,25,18,43,3,3:39
565934,2019-06-22,2019,WAS,ATL,9,13,13-9,ATL,9,false,42,47,89,172,167,339,18,20,38,2,3:42
567491,2019-06-11,2019,NYA,NYN,12,5,12-5,NYA,9,true,43,38,81,140,167,307,18,9,27,2,3:09
564867,2019-06-22,2019,ARI,SFN,4,7,7-4,SFN,9,false,39,39,78,139,177,316,13,13,26,1,3:20
567604,2019-07-23,2019,MIL,CIN,6,14,14-6,CIN,9,false,40,47,87,207,171,378,13,22,35,1,3:28
567603,2019-07-22,2019,MIL,CIN,5,6,6-5,CIN,9,false,42,40,82,142,183,325,16,15,31,5,3:33
567316,2019-07-30,2019,CHA,NYN,2,5,5-2,NYN,11,false,42,49,91,187,158,345,11,17,28,4,3:51
564865,2019-06-20,2019,ARI,COL,4,6,6-4,COL,10,false,48,42,90,173,207,380,20,16,36,2,4:08
565459,2019-07-13,2019,COL,CIN,9,17,17-9,CIN,9,false,42,53,95,202,170,372,18,28,46,4,3:53 (3:08 delay)
566699,2019-06-14,2019,TBA,ANA,9,4,9-4,TBA,9,true,43,41,84,174,188,362,19,15,34,6,3:56
566812,2019-07-13,2019,TEX,HOU,6,7,7-6,HOU,11,false,45,50,95,193,197,390,10,20,30,3,4:09
567600,2019-07-15,2019,MIL,ATL,2,4,4-2,ATL,9,false,36,38,74,142,150,292,9,12,21,1,3:02
566208,2019-06-04,2019,PIT,ATL,5,12,12-5,ATL,9,false,44,49,93,192,170,362,17,21,38,3,3:46
565927,2019-06-15,2019,WAS,ARI,3,10,10-3,ARI,9,false,37,45,82,192,149,341,10,20,30,3,3:30
567205,2019-06-17,2019,ATL,NYN,12,3,12-3,ATL,9,true,47,36,83,116,177,293,23,11,34,3,3:05 (:15 delay)
566522,2019-07-23,2019,SFN,CHN,5,4,5-4,SFN,13,false,48,49,97,173,161,334,14,12,26,2,3:45
565946,2019-07-26,2019,WAS,LAN,2,4,4-2,LAN,9,false,41,35,76,126,159,285,14,8,22,3,3:20
564960,2019-06-01,2019,BAL,SFN,2,8,8-2,SFN,9,false,33,39,72,152,131,283,7,12,19,1,2:48
564880,2019-07-23,2019,ARI,BAL,2,7,7-2,BAL,9,false,32,37,69,152,134,286,8,11,19,1,2:57
564775,2019-06-29,2019,ANA,OAK,0,4,4-0,OAK,9,false,31,37,68,165,121,286,5,12,17,2,2:45
565641,2019-06-14,2019,HOU,TOR,15,2,15-2,HOU,9,true,44,35,79,145,158,303,20,8,28,1,2:53
565362,2019-07-15,2019,CLE,DET,8,6,8-6,CLE,9,true,39,40,79,136,132,268,16,15,31,7,2:55 (:54 delay)
565077,2019-07-26,2019,BOS,NYA,10,5,10-5,BOS,9,true,38,41,79,156,165,321,14,16,30,3,3:16
566502,2019-06-11,2019,SFN,SDN,6,5,6-5,SFN,9,true,36,37,73,155,149,304,13,10,23,2,3:01
565176,2019-07-20,2019,CHN,SDN,6,5,6-5,CHN,9,true,36,39,75,150,140,290,14,12,26,1,3:25
567008,2019-07-19,2019,MIN,OAK,3,5,5-3,OAK,9,false,39,38,77,154,145,299,12,14,26,2,3:21
567203,2019-06-15,2019,ATL,PHI,5,6,6-5,PHI,9,false,39,38,77,168,159,327,13,12,25,4,3:55
564764,2019-06-05,2019,ANA,OAK,10,9,10-9,ANA,9,false,44,45,89,197,183,380,19,20,39,5,4:13
566226,2019-07-22,2019,PIT,SLN,5,6,6-5,SLN,10,false,46,44,90,170,211,381,18,15,33,3,4:05
565839,2019-06-21,2019,LAN,COL,4,2,4-2,LAN,9,false,33,30,63,111,108,219,7,3,10,0,2:12
566413,2019-06-23,2019,SEA,BAL,13,3,13-3,SEA,9,true,44,38,82,141,178,319,20,12,32,1,3:07
566514,2019-07-05,2019,SFN,SLN,4,9,9-4,SLN,9,false,36,45,81,190,148,338,10,20,30,1,3:23
566693,2019-06-01,2019,TBA,MIN,2,6,6-2,MIN,9,false,39,43,82,171,144,315,12,16,28,3,3:39
565938,2019-07-04,2019,WAS,MIA,5,2,5-2,WAS,9,true,36,42,78,167,146,313,13,14,27,3,3:17
567390,2019-06-09,2019,MIA,ATL,6,7,7-6,ATL,12,false,51,55,106,215,189,404,17,20,37,3,4:26
566916,2019-07-27,2019,TOR,TBA,10,9,10-9,TOR,12,false,54,53,107,195,210,405,21,18,39,3,4:07
567585,2019-06-08,2019,MIL,PIT,5,3,5-3,MIL,9,true,42,35,77,144,208,352,19,9,28,2,3:29
564780,2019-07-15,2019,ANA,HOU,9,6,9-6,ANA,9,true,39,44,83,170,145,315,14,19,33,3,3:25
566116,2019-06-02,2019,OAK,HOU,4,6,6-4,HOU,12,false,47,51,98,203,226,429,12,17,29,2,4:24
565736,2019-06-11,2019,KCA,DET,3,2,3-2,KCA,9,true,35,33,68,116,137,253,11,6,17,1,2:35
564964,2019-06-13,2019,BAL,TOR,3,12,12-3,TOR,9,false,37,47,84,201,160,361,10,21,31,2,3:23 (:32 delay)
567010,2019-07-21,2019,MIN,OAK,7,6,7-6,MIN,9,false,46,42,88,195,168,363,20,16,36,3,4:02
567013,2019-07-24,2019,MIN,NYA,7,10,10-7,NYA,9,false,39,43,82,165,158,323,14,17,31,2,3:24
567200,2019-06-12,2019,ATL,PIT,8,7,8-7,ATL,11,false,52,50,102,203,204,407,25,19,44,0,4:17 (:55 delay)
565738,2019-06-13,2019,KCA,DET,7,3,7-3,KCA,9,true,39,41,80,161,166,327,14,13,27,1,3:17
566794,2019-06-05,2019,TEX,BAL,2,1,2-1,TEX,12,false,47,48,95,207,203,410,13,13,26,1,4:18
565445,2019-06-10,2019,COL,CHN,6,5,6-5,COL,9,true,34,37,71,139,118,257,11,10,21,1,2:51
566899,2019-06-18,2019,TOR,ANA,1,3,3-1,ANA,9,false,29,34,63,129,109,238,3,8,11,3,2:30
566120,2019-06-17,2019,OAK,BAL,3,2,3-2,OAK,9,true,33,32,65,117,129,246,9,6,15,1,2:32
565173,2019-07-16,2019,CHN,CIN,4,3,4-3,CHN,10,false,37,42,79,149,166,315,10,14,24,4,3:31
565255,2019-06-19,2019,CIN,HOU,3,2,3-2,CIN,9,false,38,33,71,127,124,251,14,8,22,0,2:38 (:31 delay)
565548,2019-06-26,2019,DET,TEX,1,4,4-1,TEX,9,false,32,36,68,122,108,230,7,12,19,1,2:19
567397,2019-06-25,2019,MIA,WAS,1,6,6-1,WAS,9,false,32,37,69,140,105,245,7,10,17,0,2:27
566516,2019-07-07,2019,SFN,SLN,1,0,1-0,SFN,9,true,27,32,59,120,96,216,4,7,11,0,2:19
564963,2019-06-12,2019,BAL,TOR,6,8,8-6,TOR,9,false,40,44,84,194,180,374,16,16,32,5,4:05
565640,2019-06-12,2019,HOU,MIL,3,6,6-3,MIL,14,false,51,53,104,203,205,408,14,11,25,1,4:16
565739,2019-06-20,2019,KCA,MIN,4,1,4-1,KCA,9,true,33,33,66,111,122,233,11,6,17,0,2:37
565559,2019-07-23,2019,DET,PHI,2,3,3-2,PHI,15,false,56,59,115,222,208,430,15,14,29,2,4:29 (:38 delay)
567590,2019-06-23,2019,MIL,CIN,7,5,7-5,MIL,9,true,38,36,74,126,156,282,15,12,27,2,2:50
567493,2019-06-17,2019,NYA,TBA,3,0,3-0,NYA,9,true,33,29,62,111,139,250,10,3,13,1,2:34
564967,2019-06-16,2019,BAL,BOS,6,8,8-6,BOS,10,false,48,48,96,194,236,430,17,19,36,7,4:44
567209,2019-07-03,2019,ATL,PHI,9,2,9-2,ATL,9,true,36,34,70,140,130,270,11,9,20,1,2:36
566126,2019-06-23,2019,OAK,TBA,2,8,8-2,TBA,9,false,35,43,78,134,148,282,8,19,27,2,2:58
565837,2019-06-19,2019,LAN,SFN,9,2,9-2,LAN,9,true,37,31,68,110,165,275,14,5,19,1,2:47
566213,2019-06-21,2019,PIT,SDN,2,1,2-1,PIT,9,true,30,36,66,140,91,231,7,9,16,0,2:35
565747,2019-07-13,2019,KCA,DET,4,1,4-1,KCA,9,true,33,31,64,116,122,238,12,4,16,0,2:23
566037,2019-07-27,2019,NYN,PIT,3,0,3-0,NYN,9,true,30,31,61,99,115,214,6,5,11,0,2:10
565076,2019-07-25,2019,BOS,NYA,19,3,19-3,BOS,9,true,51,35,86,156,174,330,28,8,36,2,3:28
565833,2019-06-15,2019,LAN,CHN,1,2,2-1,CHN,9,false,33,33,66,125,141,266,7,6,13,1,2:49
565059,2019-06-12,2019,BOS,TEX,4,3,4-3,BOS,9,false,37,36,73,136,143,279,15,9,24,2,2:54
565159,2019-06-18,2019,CHN,CHA,1,3,3-1,CHA,9,false,33,35,68,131,124,255,8,10,18,3,2:44
566601,2019-06-17,2019,SLN,MIA,5,0,5-0,SLN,9,true,33,33,66,127,136,263,8,8,16,1,2:39
567593,2019-06-27,2019,MIL,SEA,4,2,4-2,MIL,9,true,33,35,68,145,117,262,11,6,17,1,2:34
567012,2019-07-23,2019,MIN,NYA,12,14,14-12,NYA,10,false,55,54,109,214,218,432,25,26,51,4,5:03
565744,2019-07-03,2019,KCA,CLE,0,4,4-0,CLE,9,false,32,38,70,138,119,257,6,15,21,2,2:46
566508,2019-06-25,2019,SFN,COL,4,2,4-2,SFN,9,true,35,33,68,132,126,258,13,7,20,0,2:43
567202,2019-06-14,2019,ATL,PHI,9,8,9-8,ATL,9,false,43,41,84,168,177,345,18,14,32,3,3:30
565834,2019-06-16,2019,LAN,CHN,3,2,3-2,LAN,9,true,36,37,73,130,146,276,13,10,23,3,3:05
566215,2019-06-23,2019,PIT,SDN,11,10,11-10,PIT,11,false,55,54,109,229,205,434,23,22,45,2,4:58
566313,2019-06-17,2019,SDN,MIL,2,0,2-0,SDN,9,true,35,32,67,129,152,281,11,7,18,1,2:55
566602,2019-06-18,2019,SLN,MIA,0,6,6-0,MIA,9,false,33,35,68,134,135,269,7,9,16,2,2:43
565929,2019-06-19,2019,WAS,PHI,6,2,6-2,WAS,9,true,36,37,73,142,124,266,13,11,24,1,2:46
566711,2019-07-07,2019,TBA,NYA,2,1,2-1,TBA,9,true,34,33,67,139,139,278,10,6,16,4,2:59
566902,2019-06-28,2019,TOR,KCA,6,2,6-2,TOR,9,true,35,37,72,135,130,265,11,12,23,4,2:47
564874,2019-07-07,2019,ARI,COL,5,3,5-3,ARI,9,true,34,32,66,123,127,250,9,5,14,0,2:36
565261,2019-07-03,2019,CIN,MIL,3,0,3-0,CIN,9,true,34,32,66,125,137,262,11,6,17,1,2:40
567096,2019-06-21,2019,PHI,MIA,1,2,2-1,MIA,9,false,39,35,74,125,128,253,14,8,22,1,2:56
565254,2019-06-18,2019,CIN,HOU,4,3,4-3,CIN,9,true,31,35,66,136,126,262,8,11,19,3,2:55 (:28 delay)
566036,2019-07-26,2019,NYN,PIT,6,3,6-3,NYN,9,true,31,35,66,117,108,225,7,8,15,2,2:21
566507,2019-06-24,2019,SFN,COL,0,2,2-0,COL,9,false,34,35,69,141,141,282,8,8,16,0,2:45
565644,2019-06-25,2019,HOU,PIT,5,1,5-1,HOU,9,true,36,36,72,134,132,266,11,10,21,1,2:57
566418,2019-07-06,2019,SEA,OAK,6,3,6-3,SEA,9,true,34,35,69,121,125,246,10,7,17,1,2:31
565354,2019-06-22,2019,CLE,DET,2,0,2-0,CLE,9,true,31,36,67,144,135,279,9,9,18,1,2:47
564864,2019-06-19,2019,ARI,COL,4,6,6-4,COL,9,false,39,37,76,114,122,236,13,14,27,2,2:55
566217,2019-07-02,2019,PIT,CHN,5,1,5-1,PIT,9,true,33,33,66,132,119,251,10,8,18,1,2:43 (2:05 delay)
564980,2019-07-21,2019,BAL,BOS,5,0,5-0,BAL,9,true,32,31,63,128,133,261,11,5,16,1,2:44
566420,2019-07-19,2019,SEA,ANA,10,0,10-0,SEA,9,true,39,29,68,98,154,252,17,2,19,1,2:32
565174,2019-07-17,2019,CHN,CIN,5,2,5-2,CHN,9,true,32,35,67,123,138,261,8,10,18,2,3:07
565063,2019-06-23,2019,BOS,TOR,1,6,6-1,TOR,9,false,36,41,77,146,145,291,9,16,25,0,3:04
567297,2019-06-13,2019,CHA,NYA,5,4,5-4,CHA,9,true,37,37,74,157,153,310,14,11,25,2,3:14
566799,2019-06-17,2019,TEX,CLE,7,2,7-2,TEX,9,true,36,34,70,135,153,288,12,8,20,1,2:52
567295,2019-06-10,2019,CHA,WAS,1,12,12-1,WAS,9,false,31,46,77,188,104,292,6,21,27,4,3:06
567394,2019-06-14,2019,MIA,PIT,0,11,11-0,PIT,9,false,37,44,81,153,133,286,11,20,31,0,2:56
567097,2019-06-22,2019,PHI,MIA,3,5,5-3,MIA,9,false,36,35,71,111,140,251,11,9,20,2,2:43
567501,2019-06-25,2019,NYA,TOR,4,3,4-3,NYA,9,true,34,35,69,159,115,274,14,7,21,1,2:47
565931,2019-06-19,2019,WAS,PHI,2,0,2-0,WAS,9,true,30,33,63,142,138,280,7,6,13,1,3:05
565929,2019-06-19,2019,WAS,PHI,6,2,6-2,WAS,9,true,36,37,73,142,124,266,13,11,24,1,2:46
565367,2019-07-20,2019,CLE,KCA,0,1,1-0,KCA,9,false,33,34,67,138,135,273,6,8,14,0,2:41
566706,2019-07-02,2019,TBA,BAL,6,3,6-3,TBA,9,true,36,34,70,136,151,287,12,7,19,2,2:43
567303,2019-06-30,2019,CHA,MIN,4,3,4-3,CHA,9,true,33,34,67,131,126,257,12,6,18,3,2:47 (2:54 delay)
565759,2019-07-31,2019,KCA,TOR,1,4,4-1,TOR,9,false,32,39,71,126,114,240,6,13,19,1,2:23
565836,2019-06-18,2019,LAN,SFN,9,0,9-0,LAN,9,true,43,33,76,137,142,279,20,7,27,2,2:59
565446,2019-06-11,2019,COL,CHN,10,3,10-3,COL,9,true,40,37,77,138,157,295,20,11,31,2,3:10
567594,2019-06-28,2019,MIL,PIT,2,3,3-2,PIT,9,false,33,38,71,136,134,270,9,14,23,0,3:00
567301,2019-06-28,2019,CHA,MIN,6,4,6-4,CHA,9,true,35,38,73,150,108,258,9,14,23,4,2:56
566512,2019-06-27,2019,SFN,ARI,1,5,5-1,ARI,9,false,33,37,70,143,118,261,6,12,18,3,2:42
566910,2019-07-06,2019,TOR,BAL,1,8,8-1,BAL,9,false,31,40,71,149,115,264,4,14,18,1,2:30
566606,2019-06-22,2019,SLN,ANA,4,2,4-2,SLN,9,true,32,35,67,157,119,276,7,8,15,2,2:59 (:16 delay)
566914,2019-07-24,2019,TOR,CLE,0,4,4-0,CLE,9,false,29,36,65,137,102,239,3,10,13,0,2:24
566702,2019-06-28,2019,TBA,TEX,0,5,5-0,TEX,9,false,32,38,70,148,125,273,5,13,18,0,2:48
566406,2019-06-06,2019,SEA,HOU,7,8,8-7,HOU,14,false,62,61,123,226,258,484,20,23,43,4,5:06
567498,2019-06-22,2019,NYA,HOU,7,5,7-5,NYA,9,true,35,43,78,162,145,307,11,18,29,1,3:08
565835,2019-06-17,2019,LAN,SFN,2,3,3-2,SFN,9,false,37,35,72,155,133,288,10,8,18,0,3:11
566121,2019-06-18,2019,OAK,BAL,16,2,16-2,OAK,9,true,44,32,76,122,169,291,19,5,24,2,2:28
567400,2019-06-28,2019,MIA,PHI,6,2,6-2,MIA,9,true,34,34,68,137,146,283,11,7,18,2,2:56
564968,2019-06-25,2019,BAL,SDN,3,8,8-3,SDN,9,false,38,41,79,133,135,268,13,16,29,1,2:47
565549,2019-06-27,2019,DET,TEX,1,3,3-1,TEX,9,false,36,35,71,151,138,289,11,8,19,0,2:52
565547,2019-06-25,2019,DET,TEX,3,5,5-3,TEX,9,false,36,41,77,145,133,278,9,14,23,1,2:47
565166,2019-06-25,2019,CHN,ATL,2,3,3-2,ATL,9,false,33,35,68,168,129,297,10,8,18,2,2:59
565650,2019-07-05,2019,HOU,ANA,4,5,5-4,ANA,9,false,37,35,72,133,137,270,10,10,20,1,2:54
565646,2019-06-27,2019,HOU,PIT,0,10,10-0,PIT,9,false,35,41,76,151,121,272,9,16,25,0,2:51
566907,2019-07-03,2019,TOR,BOS,6,3,6-3,TOR,9,true,39,35,74,125,149,274,17,9,26,3,3:01
565461,2019-07-15,2019,COL,SFN,1,2,2-1,SFN,9,false,32,35,67,145,120,265,7,9,16,1,2:42 (:21 delay)
566909,2019-07-05,2019,TOR,BAL,1,4,4-1,BAL,9,false,33,36,69,149,129,278,6,11,17,2,2:48
565847,2019-07-07,2019,LAN,SDN,3,5,5-3,SDN,9,false,33,34,67,138,126,264,7,8,15,2,2:58
566905,2019-07-01,2019,TOR,KCA,11,4,11-4,TOR,9,true,43,35,78,110,157,267,22,10,32,0,2:32
565449,2019-06-14,2019,COL,SDN,12,16,16-12,SDN,12,false,58,62,120,240,220,460,22,27,49,3,5:04
565932,2019-06-20,2019,WAS,PHI,7,4,7-4,WAS,9,true,36,38,74,162,136,298,15,14,29,2,3:05 (:30 delay)
566022,2019-06-14,2019,NYN,SLN,5,9,9-5,SLN,9,false,41,39,80,177,140,317,14,12,26,2,3:05
565832,2019-06-14,2019,LAN,CHN,5,3,5-3,LAN,9,true,37,36,73,133,165,298,13,8,21,3,3:06
566999,2019-06-25,2019,MIN,TBA,9,4,9-4,MIN,9,true,40,35,75,121,154,275,18,9,27,1,3:03
564868,2019-06-23,2019,ARI,SFN,3,2,3-2,ARI,10,false,37,36,73,152,143,295,11,7,18,2,3:13
566212,2019-06-19,2019,PIT,DET,8,7,8-7,PIT,9,true,37,38,75,125,143,268,13,12,25,1,2:52
567499,2019-06-23,2019,NYA,HOU,4,9,9-4,HOU,9,false,34,40,74,133,152,285,8,16,24,1,2:48
567105,2019-07-14,2019,PHI,WAS,4,3,4-3,PHI,9,false,34,36,70,147,112,259,10,12,22,1,2:54
564772,2019-06-26,2019,ANA,CIN,5,1,5-1,ANA,9,true,35,34,69,134,152,286,11,6,17,1,2:42
566133,2019-07-16,2019,OAK,SEA,9,2,9-2,OAK,9,true,37,33,70,124,138,262,14,6,20,0,2:43
565940,2019-07-06,2019,WAS,KCA,6,0,6-0,WAS,9,true,35,34,69,135,130,265,14,8,22,0,2:44
565654,2019-07-20,2019,HOU,TEX,6,1,6-1,HOU,9,true,37,29,66,127,134,261,13,2,15,1,2:25
567508,2019-07-18,2019,NYA,TBA,5,1,5-1,NYA,9,true,34,38,72,166,122,288,12,11,23,3,2:46
567207,2019-06-19,2019,ATL,NYN,7,2,7-2,ATL,9,true,37,36,73,144,153,297,14,11,25,3,3:03
567399,2019-06-27,2019,MIA,WAS,5,8,8-5,WAS,9,false,37,39,76,128,139,267,10,12,22,1,2:51
565358,2019-06-26,2019,CLE,KCA,5,3,5-3,CLE,9,true,36,37,73,166,135,301,13,11,24,1,2:49
564870,2019-06-25,2019,ARI,LAN,2,3,3-2,LAN,9,false,35,36,71,134,150,284,8,11,19,1,3:07
565163,2019-06-22,2019,CHN,NYN,2,10,10-2,NYN,9,false,36,42,78,148,134,282,10,16,26,1,3:01
566804,2019-06-22,2019,TEX,CHA,6,5,6-5,TEX,9,true,38,35,73,138,151,289,17,8,25,3,3:04
567211,2019-07-05,2019,ATL,MIA,1,0,1-0,ATL,9,false,34,36,70,157,129,286,13,10,23,0,3:00 (2:28 delay)
565558,2019-07-21,2019,DET,TOR,4,3,4-3,DET,10,false,39,36,75,136,149,285,15,7,22,1,2:58
565165,2019-06-24,2019,CHN,ATL,8,3,8-3,CHN,9,true,35,35,70,148,133,281,14,8,22,2,3:01
566417,2019-07-05,2019,SEA,OAK,2,5,5-2,OAK,9,false,31,35,66,141,121,262,5,9,14,2,2:51
565056,2019-06-09,2019,BOS,TBA,1,6,6-1,TBA,9,false,37,43,80,165,156,321,10,17,27,2,3:32
565250,2019-06-14,2019,CIN,TEX,1,7,7-1,TEX,9,false,33,43,76,197,143,340,6,16,22,2,3:08
567494,2019-06-18,2019,NYA,TBA,6,3,6-3,NYA,9,true,37,37,74,152,150,302,13,11,24,3,3:09 (1:16 delay)
566222,2019-07-07,2019,PIT,MIL,6,5,6-5,PIT,9,true,37,37,74,147,134,281,15,11,26,3,3:04 (:40 delay)
565649,2019-06-30,2019,HOU,SEA,6,1,6-1,HOU,9,true,39,33,72,146,154,300,16,8,24,1,2:52
567497,2019-06-21,2019,NYA,HOU,4,1,4-1,NYA,9,true,31,40,71,176,125,301,8,14,22,2,3:06
567206,2019-06-18,2019,ATL,NYN,2,10,10-2,NYN,9,false,33,48,81,170,123,293,6,24,30,1,3:04 (:10 delay)
565065,2019-06-25,2019,BOS,CHA,6,3,6-3,BOS,9,true,35,38,73,153,145,298,12,11,23,0,3:24 (:24 delay)
564773,2019-06-27,2019,ANA,OAK,8,3,8-3,ANA,9,true,37,32,69,125,150,275,16,7,23,1,2:46
567100,2019-06-25,2019,PHI,NYN,7,5,7-5,PHI,9,true,37,43,80,148,134,282,12,16,28,3,3:07
565935,2019-06-23,2019,WAS,ATL,3,4,4-3,ATL,10,false,40,39,79,144,135,279,12,10,22,2,3:09
566324,2019-07-14,2019,SDN,ATL,1,4,4-1,ATL,9,false,38,38,76,147,130,277,12,10,22,3,3:15
566610,2019-07-12,2019,SLN,ARI,2,4,4-2,ARI,9,false,35,34,69,137,145,282,7,9,16,3,2:56
567217,2019-07-21,2019,ATL,WAS,7,1,7-1,ATL,9,true,39,32,71,105,165,270,17,6,23,4,3:02
566911,2019-07-07,2019,TOR,BAL,6,1,6-1,TOR,9,true,36,34,70,147,134,281,13,7,20,3,2:44
565845,2019-07-05,2019,LAN,SDN,2,3,3-2,SDN,9,false,37,36,73,123,141,264,8,8,16,1,2:58
567208,2019-07-02,2019,ATL,PHI,0,2,2-0,PHI,9,false,33,36,69,124,132,256,7,10,17,1,2:48
567113,2019-07-30,2019,PHI,SFN,4,2,4-2,PHI,9,true,38,31,69,135,134,269,14,7,21,0,2:47
566614,2019-07-16,2019,SLN,PIT,1,3,3-1,PIT,9,false,33,35,68,135,126,261,8,11,19,1,3:04
565751,2019-07-17,2019,KCA,CHA,7,5,7-5,KCA,9,true,38,35,73,152,134,286,19,11,30,3,3:11
564872,2019-07-05,2019,ARI,COL,8,0,8-0,ARI,9,true,35,34,69,141,124,265,13,6,19,1,2:52
565643,2019-06-16,2019,HOU,TOR,0,12,12-0,TOR,9,false,37,45,82,174,141,315,13,18,31,1,3:02
565160,2019-06-19,2019,CHN,CHA,7,3,7-3,CHN,9,true,37,38,75,172,142,314,14,12,26,3,3:18
565930,2019-09-24,2019,WAS,PHI,4,1,4-1,WAS,9,true,35,33,68,133,150,283,11,7,18,2,3:07
564869,2019-06-24,2019,ARI,LAN,8,5,8-5,ARI,9,true,37,42,79,150,137,287,14,17,31,4,3:12
567204,2019-06-16,2019,ATL,PHI,15,1,15-1,ATL,9,true,46,36,82,142,157,299,24,11,35,1,3:09
567098,2019-06-23,2019,PHI,MIA,4,6,6-4,MIA,9,false,36,43,79,146,147,293,9,22,31,0,2:59
566025,2019-06-28,2019,NYN,ATL,2,6,6-2,ATL,9,false,36,39,75,149,138,287,9,13,22,1,2:55
565550,2019-06-28,2019,DET,WAS,1,3,3-1,WAS,9,false,37,36,73,140,158,298,9,10,19,1,3:04
567213,2019-07-07,2019,ATL,MIA,4,3,4-3,ATL,9,true,38,37,75,139,141,280,16,11,27,2,3:02 (:26 delay)
565353,2019-06-21,2019,CLE,DET,7,6,7-6,CLE,9,true,38,40,78,160,138,298,14,14,28,4,3:16
565936,2019-07-02,2019,WAS,MIA,3,2,3-2,WAS,9,false,37,33,70,118,161,279,10,8,18,0,3:01 (1:16 delay)
566130,2019-07-12,2019,OAK,CHA,5,1,5-1,OAK,9,true,37,38,75,144,146,290,15,12,27,4,3:10
566611,2019-07-13,2019,SLN,ARI,4,2,4-2,SLN,9,true,37,37,74,135,132,267,11,10,21,3,3:04
567314,2019-07-27,2019,CHA,MIN,5,1,5-1,CHA,9,true,37,32,69,126,135,261,11,6,17,2,3:04
564789,2019-07-30,2019,ANA,DET,6,1,6-1,ANA,9,true,38,38,76,139,130,269,14,10,24,1,2:52
566409,2019-06-19,2019,SEA,KCA,8,2,8-2,SEA,9,true,38,37,75,144,155,299,15,11,26,1,2:51
565551,2019-06-29,2019,DET,WAS,7,5,7-5,DET,9,true,40,37,77,156,146,302,18,11,29,4,3:13
566129,2019-07-04,2019,OAK,MIN,7,2,7-2,OAK,9,true,40,40,80,156,147,303,17,14,31,1,3:20
565742,2019-06-23,2019,KCA,MIN,6,1,6-1,KCA,9,true,34,39,73,176,132,308,11,12,23,2,3:09
565168,2019-06-27,2019,CHN,ATL,9,7,9-7,CHN,9,true,36,39,75,157,137,294,11,14,25,1,3:02
565274,2019-07-31,2019,CIN,PIT,4,1,4-1,CIN,9,true,36,34,70,129,120,249,14,7,21,2,2:45
566803,2019-06-21,2019,TEX,CHA,4,5,5-4,CHA,10,false,39,44,83,149,161,310,11,15,26,4,3:23
564971,2019-06-29,2019,BAL,CLE,13,0,13-0,BAL,9,true,45,32,77,124,174,298,22,6,28,3,2:57 (1:05 delay)
566415,2019-07-03,2019,SEA,SLN,2,5,5-2,SLN,9,false,34,36,70,132,154,286,8,10,18,5,2:58
566704,2019-06-30,2019,TBA,TEX,6,2,6-2,TBA,9,true,36,30,66,112,134,246,11,4,15,2,2:28
566806,2019-08-20,2019,TEX,ANA,1,5,5-1,ANA,9,false,32,39,71,163,118,281,5,13,18,1,2:48
567000,2019-06-26,2019,MIN,TBA,6,4,6-4,MIN,9,true,35,36,71,142,129,271,11,10,21,4,2:57
565756,2019-07-28,2019,KCA,CLE,9,6,9-6,KCA,9,true,40,38,78,125,151,276,16,11,27,3,2:55
567308,2019-07-07,2019,CHA,CHN,3,1,3-1,CHA,9,true,34,34,68,131,150,281,11,9,20,3,2:54
565928,2019-06-16,2019,WAS,ARI,15,5,15-5,WAS,9,true,43,42,85,151,167,318,21,14,35,2,3:14
566408,2019-06-18,2019,SEA,KCA,0,9,9-0,KCA,9,false,35,42,77,169,140,309,8,16,24,1,3:06
567495,2019-06-19,2019,NYA,TBA,12,1,12-1,NYA,9,true,40,35,75,141,187,328,17,7,24,3,3:21
566124,2019-06-21,2019,OAK,TBA,3,5,5-3,TBA,9,false,37,38,75,152,155,307,12,12,24,4,3:20
566316,2019-06-28,2019,SDN,SLN,3,1,3-1,SDN,9,true,30,38,68,171,97,268,9,12,21,1,2:49
566127,2019-07-02,2019,OAK,MIN,8,6,8-6,OAK,9,true,37,37,74,143,159,302,14,11,25,4,3:20
565257,2019-06-29,2019,CIN,CHN,0,6,6-0,CHN,9,false,36,39,75,142,145,287,10,13,23,2,3:00
566710,2019-07-06,2019,TBA,NYA,4,3,4-3,TBA,9,false,35,40,75,180,109,289,11,15,26,3,3:28
566122,2019-06-19,2019,OAK,BAL,8,3,8-3,OAK,9,true,39,38,77,155,150,305,15,11,26,5,3:08
566134,2019-07-17,2019,OAK,SEA,10,2,10-2,OAK,9,true,37,36,73,143,152,295,14,10,24,1,2:49
567633,2019-07-09,2019,AAS,NAS,4,3,4-3,AAS,9,true,31,35,66,152,104,256,9,8,17,1,2:48
565171,2019-07-14,2019,CHN,PIT,8,3,8-3,CHN,9,true,40,36,76,131,130,261,20,11,31,1,2:52
565552,2019-06-30,2019,DET,WAS,1,2,2-1,WAS,9,false,33,39,72,153,138,291,6,12,18,2,2:53
564965,2019-06-14,2019,BAL,BOS,2,13,13-2,BOS,9,false,36,50,86,203,149,352,10,25,35,2,3:24
566211,2019-06-18,2019,PIT,DET,4,5,5-4,DET,9,false,40,37,77,154,161,315,13,11,24,2,3:09
566214,2019-06-22,2019,PIT,SDN,6,3,6-3,PIT,9,true,37,40,77,167,149,316,17,14,31,1,3:18
565256,2019-06-28,2019,CIN,CHN,6,3,6-3,CIN,9,true,40,36,76,145,158,303,18,9,27,4,3:12
566319,2019-07-01,2019,SDN,SFN,2,13,13-2,SFN,9,false,36,46,82,182,128,310,7,18,25,2,3:12
566605,2019-06-21,2019,SLN,ANA,5,1,5-1,SLN,9,true,38,34,72,148,154,302,14,10,24,3,3:24
564875,2019-07-18,2019,ARI,MIL,1,5,5-1,MIL,9,false,34,35,69,135,132,267,10,10,20,1,2:59
566421,2019-07-20,2019,SEA,ANA,2,6,6-2,ANA,9,false,34,40,74,184,134,318,8,13,21,1,3:23
566320,2019-07-02,2019,SDN,SFN,4,10,10-4,SFN,9,false,35,48,83,162,147,309,9,22,31,0,3:12
567003,2019-07-06,2019,MIN,TEX,7,4,7-4,MIN,9,true,37,36,73,155,153,308,13,9,22,1,3:12
566712,2019-07-19,2019,TBA,CHA,2,9,9-2,CHA,9,false,36,45,81,178,136,314,9,18,27,1,3:20
564787,2019-07-28,2019,ANA,BAL,5,4,5-4,ANA,9,false,35,35,70,140,149,289,11,9,20,3,3:02
565167,2019-06-26,2019,CHN,ATL,3,5,5-3,ATL,9,false,38,35,73,141,138,279,14,9,23,3,3:02 (:48 delay)
564977,2019-07-17,2019,BAL,WAS,9,2,9-2,BAL,9,true,37,36,73,158,122,280,17,9,26,5,2:51 (1:32 delay)
566027,2019-06-30,2019,NYN,ATL,8,5,8-5,NYN,9,true,39,39,78,159,132,291,16,13,29,4,3:27
564945,2019-07-13,2019,BAL,TBA,2,1,2-1,BAL,9,true,31,33,64,149,156,305,7,8,15,4,3:02
565750,2019-07-16,2019,KCA,CHA,11,0,11-0,KCA,9,true,41,32,73,116,159,275,17,6,23,0,2:44
566992,2019-06-13,2019,MIN,SEA,10,5,10-5,MIN,9,true,46,40,86,171,182,353,21,13,34,6,3:49
566801,2019-06-19,2019,TEX,CLE,4,10,10-4,CLE,9,false,41,41,82,155,162,317,14,18,32,4,3:17
566412,2019-06-22,2019,SEA,BAL,4,8,8-4,BAL,9,false,38,41,79,168,157,325,10,16,26,0,3:05
564970,2019-06-28,2019,BAL,CLE,13,0,13-0,BAL,9,true,43,34,77,147,174,321,20,8,28,2,2:56
566903,2019-06-29,2019,TOR,KCA,7,5,7-5,TOR,9,false,36,40,76,154,162,316,13,13,26,1,3:22
565746,2019-07-12,2019,KCA,DET,8,5,8-5,KCA,9,true,36,39,75,159,137,296,13,13,26,2,3:07
567273,2019-07-03,2019,CHA,DET,7,5,7-5,CHA,9,true,37,39,76,162,152,314,16,12,28,3,3:05
567107,2019-07-16,2019,PHI,LAN,9,8,9-8,PHI,9,false,39,37,76,145,146,291,12,10,22,3,3:10 (:22 delay)
564863,2019-06-18,2019,ARI,COL,1,8,8-1,COL,9,false,38,42,80,143,126,269,11,15,26,1,2:51
566218,2019-07-03,2019,PIT,CHN,6,5,6-5,PIT,9,false,38,40,78,153,116,269,13,13,26,2,3:19
566998,2019-06-19,2019,MIN,BOS,4,9,9-4,BOS,9,false,39,46,85,176,145,321,13,22,35,1,3:22
566705,2019-07-01,2019,TBA,BAL,6,3,6-3,TBA,9,true,36,38,74,157,142,299,14,12,26,2,3:11
566032,2019-07-07,2019,NYN,PHI,3,8,8-3,PHI,9,false,37,41,78,166,134,300,9,17,26,2,3:20
567410,2019-07-27,2019,MIA,ARI,2,9,9-2,ARI,9,false,35,38,73,151,126,277,10,12,22,1,2:49
565553,2019-07-05,2019,DET,BOS,6,9,9-6,BOS,9,false,38,45,83,177,153,330,11,18,29,1,3:22 (2:04 delay)
566603,2019-06-19,2019,SLN,MIA,2,1,2-1,SLN,11,false,43,38,81,154,178,332,13,6,19,3,3:34
566707,2019-07-03,2019,TBA,BAL,6,9,9-6,BAL,9,false,38,44,82,168,145,313,12,15,27,2,3:11
566407,2019-06-17,2019,SEA,KCA,4,6,6-4,KCA,9,false,40,37,77,130,188,318,15,10,25,2,3:22
565357,2019-06-25,2019,CLE,KCA,6,8,8-6,KCA,9,false,39,43,82,161,160,321,13,17,30,5,3:27
567401,2019-06-29,2019,MIA,PHI,9,6,9-6,MIA,9,true,41,40,81,160,143,303,17,12,29,2,3:19
565743,2019-07-02,2019,KCA,CLE,5,9,9-5,CLE,9,false,38,45,83,185,137,322,13,18,31,3,3:22
567102,2019-06-27,2019,PHI,NYN,6,3,6-3,PHI,9,false,38,35,73,140,177,317,12,7,19,1,3:24
567404,2019-07-13,2019,MIA,NYN,2,4,4-2,NYN,9,false,34,39,73,161,132,293,7,14,21,0,3:05
566515,2019-07-06,2019,SFN,SLN,8,4,8-4,SFN,9,true,38,38,76,136,153,289,13,12,25,1,3:13
564774,2019-06-28,2019,ANA,OAK,2,7,7-2,OAK,9,false,37,38,75,158,141,299,10,12,22,2,3:15
565653,2019-07-19,2019,HOU,TEX,4,3,4-3,HOU,9,true,32,41,73,167,130,297,10,13,23,0,2:59
565260,2019-07-02,2019,CIN,MIL,5,4,5-4,CIN,11,false,42,40,82,151,153,304,12,9,21,3,3:19
564777,2019-07-12,2019,ANA,SEA,13,0,13-0,ANA,9,true,47,28,75,103,196,299,21,1,22,2,2:54
566030,2019-07-05,2019,NYN,PHI,2,7,7-2,PHI,9,false,35,41,76,156,127,283,9,14,23,3,3:15
565937,2019-07-03,2019,WAS,MIA,3,1,3-1,WAS,9,true,35,36,71,148,152,300,13,10,23,2,3:07
567110,2019-07-26,2019,PHI,ATL,2,9,9-2,ATL,9,false,38,40,78,155,144,299,13,15,28,1,3:02
566608,2019-06-25,2019,SLN,OAK,3,7,7-3,OAK,9,false,42,38,80,138,197,335,15,11,26,2,3:28
565451,2019-06-16,2019,COL,SDN,13,14,14-13,SDN,9,false,48,46,94,186,156,342,22,23,45,2,3:31 (1:03 delay)
565252,2019-06-16,2019,CIN,TEX,11,3,11-3,CIN,9,true,45,35,80,155,193,348,21,9,30,2,3:21 (1:34 delay)
567592,2019-06-26,2019,MIL,SEA,2,4,4-2,SEA,9,false,35,39,74,182,150,332,8,13,21,0,3:11
567210,2019-07-04,2019,ATL,PHI,12,6,12-6,ATL,9,true,40,42,82,166,171,337,18,17,35,2,3:32
567099,2019-06-24,2019,PHI,NYN,13,7,13-7,PHI,9,true,47,44,91,156,162,318,24,19,43,1,3:18
567512,2019-07-21,2019,NYA,COL,4,8,8-4,COL,9,false,34,44,78,171,129,300,7,18,25,3,3:13
565846,2019-07-06,2019,LAN,SDN,1,3,3-1,SDN,9,false,35,32,67,110,145,255,8,6,14,2,2:52
565740,2019-06-21,2019,KCA,MIN,7,8,8-7,MIN,9,false,38,44,82,172,137,309,11,17,28,3,3:27
565842,2019-07-02,2019,LAN,ARI,5,4,5-4,LAN,9,false,40,39,79,131,166,297,15,14,29,4,3:26
567601,2019-07-16,2019,MIL,ATL,13,1,13-1,MIL,9,true,47,34,81,129,188,317,24,7,31,2,3:29
564779,2019-07-14,2019,ANA,SEA,6,3,6-3,ANA,9,true,37,37,74,162,164,326,13,12,25,3,3:28
566506,2019-06-16,2019,SFN,MIL,3,5,5-3,MIL,9,false,38,41,79,176,161,337,12,15,27,1,3:18
565068,2019-06-30,2019,BOS,NYA,8,12,12-8,NYA,9,false,42,50,92,229,145,374,16,23,39,4,4:24
567413,2019-07-30,2019,MIA,MIN,1,2,2-1,MIN,9,false,33,34,67,142,151,293,6,10,16,1,3:11
565360,2019-07-13,2019,CLE,MIN,2,6,6-2,MIN,9,false,33,42,75,166,137,303,8,14,22,4,3:24
564975,2019-07-14,2019,BAL,TBA,1,4,4-1,TBA,9,false,30,35,65,157,122,279,3,9,12,4,2:45
566227,2019-07-23,2019,PIT,SLN,3,4,4-3,SLN,9,false,35,36,71,127,122,249,9,9,18,1,2:46
566224,2019-07-20,2019,PIT,PHI,5,1,5-1,PIT,9,true,39,33,72,136,131,267,16,7,23,0,2:57 (:28 delay)
565079,2019-07-28,2019,BOS,NYA,6,9,9-6,NYA,9,false,42,41,83,156,154,310,14,15,29,3,3:28
566028,2019-07-02,2019,NYN,NYA,4,2,4-2,NYN,9,true,36,35,71,166,139,305,15,8,23,2,3:11
567216,2019-07-20,2019,ATL,WAS,3,5,5-3,WAS,9,false,40,41,81,132,165,297,13,18,31,3,3:14
565951,2019-07-31,2019,WAS,ATL,4,5,5-4,ATL,10,false,39,42,81,152,145,297,13,14,27,2,3:14
567109,2019-07-18,2019,PHI,LAN,7,6,7-6,PHI,9,true,37,39,76,162,148,310,13,14,27,3,3:27
565258,2019-06-30,2019,CIN,CHN,8,6,8-6,CIN,9,true,38,42,80,146,171,317,15,15,30,4,3:20
565757,2019-07-29,2019,KCA,TOR,3,7,7-3,TOR,9,false,36,41,77,151,148,299,9,14,23,3,2:55
567607,2019-07-27,2019,MIL,CHN,5,3,5-3,MIL,10,false,40,39,79,158,149,307,16,9,25,4,3:32
567006,2019-07-17,2019,MIN,NYN,4,14,14-4,NYN,9,false,36,48,84,166,136,302,10,20,30,0,3:16
565366,2019-07-19,2019,CLE,KCA,10,5,10-5,CLE,9,true,43,38,81,144,160,304,22,15,37,2,3:20
565271,2019-07-28,2019,CIN,COL,3,2,3-2,CIN,9,true,36,41,77,161,159,320,13,14,27,2,3:32
566206,2019-06-01,2019,PIT,MIL,10,12,12-10,MIL,13,false,61,63,124,276,237,513,27,24,51,3,5:23
567306,2019-07-04,2019,CHA,DET,5,11,11-5,DET,9,false,41,44,85,166,163,329,14,16,30,4,3:27
566901,2019-06-20,2019,TOR,ANA,7,5,7-5,TOR,10,false,43,44,87,173,159,332,18,15,33,5,3:34
567403,2019-07-12,2019,MIA,NYN,8,4,8-4,MIA,9,true,34,36,70,154,130,284,12,10,22,2,2:57
566419,2019-07-07,2019,SEA,OAK,4,7,7-4,OAK,9,false,37,38,75,148,161,309,11,11,22,3,3:15
566132,2019-07-14,2019,OAK,CHA,3,2,3-2,OAK,9,false,34,33,67,131,140,271,9,8,17,1,2:47
565458,2019-07-12,2019,COL,CIN,3,2,3-2,COL,9,true,34,32,66,122,127,249,11,6,17,1,2:40
567005,2019-07-16,2019,MIN,NYN,2,3,3-2,NYN,9,false,39,35,74,123,163,286,15,9,24,3,3:13
566809,2019-07-04,2019,TEX,ANA,9,3,9-3,TEX,9,true,43,39,82,148,175,323,19,12,31,1,3:27
566510,2019-06-28,2019,SFN,ARI,6,3,6-3,SFN,9,true,38,40,78,155,113,268,16,13,29,2,3:07
565070,2019-07-13,2019,BOS,LAN,2,11,11-2,LAN,9,false,33,46,79,198,124,322,7,20,27,2,3:40
565074,2019-07-17,2019,BOS,TOR,5,4,5-4,BOS,9,true,40,40,80,173,150,323,19,13,32,2,3:35 (:33 delay)
565265,2019-07-18,2019,CIN,SLN,4,7,7-4,SLN,9,false,40,38,78,161,149,310,15,15,30,2,3:17
566509,2019-06-26,2019,SFN,COL,3,6,6-3,COL,9,false,36,36,72,148,151,299,11,9,20,1,2:54
567496,2019-06-20,2019,NYA,HOU,10,6,10-6,NYA,9,true,41,42,83,177,188,365,17,15,32,2,3:31 (:37 delay)
567502,2019-06-26,2019,NYA,TOR,8,7,8-7,NYA,9,false,44,40,84,161,193,354,19,17,36,3,3:43
565645,2019-06-26,2019,HOU,PIT,2,14,14-2,PIT,9,false,37,49,86,194,153,347,12,22,34,1,3:17
565253,2019-06-17,2019,CIN,HOU,3,2,3-2,CIN,9,true,34,39,73,161,139,300,11,13,24,5,2:55 (:52 delay)
567591,2019-06-25,2019,MIL,SEA,3,8,8-3,SEA,9,false,39,46,85,196,158,354,10,20,30,1,3:38
565368,2019-07-21,2019,CLE,KCA,5,4,5-4,CLE,9,true,36,37,73,151,119,270,11,10,21,1,2:47
566137,2019-07-27,2019,OAK,TEX,5,4,5-4,OAK,9,true,33,38,71,144,124,268,9,12,21,3,2:51
565656,2019-07-22,2019,HOU,OAK,11,1,11-1,HOU,9,true,47,31,78,129,184,313,23,3,26,1,2:56
566329,2019-07-30,2019,SDN,BAL,5,8,8-5,BAL,9,false,39,43,82,171,146,317,12,16,28,1,3:22
566026,2019-06-29,2019,NYN,ATL,4,5,5-4,ATL,9,false,42,41,83,143,166,309,14,16,30,3,3:39 (1:33 delay)
567596,2019-06-30,2019,MIL,PIT,2,1,2-1,MIL,9,true,39,32,71,145,167,312,17,9,26,3,3:40
566811,2019-07-12,2019,TEX,HOU,9,8,9-8,TEX,9,false,42,38,80,142,170,312,15,12,27,3,3:07
566995,2019-06-16,2019,MIN,KCA,6,8,8-6,KCA,9,false,48,42,90,152,202,354,22,12,34,4,4:00
565648,2019-06-29,2019,HOU,SEA,6,5,6-5,HOU,10,false,41,42,83,185,161,346,13,13,26,1,3:38
565452,2019-06-27,2019,COL,LAN,8,12,12-8,LAN,9,false,45,46,91,184,155,339,19,19,38,2,3:32
565365,2019-07-18,2019,CLE,DET,6,3,6-3,CLE,9,true,33,36,69,158,137,295,10,10,20,4,3:06
565269,2019-07-26,2019,CIN,COL,2,12,12-2,COL,9,false,33,44,77,161,115,276,8,19,27,0,2:47
567312,2019-07-25,2019,CHA,MIN,3,10,10-3,MIN,9,false,36,41,77,162,139,301,9,15,24,0,3:01
565457,2019-07-03,2019,COL,HOU,2,4,4-2,HOU,9,false,36,35,71,113,156,269,9,10,19,1,2:41
566414,2019-07-02,2019,SEA,SLN,5,4,5-4,SEA,9,true,38,36,74,157,161,318,15,11,26,6,3:18
564976,2019-07-16,2019,BAL,WAS,1,8,8-1,WAS,9,false,35,43,78,190,129,319,9,16,25,1,3:10
565069,2019-07-12,2019,BOS,LAN,8,1,8-1,BOS,9,true,35,34,69,126,131,257,12,7,19,2,2:52 (1:00 delay)
566716,2019-07-23,2019,TBA,BOS,4,5,5-4,BOS,9,false,39,39,78,138,175,313,12,14,26,3,3:19
565273,2019-07-30,2019,CIN,PIT,4,11,11-4,PIT,9,false,38,44,82,183,136,319,10,18,28,3,3:35
567103,2019-07-12,2019,PHI,WAS,0,4,4-0,WAS,9,false,36,41,77,160,153,313,10,14,24,0,3:15
565840,2019-06-22,2019,LAN,COL,5,4,5-4,LAN,11,false,47,43,90,177,195,372,17,10,27,2,4:15
565062,2019-06-22,2019,BOS,TOR,7,8,8-7,TOR,9,false,40,42,82,197,172,369,14,15,29,3,3:50 (:25 delay)
566314,2019-06-18,2019,SDN,MIL,4,1,4-1,SDN,9,true,36,32,68,121,130,251,12,8,20,0,2:43
567007,2019-07-18,2019,MIN,OAK,6,3,6-3,MIN,9,true,34,37,71,132,128,260,14,8,22,2,3:18
564973,2019-07-12,2019,BAL,TBA,4,16,16-4,TBA,9,false,35,49,84,163,128,291,7,21,28,1,2:49
566714,2019-07-21,2019,TBA,CHA,4,2,4-2,TBA,9,true,30,34,64,167,137,304,8,8,16,1,3:07
565462,2019-07-16,2019,COL,SFN,4,8,8-4,SFN,10,false,39,44,83,173,149,322,10,17,27,3,3:33
564786,2019-07-27,2019,ANA,BAL,7,8,8-7,BAL,9,false,40,42,82,154,162,316,13,18,31,3,3:24
565555,2019-07-07,2019,DET,BOS,3,6,6-3,BOS,9,false,37,38,75,152,187,339,10,12,22,1,3:30
565456,2019-07-02,2019,COL,HOU,8,9,9-8,HOU,9,false,44,42,86,145,174,319,17,15,32,2,3:27
565647,2019-06-28,2019,HOU,SEA,2,1,2-1,HOU,10,false,41,39,80,164,181,345,14,9,23,1,3:27
566814,2019-07-16,2019,TEX,ARI,2,9,9-2,ARI,9,false,34,40,74,160,135,295,9,12,21,4,3:23
567317,2019-07-31,2019,CHA,NYN,2,4,4-2,NYN,9,false,38,39,77,144,159,303,11,11,22,1,3:27
566425,2019-07-24,2019,SEA,TEX,5,3,5-3,SEA,9,true,33,35,68,117,135,252,10,9,19,0,2:25
567500,2019-06-24,2019,NYA,TOR,10,8,10-8,NYA,9,true,44,43,87,175,167,342,20,16,36,5,3:42
565072,2019-07-15,2019,BOS,TOR,10,8,10-8,BOS,9,true,44,42,86,160,161,321,21,14,35,3,3:28
566913,2019-07-23,2019,TOR,CLE,2,1,2-1,TOR,10,false,39,38,77,151,162,313,12,9,21,3,3:19
565941,2019-07-07,2019,WAS,KCA,5,2,5-2,WAS,9,true,34,35,69,142,123,265,11,9,20,2,2:37
565359,2019-07-12,2019,CLE,MIN,3,5,5-3,MIN,9,false,35,39,74,174,161,335,9,13,22,4,3:44
566708,2019-07-04,2019,TBA,NYA,4,8,8-4,NYA,10,false,46,41,87,168,200,368,16,12,28,4,4:14
565172,2019-07-15,2019,CHN,CIN,3,6,6-3,CIN,9,false,39,41,80,160,159,319,14,13,27,2,3:17
566912,2019-07-22,2019,TOR,CLE,3,7,7-3,CLE,9,false,31,46,77,169,124,293,8,19,27,2,2:55
566620,2019-07-31,2019,SLN,CHN,0,2,2-0,CHN,9,false,36,37,73,148,132,280,9,11,20,3,3:14
565430,2019-07-15,2019,COL,SFN,2,19,19-2,SFN,9,false,36,52,88,199,145,344,9,25,34,3,3:15
566703,2019-06-29,2019,TBA,TEX,5,2,5-2,TBA,9,true,34,34,68,151,141,292,10,7,17,0,2:56
566615,2019-07-17,2019,SLN,PIT,6,5,6-5,SLN,9,true,35,39,74,144,148,292,10,14,24,2,3:11
567104,2019-07-13,2019,PHI,WAS,3,4,4-3,WAS,9,false,36,41,77,166,161,327,10,14,24,3,3:43
566900,2019-06-19,2019,TOR,ANA,6,11,11-6,ANA,9,false,40,48,88,184,177,361,13,20,33,4,3:46
564776,2019-06-30,2019,ANA,OAK,3,12,12-3,OAK,9,false,38,42,80,165,144,309,11,16,27,5,3:18
565061,2019-06-21,2019,BOS,TOR,7,5,7-5,BOS,10,false,45,46,91,190,177,367,17,18,35,4,3:58
567004,2019-07-07,2019,MIN,TEX,1,4,4-1,TEX,11,false,44,46,90,192,173,365,11,15,26,3,4:15
564881,2019-07-24,2019,ARI,BAL,5,2,5-2,ARI,9,true,43,39,82,162,174,336,19,12,31,3,3:24
565268,2019-07-21,2019,CIN,SLN,1,3,3-1,SLN,9,false,38,35,73,165,164,329,11,8,19,2,3:22
565175,2019-07-19,2019,CHN,SDN,6,5,6-5,CHN,9,true,35,43,78,165,123,288,12,16,28,1,3:12
566906,2019-07-02,2019,TOR,BOS,6,10,10-6,BOS,9,false,40,43,83,158,164,322,14,17,31,1,3:18
564783,2019-07-18,2019,ANA,HOU,2,6,6-2,HOU,9,false,36,38,74,125,151,276,9,13,22,1,2:35
567602,2019-07-17,2019,MIL,ATL,5,4,5-4,MIL,9,true,32,41,73,174,123,297,9,13,22,2,3:07
566709,2019-07-05,2019,TBA,NYA,4,8,8-4,NYA,11,false,47,44,91,166,178,344,15,14,29,2,3:46
566808,2019-07-03,2019,TEX,ANA,2,6,6-2,ANA,9,false,34,38,72,149,148,297,6,13,19,1,2:55
566715,2019-07-22,2019,TBA,BOS,4,9,9-4,BOS,9,false,40,42,82,152,165,317,14,15,29,2,3:20
566523,2019-07-24,2019,SFN,CHN,1,4,4-1,CHN,9,false,37,38,75,144,134,278,10,12,22,2,2:58
566228,2019-07-24,2019,PIT,SLN,8,14,14-8,SLN,9,false,43,47,90,169,162,331,16,21,37,2,3:17
565455,2019-06-30,2019,COL,LAN,5,10,10-5,LAN,9,false,38,47,85,186,177,363,12,20,32,4,4:01
566411,2019-06-21,2019,SEA,BAL,10,9,10-9,SEA,9,true,45,39,84,144,179,323,21,14,35,4,3:18
566216,2019-07-01,2019,PIT,CHN,18,5,18-5,PIT,9,true,50,42,92,141,154,295,27,17,44,2,3:15
566029,2019-07-03,2019,NYN,NYA,1,5,5-1,NYA,9,false,34,40,74,181,137,318,7,14,21,2,3:17
566321,2019-07-03,2019,SDN,SFN,5,7,7-5,SFN,9,false,38,39,77,148,138,286,12,13,25,2,3:00
566815,2019-07-17,2019,TEX,ARI,4,19,19-4,ARI,9,false,35,59,94,213,142,355,8,32,40,2,3:14
567406,2019-07-16,2019,MIA,SDN,12,7,12-7,MIA,9,true,42,41,83,179,161,340,19,15,34,2,3:14
567605,2019-07-24,2019,MIL,CIN,5,4,5-4,MIL,9,true,35,38,73,162,146,308,13,11,24,3,3:15
567305,2019-07-03,2019,CHA,DET,9,6,9-6,CHA,12,false,48,49,97,170,192,362,13,17,30,2,3:48
567302,2019-06-29,2019,CHA,MIN,3,10,10-3,MIN,9,false,37,42,79,163,153,316,9,16,25,1,3:14
565361,2019-07-14,2019,CLE,MIN,4,3,4-3,CLE,9,true,34,38,72,151,131,282,10,10,20,2,3:00
567111,2019-07-27,2019,PHI,ATL,7,15,15-7,ATL,9,false,42,50,92,195,158,353,16,23,39,3,3:34
566220,2019-07-05,2019,PIT,MIL,6,7,7-6,MIL,10,false,47,48,95,182,185,367,17,21,38,4,4:13
566807,2019-07-02,2019,TEX,ANA,4,9,9-4,ANA,9,false,36,50,86,249,160,409,10,21,31,4,4:12
564877,2019-07-20,2019,ARI,MIL,3,8,8-3,MIL,9,false,35,42,77,158,143,301,9,17,26,3,3:17
566128,2019-07-03,2019,OAK,MIN,3,4,4-3,MIN,12,false,50,49,99,198,195,393,16,14,30,3,4:40
566033,2019-07-23,2019,NYN,SDN,5,2,5-2,NYN,9,true,35,38,73,171,123,294,12,12,24,3,3:02
566315,2019-06-19,2019,SDN,MIL,8,7,8-7,SDN,9,true,39,41,80,162,141,303,17,14,31,3,3:24
565453,2019-06-28,2019,COL,LAN,13,9,13-9,COL,9,true,44,45,89,159,159,318,21,17,38,3,3:31 (:19 delay)
566617,2019-07-27,2019,SLN,HOU,2,8,8-2,HOU,9,false,36,42,78,169,131,300,10,17,27,1,3:07
565266,2019-07-19,2019,CIN,SLN,11,12,12-11,SLN,9,false,47,41,88,172,182,354,22,14,36,5,3:49
567588,2019-06-21,2019,MIL,CIN,7,11,11-7,CIN,9,false,46,47,93,208,207,415,20,20,40,4,4:08
566604,2019-06-20,2019,SLN,MIA,6,7,7-6,MIA,11,false,51,47,98,174,206,380,19,17,36,4,4:31
567402,2019-06-30,2019,MIA,PHI,6,13,13-6,PHI,9,false,39,47,86,186,144,330,12,21,33,1,3:36
564866,2019-06-21,2019,ARI,SFN,5,11,11-5,SFN,9,false,40,43,83,150,149,299,14,18,32,3,3:09
567506,2019-07-15,2019,NYA,TBA,4,5,5-4,TBA,9,false,39,38,77,162,187,349,13,14,27,2,3:42
564979,2019-07-20,2019,BAL,BOS,6,17,17-6,BOS,9,false,43,50,93,179,173,352,16,23,39,2,3:29
566038,2019-07-28,2019,NYN,PIT,8,7,8-7,NYN,9,true,40,42,82,166,153,319,15,14,29,2,3:21
567511,2019-07-20,2019,NYA,COL,11,5,11-5,NYA,9,true,44,35,79,124,202,326,20,8,28,3,3:33
565849,2019-07-20,2019,LAN,MIA,10,6,10-6,LAN,9,true,41,38,79,165,175,340,19,10,29,4,3:27
565259,2019-07-01,2019,CIN,MIL,6,8,8-6,MIL,9,false,37,42,79,177,129,306,11,16,27,2,3:10
566898,2019-06-17,2019,TOR,ANA,5,10,10-5,ANA,9,false,37,45,82,169,129,298,11,19,30,3,3:06
565073,2019-07-16,2019,BOS,TOR,4,10,10-4,TOR,9,false,41,42,83,158,166,324,16,18,34,5,3:45
565945,2019-07-25,2019,WAS,COL,7,8,8-7,COL,9,false,42,41,83,177,171,348,16,15,31,3,3:46
566513,2019-06-30,2019,SFN,ARI,10,4,10-4,SFN,9,true,42,37,79,154,154,308,19,10,29,2,3:09
565933,2019-06-21,2019,WAS,ATL,4,3,4-3,WAS,9,true,37,38,75,146,143,289,13,12,25,1,3:01
566612,2019-07-14,2019,SLN,ARI,5,2,5-2,SLN,9,true,33,39,72,146,115,261,10,13,23,2,2:52
565745,2019-07-04,2019,KCA,CLE,4,8,8-4,CLE,9,false,38,41,79,183,156,339,10,18,28,4,3:30 (2:30 delay)
566813,2019-07-14,2019,TEX,HOU,4,12,12-4,HOU,9,false,36,49,85,219,163,382,10,21,31,2,3:40
566713,2019-07-20,2019,TBA,CHA,1,2,2-1,CHA,11,false,44,41,85,154,166,320,12,10,22,3,3:38
567599,2019-07-14,2019,MIL,SFN,3,8,8-3,SFN,9,false,37,43,80,181,142,323,10,18,28,3,3:26
564781,2019-07-16,2019,ANA,HOU,7,2,7-2,ANA,9,true,37,43,80,169,155,324,14,18,32,4,3:33
565556,2019-07-19,2019,DET,TOR,1,12,12-1,TOR,9,false,35,47,82,198,135,333,8,20,28,2,3:20
567514,2019-07-31,2019,NYA,ARI,7,5,7-5,NYA,9,true,35,42,77,189,143,332,11,15,26,5,3:43 (:36 delay)
565460,2019-07-14,2019,COL,CIN,10,9,10-9,COL,9,true,39,38,77,143,141,284,14,12,26,2,3:05
565652,2019-07-07,2019,HOU,ANA,11,10,11-10,HOU,10,false,55,50,105,197,223,420,28,20,48,4,4:49
565741,2019-06-22,2019,KCA,MIN,3,5,5-3,MIN,10,false,42,41,83,127,142,269,15,12,27,1,2:56
567589,2019-06-22,2019,MIL,CIN,6,5,6-5,MIL,9,true,36,35,71,136,159,295,11,8,19,3,3:00
567597,2019-07-12,2019,MIL,SFN,7,10,10-7,SFN,10,false,46,41,87,169,164,333,19,11,30,1,3:33
566123,2019-06-20,2019,OAK,TBA,5,4,5-4,OAK,9,false,38,36,74,127,164,291,14,8,22,3,3:01
567002,2019-07-05,2019,MIN,TEX,15,6,15-6,MIN,9,true,45,37,82,139,160,299,23,12,35,3,3:02 (1:12 delay)
566917,2019-07-28,2019,TOR,TBA,9,10,10-9,TBA,9,false,45,45,90,200,182,382,18,20,38,6,4:10
566318,2019-06-30,2019,SDN,SLN,3,5,5-3,SLN,11,false,45,45,90,177,189,366,14,14,28,5,4:07
567106,2019-07-15,2019,PHI,LAN,2,16,16-2,LAN,9,false,39,53,92,191,143,334,10,25,35,2,3:25
567214,2019-07-18,2019,ATL,WAS,4,13,13-4,WAS,9,false,38,49,87,202,156,358,12,23,35,2,3:44
566800,2019-06-18,2019,TEX,CLE,3,10,10-3,CLE,9,false,35,47,82,172,146,318,10,19,29,2,3:13
567215,2019-07-19,2019,ATL,WAS,4,3,4-3,ATL,9,false,40,35,75,140,177,317,19,8,27,2,3:30
565264,2019-07-07,2019,CIN,CLE,1,11,11-1,CLE,9,false,36,48,84,184,144,328,9,21,30,3,3:24
565939,2019-07-05,2019,WAS,KCA,4,7,7-4,KCA,11,false,56,51,107,195,221,416,27,19,46,4,4:40
565080,2019-07-30,2019,BOS,TBA,5,6,6-5,TBA,9,false,43,44,87,177,169,346,17,17,34,7,4:05
566410,2019-06-20,2019,SEA,BAL,5,2,5-2,SEA,9,true,37,35,72,144,169,313,13,10,23,3,3:16
565554,2019-07-06,2019,DET,BOS,6,10,10-6,BOS,9,false,43,49,92,189,183,372,16,21,37,4,3:51 (4:05 delay)
565067,2019-06-29,2019,BOS,NYA,13,17,17-13,NYA,9,false,50,51,101,208,214,422,24,25,49,8,4:42
565064,2019-06-24,2019,BOS,CHA,6,5,6-5,BOS,9,false,43,38,81,153,165,318,22,13,35,6,3:36
567598,2019-07-13,2019,MIL,SFN,5,4,5-4,MIL,9,false,43,39,82,182,183,365,18,12,30,2,3:54
566131,2019-07-13,2019,OAK,CHA,13,2,13-2,OAK,9,true,44,37,81,140,199,339,22,10,32,2,3:25
566997,2019-06-18,2019,MIN,BOS,4,3,4-3,MIN,17,false,69,68,137,228,259,487,23,21,44,0,5:45
567001,2019-06-27,2019,MIN,TBA,2,5,5-2,TBA,18,false,65,70,135,268,233,501,15,16,31,2,5:42 (:57 delay)
566517,2019-07-18,2019,SFN,NYN,3,2,3-2,SFN,16,false,62,60,122,211,242,453,20,17,37,1,4:47
565753,2019-07-25,2019,KCA,CLE,4,5,5-4,CLE,14,false,60,64,124,210,251,461,19,27,46,6,4:51
565071,2019-07-14,2019,BOS,LAN,4,7,7-4,LAN,12,false,53,55,108,261,196,457,19,19,38,3,5:40
564784,2019-07-25,2019,ANA,BAL,8,10,10-8,BAL,16,false,69,70,139,291,280,571,23,22,45,5,6:19
566238,2019-08-18,2019,PIT,CHN,1,7,7-1,CHN,9,false,36,42,78,179,131,310,9,16,25,2,3:20
567220,2019-08-01,2019,ATL,CIN,4,1,4-1,ATL,7,true,28,21,49,76,115,191,10,4,14,1,2:08 (1:46 delay)
565376,2019-08-07,2019,CLE,TEX,5,1,5-1,CLE,9,true,34,29,63,111,153,264,13,4,17,3,2:55
565086,2019-08-08,2019,BOS,ANA,3,0,3-0,BOS,9,true,29,29,58,115,118,233,6,2,8,0,2:16
566047,2019-08-22,2019,NYN,CLE,2,0,2-0,NYN,8,false,28,27,55,102,101,203,7,3,10,1,2:08 (3:04 delay)
567318,2019-08-01,2019,CHA,NYN,0,4,4-0,NYN,9,false,31,35,66,140,115,255,5,11,16,1,2:32
566434,2019-08-11,2019,SEA,TBA,0,1,1-0,TBA,9,false,30,32,62,120,101,221,3,6,9,1,2:23
566623,2019-08-10,2019,SLN,PIT,3,1,3-1,SLN,9,true,30,35,65,123,119,242,10,8,18,2,2:40
564882,2019-08-02,2019,ARI,WAS,0,3,3-0,WAS,9,false,32,35,67,129,126,255,6,9,15,1,2:43
566529,2019-08-10,2019,SFN,PHI,3,1,3-1,SFN,9,true,31,30,61,122,117,239,8,4,12,0,2:32
565473,2019-08-16,2019,COL,MIA,3,0,3-0,COL,9,true,32,32,64,112,107,219,9,6,15,0,2:12 (:20 delay)
565666,2019-08-21,2019,HOU,DET,1,2,2-1,DET,9,false,33,29,62,99,143,242,8,2,10,0,2:12
565186,2019-08-22,2019,CHN,SFN,1,0,1-0,CHN,9,true,26,30,56,132,108,240,3,4,7,2,2:29
564992,2019-08-20,2019,BAL,KCA,4,1,4-1,BAL,9,true,34,33,67,116,121,237,11,8,19,0,2:19 (:13 delay)
566927,2019-08-18,2019,TOR,SEA,0,7,7-0,SEA,9,false,29,39,68,151,96,247,3,16,19,1,2:25
567522,2019-08-16,2019,NYA,CLE,3,2,3-2,NYA,9,true,36,33,69,117,119,236,13,5,18,3,2:39
565855,2019-08-03,2019,LAN,SDN,4,1,4-1,LAN,9,true,33,31,64,110,118,228,9,5,14,0,2:18
566041,2019-08-07,2019,NYN,MIA,7,2,7-2,NYN,9,true,36,35,71,137,116,253,12,11,23,2,2:26
565371,2019-08-01,2019,CLE,HOU,1,7,7-1,HOU,9,false,34,45,79,167,121,288,9,20,29,3,3:10
566621,2019-08-01,2019,SLN,CHN,8,0,8-0,SLN,9,true,40,30,70,122,155,277,16,3,19,2,2:53
566237,2019-08-17,2019,PIT,CHN,0,2,2-0,CHN,9,false,38,33,71,114,139,253,11,8,19,2,2:45
567325,2019-08-22,2019,CHA,TEX,6,1,6-1,CHA,9,true,34,30,64,136,112,248,11,4,15,0,2:29
565377,2019-08-07,2019,CLE,TEX,2,0,2-0,CLE,9,true,28,34,62,147,113,260,5,8,13,0,2:32
567425,2019-08-25,2019,MIA,PHI,3,2,3-2,MIA,9,true,29,31,60,123,117,240,7,5,12,1,2:38
566625,2019-08-19,2019,SLN,MIL,3,0,3-0,SLN,9,true,31,34,65,145,113,258,8,7,15,2,2:43
567515,2019-08-02,2019,NYA,BOS,4,2,4-2,NYA,9,true,32,33,65,132,129,261,11,6,17,1,2:41
565573,2019-08-29,2019,DET,CLE,0,2,2-0,CLE,9,false,30,36,66,152,122,274,4,11,15,0,2:34
567231,2019-08-21,2019,ATL,MIA,5,0,5-0,ATL,9,true,30,36,66,125,131,256,8,11,19,0,2:44
567516,2019-08-03,2019,NYA,BOS,9,2,9-2,NYA,9,true,40,32,72,123,137,260,17,5,22,1,2:40
566720,2019-08-05,2019,TBA,TOR,0,2,2-0,TOR,9,false,34,36,70,136,130,266,7,9,16,2,2:45
566527,2019-08-08,2019,SFN,PHI,5,0,5-0,SFN,9,true,37,29,66,113,154,267,16,3,19,0,2:49
565375,2019-08-05,2019,CLE,TEX,0,1,1-0,TEX,9,false,35,33,68,135,136,271,9,8,17,0,2:49
565565,2019-08-09,2019,DET,KCA,5,2,5-2,DET,9,true,37,36,73,129,141,270,15,10,25,2,2:27
566925,2019-08-16,2019,TOR,SEA,7,3,7-3,TOR,9,true,34,33,67,153,108,261,12,10,22,3,2:37
564996,2019-08-24,2019,BAL,TBA,7,1,7-1,BAL,9,true,35,34,69,128,135,263,13,6,19,1,2:38
566240,2019-08-20,2019,PIT,WAS,4,1,4-1,PIT,9,true,33,36,69,136,115,251,11,12,23,3,3:00
567322,2019-08-13,2019,CHA,HOU,4,1,4-1,CHA,9,true,35,31,66,104,114,218,12,5,17,0,2:21
566723,2019-08-16,2019,TBA,DET,0,2,2-0,DET,9,false,33,33,66,119,136,255,9,6,15,0,2:29
567221,2019-08-02,2019,ATL,CIN,2,5,5-2,CIN,9,false,31,41,72,158,131,289,5,14,19,2,3:01
565373,2019-08-03,2019,CLE,ANA,7,2,7-2,CLE,9,true,34,36,70,144,136,280,10,10,20,6,2:59
565467,2019-08-02,2019,COL,SFN,5,4,5-4,COL,9,true,37,38,75,123,124,247,16,13,29,2,2:50
567015,2019-08-03,2019,MIN,KCA,11,3,11-3,MIN,9,true,38,35,73,132,141,273,14,7,21,2,2:53
567232,2019-08-22,2019,ATL,MIA,3,2,3-2,ATL,9,false,37,33,70,127,133,260,10,6,16,0,2:40
565572,2019-08-28,2019,DET,CLE,2,4,4-2,CLE,9,false,32,37,69,158,118,276,7,12,19,0,2:33
565763,2019-08-17,2019,KCA,NYN,1,4,4-1,NYN,9,false,32,41,73,131,133,264,6,17,23,2,2:35
565865,2019-08-22,2019,LAN,TOR,3,2,3-2,LAN,9,false,33,32,65,124,128,252,8,6,14,1,2:46
567322,2019-08-13,2019,CHA,HOU,4,1,4-1,CHA,9,true,35,31,66,104,114,218,12,5,17,0,2:21
566236,2019-08-16,2019,PIT,CHN,3,2,3-2,PIT,9,false,34,33,67,121,127,248,10,7,17,2,2:49
566141,2019-08-01,2019,OAK,MIL,5,3,5-3,OAK,9,true,35,40,75,148,157,305,12,12,24,1,3:13
566818,2019-08-02,2019,TEX,DET,5,4,5-4,TEX,9,true,36,40,76,164,113,277,12,13,25,1,2:52
565376,2019-08-07,2019,CLE,TEX,5,1,5-1,CLE,9,true,34,29,63,111,153,264,13,4,17,3,2:55
567120,2019-08-14,2019,PHI,CHN,11,1,11-1,PHI,9,true,40,31,71,131,133,264,18,5,23,1,2:45
566622,2019-08-09,2019,SLN,PIT,6,2,6-2,SLN,9,true,34,36,70,120,139,259,11,12,23,3,2:52
565281,2019-08-15,2019,CIN,SLN,2,1,2-1,CIN,9,true,34,35,69,155,119,274,11,8,19,2,3:01
565862,2019-08-11,2019,LAN,ARI,9,3,9-3,LAN,9,true,40,37,77,130,126,256,19,11,30,0,2:40
566535,2019-08-29,2019,SFN,SDN,3,5,5-3,SDN,9,false,36,34,70,111,139,250,10,9,19,0,2:28
566051,2019-08-27,2019,NYN,CHN,2,5,5-2,CHN,9,false,34,37,71,146,119,265,7,13,20,0,2:54
565767,2019-08-28,2019,KCA,OAK,6,4,6-4,KCA,9,true,36,38,74,141,120,261,14,11,25,1,2:33
566045,2019-08-20,2019,NYN,CLE,9,2,9-2,NYN,9,true,37,36,73,129,134,263,12,8,20,2,2:41
567117,2019-08-03,2019,PHI,CHA,3,2,3-2,PHI,9,true,33,35,68,136,130,266,9,7,16,2,3:05
565278,2019-08-09,2019,CIN,CHN,5,2,5-2,CIN,9,true,30,38,68,144,116,260,6,11,17,1,2:44
566040,2019-08-06,2019,NYN,MIA,5,0,5-0,NYN,9,true,34,35,69,113,136,249,11,11,22,0,2:38
566150,2019-08-22,2019,OAK,NYA,5,3,5-3,OAK,9,true,34,35,69,132,136,268,12,9,21,1,2:51
566053,2019-08-29,2019,NYN,CHN,1,4,4-1,CHN,9,false,35,33,68,127,136,263,8,7,15,0,2:35
564995,2019-08-23,2019,BAL,TBA,1,7,7-1,TBA,9,false,33,38,71,150,125,275,7,14,21,0,2:25
566333,2019-08-11,2019,SDN,COL,3,8,8-3,COL,9,false,35,46,81,165,117,282,9,19,28,2,3:03
565179,2019-08-03,2019,CHN,MIL,4,1,4-1,CHN,9,true,36,35,71,140,128,268,13,9,22,4,3:08
566531,2019-08-13,2019,SFN,OAK,3,2,3-2,SFN,9,true,32,32,64,151,132,283,9,6,15,1,2:45
567022,2019-08-10,2019,MIN,CLE,4,1,4-1,MIN,9,true,34,38,72,158,122,280,12,12,24,2,3:07 (1:51 delay)
565287,2019-08-21,2019,CIN,SDN,4,2,4-2,CIN,9,true,38,32,70,148,136,284,13,6,19,1,2:52
566923,2019-08-13,2019,TOR,TEX,3,0,3-0,TOR,9,true,34,37,71,144,145,289,10,10,20,0,2:48
566806,2019-08-20,2019,TEX,ANA,1,5,5-1,ANA,9,false,32,39,71,163,118,281,5,13,18,1,2:48
565958,2019-08-27,2019,WAS,BAL,0,2,2-0,BAL,9,false,35,32,67,126,160,286,8,6,14,1,2:52
566039,2019-08-05,2019,NYN,MIA,6,2,6-2,NYN,9,true,38,35,73,135,133,268,14,9,23,0,2:51
564799,2019-08-28,2019,ANA,TEX,0,3,3-0,TEX,9,false,31,40,71,171,110,281,6,13,19,2,2:55
565661,2019-08-04,2019,HOU,SEA,3,1,3-1,HOU,9,true,32,33,65,146,139,285,8,6,14,2,2:56
566243,2019-08-23,2019,PIT,CIN,3,2,3-2,PIT,9,false,36,36,72,145,120,265,11,10,21,1,2:53
567611,2019-08-11,2019,MIL,TEX,0,1,1-0,TEX,9,false,32,34,66,131,121,252,5,9,14,0,2:28
564887,2019-08-07,2019,ARI,PHI,6,1,6-1,ARI,9,true,39,33,72,158,140,298,18,9,27,1,3:10
566431,2019-08-07,2019,SEA,SDN,3,2,3-2,SEA,9,true,32,37,69,157,138,295,8,11,19,1,3:05
567517,2019-08-04,2019,NYA,BOS,7,4,7-4,NYA,9,true,38,36,74,157,144,301,14,11,25,2,3:18 (1:09 delay)
564797,2019-08-18,2019,ANA,CHA,9,2,9-2,ANA,9,true,40,34,74,135,144,279,18,10,28,1,2:55
566330,2019-08-08,2019,SDN,COL,9,3,9-3,SDN,9,true,38,38,76,142,128,270,12,15,27,3,3:14
564794,2019-08-15,2019,ANA,CHA,8,7,8-7,ANA,9,true,39,36,75,130,148,278,14,9,23,3,2:56
565668,2019-08-23,2019,HOU,ANA,5,4,5-4,HOU,9,true,36,37,73,124,150,274,15,11,26,3,3:07
565372,2019-08-02,2019,CLE,ANA,7,3,7-3,CLE,9,true,36,38,74,156,128,284,13,12,25,2,2:55
567230,2019-08-20,2019,ATL,MIA,5,1,5-1,ATL,9,true,37,36,73,143,135,278,12,10,22,0,3:00
564793,2019-08-14,2019,ANA,PIT,7,4,7-4,ANA,9,true,35,36,71,130,149,279,12,11,23,0,3:06
565469,2019-08-04,2019,COL,SFN,6,2,6-2,COL,9,true,37,33,70,133,145,278,16,8,24,1,2:52
567328,2019-08-25,2019,CHA,TEX,2,0,2-0,CHA,9,true,36,34,70,139,136,275,12,7,19,1,2:57
565858,2019-08-06,2019,LAN,SLN,3,1,3-1,LAN,9,true,33,36,69,145,128,273,9,9,18,2,2:55
566433,2019-08-10,2019,SEA,TBA,4,5,5-4,TBA,9,false,36,35,71,130,145,275,10,8,18,0,2:39
567025,2019-08-20,2019,MIN,CHA,14,4,14-4,MIN,9,true,41,32,73,115,141,256,17,6,23,2,2:55
566926,2019-08-17,2019,TOR,SEA,3,4,4-3,SEA,9,false,37,35,72,122,148,270,12,11,23,3,2:48
566628,2019-08-22,2019,SLN,COL,6,5,6-5,SLN,9,true,36,37,73,129,142,271,14,10,24,1,2:52 (:52 delay)
567326,2019-08-23,2019,CHA,TEX,8,3,8-3,CHA,9,true,38,33,71,134,151,285,14,6,20,2,2:50
566144,2019-08-15,2019,OAK,HOU,7,6,7-6,OAK,9,true,33,35,68,128,120,248,10,9,19,3,2:35
565854,2019-08-02,2019,LAN,SDN,2,5,5-2,SDN,9,false,31,39,70,163,140,303,4,15,19,1,3:06
564983,2019-08-03,2019,BAL,TOR,6,4,6-4,BAL,9,true,35,37,72,154,137,291,10,13,23,4,2:59
564884,2019-08-04,2019,ARI,WAS,7,5,7-5,ARI,9,true,37,40,77,137,134,271,14,15,29,3,3:07
565183,2019-08-07,2019,CHN,OAK,10,1,10-1,CHN,9,true,36,31,67,123,122,245,13,4,17,1,2:36
566332,2019-08-10,2019,SDN,COL,8,5,8-5,SDN,9,true,38,39,77,147,141,288,14,11,25,1,2:55
567118,2019-08-04,2019,PHI,CHA,5,10,10-5,CHA,9,false,38,39,77,148,147,295,13,12,25,1,3:08
565566,2019-08-10,2019,DET,KCA,0,7,7-0,KCA,9,false,32,38,70,163,137,300,6,10,16,1,2:47
564893,2019-08-20,2019,ARI,COL,8,7,8-7,ARI,9,true,38,39,77,129,143,272,14,14,28,4,3:13
567229,2019-08-18,2019,ATL,LAN,5,3,5-3,ATL,9,true,35,37,72,139,144,283,11,13,24,0,3:11
565864,2019-08-21,2019,LAN,TOR,2,1,2-1,LAN,10,false,38,37,75,140,143,283,14,7,21,1,3:10
566147,2019-08-18,2019,OAK,HOU,1,4,4-1,HOU,9,false,34,41,75,154,114,268,9,15,24,1,2:50
567327,2019-08-24,2019,CHA,TEX,0,4,4-0,TEX,9,false,36,38,74,151,135,286,8,10,18,4,3:06
564795,2019-08-16,2019,ANA,CHA,2,7,7-2,CHA,9,false,38,39,77,140,148,288,10,12,22,4,3:11
567319,2019-08-09,2019,CHA,OAK,0,7,7-0,OAK,9,false,32,42,74,155,121,276,6,17,23,2,2:50
566331,2019-08-09,2019,SDN,COL,7,1,7-1,SDN,9,true,37,35,72,137,142,279,15,8,23,1,3:02
567115,2019-08-01,2019,PHI,SFN,10,2,10-2,PHI,9,true,41,39,80,146,154,300,17,12,29,2,3:04
566043,2019-08-10,2019,NYN,WAS,4,3,4-3,NYN,9,true,32,35,67,129,126,255,8,10,18,1,2:34
564981,2019-08-01,2019,BAL,TOR,2,11,11-2,TOR,9,false,35,47,82,182,143,325,10,20,30,3,3:17
565761,2019-08-14,2019,KCA,SLN,0,6,6-0,SLN,9,false,32,38,70,152,128,280,7,11,18,2,2:38
565853,2019-08-01,2019,LAN,SDN,8,2,8-2,LAN,9,true,37,40,77,144,157,301,15,15,30,1,3:25
564982,2019-08-02,2019,BAL,TOR,2,5,5-2,TOR,9,false,38,38,76,155,152,307,11,12,23,4,3:04
565374,2019-08-04,2019,CLE,ANA,6,2,6-2,CLE,9,true,38,31,69,107,162,269,14,5,19,3,3:00
566630,2019-08-24,2019,SLN,COL,6,0,6-0,SLN,9,true,37,32,69,144,146,290,14,7,21,2,2:59
565570,2019-08-15,2019,DET,SEA,2,7,7-2,SEA,9,false,33,43,76,168,118,286,8,19,27,2,2:51
567124,2019-08-18,2019,PHI,SDN,2,3,3-2,SDN,9,false,33,36,69,141,163,304,6,11,17,2,3:21
567026,2019-08-21,2019,MIN,CHA,0,4,4-0,CHA,9,false,30,40,70,177,115,292,3,13,16,0,3:16
565184,2019-08-20,2019,CHN,SFN,5,3,5-3,CHN,9,true,39,35,74,140,151,291,17,8,25,1,2:57
565091,2019-08-17,2019,BOS,BAL,4,0,4-0,BOS,9,true,34,34,68,140,152,292,11,8,19,2,3:11
566928,2019-08-27,2019,TOR,ATL,3,1,3-1,TOR,9,true,34,39,73,154,131,285,14,13,27,2,2:57
565672,2019-08-28,2019,HOU,TBA,8,6,8-6,HOU,9,true,38,36,74,153,149,302,15,9,24,1,3:09
566627,2019-08-21,2019,SLN,MIL,3,5,5-3,MIL,8,true,30,39,69,158,121,279,9,16,25,3,2:54 (1:06 delay)
566050,2019-08-25,2019,NYN,ATL,1,2,2-1,ATL,9,false,35,32,67,146,146,292,11,5,16,0,2:45
565084,2019-08-06,2019,BOS,KCA,2,6,6-2,KCA,9,false,37,35,72,144,142,286,10,11,21,1,2:48
565762,2019-08-16,2019,KCA,NYN,4,1,4-1,KCA,9,true,35,37,72,133,134,267,12,12,24,2,3:01
567428,2019-08-28,2019,MIA,CIN,0,5,5-0,CIN,9,false,31,34,65,143,141,284,5,8,13,0,2:41
565093,2019-08-20,2019,BOS,PHI,2,3,3-2,PHI,9,false,32,37,69,150,122,272,7,10,17,2,3:17
564894,2019-08-21,2019,ARI,COL,2,7,7-2,COL,9,false,34,39,73,129,142,271,7,15,22,1,2:50
566719,2019-08-04,2019,TBA,MIA,7,2,7-2,TBA,9,true,40,33,73,115,181,296,16,8,24,2,2:53
566148,2019-08-20,2019,OAK,NYA,6,2,6-2,OAK,9,true,34,37,71,144,139,283,13,11,24,2,2:49
567479,2019-08-12,2019,NYA,BAL,8,5,8-5,NYA,9,true,35,38,73,166,138,304,11,12,23,1,2:50
565659,2019-08-02,2019,HOU,SEA,10,2,10-2,HOU,9,true,39,38,77,165,156,321,16,11,27,0,2:57
567227,2019-08-16,2019,ATL,LAN,3,8,8-3,LAN,9,false,37,39,76,138,148,286,11,15,26,2,3:06
566430,2019-08-06,2019,SEA,SDN,4,9,9-4,SDN,9,false,37,39,76,152,149,301,11,12,23,1,2:55
565283,2019-08-17,2019,CIN,SLN,6,1,6-1,CIN,9,true,37,38,75,157,137,294,14,12,26,0,2:59
566827,2019-08-16,2019,TEX,MIN,3,4,4-3,MIN,9,false,38,37,75,148,157,305,13,11,24,1,3:12
566726,2019-08-19,2019,TBA,SEA,3,9,9-3,SEA,9,false,37,40,77,157,141,298,10,14,24,0,3:04
565286,2019-08-20,2019,CIN,SDN,3,2,3-2,CIN,9,true,31,35,66,149,149,298,6,9,15,1,2:56 (:11 delay)
567225,2019-08-14,2019,ATL,NYN,6,4,6-4,ATL,9,true,35,41,76,157,136,293,12,15,27,3,3:15 (1:12 delay)
567520,2019-08-14,2019,NYA,BAL,6,5,6-5,NYA,9,true,34,41,75,167,128,295,10,15,25,3,2:56
565180,2019-08-04,2019,CHN,MIL,7,2,7-2,CHN,9,true,40,36,76,155,142,297,17,9,26,0,3:04
565867,2019-08-24,2019,LAN,NYA,2,1,2-1,LAN,9,true,32,35,67,143,138,281,8,8,16,3,3:19
567017,2019-08-05,2019,MIN,ATL,5,3,5-3,MIN,9,false,34,39,73,153,126,279,9,13,22,1,3:01
565181,2019-08-05,2019,CHN,OAK,6,5,6-5,CHN,9,true,36,37,73,170,115,285,14,11,25,4,3:17
566725,2019-08-18,2019,TBA,DET,5,4,5-4,TBA,9,false,35,39,74,151,150,301,9,13,22,1,3:04
564892,2019-08-19,2019,ARI,COL,5,3,5-3,ARI,9,true,32,39,71,149,127,276,8,15,23,3,2:51
566232,2019-08-04,2019,PIT,NYN,2,13,13-2,NYN,9,false,32,46,78,151,110,261,5,19,24,1,2:51
565859,2019-08-07,2019,LAN,SLN,2,1,2-1,LAN,9,false,35,36,71,141,133,274,9,10,19,3,3:01
566149,2019-08-21,2019,OAK,NYA,6,4,6-4,OAK,9,true,33,41,74,136,124,260,9,15,24,5,3:02
565082,2019-08-01,2019,BOS,TBA,4,9,9-4,TBA,9,false,38,44,82,184,144,328,11,20,31,2,3:20
565663,2019-08-07,2019,HOU,COL,14,3,14-3,HOU,9,true,45,33,78,142,176,318,21,8,29,2,3:05
564791,2019-08-12,2019,ANA,PIT,2,10,10-2,PIT,9,false,39,43,82,150,153,303,12,14,26,0,3:08
567119,2019-08-13,2019,PHI,CHN,4,2,4-2,PHI,9,true,36,37,73,143,140,283,11,11,22,2,3:16
565660,2019-08-03,2019,HOU,SEA,9,0,9-0,HOU,9,true,42,31,73,138,180,318,17,5,22,0,3:02
565857,2019-08-05,2019,LAN,SLN,8,0,8-0,LAN,9,true,41,31,72,122,178,300,18,5,23,1,2:59
567610,2019-08-10,2019,MIL,TEX,3,2,3-2,MIL,9,true,37,34,71,143,164,307,16,8,24,2,3:09
567228,2019-08-17,2019,ATL,LAN,4,3,4-3,ATL,9,true,32,40,72,178,141,319,8,13,21,3,3:17
564891,2019-08-18,2019,ARI,SFN,6,1,6-1,ARI,9,true,37,37,74,154,150,304,13,11,24,3,3:19
566526,2019-08-07,2019,SFN,WAS,1,4,4-1,WAS,9,false,36,38,74,145,158,303,9,14,23,0,2:59
566728,2019-08-21,2019,TBA,SEA,7,6,7-6,TBA,9,false,36,39,75,170,130,300,15,12,27,1,2:58
567330,2019-08-28,2019,CHA,MIN,2,8,8-2,MIN,9,false,37,43,80,152,140,292,11,18,29,1,3:14
566241,2019-08-21,2019,PIT,WAS,1,11,11-1,WAS,9,false,33,47,80,169,106,275,7,19,26,2,2:54
564991,2019-08-19,2019,BAL,KCA,4,5,5-4,KCA,9,false,38,37,75,144,164,308,14,9,23,2,3:05
564985,2019-08-05,2019,BAL,NYA,6,9,9-6,NYA,9,false,40,40,80,148,143,291,15,14,29,3,3:14
565182,2019-08-06,2019,CHN,OAK,4,11,11-4,OAK,9,false,40,43,83,151,130,281,14,17,31,0,2:37
565764,2019-08-18,2019,KCA,NYN,5,11,11-5,NYN,9,false,36,42,78,154,147,301,7,19,26,2,3:01
567021,2019-08-09,2019,MIN,CLE,2,6,6-2,CLE,9,false,37,43,80,160,132,292,10,17,27,2,3:09
565667,2019-08-22,2019,HOU,DET,6,3,6-3,HOU,9,true,38,35,73,138,159,297,15,8,23,2,2:50
566337,2019-08-23,2019,SDN,BOS,0,11,11-0,BOS,9,false,30,45,75,178,114,292,6,16,22,2,3:04
566718,2019-08-03,2019,TBA,MIA,8,6,8-6,TBA,9,true,42,39,81,129,186,315,19,14,33,1,3:19
567416,2019-08-08,2019,MIA,ATL,9,2,9-2,MIA,9,true,40,35,75,158,157,315,17,10,27,2,3:04
566629,2019-08-23,2019,SLN,COL,8,3,8-3,SLN,9,true,43,36,79,146,147,293,19,9,28,1,3:02
565381,2019-08-23,2019,CLE,KCA,4,1,4-1,CLE,9,true,33,33,66,139,139,278,12,9,21,1,2:50
567020,2019-08-08,2019,MIN,CLE,5,7,7-5,CLE,9,false,40,40,80,150,171,321,15,15,30,4,3:39
565178,2019-08-02,2019,CHN,MIL,6,2,6-2,CHN,9,true,43,34,77,127,174,301,18,9,27,2,3:18
565279,2019-08-10,2019,CIN,CHN,10,1,10-1,CIN,9,true,45,38,83,147,157,304,22,12,34,1,3:05
567417,2019-08-09,2019,MIA,ATL,4,8,8-4,ATL,9,false,37,41,78,149,148,297,11,16,27,2,3:19
565665,2019-08-20,2019,HOU,DET,6,3,6-3,HOU,9,true,40,39,79,153,169,322,17,13,30,1,3:03
567614,2019-08-23,2019,MIL,ARI,6,1,6-1,MIL,9,true,40,31,71,143,172,315,17,5,22,1,3:06
567014,2019-08-02,2019,MIN,KCA,11,9,11-9,MIN,9,true,40,41,81,142,149,291,16,15,31,5,3:14
566525,2019-08-06,2019,SFN,WAS,3,5,5-3,WAS,9,false,36,36,72,136,134,270,9,11,20,0,2:45
565378,2019-08-12,2019,CLE,BOS,6,5,6-5,CLE,9,false,39,41,80,149,148,297,16,17,33,3,3:34
567224,2019-08-13,2019,ATL,NYN,5,3,5-3,ATL,9,true,38,39,77,150,138,288,16,14,30,3,3:18
565284,2019-08-18,2019,CIN,SLN,4,5,5-4,SLN,9,false,39,37,76,145,153,298,14,10,24,3,3:03
566007,2019-08-05,2019,NYN,MIA,5,4,5-4,NYN,9,true,35,36,71,134,162,296,12,12,24,2,3:09
566918,2019-08-08,2019,TOR,NYA,6,12,12-6,NYA,9,false,42,44,86,167,154,321,14,17,31,2,3:06
564885,2019-08-05,2019,ARI,PHI,3,7,7-3,PHI,9,false,35,43,78,137,133,270,11,18,29,3,3:05
566230,2019-08-02,2019,PIT,NYN,8,4,8-4,PIT,9,true,39,39,78,155,151,306,16,12,28,2,3:11
565285,2019-08-19,2019,CIN,SDN,2,3,3-2,SDN,9,false,39,34,73,127,169,296,13,6,19,0,3:00
564886,2019-08-06,2019,ARI,PHI,8,4,8-4,ARI,9,true,38,43,81,153,147,300,16,16,32,4,3:19
564988,2019-08-09,2019,BAL,HOU,2,3,3-2,HOU,9,false,36,37,73,149,157,306,11,10,21,3,2:58
567518,2019-08-12,2019,NYA,BAL,11,8,11-8,NYA,9,true,41,38,79,150,154,304,19,12,31,5,2:51
567323,2019-08-13,2019,CHA,HOU,2,6,6-2,HOU,9,false,34,44,78,173,139,312,10,21,31,3,3:17
566336,2019-08-14,2019,SDN,TBA,7,2,7-2,SDN,9,true,40,33,73,164,157,321,17,8,25,2,3:10
565959,2019-08-28,2019,WAS,BAL,8,4,8-4,WAS,9,true,38,37,75,170,136,306,15,11,26,2,3:12
564796,2019-08-17,2019,ANA,CHA,6,5,6-5,ANA,9,true,37,38,75,163,145,308,15,12,27,6,3:37
565768,2019-08-29,2019,KCA,OAK,8,9,9-8,OAK,9,false,43,45,88,151,140,291,15,18,33,4,3:17
567028,2019-08-24,2019,MIN,DET,8,5,8-5,MIN,9,true,37,41,78,157,140,297,13,15,28,2,3:23
565382,2019-08-24,2019,CLE,KCA,4,2,4-2,CLE,9,true,34,38,72,150,146,296,11,10,21,3,3:07
566244,2019-08-24,2019,PIT,CIN,14,0,14-0,PIT,9,true,40,34,74,141,152,293,16,10,26,2,2:45
564989,2019-08-10,2019,BAL,HOU,2,23,23-2,HOU,9,false,36,52,88,169,145,314,9,27,36,2,3:03
567519,2019-08-13,2019,NYA,BAL,8,3,8-3,NYA,9,true,42,33,75,125,171,296,20,7,27,1,2:38
565090,2019-08-16,2019,BOS,BAL,9,1,9-1,BOS,9,true,38,34,72,129,131,260,17,8,25,2,2:41
567019,2019-08-07,2019,MIN,ATL,7,11,11-7,ATL,9,false,43,44,87,148,173,321,15,20,35,2,3:33
566046,2019-08-21,2019,NYN,CLE,4,3,4-3,NYN,10,false,42,40,82,144,159,303,14,11,25,1,3:22 (:06 delay)
567418,2019-08-10,2019,MIA,ATL,7,6,7-6,MIA,10,false,42,42,84,161,154,315,16,14,30,5,3:34
565088,2019-08-10,2019,BOS,ANA,4,12,12-4,ANA,9,false,42,43,85,164,163,327,14,16,30,5,3:28
565952,2019-08-12,2019,WAS,CIN,7,6,7-6,WAS,9,true,37,40,77,166,160,326,15,16,31,0,3:11
565471,2019-08-13,2019,COL,ARI,3,9,9-3,ARI,9,false,42,41,83,149,171,320,15,17,32,0,3:32
565563,2019-08-07,2019,DET,CHA,1,8,8-1,CHA,9,false,35,46,81,203,127,330,10,19,29,2,3:17
567024,2019-08-19,2019,MIN,CHA,4,6,6-4,CHA,9,false,41,37,78,144,169,313,16,10,26,2,3:27
565187,2019-08-23,2019,CHN,WAS,3,9,9-3,WAS,9,false,32,44,76,189,125,314,5,18,23,2,3:10
565474,2019-08-17,2019,COL,MIA,11,4,11-4,COL,9,true,40,37,77,174,147,321,20,11,31,2,3:08
567027,2019-08-23,2019,MIN,DET,6,9,9-6,DET,9,false,39,44,83,157,155,312,13,20,33,4,3:26
566234,2019-08-06,2019,PIT,MIL,3,4,4-3,MIL,9,false,37,37,74,163,146,309,11,11,22,2,3:19
566049,2019-08-24,2019,NYN,ATL,5,9,9-5,ATL,9,false,37,44,81,166,144,310,11,17,28,1,3:14
565478,2019-08-29,2019,COL,PIT,8,11,11-8,PIT,9,false,40,45,85,152,150,302,14,19,33,3,3:14
566042,2019-08-09,2019,NYN,WAS,7,6,7-6,NYN,9,false,39,41,80,164,139,303,13,17,30,2,3:20
567126,2019-08-27,2019,PHI,PIT,4,5,5-4,PIT,9,false,39,39,78,141,155,296,13,14,27,3,3:19
566235,2019-08-07,2019,PIT,MIL,3,8,8-3,MIL,9,false,37,43,80,161,145,306,9,14,23,1,3:09
565083,2019-08-05,2019,BOS,KCA,7,5,7-5,BOS,9,true,37,39,76,158,147,305,14,11,25,1,2:56
565760,2019-08-13,2019,KCA,SLN,0,2,2-0,SLN,9,false,32,34,66,149,147,296,8,9,17,2,2:54
565561,2019-08-05,2019,DET,CHA,4,7,7-4,CHA,9,false,39,46,85,192,156,348,15,20,35,1,3:41
565087,2019-08-09,2019,BOS,ANA,16,4,16-4,BOS,9,true,44,33,77,139,195,334,19,9,28,3,3:33
565470,2019-08-12,2019,COL,ARI,6,8,8-6,ARI,9,false,42,41,83,135,170,305,16,17,33,3,3:30
565185,2019-08-21,2019,CHN,SFN,12,11,12-11,CHN,9,true,43,43,86,151,153,304,20,16,36,3,3:31
564984,2019-08-04,2019,BAL,TOR,6,5,6-5,BAL,9,true,38,43,81,158,153,311,15,17,32,3,3:08
566239,2019-08-19,2019,PIT,WAS,0,13,13-0,WAS,9,false,32,45,77,181,143,324,6,20,26,1,3:16
565282,2019-08-16,2019,CIN,SLN,4,13,13-4,SLN,9,false,35,46,81,193,123,316,8,20,28,2,3:03
567128,2019-08-30,2019,PHI,NYN,5,11,11-5,NYN,9,false,41,44,85,158,145,303,17,17,34,3,3:28
566432,2019-08-09,2019,SEA,TBA,3,5,5-3,TBA,9,false,38,40,78,137,174,311,13,14,27,2,3:21
567525,2019-08-30,2019,NYA,OAK,2,8,8-2,OAK,9,false,35,43,78,188,118,306,8,17,25,0,3:02
567523,2019-08-17,2019,NYA,CLE,6,5,6-5,NYA,9,true,32,38,70,143,138,281,9,14,23,1,2:54
566919,2019-08-09,2019,TOR,NYA,8,2,8-2,TOR,9,true,34,35,69,150,157,307,11,9,20,2,2:56
566722,2019-08-07,2019,TBA,TOR,3,4,4-3,TOR,9,false,38,36,74,158,145,303,12,9,21,5,3:15
565562,2019-08-06,2019,DET,CHA,10,6,10-6,DET,9,true,44,44,88,175,165,340,19,18,37,3,3:23 (1:01 delay)
566233,2019-08-05,2019,PIT,MIL,7,9,9-7,MIL,9,false,40,43,83,157,180,337,13,16,29,3,3:32
565662,2019-08-06,2019,HOU,COL,11,6,11-6,HOU,9,true,39,38,77,160,151,311,15,11,26,2,3:09
566242,2019-08-22,2019,PIT,WAS,1,7,7-1,WAS,9,false,35,44,79,174,152,326,8,17,25,0,3:19 (:10 delay)
566143,2019-08-04,2019,OAK,SLN,4,2,4-2,OAK,9,true,39,37,76,167,165,332,16,9,25,3,3:14
566528,2019-08-09,2019,SFN,PHI,6,9,9-6,PHI,9,false,40,42,82,155,149,304,14,16,30,2,3:05
565472,2019-08-14,2019,COL,ARI,7,6,7-6,COL,9,false,39,39,78,148,155,303,13,14,27,0,3:25
565569,2019-08-14,2019,DET,SEA,3,2,3-2,DET,9,true,36,35,71,164,123,287,14,10,24,1,2:48
566146,2019-08-17,2019,OAK,HOU,8,4,8-4,OAK,9,true,40,38,78,143,152,295,17,12,29,0,3:04
564994,2019-08-22,2019,BAL,TBA,2,5,5-2,TBA,9,false,37,41,78,184,156,340,9,14,23,3,3:29 (2:16 delay)
565664,2019-08-19,2019,HOU,DET,5,4,5-4,HOU,9,true,37,42,79,174,166,340,13,15,28,1,3:13
566231,2019-08-03,2019,PIT,NYN,5,7,7-5,NYN,9,false,41,42,83,148,163,311,16,16,32,3,3:21
567122,2019-08-16,2019,PHI,SDN,8,4,8-4,PHI,9,true,39,35,74,159,164,323,15,9,24,3,3:20
567331,2019-08-29,2019,CHA,MIN,5,10,10-5,MIN,9,false,40,46,86,185,154,339,14,21,35,2,3:20
566922,2019-08-12,2019,TOR,TEX,19,4,19-4,TOR,9,true,47,37,84,120,171,291,25,10,35,3,3:02
564993,2019-08-21,2019,BAL,KCA,8,1,8-1,BAL,9,true,39,36,75,154,162,316,18,8,26,0,2:52
564987,2019-08-07,2019,BAL,NYA,2,14,14-2,NYA,9,false,35,46,81,194,142,336,8,19,27,4,3:08
565856,2019-08-04,2019,LAN,SDN,11,10,11-10,LAN,9,false,40,42,82,178,163,341,15,15,30,4,3:54
566920,2019-08-10,2019,TOR,NYA,5,4,5-4,TOR,9,true,37,37,74,185,176,361,13,11,24,4,3:27
566828,2019-08-17,2019,TEX,MIN,7,12,12-7,MIN,9,false,40,49,89,185,144,329,13,22,35,2,3:30
565085,2019-08-07,2019,BOS,KCA,5,4,5-4,BOS,10,false,44,45,89,180,169,349,18,16,34,2,3:48 (1:49 delay)
565477,2019-08-28,2019,COL,BOS,4,7,7-4,BOS,9,false,40,42,82,173,168,341,15,15,30,2,3:48
565669,2019-08-24,2019,HOU,ANA,5,2,5-2,HOU,9,true,37,39,76,177,145,322,13,14,27,2,3:03
567419,2019-08-11,2019,MIA,ATL,4,5,5-4,ATL,9,false,42,36,78,160,171,331,16,11,27,2,3:23
566524,2019-08-05,2019,SFN,WAS,0,4,4-0,WAS,9,false,33,41,74,214,113,327,7,14,21,0,3:12
567222,2019-08-03,2019,ATL,CIN,5,4,5-4,ATL,10,false,46,40,86,140,209,349,18,11,29,3,3:47
566721,2019-08-06,2019,TBA,TOR,7,6,7-6,TBA,10,false,47,41,88,153,205,358,17,10,27,2,3:50
567223,2019-08-04,2019,ATL,CIN,4,6,6-4,CIN,10,false,45,45,90,159,174,333,16,19,35,2,3:54
566924,2019-08-14,2019,TOR,TEX,3,7,7-3,TEX,9,false,39,45,84,198,155,353,11,18,29,4,3:22
566826,2019-08-15,2019,TEX,MIN,6,13,13-6,MIN,9,false,39,48,87,175,157,332,15,20,35,1,3:18
565863,2019-08-20,2019,LAN,TOR,16,3,16-3,LAN,9,true,47,34,81,128,202,330,26,11,37,3,3:20
567427,2019-08-27,2019,MIA,CIN,5,8,8-5,CIN,9,false,40,45,85,189,165,354,14,17,31,2,3:24
566824,2019-08-03,2019,TEX,DET,5,4,5-4,TEX,10,false,42,43,85,168,171,339,13,15,28,2,3:35
566626,2019-08-20,2019,SLN,MIL,9,4,9-4,SLN,9,true,43,40,83,170,179,349,20,14,34,5,3:42
565571,2019-08-27,2019,DET,CLE,1,10,10-1,CLE,9,false,32,45,77,189,157,346,5,20,25,2,3:12
566245,2019-08-25,2019,PIT,CIN,9,8,9-8,PIT,9,true,40,42,82,163,167,330,16,15,31,1,3:25
566632,2019-09-01,2019,SLN,CIN,3,5,5-3,CIN,9,false,35,41,76,166,154,320,9,13,22,2,3:04
567121,2019-08-15,2019,PHI,CHN,7,5,7-5,PHI,9,false,38,40,78,146,139,285,14,14,28,3,3:13
565380,2019-08-14,2019,CLE,BOS,1,5,5-1,BOS,9,false,35,40,75,166,142,308,9,15,24,3,3:18
565468,2019-08-03,2019,COL,SFN,5,6,6-5,SFN,9,false,40,46,86,194,157,351,14,20,34,4,3:42
566142,2019-08-03,2019,OAK,SLN,8,3,8-3,OAK,9,true,42,37,79,160,186,346,20,11,31,5,3:37
567123,2019-08-17,2019,PHI,SDN,3,5,5-3,SDN,9,false,35,41,76,152,140,292,8,15,23,1,3:16
567016,2019-08-04,2019,MIN,KCA,3,0,3-0,MIN,9,true,32,28,60,126,121,247,9,3,12,2,2:28 (:28 delay)
565085,2019-08-07,2019,BOS,KCA,5,4,5-4,BOS,10,false,44,45,89,180,169,349,18,16,34,2,3:48 (1:49 delay)
566829,2019-08-18,2019,TEX,MIN,3,6,6-3,MIN,9,false,42,44,86,181,181,362,14,15,29,0,3:49
564986,2019-08-06,2019,BAL,NYA,4,9,9-4,NYA,9,false,38,44,82,167,156,323,13,19,32,4,3:22 (1:12 delay)
566334,2019-08-12,2019,SDN,TBA,4,10,10-4,TBA,9,false,38,49,87,204,132,336,11,23,34,2,3:47
565520,2019-08-06,2019,DET,CHA,3,5,5-3,CHA,9,false,39,41,80,165,165,330,12,17,29,3,3:19
567018,2019-08-06,2019,MIN,ATL,7,12,12-7,ATL,9,false,41,47,88,166,173,339,14,20,34,3,3:27
567023,2019-08-11,2019,MIN,CLE,3,7,7-3,CLE,10,false,39,42,81,159,157,316,10,12,22,5,3:29
565275,2019-08-05,2019,CIN,ANA,7,4,7-4,CIN,9,true,35,36,71,179,144,323,11,9,20,3,3:07
566825,2019-08-04,2019,TEX,DET,9,4,9-4,TEX,9,true,39,41,80,170,149,319,14,14,28,4,3:27
565866,2019-08-23,2019,LAN,NYA,2,10,10-2,NYA,9,false,34,44,78,161,147,308,7,18,25,2,3:16
567415,2019-08-01,2019,MIA,MIN,5,4,5-4,MIA,12,false,51,47,98,193,187,380,19,12,31,1,4:14
565277,2019-08-08,2019,CIN,CHN,5,12,12-5,CHN,9,false,43,50,93,193,170,363,15,24,39,2,3:45
567226,2019-08-15,2019,ATL,NYN,8,10,10-8,NYN,9,false,42,51,93,180,159,339,16,27,43,4,3:33
565860,2019-08-09,2019,LAN,ARI,2,3,3-2,ARI,11,false,39,48,87,178,156,334,7,17,24,3,3:49
564792,2019-08-13,2019,ANA,PIT,7,10,10-7,PIT,9,false,41,48,89,188,158,346,17,23,40,2,3:46
565957,2019-08-18,2019,WAS,MIL,16,8,16-8,WAS,9,true,46,46,92,169,167,336,23,20,43,2,3:24
566338,2019-08-24,2019,SDN,BOS,4,5,5-4,BOS,9,false,40,41,81,155,180,335,14,16,30,2,3:48
567615,2019-08-24,2019,MIL,ARI,4,0,4-0,MIL,9,true,39,34,73,154,170,324,15,7,22,3,3:29
564990,2019-08-11,2019,BAL,HOU,8,7,8-7,BAL,9,false,45,43,88,172,191,363,20,17,37,3,3:51
566727,2019-08-20,2019,TBA,SEA,4,7,7-4,SEA,9,false,39,42,81,184,180,364,13,15,28,0,3:25
566832,2019-08-21,2019,TEX,ANA,8,7,8-7,TEX,9,false,40,45,85,167,173,340,16,17,33,5,3:46
564890,2019-08-17,2019,ARI,SFN,6,11,11-6,SFN,9,false,39,47,86,192,154,346,14,20,34,3,3:40
566724,2019-08-17,2019,TBA,DET,1,0,1-0,TBA,13,false,48,42,90,166,192,358,13,4,17,2,3:39
565276,2019-08-06,2019,CIN,ANA,8,4,8-4,CIN,9,true,39,37,76,158,157,315,17,12,29,3,3:08 (:54 delay)
565383,2019-08-25,2019,CLE,KCA,8,9,9-8,KCA,10,false,45,44,89,186,166,352,16,15,31,4,3:39
565564,2019-08-08,2019,DET,KCA,10,8,10-8,DET,9,false,45,39,84,164,192,356,18,12,30,4,3:37
565094,2019-08-21,2019,BOS,PHI,2,5,5-2,PHI,9,false,38,41,79,180,160,340,12,14,26,3,3:39
567618,2019-08-27,2019,MIL,SLN,3,6,6-3,SLN,9,false,36,40,76,167,163,330,9,17,26,4,3:27 (:09 delay)
565960,2019-08-30,2019,WAS,MIA,7,6,7-6,WAS,9,false,39,42,81,160,151,311,15,15,30,3,3:35
567424,2019-08-24,2019,MIA,PHI,3,9,9-3,PHI,9,false,38,48,86,213,132,345,12,23,35,1,3:37
567524,2019-08-18,2019,NYA,CLE,4,8,8-4,CLE,9,false,40,43,83,174,181,355,13,16,29,2,3:40
566831,2019-08-20,2019,TEX,ANA,3,2,3-2,TEX,11,false,43,41,84,179,150,329,13,9,22,2,3:36
566921,2019-08-11,2019,TOR,NYA,0,1,1-0,NYA,9,false,29,32,61,136,121,257,4,7,11,1,2:42
566437,2019-08-25,2019,SEA,TOR,3,1,3-1,SEA,9,true,27,35,62,135,92,227,4,8,12,0,2:28
567487,2019-08-03,2019,NYA,BOS,6,4,6-4,NYA,9,true,40,42,82,198,184,382,18,16,34,3,4:02
566530,2019-08-11,2019,SFN,PHI,9,6,9-6,SFN,9,true,38,48,86,190,142,332,16,22,38,6,3:31
566435,2019-08-23,2019,SEA,TOR,7,4,7-4,SEA,9,true,44,41,85,151,185,336,20,14,34,5,3:51
565673,2019-08-29,2019,HOU,TBA,8,9,9-8,TBA,9,false,46,43,89,155,206,361,18,16,34,7,4:06
565092,2019-08-18,2019,BOS,BAL,13,7,13-7,BOS,9,true,45,41,86,168,173,341,21,15,36,3,3:38
564883,2019-08-03,2019,ARI,WAS,18,7,18-7,ARI,9,true,50,42,92,159,211,370,26,16,42,4,3:46
565188,2019-08-24,2019,CHN,WAS,2,7,7-2,WAS,9,false,38,45,83,177,166,343,13,20,33,2,3:56
565475,2019-08-18,2019,COL,MIA,7,6,7-6,COL,10,false,44,44,88,166,195,361,15,14,29,3,3:57
566044,2019-08-11,2019,NYN,WAS,4,7,7-4,WAS,9,false,39,41,80,176,156,332,12,14,26,5,3:35
566532,2019-08-14,2019,SFN,OAK,5,9,9-5,OAK,9,false,37,44,81,183,142,325,10,19,29,4,3:15
566624,2019-08-11,2019,SLN,PIT,11,9,11-9,SLN,9,true,44,39,83,149,172,321,20,15,35,4,3:40
565961,2019-08-31,2019,WAS,MIA,7,0,7-0,WAS,9,true,33,29,62,128,123,251,10,3,13,0,2:31
565953,2019-08-13,2019,WAS,CIN,3,1,3-1,WAS,9,true,30,36,66,128,121,249,8,11,19,2,2:38
566930,2019-08-30,2019,TOR,HOU,4,7,7-4,HOU,9,false,41,44,85,173,193,366,15,17,32,1,3:22
567609,2019-08-09,2019,MIL,TEX,6,5,6-5,MIL,9,false,40,43,83,211,178,389,17,16,33,5,4:01
567429,2019-08-29,2019,MIA,CIN,4,3,4-3,MIA,12,false,41,45,86,183,160,343,11,10,21,2,3:35
566335,2019-08-13,2019,SDN,TBA,5,7,7-5,TBA,9,false,41,44,85,175,172,347,16,16,32,2,3:44
565089,2019-08-11,2019,BOS,ANA,4,5,5-4,ANA,10,false,43,45,88,180,174,354,15,17,32,5,4:02
567612,2019-08-13,2019,MIL,MIN,5,7,7-5,MIN,9,false,44,41,85,186,155,341,16,16,32,3,3:47
566729,2019-08-30,2019,TBA,CLE,4,0,4-0,TBA,9,true,32,32,64,134,133,267,10,7,17,2,2:52
566340,2019-08-26,2019,SDN,LAN,4,3,4-3,SDN,9,true,29,39,68,141,116,257,5,13,18,2,2:52
567521,2019-08-15,2019,NYA,CLE,5,19,19-5,CLE,9,false,39,54,93,219,153,372,11,29,40,2,3:28
565568,2019-08-13,2019,DET,SEA,6,11,11-6,SEA,9,false,43,44,87,184,185,369,17,17,34,3,3:42
567321,2019-08-11,2019,CHA,OAK,0,2,2-0,OAK,9,false,32,36,68,145,127,272,7,9,16,2,2:52 (:28 delay)
565955,2019-08-16,2019,WAS,MIL,2,1,2-1,WAS,9,true,32,41,73,154,113,267,8,14,22,1,3:00
564889,2019-08-16,2019,ARI,SFN,9,10,10-9,SFN,11,false,49,50,99,197,189,386,16,19,35,4,4:05
566633,2019-08-31,2019,SLN,CIN,3,2,3-2,SLN,9,false,36,33,69,122,135,257,11,8,19,4,2:53
567619,2019-08-28,2019,MIL,SLN,4,1,4-1,MIL,9,true,33,34,67,141,137,278,10,8,18,2,2:50
564798,2019-08-27,2019,ANA,TEX,5,2,5-2,ANA,9,true,31,36,67,147,121,268,8,9,17,2,2:48
565567,2019-08-11,2019,DET,KCA,2,10,10-2,KCA,9,false,33,42,75,178,119,297,8,14,22,1,2:35
565868,2019-08-25,2019,LAN,NYA,1,5,5-1,NYA,9,false,35,36,71,130,121,251,9,10,19,1,2:51
566834,2019-08-30,2019,TEX,SEA,6,3,6-3,TEX,9,true,35,37,72,139,127,266,9,11,20,3,2:45
567423,2019-08-23,2019,MIA,PHI,19,11,19-11,MIA,9,true,48,48,96,207,186,393,24,23,47,6,4:10
565861,2019-08-10,2019,LAN,ARI,4,0,4-0,LAN,9,true,36,31,67,127,150,277,12,5,17,3,3:18
566835,2019-08-31,2019,TEX,SEA,3,2,3-2,TEX,9,false,34,36,70,144,116,260,9,11,20,1,2:49
567421,2019-08-14,2019,MIA,LAN,1,9,9-1,LAN,9,false,31,43,74,154,120,274,4,17,21,0,2:45
565280,2019-08-11,2019,CIN,CHN,3,6,6-3,CHN,9,false,37,39,76,134,151,285,10,12,22,2,2:55
564897,2019-08-31,2019,ARI,LAN,6,5,6-5,ARI,9,true,33,37,70,140,140,280,9,14,23,2,3:11
565191,2019-08-31,2019,CHN,MIL,0,2,2-0,MIL,9,false,35,39,74,145,134,279,8,12,20,3,2:57
566537,2019-08-31,2019,SFN,SDN,1,4,4-1,SDN,9,false,36,39,75,136,146,282,11,13,24,1,2:58
566534,2019-08-27,2019,SFN,ARI,2,3,3-2,ARI,9,false,34,39,73,161,113,274,8,12,20,4,2:46
564888,2019-08-15,2019,ARI,SFN,0,7,7-0,SFN,9,false,31,44,75,164,115,279,4,21,25,0,2:44
566438,2019-08-26,2019,SEA,NYA,4,5,5-4,NYA,9,false,35,37,72,127,165,292,8,11,19,1,2:57
566152,2019-08-25,2019,OAK,SFN,4,5,5-4,SFN,9,false,37,39,76,151,129,280,12,13,25,4,3:02
564997,2019-08-25,2019,BAL,TBA,8,3,8-3,BAL,9,true,41,36,77,133,154,287,19,12,31,1,2:54
565770,2019-08-31,2019,KCA,BAL,7,5,7-5,KCA,9,true,40,35,75,149,142,291,14,9,23,3,2:54
566536,2019-08-30,2019,SFN,SDN,8,3,8-3,SFN,9,true,41,33,74,133,161,294,16,8,24,0,2:54
567329,2019-08-27,2019,CHA,MIN,1,3,3-1,MIN,9,false,34,36,70,145,148,293,8,11,19,2,3:16
567320,2019-08-10,2019,CHA,OAK,3,2,3-2,CHA,9,true,32,42,74,179,122,301,9,18,27,4,3:19
567426,2019-08-26,2019,MIA,CIN,3,6,6-3,CIN,9,false,37,40,77,158,147,305,10,14,24,1,3:03
566931,2019-08-31,2019,TOR,HOU,6,4,6-4,TOR,9,true,37,39,76,154,139,293,14,16,30,4,3:04
565190,2019-08-30,2019,CHN,MIL,7,1,7-1,CHN,9,true,36,37,73,150,140,290,14,10,24,1,3:07
566833,2019-08-29,2019,TEX,SEA,3,5,5-3,SEA,9,false,34,42,76,162,142,304,8,14,22,0,3:09
566145,2019-08-16,2019,OAK,HOU,3,2,3-2,OAK,13,false,47,53,100,225,181,406,9,15,24,0,4:13
564896,2019-08-30,2019,ARI,LAN,5,4,5-4,ARI,9,true,36,39,75,153,145,298,11,12,23,4,3:41
566730,2019-08-31,2019,TBA,CLE,9,6,9-6,TBA,9,true,40,37,77,143,155,298,16,13,29,6,3:18
567127,2019-08-28,2019,PHI,PIT,12,3,12-3,PHI,9,true,44,35,79,122,189,311,20,9,29,1,3:20
566599,2019-08-31,2019,SLN,CIN,10,6,10-6,SLN,9,true,39,38,77,139,161,300,16,11,27,3,3:10
566439,2019-08-27,2019,SEA,NYA,0,7,7-0,NYA,9,false,31,45,76,176,136,312,4,17,21,0,2:59
567324,2019-08-14,2019,CHA,HOU,13,9,13-9,CHA,9,true,41,46,87,168,157,325,18,21,39,6,3:30
566048,2019-08-23,2019,NYN,ATL,1,2,2-1,ATL,14,false,52,56,108,220,219,439,12,15,27,1,4:37
564895,2019-08-29,2019,ARI,LAN,11,5,11-5,ARI,9,true,43,40,83,157,149,306,20,15,35,2,3:23
565479,2019-08-30,2019,COL,PIT,4,9,9-4,PIT,9,false,38,42,80,153,155,308,11,18,29,1,3:18 (:16 delay)
566830,2019-08-19,2019,TEX,ANA,8,7,8-7,TEX,11,false,56,52,108,204,235,439,24,20,44,2,4:35
565769,2019-08-30,2019,KCA,BAL,2,14,14-2,BAL,9,false,34,51,85,202,111,313,7,27,34,1,3:07
567613,2019-08-14,2019,MIL,MIN,6,5,6-5,MIL,9,true,40,41,81,170,163,333,15,15,30,3,3:48
566436,2019-08-24,2019,SEA,TOR,5,7,7-5,TOR,9,false,42,41,83,171,165,336,14,16,30,5,3:38
564801,2019-08-31,2019,ANA,BOS,10,4,10-4,ANA,9,true,41,41,82,151,152,303,18,13,31,2,3:37
565480,2019-08-31,2019,COL,PIT,4,11,11-4,PIT,9,false,37,49,86,184,139,323,11,21,32,0,3:26
566052,2019-08-28,2019,NYN,CHN,7,10,10-7,CHN,9,false,45,42,87,153,164,317,19,15,34,3,3:24 (:12 delay)
567233,2019-08-30,2019,ATL,CHA,10,7,10-7,ATL,9,true,42,38,80,142,168,310,20,10,30,4,3:28
565575,2019-08-31,2019,DET,MIN,10,7,10-7,DET,9,true,42,41,83,173,161,334,18,14,32,2,3:20
567420,2019-08-13,2019,MIA,LAN,1,15,15-1,LAN,9,false,33,48,81,208,134,342,8,20,28,3,3:22
566440,2019-08-28,2019,SEA,NYA,3,7,7-3,NYA,9,false,35,40,75,179,164,343,10,14,24,1,3:11
567129,2019-08-31,2019,PHI,NYN,3,6,6-3,NYN,9,false,38,45,83,182,156,338,11,17,28,4,3:41
567616,2019-08-25,2019,MIL,ARI,2,5,5-2,ARI,9,false,39,40,79,169,177,346,13,13,26,2,3:44
566533,2019-08-26,2019,SFN,ARI,4,6,6-4,ARI,9,false,42,40,82,163,174,337,12,13,25,5,3:30
565476,2019-08-27,2019,COL,BOS,6,10,10-6,BOS,9,false,42,43,85,160,168,328,16,18,34,2,3:32
566151,2019-08-24,2019,OAK,SFN,5,10,10-5,SFN,9,false,42,43,85,167,179,346,16,15,31,8,3:50
567125,2019-08-26,2019,PHI,PIT,6,5,6-5,PHI,11,false,44,46,90,156,174,330,15,18,33,2,3:57
565574,2019-08-30,2019,DET,MIN,5,13,13-5,MIN,9,false,37,46,83,184,161,345,12,19,31,1,3:31
566929,2019-08-28,2019,TOR,ATL,4,9,9-4,ATL,9,false,40,43,83,175,164,339,13,17,30,3,3:33
567234,2019-08-31,2019,ATL,CHA,11,5,11-5,ATL,9,true,43,42,85,156,185,341,21,15,36,3,3:52
566631,2019-08-25,2019,SLN,COL,11,4,11-4,SLN,9,true,43,40,83,200,162,362,21,12,33,2,3:31 (2:35 delay)
564800,2019-08-30,2019,ANA,BOS,6,7,7-6,BOS,15,false,67,56,123,218,278,496,24,14,38,4,5:23
567617,2019-08-26,2019,MIL,SLN,2,12,12-2,SLN,9,false,38,48,86,179,170,349,13,20,33,4,3:34
567116,2019-08-02,2019,PHI,CHA,3,4,4-3,CHA,15,false,63,58,121,239,245,484,21,17,38,4,5:28
565379,2019-08-13,2019,CLE,BOS,6,7,7-6,BOS,10,false,42,48,90,203,172,375,12,23,35,4,4:07
565954,2019-08-14,2019,WAS,CIN,17,7,17-7,WAS,9,true,44,44,88,167,184,351,21,17,38,3,3:38
566342,2019-08-28,2019,SDN,LAN,4,6,6-4,LAN,10,false,41,47,88,194,155,349,11,19,30,4,4:05
567526,2019-08-31,2019,NYA,OAK,4,3,4-3,NYA,11,false,37,51,88,217,160,377,8,21,29,3,3:58
567422,2019-08-15,2019,MIA,LAN,13,7,13-7,MIA,9,true,44,43,87,206,177,383,22,16,38,4,4:07
565956,2019-08-17,2019,WAS,MIL,14,15,15-14,MIL,14,false,69,65,134,247,260,507,30,29,59,5,5:40
565765,2019-08-26,2019,KCA,OAK,4,19,19-4,OAK,9,false,39,55,94,215,158,373,13,28,41,3,3:37
565189,2019-08-25,2019,CHN,WAS,5,7,7-5,WAS,11,false,43,49,92,215,200,415,11,18,29,3,4:35
565766,2019-08-27,2019,KCA,OAK,1,2,2-1,OAK,9,false,35,35,70,133,142,275,11,11,22,2,2:56
567029,2019-08-25,2019,MIN,DET,7,4,7-4,MIN,9,true,36,37,73,154,139,293,12,10,22,0,2:50
565670,2019-08-25,2019,HOU,ANA,11,2,11-2,HOU,9,true,39,35,74,127,151,278,17,11,28,2,2:59
566339,2019-08-25,2019,SDN,BOS,3,1,3-1,SDN,9,true,32,34,66,138,138,276,10,7,17,0,2:54
566341,2019-08-27,2019,SDN,LAN,0,9,9-0,LAN,9,false,33,42,75,159,132,291,8,17,25,1,3:02
565418,2019-08-26,2019,COL,ATL,3,1,3-1,COL,9,false,32,37,69,165,144,309,10,12,22,1,3:27
565671,2019-08-27,2019,HOU,TBA,15,1,15-1,HOU,9,true,47,38,85,152,162,314,23,12,35,1,3:10
566634,2019-09-01,2019,SLN,CIN,4,3,4-3,SLN,9,false,34,32,66,132,139,271,9,5,14,2,2:58
565300,2019-09-26,2019,CIN,MIL,3,5,5-3,MIL,9,false,40,35,75,141,146,287,14,9,23,1,2:50
565780,2019-09-27,2019,KCA,MIN,2,6,6-2,MIN,7,true,26,33,59,110,99,209,8,13,21,0,1:54 (:56 delay)
566932,2019-09-01,2019,TOR,HOU,0,2,2-0,HOU,9,false,28,34,62,128,120,248,1,7,8,0,2:29
565577,2019-09-02,2019,DET,MIN,3,4,4-3,MIN,9,false,35,41,76,145,146,291,9,15,24,1,3:07
567130,2019-09-01,2019,PHI,NYN,5,2,5-2,PHI,9,true,36,33,69,118,130,248,14,7,21,4,2:52
565299,2019-09-25,2019,CIN,MIL,2,9,9-2,MIL,9,false,37,45,82,166,146,312,10,19,29,1,3:01
565962,2019-09-01,2019,WAS,MIA,9,3,9-3,WAS,9,true,37,34,71,127,133,260,12,7,19,1,2:46
565193,2019-09-02,2019,CHN,SEA,5,1,5-1,CHN,9,true,38,32,70,137,150,287,16,6,22,1,2:56
567235,2019-09-01,2019,ATL,CHA,5,3,5-3,ATL,9,true,31,36,67,156,124,280,8,10,18,1,3:08
567236,2019-09-02,2019,ATL,TOR,6,3,6-3,ATL,9,true,35,34,69,135,158,293,10,7,17,0,2:52
564903,2019-09-14,2019,ARI,CIN,1,0,1-0,ARI,9,true,25,30,55,111,90,201,1,5,6,0,2:15
565683,2019-09-18,2019,HOU,TEX,3,2,3-2,HOU,9,true,36,34,70,116,134,250,11,9,20,0,2:35
567036,2019-09-16,2019,MIN,CHA,5,3,5-3,MIN,9,true,35,34,69,113,126,239,12,8,20,3,2:42
565682,2019-09-17,2019,HOU,TEX,4,1,4-1,HOU,9,true,34,32,66,130,122,252,10,8,18,0,2:45
566635,2019-09-02,2019,SLN,SFN,3,1,3-1,SLN,9,true,33,33,66,139,126,265,9,6,15,3,2:43
565771,2019-09-01,2019,KCA,BAL,6,4,6-4,KCA,9,true,39,36,75,120,137,257,16,9,25,5,2:45
566160,2019-09-17,2019,OAK,KCA,2,1,2-1,OAK,9,true,32,32,64,114,134,248,8,6,14,1,2:32
566344,2019-09-07,2019,SDN,COL,3,0,3-0,SDN,9,true,33,34,67,128,128,256,10,8,18,1,2:49
566062,2019-09-14,2019,NYN,LAN,3,0,3-0,NYN,9,true,30,31,61,130,120,250,6,4,10,2,2:40
565676,2019-09-07,2019,HOU,SEA,2,1,2-1,HOU,9,true,32,32,64,133,133,266,9,7,16,1,2:56
565385,2019-09-03,2019,CLE,CHA,5,6,6-5,CHA,9,false,34,38,72,156,145,301,8,11,19,1,3:05
567245,2019-09-20,2019,ATL,SFN,6,0,6-0,ATL,9,true,35,33,68,105,125,230,12,5,17,1,2:21
565392,2019-09-18,2019,CLE,DET,2,1,2-1,CLE,10,false,40,34,74,121,140,261,14,5,19,2,2:45
565773,2019-09-04,2019,KCA,DET,5,4,5-4,KCA,9,true,37,34,71,131,131,262,14,10,24,4,2:44
564998,2019-09-05,2019,BAL,TEX,1,3,3-1,TEX,9,false,37,36,73,132,124,256,13,9,22,3,2:35
565288,2019-09-02,2019,CIN,PHI,1,7,7-1,PHI,9,false,34,36,70,142,137,279,10,8,18,1,2:40
567528,2019-09-02,2019,NYA,TEX,0,7,7-0,TEX,9,false,33,40,73,150,133,283,7,15,22,1,3:04 (2:52 delay)
566544,2019-09-14,2019,SFN,MIA,2,4,4-2,MIA,9,false,37,33,70,107,126,233,11,8,19,5,2:56
565008,2019-09-20,2019,BAL,SEA,5,3,5-3,BAL,9,true,35,33,68,113,145,258,12,5,17,0,2:27
565576,2019-09-01,2019,DET,MIN,3,8,8-3,MIN,9,false,36,44,80,169,129,298,10,17,27,2,3:07 (:21 delay)
567238,2019-09-05,2019,ATL,WAS,4,2,4-2,ATL,9,true,33,32,65,134,147,281,10,5,15,1,2:57
565489,2019-09-17,2019,COL,NYN,1,6,6-1,NYN,9,false,32,36,68,133,130,263,7,14,21,2,2:50
567626,2019-09-16,2019,MIL,SDN,5,1,5-1,MIL,9,true,33,32,65,132,126,258,9,5,14,1,2:35
565293,2019-09-07,2019,CIN,ARI,0,2,2-0,ARI,9,false,31,37,68,151,128,279,5,9,14,3,2:39
565584,2019-09-16,2019,DET,BAL,5,2,5-2,DET,9,true,34,38,72,153,109,262,11,11,22,2,2:35
565387,2019-09-05,2019,CLE,CHA,1,7,7-1,CHA,9,false,31,42,73,153,109,262,4,16,20,1,2:38
567628,2019-09-18,2019,MIL,SDN,1,2,2-1,SDN,9,false,35,34,69,126,138,264,8,9,17,1,3:01
564907,2019-09-18,2019,ARI,MIA,5,4,5-4,ARI,9,true,36,38,74,117,138,255,11,11,22,5,2:55
565483,2019-09-11,2019,COL,SLN,2,1,2-1,COL,9,true,36,36,72,137,128,265,13,10,23,2,3:01
565098,2019-09-06,2019,BOS,NYA,6,1,6-1,BOS,9,true,35,32,67,153,150,303,14,6,20,1,3:08
564808,2019-09-15,2019,ANA,TBA,6,4,6-4,ANA,9,true,34,35,69,141,133,274,13,8,21,1,2:54
566736,2019-09-06,2019,TBA,TOR,5,0,5-0,TBA,9,true,32,31,63,122,127,249,9,4,13,2,2:35
566545,2019-09-15,2019,SFN,MIA,2,1,2-1,SFN,9,true,33,34,67,129,137,266,11,8,19,3,2:51
565388,2019-09-14,2019,CLE,MIN,0,2,2-0,MIN,9,false,36,35,71,129,146,275,8,8,16,2,2:53
566636,2019-09-03,2019,SLN,SFN,1,0,1-0,SLN,9,true,29,30,59,123,106,229,6,3,9,0,2:11
567625,2019-09-08,2019,MIL,CHN,8,5,8-5,MIL,9,true,37,37,74,132,152,284,15,11,26,3,3:09
565388,2019-09-14,2019,CLE,MIN,0,2,2-0,MIN,9,false,36,35,71,129,146,275,8,8,16,2,2:53
566732,2019-09-02,2019,TBA,BAL,5,4,5-4,TBA,10,false,39,38,77,149,151,300,10,10,20,1,3:16
567031,2019-09-07,2019,MIN,CLE,5,3,5-3,MIN,9,true,36,36,72,156,131,287,12,9,21,4,3:16
565774,2019-09-05,2019,KCA,DET,4,6,6-4,DET,9,false,39,39,78,148,135,283,15,13,28,2,2:59
567530,2019-09-04,2019,NYA,TEX,4,1,4-1,NYA,9,true,35,35,70,133,162,295,11,9,20,1,3:05
567627,2019-09-17,2019,MIL,SDN,3,1,3-1,MIL,9,true,29,32,61,155,137,292,5,6,11,1,2:37
566154,2019-09-04,2019,OAK,ANA,4,0,4-0,OAK,9,true,33,35,68,136,135,271,9,7,16,2,2:31
566162,2019-09-20,2019,OAK,TEX,8,0,8-0,OAK,9,true,40,27,67,109,175,284,17,2,19,0,2:38
566253,2019-09-18,2019,PIT,SEA,1,4,4-1,SEA,9,false,34,36,70,151,117,268,9,11,20,1,2:47
565192,2019-09-01,2019,CHN,MIL,0,4,4-0,MIL,9,false,36,40,76,167,131,298,11,13,24,5,3:29
567244,2019-09-19,2019,ATL,PHI,5,4,5-4,ATL,9,true,35,38,73,152,119,271,12,12,24,1,3:10
565296,2019-09-21,2019,CIN,NYN,3,2,3-2,CIN,9,true,36,33,69,122,136,258,12,5,17,2,2:48
564802,2019-09-01,2019,ANA,BOS,3,4,4-3,BOS,9,false,39,37,76,154,168,322,13,13,26,1,3:21
565970,2019-09-24,2019,WAS,PHI,6,5,6-5,WAS,9,true,35,34,69,136,151,287,12,7,19,2,3:06
565199,2019-09-17,2019,CHN,CIN,2,4,4-2,CIN,9,false,36,36,72,133,138,271,9,9,18,2,3:08
566058,2019-09-10,2019,NYN,ARI,3,2,3-2,NYN,9,true,31,38,69,147,115,262,7,13,20,2,3:02
565588,2019-09-24,2019,DET,MIN,2,4,4-2,MIN,9,false,34,38,72,129,148,277,7,13,20,2,2:53
566057,2019-09-09,2019,NYN,ARI,3,1,3-1,NYN,9,true,32,30,62,129,122,251,13,4,17,3,2:45
566848,2019-09-29,2019,TEX,NYA,6,1,6-1,TEX,9,true,37,31,68,126,128,254,15,4,19,1,2:47
566441,2019-09-10,2019,SEA,CIN,4,3,4-3,SEA,9,true,31,36,67,142,149,291,8,13,21,3,2:49
565870,2019-09-03,2019,LAN,COL,5,3,5-3,LAN,9,true,32,36,68,149,135,284,9,10,19,3,3:14
565389,2019-09-14,2019,CLE,MIN,5,9,9-5,MIN,9,false,38,39,77,132,148,280,12,12,24,4,3:02
565003,2019-09-11,2019,BAL,LAN,7,3,7-3,BAL,9,true,36,34,70,141,142,283,12,8,20,3,2:59
565099,2019-09-07,2019,BOS,NYA,1,5,5-1,NYA,9,false,32,43,75,171,141,312,6,17,23,3,3:29
567135,2019-09-14,2019,PHI,BOS,1,2,2-1,BOS,9,false,36,37,73,140,143,283,10,11,21,2,3:21
566640,2019-09-14,2019,SLN,MIL,2,5,5-2,MIL,9,false,34,37,71,156,135,291,7,11,18,3,2:59
565930,2019-09-24,2019,WAS,PHI,4,1,4-1,WAS,9,true,35,33,68,133,150,283,11,7,18,2,3:07
565391,2019-09-17,2019,CLE,DET,7,2,7-2,CLE,9,true,42,33,75,133,179,312,17,9,26,2,2:56
566737,2019-09-07,2019,TBA,TOR,5,3,5-3,TBA,9,true,37,38,75,145,151,296,15,11,26,4,3:06
565481,2019-09-01,2019,COL,PIT,2,6,6-2,PIT,9,false,36,42,78,147,127,274,9,16,25,2,3:19
566540,2019-09-10,2019,SFN,PIT,5,4,5-4,SFN,9,true,33,36,69,149,128,277,9,10,19,3,2:57
564807,2019-09-14,2019,ANA,TBA,1,3,3-1,TBA,9,false,35,35,70,151,129,280,8,9,17,3,3:13
566351,2019-09-21,2019,SDN,ARI,2,4,4-2,ARI,9,false,37,36,73,134,135,269,9,9,18,4,3:12
567341,2019-09-28,2019,CHA,DET,3,4,4-3,DET,9,false,36,38,74,151,130,281,11,11,22,2,2:58
567332,2019-09-06,2019,CHA,ANA,4,5,5-4,ANA,9,false,35,34,69,145,141,286,10,7,17,1,3:02
565390,2019-09-15,2019,CLE,MIN,7,5,7-5,CLE,9,true,37,40,77,144,140,284,14,15,29,4,3:09
567529,2019-09-03,2019,NYA,TEX,10,1,10-1,NYA,9,true,37,31,68,131,147,278,14,5,19,1,2:36
567437,2019-09-20,2019,MIA,WAS,4,6,6-4,WAS,9,false,38,36,74,144,141,285,13,10,23,3,3:13
564898,2019-09-01,2019,ARI,LAN,3,4,4-3,LAN,11,false,40,41,81,170,157,327,11,9,20,5,3:56
566642,2019-09-16,2019,SLN,WAS,4,2,4-2,SLN,9,true,35,33,68,113,159,272,11,7,18,3,3:04
564905,2019-09-16,2019,ARI,MIA,7,5,7-5,ARI,9,true,38,38,76,147,149,296,15,13,28,6,3:24
566731,2019-09-01,2019,TBA,CLE,8,2,8-2,TBA,9,true,39,39,78,158,139,297,18,12,30,3,3:01
567527,2019-09-01,2019,NYA,OAK,5,4,5-4,NYA,9,false,35,36,71,164,160,324,12,11,23,2,3:17
567621,2019-09-03,2019,MIL,HOU,4,2,4-2,MIL,9,true,34,31,65,123,133,256,11,6,17,2,2:41
566938,2019-09-15,2019,TOR,NYA,6,4,6-4,TOR,9,true,35,38,73,148,143,291,11,11,22,2,2:47
567340,2019-09-26,2019,CHA,CLE,8,0,8-0,CHA,9,true,39,32,71,132,164,296,17,4,21,3,2:57
567040,2019-09-20,2019,MIN,KCA,4,3,4-3,MIN,9,true,32,38,70,134,143,277,8,12,20,4,3:00
565194,2019-09-03,2019,CHN,SEA,6,1,6-1,CHN,9,true,36,39,75,152,158,310,13,14,27,2,3:14
567240,2019-09-07,2019,ATL,WAS,5,4,5-4,ATL,9,true,34,35,69,164,147,311,13,11,24,2,3:29
566252,2019-09-17,2019,PIT,SEA,0,6,6-0,SEA,9,false,34,40,74,163,127,290,9,15,24,1,2:58
567630,2019-09-20,2019,MIL,PIT,10,1,10-1,MIL,9,true,39,35,74,134,144,278,17,8,25,3,2:59
566060,2019-09-12,2019,NYN,ARI,11,1,11-1,NYN,9,true,38,37,75,142,164,306,14,10,24,6,3:25
565007,2019-09-19,2019,BAL,TOR,4,8,8-4,TOR,9,false,40,39,79,143,146,289,12,14,26,2,2:53
565968,2019-09-15,2019,WAS,ATL,7,0,7-0,WAS,9,true,37,32,69,142,157,299,17,5,22,1,3:03
567136,2019-09-15,2019,PHI,BOS,3,6,6-3,BOS,9,false,36,38,74,152,135,287,11,10,21,0,2:57
565874,2019-09-08,2019,LAN,SFN,5,0,5-0,LAN,9,true,33,32,65,129,125,254,8,5,13,3,2:46
566153,2019-09-03,2019,OAK,ANA,7,5,7-5,OAK,9,true,34,37,71,151,132,283,11,13,24,2,3:04
565396,2019-09-22,2019,CLE,PHI,10,1,10-1,CLE,9,true,38,33,71,127,136,263,12,8,20,5,3:04
566734,2019-09-03,2019,TBA,BAL,2,0,2-0,TBA,9,true,31,30,61,120,93,213,9,5,14,3,2:27
565290,2019-09-04,2019,CIN,PHI,8,5,8-5,CIN,9,true,37,35,72,143,138,281,14,9,23,3,3:02
566250,2019-09-07,2019,PIT,SLN,1,10,10-1,SLN,9,false,33,46,79,181,129,310,8,18,26,1,3:24
567431,2019-09-07,2019,MIA,KCA,2,7,7-2,KCA,9,false,38,42,80,158,157,315,12,16,28,3,3:24
566155,2019-09-05,2019,OAK,ANA,10,6,10-6,OAK,9,true,42,37,79,120,162,282,20,11,31,5,3:08
565488,2019-09-16,2019,COL,NYN,9,4,9-4,COL,9,true,40,39,79,152,148,300,16,13,29,2,3:09
565297,2019-09-22,2019,CIN,NYN,3,6,6-3,NYN,9,false,39,40,79,140,161,301,12,15,27,1,3:08
565482,2019-09-10,2019,COL,SLN,2,1,2-1,COL,9,true,31,34,65,143,106,249,8,8,16,1,2:36
564902,2019-09-13,2019,ARI,CIN,3,4,4-3,CIN,9,false,38,33,71,121,153,274,11,6,17,1,2:48
564899,2019-09-02,2019,ARI,SDN,14,7,14-7,ARI,9,true,46,43,89,162,165,327,21,18,39,4,3:26
567536,2019-09-22,2019,NYA,TOR,8,3,8-3,NYA,9,true,33,40,73,170,138,308,9,13,22,0,2:45 (:33 delay)
566842,2019-09-15,2019,TEX,OAK,1,6,6-1,OAK,9,false,36,40,76,186,142,328,9,13,22,1,3:10
567032,2019-09-08,2019,MIN,CLE,2,5,5-2,CLE,9,false,37,40,77,151,160,311,10,16,26,3,3:07
565966,2019-09-13,2019,WAS,ATL,0,5,5-0,ATL,9,false,32,43,75,169,135,304,6,18,24,1,3:16
565871,2019-09-04,2019,LAN,COL,7,3,7-3,LAN,9,true,34,38,72,165,141,306,10,12,22,3,3:12
565579,2019-09-12,2019,DET,NYA,4,6,6-4,NYA,9,false,37,39,76,173,134,307,10,15,25,4,3:02
567432,2019-09-08,2019,MIA,KCA,9,0,9-0,MIA,9,true,40,32,72,102,158,260,18,6,24,0,2:40
564900,2019-09-03,2019,ARI,SDN,2,1,2-1,ARI,9,true,35,38,73,160,135,295,12,11,23,3,3:08
567033,2019-09-10,2019,MIN,WAS,5,0,5-0,MIN,9,true,34,29,63,124,124,248,11,3,14,1,2:32
565675,2019-09-06,2019,HOU,SEA,7,4,7-4,HOU,9,true,39,39,78,159,161,320,15,12,27,3,3:31
566738,2019-09-08,2019,TBA,TOR,8,3,8-3,TBA,9,true,36,35,71,137,119,256,13,8,21,2,2:36
566246,2019-09-03,2019,PIT,MIA,4,5,5-4,MIA,10,false,40,43,83,172,145,317,14,13,27,4,3:24
566247,2019-09-04,2019,PIT,MIA,6,5,6-5,PIT,9,false,38,40,78,150,105,255,16,12,28,1,2:59
567620,2019-09-02,2019,MIL,HOU,2,3,3-2,HOU,10,false,40,41,81,184,171,355,10,12,22,2,3:35
566445,2019-09-14,2019,SEA,CHA,2,1,2-1,SEA,10,false,41,37,78,135,193,328,12,8,20,2,3:28
565289,2019-09-03,2019,CIN,PHI,2,6,6-2,PHI,9,false,37,41,78,155,167,322,10,16,26,2,3:16
567034,2019-09-11,2019,MIN,WAS,2,6,6-2,WAS,9,false,38,39,77,158,160,318,11,12,23,1,3:12
565875,2019-09-17,2019,LAN,TBA,7,5,7-5,LAN,9,true,35,37,72,159,154,313,10,9,19,8,3:43
565969,2019-09-23,2019,WAS,PHI,7,2,7-2,WAS,9,true,41,36,77,144,172,316,19,9,28,1,3:19
564810,2019-09-25,2019,ANA,OAK,2,3,3-2,OAK,9,false,36,42,78,169,135,304,11,16,27,5,3:29
566632,2019-09-01,2019,SLN,CIN,3,5,5-3,CIN,9,false,35,41,76,166,154,320,9,13,22,2,3:04
566638,2019-09-05,2019,SLN,SFN,10,0,10-0,SLN,9,true,43,33,76,136,159,295,18,6,24,1,2:54
566735,2019-09-05,2019,TBA,TOR,6,4,6-4,TBA,9,true,39,38,77,163,150,313,15,12,27,4,3:32
567439,2019-09-22,2019,MIA,WAS,5,3,5-3,MIA,9,true,35,39,74,161,134,295,12,14,26,2,3:13
567632,2019-09-22,2019,MIL,PIT,4,3,4-3,MIL,9,true,35,32,67,144,134,278,11,4,15,2,2:54
567623,2019-09-06,2019,MIL,CHN,7,1,7-1,MIL,9,true,42,31,73,124,167,291,19,5,24,1,2:51
566733,2019-09-03,2019,TBA,BAL,2,4,4-2,BAL,9,false,34,36,70,139,143,282,9,11,20,1,2:41
565294,2019-09-08,2019,CIN,ARI,4,3,4-3,CIN,9,false,37,37,74,144,143,287,13,11,24,4,3:12
566249,2019-09-06,2019,PIT,SLN,9,4,9-4,PIT,9,true,41,39,80,168,163,331,20,13,33,4,3:28
565583,2019-09-15,2019,DET,BAL,2,8,8-2,BAL,9,false,40,44,84,161,155,316,13,18,31,2,3:11 (:39 delay)
565878,2019-09-21,2019,LAN,COL,2,4,4-2,COL,9,false,34,36,70,130,139,269,7,11,18,2,3:01
566061,2019-09-13,2019,NYN,LAN,2,9,9-2,LAN,9,false,36,41,77,174,151,325,9,14,23,2,3:22
565967,2019-09-14,2019,WAS,ATL,1,10,10-1,ATL,9,false,34,46,80,174,136,310,9,23,32,2,3:29
565196,2019-09-14,2019,CHN,PIT,14,1,14-1,CHN,9,true,43,38,81,145,162,307,20,11,31,2,3:23
565585,2019-09-20,2019,DET,CHA,1,10,10-1,CHA,9,false,34,48,82,188,147,335,9,22,31,1,3:14
565002,2019-09-10,2019,BAL,LAN,3,7,7-3,LAN,9,false,35,44,79,151,135,286,8,19,27,1,2:46
565095,2019-09-03,2019,BOS,MIN,5,6,6-5,MIN,9,false,38,41,79,162,149,311,11,14,25,5,3:28
564904,2019-09-15,2019,ARI,CIN,1,3,3-1,CIN,9,false,32,35,67,138,130,268,5,9,14,2,2:55
564901,2019-09-04,2019,ARI,SDN,4,1,4-1,ARI,9,true,37,32,69,142,138,280,14,6,20,3,2:55
567038,2019-09-18,2019,MIN,CHA,1,3,3-1,CHA,9,false,34,36,70,137,132,269,8,11,19,6,3:09
565869,2019-09-02,2019,LAN,COL,16,9,16-9,LAN,9,true,48,40,88,147,202,349,26,13,39,3,4:06
567134,2019-09-12,2019,PHI,ATL,9,5,9-5,PHI,9,true,40,38,78,171,163,334,16,11,27,5,3:35
565104,2019-09-19,2019,BOS,SFN,5,4,5-4,BOS,9,true,39,40,79,177,140,317,13,13,26,1,3:17
566161,2019-09-18,2019,OAK,KCA,1,0,1-0,OAK,11,false,40,39,79,158,166,324,10,9,19,3,3:09 (:28 delay)
567242,2019-09-17,2019,ATL,PHI,4,5,5-4,PHI,9,false,41,37,78,152,175,327,14,10,24,4,3:26
565395,2019-09-21,2019,CLE,PHI,4,9,9-4,PHI,9,false,34,40,74,181,133,314,7,12,19,5,3:17
566163,2019-09-21,2019,OAK,TEX,12,3,12-3,OAK,9,true,48,36,84,137,202,339,23,11,34,3,3:17
567430,2019-09-06,2019,MIA,KCA,0,3,3-0,KCA,9,false,33,38,71,141,141,282,7,13,20,1,2:52
566943,2019-09-28,2019,TOR,TBA,4,1,4-1,TOR,9,true,36,35,71,160,148,308,16,9,25,3,3:17
567333,2019-09-07,2019,CHA,ANA,7,8,8-7,ANA,9,false,37,47,84,196,151,347,10,21,31,2,3:32
566251,2019-09-08,2019,PIT,SLN,0,2,2-0,SLN,9,false,32,35,67,143,120,263,7,9,16,1,2:50
567624,2019-09-07,2019,MIL,CHN,3,2,3-2,MIL,9,false,39,35,74,151,156,307,13,9,22,5,3:35
565107,2019-09-29,2019,BOS,BAL,5,4,5-4,BOS,9,false,38,36,74,164,144,308,16,8,24,3,3:22
566067,2019-09-26,2019,NYN,MIA,2,4,4-2,MIA,9,false,35,33,68,123,140,263,10,6,16,3,2:45
565004,2019-09-12,2019,BAL,LAN,2,4,4-2,LAN,9,false,35,37,72,134,148,282,9,9,18,4,3:09
566354,2019-09-25,2019,SDN,LAN,4,6,6-4,LAN,9,false,39,38,77,148,151,299,12,13,25,2,3:20
565964,2019-09-03,2019,WAS,NYN,11,10,11-10,WAS,9,false,42,39,81,147,142,289,19,14,33,5,3:17
566744,2019-09-25,2019,TBA,NYA,4,0,4-0,TBA,9,true,34,32,66,142,139,281,11,6,17,5,3:10
565963,2019-09-02,2019,WAS,NYN,3,7,7-3,NYN,9,false,33,43,76,170,123,293,6,16,22,2,3:08
565684,2019-09-20,2019,HOU,ANA,6,4,6-4,HOU,9,true,36,35,71,139,138,277,12,9,21,1,2:49
566157,2019-09-07,2019,OAK,DET,10,2,10-2,OAK,9,true,41,37,78,157,153,310,17,11,28,1,3:06
567339,2019-09-25,2019,CHA,CLE,8,3,8-3,CHA,9,true,40,37,77,151,150,301,16,11,27,6,3:17
566641,2019-09-15,2019,SLN,MIL,6,7,7-6,MIL,9,false,36,43,79,170,139,309,9,17,26,6,3:26
565587,2019-09-22,2019,DET,CHA,6,3,6-3,DET,9,true,35,39,74,152,127,279,13,13,26,2,2:58
566055,2019-09-07,2019,NYN,PHI,0,5,5-0,PHI,9,false,36,39,75,146,136,282,9,11,20,0,2:59
565877,2019-09-20,2019,LAN,COL,12,5,12-5,LAN,9,true,43,37,80,141,182,323,20,12,32,3,3:39
565198,2019-09-16,2019,CHN,CIN,8,2,8-2,CHN,9,true,39,40,79,164,158,322,16,14,30,4,3:27
566841,2019-09-14,2019,TEX,OAK,6,8,8-6,OAK,9,false,42,43,85,151,189,340,17,15,32,2,3:47
565971,2019-09-25,2019,WAS,PHI,5,2,5-2,WAS,9,true,34,34,68,119,135,254,9,8,17,3,2:45
565298,2019-09-24,2019,CIN,MIL,2,4,4-2,MIL,9,false,36,37,73,150,142,292,9,11,20,2,2:52
566348,2019-09-11,2019,SDN,CHN,4,0,4-0,SDN,9,true,36,31,67,127,160,287,14,5,19,2,3:00
566059,2019-09-11,2019,NYN,ARI,9,0,9-0,NYN,9,true,39,38,77,163,141,304,16,12,28,1,3:06
565197,2019-09-15,2019,CHN,PIT,16,6,16-6,CHN,9,true,46,41,87,163,158,321,22,16,38,3,3:28
565490,2019-09-18,2019,COL,NYN,4,7,7-4,NYN,9,false,39,42,81,163,160,323,13,17,30,5,3:43
567246,2019-09-21,2019,ATL,SFN,8,1,8-1,ATL,9,true,36,33,69,124,145,269,12,7,19,1,2:35
564804,2019-09-10,2019,ANA,CLE,0,8,8-0,CLE,9,false,32,43,75,166,114,280,6,18,24,1,2:46
567338,2019-09-24,2019,CHA,CLE,0,11,11-0,CLE,9,false,34,45,79,193,116,309,7,18,25,1,3:02
565001,2019-09-08,2019,BAL,TEX,4,10,10-4,TEX,9,false,37,52,89,219,133,352,11,27,38,2,3:20
565534,2019-05-19,2019,DET,OAK,3,7,7-3,OAK,9,false,34,42,76,162,133,295,8,17,25,3,2:58 (1:41 delay)
565781,2019-09-28,2019,KCA,MIN,3,4,4-3,MIN,9,false,36,37,73,159,144,303,10,10,20,0,3:04
565872,2019-09-06,2019,LAN,SFN,4,5,5-4,SFN,9,false,35,40,75,168,132,300,8,16,24,3,3:22
567434,2019-09-10,2019,MIA,MIL,3,4,4-3,MIL,9,false,38,35,73,147,145,292,12,9,21,3,3:20
565965,2019-09-04,2019,WAS,NYN,4,8,8-4,NYN,9,false,43,43,86,143,170,313,16,20,36,2,3:24
566538,2019-09-01,2019,SFN,SDN,4,8,8-4,SDN,9,false,34,40,74,164,158,322,7,15,22,2,3:02
567139,2019-09-29,2019,PHI,MIA,3,4,4-3,MIA,9,false,43,33,76,120,164,284,16,7,23,3,2:50
565096,2019-09-04,2019,BOS,MIN,6,2,6-2,BOS,9,true,37,39,76,162,138,300,13,15,28,4,3:22 (:47 delay)
567335,2019-09-10,2019,CHA,KCA,7,3,7-3,CHA,9,true,38,36,74,137,147,284,13,10,23,6,3:02
566539,2019-09-09,2019,SFN,PIT,4,6,6-4,PIT,9,false,38,41,79,141,137,278,13,13,26,3,3:09
565384,2019-09-02,2019,CLE,CHA,11,3,11-3,CLE,9,true,45,42,87,172,211,383,21,18,39,4,4:07
566158,2019-09-08,2019,OAK,DET,3,1,3-1,OAK,9,true,32,32,64,126,114,240,9,5,14,1,2:14
565291,2019-09-05,2019,CIN,PHI,4,3,4-3,CIN,11,false,41,42,83,175,167,342,13,9,22,4,3:36
566940,2019-09-24,2019,TOR,BAL,4,11,11-4,BAL,9,false,36,47,83,184,127,311,9,20,29,2,3:12
564999,2019-09-06,2019,BAL,TEX,6,7,7-6,TEX,9,false,39,39,78,159,127,286,13,16,29,3,3:03
564809,2019-09-24,2019,ANA,OAK,3,2,3-2,ANA,9,true,34,33,67,142,131,273,11,7,18,2,2:52
566547,2019-09-25,2019,SFN,COL,2,1,2-1,SFN,9,false,34,38,72,170,124,294,9,10,19,3,3:13
565010,2019-09-22,2019,BAL,SEA,2,1,2-1,BAL,9,true,30,33,63,122,98,220,5,8,13,0,2:11
565772,2019-09-03,2019,KCA,DET,6,5,6-5,KCA,9,false,36,40,76,146,156,302,14,15,29,4,3:09
566448,2019-09-25,2019,SEA,HOU,0,3,3-0,HOU,9,false,29,36,65,136,118,254,3,8,11,1,2:33
565386,2019-09-04,2019,CLE,CHA,8,6,8-6,CLE,9,true,40,43,83,190,148,338,18,17,35,4,3:54
566836,2019-09-01,2019,TEX,SEA,3,11,11-3,SEA,9,false,38,50,88,204,154,358,13,25,38,2,3:39
566343,2019-09-06,2019,SDN,COL,2,3,3-2,COL,9,false,36,35,71,144,146,290,10,9,19,3,3:05
565974,2019-09-28,2019,WAS,CLE,10,7,10-7,WAS,9,true,40,40,80,164,136,300,18,14,32,2,3:10
565873,2019-09-07,2019,LAN,SFN,0,1,1-0,SFN,9,false,34,39,73,168,125,293,9,13,22,4,3:21
565487,2019-09-15,2019,COL,SDN,10,5,10-5,COL,9,true,44,41,85,179,179,358,21,15,36,3,3:44
565100,2019-09-08,2019,BOS,NYA,5,10,10-5,NYA,9,false,34,44,78,192,139,331,9,15,24,3,3:48
565677,2019-09-08,2019,HOU,SEA,21,1,21-1,HOU,9,true,55,28,83,107,206,313,30,1,31,1,2:50
565491,2019-09-27,2019,COL,MIL,11,7,11-7,COL,9,true,41,45,86,164,159,323,18,21,39,3,3:33
566345,2019-09-08,2019,SDN,COL,2,1,2-1,SDN,10,false,41,34,75,134,158,292,15,7,22,3,3:15
566444,2019-09-13,2019,SEA,CHA,7,9,9-7,CHA,9,false,43,43,86,163,174,337,19,18,37,4,3:47
565579,2019-09-12,2019,DET,NYA,4,6,6-4,NYA,9,false,37,39,76,173,134,307,10,15,25,4,3:02
567535,2019-09-21,2019,NYA,TOR,7,2,7-2,NYA,9,true,38,33,71,134,163,297,15,6,21,0,3:01
565590,2019-09-26,2019,DET,MIN,4,10,10-4,MIN,9,false,41,44,85,163,139,302,14,16,30,1,3:07
567239,2019-09-06,2019,ATL,WAS,4,3,4-3,ATL,9,true,37,37,74,140,162,302,15,11,26,2,3:20
566350,2019-09-20,2019,SDN,ARI,0,9,9-0,ARI,9,false,32,45,77,184,123,307,6,15,21,2,3:11
566349,2019-09-12,2019,SDN,CHN,1,4,4-1,CHN,9,false,35,37,72,142,168,310,10,11,21,1,3:29
566941,2019-09-25,2019,TOR,BAL,3,2,3-2,TOR,9,true,32,38,70,147,155,302,9,13,22,2,2:54
567533,2019-09-19,2019,NYA,ANA,9,1,9-1,NYA,9,true,36,31,67,117,146,263,12,5,17,2,2:39
565394,2019-09-20,2019,CLE,PHI,5,2,5-2,CLE,9,true,34,34,68,121,138,259,13,8,21,5,3:01
566355,2019-09-26,2019,SDN,LAN,0,1,1-0,LAN,9,false,32,33,65,119,138,257,5,7,12,2,2:55
567030,2019-09-06,2019,MIN,CLE,2,6,6-2,CLE,11,false,43,49,92,211,166,377,11,18,29,4,4:16
567534,2019-09-20,2019,NYA,TOR,3,4,4-3,TOR,9,false,34,35,69,144,150,294,8,10,18,4,3:08
566352,2019-09-22,2019,SDN,ARI,6,4,6-4,SDN,10,false,44,42,86,167,159,326,17,12,29,3,3:42
566068,2019-09-27,2019,NYN,ATL,4,2,4-2,NYN,9,true,36,39,75,165,134,299,14,12,26,0,3:09
566839,2019-09-12,2019,TEX,TBA,6,4,6-4,TEX,9,true,38,41,79,169,150,319,14,15,29,3,3:16
566159,2019-09-16,2019,OAK,KCA,5,6,6-5,KCA,9,false,40,40,80,181,165,346,15,14,29,5,3:35
565776,2019-09-14,2019,KCA,HOU,1,6,6-1,HOU,9,false,34,45,79,166,147,313,8,19,27,2,3:17
564911,2019-09-27,2019,ARI,SDN,6,3,6-3,ARI,9,true,39,36,75,130,143,273,13,9,22,1,3:03
567334,2019-09-08,2019,CHA,ANA,5,1,5-1,CHA,9,true,40,35,75,161,147,308,17,11,28,5,3:19
567237,2019-09-03,2019,ATL,TOR,7,2,7-2,ATL,9,true,37,33,70,124,153,277,14,9,23,3,2:46
567241,2019-09-08,2019,ATL,WAS,4,9,9-4,WAS,9,false,37,44,81,168,153,321,10,19,29,2,3:16
566447,2019-09-24,2019,SEA,HOU,0,3,3-0,HOU,9,false,32,36,68,140,145,285,5,10,15,1,2:51
566449,2019-09-26,2019,SEA,OAK,1,3,3-1,OAK,9,false,29,39,68,162,117,279,4,12,16,1,2:39
566942,2019-09-27,2019,TOR,TBA,2,6,6-2,TBA,9,false,33,41,74,166,130,296,6,14,20,5,3:04
566837,2019-09-10,2019,TEX,TBA,3,5,5-3,TBA,11,false,41,45,86,182,169,351,9,13,22,1,3:45
566550,2019-09-28,2019,SFN,LAN,0,2,2-0,LAN,9,false,35,33,68,133,135,268,8,8,16,0,2:40
567622,2019-09-05,2019,MIL,CHN,5,10,10-5,CHN,9,false,40,47,87,166,179,345,11,24,35,4,3:59
565680,2019-09-11,2019,HOU,OAK,3,5,5-3,OAK,9,false,36,38,74,173,140,313,12,11,23,1,2:57
566347,2019-09-10,2019,SDN,CHN,9,8,9-8,SDN,10,false,46,45,91,173,170,343,17,15,32,4,3:50
566063,2019-09-15,2019,NYN,LAN,2,3,3-2,LAN,9,false,33,38,71,140,128,268,7,12,19,2,3:12
566066,2019-09-25,2019,NYN,MIA,10,3,10-3,NYN,9,true,41,33,74,125,146,271,17,6,23,1,2:48
564805,2019-09-11,2019,ANA,CLE,3,4,4-3,CLE,9,false,40,39,79,141,164,305,13,13,26,6,3:24
565582,2019-09-14,2019,DET,BAL,8,4,8-4,DET,12,false,52,46,98,181,179,360,23,14,37,7,4:07
566937,2019-09-14,2019,TOR,NYA,3,13,13-3,NYA,9,false,40,50,90,195,181,376,13,25,38,3,3:47
566346,2019-09-09,2019,SDN,CHN,2,10,10-2,CHN,9,false,38,46,84,165,147,312,10,18,28,2,3:13
566548,2019-09-26,2019,SFN,COL,8,3,8-3,SFN,9,true,36,38,74,165,138,303,16,9,25,5,3:21
566164,2019-09-22,2019,OAK,TEX,3,8,8-3,TEX,9,false,39,39,78,140,169,309,13,13,26,1,3:15
566646,2019-09-28,2019,SLN,CHN,6,8,8-6,CHN,9,false,41,44,85,158,184,342,15,17,32,4,3:46
565879,2019-09-22,2019,LAN,COL,7,4,7-4,LAN,9,true,39,35,74,132,172,304,16,10,26,5,3:13
566054,2019-09-06,2019,NYN,PHI,5,4,5-4,NYN,9,false,38,40,78,177,159,336,14,14,28,4,3:32
564803,2019-09-09,2019,ANA,CLE,2,6,6-2,CLE,9,false,35,39,74,155,155,310,8,14,22,3,3:11
566541,2019-09-11,2019,SFN,PIT,3,6,6-3,PIT,9,false,34,41,75,157,128,285,6,13,19,3,2:51
567531,2019-09-17,2019,NYA,ANA,8,0,8-0,NYA,9,true,39,36,75,161,148,309,16,11,27,4,3:03
566258,2019-09-27,2019,PIT,CIN,6,5,6-5,PIT,9,false,37,42,79,173,147,320,12,15,27,1,3:13
565201,2019-09-19,2019,CHN,SLN,4,5,5-4,SLN,10,false,38,40,78,156,158,314,8,12,20,3,3:40
566248,2019-09-05,2019,PIT,MIA,7,10,10-7,MIA,9,false,42,47,89,171,159,330,14,24,38,2,3:38
566933,2019-09-10,2019,TOR,BOS,4,3,4-3,TOR,9,true,38,38,76,179,165,344,14,12,26,5,3:37
566256,2019-09-25,2019,PIT,CHN,4,2,4-2,PIT,9,true,35,35,70,118,160,278,12,10,22,3,2:54
567336,2019-09-11,2019,CHA,KCA,6,8,8-6,KCA,9,false,37,43,80,164,139,303,10,16,26,6,3:16
566254,2019-09-19,2019,PIT,SEA,5,6,6-5,SEA,11,false,46,49,95,212,160,372,14,18,32,0,4:16
566840,2019-09-13,2019,TEX,OAK,9,14,14-9,OAK,9,false,39,47,86,198,152,350,10,21,31,0,3:28
565005,2019-09-17,2019,BAL,TOR,5,8,8-5,TOR,9,false,39,41,80,173,159,332,12,15,27,4,3:27
566739,2019-09-20,2019,TBA,BOS,5,4,5-4,TBA,11,false,45,43,88,173,180,353,13,10,23,4,3:58
565578,2019-09-10,2019,DET,NYA,12,11,12-11,DET,9,false,45,40,85,169,172,341,20,13,33,5,3:33
565972,2019-09-26,2019,WAS,PHI,6,3,6-3,WAS,9,true,39,33,72,162,169,331,17,9,26,2,3:26
566643,2019-09-17,2019,SLN,WAS,2,6,6-2,WAS,9,false,38,42,80,151,154,305,10,18,28,2,3:21
567131,2019-09-09,2019,PHI,ATL,2,7,7-2,ATL,9,false,32,39,71,148,130,278,5,14,19,0,2:47
565292,2019-09-06,2019,CIN,ARI,5,7,7-5,ARI,9,false,43,42,85,174,192,366,16,16,32,7,4:10
565484,2019-09-12,2019,COL,SLN,3,10,10-3,SLN,9,false,39,47,86,182,172,354,13,21,34,6,3:56
566845,2019-09-26,2019,TEX,BOS,7,5,7-5,TEX,9,true,37,37,74,131,160,291,13,12,25,4,3:02
567433,2019-09-09,2019,MIA,MIL,3,8,8-3,MIL,9,false,44,47,91,204,171,375,17,21,38,6,4:08
565679,2019-09-10,2019,HOU,OAK,7,21,21-7,OAK,9,false,39,56,95,200,154,354,15,29,44,3,3:20
566645,2019-09-27,2019,SLN,CHN,2,8,8-2,CHN,9,false,42,46,88,191,186,377,14,20,34,4,4:04
566637,2019-09-04,2019,SLN,SFN,8,9,9-8,SFN,9,false,44,48,92,196,169,365,16,20,36,7,4:05
566843,2019-09-24,2019,TEX,BOS,10,12,12-10,BOS,9,false,48,45,93,158,194,352,22,19,41,3,3:59
565202,2019-09-20,2019,CHN,SLN,1,2,2-1,SLN,9,false,37,41,78,187,152,339,13,14,27,7,3:55
565674,2019-09-05,2019,HOU,SEA,11,9,11-9,HOU,13,false,56,54,110,230,217,447,20,15,35,5,4:40
567436,2019-09-12,2019,MIA,MIL,2,3,3-2,MIL,9,false,34,35,69,146,140,286,7,8,15,1,2:59
565678,2019-09-09,2019,HOU,OAK,15,0,15-0,HOU,9,true,41,30,71,119,148,267,19,4,23,2,2:42
566844,2019-09-25,2019,TEX,BOS,3,10,10-3,BOS,9,false,36,43,79,182,151,333,10,16,26,2,3:18
567435,2019-09-11,2019,MIA,MIL,5,7,7-5,MIL,9,false,37,40,77,156,155,311,10,14,24,3,3:02
565393,2019-09-19,2019,CLE,DET,7,0,7-0,CLE,9,true,38,37,75,149,166,315,15,10,25,1,3:17
567039,2019-09-19,2019,MIN,KCA,8,5,8-5,MIN,9,true,38,42,80,179,181,360,15,16,31,3,3:37
565973,2019-09-27,2019,WAS,CLE,8,2,8-2,WAS,9,true,38,30,68,111,130,241,15,3,18,1,2:44
566542,2019-09-12,2019,SFN,PIT,2,4,4-2,PIT,9,false,38,35,73,121,149,270,11,9,20,1,2:57
567041,2019-09-21,2019,MIN,KCA,5,12,12-5,KCA,9,false,40,46,86,178,139,317,12,20,32,4,3:25
566255,2019-09-24,2019,PIT,CHN,9,2,9-2,PIT,9,true,38,40,78,150,149,299,11,13,24,4,3:10
565295,2019-09-20,2019,CIN,NYN,1,8,8-1,NYN,9,false,34,43,77,167,137,304,8,17,25,2,3:06
565777,2019-09-15,2019,KCA,HOU,3,12,12-3,HOU,9,false,41,48,89,184,147,331,15,21,36,1,3:17
565000,2019-09-07,2019,BAL,TEX,4,9,9-4,TEX,9,false,39,41,80,143,153,296,10,15,25,3,3:11
566740,2019-09-21,2019,TBA,BOS,5,4,5-4,TBA,11,false,41,42,83,167,167,334,14,9,23,4,3:57
565485,2019-09-13,2019,COL,SDN,10,8,10-8,COL,9,true,42,43,85,184,134,318,19,20,39,4,3:28
567438,2019-09-21,2019,MIA,WAS,4,10,10-4,WAS,10,false,42,51,93,197,174,371,12,23,35,4,4:20
566156,2019-09-06,2019,OAK,DET,4,5,5-4,DET,11,false,46,46,92,183,186,369,14,14,28,4,3:44
566056,2019-09-08,2019,NYN,PHI,7,10,10-7,PHI,9,false,48,44,92,183,207,390,22,18,40,6,4:29
567132,2019-09-10,2019,PHI,ATL,6,5,6-5,PHI,9,true,35,38,73,146,136,282,12,13,25,3,3:06
567631,2019-09-21,2019,MIL,PIT,10,1,10-1,MIL,9,true,42,34,76,120,167,287,18,7,25,2,3:10
565581,2019-09-13,2019,DET,BAL,2,6,6-2,BAL,9,false,39,39,78,161,143,304,14,15,29,1,3:02
566260,2019-09-29,2019,PIT,CIN,1,3,3-1,CIN,9,false,34,37,71,129,129,258,8,12,20,1,2:43
566443,2019-09-12,2019,SEA,CIN,5,11,11-5,CIN,9,false,41,45,86,177,166,343,14,18,32,5,3:21
566446,2019-09-15,2019,SEA,CHA,11,10,11-10,SEA,9,false,51,39,90,138,205,343,29,13,42,6,3:44
564811,2019-09-26,2019,ANA,HOU,4,3,4-3,ANA,12,false,47,56,103,230,203,433,11,22,33,6,4:32
566741,2019-09-22,2019,TBA,BOS,4,7,7-4,BOS,9,false,38,45,83,173,158,331,14,17,31,3,3:32
566442,2019-09-11,2019,SEA,CIN,5,3,5-3,SEA,9,true,31,38,69,154,136,290,9,10,19,2,2:58
565103,2019-09-18,2019,BOS,SFN,3,11,11-3,SFN,9,false,35,45,80,206,146,352,10,17,27,4,3:34
566065,2019-09-24,2019,NYN,MIA,5,4,5-4,NYN,11,false,46,46,92,187,172,359,15,14,29,2,3:51
564806,2019-09-13,2019,ANA,TBA,4,11,11-4,TBA,9,false,35,42,77,173,133,306,10,17,27,1,3:07
565105,2019-09-27,2019,BOS,BAL,1,4,4-1,BAL,9,false,32,42,74,180,140,320,8,15,23,0,3:02
566743,2019-09-24,2019,TBA,NYA,2,1,2-1,TBA,12,false,41,45,86,167,192,359,10,9,19,3,4:00
564910,2019-09-25,2019,ARI,SLN,9,7,9-7,ARI,9,true,40,41,81,152,169,321,15,15,30,5,3:52
565586,2019-09-21,2019,DET,CHA,3,5,5-3,CHA,9,false,37,44,81,171,132,303,12,18,30,2,3:25
565589,2019-09-25,2019,DET,MIN,1,5,5-1,MIN,9,false,31,38,69,142,113,255,2,12,14,2,2:32
565778,2019-09-24,2019,KCA,ATL,9,6,9-6,KCA,9,true,41,41,82,153,164,317,17,15,32,3,3:28
567247,2019-09-22,2019,ATL,SFN,1,4,4-1,SFN,9,false,34,41,75,159,144,303,7,13,20,1,3:07
565876,2019-09-18,2019,LAN,TBA,7,8,8-7,TBA,11,false,47,50,97,214,164,378,15,18,33,4,4:40
564908,2019-09-23,2019,ARI,SLN,7,9,9-7,SLN,9,false,39,44,83,176,156,332,14,16,30,2,3:29
565200,2019-09-18,2019,CHN,CIN,2,3,3-2,CIN,10,false,35,44,79,186,132,318,6,16,22,5,3:40
567133,2019-09-11,2019,PHI,ATL,1,3,3-1,ATL,9,false,36,38,74,162,159,321,10,14,24,1,3:31
567042,2019-09-22,2019,MIN,KCA,12,8,12-8,MIN,9,true,46,44,90,193,180,373,23,18,41,6,4:05
567532,2019-09-18,2019,NYA,ANA,2,3,3-2,ANA,9,false,35,43,78,186,131,317,9,16,25,2,3:20
565097,2019-09-05,2019,BOS,MIN,1,2,2-1,MIN,9,false,31,35,66,146,115,261,6,11,17,2,2:58
566639,2019-09-13,2019,SLN,MIL,10,0,10-0,SLN,9,true,39,34,73,147,180,327,16,8,24,1,3:12
566644,2019-09-18,2019,SLN,WAS,5,1,5-1,SLN,9,true,32,37,69,129,128,257,9,11,20,3,2:55
566543,2019-09-13,2019,SFN,MIA,1,0,1-0,SFN,9,true,33,29,62,120,106,226,10,5,15,1,2:22
565101,2019-09-09,2019,BOS,NYA,0,5,5-0,NYA,9,false,37,42,79,194,140,334,10,15,25,3,3:25
566742,2019-09-23,2019,TBA,BOS,7,4,7-4,TBA,9,true,34,42,76,171,135,306,11,15,26,3,3:29
565006,2019-09-18,2019,BAL,TOR,10,11,11-10,TOR,9,false,47,51,98,201,192,393,19,24,43,5,4:08
565779,2019-09-25,2019,KCA,ATL,2,10,10-2,ATL,9,false,35,48,83,204,140,344,8,21,29,4,3:31
567243,2019-09-18,2019,ATL,PHI,1,4,4-1,PHI,9,false,35,36,71,146,132,278,7,8,15,1,2:59
565685,2019-09-21,2019,HOU,ANA,4,8,8-4,ANA,9,false,35,44,79,179,143,322,10,17,27,3,3:23
565009,2019-09-21,2019,BAL,SEA,6,7,7-6,SEA,13,false,52,55,107,226,188,414,13,16,29,4,4:42
567629,2019-09-19,2019,MIL,SDN,5,1,5-1,MIL,9,true,35,36,71,161,138,299,10,9,19,2,3:05
567137,2019-09-27,2019,PHI,MIA,5,4,5-4,PHI,15,false,62,61,123,203,227,430,21,19,40,4,5:13
566069,2019-09-28,2019,NYN,ATL,3,0,3-0,NYN,9,true,28,37,65,134,107,241,6,11,17,1,2:33
565486,2019-09-14,2019,COL,SDN,11,10,11-10,COL,9,true,42,43,85,157,147,304,17,18,35,6,3:29
566353,2019-09-24,2019,SDN,LAN,3,6,6-3,LAN,9,false,36,39,75,141,139,280,9,13,22,3,2:58
567343,2019-09-29,2019,CHA,DET,5,3,5-3,CHA,9,true,32,34,66,122,135,257,8,10,18,3,2:37
566546,2019-09-24,2019,SFN,COL,5,8,8-5,COL,16,false,60,71,131,283,224,507,15,24,39,9,5:31
566838,2019-09-11,2019,TEX,TBA,10,9,10-9,TEX,9,true,38,44,82,181,204,385,13,21,34,6,4:09
567341,2019-09-28,2019,CHA,DET,3,4,4-3,DET,9,false,36,38,74,151,130,281,11,11,22,2,2:58
565580,2019-09-12,2019,DET,NYA,4,10,10-4,NYA,9,false,43,46,89,196,173,369,16,18,34,3,3:36
565204,2019-09-22,2019,CHN,SLN,2,3,3-2,SLN,9,false,35,33,68,127,125,252,11,8,19,2,3:03
565782,2019-09-29,2019,KCA,MIN,5,4,5-4,KCA,9,false,37,33,70,112,147,259,12,7,19,3,2:40
565775,2019-09-13,2019,KCA,HOU,1,4,4-1,HOU,9,false,33,41,74,180,114,294,7,15,22,1,2:58
565681,2019-09-12,2019,HOU,OAK,2,3,3-2,OAK,9,false,39,35,74,144,176,320,13,8,21,4,3:39
564913,2019-09-29,2019,ARI,SDN,1,0,1-0,ARI,9,false,33,34,67,135,120,255,8,9,17,1,2:46
564906,2019-09-17,2019,ARI,MIA,6,12,12-6,MIA,9,false,41,50,91,183,161,344,16,25,41,1,3:49
566647,2019-09-29,2019,SLN,CHN,9,0,9-0,SLN,9,true,41,28,69,91,170,261,18,4,22,1,2:30
565975,2019-09-29,2019,WAS,CLE,8,2,8-2,WAS,9,true,39,36,75,131,142,273,16,10,26,1,2:50
567037,2019-09-17,2019,MIN,CHA,9,8,9-8,MIN,12,false,54,58,112,191,209,400,23,23,46,4,4:51
565203,2019-09-21,2019,CHN,SLN,8,9,9-8,SLN,9,false,42,45,87,195,168,363,16,21,37,5,4:24
564813,2019-09-28,2019,ANA,HOU,3,6,6-3,HOU,9,false,34,39,73,159,112,271,7,12,19,2,2:55
566452,2019-09-29,2019,SEA,OAK,3,1,3-1,SEA,9,true,36,34,70,141,149,290,12,7,19,2,2:52
567337,2019-09-12,2019,CHA,KCA,3,6,6-3,KCA,9,false,42,36,78,144,150,294,17,8,25,2,3:08
566451,2019-09-28,2019,SEA,OAK,0,1,1-0,OAK,9,false,35,35,70,149,129,278,8,10,18,2,2:41
567138,2019-09-28,2019,PHI,MIA,9,3,9-3,PHI,9,true,39,36,75,132,152,284,16,10,26,2,3:06
566257,2019-09-26,2019,PIT,CHN,9,5,9-5,PIT,9,true,40,36,76,148,149,297,17,9,26,2,3:15
566259,2019-09-28,2019,PIT,CIN,2,4,4-2,CIN,12,false,45,55,100,231,168,399,11,22,33,5,4:27 (1:05 delay)
566064,2019-09-23,2019,NYN,MIA,4,8,8-4,MIA,9,false,42,40,82,138,168,306,15,16,31,4,3:25
564912,2019-09-28,2019,ARI,SDN,6,5,6-5,ARI,9,true,35,38,73,144,134,278,12,14,26,2,3:05
565492,2019-09-28,2019,COL,MIL,3,2,3-2,COL,10,false,39,37,76,142,138,280,12,10,22,3,3:00
566935,2019-09-12,2019,TOR,BOS,4,7,7-4,BOS,9,false,41,40,81,166,167,333,14,14,28,4,3:32
565195,2019-09-13,2019,CHN,PIT,17,8,17-8,CHN,9,true,51,42,93,160,206,366,27,15,42,2,3:52
566944,2019-09-29,2019,TOR,TBA,8,3,8-3,TOR,9,true,39,37,76,146,152,298,15,10,25,3,3:07
567035,2019-09-12,2019,MIN,WAS,6,12,12-6,WAS,9,false,43,47,90,171,175,346,16,22,38,2,3:45 (:50 delay)
566847,2019-09-28,2019,TEX,NYA,9,4,9-4,TEX,9,true,44,34,78,134,198,332,22,10,32,2,3:17
564814,2019-09-29,2019,ANA,HOU,5,8,8-5,HOU,9,false,40,45,85,155,172,327,13,18,31,4,3:30
567342,2019-09-28,2019,CHA,DET,7,1,7-1,CHA,9,true,38,31,69,116,151,267,14,6,20,1,2:41
564909,2019-09-24,2019,ARI,SLN,3,2,3-2,ARI,19,false,74,73,147,321,273,594,25,17,42,4,6:53
566939,2019-09-23,2019,TOR,BAL,11,10,11-10,TOR,15,false,64,66,130,259,271,530,23,23,46,4,5:21
565686,2019-09-22,2019,HOU,ANA,13,5,13-5,HOU,9,true,44,41,85,170,160,330,21,14,35,3,3:32
566551,2019-09-29,2019,SFN,LAN,0,9,9-0,LAN,9,false,31,48,79,198,132,330,6,23,29,4,3:23
566450,2019-09-27,2019,SEA,OAK,4,3,4-3,SEA,9,false,38,39,77,154,183,337,13,13,26,2,3:34
564812,2019-09-27,2019,ANA,HOU,0,4,4-0,HOU,9,false,29,34,63,142,111,253,4,10,14,1,2:37
566846,2019-09-27,2019,TEX,NYA,7,14,14-7,NYA,9,false,39,47,86,175,161,336,12,23,35,3,3:37
566070,2019-09-29,2019,NYN,ATL,7,6,7-6,NYN,11,false,47,45,92,172,161,333,17,14,31,6,3:44
566936,2019-09-13,2019,TOR,NYA,6,5,6-5,TOR,12,false,46,49,95,210,167,377,16,14,30,3,4:08
566934,2019-09-11,2019,TOR,BOS,8,0,8-0,TOR,9,true,36,31,67,127,144,271,14,3,17,3,2:49
565106,2019-09-28,2019,BOS,BAL,4,9,9-4,BAL,9,false,40,42,82,189,172,361,14,16,30,6,3:37
566549,2019-09-27,2019,SFN,LAN,2,9,9-2,LAN,9,false,46,39,85,154,209,363,17,14,31,4,3:42
565493,2019-09-29,2019,COL,MIL,4,3,4-3,COL,13,false,48,54,102,211,175,386,14,15,29,1,4:02
565102,2019-09-17,2019,BOS,SFN,6,7,7-6,SFN,15,false,68,64,132,253,294,547,25,22,47,8,5:54