API Key,Date,Year,Home Team,Away Team,Home Score,Away Score,Final Score,Winning Team,# Innings,End Top Inning?,Home Team PA #,Away Team PA #,Total Number PA,Homne Team # Pitches,Away Team # Pitches,Total # Pitches,Home Team Baserunners,Away Team Baserunners,Total # Baserunners,Pitching Changes,Time
630851,2020-07-23,2020,WAS,NYA,1,4,4-1,NYA,6,true,18,26,44,99,75,174,3,10,13,0,1:43 (1:58 delay)
631377,2020-07-23,2020,LAN,SFN,8,1,8-1,LAN,9,true,43,33,76,108,149,257,18,8,26,3,2:56
631641,2020-07-24,2020,CHN,MIL,3,0,3-0,CHN,9,true,30,30,60,103,129,232,7,3,10,1,2:30
631242,2020-07-24,2020,NYN,ATL,1,0,1-0,NYN,9,true,29,32,61,132,93,225,7,5,12,0,2:25
630989,2020-07-24,2020,SLN,PIT,5,4,5-4,SLN,9,true,34,35,69,123,139,262,12,8,20,1,2:52
630941,2020-07-24,2020,TEX,COL,1,0,1-0,TEX,9,true,31,36,67,161,116,277,6,9,15,1,2:57
631438,2020-07-24,2020,HOU,SEA,8,2,8-2,HOU,9,true,39,32,71,120,150,270,14,6,20,1,2:49
631563,2020-07-24,2020,CLE,KCA,2,0,2-0,CLE,9,true,33,35,68,151,127,278,10,9,19,1,2:58
631589,2020-07-24,2020,CIN,DET,7,1,7-1,CIN,9,true,37,31,68,133,148,281,15,6,21,1,2:45
631378,2020-07-24,2020,LAN,SFN,9,1,9-1,LAN,9,true,46,32,78,122,151,273,21,5,26,2,2:55
631121,2020-07-24,2020,PHI,MIA,2,5,5-2,MIA,9,false,34,38,72,160,124,284,8,12,20,5,3:10
631091,2020-07-24,2020,SDN,ARI,7,2,7-2,SDN,9,true,37,33,70,127,168,295,15,8,23,2,3:05
631664,2020-07-24,2020,BOS,BAL,13,2,13-2,BOS,9,true,47,34,81,135,191,326,24,9,33,1,3:18
631514,2020-07-24,2020,CHA,MIN,5,10,10-5,MIN,9,false,38,43,81,175,152,327,12,16,28,6,3:31
630966,2020-07-24,2020,TBA,TOR,4,6,6-4,TOR,9,false,42,39,81,162,182,344,14,12,26,3,3:27
631182,2020-07-24,2020,OAK,ANA,7,3,7-3,OAK,10,false,41,44,85,173,169,342,15,15,30,3,3:46
630967,2020-07-25,2020,TBA,TOR,4,1,4-1,TBA,9,true,32,37,69,128,122,250,9,10,19,3,2:47
630992,2020-07-25,2020,SLN,PIT,9,1,9-1,SLN,9,true,39,33,72,118,135,253,14,6,20,4,2:55
631181,2020-07-25,2020,OAK,ANA,1,4,4-1,ANA,9,false,34,33,67,112,139,251,8,7,15,2,2:27
630899,2020-07-25,2020,WAS,NYA,9,2,9-2,WAS,9,true,38,38,76,137,138,275,14,9,23,3,3:13
631666,2020-07-25,2020,BOS,BAL,2,7,7-2,BAL,9,false,39,39,78,127,140,267,11,12,23,3,3:01
631453,2020-07-25,2020,HOU,SEA,7,2,7-2,HOU,9,true,36,36,72,142,146,288,15,11,26,2,2:53
631565,2020-07-25,2020,CLE,KCA,2,3,3-2,KCA,10,false,39,35,74,129,147,276,10,6,16,0,2:52
631108,2020-07-25,2020,PHI,MIA,7,1,7-1,PHI,9,true,38,32,70,121,165,286,16,9,25,1,2:54
631092,2020-07-25,2020,SDN,ARI,5,1,5-1,SDN,9,true,36,33,69,125,184,309,14,6,20,4,3:18
631603,2020-07-25,2020,CIN,DET,4,6,6-4,DET,9,false,39,40,79,145,150,295,13,13,26,2,3:01
631515,2020-07-25,2020,CHA,MIN,10,3,10-3,CHA,9,true,42,35,77,144,171,315,18,8,26,2,3:17
631382,2020-07-25,2020,LAN,SFN,4,5,5-4,SFN,9,false,39,38,77,158,148,306,14,12,26,2,3:16
630942,2020-07-25,2020,TEX,COL,2,3,3-2,COL,9,false,41,38,79,167,170,337,15,9,24,2,3:34
631642,2020-07-25,2020,CHN,MIL,3,8,8-3,MIL,9,false,39,42,81,158,174,332,13,15,28,1,3:36
631241,2020-07-25,2020,NYN,ATL,3,5,5-3,ATL,10,false,42,38,80,166,148,314,12,9,21,3,3:21
630993,2020-07-26,2020,SLN,PIT,1,5,5-1,PIT,9,false,32,36,68,123,144,267,8,11,19,1,2:56
630856,2020-07-26,2020,WAS,NYA,2,3,3-2,NYA,9,false,36,35,71,128,143,271,14,9,23,3,3:07
631165,2020-07-26,2020,OAK,ANA,6,4,6-4,OAK,9,true,33,36,69,131,131,262,12,9,21,4,3:02
630943,2020-07-26,2020,TEX,COL,2,5,5-2,COL,9,false,33,37,70,159,122,281,8,12,20,2,3:05
631591,2020-07-26,2020,CIN,DET,2,3,3-2,DET,9,false,38,34,72,157,136,293,12,7,19,1,3:04
631566,2020-07-26,2020,CLE,KCA,9,2,9-2,CLE,9,true,39,35,74,128,147,275,18,8,26,3,3:04
631384,2020-07-26,2020,LAN,SFN,1,3,3-1,SFN,9,false,38,39,77,148,141,289,11,14,25,4,3:28
631643,2020-07-26,2020,CHN,MIL,9,1,9-1,CHN,9,true,40,35,75,125,177,302,16,9,25,3,3:04
631668,2020-07-26,2020,BOS,BAL,4,7,7-4,BAL,9,false,34,43,77,167,124,291,7,18,25,4,3:13
631441,2020-07-26,2020,HOU,SEA,6,7,7-6,SEA,9,false,40,44,84,164,150,314,15,18,33,3,3:41
631126,2020-07-26,2020,PHI,MIA,6,11,11-6,MIA,9,false,47,44,91,147,179,326,19,18,37,5,3:44
631517,2020-07-26,2020,CHA,MIN,2,14,14-2,MIN,9,false,37,46,83,172,165,337,11,19,30,3,3:38
631240,2020-07-26,2020,NYN,ATL,1,14,14-1,ATL,9,false,38,48,86,179,168,347,11,22,33,2,3:20
630968,2020-07-26,2020,TBA,TOR,6,5,6-5,TBA,10,false,41,46,87,175,173,348,14,17,31,4,3:55
631097,2020-07-26,2020,SDN,ARI,3,4,4-3,ARI,9,false,42,39,81,170,170,340,16,14,30,4,3:44
631098,2020-07-27,2020,SDN,ARI,6,2,6-2,SDN,9,true,34,37,71,132,131,263,13,10,23,2,3:03
631168,2020-07-27,2020,OAK,ANA,3,0,3-0,OAK,9,true,33,38,71,154,141,295,9,12,21,2,2:59
630861,2020-07-27,2020,WAS,TOR,1,4,4-1,TOR,9,false,38,37,75,137,158,295,15,11,26,2,2:59
631669,2020-07-27,2020,BOS,NYN,4,7,7-4,NYN,9,false,36,40,76,131,136,267,10,13,23,2,3:11
630969,2020-07-27,2020,TBA,ATL,14,5,14-5,TBA,9,true,42,36,78,145,182,327,20,6,26,2,3:03
631442,2020-07-27,2020,HOU,SEA,8,5,8-5,HOU,9,true,37,42,79,176,153,329,13,16,29,2,3:04
631489,2020-07-27,2020,DET,KCA,6,14,14-6,KCA,9,false,41,47,88,177,163,340,13,20,33,3,3:20
631592,2020-07-27,2020,CIN,CHN,7,8,8-7,CHN,9,false,47,44,91,173,205,378,18,16,34,5,3:46 (1:47 delay)
631130,2020-07-27,2020,PIT,MIL,5,6,6-5,MIL,11,false,41,49,90,196,164,360,10,18,28,3,3:54 (1:42 delay)
631490,2020-07-28,2020,DET,KCA,4,3,4-3,DET,9,true,34,31,65,99,122,221,13,5,18,1,2:25
631567,2020-07-28,2020,CLE,CHA,5,3,5-3,CLE,9,true,32,35,67,135,125,260,10,8,18,1,2:43
631567,2020-07-28,2020,CLE,CHA,5,3,5-3,CLE,9,true,32,35,67,135,125,260,10,8,18,1,2:43
631269,2020-07-28,2020,MIN,SLN,6,3,6-3,MIN,9,true,33,36,69,151,117,268,9,10,19,2,2:42
631014,2020-07-28,2020,SFN,SDN,3,5,5-3,SDN,9,false,33,35,68,141,128,269,9,7,16,1,2:54
630944,2020-07-28,2020,TEX,ARI,1,4,4-1,ARI,9,false,31,40,71,168,124,292,4,14,18,1,3:10
631132,2020-07-28,2020,PIT,MIL,8,6,8-6,PIT,9,true,39,37,76,153,140,293,14,16,30,6,3:22
631443,2020-07-28,2020,HOU,LAN,2,5,5-2,LAN,9,false,35,43,78,155,143,298,8,16,24,3,3:19
630970,2020-07-28,2020,TBA,ATL,5,2,5-2,TBA,9,true,33,36,69,157,120,277,10,10,20,3,3:03
631171,2020-07-28,2020,OAK,COL,3,8,8-3,COL,9,false,38,44,82,164,134,298,11,16,27,0,2:58
630866,2020-07-28,2020,WAS,TOR,1,5,5-1,TOR,9,false,31,38,69,140,141,281,5,9,14,3,3:00
631663,2020-07-28,2020,BOS,NYN,3,8,8-3,NYN,9,false,36,43,79,141,132,273,11,16,27,3,2:58
631387,2020-07-28,2020,ANA,SEA,10,2,10-2,ANA,9,true,43,36,79,144,173,317,20,9,29,2,3:15
631593,2020-07-28,2020,CIN,CHN,5,8,8-5,CHN,9,false,36,41,77,165,133,298,9,15,24,3,3:02
631573,2020-07-28,2020,CLE,CHA,4,3,4-3,CLE,9,true,36,41,77,163,159,322,13,14,27,2,3:15
631270,2020-07-29,2020,MIN,SLN,3,0,3-0,MIN,9,true,33,30,63,125,156,281,9,4,13,3,2:53
631137,2020-07-29,2020,PIT,MIL,0,3,3-0,MIL,9,false,29,38,67,157,126,283,2,13,15,2,3:02
631492,2020-07-29,2020,DET,KCA,5,4,5-4,DET,9,true,32,36,68,133,126,259,7,9,16,0,2:40
631569,2020-07-29,2020,CLE,CHA,0,4,4-0,CHA,9,false,34,35,69,130,143,273,9,7,16,1,2:57
631172,2020-07-29,2020,OAK,COL,1,5,5-1,COL,9,false,36,40,76,148,151,299,9,15,24,1,2:55
630495,2020-07-29,2020,BAL,NYA,3,9,9-3,NYA,9,false,36,42,78,163,152,315,9,14,23,2,3:12
631594,2020-07-29,2020,CIN,CHN,12,7,12-7,CIN,9,true,40,41,81,161,168,329,19,13,32,5,3:23
631239,2020-07-29,2020,NYN,BOS,5,6,6-5,BOS,9,false,43,38,81,151,179,330,20,13,33,2,3:44
631033,2020-07-29,2020,SFN,SDN,7,6,7-6,SFN,9,false,37,40,77,159,147,306,13,17,30,4,3:02
630940,2020-07-29,2020,TEX,ARI,7,4,7-4,TEX,9,true,40,36,76,158,167,325,17,9,26,3,3:27
630272,2020-07-29,2020,ATL,TBA,7,4,7-4,ATL,9,true,41,37,78,147,165,312,17,10,27,3,3:22
630916,2020-07-29,2020,TOR,WAS,0,4,4-0,WAS,10,false,35,40,75,173,156,329,6,10,16,2,3:33
631389,2020-07-29,2020,ANA,SEA,7,10,10-7,SEA,9,false,40,43,83,178,160,338,13,18,31,5,3:47
631444,2020-07-29,2020,HOU,LAN,2,4,4-2,LAN,13,false,52,47,99,167,222,389,16,9,25,5,4:44
630346,2020-07-30,2020,ATL,TBA,2,1,2-1,ATL,9,true,33,31,64,117,117,234,11,6,17,3,2:40
631271,2020-07-30,2020,MIN,CLE,0,2,2-0,CLE,9,false,30,37,67,156,108,264,3,13,16,0,2:52
631494,2020-07-30,2020,DET,KCA,3,5,5-3,KCA,9,false,36,41,77,134,141,275,11,14,25,2,2:49
630496,2020-07-30,2020,BAL,NYA,6,8,8-6,NYA,9,false,37,40,77,158,138,296,11,15,26,2,3:06 (1:34 delay)
630917,2020-07-30,2020,TOR,WAS,4,6,6-4,WAS,9,false,38,41,79,162,139,301,13,15,28,4,3:35
631390,2020-07-30,2020,ANA,SEA,5,8,8-5,SEA,9,false,34,41,75,153,143,296,7,15,22,3,2:59
630145,2020-07-30,2020,ARI,LAN,3,6,6-3,LAN,9,false,36,41,77,170,143,313,9,15,24,4,3:19
631238,2020-07-30,2020,NYN,BOS,2,4,4-2,BOS,9,false,38,39,77,179,164,343,12,14,26,3,3:49
631018,2020-07-30,2020,SFN,SDN,7,12,12-7,SDN,10,false,49,48,97,171,187,358,19,17,36,4,4:04
631480,2020-07-31,2020,DET,CIN,7,2,7-2,DET,9,true,36,31,67,118,132,250,12,4,16,1,2:31
631066,2020-07-31,2020,SEA,OAK,5,3,5-3,SEA,9,true,35,34,69,129,141,270,11,7,18,1,2:34
631222,2020-07-31,2020,NYA,BOS,5,1,5-1,NYA,9,true,38,33,71,141,156,297,15,8,23,3,3:08
631019,2020-07-31,2020,SFN,TEX,9,2,9-2,SFN,9,true,38,39,77,150,142,292,16,11,27,2,3:04
631272,2020-07-31,2020,MIN,CLE,4,1,4-1,MIN,9,true,36,34,70,152,158,310,16,8,24,0,3:06
631410,2020-07-31,2020,KCA,CHA,2,3,3-2,CHA,9,false,38,35,73,145,141,286,10,8,18,1,2:56
630201,2020-07-31,2020,ARI,LAN,5,3,5-3,ARI,9,true,36,39,75,153,150,303,15,12,27,4,3:15
631647,2020-07-31,2020,CHN,PIT,6,3,6-3,CHN,9,true,41,34,75,138,183,321,19,8,27,4,3:46
631539,2020-07-31,2020,COL,SDN,7,8,8-7,SDN,9,false,43,41,84,166,151,317,17,14,31,5,3:37 (:37 delay)
630592,2020-07-31,2020,BAL,TBA,6,3,6-3,BAL,9,true,39,38,77,189,142,331,14,12,26,5,3:36 (:58 delay)
630275,2020-07-31,2020,ATL,NYN,11,10,11-10,ATL,9,true,43,44,87,172,169,341,18,17,35,4,3:35
631391,2020-07-31,2020,ANA,HOU,6,9,9-6,HOU,9,false,45,48,93,175,203,378,20,20,40,7,4:21
631273,2020-08-01,2020,MIN,CLE,3,0,3-0,MIN,9,true,31,32,63,135,111,246,9,5,14,0,2:40
631224,2020-08-01,2020,NYA,BOS,5,2,5-2,NYA,9,true,36,37,73,144,147,291,12,10,22,2,3:07
631540,2020-08-01,2020,COL,SDN,6,1,6-1,COL,9,true,36,32,68,140,146,286,14,6,20,1,2:50
630100,2020-08-01,2020,ARI,LAN,2,11,11-2,LAN,9,false,32,43,75,157,129,286,6,15,21,1,2:49
631622,2020-08-01,2020,CHN,PIT,4,3,4-3,CHN,9,true,35,35,70,147,135,282,13,9,22,4,3:11
631067,2020-08-01,2020,SEA,OAK,2,3,3-2,OAK,10,false,37,38,75,160,145,305,9,10,19,0,3:11
630278,2020-08-01,2020,ATL,NYN,7,1,7-1,ATL,9,true,37,39,76,167,159,326,13,13,26,1,3:21
631020,2020-08-01,2020,SFN,TEX,7,3,7-3,SFN,9,true,41,36,77,151,159,310,20,11,31,3,3:29
631392,2020-08-01,2020,ANA,HOU,5,4,5-4,ANA,10,false,40,44,84,162,162,324,12,16,28,5,3:58
631413,2020-08-01,2020,KCA,CHA,5,11,11-5,CHA,9,false,44,53,97,169,173,342,18,25,43,7,3:44
630492,2020-08-01,2020,BAL,TBA,5,4,5-4,BAL,11,false,45,44,89,179,173,352,14,12,26,6,3:50
631470,2020-08-02,2020,DET,CIN,3,4,4-3,CIN,7,false,28,30,58,127,104,231,6,11,17,3,2:25 (2:06 delay)
631469,2020-08-02,2020,DET,CIN,0,4,4-0,CIN,7,false,25,36,61,145,111,256,4,15,19,1,2:36
631469,2020-08-02,2020,DET,CIN,0,4,4-0,CIN,7,false,25,36,61,145,111,256,4,15,19,1,2:36
630493,2020-08-02,2020,BAL,TBA,5,1,5-1,BAL,9,true,39,33,72,129,134,263,16,6,22,3,2:56
631274,2020-08-02,2020,MIN,CLE,3,1,3-1,MIN,9,true,30,31,61,130,146,276,7,4,11,1,2:54
631541,2020-08-02,2020,COL,SDN,9,6,9-6,COL,9,true,36,39,75,146,130,276,14,12,26,4,2:52
630280,2020-08-02,2020,ATL,NYN,4,0,4-0,ATL,9,true,32,40,72,171,111,282,9,15,24,3,3:06
630101,2020-08-02,2020,ARI,LAN,0,3,3-0,LAN,9,false,32,36,68,127,147,274,5,9,14,2,2:56
631415,2020-08-02,2020,KCA,CHA,2,9,9-2,CHA,9,false,32,45,77,169,111,280,7,20,27,3,3:01
631068,2020-08-02,2020,SEA,OAK,2,3,3-2,OAK,9,false,35,37,72,178,152,330,8,11,19,2,3:20
631606,2020-08-02,2020,CHN,PIT,2,1,2-1,CHN,11,false,39,41,80,156,161,317,8,9,17,2,3:37 (1:04 delay)
631210,2020-08-02,2020,NYA,BOS,9,7,9-7,NYA,9,true,39,38,77,157,158,315,15,11,26,1,3:12
631021,2020-08-02,2020,SFN,TEX,5,9,9-5,TEX,9,false,39,43,82,148,153,301,11,16,27,3,3:04
631393,2020-08-02,2020,ANA,HOU,5,6,6-5,HOU,11,false,50,50,100,205,186,391,19,19,38,7,4:37
631645,2020-08-03,2020,CHN,KCA,2,0,2-0,CHN,9,true,32,34,66,133,138,271,8,8,16,1,2:43 (:16 delay)
631219,2020-08-03,2020,NYA,PHI,6,3,6-3,NYA,9,true,33,37,70,159,137,296,11,11,22,2,3:00 (1:07 delay)
631542,2020-08-03,2020,COL,SFN,7,6,7-6,COL,9,true,36,38,74,135,139,274,12,12,24,3,2:48
631596,2020-08-03,2020,CIN,CLE,3,2,3-2,CIN,9,true,29,33,62,143,117,260,5,8,13,0,2:33 (1:53 delay)
631275,2020-08-03,2020,MIN,PIT,5,4,5-4,MIN,9,false,39,37,76,138,163,301,14,13,27,2,3:13
631219,2020-08-03,2020,NYA,PHI,6,3,6-3,NYA,9,true,33,37,70,159,137,296,11,11,22,2,3:00 (1:07 delay)
631090,2020-08-03,2020,SDN,LAN,5,4,5-4,SDN,9,true,34,34,68,133,134,267,13,8,21,1,2:44
630281,2020-08-03,2020,ATL,NYN,2,7,7-2,NYN,9,false,37,42,79,155,162,317,11,17,28,3,3:16
631070,2020-08-03,2020,SEA,OAK,1,11,11-1,OAK,9,false,36,51,87,212,121,333,8,26,34,1,3:04
631293,2020-08-03,2020,MIL,CHA,4,6,6-4,CHA,9,false,39,43,82,181,146,327,14,17,31,5,3:43
631543,2020-08-04,2020,COL,SFN,5,2,5-2,COL,9,true,34,33,67,119,130,249,8,8,16,2,2:36
630575,2020-08-04,2020,BAL,MIA,0,4,4-0,MIA,9,false,31,35,66,139,120,259,4,8,12,3,2:38
630575,2020-08-04,2020,BAL,MIA,0,4,4-0,MIA,9,false,31,35,66,139,120,259,4,8,12,3,2:38
631173,2020-08-04,2020,OAK,TEX,5,1,5-1,OAK,9,false,34,32,66,122,148,270,11,7,18,2,2:52
631608,2020-08-04,2020,CHN,KCA,5,4,5-4,CHN,9,true,35,36,71,130,143,273,13,10,23,2,2:51
630874,2020-08-04,2020,WAS,NYN,5,3,5-3,WAS,9,true,35,40,75,162,151,313,12,14,26,3,3:13 (1:07 delay)
631597,2020-08-04,2020,CIN,CLE,2,4,4-2,CLE,9,false,33,39,72,172,125,297,7,11,18,3,2:59
631057,2020-08-04,2020,SEA,ANA,3,5,5-3,ANA,9,false,36,36,72,144,148,292,10,10,20,3,2:55
630284,2020-08-04,2020,ATL,TOR,10,1,10-1,ATL,9,true,44,34,78,130,161,291,21,9,30,3,3:06
631276,2020-08-04,2020,MIN,PIT,7,3,7-3,MIN,9,true,38,40,78,154,154,308,16,14,30,2,3:30 (:09 delay)
631069,2020-08-04,2020,SDN,LAN,2,5,5-2,LAN,9,false,33,41,74,148,129,277,7,13,20,4,3:04
630971,2020-08-04,2020,TBA,BOS,5,1,5-1,TBA,9,true,35,37,72,150,136,286,12,9,21,4,3:14
630109,2020-08-04,2020,ARI,HOU,2,8,8-2,HOU,9,false,38,46,84,165,136,301,12,19,31,2,3:09
631294,2020-08-04,2020,MIL,CHA,2,3,3-2,CHA,9,false,35,39,74,144,158,302,11,12,23,0,3:14
631339,2020-08-05,2020,MIA,BAL,2,1,2-1,MIA,7,true,23,28,51,108,75,183,5,8,13,3,2:06
631127,2020-08-05,2020,PHI,NYA,1,3,3-1,NYA,7,false,26,28,54,116,101,217,5,8,13,4,2:38
630591,2020-08-05,2020,BAL,MIA,0,1,1-0,MIA,7,false,27,29,56,121,93,214,7,6,13,2,2:19
631339,2020-08-05,2020,MIA,BAL,2,1,2-1,MIA,7,true,23,28,51,108,75,183,5,8,13,3,2:06
630591,2020-08-05,2020,BAL,MIA,0,1,1-0,MIA,7,false,27,29,56,121,93,214,7,6,13,2,2:19
631127,2020-08-05,2020,PHI,NYA,1,3,3-1,NYA,7,false,26,28,54,116,101,217,5,8,13,4,2:38
631518,2020-08-05,2020,CHA,MIL,0,1,1-0,MIL,9,false,32,33,65,117,113,230,9,6,15,0,2:21
631544,2020-08-05,2020,COL,SFN,3,4,4-3,SFN,9,false,34,34,68,122,132,254,8,7,15,1,2:48
631174,2020-08-05,2020,OAK,TEX,6,4,6-4,OAK,9,true,35,35,70,141,149,290,11,8,19,3,2:55
631140,2020-08-05,2020,PIT,MIN,2,5,5-2,MIN,9,false,31,38,69,147,122,269,5,12,17,1,2:52
630307,2020-08-05,2020,ATL,TOR,1,2,2-1,TOR,9,false,32,33,65,149,142,291,7,6,13,2,3:00
631220,2020-08-05,2020,NYA,PHI,7,11,11-7,PHI,7,false,33,40,73,131,125,256,14,18,32,3,2:44
630972,2020-08-05,2020,TBA,BOS,0,5,5-0,BOS,9,false,34,39,73,140,150,290,9,13,22,1,3:05
630878,2020-08-05,2020,WAS,NYN,1,3,3-1,NYN,9,false,31,39,70,165,100,265,5,15,20,1,2:46
631220,2020-08-05,2020,NYA,PHI,7,11,11-7,PHI,7,false,33,40,73,131,125,256,14,18,32,3,2:44
631417,2020-08-05,2020,KCA,CHN,1,6,6-1,CHN,9,false,32,38,70,156,124,280,6,12,18,2,3:09
631570,2020-08-05,2020,CLE,CIN,2,0,2-0,CLE,9,true,32,34,66,140,141,281,10,9,19,2,2:56
631085,2020-08-05,2020,SDN,LAN,6,7,7-6,LAN,9,false,40,36,76,142,159,301,14,10,24,1,3:11
631043,2020-08-05,2020,SEA,ANA,7,6,7-6,SEA,9,true,40,34,74,138,159,297,18,7,25,3,3:09
630110,2020-08-05,2020,ARI,HOU,14,7,14-7,ARI,9,true,44,38,82,149,153,302,21,12,33,2,3:14
631175,2020-08-06,2020,OAK,TEX,6,4,6-4,OAK,9,true,35,39,74,121,125,246,11,14,25,2,2:39
631042,2020-08-06,2020,SEA,ANA,1,6,6-1,ANA,9,false,32,39,71,142,107,249,5,12,17,1,2:23
630313,2020-08-06,2020,ATL,TOR,4,3,4-3,ATL,9,false,32,32,64,111,121,232,7,5,12,2,2:37
631148,2020-08-06,2020,PIT,MIN,6,5,6-5,PIT,9,false,34,39,73,151,122,273,9,12,21,1,3:07
631340,2020-08-06,2020,MIA,BAL,8,7,8-7,MIA,9,true,38,39,77,139,125,264,14,12,26,3,2:58
631340,2020-08-06,2020,MIA,BAL,8,7,8-7,MIA,9,true,38,39,77,139,125,264,14,12,26,3,2:58
630111,2020-08-06,2020,ARI,HOU,5,4,5-4,ARI,9,false,38,35,73,134,154,288,16,9,25,3,3:15
631425,2020-08-06,2020,KCA,CHN,13,2,13-2,KCA,9,true,45,36,81,132,161,293,22,10,32,2,3:02
631545,2020-08-06,2020,COL,SFN,6,4,6-4,COL,9,true,37,37,74,139,143,282,14,14,28,5,3:06 (:31 delay)
631571,2020-08-06,2020,CLE,CIN,13,0,13-0,CLE,9,true,44,33,77,128,182,310,21,7,28,1,2:53
631129,2020-08-06,2020,PHI,NYA,5,4,5-4,PHI,9,true,35,38,73,157,178,335,12,11,23,2,3:22
631129,2020-08-06,2020,PHI,NYA,5,4,5-4,PHI,9,true,35,38,73,157,178,335,12,11,23,2,3:22
631513,2020-08-06,2020,CHA,MIL,3,8,8-3,MIL,9,false,36,50,86,212,166,378,10,22,32,2,3:41
631073,2020-08-07,2020,SDN,ARI,3,0,3-0,SDN,9,true,29,32,61,131,106,237,6,5,11,1,2:27
631419,2020-08-07,2020,KCA,MIN,3,2,3-2,KCA,9,true,33,35,68,133,115,248,10,9,19,3,2:53 (:09 delay)
630974,2020-08-07,2020,TBA,NYA,1,0,1-0,TBA,9,true,28,33,61,159,107,266,4,7,11,1,2:52
631504,2020-08-07,2020,CHA,CLE,2,0,2-0,CHA,9,true,30,37,67,164,114,278,7,13,20,1,2:48
631295,2020-08-07,2020,MIL,CIN,3,8,8-3,CIN,9,false,34,41,75,163,162,325,9,15,24,1,2:59
631237,2020-08-07,2020,NYN,MIA,3,4,4-3,MIA,9,false,37,37,74,154,151,305,9,11,20,6,3:34
630879,2020-08-07,2020,WAS,BAL,0,11,11-0,BAL,9,false,32,52,84,181,120,301,6,24,30,1,3:00
631045,2020-08-07,2020,SEA,COL,4,8,8-4,COL,9,false,38,41,79,165,136,301,10,15,25,1,3:13
630920,2020-08-07,2020,TEX,ANA,4,3,4-3,TEX,9,true,35,38,73,159,150,309,12,11,23,6,3:38
631623,2020-08-07,2020,BOS,TOR,5,3,5-3,BOS,9,true,38,37,75,154,175,329,15,14,29,2,3:33
631358,2020-08-07,2020,LAN,SFN,7,2,7-2,LAN,9,true,39,36,75,159,156,315,15,10,25,2,3:16
631176,2020-08-07,2020,OAK,HOU,3,2,3-2,OAK,13,false,55,50,105,161,201,362,20,11,31,0,4:13
631105,2020-08-07,2020,PIT,DET,13,17,17-13,DET,11,false,52,56,108,223,202,425,20,23,43,4,4:33
631177,2020-08-08,2020,OAK,HOU,3,1,3-1,OAK,9,true,32,32,64,110,118,228,10,5,15,0,2:24
630935,2020-08-08,2020,TEX,ANA,2,0,2-0,TEX,9,true,29,33,62,156,120,276,5,6,11,1,2:46
631133,2020-08-08,2020,PHI,ATL,5,0,5-0,PHI,9,true,35,31,66,127,119,246,12,5,17,2,2:31
631046,2020-08-08,2020,SEA,COL,0,5,5-0,COL,9,false,30,41,71,164,122,286,4,15,19,4,2:49
631296,2020-08-08,2020,MIL,CIN,1,4,4-1,CIN,9,false,31,39,70,145,139,284,5,12,17,1,2:40
630973,2020-08-08,2020,TBA,NYA,5,3,5-3,TBA,7,true,33,29,62,115,138,253,15,11,26,3,2:47
631074,2020-08-08,2020,SDN,ARI,2,3,3-2,ARI,9,false,33,35,68,139,128,267,8,8,16,2,2:51
631343,2020-08-08,2020,LAN,SFN,4,5,5-4,SFN,9,false,33,39,72,151,130,281,6,12,18,2,2:54
631658,2020-08-08,2020,BOS,TOR,1,2,2-1,TOR,9,false,35,40,75,153,129,282,8,15,23,2,3:18
631236,2020-08-08,2020,NYN,MIA,8,4,8-4,NYN,9,true,36,40,76,162,127,289,12,15,27,3,3:03
631106,2020-08-08,2020,PIT,DET,5,11,11-5,DET,9,false,40,47,87,180,141,321,13,20,33,1,3:22
630962,2020-08-08,2020,TBA,NYA,4,8,8-4,NYA,7,false,30,37,67,160,153,313,9,16,25,2,2:52
630880,2020-08-08,2020,WAS,BAL,3,5,5-3,BAL,9,false,37,35,72,153,172,325,11,8,19,3,3:27
631503,2020-08-08,2020,CHA,CLE,1,7,7-1,CLE,9,false,37,40,77,176,144,320,10,15,25,1,3:11
631420,2020-08-08,2020,KCA,MIN,9,6,9-6,KCA,9,true,41,39,80,169,185,354,18,13,31,3,3:55
631373,2020-08-09,2020,LAN,SFN,6,2,6-2,LAN,9,true,31,34,65,124,115,239,8,7,15,6,2:41
631630,2020-08-09,2020,BOS,TOR,5,3,5-3,BOS,9,false,32,35,67,130,136,266,5,7,12,1,2:46
631131,2020-08-09,2020,PHI,ATL,0,8,8-0,ATL,7,false,27,36,63,130,111,241,6,15,21,2,2:29
631136,2020-08-09,2020,PHI,ATL,2,5,5-2,ATL,7,false,30,33,63,132,118,250,9,15,24,5,2:59
631131,2020-08-09,2020,PHI,ATL,0,8,8-0,ATL,7,false,27,36,63,130,111,241,6,15,21,2,2:29
631110,2020-08-09,2020,PIT,DET,1,2,2-1,DET,9,false,35,35,70,134,121,255,10,9,19,0,2:45
631047,2020-08-09,2020,SEA,COL,5,3,5-3,SEA,9,true,33,36,69,143,115,258,10,9,19,1,2:45
631235,2020-08-09,2020,NYN,MIA,4,2,4-2,NYN,9,true,37,39,76,166,126,292,14,13,27,1,3:09
630946,2020-08-09,2020,TBA,NYA,4,3,4-3,TBA,9,false,36,39,75,165,134,299,13,12,25,2,3:08
630882,2020-08-09,2020,WAS,BAL,2,6,6-2,BAL,9,false,38,37,75,130,151,281,13,11,24,5,3:11 (2:08 delay)
631075,2020-08-09,2020,SDN,ARI,9,5,9-5,SDN,9,true,40,37,77,150,155,305,16,10,26,2,2:59
631178,2020-08-09,2020,OAK,HOU,7,2,7-2,OAK,9,true,37,34,71,139,150,289,13,9,22,2,2:58
630882,2020-08-09,2020,WAS,BAL,2,6,6-2,BAL,9,false,38,37,75,130,151,281,13,11,24,5,3:11 (2:08 delay)
631421,2020-08-09,2020,KCA,MIN,4,2,4-2,KCA,9,true,36,36,72,155,137,292,13,9,22,1,3:16 (:25 delay)
630922,2020-08-09,2020,TEX,ANA,7,3,7-3,TEX,9,true,35,39,74,197,133,330,10,13,23,4,3:36
631297,2020-08-09,2020,MIL,CIN,9,3,9-3,MIL,9,true,43,38,81,171,170,341,18,12,30,2,3:14
631506,2020-08-09,2020,CHA,CLE,4,5,5-4,CLE,10,false,38,44,82,151,164,315,10,14,24,1,3:20 (:46 delay)
631298,2020-08-10,2020,MIL,MIN,2,4,4-2,MIN,9,false,36,37,73,138,151,289,9,10,19,0,2:57
631346,2020-08-10,2020,LAN,SDN,1,2,2-1,SDN,9,false,34,34,68,124,145,269,8,10,18,1,2:56
631445,2020-08-10,2020,HOU,SFN,6,4,6-4,HOU,9,true,37,35,72,135,151,286,11,8,19,2,3:07
631473,2020-08-10,2020,DET,CHA,5,1,5-1,DET,9,true,32,37,69,155,129,284,11,10,21,2,2:47
631138,2020-08-10,2020,PHI,ATL,13,8,13-8,PHI,9,true,43,36,79,133,158,291,19,10,29,2,2:54
630923,2020-08-10,2020,TEX,SEA,2,10,10-2,SEA,9,false,39,48,87,190,125,315,12,22,34,3,3:18
631233,2020-08-10,2020,NYN,WAS,4,16,16-4,WAS,9,false,37,49,86,178,121,299,11,21,32,2,2:59
631546,2020-08-10,2020,COL,ARI,8,12,12-8,ARI,9,false,43,48,91,166,161,327,18,21,39,3,3:43
631395,2020-08-10,2020,ANA,OAK,10,9,10-9,ANA,9,true,41,43,84,185,166,351,20,17,37,4,3:41
631631,2020-08-10,2020,BOS,TBA,7,8,8-7,TBA,9,false,41,48,89,199,162,361,16,24,40,7,4:24
631396,2020-08-11,2020,ANA,OAK,6,0,6-0,ANA,9,true,41,34,75,139,154,293,17,8,25,1,2:56
631243,2020-08-11,2020,NYN,WAS,1,2,2-1,WAS,9,false,35,33,68,125,142,267,10,10,20,1,2:55
631347,2020-08-11,2020,LAN,SDN,2,6,6-2,SDN,9,false,37,38,75,129,144,273,12,12,24,4,3:02
631474,2020-08-11,2020,DET,CHA,4,8,8-4,CHA,9,false,36,38,74,138,142,280,10,12,22,3,2:51
631299,2020-08-11,2020,MIL,MIN,6,4,6-4,MIL,9,true,33,40,73,165,114,279,9,14,23,1,2:56
631646,2020-08-11,2020,BOS,TBA,2,8,8-2,TBA,9,false,35,42,77,172,134,306,12,15,27,4,3:25
631547,2020-08-11,2020,COL,ARI,8,7,8-7,COL,9,true,38,43,81,135,139,274,16,17,33,4,3:16
630924,2020-08-11,2020,TEX,SEA,4,2,4-2,TEX,9,true,35,35,70,157,128,285,11,8,19,1,2:56
630901,2020-08-11,2020,TOR,MIA,5,4,5-4,TOR,10,false,39,38,77,162,148,310,13,9,22,2,3:20
631572,2020-08-11,2020,CLE,CHN,1,7,7-1,CHN,9,false,35,41,76,193,136,329,7,17,24,1,3:14
631192,2020-08-11,2020,NYA,ATL,9,6,9-6,NYA,9,true,38,40,78,131,186,317,15,10,25,3,3:18
631598,2020-08-11,2020,CIN,KCA,6,5,6-5,CIN,10,false,39,44,83,170,173,343,14,15,29,1,3:33
631446,2020-08-11,2020,HOU,SFN,6,7,7-6,SFN,10,false,43,46,89,185,171,356,17,17,34,4,3:52
631139,2020-08-11,2020,PHI,BAL,9,10,10-9,BAL,10,false,47,46,93,181,171,352,16,20,36,4,4:00
631648,2020-08-12,2020,BOS,TBA,5,9,9-5,TBA,9,false,38,41,79,132,140,272,12,17,29,2,2:58
631350,2020-08-12,2020,LAN,SDN,6,0,6-0,LAN,9,true,33,36,69,156,105,261,10,10,20,3,2:52
631397,2020-08-12,2020,ANA,OAK,4,8,8-4,OAK,9,false,34,42,76,174,134,308,7,15,22,5,3:20
631447,2020-08-12,2020,HOU,SFN,5,1,5-1,HOU,9,true,37,35,72,133,174,307,15,8,23,4,3:25
631141,2020-08-12,2020,PHI,BAL,4,5,5-4,BAL,9,false,40,40,80,149,160,309,15,13,28,2,3:28
631300,2020-08-12,2020,MIL,MIN,2,12,12-2,MIN,9,false,35,49,84,192,123,315,8,22,30,3,3:08
630926,2020-08-12,2020,TEX,SEA,7,4,7-4,TEX,9,true,41,41,82,157,157,314,18,14,32,2,3:09
631232,2020-08-12,2020,NYN,WAS,11,6,11-6,NYN,9,true,43,37,80,144,169,313,19,12,31,2,3:19
631475,2020-08-12,2020,DET,CHA,5,7,7-5,CHA,9,false,37,42,79,157,155,312,10,14,24,2,3:12
631568,2020-08-12,2020,CLE,CHN,2,7,7-2,CHN,9,false,37,43,80,191,146,337,11,18,29,4,3:32
631599,2020-08-12,2020,CIN,KCA,4,5,5-4,KCA,9,false,39,41,80,167,165,332,15,14,29,2,3:40
631208,2020-08-12,2020,NYA,ATL,6,3,6-3,NYA,9,true,43,41,84,157,178,335,20,14,34,6,3:40
631535,2020-08-12,2020,COL,ARI,7,13,13-7,ARI,9,false,47,46,93,162,185,347,22,20,42,5,3:56
630902,2020-08-12,2020,TOR,MIA,11,14,14-11,MIA,10,false,50,50,100,200,184,384,22,20,42,8,4:20
631609,2020-08-13,2020,CHN,MIL,4,2,4-2,CHN,9,true,35,33,68,132,156,288,13,7,20,1,3:06
631351,2020-08-13,2020,LAN,SDN,11,2,11-2,LAN,9,true,41,34,75,137,151,288,18,7,25,2,2:45
631142,2020-08-13,2020,PHI,BAL,4,11,11-4,BAL,9,false,35,44,79,189,123,312,8,20,28,5,3:29 (1:39 delay)
631231,2020-08-13,2020,NYN,WAS,8,2,8-2,NYN,9,true,42,39,81,153,169,322,19,10,29,1,3:25
631600,2020-08-13,2020,CIN,PIT,6,9,9-6,PIT,9,false,40,40,80,153,177,330,14,14,28,3,3:21
631650,2020-08-13,2020,BOS,TBA,8,17,17-8,TBA,9,false,43,53,96,204,171,375,17,24,41,3,3:44 (:06 delay)
631516,2020-08-14,2020,COL,TEX,2,3,3-2,TEX,9,false,31,33,64,142,110,252,2,9,11,1,2:33
631322,2020-08-14,2020,MIA,ATL,8,2,8-2,MIA,9,true,42,35,77,120,165,285,18,9,27,1,2:59
631610,2020-08-14,2020,CHN,MIL,3,4,4-3,MIL,9,false,39,34,73,127,183,310,11,8,19,4,3:13
631381,2020-08-14,2020,ANA,LAN,4,7,7-4,LAN,9,false,35,38,73,133,144,277,9,11,20,3,2:58
631601,2020-08-14,2020,CIN,PIT,8,1,8-1,CIN,9,true,36,33,69,145,141,286,13,6,19,2,2:50
630115,2020-08-14,2020,ARI,SDN,5,1,5-1,ARI,9,true,35,36,71,139,123,262,11,9,20,3,3:03
631150,2020-08-14,2020,PHI,NYN,6,5,6-5,PHI,9,false,39,42,81,152,138,290,15,17,32,4,3:24
631476,2020-08-14,2020,DET,CLE,5,10,10-5,CLE,9,false,37,42,79,165,142,307,10,14,24,2,2:55
631683,2020-08-14,2020,BAL,WAS,3,15,15-3,WAS,9,false,37,50,87,177,130,307,10,22,32,3,3:10 (1:57 delay)
630903,2020-08-14,2020,TOR,TBA,12,4,12-4,TOR,9,true,43,37,80,174,149,323,17,12,29,4,3:09
631196,2020-08-14,2020,NYA,BOS,10,3,10-3,NYA,9,true,43,35,78,144,198,342,19,9,28,3,3:35
631448,2020-08-14,2020,HOU,SEA,11,1,11-1,HOU,9,true,43,35,78,139,197,336,18,11,29,1,3:10
631022,2020-08-14,2020,SFN,OAK,7,8,8-7,OAK,10,false,46,42,88,166,164,330,16,12,28,2,3:23
631508,2020-08-15,2020,CHA,SLN,1,5,5-1,SLN,7,false,26,32,58,126,95,221,6,12,18,0,2:19
631280,2020-08-15,2020,MIN,KCA,4,2,4-2,MIN,7,true,27,25,52,117,113,230,9,5,14,3,2:30
631279,2020-08-15,2020,MIN,KCA,2,4,4-2,KCA,7,false,27,31,58,127,120,247,5,13,18,0,2:42
631507,2020-08-15,2020,CHA,SLN,3,6,6-3,SLN,7,false,26,33,59,147,108,255,5,12,17,2,2:30
631279,2020-08-15,2020,MIN,KCA,2,4,4-2,KCA,7,false,27,31,58,127,120,247,5,13,18,0,2:42
631507,2020-08-15,2020,CHA,SLN,3,6,6-3,SLN,7,false,26,33,59,147,108,255,5,12,17,2,2:30
631449,2020-08-15,2020,HOU,SEA,2,1,2-1,HOU,9,true,31,30,61,131,130,261,7,6,13,0,2:30
631330,2020-08-15,2020,MIA,ATL,1,2,2-1,ATL,9,false,34,35,69,138,138,276,9,10,19,2,2:59
631151,2020-08-15,2020,PHI,NYN,6,2,6-2,PHI,9,true,34,33,67,132,141,273,10,8,18,1,2:45
631197,2020-08-15,2020,NYA,BOS,11,5,11-5,NYA,9,true,40,38,78,140,144,284,15,12,27,1,3:05
630568,2020-08-15,2020,BAL,WAS,7,3,7-3,BAL,9,true,40,32,72,135,163,298,16,7,23,4,3:10
631533,2020-08-15,2020,COL,TEX,4,6,6-4,TEX,9,false,38,39,77,163,130,293,11,15,26,1,3:22
631477,2020-08-15,2020,DET,CLE,1,3,3-1,CLE,9,false,34,40,74,188,132,320,6,14,20,1,3:12
631363,2020-08-15,2020,ANA,LAN,5,6,6-5,LAN,10,false,39,45,84,170,138,308,9,17,26,4,3:17
630116,2020-08-15,2020,ARI,SDN,7,6,7-6,ARI,9,true,41,42,83,157,138,295,19,16,35,4,3:23
630905,2020-08-15,2020,TOR,TBA,2,3,3-2,TBA,9,false,38,43,81,181,144,325,11,17,28,6,3:37 (1:57 delay)
631611,2020-08-15,2020,CHN,MIL,5,6,6-5,MIL,10,false,43,45,88,152,174,326,14,14,28,2,3:24
631023,2020-08-15,2020,SFN,OAK,6,7,7-6,OAK,9,false,36,42,78,189,156,345,10,15,25,4,3:38
630905,2020-08-15,2020,TOR,TBA,2,3,3-2,TBA,9,false,38,43,81,181,144,325,11,17,28,6,3:37 (1:57 delay)
631252,2020-08-16,2020,MIN,KCA,4,2,4-2,MIN,9,true,35,31,66,123,130,253,12,6,18,2,2:37
631491,2020-08-16,2020,CHA,SLN,7,2,7-2,CHA,9,true,33,36,69,135,118,253,10,9,19,2,2:52
630872,2020-08-16,2020,TOR,TBA,5,7,7-5,TBA,8,false,33,35,68,130,119,249,11,13,24,4,2:54
631124,2020-08-16,2020,PHI,NYN,6,2,6-2,PHI,9,true,38,34,72,124,129,253,16,9,25,1,2:57
631324,2020-08-16,2020,MIA,ATL,0,4,4-0,ATL,9,false,28,38,66,168,115,283,3,11,14,3,2:58
630117,2020-08-16,2020,ARI,SDN,5,4,5-4,ARI,9,true,34,41,75,169,116,285,11,14,25,1,3:13
631364,2020-08-16,2020,ANA,LAN,3,8,8-3,LAN,9,false,37,37,74,142,153,295,13,11,24,2,3:10
631198,2020-08-16,2020,NYA,BOS,4,2,4-2,NYA,9,true,36,35,71,145,143,288,13,9,22,2,3:06
631612,2020-08-16,2020,CHN,MIL,5,6,6-5,MIL,9,false,36,37,73,142,172,314,10,12,22,1,3:11
631450,2020-08-16,2020,HOU,SEA,3,2,3-2,HOU,9,false,34,36,70,157,128,285,8,11,19,3,2:56
631521,2020-08-16,2020,COL,TEX,10,6,10-6,COL,9,true,40,38,78,145,164,309,17,12,29,1,3:00
631024,2020-08-16,2020,SFN,OAK,3,15,15-3,OAK,9,false,39,48,87,191,149,340,13,24,37,2,3:31
631479,2020-08-16,2020,DET,CLE,5,8,8-5,CLE,9,false,40,43,83,163,154,317,15,17,32,5,3:26
631679,2020-08-16,2020,BAL,WAS,5,6,6-5,WAS,9,false,37,45,82,190,152,342,10,18,28,4,3:38
631613,2020-08-17,2020,CHN,SLN,1,3,3-1,SLN,7,false,26,26,52,103,91,194,7,5,12,2,2:03
630996,2020-08-17,2020,SLN,CHN,4,5,5-4,CHN,7,false,29,33,62,132,118,250,9,14,23,2,2:33
630996,2020-08-17,2020,SLN,CHN,4,5,5-4,CHN,7,false,29,33,62,132,118,250,9,14,23,2,2:33
630118,2020-08-17,2020,ARI,OAK,4,3,4-3,ARI,9,false,40,35,75,125,135,260,16,8,24,5,3:06
631678,2020-08-17,2020,BAL,TOR,2,7,7-2,TOR,9,false,31,38,69,127,141,268,6,11,17,1,2:45
631258,2020-08-17,2020,MIN,KCA,4,1,4-1,MIN,9,true,35,35,70,137,158,295,13,10,23,2,3:06
631199,2020-08-17,2020,NYA,BOS,6,3,6-3,NYA,9,true,34,38,72,141,134,275,11,11,22,1,2:46 (1:23 delay)
631451,2020-08-17,2020,HOU,COL,2,1,2-1,HOU,9,true,33,33,66,133,128,261,9,7,16,1,2:50
631365,2020-08-17,2020,ANA,SFN,7,6,7-6,ANA,9,false,38,38,76,159,140,299,14,12,26,3,3:12
631493,2020-08-17,2020,CHA,DET,7,2,7-2,CHA,9,true,38,37,75,160,173,333,13,10,23,2,3:12
631352,2020-08-17,2020,LAN,SEA,11,9,11-9,LAN,9,true,41,42,83,169,170,339,20,15,35,2,3:32
630927,2020-08-17,2020,TEX,SDN,4,14,14-4,SDN,9,false,37,43,80,169,162,331,10,17,27,3,3:07
630316,2020-08-17,2020,ATL,WAS,7,6,7-6,ATL,9,false,46,42,88,173,192,365,21,17,38,3,3:35
631325,2020-08-17,2020,MIA,NYN,4,11,11-4,NYN,9,false,46,50,96,199,167,366,19,25,44,3,3:55
631353,2020-08-18,2020,LAN,SEA,2,1,2-1,LAN,9,true,31,33,64,132,131,263,8,6,14,2,2:38
631452,2020-08-18,2020,HOU,COL,2,1,2-1,HOU,11,false,37,38,75,143,136,279,8,7,15,0,3:03
631496,2020-08-18,2020,CHA,DET,10,4,10-4,CHA,9,true,39,38,77,152,152,304,17,11,28,2,3:00
631200,2020-08-18,2020,NYA,TBA,3,6,6-3,TBA,9,false,36,35,71,141,158,299,11,10,21,1,3:15
630928,2020-08-18,2020,TEX,SDN,4,6,6-4,SDN,9,false,39,42,81,166,168,334,12,16,28,5,3:36
630174,2020-08-18,2020,ARI,OAK,10,1,10-1,ARI,9,true,41,33,74,153,168,321,18,7,25,1,3:04
631366,2020-08-18,2020,ANA,SFN,2,8,8-2,SFN,9,false,34,43,77,159,143,302,9,17,26,1,3:06
631326,2020-08-18,2020,MIA,NYN,3,8,8-3,NYN,9,false,38,44,82,147,148,295,12,19,31,5,3:20
630322,2020-08-18,2020,ATL,WAS,5,8,8-5,WAS,9,false,43,46,89,152,171,323,18,22,40,4,3:44
631114,2020-08-18,2020,PIT,CLE,3,6,6-3,CLE,10,false,43,42,85,164,183,347,13,11,24,4,4:02
631620,2020-08-18,2020,CHN,SLN,6,3,6-3,CHN,9,true,41,39,80,165,207,372,18,15,33,6,4:09
631681,2020-08-18,2020,BAL,TOR,7,8,8-7,TOR,10,false,45,44,89,178,185,363,17,16,33,6,3:57
631260,2020-08-18,2020,MIN,MIL,4,3,4-3,MIN,12,false,47,44,91,176,195,371,13,8,21,2,4:28
631651,2020-08-18,2020,BOS,PHI,6,13,13-6,PHI,9,false,43,49,92,206,174,380,18,21,39,5,4:06
631497,2020-08-19,2020,CHA,DET,5,3,5-3,CHA,9,true,33,33,66,131,117,248,9,7,16,2,2:31
630997,2020-08-19,2020,SLN,CHN,2,4,4-2,CHN,7,false,28,27,55,121,113,234,7,8,15,1,2:26
630997,2020-08-19,2020,SLN,CHN,2,4,4-2,CHN,7,false,28,27,55,121,113,234,7,8,15,1,2:26
631422,2020-08-19,2020,KCA,CIN,0,5,5-0,CIN,7,false,25,34,59,143,97,240,4,13,17,2,2:22
631418,2020-08-19,2020,KCA,CIN,4,0,4-0,KCA,7,true,28,25,53,99,129,228,9,6,15,2,2:11
631422,2020-08-19,2020,KCA,CIN,0,5,5-0,CIN,7,false,25,34,59,143,97,240,4,13,17,2,2:22
631201,2020-08-19,2020,NYA,TBA,2,4,4-2,TBA,9,false,36,38,74,150,138,288,9,11,20,5,3:12
631179,2020-08-19,2020,OAK,ARI,4,1,4-1,OAK,9,true,37,34,71,140,156,296,13,9,22,1,2:57
631120,2020-08-19,2020,PIT,CLE,1,6,6-1,CLE,9,false,31,39,70,177,109,286,5,14,19,1,2:56
631327,2020-08-19,2020,MIA,NYN,3,5,5-3,NYN,9,false,39,39,78,142,154,296,11,15,26,4,3:14
631621,2020-08-19,2020,CHN,SLN,3,9,9-3,SLN,7,false,31,37,68,159,144,303,10,17,27,5,3:01
631025,2020-08-19,2020,SFN,ANA,7,2,7-2,SFN,9,true,36,36,72,168,127,295,12,9,21,2,3:05
631682,2020-08-19,2020,BAL,TOR,2,5,5-2,TOR,9,false,39,39,78,150,152,302,13,12,25,1,3:00
631249,2020-08-19,2020,MIN,MIL,3,9,9-3,MIL,9,false,37,43,80,159,151,310,11,19,30,2,2:59
631652,2020-08-19,2020,BOS,PHI,6,3,6-3,BOS,9,true,38,37,75,165,157,322,17,9,26,4,3:36
631522,2020-08-19,2020,COL,HOU,6,13,13-6,HOU,9,false,39,44,83,154,141,295,14,21,35,4,3:09
631076,2020-08-19,2020,SDN,TEX,6,3,6-3,SDN,10,false,39,40,79,155,165,320,11,10,21,2,3:23
631048,2020-08-19,2020,SEA,LAN,6,4,6-4,SEA,9,true,38,38,76,150,162,312,14,10,24,3,3:15
630919,2020-08-20,2020,TOR,PHI,3,2,3-2,TOR,7,false,33,28,61,137,123,260,14,8,22,3,2:43
631049,2020-08-20,2020,SEA,LAN,1,6,6-1,LAN,9,false,33,39,72,152,125,277,5,12,17,1,2:42
631180,2020-08-20,2020,OAK,ARI,5,1,5-1,OAK,9,true,35,34,69,138,147,285,13,8,21,3,2:49
630918,2020-08-20,2020,TOR,PHI,9,8,9-8,TOR,7,true,33,34,67,162,129,291,13,13,26,6,3:06
631248,2020-08-20,2020,MIN,MIL,7,1,7-1,MIN,9,true,41,32,73,128,151,279,19,6,25,1,2:58 (:11 delay)
630919,2020-08-20,2020,TOR,PHI,3,2,3-2,TOR,7,false,33,28,61,137,123,260,14,8,22,3,2:43
630986,2020-08-20,2020,SLN,CIN,5,4,5-4,SLN,9,false,37,40,77,149,155,304,13,12,25,2,3:12
631684,2020-08-20,2020,BAL,BOS,1,7,7-1,BOS,9,false,33,43,76,198,123,321,6,16,22,3,3:26
631118,2020-08-20,2020,PIT,CLE,0,2,2-0,CLE,9,false,35,41,76,180,145,325,8,13,21,1,3:24
630918,2020-08-20,2020,TOR,PHI,9,8,9-8,TOR,7,true,33,34,67,162,129,291,13,13,26,6,3:06
631523,2020-08-20,2020,COL,HOU,8,10,10-8,HOU,9,false,47,39,86,134,181,315,20,13,33,4,3:31
631077,2020-08-20,2020,SDN,TEX,8,7,8-7,SDN,10,false,42,44,86,193,169,362,16,14,30,4,3:59
631202,2020-08-20,2020,NYA,TBA,5,10,10-5,TBA,9,false,39,41,80,161,172,333,12,14,26,4,3:25
631026,2020-08-20,2020,SFN,ANA,10,5,10-5,SFN,9,true,43,42,85,183,166,349,19,15,34,3,3:40
631498,2020-08-20,2020,CHA,DET,9,0,9-0,CHA,9,true,42,33,75,140,166,306,19,6,25,1,2:56
631348,2020-08-21,2020,LAN,COL,5,1,5-1,LAN,9,true,36,31,67,122,125,247,14,4,18,2,2:35
631409,2020-08-21,2020,KCA,MIN,7,2,7-2,KCA,9,true,36,37,73,152,141,293,12,11,23,2,3:14
630886,2020-08-21,2020,WAS,MIA,2,3,3-2,MIA,9,false,33,38,71,153,148,301,6,12,18,2,3:06
631027,2020-08-21,2020,SFN,ARI,6,2,6-2,SFN,9,true,39,33,72,134,158,292,18,7,25,0,2:58
631050,2020-08-21,2020,SEA,TEX,7,4,7-4,SEA,9,true,37,34,71,119,150,269,13,7,20,4,2:41
631633,2020-08-21,2020,CHN,CHA,1,10,10-1,CHA,9,false,35,41,76,170,129,299,8,13,21,1,2:54
631665,2020-08-21,2020,BAL,BOS,5,8,8-5,BOS,9,false,39,38,77,126,175,301,13,12,25,2,3:04
631103,2020-08-21,2020,PIT,MIL,7,2,7-2,PIT,9,true,37,36,73,152,131,283,15,10,25,2,2:53
630324,2020-08-21,2020,ATL,PHI,11,2,11-2,ATL,9,true,43,37,80,146,173,319,18,12,30,3,3:18 (1:00 delay)
631548,2020-08-21,2020,CLE,DET,5,10,10-5,DET,9,false,41,43,84,155,177,332,15,16,31,3,3:18
630990,2020-08-21,2020,SLN,CIN,2,4,4-2,CIN,9,false,36,36,72,156,144,300,9,8,17,3,3:10
631186,2020-08-21,2020,OAK,ANA,5,3,5-3,OAK,9,true,37,43,80,150,153,303,13,17,30,3,3:07
631078,2020-08-21,2020,SDN,HOU,4,3,4-3,SDN,9,true,37,41,78,187,142,329,17,15,32,3,3:41
630960,2020-08-21,2020,TBA,TOR,5,6,6-5,TOR,10,false,43,39,82,135,176,311,15,12,27,2,3:31
631341,2020-08-22,2020,MIA,WAS,5,3,5-3,MIA,7,true,31,31,62,103,119,222,12,10,22,3,2:31
630991,2020-08-22,2020,SLN,CIN,3,0,3-0,SLN,9,true,33,32,65,118,134,252,12,6,18,3,2:15
631341,2020-08-22,2020,MIA,WAS,5,3,5-3,MIA,7,true,31,31,62,103,119,222,12,10,22,3,2:31
631079,2020-08-22,2020,SDN,HOU,13,2,13-2,SDN,9,true,41,34,75,118,140,258,17,7,24,2,2:41
630890,2020-08-22,2020,WAS,MIA,5,4,5-4,WAS,7,true,26,31,57,133,121,254,10,10,20,3,2:58
631028,2020-08-22,2020,SFN,ARI,5,1,5-1,SFN,9,true,37,32,69,103,148,251,14,4,18,2,2:43
631349,2020-08-22,2020,LAN,COL,4,3,4-3,LAN,9,false,32,36,68,153,133,286,12,8,20,4,3:05
631564,2020-08-22,2020,CLE,DET,6,1,6-1,CLE,9,true,37,30,67,112,141,253,14,4,18,3,2:37
631051,2020-08-22,2020,SEA,TEX,10,1,10-1,SEA,9,true,43,38,81,132,175,307,18,10,28,0,2:51
631154,2020-08-22,2020,OAK,ANA,3,4,4-3,ANA,9,false,35,40,75,151,132,283,9,11,20,3,3:06
630338,2020-08-22,2020,ATL,PHI,6,5,6-5,ATL,9,false,40,40,80,152,143,295,15,13,28,2,3:18
631638,2020-08-22,2020,CHN,CHA,4,7,7-4,CHA,9,false,38,42,80,167,150,317,13,17,30,3,3:33
630948,2020-08-22,2020,TBA,TOR,2,1,2-1,TBA,10,false,37,39,76,156,165,321,10,11,21,3,3:21
631403,2020-08-22,2020,KCA,MIN,2,7,7-2,MIN,9,false,40,42,82,154,143,297,14,17,31,3,3:23
631667,2020-08-22,2020,BAL,BOS,5,4,5-4,BAL,10,false,40,43,83,171,154,325,15,14,29,4,3:36
631104,2020-08-22,2020,PIT,MIL,12,5,12-5,PIT,9,true,42,41,83,181,170,351,18,16,34,1,3:30
631052,2020-08-23,2020,SEA,TEX,4,1,4-1,SEA,9,true,30,32,62,117,115,232,6,4,10,0,2:14
631029,2020-08-23,2020,SFN,ARI,6,1,6-1,SFN,9,true,35,36,71,147,127,274,12,9,21,2,2:52
631639,2020-08-23,2020,CHN,CHA,2,1,2-1,CHN,9,true,31,38,69,153,123,276,8,12,20,1,3:15
631080,2020-08-23,2020,SDN,HOU,5,3,5-3,SDN,9,true,33,32,65,127,138,265,9,6,15,4,3:04
631354,2020-08-23,2020,LAN,COL,11,3,11-3,LAN,9,true,40,38,78,134,141,275,18,11,29,4,2:58
630897,2020-08-23,2020,WAS,MIA,9,3,9-3,WAS,9,true,41,34,75,129,171,300,18,9,27,2,3:12
631107,2020-08-23,2020,PIT,MIL,5,4,5-4,PIT,9,true,34,37,71,152,127,279,11,10,21,3,3:11 (1:25 delay)
630273,2020-08-23,2020,ATL,PHI,4,5,5-4,PHI,9,false,38,41,79,152,147,299,13,14,27,2,3:17
630976,2020-08-23,2020,SLN,CIN,6,2,6-2,SLN,9,true,42,35,77,132,179,311,18,10,28,2,3:03
630949,2020-08-23,2020,TBA,TOR,5,4,5-4,TBA,9,true,36,38,74,138,159,297,13,11,24,5,3:14
631670,2020-08-23,2020,BAL,BOS,5,4,5-4,BAL,9,true,39,37,76,134,160,294,16,10,26,5,3:17
631551,2020-08-23,2020,CLE,DET,4,7,7-4,DET,9,false,38,43,81,155,180,335,10,18,28,3,3:22
631412,2020-08-23,2020,KCA,MIN,4,5,5-4,MIN,9,false,42,43,85,173,151,324,14,19,33,3,3:35
631170,2020-08-23,2020,OAK,ANA,5,4,5-4,OAK,10,false,41,46,87,187,167,354,12,17,29,3,3:40
631301,2020-08-24,2020,MIL,CIN,4,2,4-2,MIL,9,true,34,31,65,125,136,261,11,7,18,2,2:35
630929,2020-08-24,2020,TEX,OAK,3,2,3-2,TEX,9,true,33,40,73,161,115,276,10,13,23,2,2:52
631552,2020-08-24,2020,CLE,MIN,2,3,3-2,MIN,9,false,40,35,75,131,154,285,13,9,22,0,3:14
630193,2020-08-24,2020,ARI,COL,2,3,3-2,COL,9,false,35,37,72,158,124,282,10,15,25,1,3:19
631468,2020-08-24,2020,DET,CHN,3,9,9-3,CHN,9,false,35,45,80,187,125,312,8,20,28,2,3:01
630950,2020-08-24,2020,TBA,TOR,4,6,6-4,TOR,9,false,39,39,78,160,170,330,16,11,27,2,3:29
630977,2020-08-24,2020,SLN,KCA,9,3,9-3,SLN,9,true,45,36,81,143,181,324,22,6,28,3,3:10
631439,2020-08-24,2020,HOU,ANA,11,4,11-4,HOU,9,true,42,38,80,151,160,311,18,10,28,3,3:25
630898,2020-08-24,2020,WAS,MIA,8,11,11-8,MIA,9,false,44,50,94,196,169,365,17,24,41,6,4:02
631499,2020-08-25,2020,CHA,PIT,4,0,4-0,CHA,9,true,36,28,64,101,123,224,14,1,15,0,2:23
631323,2020-08-25,2020,MIA,NYN,3,0,3-0,MIA,7,true,23,29,52,133,100,233,5,10,15,1,2:24
631302,2020-08-25,2020,MIL,CIN,3,2,3-2,MIL,9,true,32,33,65,128,141,269,9,6,15,0,2:47
631423,2020-08-25,2020,HOU,ANA,6,3,6-3,HOU,7,true,30,27,57,112,114,226,13,6,19,2,2:26
631323,2020-08-25,2020,MIA,NYN,3,0,3-0,MIA,7,true,23,29,52,133,100,233,5,10,15,1,2:24
630951,2020-08-25,2020,TBA,BAL,4,2,4-2,TBA,9,true,37,35,72,129,138,267,12,8,20,3,2:41
631227,2020-08-25,2020,NYN,MIA,0,4,4-0,MIA,7,false,32,29,61,123,125,248,11,8,19,1,2:37 (1:05 delay)
631553,2020-08-25,2020,CLE,MIN,4,2,4-2,CLE,9,true,33,36,69,143,137,280,12,10,22,0,2:52
630978,2020-08-25,2020,SLN,KCA,4,5,5-4,KCA,9,false,39,37,76,132,159,291,15,13,28,1,3:07
631081,2020-08-25,2020,SDN,SEA,3,8,8-3,SEA,9,false,41,43,84,162,163,325,14,16,30,3,3:08
630930,2020-08-25,2020,TEX,OAK,3,10,10-3,OAK,9,false,35,42,77,170,142,312,9,16,25,2,3:15
631467,2020-08-25,2020,DET,CHN,7,1,7-1,DET,9,true,39,35,74,137,163,300,17,7,24,3,3:13
631426,2020-08-25,2020,HOU,ANA,5,12,12-5,ANA,7,false,28,43,71,191,112,303,8,22,30,9,3:24
630855,2020-08-25,2020,WAS,PHI,3,8,8-3,PHI,9,false,35,43,78,165,134,299,10,20,30,4,3:13 (1:12 delay)
630862,2020-08-25,2020,TOR,BOS,7,9,9-7,BOS,9,false,43,43,86,165,171,336,18,17,35,4,3:42
630194,2020-08-25,2020,ARI,COL,4,5,5-4,COL,9,false,43,43,86,178,175,353,16,17,33,2,3:52
631015,2020-08-25,2020,SFN,LAN,10,8,10-8,SFN,11,false,50,50,100,199,168,367,17,18,35,9,4:22
630361,2020-08-26,2020,ATL,NYA,5,1,5-1,ATL,7,true,26,26,52,100,117,217,8,5,13,1,2:05
630360,2020-08-26,2020,ATL,NYA,2,1,2-1,ATL,7,true,22,26,48,110,87,197,5,6,11,0,1:58
630360,2020-08-26,2020,ATL,NYA,2,1,2-1,ATL,7,true,22,26,48,110,87,197,5,6,11,0,1:58
631500,2020-08-26,2020,CHA,PIT,10,3,10-3,CHA,9,true,36,36,72,150,116,266,14,9,23,0,2:41
631226,2020-08-26,2020,NYN,MIA,5,4,5-4,NYN,9,true,36,36,72,150,146,296,14,11,25,3,3:16
631554,2020-08-26,2020,CLE,MIN,6,3,6-3,CLE,9,true,39,35,74,117,155,272,17,11,28,3,3:14
630863,2020-08-26,2020,TOR,BOS,9,1,9-1,TOR,9,true,38,32,70,133,152,285,15,6,21,2,2:58
630853,2020-08-26,2020,WAS,PHI,2,3,3-2,PHI,9,false,36,40,76,135,148,283,9,15,24,1,3:19
630931,2020-08-26,2020,TEX,OAK,1,3,3-1,OAK,9,false,33,40,73,162,136,298,6,13,19,2,3:08
631455,2020-08-26,2020,DET,CHN,7,6,7-6,DET,9,true,44,40,84,139,170,309,20,15,35,2,3:23
630952,2020-08-26,2020,TBA,BAL,4,3,4-3,TBA,9,true,37,37,74,151,175,326,13,10,23,5,3:26
630099,2020-08-26,2020,ARI,COL,7,8,8-7,COL,9,false,43,45,88,186,156,342,17,20,37,6,3:43
630979,2020-08-26,2020,SLN,KCA,6,5,6-5,SLN,9,false,46,38,84,134,195,329,20,14,34,4,3:37
631000,2020-08-27,2020,SLN,PIT,0,2,2-0,PIT,7,false,26,29,55,102,91,193,7,8,15,1,2:02
631000,2020-08-27,2020,SLN,PIT,0,2,2-0,PIT,7,false,26,29,55,102,91,193,7,8,15,1,2:02
631001,2020-08-27,2020,SFN,LAN,0,2,2-0,LAN,7,false,26,27,53,122,104,226,5,7,12,5,2:30
631017,2020-08-27,2020,SFN,LAN,0,7,7-0,LAN,7,false,25,35,60,130,93,223,4,16,20,1,2:17
631001,2020-08-27,2020,SFN,LAN,0,2,2-0,LAN,7,false,26,27,53,122,104,226,5,7,12,5,2:30
630999,2020-08-27,2020,SLN,PIT,3,4,4-3,PIT,8,false,32,34,66,126,120,246,11,8,19,1,2:48
631082,2020-08-27,2020,SDN,SEA,3,8,8-3,SEA,7,false,31,35,66,137,117,254,12,14,26,2,2:39
631082,2020-08-27,2020,SDN,SEA,3,8,8-3,SEA,7,false,31,35,66,137,117,254,12,14,26,2,2:39
630999,2020-08-27,2020,SLN,PIT,3,4,4-3,PIT,8,false,32,34,66,126,120,246,11,8,19,1,2:48
631303,2020-08-27,2020,MIL,CIN,0,6,6-0,CIN,7,false,25,35,60,150,120,270,4,14,18,0,2:33
631083,2020-08-27,2020,SDN,SEA,10,7,10-7,SDN,7,false,33,34,67,127,127,254,13,13,26,4,2:49
631303,2020-08-27,2020,MIL,CIN,0,6,6-0,CIN,7,false,25,35,60,150,120,270,4,14,18,0,2:33
631290,2020-08-27,2020,MIL,CIN,1,6,6-1,CIN,7,false,31,34,65,141,147,288,10,17,27,3,2:51
631230,2020-08-28,2020,NYN,NYA,4,3,4-3,NYN,7,false,26,30,56,119,98,217,10,11,21,0,2:23
631230,2020-08-28,2020,NYN,NYA,4,3,4-3,NYN,7,false,26,30,56,119,98,217,10,11,21,0,2:23
631304,2020-08-28,2020,MIA,TBA,0,2,2-0,TBA,9,false,33,38,71,135,112,247,7,13,20,3,2:55
631203,2020-08-28,2020,NYA,NYN,4,6,6-4,NYN,7,false,34,31,65,108,130,238,13,10,23,1,2:30
631394,2020-08-28,2020,ANA,SEA,3,2,3-2,ANA,9,true,35,35,70,117,153,270,15,10,25,1,2:50
630216,2020-08-28,2020,ARI,SFN,7,4,7-4,ARI,9,true,37,36,73,121,151,272,15,11,26,1,2:49
630933,2020-08-28,2020,TEX,LAN,6,2,6-2,TEX,9,true,37,37,74,150,133,283,16,10,26,1,3:10
631582,2020-08-28,2020,CIN,CHN,6,5,6-5,CIN,9,true,37,35,72,146,132,278,12,8,20,2,2:57
631291,2020-08-28,2020,MIL,PIT,9,1,9-1,MIL,9,true,37,33,70,143,148,291,13,6,19,1,2:55
631524,2020-08-28,2020,COL,SDN,4,10,10-4,SDN,9,false,40,47,87,157,157,314,13,22,35,5,3:29
631653,2020-08-28,2020,BOS,WAS,2,10,10-2,WAS,9,false,37,43,80,180,152,332,11,19,30,1,3:21
630871,2020-08-28,2020,TOR,BAL,5,4,5-4,TOR,10,false,38,39,77,158,160,318,10,12,22,2,3:19
631501,2020-08-28,2020,CHA,KCA,6,5,6-5,CHA,9,false,39,43,82,168,173,341,15,17,32,4,3:59
631125,2020-08-28,2020,PHI,ATL,7,4,7-4,PHI,11,false,44,45,89,184,169,353,14,15,29,3,4:07 (:12 delay)
630980,2020-08-28,2020,SLN,CLE,2,14,14-2,CLE,9,false,37,53,90,232,180,412,12,28,40,2,3:51
631457,2020-08-29,2020,DET,MIN,4,2,4-2,DET,7,true,28,24,52,99,116,215,11,5,16,3,2:12
631428,2020-08-29,2020,HOU,OAK,4,2,4-2,HOU,7,true,28,26,54,101,99,200,11,7,18,1,2:07
631457,2020-08-29,2020,DET,MIN,4,2,4-2,DET,7,true,28,24,52,99,116,215,11,5,16,3,2:12
631458,2020-08-29,2020,DET,MIN,8,2,8-2,DET,7,true,33,26,59,96,108,204,19,4,23,1,2:11
631427,2020-08-29,2020,HOU,OAK,6,3,6-3,HOU,7,true,32,27,59,119,129,248,14,7,21,2,2:33
631134,2020-08-29,2020,PHI,ATL,4,1,4-1,PHI,9,true,34,32,66,112,112,224,11,6,17,2,2:33 (37:00 delay)
631581,2020-08-29,2020,CIN,CHN,0,3,3-0,CHN,7,false,31,27,58,135,120,255,10,6,16,1,2:47
631427,2020-08-29,2020,HOU,OAK,6,3,6-3,HOU,7,true,32,27,59,119,129,248,14,7,21,2,2:33
631595,2020-08-29,2020,CIN,CHN,6,5,6-5,CIN,7,false,32,34,66,135,137,272,14,13,27,1,2:53
630906,2020-08-29,2020,TOR,BAL,5,0,5-0,TOR,9,true,38,35,73,138,140,278,13,8,21,1,2:44
631319,2020-08-29,2020,MIA,TBA,0,4,4-0,TBA,9,false,30,37,67,137,125,262,4,10,14,2,2:47
631204,2020-08-29,2020,NYA,NYN,2,1,2-1,NYA,9,false,34,30,64,116,159,275,10,5,15,2,3:00
631525,2020-08-29,2020,COL,SDN,4,3,4-3,COL,9,false,36,37,73,138,137,275,13,13,26,4,3:08
631595,2020-08-29,2020,CIN,CHN,6,5,6-5,CIN,7,false,32,34,66,135,137,272,14,13,27,1,2:53
630217,2020-08-29,2020,ARI,SFN,2,5,5-2,SFN,9,false,33,43,76,167,138,305,7,18,25,3,3:12
630934,2020-08-29,2020,TEX,LAN,4,7,7-4,LAN,9,false,38,42,80,181,150,331,13,15,28,5,3:36
631654,2020-08-29,2020,BOS,WAS,5,3,5-3,BOS,9,true,32,44,76,182,125,307,9,18,27,4,3:25
631277,2020-08-29,2020,MIL,PIT,7,6,7-6,MIL,9,false,36,44,80,174,149,323,12,18,30,2,3:19
631502,2020-08-29,2020,CHA,KCA,6,9,9-6,KCA,9,false,40,43,83,188,165,353,14,18,32,5,3:33
630981,2020-08-29,2020,SLN,CLE,1,2,2-1,CLE,12,false,43,45,88,204,165,369,12,12,24,2,4:06
631369,2020-08-29,2020,ANA,SEA,16,3,16-3,ANA,9,true,49,36,85,140,203,343,26,12,38,3,3:26
631229,2020-08-30,2020,NYN,NYA,2,5,5-2,NYA,8,false,31,36,67,128,109,237,7,15,22,2,2:45
631229,2020-08-30,2020,NYN,NYA,2,5,5-2,NYA,8,false,31,36,67,128,109,237,7,15,22,2,2:45
630982,2020-08-30,2020,SLN,CLE,7,2,7-2,SLN,9,true,34,32,66,122,133,255,13,6,19,1,2:24
631459,2020-08-30,2020,DET,MIN,3,2,3-2,DET,9,true,30,37,67,154,118,272,6,10,16,1,2:41
630852,2020-08-30,2020,TOR,BAL,6,5,6-5,TOR,9,false,40,40,80,141,133,274,15,17,32,3,2:58
630219,2020-08-30,2020,ARI,SFN,1,4,4-1,SFN,9,false,32,36,68,146,134,280,6,9,15,2,2:55
631371,2020-08-30,2020,ANA,SEA,1,2,2-1,SEA,10,false,40,36,76,142,168,310,14,9,23,1,3:27
631205,2020-08-30,2020,NYA,NYN,8,7,8-7,NYA,8,false,35,42,77,167,135,302,13,18,31,3,3:22
631278,2020-08-30,2020,MIL,PIT,1,5,5-1,PIT,9,false,41,36,77,139,158,297,13,10,23,2,3:13
631526,2020-08-30,2020,COL,SDN,2,13,13-2,SDN,9,false,36,45,81,181,142,323,9,20,29,1,3:07
631306,2020-08-30,2020,MIA,TBA,7,12,12-7,TBA,9,false,40,47,87,178,147,325,15,19,34,2,3:26
631655,2020-08-30,2020,BOS,WAS,9,5,9-5,BOS,9,true,43,42,85,157,173,330,19,15,34,3,3:26
631505,2020-08-30,2020,CHA,KCA,5,2,5-2,CHA,10,false,42,38,80,170,165,335,14,10,24,3,3:38
631584,2020-08-30,2020,CIN,CHN,1,10,10-1,CHN,9,false,35,43,78,184,163,347,8,17,25,2,3:26
630921,2020-08-30,2020,TEX,LAN,2,7,7-2,LAN,9,false,37,44,81,199,147,346,11,18,29,4,3:40
631135,2020-08-30,2020,PHI,ATL,10,12,12-10,ATL,9,false,42,52,94,194,174,368,16,26,42,6,4:13
631374,2020-08-31,2020,ANA,SEA,1,2,2-1,SEA,9,false,31,36,67,131,102,233,5,11,16,1,2:30
631143,2020-08-31,2020,PHI,WAS,8,6,8-6,PHI,9,true,34,40,74,156,123,279,11,13,24,2,2:48
631527,2020-08-31,2020,COL,SDN,0,6,6-0,SDN,9,false,34,38,72,132,133,265,9,12,21,2,2:49
631585,2020-08-31,2020,CIN,SLN,5,7,7-5,SLN,9,false,33,43,76,168,131,299,7,16,23,4,3:09
631223,2020-08-31,2020,NYN,MIA,3,5,5-3,MIA,9,false,35,38,73,150,146,296,10,11,21,0,3:03
631223,2020-08-31,2020,NYN,MIA,3,5,5-3,MIA,9,false,35,38,73,150,146,296,10,11,21,0,3:03
631656,2020-08-31,2020,BOS,ATL,3,6,6-3,ATL,9,false,36,42,78,161,146,307,10,16,26,1,3:19
631414,2020-08-31,2020,KCA,CLE,2,1,2-1,KCA,9,true,35,34,69,147,165,312,11,7,18,3,3:11
631281,2020-08-31,2020,MIL,PIT,6,5,6-5,MIL,9,true,37,38,75,173,152,325,16,11,27,3,3:25
631206,2020-08-31,2020,NYA,TBA,3,5,5-3,TBA,9,false,37,45,82,179,143,322,9,19,28,1,3:21
630900,2020-08-31,2020,TOR,BAL,3,4,4-3,BAL,11,false,42,43,85,175,167,342,11,11,22,3,3:38
631247,2020-08-31,2020,MIN,CHA,5,8,8-5,CHA,9,false,38,45,83,185,157,342,10,17,27,2,3:43
631307,2020-09-01,2020,MIA,TOR,3,2,3-2,MIA,9,true,32,33,65,103,109,212,9,9,18,2,2:40
631207,2020-09-01,2020,NYA,TBA,5,3,5-3,NYA,9,true,32,32,64,136,112,248,9,6,15,1,2:39
631261,2020-09-01,2020,MIN,CHA,3,2,3-2,MIN,9,true,38,34,72,133,141,274,14,8,22,2,3:12
631671,2020-09-01,2020,BAL,NYN,9,5,9-5,BAL,9,true,41,38,79,142,148,290,17,12,29,0,2:59
631355,2020-09-01,2020,LAN,ARI,6,3,6-3,LAN,9,true,41,35,76,134,146,280,17,8,25,1,2:46
631153,2020-09-01,2020,PHI,WAS,6,0,6-0,PHI,9,true,42,33,75,133,167,300,17,7,24,2,3:14
631430,2020-09-01,2020,HOU,TEX,5,6,6-5,TEX,10,false,41,41,82,154,155,309,12,13,25,2,3:28
631657,2020-09-01,2020,BOS,ATL,3,10,10-3,ATL,9,false,37,44,81,154,144,298,11,17,28,1,3:05
631416,2020-09-01,2020,KCA,CLE,1,10,10-1,CLE,9,false,34,46,80,179,134,313,7,21,28,2,3:10 (:16 delay)
631287,2020-09-01,2020,MIL,DET,1,12,12-1,DET,9,false,40,46,86,176,186,362,14,20,34,1,3:34
631109,2020-09-01,2020,PIT,CHN,7,8,8-7,CHN,11,false,50,49,99,191,173,364,19,17,36,7,4:10 (1:11 delay)
631528,2020-09-01,2020,COL,SFN,5,23,23-5,SFN,9,false,38,59,97,227,162,389,10,33,43,4,3:48
631586,2020-09-01,2020,CIN,SLN,2,16,16-2,SLN,9,false,39,56,95,208,170,378,15,30,45,2,3:27
631431,2020-09-02,2020,HOU,TEX,2,1,2-1,HOU,9,true,29,31,60,120,92,212,6,5,11,1,2:27
631404,2020-09-02,2020,KCA,CLE,0,5,5-0,CLE,9,false,28,35,63,122,119,241,4,10,14,1,2:29
631145,2020-09-02,2020,PHI,WAS,3,0,3-0,PHI,9,true,34,35,69,144,134,278,11,9,20,1,2:50
631587,2020-09-02,2020,CIN,SLN,4,3,4-3,CIN,9,false,37,36,73,133,150,283,12,11,23,4,2:55
631379,2020-09-02,2020,ANA,SDN,4,11,11-4,SDN,9,false,35,44,79,161,116,277,10,18,28,4,3:13
631624,2020-09-02,2020,BOS,ATL,5,7,7-5,ATL,9,false,37,40,77,145,142,287,10,12,22,2,3:01
631308,2020-09-02,2020,MIA,TOR,1,2,2-1,TOR,9,false,37,32,69,104,138,242,10,7,17,0,2:37
631111,2020-09-02,2020,PIT,CHN,2,8,8-2,CHN,9,false,36,43,79,157,145,302,10,13,23,1,3:15 (1:11 delay)
631253,2020-09-02,2020,MIN,CHA,8,1,8-1,MIN,9,true,42,35,77,136,181,317,15,7,22,2,3:23
631356,2020-09-02,2020,LAN,ARI,3,2,3-2,LAN,10,false,34,41,75,152,137,289,6,10,16,2,3:11
631673,2020-09-02,2020,BAL,NYN,4,9,9-4,NYN,9,false,40,43,83,145,165,310,14,18,32,3,3:12
631283,2020-09-02,2020,MIL,DET,8,5,8-5,MIL,9,true,42,37,79,137,192,329,18,11,29,2,3:20
631194,2020-09-02,2020,NYA,TBA,2,5,5-2,TBA,9,false,38,42,80,168,151,319,11,14,25,8,3:45 (:05 delay)
631529,2020-09-02,2020,COL,SFN,9,6,9-6,COL,9,true,41,45,86,177,165,342,18,18,36,2,3:35
631368,2020-09-03,2020,ANA,SDN,2,0,2-0,ANA,9,true,31,31,62,141,122,263,11,5,16,0,2:40
631370,2020-09-03,2020,LAN,ARI,5,1,5-1,LAN,9,true,37,36,73,150,143,293,12,9,21,2,2:58
631432,2020-09-03,2020,HOU,TEX,8,4,8-4,HOU,9,true,40,38,78,159,144,303,16,11,27,2,3:11
631112,2020-09-03,2020,PIT,CHN,6,2,6-2,PIT,9,true,38,38,76,156,137,293,13,13,26,2,3:16
631405,2020-09-03,2020,KCA,CHA,6,11,11-6,CHA,9,false,42,44,86,160,168,328,14,19,33,2,3:18
631614,2020-09-03,2020,BOS,TOR,2,6,6-2,TOR,10,false,43,44,87,168,168,336,14,15,29,6,4:02
631146,2020-09-03,2020,PHI,WAS,6,5,6-5,PHI,10,false,44,42,86,158,174,332,18,14,32,4,3:50
631234,2020-09-03,2020,NYN,NYA,9,7,9-7,NYN,10,false,42,47,89,208,151,359,17,17,34,1,4:00
631234,2020-09-03,2020,NYN,NYA,9,7,9-7,NYN,10,false,42,47,89,208,151,359,17,17,34,1,4:00
631262,2020-09-04,2020,MIN,DET,2,0,2-0,MIN,7,true,22,25,47,92,89,181,6,6,12,0,1:45
630371,2020-09-04,2020,ATL,WAS,7,1,7-1,ATL,7,true,31,29,60,118,113,231,13,9,22,1,2:30
630497,2020-09-04,2020,BAL,NYA,6,3,6-3,BAL,7,true,31,29,60,121,127,248,13,7,20,1,2:31
631602,2020-09-04,2020,CIN,PIT,3,4,4-3,PIT,7,false,27,28,55,110,127,237,6,8,14,1,2:25
630865,2020-09-04,2020,TOR,BOS,2,3,3-2,BOS,7,false,28,31,59,127,131,258,9,12,21,1,2:49
630497,2020-09-04,2020,BAL,NYA,6,3,6-3,BAL,7,true,31,29,60,121,127,248,13,7,20,1,2:31
631602,2020-09-04,2020,CIN,PIT,3,4,4-3,PIT,7,false,27,28,55,110,127,237,6,8,14,1,2:25
631113,2020-09-04,2020,PIT,CIN,2,4,4-2,CIN,7,false,30,32,62,139,111,250,10,12,22,1,2:31
631456,2020-09-04,2020,DET,MIN,2,3,3-2,MIN,8,false,32,35,67,125,140,265,8,13,21,2,2:57
631156,2020-09-04,2020,OAK,SDN,0,7,7-0,SDN,9,false,33,41,74,159,121,280,8,12,20,1,2:41
631649,2020-09-04,2020,BOS,TOR,7,8,8-7,TOR,7,false,33,34,67,129,123,252,13,14,27,3,2:42
630954,2020-09-04,2020,TBA,MIA,5,4,5-4,TBA,9,true,36,37,73,136,150,286,12,10,22,1,2:57
631644,2020-09-04,2020,CHN,SLN,4,1,4-1,CHN,9,true,37,29,66,136,154,290,13,3,16,3,3:05
630865,2020-09-04,2020,TOR,BOS,2,3,3-2,BOS,7,false,28,31,59,127,131,258,9,12,21,1,2:49
631555,2020-09-04,2020,CLE,MIL,1,7,7-1,MIL,9,false,32,43,75,156,131,287,6,19,25,2,2:55
631456,2020-09-04,2020,DET,MIN,2,3,3-2,MIN,8,false,32,35,67,125,140,265,8,13,21,2,2:57
631456,2020-09-04,2020,DET,MIN,2,3,3-2,MIN,8,false,32,35,67,125,140,265,8,13,21,2,2:57
631221,2020-09-04,2020,NYN,PHI,3,5,5-3,PHI,9,false,36,39,75,161,144,305,11,13,24,2,3:11
630323,2020-09-04,2020,ATL,WAS,9,10,10-9,WAS,7,false,36,38,74,157,146,303,14,17,31,4,3:12
631041,2020-09-04,2020,SEA,TEX,6,3,6-3,SEA,9,true,38,32,70,152,149,301,15,6,21,0,2:56
631406,2020-09-04,2020,KCA,CHA,4,7,7-4,CHA,9,false,43,44,87,166,161,327,15,18,33,3,3:42
631003,2020-09-04,2020,SFN,ARI,5,6,6-5,ARI,9,false,43,41,84,146,177,323,19,14,33,3,3:32
631345,2020-09-04,2020,LAN,COL,10,6,10-6,LAN,9,true,39,38,77,148,166,314,16,11,27,5,3:26 (:04 delay)
630323,2020-09-04,2020,ATL,WAS,9,10,10-9,WAS,7,false,36,38,74,157,146,303,14,17,31,4,3:12
631674,2020-09-04,2020,BAL,NYA,5,6,6-5,NYA,9,false,41,41,82,162,167,329,15,15,30,1,3:37
631357,2020-09-04,2020,ANA,HOU,6,5,6-5,ANA,11,false,49,48,97,175,198,373,19,15,34,5,4:27
630998,2020-09-05,2020,SLN,CHN,5,1,5-1,SLN,7,true,25,29,54,137,86,223,8,9,17,4,2:16
630998,2020-09-05,2020,SLN,CHN,5,1,5-1,SLN,7,true,25,29,54,137,86,223,8,9,17,4,2:16
631440,2020-09-05,2020,HOU,ANA,6,7,7-6,ANA,7,false,29,33,62,134,106,240,6,13,19,2,2:44
631607,2020-09-05,2020,CHN,SLN,2,4,4-2,SLN,7,false,30,33,63,153,111,264,8,11,19,2,2:40
631440,2020-09-05,2020,HOU,ANA,6,7,7-6,ANA,7,false,29,33,62,134,106,240,6,13,19,2,2:44
631675,2020-09-05,2020,BAL,NYA,6,1,6-1,BAL,9,true,33,38,71,152,136,288,9,12,21,3,2:47
631328,2020-09-05,2020,LAN,COL,2,5,5-2,COL,9,false,35,35,70,125,126,251,9,9,18,2,2:45
631264,2020-09-05,2020,MIN,DET,4,3,4-3,MIN,9,false,34,34,68,135,132,267,10,8,18,2,2:52
631044,2020-09-05,2020,SEA,TEX,5,3,5-3,SEA,9,true,38,35,73,116,141,257,16,11,27,2,3:04
631408,2020-09-05,2020,KCA,CHA,3,5,5-3,CHA,9,false,34,34,68,134,150,284,8,6,14,2,3:10
631388,2020-09-05,2020,ANA,HOU,10,9,10-9,ANA,7,false,34,35,69,135,132,267,16,14,30,4,3:01
631157,2020-09-05,2020,OAK,SDN,8,4,8-4,OAK,9,true,39,39,78,136,152,288,16,12,28,2,3:00
630955,2020-09-05,2020,TBA,MIA,3,7,7-3,MIA,9,false,37,40,77,148,158,306,11,13,24,2,3:16
631556,2020-09-05,2020,CLE,MIL,4,3,4-3,CLE,9,false,37,41,78,153,169,322,12,14,26,2,3:21
631228,2020-09-05,2020,NYN,PHI,5,1,5-1,NYN,9,true,37,38,75,155,139,294,14,11,25,1,3:08
631004,2020-09-05,2020,SFN,ARI,4,3,4-3,SFN,9,true,37,36,73,142,143,285,13,10,23,4,3:06
631115,2020-09-05,2020,PIT,CIN,2,6,6-2,CIN,9,false,40,37,77,163,166,329,13,10,23,2,3:23
631625,2020-09-05,2020,BOS,TOR,9,8,9-8,BOS,9,false,42,48,90,167,166,333,18,23,41,2,3:41
630383,2020-09-05,2020,ATL,WAS,4,10,10-4,WAS,9,false,38,46,84,193,161,354,12,19,31,3,3:31
631359,2020-09-06,2020,ANA,HOU,9,5,9-5,ANA,9,true,40,36,76,155,137,292,17,9,26,3,3:28
631676,2020-09-06,2020,BAL,NYA,5,1,5-1,BAL,9,true,35,35,70,142,158,300,11,7,18,2,3:02
631116,2020-09-06,2020,PIT,CIN,3,2,3-2,PIT,9,false,37,36,73,158,147,305,13,10,23,1,3:02
631030,2020-09-06,2020,SEA,TEX,4,3,4-3,SEA,9,true,32,36,68,152,124,276,9,12,21,1,2:45
631209,2020-09-06,2020,NYN,PHI,14,1,14-1,NYN,9,true,46,33,79,134,166,300,22,7,29,2,3:18
630491,2020-09-06,2020,ATL,WAS,10,3,10-3,ATL,9,true,45,35,80,135,175,310,24,8,32,3,3:26
631158,2020-09-06,2020,OAK,SDN,3,5,5-3,SDN,9,false,36,40,76,138,126,264,10,13,23,1,3:04
631005,2020-09-06,2020,SFN,ARI,4,2,4-2,SFN,9,true,34,37,71,163,128,291,13,11,24,2,2:52
631557,2020-09-06,2020,CLE,MIL,4,1,4-1,CLE,9,true,35,36,71,174,153,327,13,10,23,2,3:13
630956,2020-09-06,2020,TBA,MIA,5,4,5-4,TBA,10,false,37,41,78,175,155,330,8,13,21,2,3:18
631604,2020-09-06,2020,CHN,SLN,3,7,7-3,SLN,9,false,35,42,77,146,159,305,8,15,23,3,3:17
631407,2020-09-06,2020,KCA,CHA,2,8,8-2,CHA,9,false,35,46,81,176,116,292,8,20,28,6,3:34
631344,2020-09-06,2020,LAN,COL,6,7,7-6,COL,9,false,38,42,80,169,164,333,15,16,31,4,3:43
631254,2020-09-06,2020,MIN,DET,8,10,10-8,DET,9,false,45,44,89,181,191,372,19,19,38,4,3:43
631626,2020-09-06,2020,BOS,TOR,8,10,10-8,TOR,9,false,44,51,95,225,193,418,18,24,42,4,4:23
631159,2020-09-07,2020,OAK,HOU,6,0,6-0,OAK,9,true,38,34,72,104,169,273,15,8,23,1,2:55
631006,2020-09-07,2020,SFN,ARI,4,2,4-2,SFN,9,true,32,36,68,157,127,284,9,8,17,2,2:56
630857,2020-09-07,2020,WAS,TBA,6,1,6-1,WAS,9,true,35,38,73,151,107,258,12,11,23,1,2:41
631605,2020-09-07,2020,CHN,SLN,5,1,5-1,CHN,9,true,39,31,70,108,162,270,15,8,23,1,2:51
631558,2020-09-07,2020,CLE,KCA,5,2,5-2,CLE,9,true,35,35,70,127,135,262,11,9,20,2,2:52
631255,2020-09-07,2020,MIN,DET,6,2,6-2,MIN,9,true,34,33,67,137,137,274,11,6,17,1,2:44
631084,2020-09-07,2020,SDN,COL,1,0,1-0,SDN,9,false,35,32,67,128,142,270,11,7,18,1,3:02
631031,2020-09-07,2020,SEA,TEX,8,4,8-4,SEA,9,true,38,35,73,148,179,327,14,9,23,2,3:00
631225,2020-09-07,2020,NYN,PHI,8,9,9-8,PHI,10,false,48,44,92,177,158,335,17,16,33,1,3:40
630415,2020-09-07,2020,ATL,MIA,4,5,5-4,MIA,10,false,44,47,91,178,170,348,19,18,37,1,3:52
630859,2020-09-07,2020,TOR,NYA,12,7,12-7,TOR,9,true,46,43,89,188,215,403,21,15,36,3,4:02
631152,2020-09-08,2020,PHI,BOS,2,5,5-2,BOS,7,false,29,34,63,128,95,223,10,13,23,3,2:36
631429,2020-09-08,2020,HOU,OAK,2,4,4-2,OAK,7,false,29,31,60,116,106,222,8,10,18,0,2:23
631429,2020-09-08,2020,HOU,OAK,2,4,4-2,OAK,7,false,29,31,60,116,106,222,8,10,18,0,2:23
631160,2020-09-08,2020,OAK,HOU,4,5,5-4,HOU,7,false,32,33,65,121,124,245,11,12,23,4,2:52
631149,2020-09-08,2020,PHI,BOS,6,5,6-5,PHI,7,false,35,34,69,124,129,253,16,14,30,1,2:49
630984,2020-09-08,2020,SLN,MIN,6,4,6-4,SLN,7,true,32,32,64,121,135,256,13,11,24,3,2:48
631615,2020-09-08,2020,CHN,CIN,3,0,3-0,CHN,9,true,30,35,65,147,120,267,5,10,15,0,2:36
630983,2020-09-08,2020,SLN,MIN,3,7,7-3,MIN,7,false,27,34,61,127,136,263,6,13,19,2,2:31
630904,2020-09-08,2020,TEX,ANA,7,1,7-1,TEX,9,true,37,36,73,141,138,279,12,11,23,1,2:52
631096,2020-09-08,2020,PIT,CHA,5,4,5-4,PIT,9,false,35,38,73,147,145,292,12,13,25,3,3:19
630860,2020-09-08,2020,TOR,NYA,2,1,2-1,TOR,9,true,29,38,67,169,133,302,6,12,18,1,3:00
631211,2020-09-08,2020,NYN,BAL,2,11,11-2,BAL,9,false,33,43,76,169,133,302,7,16,23,1,3:01
631460,2020-09-08,2020,DET,MIL,8,3,8-3,DET,9,true,37,37,74,156,143,299,13,14,27,3,3:05
630438,2020-09-08,2020,ATL,MIA,0,8,8-0,MIA,9,false,34,43,77,164,144,308,7,17,24,2,3:12
630867,2020-09-08,2020,WAS,TBA,5,3,5-3,WAS,9,true,39,37,76,153,160,313,17,10,27,2,3:20
631559,2020-09-08,2020,CLE,KCA,6,8,8-6,KCA,9,false,36,41,77,164,138,302,10,13,23,3,3:13
631071,2020-09-08,2020,SDN,COL,14,5,14-5,SDN,9,true,42,36,78,148,152,300,21,10,31,3,3:16
631007,2020-09-08,2020,SFN,SEA,6,5,6-5,SFN,9,true,35,40,75,166,142,308,11,16,27,1,3:04
630220,2020-09-08,2020,ARI,LAN,9,10,10-9,LAN,10,false,43,54,97,217,181,398,13,24,37,7,4:25
631616,2020-09-09,2020,CHN,CIN,0,3,3-0,CIN,9,false,31,33,64,140,123,263,4,7,11,2,2:54
631560,2020-09-09,2020,CLE,KCA,0,3,3-0,KCA,9,false,37,36,73,136,146,282,10,10,20,1,3:03
631161,2020-09-09,2020,OAK,HOU,3,2,3-2,OAK,9,false,39,32,71,126,158,284,13,5,18,2,2:53
631461,2020-09-09,2020,DET,MIL,0,19,19-0,MIL,9,false,28,54,82,199,109,308,2,30,32,2,3:04
631056,2020-09-09,2020,SDN,COL,5,3,5-3,SDN,9,true,35,37,72,152,125,277,13,10,23,1,2:54
630864,2020-09-09,2020,TOR,NYA,2,7,7-2,NYA,9,false,32,42,74,168,114,282,6,14,20,1,3:04
631100,2020-09-09,2020,PIT,CHA,1,8,8-1,CHA,9,false,37,41,78,163,137,300,9,14,23,2,3:08
630221,2020-09-09,2020,ARI,LAN,4,6,6-4,LAN,10,false,40,45,85,148,153,301,10,15,25,2,3:20
631212,2020-09-09,2020,NYN,BAL,7,6,7-6,NYN,9,true,36,46,82,164,137,301,13,20,33,4,3:25
631008,2020-09-09,2020,SFN,SEA,10,1,10-1,SFN,9,true,41,35,76,161,161,322,18,8,26,1,3:05
630925,2020-09-09,2020,TEX,ANA,7,3,7-3,TEX,9,true,37,39,76,163,155,318,13,11,24,3,3:38
630439,2020-09-09,2020,ATL,MIA,29,9,29-9,ATL,9,true,58,43,101,197,240,437,33,17,50,4,4:14
631162,2020-09-10,2020,OAK,HOU,3,1,3-1,OAK,9,true,34,29,63,85,135,220,11,3,14,1,2:18
630995,2020-09-10,2020,SLN,DET,3,6,6-3,DET,7,false,30,34,64,127,113,240,11,16,27,4,2:40
630995,2020-09-10,2020,SLN,DET,3,6,6-3,DET,7,false,30,34,64,127,113,240,11,16,27,4,2:40
631072,2020-09-10,2020,SDN,SFN,6,1,6-1,SDN,9,true,33,33,66,148,121,269,8,9,17,1,2:48
630994,2020-09-10,2020,SLN,DET,12,2,12-2,SLN,7,true,35,27,62,121,158,279,17,7,24,2,2:34
630994,2020-09-10,2020,SLN,DET,12,2,12-2,SLN,7,true,35,27,62,121,158,279,17,7,24,2,2:34
631561,2020-09-10,2020,CLE,KCA,1,11,11-1,KCA,9,false,32,43,75,168,142,310,5,16,21,1,2:48
631309,2020-09-10,2020,MIA,PHI,7,6,7-6,MIA,9,false,45,39,84,138,178,316,20,14,34,2,3:26
630957,2020-09-10,2020,TBA,BOS,3,4,4-3,BOS,9,false,39,37,76,140,166,306,12,11,23,3,3:22
630908,2020-09-10,2020,TEX,ANA,2,6,6-2,ANA,9,false,33,40,73,162,144,306,6,15,21,2,3:04
630869,2020-09-10,2020,WAS,ATL,6,7,7-6,ATL,9,false,42,37,79,143,164,307,16,13,29,4,3:40
630223,2020-09-10,2020,ARI,LAN,5,2,5-2,ARI,9,true,37,41,78,173,138,311,12,17,29,1,3:31
631634,2020-09-10,2020,CHN,CIN,8,5,8-5,CHN,9,true,43,39,82,177,189,366,21,14,35,5,4:07 (1:15 delay)
630985,2020-09-11,2020,SLN,CIN,1,3,3-1,CIN,9,false,31,35,66,143,112,255,5,10,15,0,2:24
631256,2020-09-11,2020,MIN,CLE,3,1,3-1,MIN,9,true,31,33,64,123,123,246,7,8,15,0,2:43 (:42 delay)
631184,2020-09-11,2020,NYA,BAL,6,0,6-0,NYA,7,true,28,25,53,114,101,215,12,3,15,0,2:02
631284,2020-09-11,2020,MIL,CHN,1,0,1-0,MIL,9,false,32,33,65,124,137,261,7,4,11,1,2:50
631318,2020-09-11,2020,MIA,PHI,5,3,5-3,MIA,7,true,30,32,62,104,121,225,12,13,25,4,2:41
631318,2020-09-11,2020,MIA,PHI,5,3,5-3,MIA,7,true,30,32,62,104,121,225,12,13,25,4,2:41
631478,2020-09-11,2020,CHA,DET,4,3,4-3,CHA,9,true,30,37,67,163,119,282,7,9,16,4,3:02
631310,2020-09-11,2020,MIA,PHI,0,11,11-0,PHI,7,false,25,36,61,133,106,239,5,14,19,1,2:33
630224,2020-09-11,2020,ARI,SEA,4,3,4-3,ARI,9,true,32,33,65,127,123,250,8,6,14,1,2:32
631183,2020-09-11,2020,NYA,BAL,10,1,10-1,NYA,7,true,33,26,59,131,144,275,15,6,21,2,2:40
631530,2020-09-11,2020,COL,ANA,8,4,8-4,COL,9,false,39,37,76,128,154,282,15,10,25,2,3:08
631183,2020-09-11,2020,NYA,BAL,10,1,10-1,NYA,7,true,33,26,59,131,144,275,15,6,21,2,2:40
630909,2020-09-11,2020,TEX,OAK,6,10,10-6,OAK,9,false,38,47,85,176,154,330,13,19,32,2,3:22
631399,2020-09-11,2020,KCA,PIT,4,3,4-3,KCA,9,true,36,38,74,165,169,334,11,11,22,1,3:10
630958,2020-09-11,2020,TBA,BOS,11,1,11-1,TBA,9,true,42,37,79,163,174,337,19,13,32,3,3:37
630868,2020-09-11,2020,TOR,NYN,1,18,18-1,NYN,9,false,34,55,89,231,132,363,8,27,35,3,3:30
630873,2020-09-11,2020,WAS,ATL,8,7,8-7,WAS,12,false,50,62,112,236,192,428,18,28,46,1,4:48
630910,2020-09-12,2020,TEX,OAK,5,2,5-2,TEX,7,true,25,26,51,99,96,195,7,5,12,1,1:58
631257,2020-09-12,2020,MIN,CLE,8,4,8-4,MIN,9,true,33,37,70,167,108,275,11,10,21,2,2:56
630225,2020-09-12,2020,ARI,SEA,3,7,7-3,SEA,9,false,37,40,77,146,117,263,11,16,27,0,2:45
630959,2020-09-12,2020,TBA,BOS,5,4,5-4,TBA,9,true,33,35,68,123,126,249,10,8,18,0,2:37
631331,2020-09-12,2020,LAN,HOU,5,7,7-5,HOU,9,false,36,41,77,148,142,290,11,16,27,2,3:15
631285,2020-09-12,2020,MIL,CHN,2,4,4-2,CHN,9,false,34,37,71,145,128,273,8,10,18,2,2:42
630877,2020-09-12,2020,WAS,ATL,1,2,2-1,ATL,9,false,36,36,72,138,149,287,10,9,19,1,3:04
630988,2020-09-12,2020,SLN,CIN,7,1,7-1,SLN,9,true,39,33,72,129,162,291,16,7,23,3,3:08
630932,2020-09-12,2020,TEX,OAK,1,10,10-1,OAK,7,false,30,39,69,170,126,296,12,17,29,1,2:59
630870,2020-09-12,2020,TOR,NYN,3,2,3-2,TOR,9,true,37,36,73,149,141,290,13,10,23,2,3:22
631185,2020-09-12,2020,NYA,BAL,2,1,2-1,NYA,10,false,38,37,75,126,174,300,10,5,15,2,3:11
630932,2020-09-12,2020,TEX,OAK,1,10,10-1,OAK,7,false,30,39,69,170,126,296,12,17,29,1,2:59
631495,2020-09-12,2020,CHA,DET,14,0,14-0,CHA,9,true,47,32,79,117,178,295,23,6,29,1,3:02
631400,2020-09-12,2020,KCA,PIT,7,4,7-4,KCA,9,true,41,34,75,136,160,296,18,9,27,2,3:06 (:32 delay)
631531,2020-09-12,2020,COL,ANA,2,5,5-2,ANA,11,false,43,48,91,181,152,333,11,13,24,3,3:44
631311,2020-09-12,2020,MIA,PHI,6,12,12-6,PHI,9,false,37,49,86,175,152,327,13,23,36,5,3:43
631058,2020-09-13,2020,SDN,SFN,3,1,3-1,SDN,7,true,24,27,51,98,102,200,9,6,15,2,2:12
631060,2020-09-13,2020,SDN,SFN,6,0,6-0,SDN,7,true,28,23,51,99,115,214,11,3,14,1,2:08
631312,2020-09-13,2020,MIA,PHI,2,1,2-1,MIA,7,true,26,26,52,90,104,194,8,7,15,2,2:01
631058,2020-09-13,2020,SDN,SFN,3,1,3-1,SDN,7,true,24,27,51,98,102,200,9,6,15,2,2:12
631320,2020-09-13,2020,MIA,PHI,8,1,8-1,MIA,7,true,31,25,56,103,124,227,15,6,21,1,2:22
631320,2020-09-13,2020,MIA,PHI,8,1,8-1,MIA,7,true,31,25,56,103,124,227,15,6,21,1,2:22
631332,2020-09-13,2020,LAN,HOU,8,1,8-1,LAN,9,true,35,33,68,136,131,267,12,6,18,1,2:52
631481,2020-09-13,2020,CHA,DET,5,2,5-2,CHA,9,true,35,35,70,155,145,300,12,9,21,2,3:08
631401,2020-09-13,2020,KCA,PIT,11,0,11-0,KCA,9,true,45,32,77,111,185,296,21,6,27,2,3:02
630911,2020-09-13,2020,TEX,OAK,6,3,6-3,TEX,9,true,33,36,69,144,131,275,10,9,19,1,2:57
630947,2020-09-13,2020,TBA,BOS,3,6,6-3,BOS,9,false,40,40,80,150,162,312,11,14,25,2,3:11
631286,2020-09-13,2020,MIL,CHN,0,12,12-0,CHN,9,false,29,47,76,182,114,296,3,18,21,1,2:50
631187,2020-09-13,2020,NYA,BAL,3,1,3-1,NYA,9,true,33,33,66,137,130,267,9,7,16,2,2:44
631532,2020-09-13,2020,COL,ANA,3,5,5-3,ANA,9,false,34,43,77,179,123,302,8,17,25,3,3:04
631259,2020-09-13,2020,MIN,CLE,7,5,7-5,MIN,9,true,35,42,77,188,149,337,11,16,27,5,3:43
630875,2020-09-13,2020,TOR,NYN,7,3,7-3,TOR,9,true,37,39,76,153,150,303,13,14,27,2,3:12
630883,2020-09-13,2020,WAS,ATL,4,8,8-4,ATL,9,false,39,41,80,175,155,330,14,15,29,3,3:37
630226,2020-09-13,2020,ARI,SEA,3,7,7-3,SEA,9,false,39,41,80,172,172,344,13,15,28,2,3:32
630961,2020-09-13,2020,SLN,CIN,5,10,10-5,CIN,9,false,41,46,87,216,169,385,15,20,35,5,3:42
631588,2020-09-14,2020,CIN,PIT,3,1,3-1,CIN,7,false,28,27,55,116,119,235,9,6,15,1,2:25
631053,2020-09-14,2020,SEA,OAK,6,5,6-5,SEA,7,true,31,32,63,121,115,236,13,10,23,2,2:18
631053,2020-09-14,2020,SEA,OAK,6,5,6-5,SEA,7,true,31,32,63,121,115,236,13,10,23,2,2:18
631054,2020-09-14,2020,SEA,OAK,0,9,9-0,OAK,7,false,23,38,61,142,102,244,4,17,21,1,2:24
631054,2020-09-14,2020,SEA,OAK,0,9,9-0,OAK,7,false,23,38,61,142,102,244,4,17,21,1,2:24
631282,2020-09-14,2020,MIL,SLN,2,1,2-1,MIL,8,false,32,30,62,132,112,244,10,7,17,1,2:37
631321,2020-09-14,2020,MIA,PHI,6,2,6-2,MIA,9,true,35,31,66,125,144,269,11,4,15,3,2:47
631321,2020-09-14,2020,MIA,PHI,6,2,6-2,MIA,9,true,35,31,66,125,144,269,11,4,15,3,2:47
631590,2020-09-14,2020,CIN,PIT,9,4,9-4,CIN,7,true,32,32,64,140,155,295,15,12,27,4,2:58
631590,2020-09-14,2020,CIN,PIT,9,4,9-4,CIN,7,true,32,32,64,140,155,295,15,12,27,4,2:58
631061,2020-09-14,2020,SDN,LAN,7,2,7-2,SDN,9,true,35,34,69,141,139,280,10,8,18,2,2:59
631288,2020-09-14,2020,MIL,SLN,2,3,3-2,SLN,9,false,35,42,77,183,156,339,9,14,23,4,3:42
631677,2020-09-14,2020,BAL,ATL,14,1,14-1,BAL,9,true,47,35,82,140,175,315,24,10,34,1,2:54
631288,2020-09-14,2020,MIL,SLN,2,3,3-2,SLN,9,false,35,42,77,183,156,339,9,14,23,4,3:42
631482,2020-09-14,2020,CHA,MIN,3,1,3-1,CHA,9,true,39,43,82,187,166,353,15,19,34,4,3:51
631520,2020-09-15,2020,COL,OAK,3,1,3-1,COL,9,true,33,33,66,109,127,236,11,7,18,1,2:41
631574,2020-09-15,2020,CIN,PIT,4,1,4-1,CIN,9,true,32,35,67,151,121,272,8,8,16,0,2:40
631314,2020-09-15,2020,MIA,BOS,0,2,2-0,BOS,9,false,33,37,70,144,135,279,7,12,19,2,3:05
631360,2020-09-15,2020,ANA,ARI,8,9,9-8,ARI,9,false,41,40,81,151,135,286,16,13,29,2,3:06
631062,2020-09-15,2020,SDN,LAN,1,3,3-1,LAN,9,false,34,35,69,151,125,276,7,10,17,1,2:59
631144,2020-09-15,2020,PHI,NYN,4,1,4-1,PHI,9,true,32,40,72,154,126,280,8,15,23,2,2:58
631680,2020-09-15,2020,BAL,ATL,1,5,5-1,ATL,9,false,30,43,73,167,120,287,4,17,21,1,2:57
631433,2020-09-15,2020,HOU,TEX,4,1,4-1,HOU,9,true,37,31,68,117,176,293,14,4,18,2,3:00
631483,2020-09-15,2020,CHA,MIN,6,2,6-2,CHA,9,true,38,35,73,136,164,300,15,8,23,2,3:04
631618,2020-09-15,2020,CHN,CLE,6,5,6-5,CHN,9,false,41,39,80,139,143,282,18,16,34,1,3:17
631462,2020-09-15,2020,DET,KCA,6,0,6-0,DET,9,true,41,37,78,155,174,329,19,10,29,3,3:27
631195,2020-09-15,2020,NYA,TOR,20,6,20-6,NYA,9,true,50,41,91,127,190,317,25,15,40,2,3:12
630936,2020-09-15,2020,TBA,WAS,6,1,6-1,TBA,9,true,39,36,75,140,155,295,16,10,26,4,3:08
631263,2020-09-15,2020,MIL,SLN,18,3,18-3,MIL,9,true,46,38,84,161,190,351,22,11,33,2,3:09
631265,2020-09-16,2020,MIL,SLN,2,4,4-2,SLN,7,false,26,27,53,88,102,190,5,7,12,0,2:01
631289,2020-09-16,2020,MIL,SLN,6,0,6-0,MIL,7,true,30,25,55,106,104,210,13,4,17,1,2:01
631289,2020-09-16,2020,MIL,SLN,6,0,6-0,MIL,7,true,30,25,55,106,104,210,13,4,17,1,2:01
631434,2020-09-16,2020,HOU,TEX,0,1,1-0,TEX,9,false,32,33,65,126,114,240,7,5,12,1,2:36
631289,2020-09-16,2020,MIL,SLN,6,0,6-0,MIL,7,true,30,25,55,106,104,210,13,4,17,1,2:01
631575,2020-09-16,2020,CIN,PIT,1,0,1-0,CIN,9,true,29,30,59,114,141,255,6,4,10,2,2:34
631463,2020-09-16,2020,DET,KCA,0,4,4-0,KCA,9,false,30,37,67,146,118,264,3,8,11,0,2:33
631659,2020-09-16,2020,BAL,ATL,5,1,5-1,BAL,9,true,32,33,65,152,119,271,9,7,16,1,2:35
631484,2020-09-16,2020,CHA,MIN,1,5,5-1,MIN,9,false,30,36,66,140,138,278,3,11,14,2,3:05
631509,2020-09-16,2020,COL,OAK,1,3,3-1,OAK,9,false,36,35,71,140,131,271,9,10,19,2,2:57
631063,2020-09-16,2020,SDN,LAN,5,7,7-5,LAN,9,false,37,39,76,162,138,300,11,11,22,6,3:25
631361,2020-09-16,2020,ANA,ARI,6,9,9-6,ARI,9,false,40,41,81,150,156,306,14,14,28,1,3:10
631119,2020-09-16,2020,PHI,NYN,4,5,5-4,NYN,9,false,40,36,76,130,158,288,13,13,26,1,3:17
631619,2020-09-16,2020,CHN,CLE,3,2,3-2,CHN,10,false,42,37,79,140,159,299,18,9,27,1,3:13 (:07 delay)
631315,2020-09-16,2020,MIA,BOS,8,4,8-4,MIA,9,true,36,42,78,173,148,321,12,15,27,2,3:35
631189,2020-09-16,2020,NYA,TOR,13,2,13-2,NYA,9,true,43,35,78,127,179,306,20,8,28,1,3:02
630937,2020-09-16,2020,TBA,WAS,2,4,4-2,WAS,10,false,42,38,80,153,171,324,14,9,23,1,3:31
631032,2020-09-16,2020,SEA,SFN,3,9,9-3,SFN,9,false,41,44,85,172,182,354,16,18,34,4,3:29
631032,2020-09-16,2020,SEA,SFN,3,9,9-3,SFN,9,false,41,44,85,172,182,354,16,18,34,4,3:29
631660,2020-09-17,2020,BAL,TBA,1,3,3-1,TBA,7,false,27,30,57,129,107,236,7,9,16,1,2:28
631435,2020-09-17,2020,HOU,TEX,2,1,2-1,HOU,9,true,30,33,63,126,113,239,5,6,11,1,2:33
630953,2020-09-17,2020,TBA,BAL,10,6,10-6,TBA,7,true,32,34,66,126,124,250,15,13,28,5,2:38
631101,2020-09-17,2020,PIT,SLN,5,1,5-1,PIT,9,true,35,30,65,110,145,255,15,4,19,2,2:25
630953,2020-09-17,2020,TBA,BAL,10,6,10-6,TBA,7,true,32,34,66,126,124,250,15,13,28,5,2:38
631510,2020-09-17,2020,COL,LAN,3,9,9-3,LAN,9,false,34,43,77,161,117,278,5,18,23,5,3:07
631485,2020-09-17,2020,CHA,MIN,4,3,4-3,CHA,9,true,35,36,71,129,160,289,12,9,21,4,3:20
631313,2020-09-17,2020,MIA,BOS,3,5,5-3,BOS,9,false,37,37,74,154,136,290,9,13,22,3,3:09
631362,2020-09-17,2020,ANA,ARI,7,3,7-3,ANA,9,true,37,39,76,175,128,303,15,12,27,2,3:07
631464,2020-09-17,2020,DET,CLE,3,10,10-3,CLE,9,false,33,44,77,188,136,324,6,16,22,3,3:04
631190,2020-09-17,2020,NYA,TOR,10,7,10-7,NYA,9,true,43,40,83,144,172,316,20,14,34,2,3:19
631034,2020-09-17,2020,SEA,SFN,4,6,6-4,SFN,9,false,40,42,82,164,181,345,13,18,31,3,3:34
631034,2020-09-17,2020,SEA,SFN,4,6,6-4,SFN,9,false,40,42,82,164,181,345,13,18,31,3,3:34
631117,2020-09-17,2020,PHI,NYN,6,10,10-6,NYN,9,false,46,44,90,180,191,371,19,18,37,6,4:12
631316,2020-09-18,2020,MIA,WAS,0,5,5-0,WAS,7,false,26,32,58,102,109,211,5,15,20,0,2:15
630987,2020-09-18,2020,SLN,PIT,7,2,7-2,SLN,7,true,28,27,55,117,109,226,8,6,14,1,2:19
630987,2020-09-18,2020,SLN,PIT,7,2,7-2,SLN,7,true,28,27,55,117,109,226,8,6,14,1,2:19
630907,2020-09-18,2020,TOR,PHI,0,7,7-0,PHI,7,false,25,36,61,144,92,236,6,15,21,2,2:33
630907,2020-09-18,2020,TOR,PHI,0,7,7-0,PHI,7,false,25,36,61,144,92,236,6,15,21,2,2:33
631122,2020-09-18,2020,PHI,TOR,8,7,8-7,PHI,7,true,32,37,69,136,131,267,15,16,31,8,3:14
631342,2020-09-18,2020,MIA,WAS,14,3,14-3,MIA,7,true,38,28,66,115,149,264,19,8,27,4,2:54
631629,2020-09-18,2020,CHN,MIN,1,0,1-0,CHN,9,true,31,31,62,130,118,248,7,6,13,0,2:34
631661,2020-09-18,2020,BAL,TBA,1,2,2-1,TBA,9,false,34,39,73,147,145,292,7,12,19,1,2:59
631102,2020-09-18,2020,PIT,SLN,5,6,6-5,SLN,7,false,36,33,69,130,154,284,12,11,23,5,3:08
631342,2020-09-18,2020,MIA,WAS,14,3,14-3,MIA,7,true,38,28,66,115,149,264,19,8,27,4,2:54
631576,2020-09-18,2020,CIN,CHA,7,1,7-1,CIN,9,true,35,34,69,150,153,303,12,8,20,2,2:51
631367,2020-09-18,2020,ANA,TEX,6,2,6-2,ANA,9,true,41,33,74,130,155,285,18,6,24,1,2:55
631436,2020-09-18,2020,HOU,ARI,3,6,6-3,ARI,9,false,36,37,73,153,133,286,8,11,19,2,3:08
631465,2020-09-18,2020,DET,CLE,0,1,1-0,CLE,9,false,34,38,72,171,143,314,8,12,20,2,3:33
631163,2020-09-18,2020,OAK,SFN,6,0,6-0,OAK,9,true,35,35,70,146,155,301,10,8,18,2,2:53
631040,2020-09-18,2020,SEA,SDN,1,6,6-1,SDN,9,false,31,40,71,151,148,299,5,14,19,0,3:01
631266,2020-09-18,2020,MIL,KCA,9,5,9-5,MIL,9,true,42,42,84,181,159,340,19,16,35,2,3:20
631511,2020-09-18,2020,COL,LAN,6,15,15-6,LAN,9,false,36,48,84,192,121,313,11,22,33,7,3:24
631213,2020-09-18,2020,NYN,ATL,2,15,15-2,ATL,9,false,39,52,91,218,162,380,13,26,39,2,3:39
631627,2020-09-18,2020,BOS,NYA,5,6,6-5,NYA,12,false,53,47,100,184,228,412,16,15,31,2,4:55
631437,2020-09-19,2020,HOU,ARI,3,2,3-2,HOU,9,true,31,34,65,140,113,253,7,8,15,1,2:37
631267,2020-09-19,2020,MIL,KCA,5,0,5-0,MIL,9,true,31,31,62,141,141,282,10,5,15,1,2:55
631512,2020-09-19,2020,COL,LAN,1,6,6-1,LAN,9,false,29,37,66,144,114,258,5,11,16,0,2:32
631164,2020-09-19,2020,OAK,SFN,6,0,6-0,OAK,9,true,34,32,66,122,134,256,11,6,17,1,2:34
631372,2020-09-19,2020,ANA,TEX,4,3,4-3,ANA,9,true,32,35,67,136,121,257,9,8,17,1,2:35
631628,2020-09-19,2020,BOS,NYA,0,8,8-0,NYA,9,false,32,41,73,167,124,291,5,17,22,0,2:59
631466,2020-09-19,2020,DET,CLE,5,2,5-2,DET,9,true,39,34,73,127,159,286,17,8,25,3,3:00
631036,2020-09-19,2020,SEA,SDN,4,1,4-1,SEA,9,true,35,35,70,137,146,283,12,12,24,1,2:59
631147,2020-09-19,2020,PIT,SLN,4,5,5-4,SLN,9,false,35,38,73,152,157,309,9,11,20,4,3:06
631577,2020-09-19,2020,CIN,CHA,0,5,5-0,CHA,9,false,36,37,73,148,138,286,11,10,21,0,2:57
631123,2020-09-19,2020,PHI,TOR,3,1,3-1,PHI,9,true,37,31,68,144,152,296,13,5,18,2,3:16
631662,2020-09-19,2020,BAL,TBA,1,3,3-1,TBA,9,false,37,37,74,140,154,294,11,11,22,2,3:04
631317,2020-09-19,2020,MIA,WAS,7,3,7-3,MIA,9,true,40,36,76,156,134,290,18,11,29,2,3:06
631632,2020-09-19,2020,CHN,MIN,1,8,8-1,MIN,9,false,33,36,69,148,148,296,6,12,18,2,3:10
631214,2020-09-19,2020,NYN,ATL,7,2,7-2,NYN,9,true,39,38,77,157,168,325,15,13,28,3,3:32
631305,2020-09-20,2020,MIA,WAS,2,1,2-1,MIA,7,true,27,30,57,122,122,244,8,11,19,1,2:37
631086,2020-09-20,2020,PIT,SLN,1,2,2-1,SLN,9,false,30,37,67,151,133,284,4,9,13,0,2:50
631329,2020-09-20,2020,MIA,WAS,0,15,15-0,WAS,7,false,26,43,69,160,107,267,5,22,27,3,2:54
631672,2020-09-20,2020,BAL,TBA,2,1,2-1,BAL,9,true,31,34,65,141,109,250,7,6,13,3,2:31
631375,2020-09-20,2020,ANA,TEX,2,7,7-2,TEX,9,false,33,39,72,154,124,278,7,13,20,4,3:00
631454,2020-09-20,2020,DET,CLE,4,7,7-4,CLE,9,false,36,38,74,156,157,313,9,11,20,1,2:59
631215,2020-09-20,2020,NYN,ATL,0,7,7-0,ATL,9,false,30,41,71,163,137,300,5,14,19,2,3:09
631635,2020-09-20,2020,BOS,NYA,10,2,10-2,BOS,9,true,42,34,76,142,164,306,19,9,28,0,3:22
631329,2020-09-20,2020,MIA,WAS,0,15,15-0,WAS,7,false,26,43,69,160,107,267,5,22,27,3,2:54
631617,2020-09-20,2020,CHN,MIN,0,4,4-0,MIN,9,false,36,39,75,131,143,274,8,13,21,1,3:07
631519,2020-09-20,2020,COL,LAN,6,3,6-3,COL,9,true,35,39,74,168,141,309,11,14,25,4,3:15
631268,2020-09-20,2020,MIL,KCA,5,3,5-3,MIL,9,true,35,32,67,127,151,278,12,6,18,3,2:43
631424,2020-09-20,2020,HOU,ARI,3,2,3-2,HOU,9,true,35,33,68,134,160,294,11,9,20,2,3:04
631128,2020-09-20,2020,PHI,TOR,3,6,6-3,TOR,9,false,39,40,79,167,166,333,11,12,23,2,3:28
631578,2020-09-20,2020,CIN,CHA,7,3,7-3,CIN,9,true,43,37,80,171,186,357,20,11,31,3,3:36
631166,2020-09-20,2020,OAK,SFN,2,14,14-2,SFN,9,false,37,49,86,193,142,335,10,23,33,2,3:21
631037,2020-09-20,2020,SEA,SDN,4,7,7-4,SDN,11,false,42,47,89,207,178,385,10,14,24,1,4:02
631038,2020-09-21,2020,SEA,HOU,6,1,6-1,SEA,9,true,34,36,70,114,130,244,10,10,20,1,2:34
631402,2020-09-21,2020,KCA,SLN,4,1,4-1,KCA,9,true,34,35,69,144,125,269,11,9,20,3,2:55
631579,2020-09-21,2020,CIN,MIL,6,3,6-3,CIN,9,true,34,35,69,137,145,282,11,10,21,4,2:56
631087,2020-09-21,2020,PIT,CHN,0,5,5-0,CHN,9,false,31,37,68,139,135,274,6,11,17,3,2:58
631562,2020-09-21,2020,CLE,CHA,7,4,7-4,CLE,9,true,37,40,77,162,148,310,15,13,28,0,3:14
631216,2020-09-21,2020,NYN,TBA,1,2,2-1,TBA,9,false,34,35,69,149,119,268,8,9,17,3,3:00
631376,2020-09-21,2020,ANA,TEX,8,5,8-5,ANA,9,true,37,36,73,150,140,290,14,9,23,1,3:00
630440,2020-09-21,2020,ATL,MIA,5,4,5-4,ATL,9,true,34,41,75,176,140,316,11,16,27,1,3:30
630884,2020-09-21,2020,WAS,PHI,5,1,5-1,WAS,9,true,37,36,73,171,172,343,13,13,26,2,3:48
631009,2020-09-21,2020,SFN,COL,2,7,7-2,COL,9,false,40,41,81,180,167,347,12,14,26,2,3:33
630876,2020-09-21,2020,TOR,NYA,11,5,11-5,TOR,9,true,41,39,80,175,190,365,17,13,30,5,3:56
630888,2020-09-22,2020,WAS,PHI,5,1,5-1,WAS,7,true,27,26,53,105,94,199,9,4,13,0,2:09
631088,2020-09-22,2020,PIT,CHN,3,2,3-2,PIT,9,false,32,34,66,122,132,254,8,10,18,2,2:45
631580,2020-09-22,2020,CIN,MIL,2,3,3-2,MIL,9,false,35,33,68,136,124,260,6,7,13,0,2:27
630385,2020-09-22,2020,ATL,MIA,11,1,11-1,ATL,9,true,41,36,77,135,134,269,17,12,29,1,2:50
631217,2020-09-22,2020,NYN,TBA,5,2,5-2,NYN,9,true,34,33,67,135,151,286,14,6,20,2,3:03
630243,2020-09-22,2020,ARI,TEX,7,0,7-0,ARI,9,true,39,36,75,137,153,290,13,9,22,1,2:56
631333,2020-09-22,2020,LAN,OAK,7,2,7-2,LAN,9,true,37,36,73,154,141,295,15,8,23,3,3:18
631064,2020-09-22,2020,SDN,ANA,2,4,4-2,ANA,9,false,36,42,78,149,153,302,11,14,25,2,3:10
631039,2020-09-22,2020,SEA,HOU,1,6,6-1,HOU,9,false,33,42,75,160,140,300,7,15,22,2,3:06
631550,2020-09-22,2020,CLE,CHA,5,3,5-3,CLE,10,false,39,38,77,135,171,306,10,10,20,1,3:21
631411,2020-09-22,2020,KCA,SLN,0,5,5-0,SLN,9,false,35,40,75,169,144,313,8,15,23,1,3:09
630896,2020-09-22,2020,WAS,PHI,8,7,8-7,WAS,8,false,35,41,76,164,131,295,13,18,31,5,3:25
630896,2020-09-22,2020,WAS,PHI,8,7,8-7,WAS,8,false,35,41,76,164,131,295,13,18,31,5,3:25
631010,2020-09-22,2020,SFN,COL,5,2,5-2,SFN,9,true,38,37,75,165,154,319,16,11,27,3,3:26
631251,2020-09-22,2020,MIN,DET,5,4,5-4,MIN,10,false,42,42,84,161,175,336,14,14,28,4,3:43
631636,2020-09-22,2020,BOS,BAL,8,3,8-3,BOS,9,true,42,42,84,166,182,348,18,15,33,4,3:31
630881,2020-09-22,2020,TOR,NYA,1,12,12-1,NYA,9,false,30,43,73,182,142,324,5,18,23,3,3:29
631089,2020-09-23,2020,PIT,CHN,2,1,2-1,PIT,9,true,30,37,67,165,103,268,8,10,18,2,2:57
631218,2020-09-23,2020,NYN,TBA,5,8,8-5,TBA,9,false,35,40,75,140,124,264,8,15,23,2,2:53
631583,2020-09-23,2020,CIN,MIL,6,1,6-1,CIN,9,true,34,32,66,113,142,255,9,6,15,1,2:38
631334,2020-09-23,2020,LAN,OAK,4,6,6-4,OAK,9,false,35,36,71,139,141,280,8,9,17,1,2:52
630554,2020-09-23,2020,ATL,MIA,9,4,9-4,ATL,9,true,39,34,73,136,154,290,16,8,24,0,3:01
631035,2020-09-23,2020,SEA,HOU,3,2,3-2,SEA,9,true,37,38,75,146,151,297,13,12,25,2,3:09
630263,2020-09-23,2020,ARI,TEX,7,3,7-3,ARI,9,true,38,35,73,140,145,285,14,9,23,2,2:57
630892,2020-09-23,2020,WAS,PHI,3,12,12-3,PHI,9,false,33,47,80,168,106,274,7,22,29,2,2:48
631534,2020-09-23,2020,CLE,CHA,3,2,3-2,CLE,9,false,34,36,70,158,161,319,9,7,16,0,3:14
631011,2020-09-23,2020,SFN,COL,7,2,7-2,SFN,9,true,41,36,77,128,169,297,17,10,27,3,3:10
631250,2020-09-23,2020,MIN,DET,7,6,7-6,MIN,9,true,34,40,74,162,133,295,10,12,22,3,3:16
631637,2020-09-23,2020,BOS,BAL,9,1,9-1,BOS,9,true,40,38,78,153,142,295,15,14,29,2,3:04
631065,2020-09-23,2020,SDN,ANA,2,5,5-2,ANA,9,false,35,40,75,152,149,301,8,14,22,4,3:24
631380,2020-09-23,2020,KCA,SLN,12,3,12-3,KCA,9,true,40,37,77,146,139,285,17,11,28,2,2:50
630885,2020-09-23,2020,TOR,NYA,14,1,14-1,TOR,9,true,47,36,83,157,176,333,22,9,31,2,3:39
631099,2020-09-24,2020,PIT,CHN,7,0,7-0,PIT,9,true,37,32,69,117,133,250,17,6,23,1,2:36
631549,2020-09-24,2020,CLE,CHA,5,4,5-4,CLE,9,true,35,32,67,126,136,262,12,6,18,2,2:48
631335,2020-09-24,2020,LAN,OAK,5,1,5-1,LAN,9,true,37,32,69,140,134,274,13,6,19,0,2:50
630887,2020-09-24,2020,TOR,NYA,4,1,4-1,TOR,9,true,35,39,74,149,136,285,11,12,23,2,3:11
631685,2020-09-24,2020,ATL,MIA,2,4,4-2,MIA,9,false,40,40,80,153,166,319,13,11,24,4,3:35 (1:39 delay)
630893,2020-09-24,2020,WAS,NYN,2,3,3-2,NYN,9,false,35,42,77,152,153,305,9,15,24,0,3:15
630912,2020-09-24,2020,TEX,HOU,4,12,12-4,HOU,9,false,37,45,82,165,147,312,10,18,28,2,3:11
631640,2020-09-24,2020,BOS,BAL,1,13,13-1,BAL,9,false,33,47,80,176,118,294,10,21,31,1,3:14
631398,2020-09-24,2020,KCA,DET,8,7,8-7,KCA,9,true,37,44,81,180,135,315,15,18,33,6,3:22
630975,2020-09-24,2020,SLN,MIL,4,2,4-2,SLN,9,true,39,38,77,180,166,346,15,12,27,4,3:43
631012,2020-09-24,2020,SFN,COL,4,5,5-4,COL,11,false,46,48,94,201,156,357,17,16,33,4,4:13
631013,2020-09-25,2020,SFN,SDN,5,4,5-4,SFN,7,true,27,32,59,120,117,237,10,11,21,3,2:27
631059,2020-09-25,2020,SDN,SFN,6,5,6-5,SDN,7,false,28,29,57,119,108,227,9,7,16,3,2:37
630270,2020-09-25,2020,ARI,COL,4,0,4-0,ARI,7,true,31,29,60,105,127,232,15,9,24,2,2:36
630963,2020-09-25,2020,SLN,MIL,0,3,3-0,MIL,7,false,24,29,53,121,103,224,6,10,16,1,2:12
631292,2020-09-25,2020,MIL,SLN,1,9,9-1,SLN,7,false,26,35,61,153,120,273,5,14,19,3,2:36
631059,2020-09-25,2020,SDN,SFN,6,5,6-5,SDN,7,false,28,29,57,119,108,227,9,7,16,3,2:37
631292,2020-09-25,2020,MIL,SLN,1,9,9-1,SLN,7,false,26,35,61,153,120,273,5,14,19,3,2:36
630889,2020-09-25,2020,TOR,BAL,10,5,10-5,TOR,9,true,40,37,77,134,145,279,18,10,28,4,2:41
631383,2020-09-25,2020,KCA,DET,3,2,3-2,KCA,9,true,35,34,69,139,134,273,12,9,21,1,2:50
630203,2020-09-25,2020,ARI,COL,11,5,11-5,ARI,7,true,40,31,71,122,158,280,21,12,33,2,2:58
631486,2020-09-25,2020,CHA,CHN,0,10,10-0,CHN,9,false,31,42,73,168,117,285,4,16,20,2,3:04
631167,2020-09-25,2020,OAK,SEA,3,1,3-1,OAK,10,false,40,35,75,123,162,285,15,6,21,0,3:08
631536,2020-09-25,2020,CLE,PIT,4,3,4-3,CLE,9,false,38,36,74,148,162,310,14,11,25,1,3:18
630203,2020-09-25,2020,ARI,COL,11,5,11-5,ARI,7,true,40,31,71,122,158,280,21,12,33,2,2:58
630938,2020-09-25,2020,TBA,PHI,6,4,6-4,TBA,9,true,38,36,74,150,162,312,14,10,24,2,3:08
630913,2020-09-25,2020,TEX,HOU,5,4,5-4,TEX,10,false,40,42,82,152,146,298,10,13,23,2,3:15
631191,2020-09-25,2020,NYA,MIA,3,4,4-3,MIA,10,false,37,40,77,167,142,309,12,6,18,1,3:20
631336,2020-09-25,2020,LAN,ANA,9,5,9-5,LAN,9,true,41,38,79,165,163,328,17,12,29,6,3:42
631246,2020-09-25,2020,MIN,CIN,2,7,7-2,CIN,9,false,40,40,80,151,185,336,13,13,26,4,3:38
630569,2020-09-25,2020,ATL,BOS,8,7,8-7,ATL,11,false,53,47,100,144,200,344,24,16,40,1,3:59
631055,2020-09-26,2020,SEA,OAK,12,3,12-3,SEA,7,true,35,30,65,105,124,229,17,11,28,1,2:15
630894,2020-09-26,2020,WAS,NYN,5,3,5-3,WAS,7,true,32,29,61,118,124,242,13,8,21,1,2:35
631055,2020-09-26,2020,SEA,OAK,12,3,12-3,SEA,7,true,35,30,65,105,124,229,17,11,28,1,2:15
630894,2020-09-26,2020,WAS,NYN,5,3,5-3,WAS,7,true,32,29,61,118,124,242,13,8,21,1,2:35
631169,2020-09-26,2020,OAK,SEA,1,5,5-1,SEA,8,false,30,32,62,120,122,242,10,9,19,2,2:39
630895,2020-09-26,2020,WAS,NYN,4,3,4-3,WAS,7,true,27,30,57,124,135,259,9,9,18,1,2:39
630964,2020-09-26,2020,SLN,MIL,0,3,3-0,MIL,9,false,30,38,68,116,129,245,3,12,15,2,2:38
630891,2020-09-26,2020,TOR,BAL,5,2,5-2,TOR,9,true,33,35,68,133,151,284,7,9,16,3,2:58
630939,2020-09-26,2020,TBA,PHI,4,3,4-3,TBA,9,true,34,38,72,129,133,262,13,13,26,2,2:53
631016,2020-09-26,2020,SFN,SDN,2,6,6-2,SDN,9,false,36,37,73,137,145,282,10,10,20,3,2:47
630914,2020-09-26,2020,TEX,HOU,6,1,6-1,TEX,9,true,37,35,72,124,143,267,14,9,23,1,2:44
630271,2020-09-26,2020,ARI,COL,3,10,10-3,COL,9,false,36,43,79,180,110,290,7,15,22,0,3:03
631385,2020-09-26,2020,KCA,DET,3,4,4-3,DET,9,false,37,35,72,140,137,277,11,12,23,1,3:00
631245,2020-09-26,2020,MIN,CIN,7,3,7-3,MIN,9,true,34,37,71,156,137,293,12,11,23,2,3:06
631537,2020-09-26,2020,CLE,PIT,0,8,8-0,PIT,9,false,33,41,74,156,146,302,7,14,21,0,2:56
630570,2020-09-26,2020,ATL,BOS,2,8,8-2,BOS,9,false,36,42,78,175,149,324,10,14,24,3,3:22
631337,2020-09-26,2020,LAN,ANA,7,6,7-6,LAN,9,true,36,40,76,150,163,313,12,13,25,1,3:19 (:25 delay)
631193,2020-09-26,2020,NYA,MIA,11,4,11-4,NYA,9,true,41,41,82,153,167,320,18,13,31,3,3:20
631487,2020-09-26,2020,CHA,CHN,9,5,9-5,CHA,9,true,40,36,76,135,168,303,17,10,27,2,3:20
631386,2020-09-27,2020,KCA,DET,3,1,3-1,KCA,9,true,31,30,61,125,139,264,7,4,11,1,2:27 (1:35 delay)
631338,2020-09-27,2020,LAN,ANA,5,0,5-0,LAN,9,true,34,31,65,122,142,264,10,6,16,2,2:54
630202,2020-09-27,2020,ARI,COL,11,3,11-3,ARI,9,true,42,35,77,115,149,264,21,7,28,3,2:54
631538,2020-09-27,2020,CLE,PIT,8,6,8-6,CLE,9,true,37,40,77,129,136,265,15,14,29,3,3:00
630965,2020-09-27,2020,SLN,MIL,5,2,5-2,SLN,9,true,32,37,69,157,137,294,9,11,20,3,2:58
631188,2020-09-27,2020,NYA,MIA,0,5,5-0,MIA,9,false,35,40,75,157,138,295,10,14,24,2,3:05
630945,2020-09-27,2020,TBA,PHI,5,0,5-0,TBA,9,true,37,33,70,131,160,291,14,7,21,3,2:59
630858,2020-09-27,2020,TOR,BAL,5,7,7-5,BAL,9,false,38,40,78,160,144,304,10,14,24,1,2:52
631002,2020-09-27,2020,SFN,SDN,4,5,5-4,SDN,9,false,37,40,77,166,151,317,11,12,23,7,3:22
631155,2020-09-27,2020,OAK,SEA,6,2,6-2,OAK,9,true,41,35,76,155,167,322,18,7,25,1,3:06
630573,2020-09-27,2020,ATL,BOS,1,9,9-1,BOS,9,false,38,47,85,186,153,339,11,20,31,0,3:23
631488,2020-09-27,2020,CHA,CHN,8,10,10-8,CHN,9,false,43,43,86,163,178,341,17,16,33,6,3:37
631244,2020-09-27,2020,MIN,CIN,3,5,5-3,CIN,10,false,38,41,79,182,161,343,9,13,22,7,3:53
630915,2020-09-27,2020,TEX,HOU,8,4,8-4,TEX,9,true,40,40,80,177,167,344,18,13,31,2,3:28
630854,2020-09-27,2020,WAS,NYN,15,5,15-5,WAS,9,true,47,40,87,169,205,374,23,14,37,3,3:35