API Key,Date,Year,Home Team,Away Team,Home Score,Away Score,Final Score,Winning Team,# Innings,End Top Inning?,Home Team PA #,Away Team PA #,Total Number PA,Homne Team # Pitches,Away Team # Pitches,Total # Pitches,Home Team Baserunners,Away Team Baserunners,Total # Baserunners,Pitching Changes,Time
634532,2021-04-18,2021,BOS,CHA,2,3,3-2,CHA,7,false,26,28,54,93,91,184,8,8,16,2,2:04
633922,2021-05-27,2021,NYN,COL,1,0,1-0,NYN,7,true,21,26,47,102,62,164,4,5,9,0,1:54
634465,2021-05-20,2021,ANA,MIN,7,1,7-1,ANA,7,true,29,25,54,80,107,187,12,5,17,0,1:55
634561,2021-04-17,2021,COL,NYN,7,2,7-2,COL,7,true,29,25,54,87,107,194,11,4,15,0,2:11
634222,2021-07-17,2021,DET,MIN,1,0,1-0,DET,7,true,25,23,48,85,100,185,7,2,9,1,1:55
634465,2021-05-20,2021,ANA,MIN,7,1,7-1,ANA,7,true,29,25,54,80,107,187,12,5,17,0,1:55
634040,2021-05-28,2021,BOS,MIA,5,2,5-2,BOS,6,true,23,25,48,95,90,185,7,8,15,1,2:07 (1:25 delay)
634595,2021-04-07,2021,WAS,ATL,0,2,2-0,ATL,7,false,25,27,52,113,105,218,6,6,12,0,2:08
634595,2021-04-07,2021,WAS,ATL,0,2,2-0,ATL,7,false,25,27,52,113,105,218,6,6,12,0,2:08
634561,2021-04-17,2021,COL,NYN,7,2,7-2,COL,7,true,29,25,54,87,107,194,11,4,15,0,2:11
634434,2021-04-23,2021,MIN,PIT,2,0,2-0,MIN,9,true,28,31,59,123,92,215,5,4,9,2,2:17
634466,2021-04-20,2021,OAK,MIN,1,0,1-0,OAK,7,true,22,25,47,103,102,205,6,4,10,1,2:08 (:25 delay)
634477,2021-04-17,2021,KCA,TOR,1,5,5-1,TOR,7,false,25,29,54,129,94,223,6,8,14,1,2:10
634380,2021-04-25,2021,ATL,ARI,0,7,7-0,ARI,7,false,21,33,54,129,98,227,0,12,12,1,2:11
634472,2021-04-15,2021,BAL,SEA,1,2,2-1,SEA,7,false,26,29,55,119,92,211,6,10,16,1,2:01
634518,2021-04-18,2021,BOS,CHA,1,5,5-1,CHA,7,false,26,32,58,116,98,214,5,13,18,3,2:24
634466,2021-04-20,2021,OAK,MIN,1,0,1-0,OAK,7,true,22,25,47,103,102,205,6,4,10,1,2:08 (:25 delay)
634423,2021-04-21,2021,DET,PIT,5,2,5-2,DET,7,true,25,26,51,86,88,174,9,5,14,1,1:55
634468,2021-04-18,2021,COL,NYN,1,2,2-1,NYN,9,false,30,34,64,119,100,219,5,7,12,0,2:38
634520,2021-04-17,2021,KCA,TOR,3,2,3-2,KCA,7,false,30,27,57,95,106,201,9,6,15,4,2:21
632226,2021-04-13,2021,NYN,PHI,4,0,4-0,NYN,7,true,30,25,55,99,124,223,12,6,18,0,2:30
632226,2021-04-13,2021,NYN,PHI,4,0,4-0,NYN,7,true,30,25,55,99,124,223,12,6,18,0,2:30
634518,2021-04-18,2021,BOS,CHA,1,5,5-1,CHA,7,false,26,32,58,116,98,214,5,13,18,3,2:24
634485,2021-04-17,2021,COL,NYN,3,4,4-3,NYN,7,false,26,32,58,117,112,229,4,12,16,0,2:27
632201,2021-04-10,2021,NYN,MIA,0,3,3-0,MIA,9,false,31,35,66,113,112,225,5,9,14,1,2:36
633974,2021-05-27,2021,NYA,TOR,0,2,2-0,TOR,7,false,25,28,53,123,96,219,4,7,11,1,2:11
633910,2021-05-27,2021,NYA,TOR,5,3,5-3,NYA,7,true,26,28,54,115,96,211,9,10,19,3,2:16
633935,2021-05-30,2021,CLE,TOR,1,4,4-1,TOR,7,false,26,31,57,102,97,199,5,12,17,1,2:05
632213,2021-04-13,2021,BAL,SEA,3,4,4-3,SEA,8,false,30,32,62,132,109,241,8,9,17,1,2:26
634390,2021-04-21,2021,DET,PIT,2,3,3-2,PIT,7,false,26,31,57,122,117,239,5,11,16,0,2:16
634533,2021-04-09,2021,LAN,WAS,1,0,1-0,LAN,9,true,29,34,63,125,104,229,6,10,16,0,2:31
634490,2021-04-20,2021,OAK,MIN,7,0,7-0,OAK,7,true,31,28,59,95,128,223,12,7,19,1,2:15
634520,2021-04-17,2021,KCA,TOR,3,2,3-2,KCA,7,false,30,27,57,95,106,201,9,6,15,4,2:21
632214,2021-04-11,2021,LAN,WAS,3,0,3-0,LAN,9,true,29,34,63,124,119,243,6,7,13,0,2:29
634498,2021-04-18,2021,PHI,SLN,2,0,2-0,PHI,9,true,35,30,65,109,130,239,13,2,15,0,2:34
634263,2021-05-07,2021,OAK,TBA,2,1,2-1,OAK,9,false,34,31,65,100,127,227,10,4,14,2,2:28
634156,2021-05-11,2021,HOU,ANA,5,1,5-1,HOU,9,true,35,30,65,108,122,230,11,5,16,2,2:33
634042,2021-05-30,2021,CLE,TOR,6,5,6-5,CLE,7,false,30,29,59,112,107,219,11,10,21,3,2:08
634647,2021-06-19,2021,WAS,NYN,1,5,5-1,NYN,7,false,32,29,61,84,157,241,12,8,20,2,2:47
634580,2021-04-03,2021,PHI,ATL,4,0,4-0,PHI,9,true,36,28,64,113,144,257,15,1,16,1,2:30
634655,2021-04-01,2021,ANA,CHA,4,3,4-3,ANA,9,true,34,35,69,125,140,265,10,9,19,2,2:51
634380,2021-04-25,2021,ATL,ARI,0,7,7-0,ARI,7,false,21,33,54,129,98,227,0,12,12,1,2:11
633910,2021-05-27,2021,NYA,TOR,5,3,5-3,NYA,7,true,26,28,54,115,96,211,9,10,19,3,2:16
634472,2021-04-15,2021,BAL,SEA,1,2,2-1,SEA,7,false,26,29,55,119,92,211,6,10,16,1,2:01
634478,2021-04-09,2021,TEX,SDN,0,3,3-0,SDN,9,false,28,35,63,141,112,253,1,10,11,0,2:46
634166,2021-05-14,2021,CHA,KCA,3,1,3-1,CHA,7,true,30,27,57,101,130,231,11,6,17,2,2:30
634525,2021-04-16,2021,OAK,DET,3,0,3-0,OAK,9,true,34,31,65,146,107,253,10,5,15,0,2:31
634575,2021-04-03,2021,MIL,MIN,0,2,2-0,MIN,9,false,30,32,62,129,127,256,3,5,8,1,2:46
633986,2021-05-26,2021,DET,CLE,1,0,1-0,DET,9,true,29,33,62,133,115,248,6,10,16,1,2:39
633899,2021-06-21,2021,NYN,ATL,0,1,1-0,ATL,7,false,26,28,54,120,112,232,7,7,14,1,2:33
633887,2021-05-29,2021,CHA,BAL,3,1,3-1,CHA,7,true,26,29,55,127,98,225,8,7,15,1,2:12
634031,2021-05-19,2021,SDN,COL,3,0,3-0,SDN,9,true,32,29,61,119,117,236,8,2,10,1,2:52
634617,2021-04-04,2021,PHI,ATL,2,1,2-1,PHI,9,true,34,32,66,113,135,248,12,7,19,1,2:40
634497,2021-04-21,2021,MIA,BAL,3,0,3-0,MIA,9,true,34,31,65,99,145,244,12,5,17,2,2:42
634057,2021-05-17,2021,SDN,COL,7,0,7-0,SDN,9,true,37,31,68,99,141,240,14,4,18,1,2:55
634206,2021-05-14,2021,DET,CHN,2,4,4-2,CHN,9,false,29,37,66,137,107,244,5,13,18,0,2:31
634107,2021-05-18,2021,ATL,NYN,3,4,4-3,NYN,9,false,34,34,68,109,133,242,8,9,17,1,2:36
633969,2021-05-25,2021,MIA,PHI,0,2,2-0,PHI,9,false,33,29,62,106,136,242,9,3,12,0,2:49
634598,2021-04-07,2021,DET,MIN,2,3,3-2,MIN,9,false,33,33,66,118,120,238,9,8,17,0,2:46
632204,2021-04-12,2021,TBA,TEX,1,0,1-0,TBA,9,true,31,31,62,126,127,253,8,5,13,1,2:42
634529,2021-04-06,2021,SDN,SFN,3,1,3-1,SDN,9,true,31,30,61,133,124,257,10,4,14,1,2:53
634616,2021-04-05,2021,CLE,KCA,0,3,3-0,KCA,9,false,32,38,70,133,133,266,7,13,20,1,2:52
632224,2021-04-13,2021,BAL,SEA,7,6,7-6,BAL,7,false,34,31,65,115,134,249,13,10,23,2,2:38
634409,2021-04-20,2021,BOS,TOR,4,2,4-2,BOS,9,true,33,33,66,133,121,254,9,6,15,2,2:42
634656,2021-05-14,2021,CHA,KCA,2,6,6-2,KCA,7,false,28,32,60,131,122,253,9,11,20,0,2:28
634357,2021-04-29,2021,CHA,DET,11,0,11-0,CHA,7,true,37,24,61,91,154,245,19,3,22,2,2:42 (1:06 delay)
634429,2021-04-23,2021,NYN,WAS,6,0,6-0,NYN,9,true,38,29,67,109,145,254,15,2,17,0,2:37
634175,2021-05-09,2021,ATL,PHI,6,1,6-1,ATL,9,true,32,34,66,138,121,259,11,8,19,0,2:44
633934,2021-05-27,2021,SEA,TEX,5,0,5-0,SEA,9,true,33,33,66,121,131,252,11,7,18,1,2:35
634176,2021-05-10,2021,BAL,BOS,4,1,4-1,BAL,9,true,34,32,66,113,131,244,11,5,16,2,2:45
634043,2021-05-18,2021,KCA,MIL,2,0,2-0,KCA,9,true,32,31,63,132,107,239,8,5,13,2,2:48 (:21 delay)
632223,2021-04-14,2021,MIN,BOS,1,7,7-1,BOS,7,false,28,32,60,133,110,243,8,13,21,2,2:31
634390,2021-04-21,2021,DET,PIT,2,3,3-2,PIT,7,false,26,31,57,122,117,239,5,11,16,0,2:16
634648,2021-04-12,2021,SFN,CIN,0,3,3-0,CIN,9,false,31,35,66,129,138,267,5,8,13,2,2:35
634607,2021-04-04,2021,NYA,TOR,1,3,3-1,TOR,9,false,33,36,69,136,141,277,7,7,14,1,2:41
634641,2021-04-07,2021,BOS,TBA,9,2,9-2,BOS,9,true,37,35,72,121,134,255,15,9,24,0,2:51
634505,2021-04-09,2021,CLE,DET,4,1,4-1,CLE,9,true,32,31,63,132,136,268,7,5,12,1,2:40
634463,2021-04-16,2021,TEX,BAL,2,5,5-2,BAL,9,false,34,35,69,134,133,267,6,8,14,1,2:32
634344,2021-04-25,2021,NYN,WAS,4,0,4-0,NYN,9,true,34,34,68,125,131,256,13,9,22,1,2:42
634066,2021-05-19,2021,ATL,NYN,5,4,5-4,ATL,9,false,37,33,70,127,120,247,16,5,21,3,2:50
634519,2021-04-16,2021,MIA,SFN,4,1,4-1,MIA,9,true,32,34,66,133,115,248,8,8,16,1,2:44
634565,2021-04-08,2021,CHA,KCA,6,0,6-0,CHA,9,true,38,32,70,111,153,264,16,5,21,2,2:48 (2:12 delay)
634381,2021-04-30,2021,OAK,BAL,2,3,3-2,BAL,9,false,35,35,70,120,136,256,8,10,18,1,2:40
634516,2021-04-14,2021,CHA,CLE,8,0,8-0,CHA,9,true,41,28,69,114,148,262,17,1,18,2,2:40
634656,2021-05-14,2021,CHA,KCA,2,6,6-2,KCA,7,false,28,32,60,131,122,253,9,11,20,0,2:28
634652,2021-04-01,2021,MIA,TBA,0,1,1-0,TBA,9,false,31,36,67,138,121,259,4,9,13,1,2:44
632223,2021-04-14,2021,MIN,BOS,1,7,7-1,BOS,7,false,28,32,60,133,110,243,8,13,21,2,2:31
634515,2021-06-25,2021,NYN,PHI,1,2,2-1,PHI,8,false,31,29,60,107,118,225,8,6,14,0,2:32
634432,2021-04-22,2021,SFN,MIA,3,0,3-0,SFN,9,true,30,29,59,124,116,240,7,4,11,0,2:26
634587,2021-04-05,2021,NYA,BAL,7,0,7-0,NYA,9,true,38,33,71,120,153,273,14,6,20,2,2:58
634566,2021-04-05,2021,CHN,MIL,5,3,5-3,CHN,9,true,33,33,66,135,131,266,10,7,17,3,2:49
634623,2021-04-03,2021,SDN,ARI,7,0,7-0,SDN,9,true,42,30,72,116,169,285,17,4,21,0,2:58
634557,2021-04-04,2021,COL,LAN,2,4,4-2,LAN,9,false,33,38,71,162,106,268,6,13,19,1,2:51
632210,2021-04-13,2021,KCA,ANA,3,2,3-2,KCA,9,true,31,40,71,161,112,273,7,14,21,1,2:57
634355,2021-04-25,2021,BOS,SEA,5,3,5-3,BOS,9,true,34,33,67,126,144,270,13,7,20,1,2:44 (:07 delay)
634513,2021-04-14,2021,TOR,NYA,5,4,5-4,TOR,9,false,38,34,72,122,143,265,16,9,25,0,2:54
634564,2021-04-08,2021,COL,ARI,7,3,7-3,COL,9,true,35,37,72,140,120,260,10,11,21,2,2:51
634276,2021-05-01,2021,PHI,NYN,4,5,5-4,NYN,9,false,36,35,71,117,133,250,10,10,20,0,2:56
634527,2021-04-07,2021,WAS,ATL,6,7,7-6,ATL,7,false,34,33,67,122,129,251,14,14,28,1,2:49
634458,2021-04-18,2021,NYA,TBA,2,4,4-2,TBA,9,false,34,34,68,143,140,283,7,8,15,4,2:56
634441,2021-05-20,2021,ANA,MIN,3,6,6-3,MIN,7,false,26,35,61,150,120,270,5,14,19,1,2:49
634509,2021-04-20,2021,WAS,SLN,3,2,3-2,WAS,9,true,35,33,68,131,129,260,13,7,20,1,2:51
634589,2021-04-07,2021,CLE,KCA,4,2,4-2,CLE,9,true,34,35,69,139,137,276,11,8,19,2,2:53
634480,2021-04-18,2021,OAK,DET,3,2,3-2,OAK,9,false,34,36,70,137,125,262,10,9,19,1,2:42
634611,2021-04-04,2021,DET,CLE,3,9,9-3,CLE,9,false,30,39,69,144,119,263,5,13,18,1,2:38
634417,2021-04-20,2021,SEA,LAN,0,1,1-0,LAN,9,false,30,32,62,130,112,242,3,6,9,0,2:28
634571,2021-04-15,2021,BAL,SEA,2,4,4-2,SEA,7,false,26,30,56,141,103,244,6,8,14,2,2:23
634627,2021-04-02,2021,BOS,BAL,0,3,3-0,BAL,9,false,31,36,67,164,136,300,4,11,15,2,3:10
634645,2021-04-01,2021,DET,CLE,3,2,3-2,DET,9,true,35,38,73,154,125,279,10,12,22,2,3:03
634586,2021-04-06,2021,ANA,HOU,2,4,4-2,HOU,9,false,33,36,69,150,125,275,8,9,17,0,2:47
634593,2021-04-04,2021,KCA,TEX,3,7,7-3,TEX,9,false,36,39,75,143,130,273,8,13,21,2,2:53
634489,2021-04-13,2021,TBA,TEX,3,8,8-3,TEX,9,false,36,41,77,142,120,262,10,15,25,0,2:43
634340,2021-05-02,2021,SEA,ANA,2,0,2-0,SEA,9,true,33,35,68,138,139,277,9,10,19,1,3:05
634033,2021-05-19,2021,LAN,ARI,4,2,4-2,LAN,9,true,35,32,67,119,150,269,11,5,16,3,2:56
634474,2021-04-16,2021,PHI,SLN,9,2,9-2,PHI,9,true,38,32,70,120,147,267,16,6,22,2,2:34
633929,2021-05-29,2021,OAK,ANA,0,4,4-0,ANA,9,false,29,38,67,148,125,273,5,11,16,2,2:57
634524,2021-04-10,2021,ATL,PHI,5,4,5-4,ATL,9,true,35,35,70,146,113,259,11,8,19,2,2:50
634406,2021-04-20,2021,COL,HOU,6,2,6-2,COL,9,true,34,35,69,132,133,265,13,9,22,4,3:08
633947,2021-05-29,2021,SEA,TEX,3,2,3-2,SEA,9,true,31,34,65,151,112,263,8,7,15,1,2:43
634415,2021-04-23,2021,ATL,ARI,5,4,5-4,ATL,9,true,35,35,70,136,133,269,12,8,20,2,2:47
633996,2021-05-23,2021,SDN,SEA,9,2,9-2,SDN,9,true,38,35,73,123,133,256,13,10,23,1,2:55
634469,2021-04-16,2021,WAS,ARI,1,0,1-0,WAS,9,false,31,32,63,137,124,261,7,5,12,0,2:54
634239,2021-05-05,2021,SLN,NYN,2,7,7-2,NYN,7,false,33,34,67,112,108,220,13,13,26,3,2:40
634399,2021-04-19,2021,SDN,MIL,1,3,3-1,MIL,9,false,32,34,66,127,130,257,7,7,14,0,2:49
634646,2021-04-03,2021,ANA,CHA,5,3,5-3,ANA,9,true,35,39,74,144,144,288,11,13,24,2,3:04
634530,2021-04-06,2021,CIN,PIT,14,1,14-1,CIN,9,true,43,33,76,113,151,264,20,6,26,2,2:35
634573,2021-04-03,2021,DET,CLE,5,2,5-2,DET,9,true,39,36,75,145,154,299,15,11,26,2,3:17
634542,2021-04-07,2021,COL,ARI,8,0,8-0,COL,9,true,39,33,72,111,149,260,15,7,22,0,2:57
634405,2021-04-21,2021,WAS,SLN,1,0,1-0,WAS,9,true,30,36,66,168,123,291,6,11,17,0,3:01
634487,2021-04-18,2021,CIN,CLE,3,6,6-3,CLE,9,false,37,36,73,147,123,270,9,10,19,1,2:42
634268,2021-05-02,2021,TEX,BOS,5,3,5-3,TEX,9,true,36,35,71,116,149,265,12,11,23,1,2:57
634486,2021-04-24,2021,CLE,NYA,1,2,2-1,NYA,9,false,31,36,67,160,141,301,4,9,13,1,3:05
634398,2021-04-20,2021,ANA,TEX,6,2,6-2,ANA,9,true,34,38,72,150,133,283,11,13,24,2,2:52
634479,2021-04-17,2021,OAK,DET,7,0,7-0,OAK,9,true,36,33,69,135,153,288,14,6,20,1,2:49
634202,2021-05-11,2021,BOS,OAK,2,3,3-2,OAK,9,false,33,36,69,161,119,280,6,10,16,1,3:01
634316,2021-05-01,2021,SDN,SFN,6,2,6-2,SDN,9,true,33,35,68,143,129,272,12,9,21,2,2:56
634136,2021-05-13,2021,ARI,MIA,1,5,5-1,MIA,9,false,35,39,74,127,131,258,8,14,22,1,2:55
634396,2021-04-19,2021,KCA,TBA,1,4,4-1,TBA,9,false,32,39,71,162,118,280,6,11,17,2,3:00
633997,2021-05-28,2021,SEA,TEX,3,2,3-2,SEA,9,true,30,36,66,153,119,272,8,13,21,1,2:46
632208,2021-08-10,2021,TOR,ANA,3,6,6-3,ANA,7,false,31,35,66,144,111,255,12,14,26,2,2:43
634583,2021-04-07,2021,TEX,TOR,2,1,2-1,TEX,9,true,33,36,69,132,102,234,9,10,19,1,2:33
634452,2021-05-31,2021,CLE,CHA,3,1,3-1,CLE,7,true,26,28,54,122,99,221,8,8,16,3,2:21
634447,2021-04-17,2021,SEA,HOU,0,1,1-0,HOU,9,false,30,36,66,135,99,234,4,11,15,1,2:36
634572,2021-04-04,2021,SDN,ARI,1,3,3-1,ARI,9,false,38,38,76,155,136,291,13,13,26,2,3:19
634620,2021-06-28,2021,WAS,NYN,8,4,8-4,WAS,9,true,38,38,76,155,116,271,16,12,28,3,3:03
634643,2021-04-03,2021,CHN,PIT,5,1,5-1,CHN,9,true,36,33,69,126,160,286,11,7,18,1,3:08
634613,2021-04-04,2021,CHN,PIT,4,3,4-3,CHN,9,true,34,36,70,139,144,283,10,11,21,3,3:09
634599,2021-04-06,2021,NYA,BAL,7,2,7-2,NYA,9,true,39,34,73,131,158,289,16,7,23,1,2:58
634475,2021-04-15,2021,KCA,TOR,7,5,7-5,KCA,9,true,34,39,73,145,126,271,10,13,23,3,2:51
632212,2021-04-13,2021,LAN,COL,7,0,7-0,LAN,9,true,39,30,69,123,169,292,14,4,18,1,3:08
634157,2021-05-10,2021,ARI,MIA,5,2,5-2,ARI,9,true,35,34,69,121,142,263,12,8,20,2,2:47
634496,2021-04-14,2021,TBA,TEX,1,5,5-1,TEX,9,false,34,38,72,149,140,289,8,15,23,3,2:58
632202,2021-04-10,2021,HOU,OAK,3,7,7-3,OAK,9,false,36,39,75,146,145,291,11,13,24,2,3:14
634639,2021-04-03,2021,SEA,SFN,4,0,4-0,SEA,9,true,34,35,69,157,127,284,11,9,20,2,2:59
634091,2021-05-17,2021,LAN,ARI,3,1,3-1,LAN,9,true,36,36,72,133,143,276,14,10,24,1,3:05
634153,2021-05-10,2021,SFN,TEX,3,1,3-1,SFN,9,true,35,34,69,121,156,277,10,9,19,1,2:47
634553,2021-04-14,2021,MIL,CHN,7,0,7-0,MIL,9,true,39,34,73,122,162,284,16,6,22,1,3:06
633942,2021-05-30,2021,HOU,SDN,7,4,7-4,HOU,9,true,33,36,69,131,140,271,9,11,20,0,2:47
634169,2021-05-11,2021,TBA,NYA,1,3,3-1,NYA,9,false,33,36,69,147,136,283,6,11,17,0,2:50
632233,2021-04-11,2021,TEX,SDN,0,2,2-0,SDN,9,false,37,35,72,123,150,273,11,8,19,2,3:16
634012,2021-05-21,2021,WAS,BAL,4,2,4-2,WAS,9,true,40,33,73,123,139,262,17,8,25,1,2:56
634102,2021-05-18,2021,ANA,CLE,5,6,6-5,CLE,9,false,35,38,73,147,129,276,10,11,21,1,2:48
634574,2021-04-14,2021,MIN,BOS,2,3,3-2,BOS,7,false,28,36,64,132,107,239,7,14,21,1,2:40
632225,2021-04-11,2021,PIT,CHN,7,1,7-1,PIT,9,true,42,34,76,123,140,263,18,8,26,3,3:02
634042,2021-05-30,2021,CLE,TOR,6,5,6-5,CLE,7,false,30,29,59,112,107,219,11,10,21,3,2:08
634138,2021-05-14,2021,BOS,ANA,4,3,4-3,BOS,9,true,33,33,66,136,134,270,11,6,17,1,2:45
634570,2021-04-07,2021,CIN,PIT,11,4,11-4,CIN,9,true,38,35,73,116,133,249,16,9,25,0,2:35
633912,2021-05-27,2021,NYN,COL,4,2,4-2,NYN,7,true,28,30,58,124,113,237,12,10,22,3,2:48
634313,2021-05-04,2021,SDN,PIT,1,2,2-1,PIT,9,false,34,37,71,113,138,251,7,12,19,1,2:59
634528,2021-04-14,2021,NYN,PHI,5,1,5-1,NYN,9,true,39,31,70,117,135,252,16,5,21,3,2:50
634059,2021-05-20,2021,LAN,ARI,3,2,3-2,LAN,9,true,30,34,64,147,115,262,8,8,16,1,2:54
632217,2021-04-10,2021,TBA,NYA,4,0,4-0,TBA,9,true,39,33,72,126,155,281,14,7,21,1,3:04
634560,2021-04-04,2021,CIN,SLN,12,1,12-1,CIN,9,true,40,33,73,144,153,297,14,8,22,2,3:00
634577,2021-04-03,2021,BOS,BAL,2,4,4-2,BAL,9,false,37,36,73,136,152,288,10,9,19,1,2:51
634559,2021-04-06,2021,CHN,MIL,0,4,4-0,MIL,9,false,31,36,67,149,145,294,7,10,17,0,3:06
632198,2021-04-12,2021,PIT,SDN,2,6,6-2,SDN,9,false,34,41,75,165,126,291,7,14,21,1,3:04 (:20 delay)
634602,2021-04-02,2021,MIA,TBA,4,6,6-4,TBA,9,false,39,36,75,143,140,283,13,11,24,2,3:22
632199,2021-04-13,2021,CHA,CLE,0,2,2-0,CLE,10,false,34,38,72,154,129,283,5,7,12,2,3:02
634578,2021-04-02,2021,SEA,SFN,3,6,6-3,SFN,9,false,35,39,74,149,152,301,10,12,22,2,3:16
634555,2021-04-08,2021,PIT,CHN,2,4,4-2,CHN,9,false,39,36,75,122,144,266,13,12,25,5,3:15
634534,2021-04-09,2021,ATL,PHI,8,1,8-1,ATL,9,true,40,34,74,127,161,288,17,8,25,1,3:03
634422,2021-04-20,2021,NYA,ATL,3,1,3-1,NYA,9,true,34,36,70,152,135,287,11,11,22,3,3:06
634473,2021-04-17,2021,MIL,PIT,7,1,7-1,MIL,9,true,36,36,72,130,146,276,13,8,21,0,2:42
634546,2021-04-08,2021,HOU,OAK,6,2,6-2,HOU,9,true,34,37,71,160,124,284,9,10,19,3,3:10
634420,2021-04-22,2021,LAN,SDN,2,3,3-2,SDN,9,false,37,33,70,126,154,280,12,7,19,3,3:02
634358,2021-04-24,2021,TBA,TOR,5,3,5-3,TBA,9,true,34,39,73,161,125,286,8,13,21,2,3:10
633965,2021-05-25,2021,WAS,CIN,1,2,2-1,CIN,9,false,32,33,65,143,146,289,6,9,15,2,2:52
634499,2021-04-09,2021,TBA,NYA,10,5,10-5,TBA,9,true,40,34,74,128,159,287,17,8,25,1,2:53
634058,2021-05-18,2021,CIN,SFN,2,4,4-2,SFN,9,false,36,39,75,157,129,286,10,13,23,1,2:52
634568,2021-04-08,2021,SLN,MIL,3,1,3-1,SLN,9,true,32,37,69,153,138,291,9,10,19,0,3:05
634543,2021-04-17,2021,TEX,BAL,1,6,6-1,BAL,9,false,35,41,76,134,146,280,10,13,23,3,3:05
634606,2021-04-05,2021,PHI,NYN,5,3,5-3,PHI,9,true,34,40,74,164,120,284,11,14,25,2,3:15
633870,2021-05-31,2021,CHN,SDN,7,2,7-2,CHN,9,true,35,34,69,121,155,276,12,8,20,2,2:53
634023,2021-05-25,2021,NYN,COL,3,1,3-1,NYN,9,true,36,33,69,131,153,284,15,6,21,1,3:04
634424,2021-04-21,2021,COL,HOU,6,3,6-3,COL,9,true,38,34,72,113,143,256,15,7,22,0,2:34
634492,2021-04-22,2021,DET,PIT,2,4,4-2,PIT,9,false,36,37,73,137,135,272,9,11,20,3,2:54
634047,2021-05-20,2021,TEX,NYA,0,2,2-0,NYA,9,false,33,36,69,138,117,255,7,13,20,1,2:49
634014,2021-05-21,2021,NYA,CHA,2,1,2-1,NYA,9,false,32,34,66,122,140,262,8,8,16,1,2:53
634311,2021-05-02,2021,NYA,DET,2,0,2-0,NYA,9,true,28,30,58,113,117,230,4,3,7,0,2:14
634264,2021-05-04,2021,CHN,LAN,7,1,7-1,CHN,7,true,28,30,58,92,115,207,10,9,19,0,2:17
633916,2021-05-29,2021,WAS,MIL,1,4,4-1,MIL,7,false,25,26,51,101,100,201,5,6,11,0,2:06
634622,2021-04-01,2021,PHI,ATL,3,2,3-2,PHI,10,false,43,40,83,134,151,285,15,10,25,1,3:33
634640,2021-04-01,2021,OAK,HOU,1,8,8-1,HOU,9,false,35,43,78,152,155,307,10,17,27,3,3:28
634563,2021-04-07,2021,SDN,SFN,2,3,3-2,SFN,10,false,36,40,76,162,129,291,7,11,18,0,3:21
634584,2021-04-08,2021,NYN,MIA,3,2,3-2,NYN,9,false,39,34,73,136,155,291,17,8,25,1,3:18
634403,2021-04-25,2021,HOU,ANA,2,4,4-2,ANA,9,false,34,38,72,153,139,292,9,11,20,2,3:04
634352,2021-04-29,2021,SLN,PHI,4,3,4-3,SLN,10,false,34,39,73,164,113,277,9,11,20,1,3:10
634526,2021-04-16,2021,ANA,MIN,10,3,10-3,ANA,9,true,37,37,74,145,140,285,15,14,29,3,3:08
632189,2021-04-13,2021,NYN,PHI,4,3,4-3,NYN,8,false,35,33,68,146,139,285,14,12,26,1,3:11
634000,2021-05-22,2021,ANA,OAK,2,6,6-2,OAK,9,false,33,40,73,144,114,258,6,15,21,3,3:02
633982,2021-05-24,2021,MIN,BAL,8,3,8-3,MIN,9,true,37,37,74,134,146,280,14,11,25,2,3:09 (:45 delay)
634562,2021-04-05,2021,MIA,SLN,1,4,4-1,SLN,9,false,35,35,70,152,145,297,8,9,17,0,3:09
633966,2021-05-28,2021,CLE,TOR,2,11,11-2,TOR,7,false,24,41,65,184,111,295,6,21,27,2,2:55 (:36 delay)
632221,2021-04-12,2021,MIL,CHN,6,3,6-3,MIL,9,true,37,35,72,141,132,273,15,9,24,3,3:04
634569,2021-04-13,2021,TOR,NYA,7,3,7-3,TOR,9,true,39,34,73,132,155,287,15,10,25,4,3:04
633933,2021-05-30,2021,WAS,MIL,0,3,3-0,MIL,9,false,32,35,67,158,134,292,6,8,14,0,3:01
634142,2021-05-11,2021,LAN,SEA,6,4,6-4,LAN,9,true,36,31,67,121,149,270,12,5,17,2,2:54
634035,2021-05-22,2021,NYA,CHA,7,0,7-0,NYA,9,true,40,32,72,129,160,289,16,8,24,2,3:06
633887,2021-05-29,2021,CHA,BAL,3,1,3-1,CHA,7,true,26,29,55,127,98,225,8,7,15,1,2:12
634582,2021-04-14,2021,SFN,CIN,3,0,3-0,SFN,9,true,31,31,62,106,134,240,9,5,14,1,2:30
634283,2021-05-06,2021,PHI,MIL,2,0,2-0,PHI,9,true,31,29,60,118,128,246,7,3,10,1,2:41
634375,2021-04-24,2021,DET,KCA,1,2,2-1,KCA,9,false,30,30,60,105,118,223,3,3,6,0,2:10
634501,2021-04-15,2021,CHA,CLE,2,4,4-2,CLE,9,false,38,37,75,150,148,298,11,9,20,1,3:17
634558,2021-04-05,2021,CIN,PIT,5,3,5-3,CIN,9,true,38,35,73,147,159,306,13,8,21,1,3:18
634495,2021-04-14,2021,KCA,ANA,6,1,6-1,KCA,9,true,38,37,75,144,143,287,13,9,22,3,3:10
634265,2021-05-04,2021,SEA,BAL,5,2,5-2,SEA,9,true,33,41,74,156,136,292,10,14,24,5,3:15
634544,2021-04-08,2021,BAL,BOS,3,7,7-3,BOS,9,false,34,42,76,165,131,296,6,16,22,4,3:08
634190,2021-05-08,2021,NYN,ARI,4,2,4-2,NYN,9,true,34,40,74,149,144,293,10,11,21,2,3:30
634304,2021-05-01,2021,WAS,MIA,7,2,7-2,WAS,9,true,39,35,74,129,155,284,15,11,26,1,2:59
634341,2021-05-02,2021,MIN,KCA,13,4,13-4,MIN,9,true,42,37,79,148,139,287,19,11,30,2,3:02
634273,2021-05-01,2021,CIN,CHN,2,3,3-2,CHN,9,false,38,36,74,146,139,285,11,11,22,3,3:17
633995,2021-05-23,2021,COL,ARI,4,3,4-3,COL,9,false,38,34,72,132,146,278,13,7,20,2,3:20
634095,2021-05-15,2021,BOS,ANA,9,0,9-0,BOS,9,true,37,36,73,159,136,295,14,11,25,1,2:52
634081,2021-05-22,2021,TOR,TBA,1,3,3-1,TBA,9,false,35,37,72,154,130,284,10,10,20,1,2:51
633993,2021-05-26,2021,BOS,ATL,9,5,9-5,BOS,9,true,36,38,74,147,138,285,10,12,22,3,2:56 (2:53 delay)
632203,2021-04-12,2021,TOR,NYA,1,3,3-1,NYA,9,false,34,33,67,153,144,297,7,9,16,3,3:04
632228,2021-04-11,2021,CLE,DET,5,2,5-2,CLE,9,true,36,35,71,154,136,290,14,10,24,2,3:04
634421,2021-04-19,2021,SEA,LAN,4,3,4-3,SEA,9,true,31,38,69,152,131,283,7,12,19,2,3:11
634076,2021-05-17,2021,CHN,WAS,7,3,7-3,CHN,9,true,34,35,69,128,127,255,12,9,21,3,2:53
634345,2021-04-26,2021,SLN,PHI,1,2,2-1,PHI,9,false,31,31,62,107,125,232,5,6,11,1,2:22
634250,2021-05-05,2021,SLN,NYN,4,1,4-1,SLN,7,true,29,27,56,101,111,212,9,6,15,0,2:28
634629,2021-04-03,2021,OAK,HOU,1,9,9-1,HOU,9,false,35,43,78,172,150,322,9,17,26,2,3:24
634504,2021-04-21,2021,NYA,ATL,1,4,4-1,ATL,9,false,37,40,77,163,143,306,11,14,25,2,3:16
634651,2021-04-04,2021,OAK,HOU,2,9,9-2,HOU,9,false,33,40,73,173,145,318,6,15,21,3,3:15
634500,2021-04-17,2021,NYA,TBA,3,6,6-3,TBA,9,false,37,35,72,139,173,312,9,8,17,3,3:28
634624,2021-04-06,2021,WAS,ATL,6,5,6-5,WAS,9,false,39,37,76,149,154,303,15,10,25,2,3:10
634224,2021-05-06,2021,NYA,HOU,4,7,7-4,HOU,9,false,38,37,75,156,153,309,13,12,25,1,3:14
634126,2021-05-13,2021,TBA,NYA,9,1,9-1,TBA,9,true,40,35,75,138,170,308,15,10,25,2,3:05
634173,2021-08-09,2021,CLE,CIN,9,3,9-3,CLE,9,true,41,38,79,146,153,299,17,12,29,2,3:09
634551,2021-04-05,2021,SEA,CHA,0,6,6-0,CHA,9,false,36,42,78,158,151,309,9,15,24,0,3:23
634612,2021-04-05,2021,TEX,TOR,2,6,6-2,TOR,9,false,35,39,74,160,138,298,8,15,23,3,3:04
634233,2021-05-06,2021,KCA,CLE,0,4,4-0,CLE,9,false,34,37,71,154,152,306,9,12,21,2,3:10
634064,2021-05-26,2021,TBA,KCA,2,1,2-1,TBA,10,false,40,36,76,133,156,289,13,6,19,0,2:55
632169,2021-04-10,2021,SFN,COL,4,3,4-3,SFN,9,true,34,36,70,160,144,304,12,12,24,1,3:13
634096,2021-05-15,2021,LAN,MIA,7,0,7-0,LAN,9,true,38,31,69,143,159,302,15,3,18,3,3:11
633967,2021-05-26,2021,PIT,CHN,1,4,4-1,CHN,9,false,32,40,72,157,120,277,6,15,21,2,2:54 (:26 delay)
634168,2021-05-19,2021,TEX,NYA,0,2,2-0,NYA,9,false,28,31,59,118,101,219,1,9,10,1,2:22
634452,2021-05-31,2021,CLE,CHA,3,1,3-1,CLE,7,true,26,28,54,122,99,221,8,8,16,3,2:21
633925,2021-07-26,2021,NYN,ATL,1,0,1-0,NYN,7,true,26,25,51,108,93,201,9,5,14,1,2:11
634428,2021-04-21,2021,PHI,SFN,6,5,6-5,PHI,9,false,42,38,80,152,146,298,17,13,30,2,3:15 (:44 delay)
634464,2021-04-16,2021,NYA,TBA,2,8,8-2,TBA,9,false,31,46,77,184,144,328,5,19,24,0,3:22
634378,2021-04-23,2021,SLN,CIN,5,4,5-4,SLN,9,true,34,39,73,154,144,298,10,12,22,5,3:15
634178,2021-05-08,2021,SFN,SDN,7,1,7-1,SFN,9,true,39,35,74,149,139,288,17,8,25,0,3:02
634088,2021-05-21,2021,KCA,DET,5,7,7-5,DET,9,false,37,40,77,167,138,305,11,15,26,2,3:19
634271,2021-05-01,2021,TEX,BOS,8,6,8-6,TEX,9,true,37,43,80,174,119,293,15,17,32,2,3:19
633903,2021-05-29,2021,BOS,MIA,3,1,3-1,BOS,9,true,35,40,75,176,118,294,12,13,25,4,3:17 (:16 delay)
634618,2021-04-01,2021,SDN,ARI,8,7,8-7,SDN,9,true,39,41,80,169,149,318,16,13,29,2,3:26
634628,2021-04-06,2021,OAK,LAN,1,5,5-1,LAN,9,false,34,39,73,147,127,274,7,14,21,1,2:45
634297,2021-05-04,2021,WAS,ATL,1,6,6-1,ATL,9,false,33,39,72,150,132,282,8,14,22,1,2:55
634384,2021-04-24,2021,CHA,TEX,2,1,2-1,CHA,9,false,36,36,72,137,134,271,13,11,24,1,2:58
633964,2021-05-27,2021,OAK,ANA,5,0,5-0,OAK,9,true,38,30,68,114,159,273,16,3,19,2,2:59
634547,2021-04-15,2021,LAN,COL,7,5,7-5,LAN,9,true,37,38,75,127,144,271,14,12,26,2,3:01
633991,2021-05-22,2021,SDN,SEA,6,4,6-4,SDN,9,true,39,39,78,134,155,289,18,12,30,1,3:06
634239,2021-05-05,2021,SLN,NYN,2,7,7-2,NYN,7,false,33,34,67,112,108,220,13,13,26,3,2:40
632224,2021-04-13,2021,BAL,SEA,7,6,7-6,BAL,7,false,34,31,65,115,134,249,13,10,23,2,2:38
634346,2021-04-29,2021,MIL,LAN,2,1,2-1,MIL,9,true,29,37,66,141,113,254,6,12,18,0,2:45
632220,2021-04-12,2021,HOU,DET,2,6,6-2,DET,9,false,36,43,79,152,128,280,10,16,26,2,3:04
633916,2021-05-29,2021,WAS,MIL,1,4,4-1,MIL,7,false,25,26,51,101,100,201,5,6,11,0,2:06
632193,2021-04-10,2021,TEX,SDN,4,7,7-4,SDN,9,false,36,42,78,162,150,312,9,19,28,3,3:15
634654,2021-04-03,2021,CIN,SLN,9,6,9-6,CIN,9,true,41,40,81,170,152,322,18,12,30,4,3:24
634633,2021-04-03,2021,COL,LAN,5,6,6-5,LAN,9,false,37,45,82,170,146,316,10,18,28,2,3:35
632215,2021-04-11,2021,MIN,SEA,6,8,8-6,SEA,9,false,41,43,84,162,146,308,13,17,30,3,3:28
634482,2021-04-16,2021,CIN,CLE,10,3,10-3,CIN,9,true,40,40,80,135,167,302,16,16,32,1,3:11
634596,2021-04-03,2021,MIA,TBA,12,7,12-7,MIA,9,true,42,37,79,124,171,295,19,10,29,4,3:32
634383,2021-04-23,2021,HOU,ANA,5,4,5-4,HOU,10,false,38,42,80,147,161,308,9,15,24,3,3:33
634037,2021-05-19,2021,KCA,MIL,6,4,6-4,KCA,9,true,36,40,76,157,145,302,10,12,22,2,3:10
634446,2021-04-21,2021,KCA,TBA,9,8,9-8,KCA,9,false,39,41,80,147,129,276,13,16,29,4,3:13
634549,2021-04-07,2021,CHN,MIL,2,4,4-2,MIL,10,false,37,40,77,149,147,296,7,9,16,2,3:32
634457,2021-04-19,2021,PHI,SFN,0,2,2-0,SFN,9,false,38,36,74,150,144,294,11,9,20,0,3:10
634029,2021-05-19,2021,ANA,CLE,2,3,3-2,CLE,9,false,33,36,69,142,140,282,7,12,19,3,3:05
632205,2021-04-10,2021,MIN,SEA,3,4,4-3,SEA,10,false,40,38,78,134,152,286,12,8,20,0,3:14
633927,2021-05-26,2021,MIL,SDN,1,2,2-1,SDN,10,false,37,37,74,151,144,295,7,7,14,0,3:04
634653,2021-04-02,2021,COL,LAN,6,11,11-6,LAN,9,false,37,47,84,169,133,302,10,19,29,3,3:19
634554,2021-04-15,2021,MIN,BOS,4,3,4-3,MIN,9,false,40,35,75,132,151,283,13,10,23,2,3:25 (:04 delay)
634135,2021-05-13,2021,SEA,CLE,2,4,4-2,CLE,9,false,34,33,67,119,118,237,8,6,14,1,2:36
634032,2021-05-22,2021,SLN,CHN,2,1,2-1,SLN,9,true,30,36,66,130,99,229,6,9,15,1,2:47
634003,2021-05-27,2021,WAS,CIN,0,3,3-0,CIN,7,false,24,30,54,113,101,214,3,8,11,0,2:07
634264,2021-05-04,2021,CHN,LAN,7,1,7-1,CHN,7,true,28,30,58,92,115,207,10,9,19,0,2:17
634594,2021-04-06,2021,MIA,SLN,2,4,4-2,SLN,9,false,40,38,78,158,165,323,14,11,25,2,3:43
634295,2021-05-01,2021,NYA,DET,6,4,6-4,NYA,9,true,39,40,79,137,162,299,15,13,28,3,3:25
634448,2021-04-25,2021,DET,KCA,0,4,4-0,KCA,9,false,32,41,73,173,146,319,6,13,19,2,3:23
634101,2021-05-17,2021,ANA,CLE,7,4,7-4,ANA,9,true,38,38,76,153,151,304,14,13,27,4,3:23
634439,2021-04-20,2021,PHI,SFN,7,10,10-7,SFN,9,false,39,40,79,164,150,314,13,15,28,2,3:16
634116,2021-05-19,2021,TOR,BOS,3,7,7-3,BOS,9,false,37,39,76,163,140,303,14,13,27,2,3:07
633901,2021-05-26,2021,MIA,PHI,4,2,4-2,MIA,9,true,36,38,74,151,144,295,12,10,22,0,3:29
634484,2021-04-10,2021,ARI,CIN,8,3,8-3,ARI,9,true,39,38,77,125,164,289,14,13,27,1,3:09
634299,2021-05-02,2021,ARI,COL,8,4,8-4,ARI,9,true,36,45,81,142,148,290,12,17,29,3,3:29
634604,2021-04-03,2021,KCA,TEX,11,4,11-4,KCA,9,true,40,36,76,146,148,294,17,10,27,2,2:53
634061,2021-05-19,2021,CIN,SFN,0,4,4-0,SFN,9,false,32,39,71,155,138,293,6,12,18,2,3:07
632188,2021-04-11,2021,SFN,COL,4,0,4-0,SFN,9,true,37,39,76,146,139,285,13,12,25,2,3:00
634538,2021-04-18,2021,SEA,HOU,7,2,7-2,SEA,9,true,35,34,69,153,154,307,11,4,15,2,3:19
634494,2021-04-09,2021,SFN,COL,3,1,3-1,SFN,9,true,35,31,66,121,158,279,12,5,17,4,2:54
634437,2021-04-23,2021,CLE,NYA,3,5,5-3,NYA,9,false,35,36,71,146,144,290,9,10,19,2,3:17
634517,2021-04-16,2021,SEA,HOU,6,5,6-5,SEA,9,false,38,36,74,114,141,255,15,11,26,4,3:04
634071,2021-05-16,2021,TBA,NYN,7,1,7-1,TBA,9,true,33,30,63,113,121,234,12,3,15,0,2:32
634290,2021-04-30,2021,MIL,LAN,3,1,3-1,MIL,9,true,31,31,62,129,107,236,9,4,13,1,2:44
634523,2021-04-14,2021,PIT,SDN,5,1,5-1,PIT,9,true,39,33,72,135,167,302,15,9,24,2,3:27
634259,2021-05-02,2021,WAS,MIA,3,1,3-1,WAS,9,true,34,31,65,106,124,230,13,6,19,1,2:37
633936,2021-05-29,2021,PIT,COL,4,0,4-0,PIT,7,true,26,28,54,117,88,205,8,7,15,0,2:03
634601,2021-04-05,2021,BOS,TBA,11,2,11-2,BOS,9,true,41,38,79,168,158,326,19,13,32,3,3:26
634591,2021-04-05,2021,SDN,SFN,2,3,3-2,SFN,9,false,41,37,78,152,158,310,13,11,24,2,3:35
634626,2021-04-07,2021,PHI,NYN,8,2,8-2,PHI,9,true,38,43,81,167,154,321,14,15,29,2,3:35
634460,2021-04-17,2021,CIN,CLE,3,2,3-2,CIN,10,false,43,41,84,144,155,299,17,15,32,1,3:25
634592,2021-04-07,2021,SEA,CHA,8,4,8-4,SEA,9,true,38,40,78,169,150,319,13,16,29,3,3:49
634445,2021-04-19,2021,BOS,CHA,11,4,11-4,BOS,9,true,46,36,82,129,189,318,23,9,32,2,3:15
634411,2021-04-20,2021,CHN,NYN,3,1,3-1,CHN,9,true,35,38,73,158,154,312,10,11,21,2,3:32
632197,2021-04-12,2021,KCA,ANA,3,10,10-3,ANA,9,false,37,42,79,167,152,319,10,18,28,5,3:28
634576,2021-04-02,2021,SDN,ARI,4,2,4-2,SDN,9,true,36,38,74,160,159,319,16,10,26,3,3:53
634632,2021-04-15,2021,OAK,DET,8,4,8-4,OAK,9,true,46,37,83,137,192,329,20,10,30,2,3:17
634430,2021-04-21,2021,ANA,TEX,4,7,7-4,TEX,9,false,37,41,78,188,127,315,11,15,26,2,3:20
633976,2021-05-24,2021,MIA,PHI,9,6,9-6,MIA,9,true,38,40,78,157,138,295,15,13,28,2,3:23
634010,2021-05-22,2021,COL,ARI,7,6,7-6,COL,9,true,35,43,78,160,134,294,11,17,28,3,3:19
633924,2021-05-27,2021,CHA,BAL,5,1,5-1,CHA,9,true,39,36,75,158,153,311,16,9,25,2,3:18 (:19 delay)
632229,2021-04-13,2021,HOU,DET,2,8,8-2,DET,9,false,37,41,78,184,134,318,11,16,27,2,3:27
633892,2021-05-30,2021,TBA,PHI,6,2,6-2,TBA,9,true,35,37,72,152,145,297,13,11,24,5,3:12
634055,2021-05-19,2021,BAL,TBA,7,9,9-7,TBA,9,false,41,41,82,152,147,299,14,14,28,3,3:12
633914,2021-05-27,2021,ARI,SLN,4,5,5-4,SLN,10,false,40,43,83,145,165,310,11,12,23,3,3:28
634537,2021-04-09,2021,HOU,OAK,2,6,6-2,OAK,9,false,38,39,77,159,142,301,11,12,23,1,3:14
633940,2021-05-26,2021,ANA,TEX,9,8,9-8,ANA,9,true,37,42,79,165,140,305,15,15,30,3,3:14
634051,2021-05-18,2021,PHI,MIA,8,3,8-3,PHI,9,true,41,34,75,134,159,293,18,6,24,4,3:34
634511,2021-04-18,2021,TEX,BAL,1,0,1-0,TEX,10,false,39,34,73,122,148,270,10,5,15,2,3:00
634536,2021-04-19,2021,ANA,TEX,4,6,6-4,TEX,9,false,36,38,74,147,154,301,11,10,21,5,3:15
634635,2021-04-06,2021,TEX,TOR,7,4,7-4,TEX,9,true,35,34,69,123,135,258,13,7,20,0,2:33
634260,2021-05-02,2021,PIT,SLN,0,3,3-0,SLN,9,false,33,37,70,140,112,252,9,12,21,0,2:41
633912,2021-05-27,2021,NYN,COL,4,2,4-2,NYN,7,true,28,30,58,124,113,237,12,10,22,3,2:48
634306,2021-05-02,2021,OAK,BAL,7,5,7-5,OAK,9,true,40,40,80,159,139,298,17,12,29,3,3:03
634627,2021-04-02,2021,BOS,BAL,0,3,3-0,BAL,9,false,31,36,67,164,136,300,4,11,15,2,3:10
634030,2021-05-19,2021,MIN,CHA,1,2,2-1,CHA,9,false,31,37,68,119,120,239,5,10,15,0,2:35
634431,2021-04-19,2021,WAS,SLN,5,12,12-5,SLN,9,false,39,43,82,157,147,304,11,18,29,1,3:11
634060,2021-05-23,2021,ATL,PIT,7,1,7-1,ATL,9,true,32,33,65,112,115,227,9,7,16,1,2:30
634005,2021-05-29,2021,PIT,COL,7,0,7-0,PIT,7,true,32,28,60,106,126,232,13,6,19,0,2:33
633930,2021-05-27,2021,LAN,SFN,4,3,4-3,LAN,9,true,31,32,63,119,102,221,7,5,12,4,2:26
634082,2021-05-17,2021,SEA,DET,1,4,4-1,DET,9,false,32,36,68,139,114,253,7,10,17,1,2:34
634631,2021-04-02,2021,ANA,CHA,8,12,12-8,CHA,9,false,40,45,85,173,161,334,14,18,32,8,3:44
634506,2021-04-18,2021,CHN,ATL,4,13,13-4,ATL,9,false,38,50,88,178,139,317,13,25,38,1,3:26
634493,2021-04-18,2021,WAS,ARI,2,5,5-2,ARI,9,false,36,43,79,167,155,322,10,19,29,1,3:20
634054,2021-05-21,2021,PHI,BOS,3,11,11-3,BOS,9,false,37,43,80,175,143,318,11,16,27,2,3:35
634022,2021-05-21,2021,SLN,CHN,3,12,12-3,CHN,9,false,37,46,83,166,119,285,11,22,33,3,3:17
634104,2021-05-15,2021,BAL,NYA,2,8,8-2,NYA,9,false,33,42,75,190,126,316,9,17,26,1,3:03
634067,2021-05-18,2021,TEX,NYA,4,7,7-4,NYA,9,false,36,42,78,173,134,307,10,16,26,5,3:31
634161,2021-05-15,2021,HOU,TEX,6,5,6-5,HOU,9,true,41,39,80,164,155,319,18,13,31,2,3:26
634261,2021-05-06,2021,MIN,TEX,3,4,4-3,TEX,10,false,42,39,81,145,163,308,12,11,23,2,3:25
634392,2021-04-20,2021,SDN,MIL,0,6,6-0,MIL,9,false,35,39,74,143,134,277,7,12,19,0,2:50
634441,2021-05-20,2021,ANA,MIN,3,6,6-3,MIN,7,false,26,35,61,150,120,270,5,14,19,1,2:49
632209,2021-04-11,2021,ARI,CIN,7,0,7-0,ARI,9,true,41,32,73,122,141,263,19,5,24,1,2:39
634433,2021-04-26,2021,BAL,NYA,4,2,4-2,BAL,9,true,35,35,70,127,123,250,12,11,23,1,2:41
634210,2021-05-12,2021,TBA,NYA,0,1,1-0,NYA,9,false,30,32,62,138,121,259,4,7,11,3,2:36
633990,2021-05-25,2021,TBA,KCA,1,2,2-1,KCA,9,false,34,35,69,117,122,239,9,8,17,1,2:29
634080,2021-05-15,2021,MIN,OAK,5,4,5-4,MIN,9,true,35,36,71,127,111,238,12,9,21,2,2:51
634099,2021-05-17,2021,TEX,NYA,5,2,5-2,TEX,9,true,34,33,67,118,131,249,11,8,19,2,2:38
634005,2021-05-29,2021,PIT,COL,7,0,7-0,PIT,7,true,32,28,60,106,126,232,13,6,19,0,2:33
634614,2021-04-14,2021,LAN,COL,4,2,4-2,LAN,9,true,39,38,77,130,177,307,15,11,26,3,3:36
634615,2021-04-01,2021,COL,LAN,8,5,8-5,COL,9,true,39,46,85,190,131,321,14,24,38,2,3:46
632196,2021-04-11,2021,SLN,MIL,3,9,9-3,MIL,9,false,38,44,82,168,157,325,13,18,31,2,3:04
634608,2021-04-06,2021,PHI,NYN,4,8,8-4,NYN,9,false,41,41,82,168,160,328,14,14,28,1,3:40
634642,2021-04-01,2021,NYA,TOR,2,3,3-2,TOR,10,false,41,38,79,159,181,340,12,10,22,2,3:44
634471,2021-04-17,2021,BOS,CHA,7,4,7-4,BOS,9,true,42,39,81,173,164,337,20,13,33,3,3:36
634625,2021-04-01,2021,SEA,SFN,8,7,8-7,SEA,10,false,43,43,86,174,171,345,15,15,30,3,3:45
634462,2021-04-17,2021,CHN,ATL,13,4,13-4,CHN,9,true,42,38,80,161,163,324,18,13,31,3,3:23
634491,2021-04-10,2021,BAL,BOS,4,6,6-4,BOS,10,false,44,42,86,157,169,326,13,14,27,3,3:34
634481,2021-04-15,2021,WAS,ARI,6,11,11-6,ARI,9,false,40,49,89,179,138,317,13,20,33,3,3:26
634416,2021-04-24,2021,CHN,MIL,3,4,4-3,MIL,9,false,38,41,79,176,156,332,12,13,25,2,3:32
634152,2021-05-10,2021,PIT,CIN,1,14,14-1,CIN,9,false,36,45,81,187,140,327,10,21,31,3,3:19
634309,2021-04-28,2021,SFN,COL,7,3,7-3,SFN,9,true,40,37,77,140,189,329,18,11,29,2,3:20
634048,2021-05-25,2021,MIN,BAL,7,4,7-4,MIN,9,true,38,42,80,160,166,326,14,14,28,2,3:23
633981,2021-05-24,2021,DET,CLE,5,6,6-5,CLE,9,false,41,38,79,140,178,318,16,14,30,1,3:31
634015,2021-05-21,2021,CLE,MIN,0,10,10-0,MIN,9,false,35,44,79,181,141,322,7,18,25,2,3:10
633854,2021-05-30,2021,DET,NYA,6,2,6-2,DET,9,true,41,39,80,156,169,325,16,14,30,2,3:06
634585,2021-04-07,2021,MIA,SLN,0,7,7-0,SLN,9,false,34,39,73,158,148,306,8,13,21,2,3:10
634272,2021-05-01,2021,SEA,ANA,5,10,10-5,ANA,9,false,39,42,81,147,166,313,11,17,28,3,3:16
632227,2021-04-10,2021,TOR,ANA,15,1,15-1,TOR,9,true,48,34,82,132,194,326,23,9,32,2,3:21 (2:38 delay)
634324,2021-05-04,2021,PHI,MIL,6,5,6-5,PHI,9,true,32,41,73,175,121,296,8,14,22,2,3:21
634488,2021-04-18,2021,SDN,LAN,5,2,5-2,SDN,9,true,34,32,66,148,143,291,10,5,15,2,3:12
634644,2021-04-03,2021,NYA,TOR,5,3,5-3,NYA,9,true,41,37,78,150,170,320,17,12,29,5,3:38
634442,2021-04-18,2021,KCA,TOR,2,0,2-0,KCA,9,true,39,33,72,128,150,278,16,5,21,1,2:54
634115,2021-05-18,2021,SEA,DET,0,5,5-0,DET,9,false,29,39,68,142,117,259,2,12,14,1,2:44
634289,2021-04-29,2021,TEX,BOS,4,1,4-1,TEX,9,true,32,34,66,141,124,265,8,6,14,1,2:49
634353,2021-04-29,2021,HOU,SEA,0,1,1-0,SEA,9,false,30,32,62,126,121,247,4,5,9,0,2:43
634638,2021-04-01,2021,MIL,MIN,6,5,6-5,MIL,10,false,44,47,91,189,151,340,15,17,32,1,4:14
634507,2021-04-17,2021,WAS,ARI,6,2,6-2,WAS,9,true,39,37,76,174,163,337,15,8,23,1,3:23
634476,2021-04-21,2021,SDN,MIL,2,4,4-2,MIL,9,false,40,40,80,166,179,345,13,13,26,3,3:40
634141,2021-05-13,2021,HOU,TEX,4,3,4-3,HOU,11,false,48,42,90,166,161,327,22,10,32,0,3:44
634579,2021-04-15,2021,ATL,MIA,7,6,7-6,ATL,9,false,41,41,82,166,170,336,16,14,30,0,3:24
633959,2021-05-29,2021,NYN,ATL,13,2,13-2,NYN,9,true,42,34,76,161,170,331,17,10,27,3,3:27
634041,2021-05-20,2021,ATL,PIT,4,6,6-4,PIT,10,false,40,42,82,178,160,338,11,13,24,3,3:43
634027,2021-05-21,2021,CIN,MIL,9,4,9-4,CIN,9,true,40,38,78,168,170,338,17,11,28,2,3:29
634502,2021-04-13,2021,SLN,WAS,14,3,14-3,SLN,9,true,46,36,82,153,158,311,24,9,33,1,3:24
634636,2021-04-01,2021,CIN,SLN,6,11,11-6,SLN,9,false,42,41,83,146,176,322,16,14,30,2,3:31
634597,2021-04-04,2021,MIL,MIN,2,8,8-2,MIN,9,false,36,41,77,178,141,319,8,16,24,0,3:29
634581,2021-04-14,2021,ATL,MIA,5,6,6-5,MIA,10,false,39,42,81,172,134,306,13,15,28,1,3:26
634512,2021-04-09,2021,TOR,ANA,1,7,7-1,ANA,9,false,37,42,79,164,158,322,10,15,25,2,3:06
632195,2021-04-10,2021,PIT,CHN,8,2,8-2,PIT,9,true,40,37,77,142,152,294,17,11,28,1,3:07
634171,2021-05-08,2021,TEX,SEA,9,8,9-8,TEX,9,true,39,41,80,153,140,293,17,15,32,6,3:25
634389,2021-04-23,2021,BAL,OAK,1,3,3-1,OAK,9,false,38,36,74,153,133,286,11,9,20,2,2:53
632218,2021-04-10,2021,CLE,DET,11,3,11-3,CLE,9,true,39,32,71,128,157,285,15,5,20,1,2:53
632194,2021-04-13,2021,MIL,CHN,2,3,3-2,CHN,9,false,35,34,69,143,127,270,9,8,17,1,3:07
632207,2021-04-11,2021,ATL,PHI,6,7,7-6,PHI,9,false,38,35,73,150,133,283,11,8,19,0,3:03
632216,2021-04-12,2021,CHA,CLE,4,3,4-3,CHA,9,false,34,35,69,128,149,277,10,9,19,3,3:05
634483,2021-04-16,2021,MIL,PIT,1,6,6-1,PIT,9,false,37,38,75,153,140,293,12,11,23,2,3:09
634351,2021-04-27,2021,ATL,CHN,5,0,5-0,ATL,9,true,39,30,69,126,150,276,14,3,17,1,2:46
634328,2021-04-30,2021,ARI,COL,7,2,7-2,ARI,9,true,38,36,74,133,119,252,15,10,25,1,2:58
634155,2021-05-12,2021,COL,SDN,3,2,3-2,COL,8,false,34,33,67,128,131,259,13,9,22,1,2:55
634103,2021-05-13,2021,WAS,PHI,5,1,5-1,WAS,9,true,32,34,66,142,118,260,10,7,17,1,2:38
634198,2021-05-12,2021,MIL,SLN,4,1,4-1,MIL,9,true,34,33,67,131,140,271,11,6,17,3,3:07
633998,2021-05-23,2021,MIA,NYN,5,1,5-1,MIA,9,true,35,32,67,122,129,251,11,6,17,0,2:37
634350,2021-04-28,2021,TEX,ANA,3,4,4-3,ANA,9,false,35,35,70,124,135,259,10,9,19,2,2:48
634610,2021-04-04,2021,BOS,BAL,3,11,11-3,BAL,9,false,35,52,87,217,133,350,8,25,33,2,3:28
634241,2021-05-04,2021,BOS,DET,11,7,11-7,BOS,9,true,41,42,83,187,150,337,17,16,33,5,3:38
634097,2021-05-15,2021,ARI,WAS,11,4,11-4,ARI,9,true,40,42,82,176,149,325,17,15,32,4,3:27
634026,2021-05-19,2021,SLN,PIT,8,5,8-5,SLN,9,true,43,41,84,167,164,331,19,15,34,4,3:46
634366,2021-04-24,2021,HOU,ANA,16,2,16-2,HOU,9,true,48,31,79,95,204,299,25,6,31,5,3:20
632206,2021-04-13,2021,ARI,OAK,5,7,7-5,OAK,9,false,38,41,79,168,159,327,12,13,25,3,3:39
634028,2021-05-21,2021,ANA,OAK,4,8,8-4,OAK,9,false,36,43,79,150,151,301,10,19,29,4,3:15
634360,2021-04-28,2021,HOU,SEA,7,5,7-5,HOU,9,true,38,36,74,154,155,309,13,10,23,3,3:29
634221,2021-05-08,2021,NYA,WAS,4,3,4-3,NYA,11,false,40,43,83,168,174,342,10,13,23,3,3:50 (2:25 delay)
634326,2021-05-01,2021,CHA,CLE,7,3,7-3,CHA,9,true,36,33,69,126,161,287,13,7,20,1,3:02
634372,2021-04-25,2021,CLE,NYA,7,3,7-3,CLE,9,true,34,39,73,167,146,313,10,12,22,1,3:07
634336,2021-04-30,2021,PHI,NYN,2,1,2-1,PHI,9,true,32,38,70,149,119,268,7,13,20,1,3:20
632231,2021-04-12,2021,ARI,OAK,5,9,9-5,OAK,9,false,39,43,82,177,143,320,12,19,31,3,3:29
634140,2021-05-12,2021,LAN,SEA,7,1,7-1,LAN,9,true,40,30,70,113,166,279,15,3,18,2,2:57
634362,2021-04-28,2021,BAL,NYA,0,7,7-0,NYA,9,false,31,39,70,149,120,269,5,13,18,1,2:33
634503,2021-04-24,2021,SFN,MIA,2,5,5-2,MIA,9,false,32,36,68,129,139,268,6,8,14,1,2:46
634024,2021-05-28,2021,CHN,CIN,1,0,1-0,CHN,9,true,29,37,66,146,122,268,6,11,17,3,2:57
634291,2021-05-06,2021,MIA,ARI,3,1,3-1,MIA,9,true,29,38,67,145,114,259,6,10,16,0,2:44
633999,2021-05-22,2021,MIA,NYN,3,1,3-1,MIA,9,false,33,36,69,135,122,257,9,9,18,2,3:02
634333,2021-04-27,2021,HOU,SEA,2,0,2-0,HOU,9,true,32,30,62,132,125,257,9,5,14,0,2:40
634605,2021-04-02,2021,OAK,HOU,5,9,9-5,HOU,9,false,39,45,84,182,164,346,13,20,33,3,3:34
634267,2021-05-04,2021,ANA,TBA,3,8,8-3,TBA,9,false,35,44,79,201,144,345,9,17,26,1,3:29
634257,2021-05-02,2021,PHI,NYN,7,8,8-7,NYN,9,false,39,47,86,169,161,330,12,19,31,3,3:54
634438,2021-04-22,2021,HOU,ANA,8,2,8-2,HOU,9,true,42,39,81,176,163,339,17,12,29,5,3:43
634214,2021-05-08,2021,DET,MIN,7,3,7-3,DET,9,true,43,46,89,182,167,349,22,19,41,2,3:38
632219,2021-04-12,2021,ATL,MIA,3,5,5-3,MIA,10,false,41,43,84,184,148,332,12,14,26,3,3:45
634036,2021-05-21,2021,ATL,PIT,20,1,20-1,ATL,9,true,49,38,87,136,184,320,25,12,37,0,3:09
634191,2021-05-13,2021,COL,CIN,13,8,13-8,COL,9,true,46,40,86,146,169,315,22,14,36,4,3:36
634550,2021-04-08,2021,MIN,SEA,10,2,10-2,MIN,9,true,44,36,80,155,173,328,20,11,31,3,3:27 (:16 delay)
634418,2021-04-24,2021,COL,PHI,5,7,7-5,PHI,9,false,36,41,77,157,130,287,10,16,26,1,3:11
634282,2021-05-02,2021,MIL,LAN,4,16,16-4,LAN,9,false,36,52,88,180,135,315,11,25,36,1,3:11
634419,2021-04-22,2021,CHN,NYN,4,3,4-3,CHN,10,false,36,39,75,146,149,295,11,10,21,3,3:41
634303,2021-04-30,2021,SDN,SFN,3,2,3-2,SDN,9,true,35,37,72,149,126,275,12,11,23,1,3:15
634016,2021-05-21,2021,COL,ARI,7,1,7-1,COL,9,true,36,37,73,141,129,270,12,11,23,0,2:45
634242,2021-05-03,2021,SEA,BAL,3,5,5-3,BAL,9,false,33,38,71,146,128,274,6,11,17,3,2:55
634130,2021-05-16,2021,ARI,WAS,0,3,3-0,WAS,9,false,32,35,67,149,125,274,6,10,16,0,2:49
634183,2021-05-12,2021,ARI,MIA,2,3,3-2,MIA,9,false,33,39,72,127,125,252,7,14,21,1,2:41
634307,2021-05-01,2021,TBA,HOU,1,3,3-1,HOU,9,false,34,35,69,143,129,272,7,10,17,0,2:40
634056,2021-05-24,2021,NYN,COL,2,3,3-2,COL,9,false,30,35,65,133,115,248,4,11,15,1,2:43
634600,2021-04-05,2021,OAK,LAN,3,10,10-3,LAN,9,false,38,51,89,223,144,367,10,23,33,2,3:35
634521,2021-04-14,2021,HOU,DET,4,6,6-4,DET,9,false,41,41,82,182,173,355,14,15,29,4,4:00
634286,2021-05-01,2021,ARI,COL,6,14,14-6,COL,9,false,38,50,88,213,123,336,11,23,34,2,3:41
634284,2021-05-01,2021,PIT,SLN,5,12,12-5,SLN,9,false,38,47,85,176,159,335,11,19,30,3,3:43
632232,2021-04-11,2021,TBA,NYA,4,8,8-4,NYA,10,false,39,45,84,172,151,323,10,18,28,4,3:42
634361,2021-04-24,2021,LAN,SDN,5,4,5-4,LAN,9,true,39,38,77,177,134,311,16,11,27,5,3:53
634621,2021-04-15,2021,PIT,SDN,3,8,8-3,SDN,9,false,37,42,79,173,151,324,10,15,25,1,3:15
634427,2021-04-20,2021,MIA,BAL,5,7,7-5,BAL,9,false,42,41,83,148,161,309,14,15,29,5,3:26
634459,2021-04-21,2021,BOS,TOR,3,6,6-3,TOR,9,false,39,44,83,173,154,327,13,19,32,3,3:45 (:31 delay)
634112,2021-05-20,2021,CHN,WAS,5,2,5-2,CHN,9,true,38,34,72,128,142,270,13,9,22,3,3:07
634002,2021-05-23,2021,KCA,DET,3,2,3-2,KCA,9,false,29,38,67,147,113,260,7,12,19,1,2:50
633898,2021-05-31,2021,NYA,TBA,1,3,3-1,TBA,9,false,34,36,70,135,119,254,8,9,17,2,2:43
634006,2021-05-28,2021,OAK,ANA,3,1,3-1,OAK,9,true,33,34,67,116,128,244,11,9,20,2,2:51
634450,2021-04-17,2021,MIA,SFN,7,6,7-6,MIA,10,false,53,40,93,145,200,345,24,11,35,4,3:56
632211,2021-04-13,2021,ATL,MIA,8,14,14-8,MIA,9,false,44,49,93,180,169,349,16,22,38,3,3:51
634634,2021-04-01,2021,CHN,PIT,3,5,5-3,PIT,9,false,34,47,81,214,151,365,6,21,27,4,4:00
634120,2021-05-20,2021,BAL,TBA,1,10,10-1,TBA,9,false,35,53,88,211,142,353,9,25,34,0,3:14
634007,2021-05-23,2021,CLE,MIN,5,8,8-5,MIN,10,false,46,43,89,172,174,346,16,13,29,2,3:44
634196,2021-05-08,2021,BAL,BOS,6,11,11-6,BOS,9,false,39,47,86,184,149,333,14,19,33,2,3:25
634367,2021-04-24,2021,BAL,OAK,2,7,7-2,OAK,9,false,37,42,79,169,143,312,11,15,26,3,3:19
632230,2021-04-12,2021,SLN,WAS,2,5,5-2,WAS,9,false,36,41,77,147,146,293,9,16,25,4,3:20
633994,2021-05-24,2021,CHA,SLN,5,1,5-1,CHA,9,true,36,35,71,132,152,284,12,8,20,2,3:14
633955,2021-05-24,2021,OAK,SEA,2,4,4-2,SEA,9,false,34,37,71,136,141,277,9,10,19,2,3:04
632190,2021-04-13,2021,MIN,BOS,2,4,4-2,BOS,9,false,39,34,73,146,152,298,12,9,21,1,3:17
633960,2021-05-29,2021,CHA,BAL,7,4,7-4,CHA,7,true,33,29,62,115,159,274,14,9,23,2,2:44
634172,2021-05-12,2021,HOU,ANA,9,1,9-1,HOU,9,true,37,34,71,125,148,273,13,7,20,3,2:52
634150,2021-05-13,2021,BOS,OAK,8,1,8-1,BOS,9,true,38,37,75,143,132,275,16,13,29,1,2:54
634044,2021-05-19,2021,PHI,MIA,1,3,3-1,MIA,9,false,33,38,71,138,120,258,9,12,21,2,3:02
634083,2021-05-16,2021,DET,CHN,1,5,5-1,CHN,9,false,33,42,75,141,118,259,8,13,21,1,2:52
633928,2021-05-26,2021,MIN,BAL,3,2,3-2,MIN,9,true,31,34,65,152,116,268,8,8,16,0,2:39
634539,2021-04-07,2021,NYA,BAL,3,4,4-3,BAL,11,false,46,40,86,172,189,361,15,6,21,5,3:54
634137,2021-05-12,2021,PIT,CIN,1,5,5-1,CIN,10,false,39,44,83,170,172,342,9,14,23,5,3:55
634552,2021-04-05,2021,ANA,HOU,7,6,7-6,ANA,9,true,41,44,85,190,165,355,17,16,33,5,4:01
634143,2021-05-15,2021,SDN,SLN,13,3,13-3,SDN,9,true,46,37,83,168,192,360,24,11,35,2,3:31
632170,2021-04-11,2021,CHA,KCA,3,4,4-3,KCA,10,false,44,40,84,172,184,356,14,13,27,3,3:54
634508,2021-04-22,2021,BOS,SEA,3,7,7-3,SEA,10,false,41,39,80,156,176,332,11,11,22,0,3:28
632191,2021-04-10,2021,LAN,WAS,9,5,9-5,LAN,9,true,39,41,80,159,133,292,18,17,35,3,3:11
634314,2021-04-28,2021,SLN,PHI,3,5,5-3,PHI,9,false,36,39,75,151,130,281,12,12,24,4,3:19
634371,2021-04-28,2021,CLE,MIN,2,10,10-2,MIN,9,false,33,42,75,171,126,297,6,15,21,2,3:00
634084,2021-05-15,2021,SEA,CLE,7,3,7-3,SEA,9,true,37,36,73,139,155,294,13,9,22,1,3:09
634373,2021-04-24,2021,BOS,SEA,2,8,8-2,SEA,9,false,33,45,78,169,121,290,8,18,26,2,3:05
634456,2021-04-25,2021,SLN,CIN,5,2,5-2,SLN,9,true,33,34,67,147,134,281,10,9,19,0,2:49
634113,2021-05-13,2021,PIT,SFN,1,3,3-1,SFN,9,false,33,38,71,159,128,287,6,12,18,0,2:52
633962,2021-05-25,2021,MIL,SDN,1,7,7-1,SDN,9,false,32,37,69,148,136,284,4,10,14,1,3:06
633894,2021-05-29,2021,TBA,PHI,5,3,5-3,TBA,9,true,35,36,71,142,128,270,12,10,22,4,3:06
633970,2021-05-25,2021,DET,CLE,1,4,4-1,CLE,9,false,36,36,72,146,124,270,9,9,18,2,2:47
633949,2021-05-29,2021,DET,NYA,6,1,6-1,DET,9,true,33,34,67,157,131,288,9,8,17,2,2:54
634049,2021-05-22,2021,ATL,PIT,6,1,6-1,ATL,9,true,37,36,73,135,142,277,14,11,25,1,2:51
634408,2021-04-20,2021,CIN,ARI,4,5,5-4,ARI,9,false,39,46,85,190,173,363,12,20,32,4,3:54 (1:06 delay)
634455,2021-04-18,2021,MIL,PIT,5,6,6-5,PIT,10,false,40,44,84,179,171,350,10,14,24,2,3:47
634588,2021-04-05,2021,DET,MIN,6,15,15-6,MIN,9,false,37,51,88,215,144,359,9,25,34,1,3:32 (:52 delay)
633989,2021-05-23,2021,CIN,MIL,4,9,9-4,MIL,9,false,40,41,81,169,183,352,12,14,26,3,3:30
634317,2021-04-28,2021,MIL,MIA,2,6,6-2,MIA,9,false,33,43,76,165,124,289,7,17,24,1,3:04
634379,2021-04-27,2021,LAN,CIN,5,6,6-5,CIN,9,false,40,38,78,144,155,299,13,12,25,3,3:14
634285,2021-05-03,2021,MIN,TEX,6,5,6-5,MIN,9,true,34,41,75,173,126,299,10,14,24,3,3:05
634108,2021-05-14,2021,PIT,SFN,3,2,3-2,PIT,11,false,41,38,79,145,136,281,11,6,17,1,3:20
634329,2021-05-01,2021,MIN,KCA,3,11,11-3,KCA,9,false,37,41,78,141,143,284,9,15,24,1,2:59
634225,2021-05-05,2021,COL,SFN,6,5,6-5,COL,9,true,35,36,71,152,137,289,12,10,22,2,3:08 (1:26 delay)
634254,2021-05-04,2021,COL,SFN,8,6,8-6,COL,7,false,33,36,69,146,121,267,13,17,30,4,3:04
634249,2021-05-05,2021,MIA,ARI,8,0,8-0,MIA,9,true,36,35,71,150,140,290,12,8,20,0,2:57
634074,2021-05-26,2021,OAK,SEA,6,3,6-3,OAK,9,true,36,37,73,151,133,284,15,10,25,2,3:01
634131,2021-05-14,2021,MIN,OAK,1,6,6-1,OAK,9,false,35,38,73,156,134,290,9,11,20,0,3:00
633926,2021-05-31,2021,ARI,NYN,2,6,6-2,NYN,9,false,35,41,76,119,135,254,8,16,24,3,2:58
634211,2021-05-09,2021,OAK,TBA,3,4,4-3,TBA,9,false,36,33,69,120,157,277,11,5,16,2,2:40
633992,2021-05-24,2021,MIL,SDN,5,3,5-3,MIL,9,true,34,35,69,141,147,288,11,8,19,2,3:12
634293,2021-05-03,2021,OAK,TOR,5,4,5-4,OAK,9,true,36,37,73,132,150,282,14,10,24,1,2:45
633968,2021-05-30,2021,SEA,TEX,4,2,4-2,SEA,9,true,35,32,67,128,148,276,11,5,16,1,3:00
632192,2021-04-11,2021,NYN,MIA,6,5,6-5,NYN,9,false,42,43,85,199,161,360,16,16,32,4,4:05 (2:10 delay)
634407,2021-04-20,2021,KCA,TBA,7,14,14-7,TBA,9,false,40,49,89,187,160,347,13,23,36,4,3:35
634590,2021-04-06,2021,BOS,TBA,6,5,6-5,BOS,12,false,48,48,96,187,170,357,15,15,30,3,4:25
634540,2021-04-09,2021,ARI,CIN,5,6,6-5,CIN,10,false,45,45,90,156,198,354,16,16,32,2,3:47
634397,2021-04-20,2021,CLE,CHA,5,8,8-5,CHA,9,false,45,39,84,158,184,342,16,12,28,3,3:39
632200,2021-04-11,2021,BAL,BOS,9,14,14-9,BOS,9,false,43,50,93,179,181,360,18,23,41,4,3:46
634510,2021-04-13,2021,SFN,CIN,7,6,7-6,SFN,9,true,38,36,74,139,174,313,15,10,25,2,3:11
634567,2021-04-07,2021,OAK,LAN,4,3,4-3,OAK,10,false,40,46,86,169,170,339,12,17,29,4,3:46
634436,2021-04-22,2021,CLE,NYA,3,6,6-3,NYA,9,false,38,46,84,175,134,309,10,20,30,2,3:31
634454,2021-04-25,2021,BAL,OAK,8,1,8-1,BAL,9,true,40,32,72,143,157,300,16,6,22,3,2:56
634182,2021-05-09,2021,TEX,SEA,10,2,10-2,TEX,9,true,39,41,80,150,136,286,16,15,31,1,3:03
634217,2021-05-05,2021,NYA,HOU,6,3,6-3,NYA,9,true,39,33,72,126,168,294,16,9,25,3,3:35
634342,2021-04-25,2021,SFN,MIA,4,3,4-3,SFN,9,true,35,37,72,142,149,291,11,13,24,0,3:10
634244,2021-05-03,2021,PHI,MIL,4,3,4-3,PHI,9,true,32,38,70,172,139,311,8,12,20,1,3:18
633975,2021-05-23,2021,TOR,TBA,4,6,6-4,TBA,9,false,38,42,80,170,117,287,11,17,28,2,3:03
633941,2021-05-25,2021,PIT,CHN,3,4,4-3,CHN,9,false,37,38,75,145,138,283,11,13,24,2,2:59
634063,2021-05-17,2021,ATL,NYN,1,3,3-1,NYN,9,false,31,42,73,160,118,278,4,16,20,2,3:14
634637,2021-04-04,2021,ANA,CHA,7,4,7-4,ANA,9,false,41,41,82,163,165,328,16,12,28,4,3:56
633923,2021-05-30,2021,LAN,SFN,4,5,5-4,SFN,9,false,35,40,75,157,118,275,6,14,20,1,3:07
634139,2021-05-15,2021,TOR,PHI,4,0,4-0,TOR,9,true,35,38,73,167,120,287,11,11,22,2,3:13
633917,2021-05-31,2021,ATL,WAS,5,3,5-3,ATL,9,true,35,37,72,135,151,286,11,10,21,0,3:05
634068,2021-05-16,2021,HOU,TEX,6,2,6-2,HOU,9,true,36,35,71,143,135,278,12,10,22,1,3:03
633872,2021-05-30,2021,CHA,BAL,3,1,3-1,CHA,9,true,36,33,69,130,153,283,12,6,18,2,2:41
634092,2021-05-18,2021,LAN,ARI,9,1,9-1,LAN,9,true,41,31,72,109,159,268,17,4,21,2,2:50
634281,2021-05-05,2021,ANA,TBA,1,3,3-1,TBA,9,false,37,39,76,136,135,271,14,13,27,4,3:16
634109,2021-05-18,2021,SLN,PIT,5,2,5-2,SLN,9,true,38,35,73,139,120,259,14,8,22,2,2:53
634232,2021-05-06,2021,WAS,ATL,2,3,3-2,ATL,9,false,39,31,70,130,145,275,14,6,20,3,2:53
633915,2021-05-27,2021,TBA,KCA,7,2,7-2,TBA,9,true,38,34,72,115,163,278,15,9,24,1,2:38
634556,2021-09-04,2021,WAS,NYN,9,11,11-9,NYN,9,false,45,43,88,180,174,354,19,15,34,1,4:05
633884,2021-05-31,2021,CLE,CHA,6,8,8-6,CHA,8,false,34,35,69,157,104,261,13,11,24,1,2:45
634408,2021-04-20,2021,CIN,ARI,4,5,5-4,ARI,9,false,39,46,85,190,173,363,12,20,32,4,3:54 (1:06 delay)
634122,2021-05-16,2021,LAN,MIA,2,3,3-2,MIA,9,false,37,37,74,165,146,311,11,9,20,2,3:23
634124,2021-05-16,2021,CHA,KCA,4,3,4-3,CHA,9,false,41,36,77,135,165,300,17,10,27,3,3:21
634125,2021-05-13,2021,CHA,MIN,4,2,4-2,CHA,9,true,35,41,76,175,144,319,11,11,22,2,3:31
634320,2021-04-27,2021,MIL,MIA,5,4,5-4,MIL,9,true,36,36,72,153,130,283,13,10,23,3,3:15
634270,2021-05-05,2021,CIN,CHA,1,0,1-0,CIN,10,false,38,35,73,133,156,289,14,7,21,1,3:10
633956,2021-05-25,2021,NYA,TOR,2,6,6-2,TOR,9,false,36,44,80,152,146,298,10,17,27,1,3:02
634294,2021-05-05,2021,PHI,MIL,5,4,5-4,PHI,9,true,30,40,70,175,135,310,7,16,23,2,3:07
633943,2021-05-27,2021,DET,CLE,2,5,5-2,CLE,9,false,36,42,78,166,146,312,9,15,24,1,3:06
634231,2021-05-06,2021,OAK,TOR,4,10,10-4,TOR,9,false,35,46,81,150,144,294,11,19,30,2,3:10
633932,2021-05-28,2021,MIN,KCA,3,8,8-3,KCA,9,false,38,41,79,140,163,303,12,15,27,2,3:12
634133,2021-05-18,2021,TOR,BOS,8,0,8-0,TOR,9,true,43,35,78,142,151,293,20,7,27,1,3:16
634184,2021-05-09,2021,NYN,ARI,4,2,4-2,NYN,9,true,37,35,72,163,137,300,13,10,23,2,3:27
634034,2021-05-19,2021,OAK,HOU,1,8,8-1,HOU,9,false,31,46,77,198,111,309,4,20,24,1,3:18
633972,2021-05-25,2021,ANA,TEX,11,5,11-5,ANA,9,true,39,38,77,148,142,290,16,10,26,2,2:59
633958,2021-05-25,2021,BOS,ATL,1,3,3-1,ATL,9,false,33,40,73,159,135,294,8,14,22,1,3:06
633971,2021-05-26,2021,CHA,SLN,0,4,4-0,SLN,9,false,40,36,76,148,147,295,12,9,21,2,3:19
634050,2021-05-18,2021,OAK,HOU,6,5,6-5,OAK,9,false,39,38,77,139,149,288,15,13,28,2,3:09
634011,2021-05-22,2021,SFN,LAN,3,6,6-3,LAN,9,false,34,37,71,140,138,278,9,10,19,0,2:54
634017,2021-05-22,2021,CIN,MIL,3,4,4-3,MIL,9,false,33,37,70,148,141,289,7,11,18,1,3:07
634302,2021-05-02,2021,CHA,CLE,0,5,5-0,CLE,9,false,36,40,76,149,153,302,9,13,22,2,3:19
633897,2021-05-31,2021,SFN,ANA,6,1,6-1,SFN,9,true,37,34,71,126,147,273,14,9,23,2,2:58
634013,2021-05-21,2021,SFN,LAN,1,2,2-1,LAN,9,false,34,37,71,132,151,283,6,13,19,1,2:55
634630,2021-04-01,2021,KCA,TEX,14,10,14-10,KCA,9,true,51,50,101,202,200,402,25,25,50,6,4:26
634535,2021-04-13,2021,PIT,SDN,8,4,8-4,PIT,9,true,44,46,90,190,169,359,20,22,42,5,4:07
634603,2021-04-06,2021,DET,MIN,4,3,4-3,DET,10,false,43,42,85,186,197,383,17,11,28,0,4:00
633963,2021-05-24,2021,TOR,TBA,8,14,14-8,TBA,11,false,44,51,95,182,169,351,11,19,30,2,3:52
634522,2021-04-15,2021,TBA,TEX,4,6,6-4,TEX,10,false,45,44,89,164,196,360,15,15,30,4,3:44
634075,2021-05-18,2021,BAL,TBA,6,13,13-6,TBA,9,false,43,47,90,190,188,378,16,20,36,4,3:42
634165,2021-05-08,2021,SLN,COL,9,8,9-8,SLN,9,true,41,44,85,170,157,327,20,17,37,2,3:39
634117,2021-05-13,2021,DET,KCA,4,3,4-3,DET,9,true,36,41,77,153,152,305,14,14,28,4,3:11
634322,2021-04-28,2021,ARI,SDN,3,12,12-3,SDN,9,false,35,45,80,140,149,289,10,18,28,4,3:05
634094,2021-05-16,2021,PIT,SFN,1,4,4-1,SFN,9,false,37,41,78,154,139,293,11,14,25,1,3:13
634334,2021-05-03,2021,ANA,TBA,3,7,7-3,TBA,9,false,34,42,76,172,139,311,11,15,26,4,3:31
634292,2021-05-03,2021,SLN,NYN,6,5,6-5,SLN,9,true,33,41,74,155,144,299,11,16,27,3,3:20
634004,2021-05-23,2021,PHI,BOS,6,2,6-2,PHI,9,true,38,34,72,129,163,292,16,7,23,2,3:19
634256,2021-05-02,2021,TOR,ATL,7,2,7-2,TOR,9,true,38,37,75,141,157,298,14,11,25,3,3:09
634377,2021-04-26,2021,TEX,ANA,4,9,9-4,ANA,9,false,36,46,82,166,129,295,9,19,28,2,3:06
634021,2021-05-26,2021,HOU,LAN,5,2,5-2,HOU,9,true,36,34,70,149,135,284,13,7,20,0,3:05
634541,2021-04-14,2021,SLN,WAS,0,6,6-0,WAS,9,false,34,42,76,157,137,294,8,17,25,1,3:11
634105,2021-05-15,2021,TBA,NYN,12,5,12-5,TBA,9,true,45,37,82,127,148,275,21,10,31,3,3:01
634338,2021-05-01,2021,MIL,LAN,6,5,6-5,MIL,11,false,49,47,96,179,194,373,18,18,36,3,4:48
632222,2021-04-10,2021,SLN,MIL,5,9,9-5,MIL,9,false,42,45,87,191,174,365,17,19,36,3,3:43
634453,2021-04-21,2021,CHN,NYN,16,4,16-4,CHN,9,true,46,39,85,147,175,322,22,13,35,4,3:27
634444,2021-04-21,2021,CIN,ARI,5,8,8-5,ARI,10,false,40,46,86,184,153,337,14,17,31,4,3:40
634440,2021-04-21,2021,OAK,MIN,13,12,13-12,OAK,10,false,47,51,98,186,175,361,18,20,38,4,4:16
634323,2021-05-02,2021,TBA,HOU,5,4,5-4,TBA,9,true,36,37,73,139,156,295,12,11,23,4,3:21
634287,2021-04-30,2021,SEA,ANA,7,4,7-4,SEA,9,true,41,34,75,142,180,322,16,7,23,2,3:20
634046,2021-05-19,2021,SEA,DET,2,6,6-2,DET,9,false,35,40,75,158,145,303,8,15,23,1,3:11
634079,2021-05-22,2021,TEX,HOU,8,4,8-4,TEX,9,true,42,39,81,132,170,302,16,12,28,3,3:24
633980,2021-05-23,2021,SFN,LAN,5,11,11-5,LAN,9,false,39,41,80,138,160,298,12,16,28,2,3:06
634086,2021-05-16,2021,BAL,NYA,10,6,10-6,BAL,9,true,41,38,79,147,169,316,17,13,30,2,3:13
634070,2021-05-17,2021,CIN,SFN,3,6,6-3,SFN,9,false,39,38,77,149,148,297,13,13,26,1,3:02
634052,2021-05-18,2021,CHN,WAS,6,3,6-3,CHN,9,true,37,41,78,148,151,299,16,13,29,3,3:22
633888,2021-05-27,2021,PIT,CHN,3,5,5-3,CHN,9,false,36,38,74,159,118,277,10,11,21,1,3:01
633957,2021-05-27,2021,MIA,PHI,2,3,3-2,PHI,9,false,35,35,70,138,144,282,11,10,21,1,3:11
633919,2021-05-31,2021,BAL,MIN,2,3,3-2,MIN,10,false,36,39,75,151,123,274,7,10,17,1,2:53
634548,2021-04-16,2021,CHN,ATL,2,5,5-2,ATL,9,false,41,43,84,186,181,367,16,18,34,2,4:02
634545,2021-04-08,2021,TOR,ANA,5,7,7-5,ANA,11,false,42,47,89,166,187,353,10,14,24,3,3:57
634388,2021-04-25,2021,COL,PHI,12,2,12-2,COL,9,true,44,36,80,135,183,318,21,9,30,1,3:16
634127,2021-05-15,2021,CHA,KCA,1,5,5-1,KCA,9,false,34,40,74,167,153,320,7,14,21,1,3:21
633953,2021-05-25,2021,HOU,LAN,2,9,9-2,LAN,9,false,33,44,77,191,115,306,6,17,23,4,3:27
634100,2021-05-16,2021,BOS,ANA,5,6,6-5,ANA,9,false,37,40,77,149,158,307,11,13,24,4,3:19
633977,2021-05-23,2021,WAS,BAL,6,5,6-5,WAS,9,true,38,40,78,134,154,288,14,17,31,3,3:14
633851,2021-05-31,2021,LAN,SLN,9,4,9-4,LAN,9,true,38,33,71,119,165,284,16,6,22,3,3:17
633881,2021-05-30,2021,MIN,KCA,3,6,6-3,KCA,9,false,40,38,78,127,172,299,13,12,25,2,3:19
633875,2021-05-29,2021,CHN,CIN,10,2,10-2,CHN,9,true,43,36,79,126,147,273,20,9,29,4,3:13
633948,2021-05-31,2021,MIL,DET,3,2,3-2,MIL,10,false,35,38,73,149,138,287,9,10,19,1,3:09
633890,2021-05-26,2021,WAS,CIN,5,3,5-3,WAS,9,true,39,39,78,163,144,307,15,13,28,3,3:26 (3:04 delay)
634065,2021-05-18,2021,SDN,COL,2,1,2-1,SDN,10,false,36,40,76,160,155,315,7,12,19,0,3:40
633983,2021-05-31,2021,CIN,PHI,11,1,11-1,CIN,9,true,40,38,78,150,148,298,15,12,27,1,2:53
634167,2021-05-09,2021,KCA,CHA,3,9,9-3,CHA,9,false,36,42,78,172,157,329,10,14,24,3,3:29
633900,2021-05-31,2021,KCA,PIT,7,3,7-3,KCA,9,true,37,35,72,156,153,309,15,8,23,0,3:09
633939,2021-05-26,2021,ARI,SFN,4,5,5-4,SFN,9,false,39,36,75,134,153,287,13,10,23,1,3:03
633950,2021-05-29,2021,WAS,MIL,2,6,6-2,MIL,7,false,34,35,69,140,143,283,13,16,29,3,3:00
634247,2021-05-06,2021,ANA,TBA,3,8,8-3,TBA,9,false,33,42,75,182,120,302,8,15,23,3,3:03
633896,2021-05-31,2021,HOU,BOS,11,2,11-2,HOU,9,true,41,33,74,128,172,300,20,6,26,2,3:15
634514,2021-04-22,2021,CIN,ARI,11,14,14-11,ARI,10,false,48,52,100,215,179,394,17,22,39,7,4:26
634087,2021-05-16,2021,SEA,CLE,3,2,3-2,SEA,9,true,37,38,75,169,167,336,14,12,26,2,3:36
634045,2021-05-20,2021,OAK,HOU,4,8,8-4,HOU,9,false,39,42,81,143,171,314,13,16,29,1,3:26
634039,2021-05-20,2021,PHI,MIA,0,6,6-0,MIA,9,false,33,39,72,159,151,310,7,14,21,1,3:08
633973,2021-05-23,2021,SLN,CHN,1,2,2-1,CHN,10,false,42,36,78,144,172,316,12,6,18,2,3:38
634106,2021-05-15,2021,MIL,ATL,1,5,5-1,ATL,9,false,34,42,76,158,149,307,8,16,24,2,2:54
634330,2021-04-29,2021,CHA,DET,3,1,3-1,CHA,7,true,24,24,48,108,87,195,7,3,10,0,1:50
633945,2021-05-25,2021,OAK,SEA,3,4,4-3,SEA,9,false,38,39,77,136,164,300,11,13,24,2,3:09
633931,2021-05-30,2021,CHN,CIN,1,5,5-1,CIN,9,false,33,42,75,168,166,334,8,14,22,2,3:27
633944,2021-05-29,2021,MIN,KCA,6,5,6-5,MIN,9,true,38,35,73,156,137,293,14,10,24,2,3:04
633889,2021-05-30,2021,OAK,ANA,2,4,4-2,ANA,9,false,37,38,75,140,171,311,9,10,19,2,3:20
634188,2021-05-16,2021,MIN,OAK,6,7,7-6,OAK,9,false,42,42,84,166,147,313,16,16,32,3,3:33
633984,2021-05-22,2021,PHI,BOS,3,4,4-3,BOS,9,false,40,40,80,163,154,317,13,13,26,4,3:40
634470,2021-04-17,2021,PHI,SLN,4,9,9-4,SLN,9,false,42,45,87,186,194,380,15,20,35,5,3:54
633890,2021-05-26,2021,WAS,CIN,5,3,5-3,WAS,9,true,39,39,78,163,144,307,15,13,28,3,3:26 (3:04 delay)
634119,2021-05-14,2021,TOR,PHI,1,5,5-1,PHI,9,false,36,42,78,198,144,342,10,17,27,3,3:38
633985,2021-05-23,2021,ANA,OAK,6,5,6-5,ANA,9,true,38,39,77,157,165,322,15,13,28,5,3:21
634145,2021-05-14,2021,LAN,MIA,9,6,9-6,LAN,9,true,39,39,78,149,159,308,15,12,27,3,3:18
634404,2021-04-25,2021,ATL,ARI,0,5,5-0,ARI,7,false,24,31,55,107,83,190,4,11,15,0,2:10
634123,2021-05-14,2021,HOU,TEX,10,4,10-4,HOU,9,true,42,35,77,130,174,304,18,10,28,2,3:01
634038,2021-05-22,2021,CLE,MIN,5,3,5-3,CLE,10,false,37,40,77,169,141,310,13,12,25,2,3:34
634073,2021-05-18,2021,MIN,CHA,5,4,5-4,MIN,9,false,39,42,81,185,160,345,13,13,26,2,3:48
634025,2021-05-23,2021,TEX,HOU,3,2,3-2,TEX,10,false,40,40,80,166,162,328,14,11,25,2,3:39
634018,2021-05-20,2021,TOR,BOS,7,8,8-7,BOS,9,false,44,42,86,153,169,322,16,18,34,2,3:25
633913,2021-05-29,2021,ARI,SLN,4,7,7-4,SLN,9,false,41,42,83,144,168,312,14,17,31,1,3:24
634053,2021-05-19,2021,CHN,WAS,3,4,4-3,WAS,9,false,39,39,78,156,170,326,13,13,26,2,3:48
633987,2021-05-28,2021,ARI,SLN,6,8,8-6,SLN,9,false,46,41,87,140,174,314,19,13,32,2,3:28
634009,2021-05-23,2021,NYA,CHA,5,4,5-4,NYA,9,false,39,36,75,153,174,327,16,11,27,3,3:37
634300,2021-04-29,2021,BAL,NYA,4,3,4-3,BAL,10,false,37,44,81,177,144,321,9,17,26,3,3:30
634449,2021-04-17,2021,SDN,LAN,0,2,2-0,LAN,9,false,34,33,67,144,141,285,7,6,13,1,3:12
634158,2021-05-13,2021,MIL,SLN,0,2,2-0,SLN,9,false,36,41,77,169,147,316,9,17,26,0,3:31
633946,2021-05-30,2021,ARI,SLN,9,2,9-2,ARI,9,true,42,36,78,138,146,284,19,11,30,1,2:59
634312,2021-05-01,2021,TOR,ATL,6,5,6-5,TOR,10,false,42,44,86,165,166,331,17,16,33,3,3:34
633979,2021-05-25,2021,ARI,SFN,0,8,8-0,SFN,9,false,38,43,81,180,161,341,11,16,27,0,3:16
634090,2021-05-16,2021,SDN,SLN,5,3,5-3,SDN,9,true,38,37,75,151,177,328,15,10,25,3,3:32
634072,2021-06-07,2021,BOS,MIA,5,3,5-3,BOS,9,true,36,44,80,168,143,311,13,18,31,3,3:38
634077,2021-05-17,2021,MIN,CHA,4,16,16-4,CHA,9,false,37,50,87,196,147,343,11,26,37,1,3:11
634001,2021-05-22,2021,KCA,DET,7,5,7-5,KCA,9,true,38,43,81,172,151,323,14,15,29,1,3:28 (1:21 delay)
634121,2021-05-14,2021,COL,CIN,9,6,9-6,COL,9,true,43,38,81,135,175,310,21,15,36,2,3:20
633951,2021-05-25,2021,CHA,SLN,8,3,8-3,CHA,9,true,40,37,77,153,152,305,15,12,27,3,3:23
633874,2021-05-29,2021,HOU,SDN,8,11,11-8,SDN,12,false,52,54,106,230,197,427,19,20,39,3,5:08
634162,2021-05-14,2021,ARI,WAS,2,17,17-2,WAS,9,false,33,59,92,207,133,340,7,29,36,0,3:14
634298,2021-05-02,2021,CIN,CHN,13,12,13-12,CIN,10,false,47,45,92,159,182,341,23,18,41,4,3:57
633978,2021-05-30,2021,PIT,COL,3,4,4-3,COL,9,false,36,43,79,180,146,326,10,17,27,4,3:36
633961,2021-05-28,2021,DET,NYA,3,2,3-2,DET,10,false,37,43,80,186,159,345,10,13,23,0,3:34
633849,2021-05-31,2021,SEA,OAK,6,5,6-5,SEA,10,false,43,42,85,147,169,316,15,13,28,2,3:31
634181,2021-05-10,2021,HOU,ANA,4,5,5-4,ANA,9,false,42,42,84,163,163,326,16,14,30,5,3:57
634118,2021-05-14,2021,MIL,ATL,3,6,6-3,ATL,9,false,38,41,79,159,157,316,11,14,25,3,3:23
634609,2021-04-06,2021,SEA,CHA,4,10,10-4,CHA,9,false,40,44,84,189,164,353,12,17,29,4,3:45
633938,2021-05-29,2021,LAN,SFN,6,11,11-6,SFN,9,false,40,48,88,169,156,325,11,25,36,3,3:38
634363,2021-04-26,2021,LAN,CIN,3,5,5-3,CIN,10,false,42,42,84,171,187,358,14,12,26,2,3:49
634019,2021-05-21,2021,SDN,SEA,16,1,16-1,SDN,9,true,46,36,82,162,197,359,23,10,33,1,3:34
634148,2021-05-15,2021,COL,CIN,5,6,6-5,CIN,12,false,47,50,97,169,152,321,13,17,30,2,4:10 (:10 delay)
634228,2021-05-05,2021,BOS,DET,5,6,6-5,DET,10,false,46,42,88,170,167,337,17,13,30,3,3:47 (:37 delay)
634619,2021-04-06,2021,COL,ARI,8,10,10-8,ARI,13,false,52,57,109,214,198,412,16,17,33,2,4:29
634098,2021-05-16,2021,COL,CIN,6,7,7-6,CIN,9,false,41,41,82,171,158,329,14,17,31,3,3:56
634069,2021-05-16,2021,TOR,PHI,10,8,10-8,TOR,9,true,44,44,88,194,164,358,20,17,37,5,3:45
634085,2021-05-15,2021,PIT,SFN,8,6,8-6,PIT,9,false,40,42,82,184,159,343,20,16,36,3,3:36
634008,2021-05-21,2021,TEX,HOU,7,5,7-5,TEX,10,false,41,48,89,211,150,361,13,17,30,4,4:08
634357,2021-04-29,2021,CHA,DET,11,0,11-0,CHA,7,true,37,24,61,91,154,245,19,3,22,2,2:42 (1:06 delay)
634331,2021-04-27,2021,PIT,KCA,2,1,2-1,PIT,9,true,32,33,65,120,110,230,9,6,15,1,2:20
634370,2021-04-23,2021,LAN,SDN,1,6,6-1,SDN,9,false,34,37,71,130,118,248,9,13,22,1,2:52
634220,2021-05-05,2021,SEA,BAL,0,6,6-0,BAL,9,false,27,35,62,136,113,249,0,9,9,0,2:25
634134,2021-05-16,2021,MIL,ATL,10,9,10-9,MIL,9,true,45,43,88,170,184,354,21,13,34,3,3:45
634230,2021-05-05,2021,CHN,LAN,6,5,6-5,CHN,11,false,45,46,91,183,180,363,15,14,29,1,4:23
634318,2021-04-27,2021,SLN,PHI,5,2,5-2,SLN,9,true,36,32,68,118,131,249,12,5,17,2,2:42
634410,2021-04-27,2021,NYN,BOS,1,2,2-1,BOS,9,false,32,31,63,124,119,243,7,7,14,0,2:38
634194,2021-05-09,2021,SLN,COL,2,0,2-0,SLN,9,true,35,33,68,122,116,238,13,7,20,1,2:48
634062,2021-05-22,2021,WAS,BAL,12,9,12-9,WAS,9,true,43,42,85,169,194,363,18,16,34,1,3:41
634531,2021-04-16,2021,SDN,LAN,6,11,11-6,LAN,12,false,54,55,109,216,204,420,20,18,38,5,4:57
634111,2021-05-15,2021,DET,CHN,9,8,9-8,DET,10,false,51,44,95,162,209,371,22,14,36,4,4:06
634089,2021-05-21,2021,MIA,NYN,5,6,6-5,NYN,12,false,49,45,94,166,199,365,17,12,29,2,4:38
634467,2021-04-24,2021,MIN,PIT,2,6,6-2,PIT,9,false,33,38,71,142,124,266,5,11,16,2,2:43
634243,2021-05-03,2021,SDN,PIT,2,0,2-0,SDN,9,true,30,34,64,134,106,240,6,7,13,1,2:41
634132,2021-05-14,2021,SDN,SLN,5,4,5-4,SDN,9,true,41,41,82,171,184,355,19,17,36,3,4:08
633937,2021-05-27,2021,MIL,SDN,6,5,6-5,MIL,10,false,43,41,84,170,186,356,14,12,26,1,3:51
634238,2021-05-12,2021,ATL,TOR,1,4,4-1,TOR,9,false,34,33,67,133,121,254,7,8,15,0,2:42
634395,2021-04-24,2021,SLN,CIN,2,0,2-0,SLN,9,true,34,32,66,120,124,244,9,6,15,0,2:33 (2:20 delay)
633921,2021-05-28,2021,LAN,SFN,5,8,8-5,SFN,10,false,46,42,88,167,172,339,15,14,29,3,3:43
634020,2021-05-20,2021,CIN,SFN,4,19,19-4,SFN,9,false,38,51,89,205,185,390,12,24,36,3,3:47
634369,2021-04-23,2021,SFN,MIA,5,3,5-3,SFN,9,true,37,31,68,127,146,273,16,4,20,2,2:41
634301,2021-05-02,2021,SDN,SFN,1,7,7-1,SFN,9,false,36,39,75,159,143,302,9,12,21,0,3:10
634374,2021-04-26,2021,SFN,COL,12,0,12-0,SFN,9,true,42,31,73,100,155,255,20,4,24,1,2:27
634203,2021-05-07,2021,CLE,CIN,0,3,3-0,CIN,9,false,29,34,63,145,114,259,1,6,7,1,2:34
634339,2021-04-27,2021,CLE,MIN,7,4,7-4,CLE,9,true,39,34,73,115,144,259,15,8,23,4,3:07
634078,2021-05-21,2021,TOR,TBA,7,9,9-7,TBA,12,false,50,53,103,209,175,384,18,22,40,4,4:26
634254,2021-05-04,2021,COL,SFN,8,6,8-6,COL,7,false,33,36,69,146,121,267,13,17,30,4,3:04
634155,2021-05-12,2021,COL,SDN,3,2,3-2,COL,8,false,34,33,67,128,131,259,13,9,22,1,2:55
634368,2021-04-27,2021,TBA,OAK,4,3,4-3,TBA,9,true,38,36,74,128,130,258,12,9,21,0,2:56
634310,2021-04-28,2021,NYN,BOS,0,1,1-0,BOS,9,false,33,31,64,127,147,274,7,5,12,0,2:56
634278,2021-05-04,2021,OAK,TOR,4,1,4-1,OAK,9,true,34,30,64,119,131,250,11,4,15,1,2:18
634343,2021-04-26,2021,TBA,OAK,1,2,2-1,OAK,9,false,36,33,69,124,165,289,10,9,19,0,2:51
634288,2021-04-30,2021,CHA,CLE,3,5,5-3,CLE,9,false,37,35,72,123,138,261,9,9,18,0,2:55
634246,2021-05-04,2021,COL,SFN,4,12,12-4,SFN,7,false,33,36,69,119,130,249,11,16,27,2,2:38
634308,2021-04-28,2021,TBA,OAK,2,0,2-0,TBA,9,true,33,35,68,136,128,264,12,9,21,1,2:45
634200,2021-05-07,2021,SLN,COL,5,0,5-0,SLN,9,true,34,31,65,132,130,262,9,5,14,0,2:42
634128,2021-05-12,2021,NYN,BAL,7,1,7-1,NYN,9,true,36,36,72,129,125,254,12,10,22,1,2:39
634364,2021-04-27,2021,ARI,SDN,5,1,5-1,ARI,9,true,31,33,64,144,127,271,7,7,14,1,2:53
634274,2021-04-30,2021,WAS,MIA,2,1,2-1,WAS,10,false,33,40,73,139,109,248,11,15,26,1,3:02
634093,2021-05-14,2021,TBA,NYN,3,2,3-2,TBA,9,false,36,35,71,119,140,259,11,7,18,2,2:54
634359,2021-04-27,2021,TEX,ANA,6,1,6-1,TEX,9,true,34,37,71,139,138,277,12,11,23,2,2:50
634451,2021-04-26,2021,DET,KCA,2,3,3-2,KCA,9,false,40,35,75,134,153,287,14,8,22,0,2:56
634337,2021-04-30,2021,TEX,BOS,1,6,6-1,BOS,9,false,37,38,75,127,140,267,11,10,21,1,2:45
634387,2021-04-27,2021,BAL,NYA,1,5,5-1,NYA,9,false,37,39,76,141,130,271,11,15,26,4,2:53
634189,2021-05-11,2021,CLE,CHN,3,2,3-2,CLE,9,true,29,39,68,152,126,278,6,16,22,1,2:56
634218,2021-05-09,2021,NYA,WAS,3,2,3-2,NYA,9,false,38,34,72,105,165,270,16,9,25,3,3:04
634154,2021-05-12,2021,BOS,OAK,1,4,4-1,OAK,9,false,36,35,71,137,149,286,9,9,18,0,2:59
634146,2021-05-14,2021,BAL,NYA,4,5,5-4,NYA,9,false,35,35,70,152,117,269,11,9,20,2,2:55
634394,2021-04-26,2021,CLE,MIN,5,3,5-3,CLE,10,false,38,36,74,121,152,273,11,6,17,2,3:10
634253,2021-05-07,2021,TEX,SEA,4,5,5-4,SEA,9,false,35,39,74,158,121,279,13,13,26,2,2:57
634215,2021-05-08,2021,MIA,MIL,2,6,6-2,MIL,9,false,33,41,74,135,135,270,6,14,20,0,3:02
634195,2021-05-07,2021,MIA,MIL,6,1,6-1,MIA,9,true,34,35,69,151,134,285,13,8,21,1,2:59
634110,2021-05-14,2021,SEA,CLE,7,3,7-3,SEA,9,true,35,37,72,142,147,289,12,11,23,3,3:06
634170,2021-05-11,2021,NYN,BAL,3,2,3-2,NYN,9,false,36,38,74,139,122,261,13,12,25,2,3:13
634212,2021-05-08,2021,CHN,PIT,3,2,3-2,CHN,9,true,31,40,71,149,134,283,8,12,20,1,3:13
634266,2021-05-05,2021,WAS,ATL,3,5,5-3,ATL,9,false,37,34,71,121,145,266,11,8,19,1,2:49
634335,2021-04-27,2021,TOR,WAS,9,5,9-5,TOR,9,true,35,38,73,150,131,281,13,13,26,4,2:56
634332,2021-04-27,2021,CHA,DET,2,5,5-2,DET,9,false,38,37,75,154,135,289,12,9,21,1,3:10
634382,2021-04-26,2021,HOU,SEA,5,2,5-2,HOU,9,true,37,36,73,161,130,291,15,9,24,1,3:07
634216,2021-05-07,2021,CHN,PIT,3,2,3-2,CHN,9,true,32,38,70,132,142,274,10,13,23,2,3:07
634193,2021-05-08,2021,HOU,TOR,4,8,8-4,TOR,9,false,36,38,74,157,137,294,9,10,19,2,3:09
634208,2021-05-12,2021,COL,SDN,3,5,5-3,SDN,7,false,34,30,64,115,156,271,13,9,22,2,3:09
634201,2021-05-07,2021,HOU,TOR,10,4,10-4,HOU,9,true,42,34,76,114,172,286,20,8,28,3,3:14
634279,2021-05-05,2021,MIN,TEX,1,3,3-1,TEX,9,false,36,36,72,149,142,291,10,11,21,2,3:04 (:31 delay)
634365,2021-04-28,2021,LAN,CIN,8,0,8-0,LAN,9,true,39,35,74,134,157,291,17,9,26,3,3:15
634391,2021-04-30,2021,MIN,KCA,9,1,9-1,MIN,9,true,41,32,73,121,170,291,18,7,25,0,3:09
634376,2021-04-25,2021,TBA,TOR,0,1,1-0,TOR,9,false,36,36,72,141,142,283,9,9,18,6,3:13
634426,2021-04-23,2021,CHN,MIL,15,2,15-2,CHN,9,true,46,36,82,143,163,306,23,11,34,1,3:06
634461,2021-04-26,2021,MIL,MIA,0,8,8-0,MIA,9,false,32,41,73,181,127,308,8,14,22,1,3:20
634149,2021-05-11,2021,COL,SDN,1,8,8-1,SDN,9,false,30,44,74,164,115,279,4,16,20,2,3:04
634213,2021-05-07,2021,ANA,LAN,9,2,9-2,ANA,9,true,38,39,77,137,130,267,15,13,28,2,3:05
634180,2021-05-11,2021,ARI,MIA,11,3,11-3,ARI,9,true,41,36,77,139,154,293,19,9,28,2,3:02
634400,2021-04-25,2021,CHN,MIL,0,6,6-0,MIL,9,false,32,43,75,181,128,309,6,15,21,1,3:23
634197,2021-05-08,2021,KCA,CHA,1,9,9-1,CHA,9,false,36,43,79,152,139,291,10,17,27,3,3:04
634227,2021-05-05,2021,SDN,PIT,4,2,4-2,SDN,9,true,38,36,74,143,144,287,13,9,22,1,3:21
634248,2021-05-05,2021,OAK,TOR,4,9,9-4,TOR,9,false,36,41,77,145,154,299,9,15,24,1,3:04
634164,2021-05-11,2021,SFN,TEX,4,2,4-2,SFN,9,true,35,35,70,138,144,282,11,8,19,3,3:00
633918,2021-05-28,2021,HOU,SDN,3,10,10-3,SDN,11,false,49,53,102,199,214,413,20,19,39,2,4:43
634385,2021-04-29,2021,ARI,COL,5,3,5-3,ARI,9,true,40,35,75,144,157,301,15,12,27,1,3:01
634443,2021-04-24,2021,NYN,WAS,1,7,7-1,WAS,9,false,35,42,77,161,136,297,9,16,25,1,3:20
634327,2021-04-30,2021,NYA,DET,10,0,10-0,NYA,9,true,43,31,74,124,197,321,20,5,25,1,3:03
634401,2021-04-23,2021,COL,PHI,5,4,5-4,COL,9,false,37,39,76,150,151,301,12,14,26,2,3:22
634236,2021-05-08,2021,OAK,TBA,6,3,6-3,OAK,9,true,37,41,78,155,151,306,12,14,26,6,3:12
634163,2021-05-11,2021,ATL,TOR,3,5,5-3,TOR,9,false,35,39,74,152,153,305,9,13,22,1,3:15
634237,2021-05-09,2021,CHN,PIT,5,6,6-5,PIT,9,false,36,42,78,145,138,283,9,13,22,1,3:03
634187,2021-05-08,2021,CLE,CIN,9,2,9-2,CLE,9,true,42,36,78,138,167,305,16,10,26,1,3:08
634349,2021-04-25,2021,MIN,PIT,2,6,6-2,PIT,9,false,36,39,75,165,162,327,10,13,23,3,3:31
634235,2021-05-07,2021,KCA,CHA,0,3,3-0,CHA,9,false,36,38,74,167,137,304,8,12,20,0,3:06
634269,2021-05-04,2021,NYA,HOU,7,3,7-3,NYA,9,true,41,33,74,149,179,328,18,9,27,1,3:27
634296,2021-04-29,2021,TBA,OAK,2,3,3-2,OAK,9,false,37,33,70,144,150,294,10,8,18,0,3:04
634354,2021-04-27,2021,SFN,COL,5,7,7-5,COL,10,false,41,44,85,154,140,294,12,14,26,2,3:30
634325,2021-04-30,2021,PIT,SLN,3,7,7-3,SLN,9,false,38,40,78,131,176,307,13,13,26,1,3:19
634229,2021-05-04,2021,MIN,TEX,3,6,6-3,TEX,10,false,35,44,79,187,126,313,6,14,20,3,3:24
634245,2021-05-04,2021,MIA,ARI,9,3,9-3,MIA,9,true,38,40,78,154,149,303,16,12,28,2,3:17
634205,2021-05-09,2021,ANA,LAN,2,1,2-1,ANA,9,true,32,40,72,173,146,319,10,13,23,2,3:26
634348,2021-04-28,2021,TOR,WAS,2,8,8-2,WAS,9,false,36,41,77,160,144,304,10,15,25,1,2:53
634174,2021-05-11,2021,PIT,CIN,7,2,7-2,PIT,9,true,38,35,73,138,150,288,14,10,24,3,3:08
634234,2021-05-07,2021,NYA,WAS,4,11,11-4,WAS,9,false,35,43,78,170,140,310,8,14,22,2,3:01
634435,2021-04-23,2021,CHA,TEX,9,7,9-7,CHA,9,true,41,42,83,190,161,351,18,15,33,5,3:44
634414,2021-04-28,2021,ATL,CHN,10,0,10-0,ATL,9,true,45,36,81,154,168,322,21,8,29,3,2:56
634393,2021-04-25,2021,CHA,TEX,8,4,8-4,CHA,9,true,41,38,79,168,182,350,17,14,31,1,3:32
634275,2021-04-30,2021,TBA,HOU,2,9,9-2,HOU,9,false,37,45,82,174,150,324,11,18,29,0,3:10
634177,2021-05-09,2021,BAL,BOS,3,4,4-3,BOS,9,false,36,38,74,155,148,303,10,11,21,2,2:57
634319,2021-05-01,2021,OAK,BAL,4,8,8-4,BAL,9,false,40,40,80,157,160,317,13,14,27,3,3:10
634192,2021-05-09,2021,HOU,TOR,7,4,7-4,HOU,9,true,39,36,75,150,168,318,17,11,28,3,3:30
634258,2021-05-03,2021,KCA,CLE,6,8,8-6,CLE,9,false,43,44,87,175,159,334,16,19,35,5,3:40
634147,2021-05-11,2021,CHA,MIN,9,3,9-3,CHA,9,true,37,40,77,149,159,308,16,13,29,3,3:23
634251,2021-05-04,2021,CIN,CHA,0,9,9-0,CHA,9,false,33,45,78,193,138,331,6,18,24,1,3:17 (1:06 delay)
634209,2021-05-07,2021,BAL,BOS,2,6,6-2,BOS,9,false,39,39,78,154,162,316,14,11,25,2,3:25 (1:38 delay)
634321,2021-05-04,2021,CHN,LAN,4,3,4-3,CHN,9,false,40,34,74,142,158,300,15,10,25,2,3:46
634347,2021-04-29,2021,ATL,CHN,3,9,9-3,CHN,9,false,37,48,85,168,144,312,11,23,34,2,3:15
634223,2021-05-06,2021,SLN,NYN,1,4,4-1,NYN,9,false,31,48,79,192,128,320,3,20,23,2,3:19 (:32 delay)
634280,2021-04-30,2021,TOR,ATL,13,5,13-5,TOR,9,true,46,36,82,155,170,325,21,11,32,4,3:17
634114,2021-05-13,2021,ATL,TOR,4,8,8-4,TOR,9,false,35,43,78,158,148,306,8,17,25,3,3:14
634240,2021-05-07,2021,SFN,SDN,5,4,5-4,SFN,9,true,36,36,72,169,162,331,12,9,21,4,3:34
634305,2021-04-30,2021,CIN,CHN,8,6,8-6,CIN,9,true,36,43,79,194,144,338,11,17,28,3,3:21
634204,2021-05-07,2021,DET,MIN,3,7,7-3,MIN,9,false,37,43,80,185,159,344,11,16,27,0,3:21 (1:44 delay)
634402,2021-04-26,2021,ATL,CHN,8,7,8-7,ATL,9,true,42,41,83,153,172,325,18,13,31,3,3:29
634129,2021-05-12,2021,CLE,CHN,2,1,2-1,CLE,10,false,38,45,83,190,134,324,14,17,31,3,3:50
634151,2021-05-12,2021,WAS,PHI,2,5,5-2,PHI,10,false,43,44,87,169,162,331,14,17,31,2,3:46
634277,2021-05-04,2021,KCA,CLE,3,7,7-3,CLE,9,false,39,40,79,178,155,333,14,13,27,5,3:39
634219,2021-05-07,2021,ATL,PHI,2,12,12-2,PHI,9,false,32,49,81,215,134,349,6,22,28,3,3:23
634160,2021-05-12,2021,CHA,MIN,13,8,13-8,CHA,9,true,43,41,84,154,187,341,19,16,35,4,3:45
634252,2021-05-07,2021,NYN,ARI,5,4,5-4,NYN,10,false,44,46,90,171,158,329,17,16,33,1,3:52
634226,2021-05-05,2021,KCA,CLE,4,5,5-4,CLE,9,false,37,36,73,144,149,293,11,9,20,1,3:09
634179,2021-05-11,2021,DET,KCA,8,7,8-7,DET,9,false,46,42,88,158,186,344,21,16,37,4,3:40
634315,2021-04-28,2021,PIT,KCA,6,9,9-6,KCA,9,false,42,45,87,195,171,366,15,19,34,4,3:55
634144,2021-05-11,2021,WAS,PHI,2,6,6-2,PHI,9,false,39,45,84,190,180,370,12,18,30,4,3:58
634262,2021-05-08,2021,ANA,LAN,11,14,14-11,LAN,9,false,42,52,94,206,161,367,15,26,41,3,4:03
634159,2021-05-11,2021,MIL,SLN,1,6,6-1,SLN,11,false,44,44,88,166,170,336,13,10,23,1,3:55
634255,2021-05-06,2021,BOS,DET,12,9,12-9,BOS,9,true,48,47,95,182,194,376,21,18,39,5,4:13
634199,2021-05-08,2021,ATL,PHI,8,7,8-7,ATL,12,false,54,51,105,207,199,406,23,16,39,3,4:47
634356,2021-04-25,2021,LAN,SDN,7,8,8-7,SDN,11,false,56,50,106,200,222,422,25,17,42,1,4:59
634425,2021-04-18,2021,MIA,SFN,0,1,1-0,SFN,9,false,29,39,68,148,111,259,4,11,15,1,2:53
634186,2021-05-12,2021,DET,KCA,4,2,4-2,DET,9,true,35,34,69,136,137,273,11,8,19,0,2:42
634413,2021-04-23,2021,TBA,TOR,3,5,5-3,TOR,9,false,37,35,72,128,144,272,8,8,16,1,2:46
634412,2021-04-23,2021,DET,KCA,2,6,6-2,KCA,9,false,34,40,74,154,145,299,8,14,22,2,3:02
634386,2021-04-23,2021,BOS,SEA,6,5,6-5,BOS,9,true,38,41,79,179,159,338,14,15,29,3,3:28
634207,2021-05-09,2021,MIA,MIL,1,2,2-1,MIL,10,false,37,40,77,152,147,299,9,12,21,0,3:15
634185,2021-05-09,2021,SFN,SDN,1,11,11-1,SDN,9,false,37,47,84,162,151,313,11,20,31,0,3:08
633256,2021-07-18,2021,TOR,TEX,5,0,5-0,TOR,7,true,27,25,52,83,98,181,9,4,13,1,1:48
633745,2021-06-12,2021,WAS,SFN,2,0,2-0,WAS,7,true,22,25,47,108,85,193,6,5,11,0,2:10
633745,2021-06-12,2021,WAS,SFN,2,0,2-0,WAS,7,true,22,25,47,108,85,193,6,5,11,0,2:10
633760,2021-06-21,2021,NYN,ATL,4,2,4-2,NYN,7,true,27,26,53,103,94,197,9,5,14,1,2:12
633292,2021-07-18,2021,TOR,TEX,10,0,10-0,TOR,7,true,29,24,53,91,98,189,11,4,15,1,1:51
633360,2021-07-07,2021,TBA,CLE,4,0,4-0,TBA,7,true,29,23,52,97,117,214,11,2,13,2,2:04
633565,2021-06-20,2021,ATL,SLN,1,0,1-0,ATL,7,true,22,26,48,109,81,190,5,5,10,1,1:58
633530,2021-06-26,2021,DET,HOU,3,1,3-1,DET,7,true,24,29,53,124,86,210,6,8,14,0,2:06
633435,2021-06-30,2021,CIN,SDN,5,7,7-5,SDN,6,true,22,26,48,96,94,190,8,11,19,1,2:03 (2:10 delay)
633188,2021-07-24,2021,LAN,COL,1,0,1-0,LAN,9,true,28,33,61,122,98,220,5,6,11,2,2:38
633476,2021-07-19,2021,CHA,MIN,5,3,5-3,CHA,7,false,24,25,49,94,94,188,6,6,12,0,1:54
633899,2021-06-21,2021,NYN,ATL,0,1,1-0,ATL,7,false,26,28,54,120,112,232,7,7,14,1,2:33
633794,2021-06-06,2021,PIT,MIA,1,3,3-1,MIA,9,false,34,34,68,122,115,237,9,8,17,0,2:40
633859,2021-06-03,2021,CHA,DET,4,1,4-1,CHA,9,true,30,34,64,129,106,235,6,7,13,0,2:29
633862,2021-06-04,2021,PHI,WAS,1,2,2-1,WAS,9,false,32,33,65,122,128,250,8,9,17,3,2:56
633709,2021-06-16,2021,SLN,MIA,1,0,1-0,SLN,9,false,32,34,66,117,108,225,8,8,16,1,2:40
633192,2021-07-25,2021,PHI,ATL,2,1,2-1,PHI,9,true,29,32,61,120,107,227,6,4,10,1,2:30
633162,2021-07-28,2021,BOS,TOR,1,4,4-1,TOR,7,false,29,29,58,102,122,224,8,9,17,1,2:36
633739,2021-06-09,2021,SDN,CHN,1,3,3-1,CHN,9,false,32,30,62,126,134,260,5,6,11,0,2:58
633837,2021-06-04,2021,ANA,SEA,3,2,3-2,ANA,9,true,31,34,65,124,120,244,11,7,18,2,2:42
633774,2021-06-06,2021,CHA,DET,3,0,3-0,CHA,9,true,34,33,67,124,121,245,10,6,16,0,2:36
633523,2021-06-25,2021,SFN,OAK,2,0,2-0,SFN,9,true,31,36,67,127,116,243,8,8,16,1,2:23
633394,2021-09-20,2021,CLE,KCA,2,4,4-2,KCA,7,false,24,29,53,135,103,238,4,10,14,3,2:37
633209,2021-07-24,2021,MIN,ANA,1,2,2-1,ANA,9,false,32,33,65,127,115,242,5,5,10,2,2:34
633799,2021-06-05,2021,KCA,MIN,4,5,5-4,MIN,9,false,35,34,69,112,128,240,9,8,17,0,2:37
633247,2021-07-18,2021,CHA,HOU,4,0,4-0,CHA,9,true,34,28,62,119,108,227,11,1,12,1,2:28
633880,2021-06-01,2021,CHN,SDN,4,3,4-3,CHN,9,true,34,35,69,117,136,253,10,8,18,0,2:52
633813,2021-06-08,2021,MIA,COL,6,2,6-2,MIA,9,true,37,31,68,104,137,241,14,6,20,1,2:45
633836,2021-06-03,2021,ATL,WAS,5,1,5-1,ATL,9,true,34,36,70,137,121,258,10,9,19,2,2:47
633798,2021-06-06,2021,MIL,ARI,2,0,2-0,MIL,9,true,34,33,67,135,124,259,11,6,17,0,3:04
633373,2021-07-09,2021,CLE,KCA,2,1,2-1,CLE,9,false,32,32,64,123,122,245,9,5,14,1,2:26
633818,2021-06-04,2021,BAL,CLE,3,1,3-1,BAL,9,true,32,36,68,138,129,267,11,9,20,0,2:50
633704,2021-06-12,2021,MIA,ATL,4,2,4-2,MIA,9,true,33,34,67,121,127,248,11,8,19,1,2:47
633842,2021-06-02,2021,HOU,BOS,2,1,2-1,HOU,9,true,30,36,66,127,136,263,7,9,16,1,2:57
633846,2021-06-04,2021,MIL,ARI,5,1,5-1,MIL,9,true,33,31,64,132,140,272,10,4,14,2,2:40
633220,2021-07-22,2021,MIN,ANA,2,3,3-2,ANA,9,false,33,33,66,127,117,244,9,7,16,0,2:38
633689,2021-06-13,2021,CHN,SLN,2,0,2-0,CHN,9,true,31,32,63,130,113,243,6,5,11,1,2:34
633203,2021-07-21,2021,DET,TEX,4,2,4-2,DET,9,true,31,35,66,123,123,246,8,9,17,0,2:27
633283,2021-07-16,2021,PHI,MIA,5,2,5-2,PHI,7,true,29,28,57,117,125,242,11,8,19,1,2:35
633065,2021-07-29,2021,SDN,COL,3,0,3-0,SDN,9,true,32,33,65,120,118,238,11,6,17,0,2:53
633746,2021-06-11,2021,WAS,SFN,0,1,1-0,SFN,9,false,28,31,59,130,103,233,3,4,7,2,2:30
633848,2021-06-02,2021,COL,TEX,6,3,6-3,COL,9,true,39,35,74,110,137,247,15,8,23,2,2:49
633610,2021-06-20,2021,ATL,SLN,1,9,9-1,SLN,7,false,26,36,62,113,111,224,6,15,21,1,2:16
633342,2021-07-07,2021,NYN,MIL,0,5,5-0,MIL,7,false,25,31,56,127,103,230,6,11,17,1,2:26
633700,2021-06-14,2021,BOS,TOR,2,1,2-1,BOS,9,false,32,31,63,111,134,245,8,5,13,1,2:42
633676,2021-06-15,2021,CHA,TBA,3,0,3-0,CHA,9,true,33,34,67,136,132,268,10,8,18,0,2:42
633179,2021-07-25,2021,MIN,ANA,2,6,6-2,ANA,9,false,34,37,71,120,121,241,7,12,19,2,2:42
633198,2021-07-25,2021,BOS,NYA,5,4,5-4,BOS,9,true,31,39,70,128,112,240,6,15,21,3,2:50
633692,2021-06-17,2021,NYN,CHN,0,2,2-0,CHN,9,false,30,32,62,115,132,247,4,5,9,0,2:48
633610,2021-06-20,2021,ATL,SLN,1,9,9-1,SLN,7,false,26,36,62,113,111,224,6,15,21,1,2:16
633781,2021-06-11,2021,TBA,BAL,4,2,4-2,TBA,9,true,35,33,68,118,158,276,13,6,19,1,2:54
633772,2021-06-08,2021,PIT,LAN,3,5,5-3,LAN,9,false,34,38,72,128,135,263,7,12,19,2,2:55 (:30 delay)
633835,2021-06-03,2021,PIT,MIA,5,3,5-3,PIT,9,true,33,36,69,118,128,246,9,9,18,4,3:01
633673,2021-06-14,2021,CHA,TBA,2,5,5-2,TBA,9,false,33,37,70,150,112,262,7,12,19,0,2:46
633816,2021-06-04,2021,SDN,NYN,2,0,2-0,SDN,9,true,33,32,65,137,120,257,10,5,15,2,3:07
633824,2021-06-04,2021,NYA,BOS,2,5,5-2,BOS,9,false,35,36,71,120,133,253,9,9,18,1,2:49
633367,2021-07-09,2021,SDN,COL,4,2,4-2,SDN,9,true,35,37,72,138,107,245,14,11,25,3,3:00
633715,2021-06-13,2021,PHI,NYA,7,0,7-0,PHI,9,true,37,31,68,121,132,253,14,5,19,2,2:57
633703,2021-06-14,2021,COL,SDN,3,2,3-2,COL,9,true,34,31,65,118,141,259,11,5,16,0,2:37
633176,2021-07-23,2021,BAL,WAS,6,1,6-1,BAL,9,true,32,35,67,149,121,270,7,8,15,3,2:47
633629,2021-06-20,2021,CHN,MIA,2,0,2-0,CHN,9,true,30,33,63,115,129,244,9,6,15,1,2:52
633136,2021-07-25,2021,HOU,TEX,3,1,3-1,HOU,9,true,31,34,65,121,134,255,10,8,18,4,2:59
633183,2021-07-25,2021,KCA,DET,6,1,6-1,KCA,9,true,32,33,65,117,138,255,9,8,17,1,2:22
633094,2021-07-30,2021,WAS,CHN,4,3,4-3,WAS,9,true,35,35,70,127,114,241,12,9,21,2,2:47
633465,2021-06-28,2021,COL,PIT,2,0,2-0,COL,9,true,34,35,69,125,119,244,9,8,17,1,3:02
633212,2021-07-20,2021,DET,TEX,4,1,4-1,DET,9,true,33,30,63,130,120,250,10,4,14,1,2:33
633853,2021-06-02,2021,BAL,MIN,6,3,6-3,BAL,9,true,38,35,73,136,120,256,16,9,25,3,2:54
634647,2021-06-19,2021,WAS,NYN,1,5,5-1,NYN,7,false,32,29,61,84,157,241,12,8,20,2,2:47
633857,2021-06-01,2021,TOR,MIA,5,1,5-1,TOR,9,true,35,36,71,141,127,268,11,11,22,0,2:45
633743,2021-06-11,2021,CLE,SEA,7,0,7-0,CLE,9,true,42,31,73,108,170,278,20,4,24,0,2:56
633737,2021-06-13,2021,TBA,BAL,7,1,7-1,TBA,9,true,38,30,68,127,139,266,16,5,21,2,2:48
633847,2021-06-06,2021,COL,OAK,3,1,3-1,COL,9,true,36,36,72,132,134,266,13,9,22,0,2:59
633566,2021-06-20,2021,SDN,CIN,3,2,3-2,SDN,9,true,34,38,72,144,129,273,12,12,24,0,3:00
633744,2021-06-10,2021,PIT,LAN,3,6,6-3,LAN,8,true,26,40,66,164,99,263,6,20,26,3,2:50 (1:15 delay)
633866,2021-09-23,2021,CLE,CHA,2,7,7-2,CHA,7,false,28,34,62,136,133,269,9,15,24,2,2:46
633705,2021-06-14,2021,CLE,BAL,4,3,4-3,CLE,9,true,29,34,63,143,106,249,6,9,15,3,2:46 (:56 delay)
633194,2021-07-25,2021,CLE,TBA,3,2,3-2,CLE,9,true,33,35,68,136,121,257,9,8,17,1,2:46
633240,2021-07-20,2021,ATL,SDN,2,1,2-1,ATL,9,true,32,35,67,111,132,243,8,8,16,2,2:50
633618,2021-06-18,2021,WAS,NYN,1,0,1-0,WAS,9,false,32,31,63,117,142,259,10,7,17,2,3:04
633839,2021-06-05,2021,TEX,TBA,0,3,3-0,TBA,9,false,29,33,62,136,127,263,5,6,11,1,2:43
633702,2021-06-18,2021,HOU,CHA,2,1,2-1,HOU,9,false,32,36,68,127,131,258,8,10,18,0,2:46
633278,2021-07-19,2021,CHA,MIN,2,3,3-2,MIN,8,false,32,33,65,107,145,252,7,8,15,1,2:45
633232,2021-07-23,2021,KCA,DET,5,3,5-3,KCA,9,true,33,36,69,138,125,263,9,11,20,2,2:50
633080,2021-07-31,2021,ANA,OAK,1,0,1-0,ANA,9,true,31,35,66,138,112,250,6,8,14,3,2:43
633292,2021-07-18,2021,TOR,TEX,10,0,10-0,TOR,7,true,29,24,53,91,98,189,11,4,15,1,1:51
633733,2021-06-10,2021,CHA,TOR,5,2,5-2,CHA,9,true,32,36,68,150,137,287,9,10,19,0,2:43
633776,2021-06-09,2021,ANA,KCA,6,1,6-1,ANA,9,true,36,36,72,126,146,272,14,9,23,2,2:53
633698,2021-06-12,2021,WAS,SFN,1,2,2-1,SFN,8,false,28,34,62,143,127,270,6,10,16,1,3:05
633800,2021-06-05,2021,TOR,HOU,6,2,6-2,TOR,9,true,36,36,72,132,139,271,14,12,26,1,2:50
633441,2021-07-03,2021,CIN,CHN,3,2,3-2,CIN,9,true,30,38,68,161,103,264,7,11,18,3,2:58
633765,2021-06-08,2021,OAK,ARI,5,2,5-2,OAK,9,true,35,33,68,113,150,263,11,6,17,1,2:44
633594,2021-06-19,2021,TEX,MIN,2,3,3-2,MIN,9,false,34,34,68,113,127,240,8,7,15,0,2:42
633797,2021-06-05,2021,SLN,CIN,2,5,5-2,CIN,9,false,35,41,76,154,120,274,8,14,22,1,3:06
633831,2021-06-03,2021,HOU,BOS,1,5,5-1,BOS,9,false,34,41,75,185,105,290,8,16,24,1,3:07
633864,2021-06-01,2021,SFN,ANA,1,8,8-1,ANA,9,false,33,40,73,150,128,278,7,14,21,2,2:52
633833,2021-06-03,2021,KCA,MIN,6,5,6-5,KCA,9,true,36,38,74,149,119,268,12,13,25,1,3:02
633830,2021-06-04,2021,TEX,TBA,5,4,5-4,TEX,9,true,34,37,71,141,108,249,10,12,22,1,2:47
633403,2021-07-03,2021,TOR,TBA,6,3,6-3,TOR,9,true,33,37,70,154,115,269,8,10,18,3,2:45
633217,2021-07-21,2021,LAN,SFN,2,4,4-2,SFN,9,false,33,36,69,143,130,273,6,10,16,1,2:58
633337,2021-09-24,2021,CHN,SLN,4,12,12-4,SLN,7,false,30,39,69,150,103,253,9,19,28,3,2:41
633261,2021-07-17,2021,COL,LAN,2,9,9-2,LAN,9,false,33,40,73,142,113,255,6,13,19,1,2:56
633628,2021-06-16,2021,WAS,PIT,3,1,3-1,WAS,9,true,35,37,72,123,142,265,12,10,22,2,2:59
633314,2021-07-11,2021,SDN,COL,1,3,3-1,COL,9,false,34,38,72,125,138,263,8,12,20,2,3:13
633121,2021-07-26,2021,KCA,CHA,4,3,4-3,KCA,9,true,34,34,68,134,130,264,11,8,19,0,2:36
633687,2021-06-17,2021,HOU,CHA,10,2,10-2,HOU,9,true,39,32,71,113,153,266,14,5,19,1,2:45
633681,2021-06-15,2021,NYN,CHN,3,2,3-2,NYN,9,true,37,35,72,129,130,259,14,9,23,1,3:05
633467,2021-06-30,2021,BOS,KCA,6,2,6-2,BOS,9,true,35,33,68,134,126,260,11,9,20,2,2:55 (2:21 delay)
633291,2021-08-17,2021,NYA,BOS,5,3,5-3,NYA,7,true,33,29,62,118,127,245,15,10,25,4,2:56
633395,2021-07-07,2021,NYN,MIL,4,3,4-3,NYN,8,false,32,30,62,111,124,235,11,7,18,1,2:45
633390,2021-07-03,2021,PHI,SDN,4,2,4-2,PHI,9,true,34,31,65,123,137,260,11,6,17,0,2:50 (2:46 delay)
633166,2021-07-27,2021,KCA,CHA,3,5,5-3,CHA,9,false,33,35,68,129,127,256,8,11,19,1,2:35
633581,2021-09-14,2021,MIN,CLE,1,3,3-1,CLE,7,false,24,29,53,99,83,182,4,8,12,1,2:06
633877,2021-06-01,2021,CLE,CHA,6,5,6-5,CLE,9,true,35,40,75,145,144,289,10,14,24,1,3:00
633615,2021-06-18,2021,SEA,TBA,5,1,5-1,SEA,9,true,36,35,71,126,124,250,15,8,23,1,2:48
633748,2021-06-10,2021,MIA,COL,11,4,11-4,MIA,9,true,42,36,78,124,155,279,19,8,27,1,3:03
633472,2021-06-27,2021,LAN,CHN,7,1,7-1,LAN,9,true,36,31,67,114,133,247,12,5,17,0,2:42
633481,2021-07-01,2021,WAS,LAN,2,6,6-2,LAN,5,false,21,26,47,103,74,177,8,10,18,2,1:56 (1:17 delay)
633819,2021-06-03,2021,NYA,TBA,2,9,9-2,TBA,9,false,33,42,75,170,113,283,6,15,21,1,2:58
633736,2021-06-12,2021,MIN,HOU,5,2,5-2,MIN,9,true,36,33,69,123,156,279,13,7,20,2,3:20
633611,2021-06-20,2021,SFN,PHI,11,2,11-2,SFN,9,true,43,32,75,108,169,277,18,5,23,2,2:51
633652,2021-06-14,2021,LAN,PHI,3,1,3-1,LAN,9,true,28,38,66,157,122,279,4,11,15,4,3:09
633091,2021-07-30,2021,TOR,KCA,6,4,6-4,TOR,9,true,36,35,71,125,149,274,14,8,22,1,2:50 (:21 delay)
633810,2021-06-06,2021,ATL,LAN,4,2,4-2,ATL,9,true,37,34,71,126,147,273,13,7,20,2,3:21
633280,2021-07-18,2021,DET,MIN,7,0,7-0,DET,9,true,36,34,70,128,113,241,12,11,23,0,2:30
633665,2021-06-16,2021,MIL,CIN,1,2,2-1,CIN,9,false,36,33,69,132,159,291,9,9,18,1,2:56
633771,2021-06-11,2021,NYN,SDN,3,2,3-2,NYN,9,true,32,32,64,132,114,246,11,6,17,3,3:00
633550,2021-06-20,2021,PIT,CLE,1,2,2-1,CLE,9,false,35,33,68,112,120,232,9,6,15,1,2:31
633557,2021-06-20,2021,WAS,NYN,5,2,5-2,WAS,9,true,36,31,67,123,116,239,14,5,19,2,2:49
633693,2021-06-14,2021,WAS,PIT,3,2,3-2,WAS,9,true,34,36,70,136,122,258,10,10,20,2,2:55
633796,2021-06-07,2021,ANA,KCA,8,3,8-3,ANA,9,true,36,36,72,124,160,284,14,11,25,3,3:02
633691,2021-06-17,2021,ATL,SLN,4,0,4-0,ATL,9,true,36,31,67,128,143,271,13,5,18,3,2:54
633815,2021-06-04,2021,TOR,HOU,1,13,13-1,HOU,9,false,32,48,80,179,102,281,7,21,28,2,2:58
633407,2021-07-09,2021,MIL,CIN,0,2,2-0,CIN,9,false,34,38,72,137,116,253,10,14,24,1,2:50
633886,2021-06-05,2021,SFN,CHN,4,3,4-3,SFN,9,true,36,33,69,132,164,296,14,4,18,1,3:04
633809,2021-06-03,2021,SLN,CIN,2,4,4-2,CIN,9,false,37,41,78,148,140,288,11,15,26,0,3:07
633954,2021-06-02,2021,SEA,OAK,0,6,6-0,OAK,9,false,31,38,69,146,111,257,6,11,17,0,2:37
633711,2021-06-13,2021,CIN,COL,6,2,6-2,CIN,9,true,35,41,76,162,125,287,12,14,26,3,3:11
633521,2021-06-25,2021,CIN,ATL,2,3,3-2,ATL,9,false,36,38,74,144,125,269,11,11,22,1,3:03
633228,2021-07-18,2021,SLN,SFN,2,1,2-1,SLN,9,true,31,38,69,160,117,277,7,12,19,1,3:02
633107,2021-07-30,2021,DET,BAL,3,4,4-3,BAL,9,false,37,36,73,129,142,271,11,10,21,3,2:52
633764,2021-06-09,2021,PHI,ATL,2,1,2-1,PHI,9,false,34,35,69,131,127,258,7,10,17,0,2:51
633823,2021-06-03,2021,SFN,CHN,7,2,7-2,SFN,9,true,39,31,70,115,175,290,16,5,21,2,3:05
633883,2021-06-02,2021,ATL,WAS,3,5,5-3,WAS,9,false,37,38,75,142,145,287,10,12,22,3,3:24
633677,2021-06-16,2021,LAN,PHI,0,2,2-0,PHI,9,false,37,38,75,146,130,276,11,13,24,0,3:15
633607,2021-06-18,2021,ATL,SLN,9,1,9-1,ATL,9,true,42,31,73,123,149,272,20,6,26,1,2:51
633170,2021-07-23,2021,CHN,ARI,8,3,8-3,CHN,9,true,35,39,74,164,130,294,13,12,25,1,3:11
633501,2021-06-26,2021,CHA,SEA,2,3,3-2,SEA,9,false,34,37,71,149,142,291,10,10,20,3,3:17 (1:38 delay)
633600,2021-06-18,2021,SFN,PHI,5,3,5-3,SFN,9,true,35,32,67,128,149,277,10,7,17,0,3:02
633225,2021-07-21,2021,TBA,BAL,5,4,5-4,TBA,9,false,39,36,75,118,164,282,13,11,24,2,2:51
633366,2021-07-09,2021,MIN,DET,4,2,4-2,MIN,9,true,32,35,67,151,116,267,8,10,18,4,2:57
633678,2021-06-14,2021,NYN,CHN,5,2,5-2,NYN,9,true,35,30,65,130,135,265,15,5,20,3,3:10
633575,2021-06-20,2021,NYA,OAK,2,1,2-1,NYA,9,true,29,34,63,146,133,279,5,9,14,2,3:01
633710,2021-06-13,2021,WAS,SFN,5,0,5-0,WAS,9,true,38,32,70,118,135,253,14,5,19,1,2:49
633791,2021-06-09,2021,CIN,MIL,7,3,7-3,CIN,9,true,39,41,80,142,151,293,15,14,29,1,3:17
633171,2021-07-25,2021,SFN,PIT,6,1,6-1,SFN,9,true,37,34,71,126,159,285,13,7,20,2,2:54
633856,2021-06-01,2021,BAL,MIN,7,4,7-4,BAL,9,true,36,42,78,167,139,306,14,16,30,3,3:21
633730,2021-06-12,2021,CIN,COL,10,3,10-3,CIN,9,true,42,35,77,143,148,291,20,9,29,1,3:02
633806,2021-06-06,2021,SDN,NYN,2,6,6-2,NYN,9,false,38,37,75,140,141,281,11,13,24,1,3:17
633722,2021-06-13,2021,NYN,SDN,3,7,7-3,SDN,9,false,37,38,75,157,132,289,10,15,25,2,3:24
633920,2021-06-05,2021,CHA,DET,3,4,4-3,DET,9,false,38,34,72,130,177,307,12,8,20,1,3:05
633251,2021-07-18,2021,ARI,CHN,6,4,6-4,ARI,9,true,41,34,75,99,156,255,22,7,29,4,3:09
633499,2021-06-27,2021,CHA,SEA,7,5,7-5,CHA,7,true,33,31,64,151,127,278,15,11,26,4,2:53
633590,2021-06-19,2021,PIT,CLE,6,3,6-3,PIT,9,true,37,35,72,143,159,302,13,8,21,3,3:14
633626,2021-06-15,2021,SEA,MIN,10,0,10-0,SEA,9,true,43,29,72,118,177,295,19,4,23,0,2:53
633233,2021-07-19,2021,WAS,MIA,18,1,18-1,WAS,9,true,44,34,78,112,154,266,21,9,30,2,2:53
633174,2021-07-25,2021,NYN,TOR,5,4,5-4,NYN,9,true,33,40,73,127,144,271,12,15,27,5,3:18
633533,2021-06-21,2021,ARI,MIL,5,1,5-1,ARI,9,true,38,33,71,116,161,277,16,7,23,1,2:55
633172,2021-07-25,2021,LAN,COL,3,2,3-2,LAN,9,true,34,35,69,142,147,289,10,11,21,0,3:19
633632,2021-06-16,2021,OAK,ANA,8,4,8-4,OAK,9,true,38,37,75,130,134,264,15,11,26,3,2:56
633638,2021-06-18,2021,CHN,MIA,2,10,10-2,MIA,9,false,36,42,78,143,151,294,9,16,25,2,3:21
633336,2021-07-09,2021,MIA,ATL,0,5,5-0,ATL,9,false,32,43,75,162,126,288,5,16,21,0,3:01
633542,2021-06-21,2021,CHN,CLE,0,4,4-0,CLE,9,false,34,35,69,136,145,281,10,8,18,2,3:12
633178,2021-07-22,2021,SLN,CHN,3,2,3-2,SLN,9,true,34,32,66,123,139,262,11,6,17,1,2:49
633893,2021-06-06,2021,KCA,MIN,1,2,2-1,MIN,9,false,32,39,71,148,116,264,8,14,22,2,2:59
633784,2021-06-09,2021,OAK,ARI,4,0,4-0,OAK,9,true,34,34,68,144,151,295,11,6,17,1,2:59
633119,2021-07-30,2021,SLN,MIN,5,1,5-1,SLN,9,true,33,37,70,120,138,258,11,11,22,1,2:45
633196,2021-07-21,2021,CIN,NYN,0,7,7-0,NYN,9,false,29,44,73,170,108,278,3,16,19,1,2:59
633352,2021-07-06,2021,MIN,CHA,1,4,4-1,CHA,9,false,34,34,68,132,146,278,8,6,14,0,2:57
633506,2021-06-30,2021,CLE,DET,1,7,7-1,DET,7,false,27,34,61,139,110,249,4,14,18,1,2:27
634072,2021-06-07,2021,BOS,MIA,5,3,5-3,BOS,9,true,36,44,80,168,143,311,13,18,31,3,3:38
633157,2021-07-26,2021,ANA,COL,6,2,6-2,ANA,9,true,35,36,71,135,141,276,12,9,21,3,3:16
633720,2021-06-11,2021,MIN,HOU,4,6,6-4,HOU,9,false,35,40,75,148,139,287,7,14,21,1,2:58
633803,2021-06-09,2021,BOS,HOU,3,8,8-3,HOU,9,false,32,47,79,169,124,293,5,21,26,1,3:07
634222,2021-07-17,2021,DET,MIN,1,0,1-0,DET,7,true,25,23,48,85,100,185,7,2,9,1,1:55
633751,2021-06-12,2021,BOS,TOR,2,7,7-2,TOR,9,false,36,38,74,152,158,310,10,14,24,2,3:09
633773,2021-06-08,2021,BAL,NYN,10,3,10-3,BAL,9,true,42,32,74,128,176,304,19,6,25,1,3:14
633841,2021-06-03,2021,SDN,NYN,4,3,4-3,SDN,9,true,36,37,73,154,141,295,12,11,23,1,3:35
633619,2021-06-16,2021,HOU,TEX,8,4,8-4,HOU,9,true,39,35,74,149,143,292,16,10,26,2,3:01
633161,2021-07-27,2021,PIT,MIL,0,9,9-0,MIL,9,false,32,43,75,175,117,292,6,17,23,1,2:54
633135,2021-07-25,2021,MIA,SDN,9,3,9-3,MIA,9,true,41,33,74,129,155,284,17,9,26,1,3:04
633204,2021-07-25,2021,CHN,ARI,5,1,5-1,CHN,9,true,34,38,72,155,140,295,11,11,22,4,3:13
633585,2021-06-19,2021,KCA,BOS,1,7,7-1,BOS,9,false,36,38,74,143,147,290,9,12,21,0,2:59
633482,2021-06-27,2021,SLN,PIT,2,7,7-2,PIT,9,false,32,42,74,164,115,279,5,17,22,0,2:53 (1:04 delay)
633244,2021-07-22,2021,LAN,SFN,3,5,5-3,SFN,9,false,36,38,74,140,128,268,9,12,21,3,3:07
633811,2021-06-09,2021,BAL,NYN,1,14,14-1,NYN,9,false,33,43,76,151,115,266,7,19,26,0,2:43
633187,2021-07-21,2021,TOR,BOS,4,7,7-4,BOS,9,false,34,38,72,149,128,277,7,11,18,1,2:54
633777,2021-06-08,2021,SDN,CHN,1,7,7-1,CHN,9,false,33,38,71,138,140,278,8,11,19,1,2:51
633795,2021-06-05,2021,PHI,WAS,5,2,5-2,PHI,9,true,33,39,72,157,125,282,9,11,20,4,3:11
633606,2021-06-19,2021,NYA,OAK,7,5,7-5,NYA,9,true,38,41,79,147,141,288,16,14,30,3,3:14
633189,2021-07-27,2021,CLE,SLN,2,4,4-2,SLN,9,false,33,38,71,161,105,266,8,12,20,1,2:51
633517,2021-06-24,2021,TBA,BOS,1,0,1-0,TBA,9,false,34,34,68,132,137,269,10,9,19,3,3:02
633688,2021-06-13,2021,DET,CHA,1,4,4-1,CHA,9,false,30,43,73,144,128,272,3,16,19,1,2:47
633867,2021-06-28,2021,CIN,PHI,12,4,12-4,CIN,9,true,41,39,80,136,167,303,17,12,29,3,3:18
633895,2021-06-01,2021,COL,TEX,3,2,3-2,COL,11,false,43,38,81,147,159,306,14,6,20,2,3:21
633728,2021-06-13,2021,BOS,TOR,4,18,18-4,TOR,9,false,36,49,85,160,142,302,10,24,34,1,2:54
633741,2021-06-11,2021,CIN,COL,11,5,11-5,CIN,9,true,42,35,77,145,157,302,16,8,24,2,3:09
633081,2021-07-29,2021,PHI,WAS,1,3,3-1,WAS,7,false,26,28,54,100,100,200,7,9,16,0,2:06
633855,2021-06-02,2021,CHN,SDN,6,1,6-1,CHN,9,true,38,35,73,150,156,306,13,9,22,2,3:16
633696,2021-06-13,2021,ARI,ANA,3,10,10-3,ANA,9,false,38,42,80,146,136,282,12,15,27,2,3:05
633793,2021-06-08,2021,BOS,HOU,1,7,7-1,HOU,9,false,36,43,79,177,128,305,9,20,29,1,3:28
633832,2021-06-03,2021,ANA,SEA,2,6,6-2,SEA,9,false,36,39,75,171,139,310,9,14,23,2,3:26
633197,2021-07-24,2021,HOU,TEX,4,1,4-1,HOU,9,true,35,36,71,166,137,303,14,9,23,0,3:10
633313,2021-07-10,2021,MIL,CIN,3,4,4-3,CIN,9,false,37,36,73,164,144,308,14,10,24,2,3:18
633205,2021-07-21,2021,CHA,MIN,2,7,7-2,MIN,9,false,37,40,77,155,149,304,12,14,26,1,3:15
633349,2021-07-07,2021,TEX,DET,3,5,5-3,DET,9,false,37,40,77,153,137,290,11,15,26,2,3:11
633073,2021-07-30,2021,MIA,NYA,1,3,3-1,NYA,9,false,37,38,75,139,152,291,11,14,25,3,3:17
633860,2021-06-03,2021,COL,TEX,11,6,11-6,COL,9,true,43,36,79,140,158,298,19,10,29,1,3:01
633762,2021-06-10,2021,PHI,ATL,4,3,4-3,PHI,10,false,38,38,76,162,140,302,11,9,20,1,3:30
633822,2021-06-08,2021,DET,SEA,5,3,5-3,DET,9,true,35,39,74,149,144,293,12,14,26,1,3:09 (:36 delay)
633828,2021-06-05,2021,ATL,LAN,6,4,6-4,ATL,9,true,36,38,74,155,130,285,14,9,23,1,3:16 (:20 delay)
633826,2021-06-08,2021,ANA,KCA,8,1,8-1,ANA,9,true,35,36,71,142,159,301,12,11,23,1,2:58
633651,2021-06-21,2021,SDN,LAN,6,2,6-2,SDN,9,true,39,35,74,155,155,310,16,7,23,2,3:38
633236,2021-07-19,2021,TBA,BAL,1,6,6-1,BAL,9,false,34,39,73,156,133,289,9,12,21,2,3:09
633223,2021-07-20,2021,MIL,KCA,2,5,5-2,KCA,9,false,37,39,76,155,126,281,11,12,23,2,3:11
633707,2021-06-13,2021,OAK,KCA,6,3,6-3,OAK,9,true,36,38,74,143,145,288,13,12,25,2,3:08
633118,2021-07-30,2021,ANA,OAK,0,2,2-0,OAK,9,false,34,39,73,156,129,285,8,12,20,1,3:18
633609,2021-06-18,2021,NYA,OAK,3,5,5-3,OAK,9,false,32,39,71,145,129,274,6,12,18,2,3:03
633742,2021-06-11,2021,CHN,SLN,8,5,8-5,CHN,9,true,34,38,72,130,138,268,11,13,24,3,3:04
633885,2021-06-01,2021,ARI,NYN,6,5,6-5,ARI,10,false,42,38,80,139,147,286,13,10,23,1,3:27
633656,2021-06-15,2021,OAK,ANA,6,4,6-4,OAK,9,true,36,34,70,130,161,291,12,8,20,2,2:54
633821,2021-06-05,2021,SDN,NYN,0,4,4-0,NYN,9,false,34,44,78,187,126,313,6,17,23,1,3:25
633817,2021-06-04,2021,SFN,CHN,8,5,8-5,SFN,9,true,39,36,75,150,167,317,16,8,24,0,3:14
633560,2021-06-24,2021,TOR,BAL,9,0,9-0,TOR,9,true,39,37,76,151,153,304,15,10,25,1,3:01
633789,2021-06-11,2021,DET,CHA,4,5,5-4,CHA,10,false,39,40,79,142,173,315,10,13,23,0,3:12 (:49 delay)
633659,2021-06-16,2021,CLE,BAL,8,7,8-7,CLE,9,true,38,42,80,166,140,306,15,16,31,1,3:05
633191,2021-07-21,2021,WAS,MIA,1,3,3-1,MIA,10,false,37,38,75,156,137,293,10,8,18,1,3:22
633675,2021-06-15,2021,LAN,PHI,5,3,5-3,LAN,9,true,38,39,77,156,135,291,16,11,27,2,3:23
633286,2021-07-17,2021,ANA,SEA,9,4,9-4,ANA,9,true,39,42,81,172,136,308,15,16,31,3,3:20
633697,2021-06-17,2021,SEA,TBA,6,5,6-5,SEA,9,false,36,37,73,150,137,287,12,11,23,2,3:08
633140,2021-07-24,2021,SEA,OAK,5,4,5-4,SEA,9,false,37,35,72,155,159,314,12,8,20,2,3:26
633277,2021-07-19,2021,HOU,CLE,4,3,4-3,HOU,9,true,36,38,74,151,150,301,12,13,25,2,3:25
633381,2021-07-06,2021,ARI,COL,4,3,4-3,ARI,9,false,38,36,74,149,142,291,13,9,22,2,3:17
633093,2021-07-29,2021,PIT,MIL,0,12,12-0,MIL,9,false,29,46,75,185,96,281,4,19,23,2,3:07
633214,2021-07-23,2021,PHI,ATL,5,1,5-1,PHI,9,true,36,38,74,150,143,293,13,12,25,0,3:10
633716,2021-06-14,2021,SEA,MIN,4,3,4-3,SEA,9,true,36,39,75,140,146,286,14,12,26,0,3:10
633576,2021-06-19,2021,HOU,CHA,7,3,7-3,HOU,9,true,36,37,73,141,137,278,13,10,23,1,3:10
633452,2021-07-02,2021,OAK,BOS,2,3,3-2,BOS,10,false,35,39,74,137,147,284,6,11,17,1,3:04
633208,2021-07-23,2021,HOU,TEX,7,3,7-3,HOU,9,true,37,36,73,147,159,306,11,9,20,3,3:15
633242,2021-07-20,2021,WAS,MIA,6,3,6-3,WAS,9,true,39,34,73,123,131,254,17,7,24,1,2:56
633617,2021-06-17,2021,SDN,CIN,6,4,6-4,SDN,9,false,35,38,73,140,140,280,10,12,22,3,3:07
633699,2021-06-12,2021,TBA,BAL,5,4,5-4,TBA,9,true,38,34,72,126,151,277,14,9,23,4,3:00
633630,2021-06-16,2021,NYN,CHN,6,3,6-3,NYN,9,true,35,36,71,160,116,276,12,7,19,1,3:01
633790,2021-06-10,2021,MIN,NYA,7,5,7-5,MIN,9,false,40,40,80,162,152,314,16,14,30,3,3:31
633584,2021-06-18,2021,PIT,CLE,11,10,11-10,PIT,9,true,37,41,78,153,146,299,14,18,32,3,3:07
633827,2021-06-05,2021,MIL,ARI,7,5,7-5,MIL,9,true,34,39,73,180,123,303,10,13,23,0,3:12
633788,2021-06-08,2021,CHA,TOR,6,1,6-1,CHA,9,true,39,37,76,169,154,323,14,12,26,2,3:34
633258,2021-07-22,2021,DET,TEX,7,5,7-5,DET,9,true,35,41,76,161,132,293,10,14,24,3,3:02
633181,2021-07-23,2021,BOS,NYA,6,2,6-2,BOS,9,true,36,40,76,159,156,315,12,14,26,1,3:26
633858,2021-06-04,2021,PIT,MIA,9,2,9-2,PIT,9,true,39,36,75,148,161,309,17,9,26,2,3:22
633548,2021-06-24,2021,MIA,WAS,3,7,7-3,WAS,9,false,35,41,76,164,140,304,10,14,24,0,3:14
633335,2021-07-07,2021,MIN,CHA,1,6,6-1,CHA,9,false,36,40,76,152,140,292,9,17,26,2,3:09
633718,2021-06-12,2021,OAK,KCA,11,2,11-2,OAK,9,true,44,37,81,146,166,312,20,10,30,3,3:18
633679,2021-06-15,2021,SFN,ARI,9,8,9-8,SFN,9,true,39,41,80,141,143,284,15,15,30,2,3:03
633778,2021-06-08,2021,SLN,CLE,1,10,10-1,CLE,9,false,37,45,82,169,134,303,10,19,29,0,3:10
633364,2021-07-06,2021,TEX,DET,10,5,10-5,TEX,9,true,40,36,76,147,145,292,17,9,26,2,2:50
633088,2021-07-31,2021,SFN,HOU,8,6,8-6,SFN,9,true,41,37,78,114,174,288,18,8,26,2,3:11
633200,2021-07-20,2021,HOU,CLE,9,3,9-3,HOU,9,true,40,38,78,137,160,297,18,11,29,2,3:13
633100,2021-07-30,2021,NYN,CIN,2,6,6-2,CIN,9,false,36,40,76,131,150,281,11,13,24,0,3:02
633254,2021-07-20,2021,ARI,PIT,11,6,11-6,ARI,9,true,41,40,81,135,145,280,18,14,32,2,3:11
633150,2021-07-27,2021,TEX,ARI,5,4,5-4,TEX,9,true,37,35,72,141,141,282,14,12,26,3,3:08
633701,2021-06-15,2021,COL,SDN,8,4,8-4,COL,9,true,39,33,72,128,162,290,15,10,25,3,3:26
633661,2021-06-19,2021,SEA,TBA,6,5,6-5,SEA,10,false,38,38,76,153,154,307,11,8,19,2,3:02
633845,2021-06-05,2021,ANA,SEA,12,5,12-5,ANA,9,true,41,34,75,132,145,277,17,6,23,3,3:00
633152,2021-07-27,2021,PHI,WAS,4,6,6-4,WAS,9,false,40,36,76,126,149,275,12,11,23,2,3:14
633252,2021-07-18,2021,CIN,MIL,0,8,8-0,MIL,9,false,33,44,77,179,118,297,6,18,24,2,3:21
633284,2021-07-18,2021,ANA,SEA,4,7,7-4,SEA,9,false,40,40,80,145,150,295,13,13,26,3,3:20
633165,2021-07-30,2021,TBA,BOS,7,3,7-3,TBA,9,true,38,39,77,161,144,305,15,13,28,0,3:11
633455,2021-06-29,2021,COL,PIT,8,0,8-0,COL,9,true,38,28,66,92,113,205,15,3,18,0,2:18
633162,2021-07-28,2021,BOS,TOR,1,4,4-1,TOR,7,false,29,29,58,102,122,224,8,9,17,1,2:36
633583,2021-06-19,2021,WAS,NYN,6,2,6-2,WAS,7,true,28,30,58,114,96,210,11,9,20,3,2:26
633775,2021-06-09,2021,SLN,CLE,8,2,8-2,SLN,9,true,40,31,71,120,166,286,16,4,20,1,2:59
633299,2021-07-17,2021,PHI,MIA,4,2,4-2,PHI,10,false,38,37,75,154,135,289,10,9,19,0,3:30 (1:15 delay)
633865,2021-06-04,2021,COL,OAK,5,9,9-5,OAK,9,false,40,44,84,163,141,304,14,18,32,4,3:43
633834,2021-06-02,2021,ARI,NYN,6,7,7-6,NYN,9,false,36,42,78,151,143,294,12,17,29,2,3:12
633105,2021-07-31,2021,DET,BAL,2,5,5-2,BAL,9,false,38,42,80,148,144,292,9,14,23,3,2:59
633160,2021-07-27,2021,CHN,CIN,4,7,7-4,CIN,9,false,41,39,80,140,161,301,15,12,27,2,3:12
633227,2021-07-21,2021,MIL,KCA,3,6,6-3,KCA,9,false,35,42,77,170,126,296,9,14,23,1,3:06
633241,2021-07-21,2021,SLN,CHN,3,2,3-2,SLN,10,false,41,43,84,138,159,297,14,16,30,6,4:09
633838,2021-06-04,2021,KCA,MIN,14,5,14-5,KCA,9,true,45,40,85,157,153,310,18,14,32,2,3:16
633494,2021-06-27,2021,DET,HOU,2,1,2-1,DET,10,false,39,38,77,149,166,315,10,10,20,2,3:29
633346,2021-07-16,2021,PIT,NYN,4,1,4-1,PIT,9,true,36,37,73,150,154,304,13,11,24,1,3:30 (:39 delay)
633624,2021-06-17,2021,ANA,DET,7,5,7-5,ANA,9,true,38,39,77,136,128,264,14,15,29,2,2:59
633245,2021-07-20,2021,COL,SEA,4,6,6-4,SEA,9,false,39,40,79,151,146,297,15,14,29,1,3:16
633573,2021-06-19,2021,BAL,TOR,7,10,10-7,TOR,9,false,39,41,80,160,145,305,12,16,28,3,3:10
633531,2021-06-26,2021,BOS,NYA,4,2,4-2,BOS,9,true,35,38,73,162,129,291,12,13,25,2,3:22
633852,2021-06-05,2021,NYA,BOS,3,7,7-3,BOS,9,false,35,40,75,146,142,288,9,15,24,4,3:14
633257,2021-07-20,2021,TBA,BAL,9,3,9-3,TBA,9,true,36,38,74,168,125,293,11,9,20,1,3:00
633462,2021-07-02,2021,CIN,CHN,2,1,2-1,CIN,9,true,30,36,66,162,132,294,6,9,15,3,3:12
633879,2021-06-01,2021,LAN,SLN,2,3,3-2,SLN,9,false,37,37,74,148,150,298,12,9,21,2,3:33
633348,2021-07-09,2021,HOU,NYA,0,4,4-0,NYA,9,false,32,39,71,167,128,295,5,13,18,2,3:14
633604,2021-06-18,2021,ARI,LAN,0,3,3-0,LAN,9,false,33,35,68,158,138,296,6,10,16,1,3:09
633658,2021-06-16,2021,SEA,MIN,2,7,7-2,MIN,9,false,31,39,70,139,146,285,5,14,19,0,2:54
633891,2021-06-01,2021,KCA,PIT,10,5,10-5,KCA,9,true,39,41,80,158,147,305,16,13,29,3,3:28
633840,2021-06-04,2021,CHA,DET,9,8,9-8,CHA,9,false,41,42,83,155,171,326,16,15,31,4,3:27
633766,2021-06-08,2021,TBA,WAS,3,1,3-1,TBA,9,true,39,35,74,156,182,338,16,10,26,4,3:21
633988,2021-06-02,2021,LAN,SLN,14,3,14-3,LAN,9,true,45,37,82,143,190,333,20,10,30,1,3:16
633116,2021-07-30,2021,TEX,SEA,5,9,9-5,SEA,9,false,35,44,79,172,135,307,8,17,25,2,3:17
633417,2021-07-04,2021,NYA,NYN,4,2,4-2,NYA,7,true,24,26,50,115,101,216,7,5,12,2,2:14
633623,2021-06-17,2021,COL,MIL,7,3,7-3,COL,9,true,38,38,76,149,141,290,12,11,23,3,3:29
633684,2021-06-15,2021,WAS,PIT,8,1,8-1,WAS,9,true,38,36,74,116,143,259,15,9,24,1,2:42
633754,2021-06-10,2021,DET,SEA,8,3,8-3,DET,9,true,41,37,78,152,175,327,17,10,27,1,3:21
633612,2021-06-16,2021,KCA,DET,5,6,6-5,DET,9,false,39,44,83,187,132,319,12,19,31,1,3:17
633801,2021-06-08,2021,CIN,MIL,1,5,5-1,MIL,9,false,38,43,81,166,148,314,12,19,31,2,3:39
633295,2021-07-10,2021,NYN,PIT,2,6,6-2,PIT,7,false,28,32,60,117,87,204,7,13,20,0,2:22
633814,2021-06-06,2021,BAL,CLE,18,5,18-5,BAL,9,true,47,37,84,127,182,309,25,12,37,2,3:10
633749,2021-06-13,2021,MIN,HOU,3,14,14-3,HOU,9,false,35,51,86,171,122,293,10,24,34,0,3:11
633396,2021-07-06,2021,SDN,WAS,7,4,7-4,SDN,9,true,38,38,76,148,160,308,15,13,28,3,3:25
633255,2021-07-18,2021,COL,LAN,6,5,6-5,COL,10,false,40,41,81,144,149,293,10,12,22,1,3:32
633753,2021-06-09,2021,PIT,LAN,1,2,2-1,LAN,9,false,38,39,77,140,170,310,12,12,24,3,3:32 (1:10 delay)
633485,2021-06-30,2021,HOU,BAL,2,5,5-2,BAL,9,false,34,40,74,201,139,340,8,13,21,3,3:34
633231,2021-07-22,2021,SEA,OAK,1,4,4-1,OAK,9,false,35,45,80,195,127,322,8,18,26,1,3:23
633464,2021-07-02,2021,TOR,TBA,11,1,11-1,TOR,9,true,41,33,74,139,166,305,16,6,22,2,2:59
634675,2021-07-13,2021,NAS,AAS,2,5,5-2,AAS,9,false,37,38,75,137,141,278,12,11,23,2,3:00
633735,2021-06-11,2021,BOS,TOR,6,5,6-5,BOS,9,false,38,45,83,162,130,292,13,20,33,5,3:31
633717,2021-06-11,2021,OAK,KCA,4,3,4-3,OAK,9,false,35,37,72,122,146,268,11,10,21,2,3:00
633522,2021-07-04,2021,NYA,NYN,5,10,10-5,NYN,7,false,29,40,69,162,111,273,9,20,29,3,3:16
633613,2021-06-19,2021,CHN,MIA,1,11,11-1,MIA,9,false,30,43,73,167,110,277,4,15,19,0,3:07
633395,2021-07-07,2021,NYN,MIL,4,3,4-3,NYN,8,false,32,30,62,111,124,235,11,7,18,1,2:45
633725,2021-06-12,2021,CLE,SEA,5,4,5-4,CLE,10,false,40,44,84,189,145,334,15,15,30,2,3:41
633425,2021-07-04,2021,SEA,TEX,4,1,4-1,SEA,9,true,30,32,62,120,106,226,7,5,12,0,2:22
633712,2021-06-12,2021,ARI,ANA,7,8,8-7,ANA,9,false,38,44,82,167,136,303,11,18,29,1,3:23
633882,2021-06-02,2021,NYA,TBA,4,3,4-3,NYA,9,true,37,39,76,150,181,331,15,11,26,2,3:38
633602,2021-06-20,2021,HOU,CHA,8,2,8-2,HOU,9,true,44,33,77,149,169,318,22,9,31,1,3:18
633844,2021-06-02,2021,TOR,MIA,6,5,6-5,TOR,9,false,42,39,81,159,186,345,17,13,30,3,3:41
633706,2021-06-16,2021,COL,SDN,8,7,8-7,COL,9,false,40,42,82,153,147,300,16,16,32,2,3:27
633133,2021-07-26,2021,MIN,DET,6,5,6-5,MIN,10,false,46,38,84,143,165,308,20,9,29,2,3:46
633738,2021-06-09,2021,MIA,COL,3,4,4-3,COL,9,false,40,39,79,159,168,327,15,14,29,1,3:53
633184,2021-07-23,2021,CIN,SLN,6,5,6-5,CIN,9,true,40,41,81,173,139,312,16,15,31,3,3:43
633768,2021-06-11,2021,MIL,PIT,7,4,7-4,MIL,9,true,40,34,74,143,162,305,18,6,24,2,3:22
633792,2021-06-09,2021,MIN,NYA,6,9,9-6,NYA,9,false,38,44,82,163,141,304,11,18,29,1,3:08 (:11 delay)
633153,2021-07-27,2021,BAL,MIA,3,7,7-3,MIA,9,false,35,44,79,175,122,297,9,17,26,1,3:06
633514,2021-06-24,2021,CIN,ATL,5,3,5-3,CIN,9,true,39,40,79,153,146,299,17,13,30,2,3:12
633268,2021-07-20,2021,CHA,MIN,9,5,9-5,CHA,9,true,40,40,80,168,145,313,15,13,28,3,3:34
633327,2021-07-11,2021,BOS,PHI,4,5,5-4,PHI,9,false,41,37,78,151,155,306,15,10,25,6,3:35
633222,2021-07-21,2021,HOU,CLE,4,5,5-4,CLE,9,false,33,40,73,165,124,289,6,12,18,3,3:07
633783,2021-06-09,2021,CHA,TOR,2,6,6-2,TOR,9,false,35,38,73,153,155,308,8,10,18,1,3:26
633820,2021-06-04,2021,ATL,LAN,5,9,9-5,LAN,9,false,39,40,79,189,162,351,12,12,24,3,3:45
633690,2021-06-13,2021,CLE,SEA,2,6,6-2,SEA,9,false,34,43,77,171,136,307,8,16,24,2,3:17
633593,2021-06-18,2021,BAL,TOR,7,1,7-1,BAL,9,true,39,33,72,128,186,314,16,6,22,3,3:10
633596,2021-06-18,2021,SDN,CIN,8,2,8-2,SDN,9,true,41,36,77,154,160,314,18,9,27,0,3:33
633571,2021-06-22,2021,MIA,TOR,1,2,2-1,TOR,9,false,31,36,67,104,121,225,4,9,13,0,2:34
633339,2021-07-07,2021,TBA,CLE,8,1,8-1,TBA,7,true,28,27,55,106,133,239,10,6,16,2,2:13
633732,2021-06-12,2021,NYN,SDN,4,1,4-1,NYN,9,true,31,33,64,117,113,230,8,8,16,2,2:43
633779,2021-06-07,2021,SDN,CHN,9,4,9-4,SDN,9,true,44,33,77,136,191,327,20,9,29,2,3:42
633723,2021-06-12,2021,LAN,TEX,1,12,12-1,TEX,9,false,34,47,81,185,153,338,8,21,29,2,3:35
633876,2021-06-03,2021,MIL,ARI,7,4,7-4,MIL,9,true,36,45,81,180,137,317,12,18,30,2,3:09
633180,2021-07-22,2021,CLE,TBA,4,5,5-4,TBA,10,false,41,43,84,164,165,329,11,14,25,1,3:39
633634,2021-06-16,2021,CHA,TBA,8,7,8-7,CHA,10,false,41,42,83,178,133,311,13,11,24,2,3:24
633108,2021-07-30,2021,PIT,PHI,7,0,7-0,PIT,9,true,43,34,77,142,187,329,19,7,26,0,3:33
633873,2021-06-01,2021,HOU,BOS,5,1,5-1,HOU,9,true,38,33,71,131,152,283,17,6,23,1,3:23
633211,2021-07-23,2021,CLE,TBA,5,10,10-5,TBA,9,false,38,43,81,151,152,303,12,18,30,2,3:05
633559,2021-06-24,2021,NYA,KCA,8,1,8-1,NYA,9,true,42,37,79,133,180,313,19,11,30,1,3:03
633740,2021-06-12,2021,CHN,SLN,7,2,7-2,CHN,9,true,35,36,71,147,152,299,14,9,23,3,3:19
633622,2021-06-17,2021,SFN,ARI,10,3,10-3,SFN,9,true,42,33,75,109,162,271,19,6,25,1,2:54
633650,2021-06-19,2021,ANA,DET,8,3,8-3,ANA,9,true,41,36,77,132,138,270,18,10,28,4,3:02
633641,2021-06-17,2021,CLE,BAL,10,3,10-3,CLE,9,true,40,38,78,152,154,306,16,10,26,4,3:03
633147,2021-07-27,2021,NYN,ATL,5,12,12-5,ATL,9,false,39,45,84,172,143,315,12,18,30,1,3:10
633193,2021-07-22,2021,BOS,NYA,5,4,5-4,BOS,10,false,41,39,80,174,150,324,12,10,22,3,3:48 (:55 delay)
633577,2021-06-19,2021,COL,MIL,5,6,6-5,MIL,9,false,42,41,83,155,150,305,17,15,32,0,3:40
633756,2021-06-09,2021,TEX,SFN,4,3,4-3,TEX,11,false,38,40,78,150,156,306,10,8,18,1,3:28
633276,2021-07-22,2021,PHI,ATL,2,7,7-2,ATL,9,false,37,41,78,150,150,300,11,15,26,2,3:09
633871,2021-06-01,2021,SEA,OAK,6,12,12-6,OAK,9,false,41,46,87,174,172,346,14,20,34,3,3:33
633758,2021-06-10,2021,BOS,HOU,12,8,12-8,BOS,9,true,45,39,84,173,164,337,20,14,34,3,3:47
633111,2021-07-29,2021,ANA,OAK,0,4,4-0,OAK,9,false,34,38,72,156,139,295,7,11,18,2,3:14
633769,2021-06-15,2021,CLE,BAL,7,2,7-2,CLE,9,true,40,35,75,166,156,322,13,8,21,2,3:21
633300,2021-07-18,2021,WAS,SDN,8,7,8-7,WAS,9,false,46,40,86,155,156,311,23,13,36,0,3:40
633239,2021-07-18,2021,PHI,MIA,7,4,7-4,PHI,9,true,39,39,78,146,139,285,17,13,30,2,3:28
633567,2021-06-20,2021,COL,MIL,6,7,7-6,MIL,9,false,40,40,80,141,163,304,13,15,28,3,3:35
633325,2021-07-11,2021,NYN,PIT,5,6,6-5,PIT,9,false,38,43,81,160,149,309,13,18,31,3,3:27
633558,2021-06-20,2021,KCA,BOS,7,3,7-3,KCA,9,true,42,40,82,140,166,306,18,14,32,3,3:35
633520,2021-06-26,2021,TOR,BAL,12,4,12-4,TOR,9,true,43,35,78,125,171,296,19,9,28,2,2:51
633543,2021-06-25,2021,BOS,NYA,5,3,5-3,BOS,9,true,37,37,74,152,157,309,11,12,23,3,3:37 (:07 delay)
633168,2021-07-26,2021,PHI,WAS,6,5,6-5,PHI,9,false,40,42,82,147,152,299,17,17,34,2,3:37
633505,2021-06-24,2021,LAN,CHN,0,4,4-0,CHN,9,false,33,38,71,152,139,291,8,14,22,1,3:12
633269,2021-07-22,2021,MIA,SDN,2,3,3-2,SDN,9,false,36,44,80,189,137,326,10,17,27,6,3:58
633868,2021-06-01,2021,CIN,PHI,3,17,17-3,PHI,9,false,34,51,85,204,139,343,12,24,36,5,3:36
633861,2021-06-01,2021,NYA,TBA,5,3,5-3,NYA,11,false,45,42,87,186,165,351,14,9,23,1,3:45
633461,2021-06-30,2021,OAK,TEX,3,1,3-1,OAK,9,true,30,35,65,138,110,248,6,8,14,0,2:34
633759,2021-06-09,2021,DET,SEA,6,9,9-6,SEA,11,false,41,47,88,180,160,340,11,19,30,2,3:43
633145,2021-07-26,2021,NYN,ATL,0,2,2-0,ATL,7,false,26,32,58,97,96,193,7,13,20,0,2:12
633382,2021-07-06,2021,SEA,NYA,1,12,12-1,NYA,9,false,36,51,87,210,136,346,9,24,33,1,3:37
633620,2021-06-25,2021,CHA,SEA,3,9,9-3,SEA,9,false,36,48,84,191,145,336,12,22,34,1,3:31
633451,2021-07-02,2021,CLE,HOU,3,6,6-3,HOU,9,false,45,39,84,157,176,333,18,12,30,2,3:29
633287,2021-07-18,2021,KCA,BAL,0,5,5-0,BAL,9,false,36,41,77,166,135,301,9,12,21,1,3:06
633752,2021-06-08,2021,TEX,SFN,4,9,9-4,SFN,9,false,36,44,80,182,145,327,13,19,32,4,3:28
633502,2021-06-24,2021,SLN,PIT,2,8,8-2,PIT,9,false,35,45,80,157,147,304,10,21,31,2,3:10
633780,2021-06-06,2021,TOR,HOU,3,6,6-3,HOU,9,false,37,46,83,177,134,311,10,19,29,4,3:32
633608,2021-06-25,2021,LAN,CHN,6,2,6-2,LAN,9,true,39,37,76,152,148,300,14,10,24,5,3:42
633522,2021-07-04,2021,NYA,NYN,5,10,10-5,NYN,7,false,29,40,69,162,111,273,9,20,29,3,3:16
633683,2021-06-18,2021,KCA,BOS,5,3,5-3,KCA,9,true,37,38,75,152,149,301,15,13,28,1,3:20
633850,2021-06-05,2021,COL,OAK,3,6,6-3,OAK,9,false,37,40,77,119,124,243,12,16,28,1,2:46
633863,2021-06-01,2021,ATL,WAS,6,11,11-6,WAS,9,false,41,45,86,174,170,344,12,18,30,4,3:54
633085,2021-07-31,2021,TOR,KCA,4,0,4-0,TOR,9,true,30,32,62,121,109,230,6,5,11,1,2:19
633315,2021-07-08,2021,SEA,NYA,4,0,4-0,SEA,9,true,31,29,60,124,127,251,7,3,10,1,2:27
633377,2021-07-09,2021,BAL,CHA,1,12,12-1,CHA,9,false,35,52,87,205,127,332,8,24,32,3,3:30
633802,2021-06-06,2021,TEX,TBA,1,7,7-1,TBA,9,false,39,42,81,182,156,338,14,15,29,3,3:45
633655,2021-06-14,2021,KCA,DET,3,10,10-3,DET,9,false,43,41,84,149,184,333,18,14,32,3,3:32
633597,2021-06-19,2021,SDN,CIN,7,5,7-5,SDN,9,true,39,38,77,146,157,303,15,13,28,2,3:24
633812,2021-06-06,2021,NYA,BOS,5,6,6-5,BOS,10,false,46,40,86,151,185,336,20,10,30,1,3:49
633158,2021-07-27,2021,SEA,HOU,6,8,8-6,HOU,9,false,40,43,83,169,159,328,13,17,30,0,3:26
633384,2021-07-06,2021,PIT,ATL,2,1,2-1,PIT,9,false,39,33,72,148,156,304,16,8,24,0,3:20
633843,2021-06-06,2021,ANA,SEA,5,9,9-5,SEA,9,false,42,43,85,173,188,361,15,16,31,4,3:57
633714,2021-06-15,2021,MIL,CIN,1,2,2-1,CIN,10,false,38,35,73,145,178,323,9,7,16,1,3:15
633471,2021-06-29,2021,LAN,SFN,3,1,3-1,LAN,9,true,33,33,66,142,121,263,9,6,15,1,3:00
633770,2021-06-10,2021,OAK,KCA,1,6,6-1,KCA,9,false,30,37,67,136,128,264,4,10,14,1,2:41
633878,2021-06-01,2021,MIL,DET,7,10,10-7,DET,9,false,39,47,86,203,166,369,12,20,32,2,3:37
633109,2021-07-29,2021,SFN,LAN,5,0,5-0,SFN,9,true,39,31,70,118,121,239,18,6,24,2,2:45
633097,2021-07-28,2021,TEX,ARI,2,3,3-2,ARI,9,false,35,32,67,131,115,246,8,5,13,0,2:42
633270,2021-07-11,2021,TBA,TOR,1,3,3-1,TOR,9,false,31,35,66,119,131,250,4,9,13,0,2:32
633582,2021-06-20,2021,ARI,LAN,8,9,9-8,LAN,9,false,42,48,90,196,139,335,15,22,37,4,3:39
633359,2021-07-08,2021,MIN,DET,5,3,5-3,MIN,9,true,33,34,67,123,120,243,8,9,17,1,2:23
633282,2021-07-11,2021,BAL,CHA,5,7,7-5,CHA,10,false,40,42,82,188,167,355,10,14,24,5,3:47
633235,2021-07-18,2021,PIT,NYN,6,7,7-6,NYN,9,false,43,45,88,170,166,336,17,18,35,3,3:49 (3:48 delay)
633128,2021-07-30,2021,CHA,CLE,6,4,6-4,CHA,9,true,42,39,81,174,168,342,19,13,32,3,3:42
633808,2021-06-06,2021,SLN,CIN,7,8,8-7,CIN,9,false,43,41,84,162,184,346,18,15,33,2,3:50
633358,2021-07-06,2021,SFN,SLN,5,6,6-5,SLN,9,false,45,40,85,152,166,318,19,14,33,4,3:28
633869,2021-06-06,2021,SFN,CHN,3,4,4-3,CHN,9,false,37,37,74,135,129,264,12,10,22,4,3:01
633726,2021-06-12,2021,MIL,PIT,7,4,7-4,MIL,9,true,37,41,78,161,151,312,13,15,28,2,3:34
633274,2021-07-11,2021,MIL,CIN,1,3,3-1,CIN,9,false,36,40,76,166,164,330,11,15,26,4,3:48
633250,2021-07-21,2021,ATL,SDN,2,3,3-2,SDN,7,false,27,31,58,136,112,248,5,11,16,0,2:36
633807,2021-06-05,2021,BAL,CLE,4,10,10-4,CLE,9,false,39,41,80,181,153,334,12,14,26,4,3:28
633297,2021-07-11,2021,TEX,OAK,1,4,4-1,OAK,9,false,34,33,67,120,130,250,8,6,14,0,2:39
633419,2021-06-30,2021,PHI,MIA,6,11,11-6,MIA,9,false,40,48,88,190,154,344,14,19,33,3,4:06 (:38 delay)
633288,2021-07-10,2021,SEA,ANA,2,0,2-0,SEA,9,true,34,31,65,119,137,256,11,5,16,1,2:50
633224,2021-07-21,2021,ATL,SDN,5,6,6-5,SDN,7,false,31,33,64,156,162,318,11,14,25,3,3:17 (4:08 delay)
633143,2021-07-27,2021,TBA,NYA,3,4,4-3,NYA,9,false,39,42,81,147,194,341,15,18,33,1,3:38
633420,2021-07-02,2021,DET,CHA,2,8,8-2,CHA,9,false,41,40,81,154,184,338,15,13,28,2,3:31
633218,2021-07-19,2021,TOR,BOS,4,13,13-4,BOS,9,false,39,48,87,200,140,340,14,21,35,3,3:32
633440,2021-07-03,2021,NYA,NYN,3,8,8-3,NYN,9,false,35,47,82,177,162,339,7,19,26,4,3:40
633729,2021-06-14,2021,OAK,ANA,8,5,8-5,OAK,9,true,42,45,87,163,164,327,19,18,37,4,3:23
633694,2021-06-15,2021,SLN,MIA,2,1,2-1,SLN,9,false,29,36,65,142,123,265,7,9,16,0,2:54
633535,2021-06-25,2021,TBA,ANA,4,3,4-3,TBA,9,true,37,34,71,123,138,261,15,6,21,2,2:53
633370,2021-07-06,2021,ANA,BOS,5,3,5-3,ANA,9,true,35,34,69,119,136,255,13,7,20,1,2:54
633141,2021-07-29,2021,KCA,CHA,5,0,5-0,KCA,9,true,35,31,66,132,138,270,11,6,17,0,2:46
633412,2021-07-05,2021,NYN,MIL,4,2,4-2,NYN,9,true,31,35,66,147,106,253,8,9,17,2,2:58
633221,2021-07-23,2021,NYN,TOR,3,0,3-0,NYN,9,true,32,31,63,114,130,244,9,4,13,1,2:33
633185,2021-07-24,2021,CLE,TBA,2,8,8-2,TBA,9,false,34,42,76,134,123,257,6,15,21,2,2:59
633592,2021-06-19,2021,SFN,PHI,6,13,13-6,PHI,9,false,37,50,87,182,161,343,12,22,34,2,3:47
633529,2021-07-01,2021,CHA,MIN,8,5,8-5,CHA,9,true,41,42,83,180,174,354,18,15,33,2,3:49
633511,2021-07-02,2021,SEA,TEX,5,4,5-4,SEA,10,false,44,39,83,172,189,361,17,9,26,4,4:19
633206,2021-07-26,2021,SEA,HOU,11,8,11-8,SEA,9,true,37,42,79,171,168,339,14,15,29,4,3:54
633338,2021-07-09,2021,TBA,TOR,7,1,7-1,TBA,9,true,40,35,75,163,183,346,15,8,23,3,3:31
633785,2021-06-08,2021,PHI,ATL,5,9,9-5,ATL,9,false,42,41,83,154,161,315,17,16,33,3,3:45 (:42 delay)
633633,2021-06-17,2021,TOR,NYA,4,8,8-4,NYA,9,false,36,46,82,192,125,317,13,17,30,7,3:43
633456,2021-07-01,2021,TOR,SEA,2,7,7-2,SEA,9,false,35,43,78,187,141,328,10,16,26,3,3:23
633598,2021-06-19,2021,ARI,LAN,3,9,9-3,LAN,9,false,34,46,80,178,146,324,8,18,26,1,3:06
633804,2021-06-08,2021,MIN,NYA,4,8,8-4,NYA,9,false,37,46,83,168,134,302,10,16,26,3,3:32
633829,2021-06-15,2021,HOU,TEX,6,3,6-3,HOU,10,false,37,42,79,157,155,312,12,10,22,2,3:34
633304,2021-07-10,2021,HOU,NYA,0,1,1-0,NYA,9,false,31,35,66,144,129,273,5,9,14,0,3:00
633468,2021-07-02,2021,ATL,MIA,1,0,1-0,ATL,9,true,29,36,65,143,124,267,5,12,17,3,3:24
633601,2021-06-28,2021,NYA,ANA,3,5,5-3,ANA,9,false,33,40,73,149,122,271,7,13,20,3,3:06
633782,2021-06-11,2021,MIA,ATL,4,3,4-3,MIA,9,true,36,40,76,153,152,305,13,13,26,1,3:23
633275,2021-07-17,2021,DET,MIN,5,4,5-4,DET,8,false,31,33,64,124,129,253,8,10,18,2,2:56
633326,2021-07-10,2021,NYN,PIT,4,2,4-2,NYN,7,true,31,30,61,119,137,256,14,9,23,1,2:54
633645,2021-06-16,2021,SFN,ARI,13,7,13-7,SFN,9,true,46,41,87,163,194,357,23,12,35,1,3:36
633273,2021-07-18,2021,NYA,BOS,9,1,9-1,NYA,9,true,38,37,75,168,160,328,15,10,25,4,3:44
633680,2021-06-14,2021,MIL,CIN,2,10,10-2,CIN,9,false,33,45,78,172,148,320,6,18,24,0,3:18
633713,2021-06-13,2021,MIL,PIT,5,2,5-2,MIL,9,true,30,39,69,144,130,274,6,14,20,2,3:09
633415,2021-07-02,2021,COL,SLN,3,9,9-3,SLN,10,false,43,45,88,170,151,321,13,18,31,4,3:50
633825,2021-06-04,2021,SLN,CIN,4,6,6-4,CIN,9,false,39,42,81,146,159,305,11,18,29,5,3:26
633418,2021-07-01,2021,ATL,NYN,4,3,4-3,ATL,9,false,38,36,74,130,147,277,13,9,22,0,3:05
633562,2021-06-26,2021,LAN,CHN,3,2,3-2,LAN,9,false,36,34,70,125,138,263,13,8,21,4,3:12
633438,2021-07-01,2021,ARI,SFN,5,3,5-3,ARI,9,true,34,36,70,126,135,261,12,10,22,0,2:37
633400,2021-07-05,2021,TEX,DET,3,7,7-3,DET,9,false,33,41,74,153,116,269,7,12,19,2,2:55
633516,2021-06-27,2021,TEX,KCA,4,1,4-1,TEX,9,true,34,35,69,124,141,265,10,9,19,0,2:49
633761,2021-06-11,2021,LAN,TEX,12,1,12-1,LAN,9,true,45,37,82,155,160,315,21,8,29,1,3:05
633131,2021-07-30,2021,ATL,MIL,5,9,9-5,MIL,9,false,39,45,84,174,162,336,14,18,32,2,3:37
633563,2021-06-20,2021,ANA,DET,3,5,5-3,DET,10,false,39,46,85,222,151,373,12,18,30,3,4:03
633177,2021-07-25,2021,CIN,SLN,6,10,10-6,SLN,9,false,46,45,91,187,182,369,20,19,39,4,4:04
633404,2021-07-02,2021,WAS,LAN,5,10,10-5,LAN,9,false,38,42,80,178,140,318,9,16,25,3,3:16
633301,2021-07-10,2021,SDN,COL,0,3,3-0,COL,9,false,31,40,71,163,111,274,6,13,19,1,3:06
633510,2021-06-26,2021,CIN,ATL,4,1,4-1,CIN,9,true,30,38,68,145,126,271,7,12,19,0,2:35
633322,2021-07-09,2021,SFN,WAS,5,3,5-3,SFN,9,true,35,40,75,135,123,258,12,15,27,2,2:57
633345,2021-07-09,2021,TEX,OAK,3,2,3-2,TEX,9,true,32,36,68,144,138,282,10,11,21,2,3:03
633210,2021-07-24,2021,MIA,SDN,3,2,3-2,MIA,9,true,36,32,68,108,151,259,13,7,20,1,2:58
633372,2021-08-30,2021,DET,MIN,2,3,3-2,MIN,9,false,34,34,68,119,125,244,8,8,16,1,2:42
633115,2021-07-29,2021,DET,BAL,6,2,6-2,DET,9,true,38,35,73,122,130,252,15,10,25,0,2:35
633207,2021-07-20,2021,OAK,ANA,6,0,6-0,OAK,9,true,34,37,71,143,121,264,11,10,21,1,3:01
633139,2021-07-27,2021,ANA,COL,3,12,12-3,COL,9,false,41,51,92,211,155,366,14,22,36,2,3:53
633763,2021-06-12,2021,PHI,NYA,8,7,8-7,PHI,10,false,47,42,89,168,187,355,20,14,34,1,4:02
633599,2021-06-25,2021,MIL,COL,5,4,5-4,MIL,11,false,44,42,86,179,176,355,14,9,23,3,4:21
633492,2021-06-25,2021,SDN,ARI,11,5,11-5,SDN,9,true,42,45,87,180,154,334,19,18,37,2,3:31
633867,2021-06-28,2021,CIN,PHI,12,4,12-4,CIN,9,true,41,39,80,136,167,303,17,12,29,3,3:18
633605,2021-06-21,2021,TEX,OAK,8,3,8-3,TEX,9,true,37,39,76,157,125,282,14,12,26,2,3:12
633787,2021-06-05,2021,PIT,MIA,8,7,8-7,PIT,12,false,49,49,98,208,172,380,14,15,29,1,4:20
633246,2021-08-07,2021,TOR,BOS,1,2,2-1,BOS,8,false,32,31,63,130,140,270,9,9,18,2,2:59
633414,2021-07-04,2021,CLE,HOU,3,4,4-3,HOU,10,false,35,42,77,159,119,278,6,11,17,3,3:16
633654,2021-06-18,2021,ANA,DET,11,3,11-3,ANA,9,true,40,38,78,176,161,337,17,11,28,2,3:32
633538,2021-06-24,2021,MIN,CLE,1,4,4-1,CLE,9,false,34,37,71,129,134,263,8,12,20,2,2:58
633439,2021-07-03,2021,KCA,MIN,6,3,6-3,KCA,9,true,36,39,75,138,129,267,13,14,27,0,2:57
633428,2021-07-04,2021,CIN,CHN,3,2,3-2,CIN,9,true,34,37,71,127,127,254,11,13,24,4,2:59
633330,2021-07-07,2021,PIT,ATL,3,14,14-3,ATL,9,false,44,52,96,206,163,369,19,26,45,3,4:08 (1:18 delay)
633484,2021-06-30,2021,NYA,ANA,8,11,11-8,ANA,9,false,42,45,87,181,158,339,19,17,36,4,3:44 (2:13 delay)
633653,2021-06-15,2021,TOR,NYA,5,6,6-5,NYA,9,false,41,42,83,164,158,322,15,15,30,4,3:31
633424,2021-07-03,2021,COL,SLN,3,2,3-2,COL,9,true,34,38,72,172,116,288,12,12,24,3,3:23
633755,2021-06-15,2021,KCA,DET,3,4,4-3,DET,9,false,35,36,71,145,145,290,10,10,20,2,2:49
633466,2021-06-28,2021,CLE,DET,13,5,13-5,CLE,9,true,44,35,79,133,161,294,21,8,29,2,2:58
633429,2021-07-03,2021,CLE,HOU,2,3,3-2,HOU,9,false,32,39,71,167,128,295,6,15,21,3,3:24
633409,2021-07-08,2021,CLE,KCA,7,4,7-4,CLE,9,false,40,35,75,138,141,279,16,9,25,0,3:10 (:12 delay)
633504,2021-06-27,2021,NYN,PHI,2,4,4-2,PHI,9,false,36,40,76,141,137,278,9,13,22,0,3:21
633266,2021-07-16,2021,TOR,TEX,10,2,10-2,TOR,9,true,38,37,75,143,146,289,14,10,24,1,2:58
633363,2021-07-05,2021,KCA,CIN,2,6,6-2,CIN,9,false,37,38,75,147,130,277,10,13,23,1,3:00
633507,2021-07-02,2021,PIT,MIL,2,7,7-2,MIL,9,false,36,37,73,136,143,279,9,12,21,1,2:52
633368,2021-07-07,2021,HOU,OAK,4,3,4-3,HOU,9,true,29,36,65,163,112,275,4,9,13,1,2:58
633123,2021-07-28,2021,CLE,SLN,7,2,7-2,CLE,9,true,36,36,72,143,142,285,14,9,23,1,3:08
633434,2021-07-04,2021,COL,SLN,3,2,3-2,COL,9,false,35,36,71,141,126,267,11,10,21,3,3:16
633445,2021-06-30,2021,TOR,SEA,7,9,9-7,SEA,10,false,46,46,92,172,190,362,18,15,33,4,4:12
633408,2021-07-04,2021,TOR,TBA,1,5,5-1,TBA,9,false,32,37,69,144,126,270,6,11,17,1,2:53
633731,2021-06-11,2021,ARI,ANA,5,6,6-5,ANA,10,false,45,46,91,168,181,349,14,18,32,4,4:09
633376,2021-07-06,2021,MIA,LAN,2,1,2-1,MIA,10,false,40,44,84,186,177,363,13,16,29,3,4:34
633303,2021-07-17,2021,ATL,TBA,9,0,9-0,ATL,9,true,38,33,71,121,127,248,15,6,21,1,2:33
633354,2021-07-08,2021,HOU,OAK,1,2,2-1,OAK,9,false,33,38,71,130,120,250,8,10,18,1,2:52
633299,2021-07-17,2021,PHI,MIA,4,2,4-2,PHI,10,false,38,37,75,154,135,289,10,9,19,0,3:30 (1:15 delay)
633477,2021-06-27,2021,BOS,NYA,9,2,9-2,BOS,9,true,39,36,75,151,146,297,16,10,26,1,3:09
633380,2021-07-05,2021,SFN,SLN,3,5,5-3,SLN,9,false,35,38,73,156,127,283,9,12,21,0,3:04
633371,2021-07-07,2021,SEA,NYA,4,5,5-4,NYA,9,false,34,40,74,140,151,291,8,13,21,1,3:02
633473,2021-06-27,2021,MIN,CLE,8,2,8-2,MIN,9,true,38,36,74,155,142,297,15,9,24,2,2:58
633385,2021-07-07,2021,ANA,BOS,5,4,5-4,ANA,9,true,34,37,71,162,129,291,11,11,22,1,2:55
633310,2021-07-16,2021,NYA,BOS,0,4,4-0,BOS,9,false,33,35,68,149,149,298,6,8,14,1,3:03
633249,2021-07-19,2021,OAK,ANA,4,1,4-1,OAK,9,true,34,35,69,116,144,260,10,10,20,3,2:51
633495,2021-06-29,2021,PHI,MIA,4,3,4-3,PHI,9,true,35,34,69,149,146,295,11,7,18,3,3:25
633347,2021-07-07,2021,SFN,SLN,5,2,5-2,SFN,9,true,41,35,76,129,166,295,18,9,27,3,3:07
633453,2021-07-03,2021,ANA,BAL,4,1,4-1,ANA,9,true,39,31,70,131,149,280,18,6,24,3,2:52
633264,2021-07-16,2021,OAK,CLE,5,4,5-4,OAK,9,false,40,35,75,144,149,293,15,9,24,1,2:58
633470,2021-07-02,2021,ARI,SFN,4,11,11-4,SFN,9,false,37,45,82,181,152,333,11,20,31,2,3:40
633126,2021-07-29,2021,BOS,TOR,1,13,13-1,TOR,9,false,38,50,88,192,148,340,8,23,31,1,3:24
633727,2021-06-14,2021,SLN,MIA,4,2,4-2,SLN,9,true,35,33,68,139,119,258,14,8,22,1,3:02
633556,2021-06-25,2021,TEX,KCA,9,4,9-4,TEX,9,true,38,36,74,146,127,273,16,10,26,2,2:51
633279,2021-07-11,2021,SFN,WAS,3,1,3-1,SFN,9,true,35,33,68,138,135,273,13,8,21,1,2:53
633324,2021-07-11,2021,MIA,ATL,7,4,7-4,MIA,9,true,40,35,75,119,173,292,18,8,26,1,3:05
633430,2021-07-03,2021,WAS,LAN,3,5,5-3,LAN,9,false,35,38,73,153,128,281,10,11,21,3,3:21 (1:44 delay)
633114,2021-07-28,2021,KCA,CHA,3,2,3-2,KCA,10,false,35,35,70,150,120,270,7,7,14,2,3:06
633213,2021-07-21,2021,NYA,PHI,6,5,6-5,NYA,10,false,42,46,88,207,165,372,14,16,30,3,4:17
633190,2021-07-21,2021,COL,SEA,6,3,6-3,COL,9,true,34,32,66,119,125,244,11,6,17,0,2:35
633708,2021-06-16,2021,ATL,BOS,8,10,10-8,BOS,9,false,47,44,91,179,181,360,19,17,36,4,4:10
633406,2021-07-06,2021,HOU,OAK,9,6,9-6,HOU,9,true,39,38,77,134,167,301,16,13,29,2,3:15
633479,2021-06-30,2021,CHA,MIN,13,3,13-3,CHA,9,true,41,34,75,130,179,309,17,8,25,1,3:04
633734,2021-06-14,2021,SFN,ARI,5,2,5-2,SFN,9,true,41,36,77,141,156,297,19,9,28,1,2:59
633405,2021-07-01,2021,OAK,TEX,3,8,8-3,TEX,9,false,38,43,81,164,137,301,11,18,29,1,2:52
633616,2021-06-18,2021,COL,MIL,6,5,6-5,COL,10,false,42,41,83,128,153,281,15,14,29,3,3:30
633334,2021-07-08,2021,MIA,LAN,1,6,6-1,LAN,9,false,36,43,79,177,127,304,10,14,24,1,3:05
633122,2021-07-28,2021,TBA,NYA,1,3,3-1,NYA,10,false,35,38,73,147,146,293,6,9,15,2,3:25
633238,2021-07-18,2021,OAK,CLE,2,4,4-2,CLE,9,false,32,39,71,140,127,267,6,12,18,1,2:55
633478,2021-06-29,2021,CHA,MIN,7,6,7-6,CHA,9,true,38,34,72,148,150,298,15,11,26,4,3:20 (:10 delay)
633226,2021-07-19,2021,SLN,CHN,8,3,8-3,SLN,9,true,38,36,74,131,138,269,13,10,23,2,3:00
633398,2021-07-04,2021,WAS,LAN,1,5,5-1,LAN,9,false,35,41,76,150,147,297,11,14,25,3,3:37
633151,2021-07-25,2021,MIL,CHA,1,3,3-1,CHA,9,false,37,34,71,137,149,286,10,9,19,1,3:13
633579,2021-06-18,2021,TEX,MIN,5,7,7-5,MIN,10,false,43,44,87,180,173,353,12,17,29,1,3:44
633515,2021-06-27,2021,TOR,BAL,5,2,5-2,TOR,9,true,36,37,73,166,145,311,16,10,26,3,3:15
633431,2021-07-04,2021,KCA,MIN,2,6,6-2,MIN,9,false,35,40,75,150,154,304,8,14,22,1,3:11
633328,2021-07-16,2021,KCA,BAL,9,2,9-2,KCA,9,true,42,34,76,134,151,285,19,9,28,0,3:01
633312,2021-07-10,2021,MIA,ATL,4,5,5-4,ATL,9,false,39,37,76,147,150,297,12,10,22,1,3:37
633323,2021-07-16,2021,ANA,SEA,5,6,6-5,SEA,9,false,40,38,78,158,128,286,13,13,26,3,3:07
633498,2021-06-25,2021,SLN,PIT,4,5,5-4,PIT,9,false,43,38,81,146,163,309,16,13,29,5,3:46
633106,2021-07-31,2021,TEX,SEA,5,4,5-4,TEX,10,false,33,39,72,150,128,278,7,12,19,3,3:19
633083,2021-07-29,2021,NYN,ATL,3,6,6-3,ATL,9,false,37,38,75,136,136,272,13,11,24,1,2:53
633296,2021-07-16,2021,ARI,CHN,1,5,5-1,CHN,9,false,36,36,72,131,153,284,11,12,23,0,3:09
633767,2021-06-09,2021,TBA,WAS,7,9,9-7,WAS,11,false,48,48,96,191,209,400,16,16,32,2,4:19
633426,2021-06-30,2021,SLN,ARI,7,4,7-4,SLN,9,true,38,41,79,168,131,299,13,14,27,2,3:20
633148,2021-07-28,2021,NYN,ATL,2,1,2-1,NYN,9,true,31,36,67,141,116,257,9,10,19,2,3:01
633383,2021-07-07,2021,KCA,CIN,2,5,5-2,CIN,9,false,37,42,79,163,132,295,12,16,28,2,3:09 (1:12 delay)
633318,2021-07-11,2021,SEA,ANA,1,7,7-1,ANA,9,false,35,43,78,159,148,307,8,16,24,4,3:32
633719,2021-06-13,2021,LAN,TEX,5,3,5-3,LAN,9,true,36,42,78,152,146,298,15,15,30,2,3:15
633248,2021-07-17,2021,KCA,BAL,4,8,8-4,BAL,9,false,38,42,80,153,147,300,12,15,27,2,3:03
633433,2021-07-02,2021,KCA,MIN,7,4,7-4,KCA,9,true,39,39,78,151,157,308,16,12,28,2,3:18
633113,2021-07-28,2021,PIT,MIL,3,7,7-3,MIL,9,false,36,41,77,132,144,276,9,16,25,1,3:01
633476,2021-07-19,2021,CHA,MIN,5,3,5-3,CHA,7,false,24,25,49,94,94,188,6,6,12,0,1:54
633524,2021-06-23,2021,TBA,BOS,8,2,8-2,TBA,9,true,42,39,81,159,169,328,17,13,30,2,3:31
633379,2021-07-03,2021,SEA,TEX,3,7,7-3,TEX,9,false,38,41,79,156,173,329,11,14,25,1,3:12
633391,2021-07-04,2021,ANA,BAL,6,5,6-5,ANA,9,false,36,37,73,155,138,293,12,12,24,3,3:04
633410,2021-07-04,2021,DET,CHA,6,5,6-5,DET,9,true,36,42,78,167,154,321,13,17,30,4,3:25
633293,2021-07-10,2021,TBA,TOR,5,2,5-2,TBA,9,true,35,36,71,173,154,327,12,10,22,4,3:19
633117,2021-07-31,2021,ATL,MIL,8,1,8-1,ATL,9,true,40,39,79,143,153,296,16,12,28,2,3:27
633092,2021-07-31,2021,MIA,NYA,2,4,4-2,NYA,9,false,33,41,74,163,125,288,6,15,21,2,3:25
633397,2021-07-08,2021,CHN,PHI,0,8,8-0,PHI,9,false,33,42,75,158,144,302,8,15,23,0,3:15
633463,2021-07-01,2021,PIT,MIL,2,7,7-2,MIL,9,false,33,43,76,176,126,302,7,17,24,3,3:37
633375,2021-07-07,2021,CHN,PHI,8,3,8-3,CHN,9,true,36,35,71,143,121,264,11,8,19,2,2:54 (:12 delay)
633805,2021-06-13,2021,MIA,ATL,4,6,6-4,ATL,9,false,37,43,80,174,149,323,10,19,29,1,3:45
633411,2021-07-05,2021,PIT,ATL,11,1,11-1,PIT,9,true,42,37,79,159,164,323,19,12,31,2,3:31
633333,2021-07-07,2021,MIA,LAN,9,6,9-6,MIA,9,false,40,38,78,156,155,311,14,11,25,3,3:46
633413,2021-07-06,2021,BAL,TOR,7,5,7-5,BAL,9,true,39,37,76,145,159,304,14,11,25,3,3:03
633063,2021-07-31,2021,NYN,CIN,5,4,5-4,NYN,10,false,35,41,76,161,146,307,10,13,23,2,3:22
633167,2021-07-24,2021,MIL,CHA,6,1,6-1,MIL,9,true,36,33,69,137,143,280,10,8,18,0,3:10
633285,2021-07-16,2021,SLN,SFN,2,7,7-2,SFN,9,false,42,39,81,140,164,304,15,13,28,3,3:22
633500,2021-06-26,2021,SFN,OAK,6,5,6-5,SFN,10,false,44,39,83,171,203,374,17,9,26,4,4:05
633437,2021-06-30,2021,ATL,NYN,20,2,20-2,ATL,9,true,50,33,83,119,195,314,27,7,34,3,3:21
633201,2021-07-24,2021,KCA,DET,9,8,9-8,KCA,9,true,40,41,81,148,158,306,15,14,29,5,3:23
633392,2021-07-08,2021,ARI,COL,3,9,9-3,COL,9,false,37,46,83,176,134,310,10,19,29,0,3:23
633356,2021-07-10,2021,CHN,SLN,0,6,6-0,SLN,9,false,34,42,76,193,140,333,8,14,22,2,3:32
633090,2021-07-31,2021,TBA,BOS,9,5,9-5,TBA,9,true,38,39,77,161,164,325,12,14,26,4,3:34
633272,2021-07-24,2021,NYN,TOR,3,10,10-3,TOR,9,false,39,46,85,160,143,303,16,20,36,4,3:33
634222,2021-07-17,2021,DET,MIN,1,0,1-0,DET,7,true,25,23,48,85,100,185,7,2,9,1,1:55
633076,2021-07-31,2021,PIT,PHI,3,2,3-2,PIT,9,false,33,38,71,132,140,272,8,12,20,1,2:59
633104,2021-07-29,2021,TBA,NYA,14,0,14-0,TBA,9,true,41,33,74,143,170,313,16,7,23,3,2:59
633378,2021-07-05,2021,SDN,WAS,5,7,7-5,WAS,9,false,41,43,84,179,158,337,15,14,29,1,3:44
633361,2021-07-05,2021,MIA,LAN,5,4,5-4,MIA,9,true,36,42,78,184,148,332,13,13,26,2,3:48
633374,2021-07-04,2021,PHI,SDN,1,11,11-1,SDN,9,false,35,45,80,180,139,319,12,23,35,2,3:45
633112,2021-07-30,2021,SDN,COL,4,9,9-4,COL,9,false,35,43,78,169,141,310,10,18,28,1,3:17
633442,2021-07-03,2021,DET,CHA,11,5,11-5,DET,9,true,40,36,76,150,180,330,18,11,29,2,3:07
633341,2021-07-09,2021,SEA,ANA,7,3,7-3,SEA,9,true,39,37,76,151,163,314,14,11,25,6,3:31
633164,2021-07-23,2021,MIA,SDN,2,5,5-2,SDN,9,false,36,38,74,153,156,309,11,10,21,2,3:25
633320,2021-07-09,2021,LAN,ARI,2,5,5-2,ARI,9,false,35,46,81,187,115,302,8,17,25,2,3:34
633389,2021-07-05,2021,ANA,BOS,4,5,5-4,BOS,9,false,38,42,80,185,140,325,13,14,27,4,3:46
633343,2021-07-08,2021,SDN,WAS,9,8,9-8,SDN,9,false,41,40,81,151,173,324,16,13,29,2,3:40
633636,2021-06-20,2021,BAL,TOR,4,7,7-4,TOR,9,false,34,46,80,169,131,300,8,19,27,1,3:05
633512,2021-06-26,2021,SDN,ARI,1,10,10-1,ARI,9,false,40,44,84,153,162,315,14,19,33,2,3:35
633444,2021-06-29,2021,NYA,ANA,11,5,11-5,NYA,9,true,43,38,81,140,196,336,20,13,33,3,3:31
633134,2021-07-29,2021,PHI,WAS,11,8,11-8,PHI,8,false,39,44,83,148,146,294,18,23,41,2,3:18
633580,2021-06-22,2021,MIN,CIN,7,10,10-7,CIN,9,false,40,43,83,177,149,326,13,17,30,3,3:29
633369,2021-07-06,2021,KCA,CIN,7,6,7-6,KCA,9,false,39,40,79,182,153,335,11,15,26,5,3:32
633134,2021-07-29,2021,PHI,WAS,11,8,11-8,PHI,8,false,39,44,83,148,146,294,18,23,41,2,3:18
633271,2021-07-19,2021,CIN,NYN,11,15,15-11,NYN,11,false,57,52,109,190,209,399,22,21,43,6,4:45
633530,2021-06-26,2021,DET,HOU,3,1,3-1,DET,7,true,24,29,53,124,86,210,6,8,14,0,2:06
633344,2021-07-10,2021,BOS,PHI,2,11,11-2,PHI,9,false,36,45,81,181,129,310,10,20,30,5,3:27
633302,2021-07-11,2021,LAN,ARI,7,4,7-4,LAN,9,false,38,38,76,156,143,299,15,13,28,3,3:40
633263,2021-07-16,2021,CIN,MIL,6,11,11-6,MIL,9,false,40,44,84,173,157,330,15,16,31,2,3:29
633536,2021-06-25,2021,TOR,BAL,5,6,6-5,BAL,10,false,40,45,85,186,149,335,11,15,26,3,3:36
633130,2021-07-28,2021,ANA,COL,8,7,8-7,ANA,9,true,41,42,83,170,157,327,18,15,33,3,3:38
633518,2021-06-26,2021,MIL,COL,10,4,10-4,MIL,9,true,43,39,82,161,175,336,19,14,33,1,3:40
633454,2021-06-29,2021,CIN,SDN,4,5,5-4,SDN,9,false,37,48,85,182,150,332,11,20,31,3,3:50 (:52 delay)
633786,2021-06-06,2021,PHI,WAS,12,6,12-6,PHI,9,true,40,41,81,183,154,337,14,15,29,4,4:06 (:20 delay)
633387,2021-07-03,2021,PIT,MIL,2,11,11-2,MIL,9,false,38,53,91,209,139,348,11,25,36,2,3:45
633216,2021-07-20,2021,NYA,PHI,6,4,6-4,NYA,9,true,37,42,79,174,156,330,14,16,30,3,3:46
633308,2021-07-09,2021,NYN,PIT,13,4,13-4,NYN,9,true,39,42,81,171,162,333,15,17,32,2,3:27 (:41 delay)
633724,2021-06-15,2021,ATL,BOS,8,10,10-8,BOS,9,false,41,42,83,155,162,317,12,16,28,2,3:32
633155,2021-07-27,2021,SDN,OAK,7,4,7-4,SDN,9,true,37,37,74,143,132,275,14,12,26,2,3:08
633416,2021-07-03,2021,ATL,MIA,2,3,3-2,MIA,9,false,39,36,75,148,149,297,13,10,23,1,3:14
633757,2021-06-10,2021,CIN,MIL,2,7,7-2,MIL,9,false,35,41,76,171,153,324,8,15,23,1,3:16 (:37 delay)
633125,2021-07-28,2021,SFN,LAN,0,8,8-0,LAN,9,false,33,47,80,183,132,315,7,18,25,1,3:10
633353,2021-07-05,2021,TBA,CLE,9,8,9-8,TBA,9,false,41,44,85,183,153,336,18,18,36,5,3:39
633487,2021-07-05,2021,MIN,CHA,8,5,8-5,MIN,9,true,39,40,79,182,168,350,16,13,29,3,3:38
633332,2021-07-07,2021,BAL,TOR,2,10,10-2,TOR,9,false,38,45,83,187,153,340,13,19,32,2,3:23
633388,2021-07-03,2021,ARI,SFN,5,6,6-5,SFN,9,false,41,46,87,178,167,345,12,21,33,2,3:47
633393,2021-07-06,2021,CHN,PHI,10,15,15-10,PHI,9,false,43,50,93,189,156,345,16,21,37,3,3:45
633316,2021-07-10,2021,TEX,OAK,4,8,8-4,OAK,11,false,46,44,90,168,175,343,16,11,27,3,3:55
633480,2021-07-01,2021,CIN,SDN,5,4,5-4,CIN,9,false,49,37,86,147,183,330,27,10,37,2,3:52 (:52 delay)
633365,2021-07-09,2021,CHN,SLN,10,5,10-5,CHN,9,true,46,42,88,153,182,335,22,14,36,5,3:57
633294,2021-07-10,2021,SFN,WAS,10,4,10-4,SFN,9,true,46,38,84,140,185,325,20,11,31,2,3:27
633096,2021-07-28,2021,SDN,OAK,4,10,10-4,OAK,9,false,38,43,81,181,155,336,11,16,27,1,3:28
633422,2021-07-04,2021,PIT,MIL,2,0,2-0,PIT,9,true,34,33,67,116,117,233,9,7,16,0,2:41
633925,2021-07-26,2021,NYN,ATL,1,0,1-0,NYN,7,true,26,25,51,108,93,201,9,5,14,1,2:11
633360,2021-07-07,2021,TBA,CLE,4,0,4-0,TBA,7,true,29,23,52,97,117,214,11,2,13,2,2:04
633340,2021-07-11,2021,HOU,NYA,8,7,8-7,HOU,9,false,37,48,85,212,131,343,13,22,35,3,3:38
633215,2021-07-23,2021,SFN,PIT,4,6,6-4,PIT,9,false,38,39,77,164,168,332,13,10,23,2,3:28
633427,2021-06-30,2021,WAS,TBA,15,6,15-6,WAS,9,true,48,40,88,165,179,344,25,13,38,3,3:37
633721,2021-06-12,2021,DET,CHA,2,15,15-2,CHA,9,false,37,52,89,223,151,374,11,25,36,2,3:47
633350,2021-07-10,2021,BAL,CHA,3,8,8-3,CHA,9,false,39,43,82,185,187,372,13,18,31,4,3:24
633058,2021-07-31,2021,CHA,CLE,11,12,12-11,CLE,9,false,43,43,86,171,176,347,16,16,32,4,3:37
633447,2021-07-16,2021,PHI,MIA,0,7,7-0,MIA,7,false,27,34,61,127,96,223,5,12,17,1,2:21
633289,2021-07-10,2021,MIN,DET,9,4,9-4,MIN,9,true,39,35,74,160,169,329,15,9,24,5,3:26
633357,2021-07-09,2021,BOS,PHI,11,5,11-5,BOS,9,true,45,37,82,145,185,330,21,11,32,2,3:44
633267,2021-07-17,2021,WAS,SDN,4,10,10-4,SDN,9,false,40,45,85,170,154,324,15,23,38,2,3:37
633528,2021-06-22,2021,SEA,COL,2,1,2-1,SEA,9,true,29,32,61,132,116,248,7,7,14,1,2:39
633509,2021-06-26,2021,DET,HOU,2,3,3-2,HOU,7,false,28,27,55,121,109,230,7,8,15,2,2:21
634515,2021-06-25,2021,NYN,PHI,1,2,2-1,PHI,8,false,31,29,60,107,118,225,8,6,14,0,2:32
633447,2021-07-16,2021,PHI,MIA,0,7,7-0,MIA,7,false,27,34,61,127,96,223,5,12,17,1,2:21
633311,2021-07-10,2021,LAN,ARI,22,1,22-1,LAN,9,true,53,33,86,133,192,325,30,6,36,2,3:19
633421,2021-08-16,2021,NYA,ANA,2,1,2-1,NYA,9,true,31,32,63,131,125,256,10,4,14,4,2:49
633443,2021-06-29,2021,WAS,TBA,4,3,4-3,WAS,9,true,30,37,67,122,108,230,9,10,19,1,2:34
633298,2021-07-17,2021,NYA,BOS,3,1,3-1,NYA,6,false,27,25,52,96,121,217,9,7,16,1,2:43 (1:42 delay)
633362,2021-07-07,2021,SDN,WAS,5,15,15-5,WAS,9,false,44,51,95,194,168,362,17,23,40,2,3:32
633265,2021-07-16,2021,ATL,TBA,6,7,7-6,TBA,10,false,43,50,93,192,176,368,13,20,33,2,3:46
633103,2021-07-28,2021,CHN,CIN,2,8,8-2,CIN,9,false,37,46,83,175,167,342,11,21,32,0,3:37
633506,2021-06-30,2021,CLE,DET,1,7,7-1,DET,7,false,27,34,61,139,110,249,4,14,18,1,2:27
633552,2021-06-26,2021,MIA,WAS,3,2,3-2,MIA,9,true,31,38,69,146,105,251,7,11,18,0,2:44
633137,2021-07-27,2021,MIN,DET,5,6,6-5,DET,11,false,45,41,86,164,142,306,15,12,27,4,3:52
633182,2021-07-26,2021,CHN,CIN,6,5,6-5,CHN,9,false,45,42,87,171,183,354,21,15,36,4,4:00
633436,2021-07-04,2021,ARI,SFN,2,5,5-2,SFN,9,false,33,34,67,133,124,257,9,7,16,1,2:43
633537,2021-06-22,2021,CHN,CLE,7,1,7-1,CHN,9,true,33,34,67,132,124,256,9,7,16,2,2:51
633326,2021-07-10,2021,NYN,PIT,4,2,4-2,NYN,7,true,31,30,61,119,137,256,14,9,23,1,2:54
633553,2021-06-23,2021,TEX,OAK,5,3,5-3,TEX,9,true,33,38,71,123,117,240,13,11,24,2,2:43
633401,2021-07-03,2021,OAK,BOS,7,6,7-6,OAK,12,false,55,47,102,173,191,364,25,12,37,3,4:24
633695,2021-06-16,2021,TOR,NYA,2,3,3-2,NYA,9,false,34,36,70,142,125,267,7,7,14,2,3:01
633555,2021-06-25,2021,MIN,CLE,8,7,8-7,MIN,9,true,35,36,71,133,110,243,12,9,21,2,2:46
633545,2021-06-25,2021,NYN,PHI,2,1,2-1,NYN,8,false,32,32,64,114,136,250,10,9,19,3,3:03
633110,2021-07-28,2021,BOS,TOR,4,1,4-1,BOS,7,true,31,26,57,116,111,227,14,7,21,2,2:27
633589,2021-06-26,2021,SLN,PIT,3,1,3-1,SLN,9,true,33,34,67,134,120,254,10,8,18,1,2:56
633120,2021-07-30,2021,SFN,HOU,6,9,9-6,HOU,9,false,43,46,89,187,169,356,15,18,33,3,3:58
633195,2021-07-24,2021,BAL,WAS,5,3,5-3,BAL,9,true,33,34,67,129,125,254,10,7,17,2,2:41
633307,2021-07-11,2021,MIN,DET,12,9,12-9,MIN,10,false,51,43,94,158,233,391,26,15,41,5,4:09
633102,2021-07-30,2021,ARI,LAN,6,5,6-5,ARI,10,false,47,44,91,176,194,370,19,14,33,4,4:33
633525,2021-06-26,2021,TBA,ANA,13,3,13-3,TBA,9,true,43,35,78,115,181,296,20,8,28,1,2:52
633458,2021-06-28,2021,LAN,SFN,3,2,3-2,LAN,9,true,30,40,70,147,116,263,7,14,21,1,3:10
633281,2021-07-17,2021,SLN,SFN,3,1,3-1,SLN,9,true,31,36,67,139,106,245,7,11,18,1,2:36
633149,2021-07-27,2021,SFN,LAN,2,1,2-1,SFN,9,true,33,33,66,128,130,258,10,7,17,2,2:49
633588,2021-06-21,2021,MIN,CIN,7,5,7-5,MIN,12,false,56,51,107,221,217,438,25,19,44,7,5:14
633554,2021-06-20,2021,SEA,TBA,6,2,6-2,SEA,10,false,36,37,73,144,133,277,9,10,19,1,3:08
633614,2021-06-23,2021,SEA,COL,2,5,5-2,COL,9,false,32,37,69,156,122,278,5,10,15,2,3:00
633527,2021-06-27,2021,SFN,OAK,2,6,6-2,OAK,9,false,35,42,77,156,121,277,10,13,23,2,2:57
633488,2021-06-29,2021,OAK,TEX,4,5,5-4,TEX,9,false,36,37,73,150,131,281,9,11,20,0,2:41
633154,2021-07-24,2021,BOS,NYA,3,4,4-3,NYA,9,false,37,37,74,124,144,268,11,12,23,1,3:02
633489,2021-06-27,2021,MIA,WAS,1,5,5-1,WAS,9,false,36,35,71,130,141,271,10,12,22,1,3:06
633331,2021-09-11,2021,BAL,TOR,2,11,11-2,TOR,7,false,29,36,65,146,111,257,7,15,22,2,2:28
633432,2021-06-30,2021,CLE,DET,4,9,9-4,DET,7,false,28,40,68,169,113,282,7,20,27,2,2:55
633572,2021-06-22,2021,PIT,CHA,6,3,6-3,PIT,9,true,35,35,70,125,152,277,12,8,20,2,2:50
633513,2021-06-23,2021,MIA,TOR,1,3,3-1,TOR,9,false,34,38,72,143,144,287,6,11,17,0,3:18
633475,2021-06-28,2021,BOS,KCA,6,5,6-5,BOS,9,true,34,37,71,135,138,273,13,12,25,2,3:02
633540,2021-06-22,2021,SDN,LAN,3,2,3-2,SDN,9,true,31,39,70,166,120,286,7,13,20,2,3:09
633319,2021-07-17,2021,ARI,CHN,2,4,4-2,CHN,9,false,35,39,74,131,133,264,9,13,22,2,3:15
633423,2021-07-04,2021,ATL,MIA,8,7,8-7,ATL,10,false,45,44,89,196,163,359,24,14,38,1,4:08
633574,2021-06-20,2021,TEX,MIN,2,4,4-2,MIN,9,false,35,41,76,153,136,289,8,16,24,1,3:07
634620,2021-06-28,2021,WAS,NYN,8,4,8-4,WAS,9,true,38,38,76,155,116,271,16,12,28,3,3:03
633541,2021-06-23,2021,DET,SLN,6,2,6-2,DET,9,true,36,35,71,128,161,289,13,9,22,5,3:12
633486,2021-06-27,2021,MIL,COL,5,0,5-0,MIL,9,true,34,32,66,133,164,297,12,6,18,1,3:09
633501,2021-06-26,2021,CHA,SEA,2,3,3-2,SEA,9,false,34,37,71,149,142,291,10,10,20,3,3:17 (1:38 delay)
633603,2021-06-22,2021,ARI,MIL,0,5,5-0,MIL,9,false,34,37,71,143,137,280,7,11,18,2,3:13
633539,2021-06-26,2021,NYN,PHI,4,3,4-3,NYN,9,false,39,35,74,125,143,268,12,9,21,1,3:05
633587,2021-06-29,2021,ATL,NYN,3,4,4-3,NYN,9,false,37,37,74,139,140,279,11,11,22,1,3:15
633503,2021-06-24,2021,TEX,OAK,1,5,5-1,OAK,9,false,36,40,76,159,137,296,11,13,24,0,3:03
633186,2021-07-24,2021,CHN,ARI,3,7,7-3,ARI,9,false,35,40,75,162,119,281,9,14,23,2,3:15 (1:39 delay)
633448,2021-07-02,2021,PHI,SDN,4,3,4-3,PHI,10,false,35,38,73,158,128,286,8,8,16,2,3:09
633544,2021-06-27,2021,SDN,ARI,5,4,5-4,SDN,9,true,37,37,74,148,127,275,14,10,24,1,3:27
633262,2021-07-17,2021,CHA,HOU,10,1,10-1,CHA,9,true,42,30,72,107,167,274,19,3,22,1,2:51
633627,2021-06-23,2021,SDN,LAN,5,3,5-3,SDN,9,true,36,35,71,148,137,285,15,9,24,4,3:30
633234,2021-07-20,2021,CIN,NYN,4,3,4-3,CIN,9,true,36,39,75,153,137,290,14,12,26,2,3:13
633156,2021-07-25,2021,BAL,WAS,5,4,5-4,BAL,9,false,36,40,76,142,147,289,13,14,27,4,3:18
633578,2021-06-23,2021,ARI,MIL,2,3,3-2,MIL,9,false,34,40,74,150,138,288,8,14,22,1,3:28
633591,2021-06-25,2021,MIA,WAS,11,2,11-2,MIA,9,true,42,35,77,138,159,297,16,11,27,1,3:21
633497,2021-06-29,2021,TOR,SEA,9,3,9-3,TOR,9,true,42,37,79,146,145,291,19,11,30,0,3:08
633169,2021-07-25,2021,SEA,OAK,4,3,4-3,SEA,9,true,35,36,71,149,136,285,12,10,22,3,3:07
633355,2021-07-07,2021,ARI,COL,6,4,6-4,ARI,9,true,35,39,74,145,143,288,11,13,24,2,3:02
633459,2021-06-27,2021,TBA,ANA,4,6,6-4,ANA,9,false,36,40,76,158,150,308,9,16,25,4,3:26
633309,2021-07-16,2021,CHA,HOU,1,7,7-1,HOU,9,false,31,43,74,188,124,312,5,16,21,2,3:07
633493,2021-06-27,2021,CIN,ATL,0,4,4-0,ATL,9,false,33,36,69,148,162,310,6,11,17,1,3:15
633219,2021-07-26,2021,BOS,TOR,5,4,5-4,BOS,9,true,35,37,72,134,134,268,12,11,23,4,3:17
633305,2021-07-16,2021,WAS,SDN,8,24,24-8,SDN,9,false,41,60,101,258,174,432,16,31,47,3,4:15
633568,2021-06-23,2021,BAL,HOU,0,13,13-0,HOU,9,false,34,49,83,175,118,293,9,23,32,1,2:46
633469,2021-07-01,2021,CLE,HOU,2,7,7-2,HOU,9,false,37,39,76,167,145,312,12,12,24,1,3:04
633402,2021-07-02,2021,ANA,BAL,8,7,8-7,ANA,9,false,40,41,81,161,142,303,15,14,29,8,3:26
633124,2021-07-29,2021,CHN,CIN,4,7,7-4,CIN,9,false,34,42,76,158,147,305,10,16,26,2,3:12
633321,2021-07-16,2021,COL,LAN,4,10,10-4,LAN,9,false,39,48,87,153,131,284,14,20,34,2,3:17
633163,2021-07-23,2021,MIL,CHA,7,1,7-1,MIL,9,true,39,36,75,121,143,264,18,10,28,1,3:00
633175,2021-07-24,2021,CIN,SLN,5,3,5-3,CIN,9,true,36,39,75,143,128,271,12,14,26,1,2:55
633159,2021-07-23,2021,MIN,ANA,5,4,5-4,MIN,9,true,37,39,76,137,140,277,15,12,27,1,3:07
633306,2021-07-17,2021,OAK,CLE,2,3,3-2,CLE,9,false,38,37,75,137,154,291,12,11,23,0,3:11
633229,2021-07-23,2021,SEA,OAK,4,3,4-3,SEA,9,true,33,36,69,159,139,298,9,11,20,1,3:17
633508,2021-06-29,2021,SLN,ARI,3,2,3-2,SLN,9,true,36,37,73,147,148,295,12,11,23,1,3:11
633199,2021-07-20,2021,LAN,SFN,8,6,8-6,LAN,9,false,39,38,77,151,135,286,16,10,26,3,3:22
633446,2021-06-29,2021,MIL,CHN,2,1,2-1,MIL,9,true,32,40,72,172,144,316,7,15,22,1,3:40
633127,2021-07-31,2021,SLN,MIN,1,8,8-1,MIN,9,false,34,43,77,160,133,293,9,14,23,1,2:58
633532,2021-06-22,2021,TEX,OAK,6,13,13-6,OAK,9,false,38,46,84,183,129,312,13,20,33,3,3:20
633243,2021-07-19,2021,ARI,PIT,4,2,4-2,ARI,9,true,36,40,76,140,145,285,13,14,27,2,3:25
633534,2021-06-26,2021,TEX,KCA,8,0,8-0,TEX,9,true,45,32,77,138,183,321,20,6,26,1,3:27
633491,2021-06-30,2021,COL,PIT,6,2,6-2,COL,9,true,39,37,76,151,162,313,18,11,29,2,3:27
633569,2021-06-23,2021,PIT,CHA,3,4,4-3,CHA,9,false,38,39,77,163,152,315,11,13,24,3,3:37
633399,2021-07-04,2021,OAK,BOS,0,1,1-0,BOS,9,false,34,34,68,117,147,264,7,7,14,1,2:52
633450,2021-06-28,2021,MIL,CHN,14,4,14-4,MIL,9,true,45,39,84,161,152,313,22,13,35,2,3:43
633490,2021-06-28,2021,SLN,ARI,7,1,7-1,SLN,9,true,37,38,75,175,141,316,12,12,24,3,3:33
633259,2021-07-19,2021,LAN,SFN,2,7,7-2,SFN,9,false,36,43,79,159,157,316,9,17,26,5,3:45
633526,2021-06-22,2021,DET,SLN,8,2,8-2,DET,9,true,41,38,79,157,157,314,17,11,28,3,3:13
633317,2021-07-10,2021,CLE,KCA,14,6,14-6,CLE,9,true,41,39,80,152,147,299,20,12,32,4,3:20
633142,2021-07-31,2021,SDN,COL,3,5,5-3,COL,9,false,37,36,73,149,151,300,12,9,21,0,3:13
633132,2021-07-31,2021,WAS,CHN,3,6,6-3,CHN,9,false,38,41,79,153,137,290,11,13,24,2,3:16
633496,2021-06-29,2021,BOS,KCA,7,6,7-6,BOS,9,true,40,41,81,164,154,318,20,16,36,2,3:31
633267,2021-07-17,2021,WAS,SDN,4,10,10-4,SDN,9,false,40,45,85,170,154,324,15,23,38,2,3:37
633099,2021-07-31,2021,ARI,LAN,3,8,8-3,LAN,9,false,32,45,77,149,148,297,7,18,25,4,3:33
633549,2021-06-22,2021,PHI,WAS,2,3,3-2,WAS,9,false,38,39,77,161,183,344,11,12,23,2,3:52
633621,2021-06-22,2021,NYA,KCA,5,6,6-5,KCA,9,false,45,39,84,138,190,328,19,11,30,3,3:38
633260,2021-07-21,2021,ARI,PIT,6,4,6-4,ARI,9,true,39,38,77,144,147,291,17,12,29,3,3:24
633290,2021-07-17,2021,PIT,NYN,9,7,9-7,PIT,9,false,43,40,83,160,165,325,18,16,34,2,3:49
633551,2021-06-23,2021,NYA,KCA,6,5,6-5,NYA,9,false,41,41,82,142,200,342,18,16,34,2,3:40
633144,2021-07-24,2021,SFN,PIT,2,10,10-2,PIT,9,false,33,46,79,185,132,317,7,20,27,2,3:27
633747,2021-06-21,2021,BAL,HOU,2,10,10-2,HOU,9,false,32,47,79,190,163,353,4,21,25,2,3:40 (1:41 delay)
633561,2021-06-23,2021,NYN,ATL,7,3,7-3,NYN,9,true,40,39,79,185,158,343,17,13,30,3,3:42
633173,2021-07-23,2021,LAN,COL,6,9,9-6,COL,10,false,45,43,88,156,187,343,15,14,29,3,4:06
633474,2021-06-30,2021,MIL,CHN,15,7,15-7,MIL,9,true,47,41,88,151,189,340,23,15,38,3,3:47
633237,2021-07-18,2021,ATL,TBA,5,7,7-5,TBA,9,false,42,37,79,146,169,315,15,11,26,3,3:11
633224,2021-07-21,2021,ATL,SDN,5,6,6-5,SDN,7,false,31,33,64,156,162,318,11,14,25,3,3:17 (4:08 delay)
633449,2021-06-29,2021,HOU,BAL,3,13,13-3,BAL,9,false,42,47,89,197,156,353,18,21,39,6,3:53
633329,2021-07-19,2021,DET,TEX,14,0,14-0,DET,9,true,47,32,79,135,176,311,26,5,31,3,3:25
633230,2021-07-20,2021,SLN,CHN,6,7,7-6,CHN,9,false,38,42,80,172,161,333,11,15,26,3,3:43
633564,2021-06-24,2021,DET,HOU,3,12,12-3,HOU,9,false,38,53,91,201,142,343,13,26,39,2,3:52
633098,2021-07-28,2021,BAL,MIA,8,7,8-7,BAL,9,false,41,46,87,164,173,337,19,19,38,3,3:32
633202,2021-07-24,2021,PHI,ATL,3,15,15-3,ATL,9,false,41,50,91,178,166,344,14,22,36,3,3:31
633483,2021-06-28,2021,HOU,BAL,7,9,9-7,BAL,9,false,47,45,92,185,198,383,21,19,40,6,4:19
633546,2021-06-23,2021,PHI,WAS,12,13,13-12,WAS,9,false,50,44,94,195,183,378,22,20,42,5,4:19
633146,2021-07-28,2021,SEA,HOU,4,11,11-4,HOU,9,false,42,49,91,206,189,395,15,22,37,3,4:14
633570,2021-06-23,2021,ANA,SFN,3,9,9-3,SFN,13,false,50,55,105,208,176,384,14,18,32,2,4:51
633138,2021-07-28,2021,MIN,DET,14,17,17-14,DET,9,false,51,51,102,196,205,401,24,25,49,3,4:03
633253,2021-07-17,2021,CIN,MIL,4,7,7-4,MIL,11,false,45,52,97,194,195,389,13,19,32,4,4:37 (:43 delay)
633460,2021-07-01,2021,COL,SLN,5,2,5-2,COL,9,false,35,35,70,109,135,244,10,8,18,0,2:47 (:58 delay)
633547,2021-06-22,2021,BAL,HOU,1,3,3-1,HOU,9,false,32,38,70,155,115,270,7,12,19,4,2:55
633750,2021-06-22,2021,NYN,ATL,0,3,3-0,ATL,9,false,33,37,70,150,131,281,6,10,16,0,3:02 (:26 delay)
633670,2021-06-22,2021,ANA,SFN,0,5,5-0,SFN,9,false,35,39,74,158,131,289,8,13,21,0,2:53
633351,2021-07-08,2021,MIL,CIN,5,3,5-3,MIL,9,true,37,38,75,149,143,292,15,11,26,3,3:16
633457,2021-07-01,2021,BOS,KCA,15,1,15-1,BOS,9,true,45,35,80,118,174,292,23,8,31,0,3:08
633386,2021-07-05,2021,CHN,PHI,3,13,13-3,PHI,9,false,36,44,80,174,147,321,10,17,27,2,3:33
633519,2021-06-22,2021,TBA,BOS,5,9,9-5,BOS,11,false,46,45,91,197,169,366,15,15,30,3,4:21
632924,2021-08-12,2021,CHA,NYA,9,8,9-8,CHA,9,false,37,42,79,189,128,317,13,14,27,2,3:29
632297,2021-09-29,2021,LAN,SDN,11,9,11-9,LAN,9,true,39,43,82,160,139,299,15,16,31,4,3:34
632949,2021-08-12,2021,NYN,WAS,4,1,4-1,NYN,7,true,29,26,55,110,96,206,13,7,20,2,2:28
632963,2021-08-07,2021,TOR,BOS,1,0,1-0,TOR,7,false,21,24,45,100,77,177,3,4,7,0,1:55
632940,2021-08-10,2021,ANA,TOR,0,4,4-0,TOR,7,false,28,32,60,121,94,215,7,12,19,1,2:23
632893,2021-08-17,2021,NYA,BOS,2,0,2-0,NYA,7,true,27,30,57,108,103,211,9,9,18,2,2:31
632497,2021-09-14,2021,TOR,TBA,0,2,2-0,TBA,9,false,30,34,64,118,103,221,4,7,11,0,2:20
633003,2021-08-05,2021,TOR,CLE,3,0,3-0,TOR,9,true,30,33,63,134,105,239,6,5,11,0,2:25
632861,2021-08-18,2021,DET,ANA,1,3,3-1,ANA,9,false,31,34,65,121,100,221,6,7,13,1,2:25
632919,2021-08-17,2021,SFN,NYN,3,2,3-2,SFN,9,true,30,35,65,107,126,233,7,9,16,2,2:27
633095,2021-08-01,2021,ATL,MIL,1,2,2-1,MIL,9,false,36,30,66,122,127,249,9,3,12,1,2:38
632997,2021-08-10,2021,CHN,MIL,2,4,4-2,MIL,7,false,32,30,62,105,119,224,11,9,20,1,2:38
632997,2021-08-10,2021,CHN,MIL,2,4,4-2,MIL,7,false,32,30,62,105,119,224,11,9,20,1,2:38
632437,2021-09-20,2021,CLE,KCA,2,7,7-2,KCA,7,false,28,30,58,111,97,208,8,10,18,1,2:08
633066,2021-08-03,2021,WAS,PHI,4,5,5-4,PHI,9,false,37,35,72,116,130,246,10,8,18,1,2:35
632912,2021-08-12,2021,NYN,WAS,5,4,5-4,NYN,7,false,30,31,61,120,114,234,11,12,23,2,2:46
633054,2021-08-02,2021,TEX,ANA,4,1,4-1,TEX,9,true,31,32,63,125,110,235,8,5,13,1,2:29
632813,2021-08-16,2021,COL,SDN,6,5,6-5,COL,9,false,32,36,68,116,108,224,10,11,21,0,2:32
632872,2021-08-17,2021,MIA,ATL,0,2,2-0,ATL,9,false,31,34,65,122,119,241,6,7,13,1,2:33
632912,2021-08-12,2021,NYN,WAS,5,4,5-4,NYN,7,false,30,31,61,120,114,234,11,12,23,2,2:46
632303,2021-09-29,2021,NYN,MIA,2,3,3-2,MIA,9,false,33,32,65,110,111,221,9,8,17,1,2:39
633394,2021-09-20,2021,CLE,KCA,2,4,4-2,KCA,7,false,24,29,53,135,103,238,4,10,14,3,2:37
632982,2021-08-06,2021,SLN,KCA,4,2,4-2,SLN,9,true,35,35,70,116,140,256,12,9,21,0,2:49
633047,2021-08-01,2021,CHA,CLE,2,1,2-1,CHA,9,false,34,32,66,134,130,264,9,6,15,0,2:45
632928,2021-08-11,2021,PIT,SLN,0,4,4-0,SLN,9,false,28,39,67,159,88,247,2,16,18,1,2:52
632972,2021-08-13,2021,ANA,HOU,1,4,4-1,HOU,9,false,32,36,68,132,122,254,5,8,13,1,2:51
632678,2021-08-30,2021,TEX,COL,4,3,4-3,TEX,9,true,33,35,68,142,114,256,11,9,20,1,2:49
633009,2021-08-08,2021,CIN,PIT,3,2,3-2,CIN,9,true,33,34,67,133,129,262,10,7,17,1,2:52
633049,2021-08-03,2021,MIA,NYN,5,4,5-4,MIA,9,true,35,36,71,113,123,236,12,10,22,3,2:43
632859,2021-08-18,2021,KCA,HOU,3,2,3-2,KCA,9,true,31,37,68,129,112,241,9,12,21,2,2:49
632516,2021-09-12,2021,SLN,CIN,2,0,2-0,SLN,9,true,28,33,61,132,108,240,4,6,10,2,2:35
632947,2021-08-12,2021,SEA,TEX,3,1,3-1,SEA,9,true,32,29,61,108,110,218,8,3,11,0,2:08
632975,2021-08-08,2021,ATL,WAS,5,4,5-4,ATL,9,true,31,40,71,161,88,249,7,14,21,1,2:42
632847,2021-08-15,2021,TEX,OAK,7,4,7-4,TEX,9,true,33,38,71,131,118,249,9,12,21,1,2:39
632801,2021-08-22,2021,CIN,MIA,3,1,3-1,CIN,9,true,32,32,64,127,137,264,10,5,15,0,2:43
632357,2021-09-24,2021,MIN,TOR,3,1,3-1,MIN,9,true,33,32,65,129,123,252,9,5,14,1,2:38
632875,2021-08-17,2021,KCA,HOU,3,1,3-1,KCA,9,true,33,33,66,131,111,242,11,9,20,1,2:45
632341,2021-09-25,2021,PHI,PIT,3,0,3-0,PHI,9,true,35,28,63,97,144,241,14,4,18,1,2:33
633050,2021-08-01,2021,DET,BAL,6,2,6-2,DET,9,true,36,34,70,129,148,277,12,7,19,3,2:56
633055,2021-08-04,2021,TEX,ANA,1,2,2-1,ANA,9,false,32,34,66,127,136,263,7,8,15,0,2:53
633069,2021-08-01,2021,MIA,NYA,1,3,3-1,NYA,9,false,32,35,67,133,133,266,7,7,14,2,3:04
633027,2021-08-04,2021,TBA,SEA,4,3,4-3,TBA,9,true,33,35,68,136,129,265,9,8,17,1,2:39
632869,2021-08-17,2021,ARI,PHI,3,2,3-2,ARI,9,true,32,36,68,136,116,252,10,10,20,1,2:49
633032,2021-08-03,2021,SLN,ATL,1,6,6-1,ATL,9,false,34,37,71,134,141,275,9,13,22,0,2:39
632863,2021-08-15,2021,SFN,COL,5,2,5-2,SFN,9,true,36,35,71,117,128,245,13,9,22,3,2:53
632853,2021-08-17,2021,TEX,SEA,1,3,3-1,SEA,9,false,33,35,68,124,132,256,7,9,16,1,2:56
633331,2021-09-11,2021,BAL,TOR,2,11,11-2,TOR,7,false,29,36,65,146,111,257,7,15,22,2,2:28
633000,2021-08-10,2021,CHN,MIL,3,6,6-3,MIL,7,false,31,31,62,124,119,243,10,11,21,5,2:55 (1:29 delay)
632685,2021-08-26,2021,SDN,LAN,0,4,4-0,LAN,9,false,31,34,65,141,123,264,5,7,12,1,3:01
632483,2021-09-15,2021,TOR,TBA,6,3,6-3,TOR,9,true,33,33,66,135,125,260,9,6,15,0,2:29
632525,2021-09-11,2021,SLN,CIN,6,4,6-4,SLN,9,true,33,34,67,128,123,251,12,8,20,0,2:44
632518,2021-09-13,2021,WAS,MIA,0,3,3-0,MIA,9,false,29,37,66,137,106,243,2,13,15,0,2:36
632995,2021-08-07,2021,HOU,MIN,4,0,4-0,HOU,9,true,34,31,65,122,135,257,11,4,15,0,2:55
632986,2021-08-07,2021,LAN,ANA,5,3,5-3,LAN,9,true,36,38,74,146,124,270,12,11,23,2,3:05
633086,2021-08-01,2021,SFN,HOU,5,3,5-3,SFN,9,true,36,36,72,135,126,261,13,11,24,2,3:01
633012,2021-08-07,2021,CHN,CHA,0,4,4-0,CHA,9,false,34,35,69,125,148,273,7,8,15,2,3:10
633291,2021-08-17,2021,NYA,BOS,5,3,5-3,NYA,7,true,33,29,62,118,127,245,15,10,25,4,2:56
633246,2021-08-07,2021,TOR,BOS,1,2,2-1,BOS,8,false,32,31,63,130,140,270,9,9,18,2,2:59
632780,2021-08-21,2021,CLE,ANA,5,1,5-1,CLE,9,true,39,30,69,117,146,263,17,4,21,5,2:50
632528,2021-09-10,2021,SEA,ARI,5,4,5-4,SEA,9,true,32,35,67,154,114,268,10,8,18,1,2:38
632934,2021-08-10,2021,MIN,CHA,4,3,4-3,MIN,9,true,35,33,68,119,144,263,12,7,19,0,2:43
633866,2021-09-23,2021,CLE,CHA,2,7,7-2,CHA,7,false,28,34,62,136,133,269,9,15,24,2,2:46
632304,2021-09-29,2021,CHA,CIN,6,1,6-1,CHA,9,true,34,34,68,123,132,255,10,8,18,2,2:41
632880,2021-08-17,2021,MIN,CLE,1,3,3-1,CLE,9,false,35,34,69,110,155,265,9,7,16,1,3:01
632415,2021-09-20,2021,MIL,SLN,2,5,5-2,SLN,9,false,30,38,68,136,107,243,4,12,16,1,2:43
632556,2021-09-09,2021,BAL,KCA,0,6,6-0,KCA,9,false,33,38,71,119,134,253,7,12,19,1,2:44
632897,2021-08-14,2021,PIT,MIL,0,6,6-0,MIL,7,false,26,33,59,125,101,226,5,15,20,1,2:34
632264,2021-10-02,2021,KCA,MIN,0,4,4-0,MIN,9,false,30,37,67,130,122,252,6,10,16,3,2:52
633060,2021-08-04,2021,COL,CHN,2,3,3-2,CHN,9,false,35,38,73,138,122,260,12,12,24,0,3:04
632939,2021-08-12,2021,SFN,COL,7,0,7-0,SFN,9,true,35,31,66,128,156,284,12,7,19,0,2:44
632790,2021-08-21,2021,COL,ARI,5,2,5-2,COL,9,false,34,37,71,114,153,267,9,11,20,0,3:04
632339,2021-09-24,2021,CHN,SLN,5,8,8-5,SLN,7,false,32,33,65,118,128,246,12,13,25,1,2:39
632776,2021-08-24,2021,HOU,KCA,4,0,4-0,HOU,9,true,37,31,68,120,151,271,13,6,19,1,3:21
632409,2021-09-27,2021,CLE,KCA,8,3,8-3,CLE,9,true,38,33,71,124,139,263,12,7,19,2,2:44
632458,2021-09-17,2021,NYA,CLE,8,0,8-0,NYA,9,true,36,32,68,126,138,264,13,7,20,1,2:50
632479,2021-09-15,2021,DET,MIL,4,1,4-1,DET,9,true,31,34,65,148,127,275,8,6,14,1,2:46
632876,2021-08-15,2021,PIT,MIL,1,2,2-1,MIL,9,false,33,37,70,129,140,269,5,11,16,1,3:09
632263,2021-10-02,2021,MIA,PHI,3,1,3-1,MIA,9,true,32,34,66,130,130,260,10,8,18,1,2:52
633036,2021-08-03,2021,TOR,CLE,7,2,7-2,TOR,9,true,38,34,72,121,134,255,14,7,21,0,2:46
633421,2021-08-16,2021,NYA,ANA,2,1,2-1,NYA,9,true,31,32,63,131,125,256,10,4,14,4,2:49
632254,2021-10-03,2021,ATL,NYN,5,0,5-0,ATL,9,true,32,29,61,115,118,233,9,4,13,1,2:26
632342,2021-09-25,2021,OAK,HOU,2,1,2-1,OAK,9,false,38,32,70,113,135,248,14,5,19,1,2:49
632942,2021-08-09,2021,SDN,MIA,8,3,8-3,SDN,9,true,36,35,71,151,135,286,13,8,21,0,3:06
632964,2021-08-09,2021,MIN,CHA,1,11,11-1,CHA,9,false,29,44,73,164,118,282,4,17,21,1,2:48
632952,2021-08-11,2021,SEA,TEX,2,1,2-1,SEA,9,false,36,34,70,138,141,279,13,8,21,1,3:12
632909,2021-08-17,2021,LAN,PIT,4,3,4-3,LAN,9,true,36,36,72,130,150,280,12,7,19,1,3:29
632881,2021-08-15,2021,ANA,HOU,3,1,3-1,ANA,9,true,34,37,71,138,147,285,10,11,21,2,3:02
632442,2021-09-18,2021,SFN,ATL,2,0,2-0,SFN,9,true,34,33,67,119,130,249,10,8,18,1,2:40
632438,2021-09-19,2021,WAS,COL,3,0,3-0,WAS,9,true,33,35,68,145,109,254,10,10,20,3,3:01
632666,2021-09-28,2021,NYN,MIA,2,1,2-1,NYN,9,false,32,32,64,127,136,263,10,6,16,1,2:59
633004,2021-08-05,2021,TEX,ANA,0,5,5-0,ANA,9,false,35,40,75,142,133,275,8,12,20,4,2:59
632298,2021-09-29,2021,SFN,ARI,1,0,1-0,SFN,9,true,36,31,67,105,153,258,12,5,17,0,2:52
632291,2021-09-30,2021,LAN,SDN,8,3,8-3,LAN,9,true,35,36,71,138,117,255,13,9,22,3,2:55
632299,2021-09-29,2021,SEA,OAK,4,2,4-2,SEA,9,true,34,35,69,135,132,267,8,8,16,1,3:06
633024,2021-08-01,2021,SLN,MIN,7,3,7-3,SLN,9,true,39,33,72,102,150,252,16,7,23,0,3:01
632877,2021-08-14,2021,ARI,SDN,7,0,7-0,ARI,9,true,39,28,67,102,146,248,17,3,20,1,2:31
633129,2021-08-01,2021,NYN,CIN,1,7,7-1,CIN,9,false,31,45,76,185,104,289,5,19,24,1,3:06
632967,2021-08-08,2021,PHI,NYN,3,0,3-0,PHI,9,true,28,30,58,108,107,215,6,3,9,0,2:20
632260,2021-10-02,2021,LAN,MIL,8,3,8-3,LAN,9,true,33,33,66,133,133,266,10,7,17,1,2:53
632993,2021-08-07,2021,CLE,DET,1,2,2-1,DET,9,false,38,34,72,105,143,248,11,8,19,2,2:39 (1:06 delay)
632943,2021-08-13,2021,KCA,SLN,0,6,6-0,SLN,9,false,32,40,72,165,124,289,6,13,19,1,3:08
632945,2021-08-08,2021,MIL,SFN,4,5,5-4,SFN,9,false,35,39,74,139,136,275,10,12,22,1,2:49
633044,2021-08-01,2021,WAS,CHN,6,5,6-5,WAS,9,false,40,33,73,152,133,285,20,7,27,1,3:20
633019,2021-08-04,2021,LAN,HOU,7,5,7-5,LAN,9,true,37,36,73,151,136,287,13,9,22,0,3:10
632874,2021-08-15,2021,MIA,CHN,4,1,4-1,MIA,9,true,34,37,71,155,126,281,10,10,20,5,3:21
632743,2021-08-26,2021,BAL,ANA,13,1,13-1,BAL,9,true,44,33,77,120,161,281,21,7,28,2,3:07
632839,2021-08-18,2021,CIN,CHN,1,7,7-1,CHN,9,false,35,41,76,149,139,288,9,16,25,0,3:01
632409,2021-09-27,2021,CLE,KCA,8,3,8-3,CLE,9,true,38,33,71,124,139,263,12,7,19,2,2:44
632515,2021-09-11,2021,DET,TBA,2,7,7-2,TBA,9,false,32,40,72,143,132,275,4,12,16,1,2:49
632826,2021-08-20,2021,CHN,KCA,2,6,6-2,KCA,9,false,33,38,71,153,133,286,7,11,18,0,2:55
632246,2021-10-03,2021,MIA,PHI,5,4,5-4,MIA,9,true,32,37,69,129,123,252,9,11,20,2,2:46
632321,2021-09-28,2021,CHA,CIN,7,1,7-1,CHA,9,true,39,31,70,113,144,257,16,5,21,2,2:49
633002,2021-08-06,2021,CIN,PIT,10,0,10-0,CIN,9,true,39,34,73,127,149,276,15,9,24,0,2:41
632851,2021-08-17,2021,COL,SDN,7,3,7-3,COL,9,true,38,33,71,116,156,272,14,7,21,4,2:57
632281,2021-09-30,2021,SLN,MIL,4,3,4-3,SLN,9,true,30,36,66,141,116,257,7,11,18,3,2:41
632882,2021-08-16,2021,LAN,PIT,2,1,2-1,LAN,9,true,32,38,70,133,124,257,9,13,22,2,2:50
632916,2021-08-14,2021,PHI,CIN,6,1,6-1,PHI,9,true,35,31,66,121,141,262,11,5,16,1,2:38
632290,2021-09-26,2021,TBA,MIA,3,2,3-2,TBA,9,true,32,35,67,123,142,265,8,8,16,3,2:54
633035,2021-08-06,2021,COL,MIA,14,2,14-2,COL,9,true,46,35,81,132,150,282,23,9,32,1,2:51
633015,2021-08-05,2021,CHA,KCA,2,3,3-2,KCA,9,false,35,36,71,156,141,297,9,10,19,1,2:58
632561,2021-09-09,2021,CLE,MIN,4,1,4-1,CLE,9,true,38,31,69,124,164,288,15,6,21,1,2:46
632766,2021-08-25,2021,CLE,TEX,7,2,7-2,CLE,9,true,37,38,75,138,152,290,13,13,26,3,2:56
633067,2021-08-01,2021,TOR,KCA,5,1,5-1,TOR,9,true,38,36,74,141,160,301,15,10,25,2,2:56
632729,2021-08-26,2021,PIT,SLN,11,7,11-7,PIT,9,true,43,37,80,131,142,273,20,11,31,4,3:07
632520,2021-09-13,2021,SFN,SDN,9,1,9-1,SFN,9,true,36,36,72,128,155,283,12,9,21,1,2:51
632946,2021-08-11,2021,CHN,MIL,0,10,10-0,MIL,9,false,30,45,75,168,109,277,4,19,23,0,2:58
632523,2021-09-12,2021,ATL,MIA,5,3,5-3,ATL,9,true,35,35,70,135,139,274,11,7,18,1,3:17
632390,2021-09-23,2021,BAL,TEX,3,0,3-0,BAL,9,true,32,35,67,154,130,284,8,9,17,1,2:46
632990,2021-08-06,2021,CLE,DET,6,1,6-1,CLE,9,true,38,34,72,148,144,292,16,8,24,1,3:11
632988,2021-08-07,2021,SDN,ARI,6,2,6-2,SDN,9,true,37,31,68,122,150,272,16,6,22,1,3:18
632347,2021-09-25,2021,DET,KCA,5,1,5-1,DET,9,true,35,35,70,122,146,268,14,10,24,5,3:00
632553,2021-09-12,2021,OAK,TEX,3,4,4-3,TEX,9,false,31,39,70,166,110,276,6,13,19,1,3:04
632267,2021-10-01,2021,SFN,SDN,3,0,3-0,SFN,9,true,35,34,69,126,138,264,10,9,19,0,2:50
632965,2021-08-11,2021,ANA,TOR,2,10,10-2,TOR,9,false,36,40,76,163,132,295,8,13,21,2,3:03
632724,2021-08-26,2021,TOR,CHA,7,10,10-7,CHA,9,false,40,41,81,157,116,273,13,14,27,3,3:14
632655,2021-09-01,2021,ANA,NYA,1,4,4-1,NYA,9,false,31,37,68,139,133,272,4,12,16,3,2:50
632268,2021-10-01,2021,TOR,BAL,6,4,6-4,TOR,9,true,37,36,73,133,112,245,14,12,26,5,2:55
632871,2021-08-17,2021,CIN,CHN,1,2,2-1,CHN,9,false,35,36,71,110,133,243,9,13,22,2,2:45
632294,2021-09-30,2021,BAL,BOS,6,2,6-2,BAL,9,true,34,34,68,117,142,259,12,9,21,1,2:40
632239,2021-10-03,2021,NYA,TBA,1,0,1-0,NYA,9,false,30,36,66,143,117,260,7,9,16,5,3:03
632238,2021-10-03,2021,SLN,CHN,2,3,3-2,CHN,8,true,29,28,57,113,95,208,10,7,17,0,2:11 (:42 delay)
633038,2021-08-03,2021,COL,CHN,13,6,13-6,COL,9,true,42,36,78,127,146,273,18,10,28,1,3:04
632679,2021-08-31,2021,NYN,MIA,3,1,3-1,NYN,7,true,23,28,51,96,79,175,9,7,16,1,2:05
632970,2021-08-08,2021,CHN,CHA,3,9,9-3,CHA,9,false,36,41,77,157,147,304,9,15,24,0,3:06
634173,2021-08-09,2021,CLE,CIN,9,3,9-3,CLE,9,true,41,38,79,146,153,299,17,12,29,2,3:09
633010,2021-08-04,2021,OAK,SDN,5,4,5-4,OAK,10,false,39,40,79,132,155,287,14,12,26,0,3:23
632977,2021-08-08,2021,COL,MIA,13,8,13-8,COL,9,true,39,42,81,155,128,283,15,15,30,2,3:06
632922,2021-08-11,2021,BAL,DET,2,5,5-2,DET,9,false,38,40,78,134,147,281,12,14,26,1,3:01 (1:11 delay)
633057,2021-08-02,2021,WAS,PHI,5,7,7-5,PHI,9,false,36,43,79,151,136,287,12,20,32,4,3:16
632950,2021-08-07,2021,NYA,SEA,5,4,5-4,NYA,9,true,37,36,73,141,152,293,13,9,22,3,3:11
632918,2021-08-12,2021,ANA,TOR,6,3,6-3,ANA,9,true,37,34,71,146,146,292,16,8,24,3,3:08
632864,2021-08-17,2021,TBA,BAL,10,0,10-0,TBA,9,true,38,33,71,142,163,305,12,6,18,3,2:55
632648,2021-09-01,2021,SEA,HOU,1,0,1-0,SEA,9,true,32,35,67,160,133,293,8,10,18,3,3:17
632845,2021-08-19,2021,SLN,MIL,8,4,8-4,SLN,9,true,39,36,75,127,153,280,15,10,25,2,3:21
632987,2021-08-10,2021,KCA,NYA,8,4,8-4,KCA,9,true,37,38,75,163,126,289,12,11,23,4,3:03
632904,2021-08-11,2021,HOU,COL,5,1,5-1,HOU,9,true,39,38,77,140,144,284,15,11,26,0,3:04
632366,2021-09-24,2021,MIL,NYN,5,1,5-1,MIL,9,true,34,34,68,146,143,289,11,6,17,1,2:56
633079,2021-08-02,2021,MIA,NYN,6,3,6-3,MIA,9,true,35,39,74,150,142,292,10,13,23,1,3:11
632340,2021-09-24,2021,ARI,LAN,2,4,4-2,LAN,9,false,34,39,73,136,138,274,7,14,21,1,2:59
632293,2021-09-30,2021,ATL,PHI,5,3,5-3,ATL,9,true,34,35,69,125,142,267,10,9,19,2,2:53
632270,2021-10-01,2021,SEA,ANA,1,2,2-1,ANA,9,false,34,33,67,146,147,293,9,8,17,2,3:13
632429,2021-09-20,2021,PHI,BAL,0,2,2-0,BAL,9,false,32,35,67,144,124,268,5,10,15,1,2:49
632968,2021-08-07,2021,SLN,KCA,5,2,5-2,SLN,9,true,37,34,71,156,133,289,15,7,22,1,3:07
632292,2021-09-30,2021,HOU,TBA,3,2,3-2,HOU,9,true,32,32,64,142,128,270,8,7,15,1,3:00
632236,2021-10-03,2021,TEX,CLE,0,6,6-0,CLE,9,false,32,39,71,156,128,284,5,11,16,1,2:54
632265,2021-10-02,2021,CHA,DET,5,4,5-4,CHA,9,true,34,36,70,147,127,274,10,10,20,2,3:05 (:26 delay)
633030,2021-08-03,2021,CHA,KCA,7,1,7-1,CHA,9,true,35,33,68,138,139,277,12,5,17,1,2:44
633089,2021-08-01,2021,TBA,BOS,3,2,3-2,TBA,9,true,30,39,69,149,112,261,8,12,20,2,2:51
632927,2021-08-11,2021,MIN,CHA,1,0,1-0,MIN,9,true,31,35,66,131,138,269,8,9,17,2,2:48
632994,2021-08-07,2021,ATL,WAS,2,3,3-2,WAS,9,false,36,37,73,131,139,270,9,11,20,0,3:01
632460,2021-09-17,2021,MIA,PIT,1,2,2-1,PIT,9,false,34,39,73,133,147,280,8,14,22,2,3:04
632312,2021-09-28,2021,SEA,OAK,4,2,4-2,SEA,9,true,38,36,74,113,148,261,14,8,22,4,3:08
632306,2021-09-29,2021,ATL,PHI,7,2,7-2,ATL,9,true,40,33,73,123,139,262,16,6,22,2,3:05
632247,2021-10-02,2021,TOR,BAL,10,1,10-1,TOR,9,true,39,31,70,111,140,251,14,4,18,1,2:47
632812,2021-08-22,2021,CLE,ANA,3,0,3-0,CLE,9,true,33,33,66,136,118,254,9,8,17,1,2:47
632973,2021-08-10,2021,HOU,COL,5,0,5-0,HOU,9,true,36,35,71,165,155,320,13,10,23,3,3:28
632933,2021-08-10,2021,SFN,ARI,8,7,8-7,SFN,9,false,41,38,79,138,158,296,17,12,29,3,3:10
633087,2021-08-03,2021,DET,BOS,4,2,4-2,DET,9,true,34,38,72,167,146,313,11,11,22,2,3:24
633061,2021-08-03,2021,LAN,HOU,0,3,3-0,HOU,9,false,37,38,75,155,151,306,9,15,24,1,3:23
632956,2021-08-08,2021,LAN,ANA,8,2,8-2,LAN,9,true,40,39,79,148,141,289,17,12,29,1,2:58
633018,2021-08-04,2021,NYA,BAL,10,3,10-3,NYA,9,true,40,32,72,122,152,274,17,7,24,3,2:56
632734,2021-08-27,2021,TEX,HOU,4,5,5-4,HOU,9,false,40,39,79,151,140,291,14,12,26,1,3:15
632526,2021-09-12,2021,PIT,WAS,2,6,6-2,WAS,9,false,33,41,74,144,135,279,8,16,24,2,3:06
633074,2021-08-06,2021,PHI,NYN,4,2,4-2,PHI,9,true,33,37,70,159,141,300,10,9,19,0,3:16
632951,2021-08-11,2021,SFN,ARI,7,2,7-2,SFN,9,true,37,38,75,154,136,290,15,12,27,0,3:14
632745,2021-08-26,2021,NYN,SFN,2,3,3-2,SFN,9,false,38,35,73,128,140,268,14,8,22,3,3:07
632491,2021-09-14,2021,SFN,SDN,6,1,6-1,SFN,9,true,41,32,73,117,163,280,19,4,23,4,3:17
632989,2021-08-10,2021,ATL,CIN,3,2,3-2,ATL,9,true,35,35,70,149,141,290,11,9,20,3,3:02
632756,2021-08-25,2021,BAL,ANA,10,6,10-6,BAL,9,true,39,38,77,131,158,289,16,13,29,7,3:22
632318,2021-09-28,2021,LAN,SDN,2,1,2-1,LAN,9,true,39,33,72,123,157,280,16,8,24,1,3:04
632524,2021-09-12,2021,SEA,ARI,4,5,5-4,ARI,9,false,37,37,74,115,152,267,8,12,20,3,3:03
632423,2021-09-20,2021,DET,CHA,4,3,4-3,DET,9,true,32,36,68,141,143,284,7,9,16,0,2:56
632316,2021-09-28,2021,HOU,TBA,4,3,4-3,HOU,9,false,36,36,72,152,132,284,12,10,22,2,2:59
632436,2021-09-17,2021,SLN,SDN,8,2,8-2,SLN,9,true,35,37,72,147,140,287,11,11,22,4,3:13
632305,2021-09-29,2021,HOU,TBA,0,7,7-0,TBA,9,false,32,39,71,148,124,272,5,17,22,1,3:04
632371,2021-09-23,2021,ANA,HOU,3,2,3-2,ANA,9,true,34,38,72,149,136,285,10,11,21,2,3:18
632564,2021-09-09,2021,SLN,LAN,2,1,2-1,SLN,9,true,32,34,66,134,129,263,8,7,15,1,2:56
632439,2021-09-18,2021,TEX,CHA,2,1,2-1,TEX,9,true,35,37,72,148,125,273,12,10,22,1,3:15
632308,2021-09-28,2021,TEX,ANA,5,2,5-2,TEX,9,true,35,32,67,133,141,274,13,6,19,2,2:59
632374,2021-09-23,2021,ARI,ATL,6,4,6-4,ARI,9,true,36,37,73,148,130,278,14,12,26,2,2:56
632698,2021-08-29,2021,PIT,SLN,4,3,4-3,PIT,9,false,33,35,68,144,129,273,8,11,19,1,3:00
633008,2021-08-06,2021,SDN,ARI,5,8,8-5,ARI,9,false,40,39,79,147,144,291,14,14,28,3,3:09
633034,2021-08-05,2021,CIN,PIT,7,4,7-4,CIN,9,true,36,37,73,159,152,311,12,12,24,0,3:17
632998,2021-08-05,2021,HOU,MIN,3,5,5-3,MIN,9,false,34,42,76,161,142,303,7,16,23,3,3:14
633013,2021-08-05,2021,NYA,SEA,5,3,5-3,NYA,9,true,37,38,75,158,145,303,13,14,27,0,3:13
633052,2021-08-04,2021,DET,BOS,1,4,4-1,BOS,9,false,38,38,76,144,164,308,11,13,24,2,3:20
633041,2021-08-02,2021,TOR,CLE,2,5,5-2,CLE,10,false,38,42,80,173,142,315,9,13,22,0,3:14
632583,2021-09-07,2021,ATL,WAS,8,5,8-5,ATL,9,true,38,40,78,144,141,285,15,15,30,2,3:14
632856,2021-08-18,2021,WAS,TOR,8,5,8-5,WAS,9,true,40,39,79,146,149,295,17,13,30,5,3:19
632789,2021-08-24,2021,MIA,WAS,1,5,5-1,WAS,9,false,35,40,75,151,153,304,9,15,24,2,3:16
632286,2021-09-30,2021,PIT,CHN,0,9,9-0,CHN,9,false,32,42,74,151,116,267,8,16,24,0,2:49
632240,2021-10-03,2021,PIT,CIN,3,6,6-3,CIN,9,false,36,41,77,155,123,278,10,15,25,1,2:59
632377,2021-09-22,2021,TBA,TOR,7,1,7-1,TBA,9,true,38,37,75,140,146,286,15,9,24,4,3:20
632420,2021-09-19,2021,ANA,OAK,2,3,3-2,OAK,10,false,38,44,82,155,125,280,9,16,25,2,3:21
632301,2021-09-29,2021,SLN,MIL,0,4,4-0,MIL,9,false,33,38,71,147,139,286,7,12,19,1,2:48
632300,2021-09-29,2021,MIN,DET,5,2,5-2,MIN,9,true,35,40,75,146,127,273,12,14,26,2,3:05
633020,2021-08-06,2021,MIL,SFN,2,1,2-1,MIL,10,false,33,37,70,149,128,277,7,6,13,0,3:08
633084,2021-08-01,2021,SDN,COL,8,1,8-1,SDN,9,true,38,34,72,132,160,292,14,10,24,1,3:02
632416,2021-09-19,2021,KCA,SEA,1,7,7-1,SEA,9,false,31,43,74,177,117,294,4,18,22,1,3:04
632913,2021-08-14,2021,MIN,TBA,12,0,12-0,MIN,9,true,45,30,75,102,164,266,21,5,26,0,2:51
632921,2021-08-13,2021,WAS,ATL,2,4,4-2,ATL,9,false,38,34,72,122,146,268,13,8,21,1,3:02 (3:12 delay)
632917,2021-08-15,2021,ARI,SDN,2,8,8-2,SDN,9,false,36,45,81,176,122,298,9,22,31,1,3:19
632883,2021-08-16,2021,KCA,HOU,7,6,7-6,KCA,9,true,40,37,77,104,143,247,16,13,29,3,3:06
632346,2021-09-25,2021,MIL,NYN,2,1,2-1,MIL,9,true,33,34,67,139,146,285,11,8,19,0,3:16
632738,2021-08-25,2021,CHN,COL,5,2,5-2,CHN,7,true,27,25,52,95,107,202,9,4,13,2,2:09
632241,2021-10-03,2021,SFN,SDN,11,4,11-4,SFN,9,true,40,36,76,128,138,266,16,10,26,3,2:56
633045,2021-08-03,2021,CIN,MIN,5,7,7-5,MIN,9,false,37,41,78,184,139,323,12,15,27,2,3:37
633040,2021-08-04,2021,WAS,PHI,5,9,9-5,PHI,9,false,36,44,80,159,132,291,9,15,24,2,3:10
632962,2021-08-07,2021,OAK,TEX,12,3,12-3,OAK,9,true,44,37,81,138,174,312,22,10,32,1,3:04
633031,2021-08-06,2021,ATL,WAS,8,4,8-4,ATL,9,true,41,34,75,146,164,310,17,9,26,2,3:11
632906,2021-08-13,2021,SFN,COL,5,4,5-4,SFN,9,true,39,41,80,152,141,293,15,14,29,1,3:13
632588,2021-09-07,2021,BOS,TBA,7,12,12-7,TBA,9,false,43,41,84,145,149,294,16,15,31,1,2:57
632422,2021-09-19,2021,HOU,ARI,7,6,7-6,HOU,9,true,38,36,74,138,165,303,14,10,24,2,3:17
632443,2021-09-19,2021,SLN,SDN,8,7,8-7,SLN,9,true,36,38,74,150,130,280,13,12,25,3,3:16
632710,2021-09-01,2021,DET,OAK,8,6,8-6,DET,9,true,38,38,76,152,146,298,14,11,25,2,3:13
633078,2021-08-02,2021,NYA,BAL,1,7,7-1,BAL,9,false,37,38,75,158,152,310,11,13,24,1,3:12
632387,2021-09-23,2021,CIN,WAS,2,3,3-2,WAS,9,false,38,38,76,150,144,294,12,12,24,1,3:09
632336,2021-09-26,2021,MIN,TOR,2,5,5-2,TOR,9,false,37,38,75,151,146,297,12,11,23,3,3:27
633075,2021-08-01,2021,TEX,SEA,4,3,4-3,TEX,9,false,33,40,73,184,123,307,10,15,25,1,3:05
632365,2021-09-23,2021,PHI,PIT,12,6,12-6,PHI,9,true,42,34,76,121,178,299,20,8,28,2,3:21
632935,2021-08-11,2021,KCA,NYA,2,5,5-2,NYA,9,false,36,39,75,145,150,295,9,16,25,3,3:22
632282,2021-10-01,2021,NYA,TBA,3,4,4-3,TBA,9,false,36,39,75,160,131,291,9,13,22,5,3:25
632424,2021-09-20,2021,ANA,HOU,0,10,10-0,HOU,9,false,35,45,80,166,123,289,10,19,29,1,3:12
632407,2021-09-19,2021,NYN,PHI,3,2,3-2,NYN,9,true,33,39,72,158,132,290,10,12,22,3,3:34
632446,2021-09-19,2021,TOR,MIN,5,3,5-3,TOR,9,true,37,35,72,131,159,290,14,7,21,1,2:58
633048,2021-08-01,2021,ANA,OAK,3,8,8-3,OAK,9,false,33,45,78,168,123,291,8,19,27,2,3:08
632941,2021-08-14,2021,MIA,CHN,5,4,5-4,MIA,9,true,35,33,68,126,152,278,8,8,16,1,3:03
632726,2021-08-26,2021,MIL,CIN,1,5,5-1,CIN,9,false,35,34,69,145,136,281,11,10,21,2,3:00
632884,2021-08-17,2021,SLN,MIL,0,2,2-0,MIL,9,false,34,42,76,145,140,285,7,17,24,0,3:15
632688,2021-08-31,2021,DET,OAK,3,9,9-3,OAK,9,false,38,42,80,153,137,290,12,16,28,1,2:58
632245,2021-10-03,2021,HOU,OAK,7,6,7-6,HOU,9,false,39,36,75,129,143,272,15,9,24,1,2:52
632666,2021-09-28,2021,NYN,MIA,2,1,2-1,NYN,9,false,32,32,64,127,136,263,10,6,16,1,2:59
632894,2021-08-14,2021,TEX,OAK,3,8,8-3,OAK,9,false,36,38,74,154,105,259,11,11,22,2,2:55
632954,2021-08-13,2021,SEA,TOR,3,2,3-2,SEA,9,false,34,38,72,127,124,251,10,14,24,2,3:00
632327,2021-09-26,2021,ANA,SEA,1,5,5-1,SEA,9,false,33,40,73,171,122,293,6,12,18,2,3:09
632611,2021-09-04,2021,WAS,NYN,4,3,4-3,WAS,7,true,24,29,53,109,96,205,8,8,16,1,2:17
632953,2021-08-08,2021,NYA,SEA,0,2,2-0,SEA,9,false,38,38,76,174,160,334,11,11,22,1,3:48
633021,2021-08-04,2021,MIA,NYN,3,5,5-3,NYN,9,false,34,44,78,177,133,310,7,16,23,3,3:33
633023,2021-08-03,2021,NYA,BAL,13,1,13-1,NYA,9,true,40,36,76,138,164,302,16,10,26,1,3:04
632955,2021-08-10,2021,SEA,TEX,4,5,5-4,TEX,10,false,43,39,82,146,174,320,15,8,23,1,3:28
633068,2021-08-04,2021,MIL,PIT,4,2,4-2,MIL,9,true,34,38,72,152,163,315,10,12,22,1,3:16
632538,2021-09-11,2021,ATL,MIA,4,6,6-4,MIA,9,false,40,40,80,137,167,304,12,13,25,1,3:23
632519,2021-09-12,2021,MIN,KCA,3,5,5-3,KCA,9,false,36,41,77,158,139,297,9,14,23,3,3:31
632510,2021-09-12,2021,CLE,MIL,1,11,11-1,MIL,9,false,31,44,75,165,141,306,5,15,20,1,2:59
632944,2021-08-12,2021,PIT,SLN,6,7,7-6,SLN,9,false,38,41,79,155,153,308,12,15,27,2,3:39
632250,2021-10-01,2021,PIT,CIN,9,2,9-2,PIT,9,true,39,35,74,148,152,300,17,8,25,3,3:21
633033,2021-08-05,2021,MIA,NYN,4,2,4-2,MIA,9,true,33,44,77,190,122,312,11,17,28,3,3:38
632277,2021-10-01,2021,ATL,NYN,3,4,4-3,NYN,9,false,36,36,72,131,155,286,9,13,22,0,3:02
632489,2021-09-13,2021,TOR,TBA,8,1,8-1,TOR,9,true,42,30,72,113,169,282,19,3,22,2,2:53
632271,2021-10-01,2021,MIA,PHI,0,5,5-0,PHI,9,false,35,39,74,140,133,273,11,13,24,0,3:01
632689,2021-09-01,2021,MIN,CHN,0,3,3-0,CHN,9,false,32,31,63,134,126,260,6,5,11,0,2:28
632932,2021-08-13,2021,ARI,SDN,3,2,3-2,ARI,9,false,35,37,72,130,157,287,13,10,23,1,3:06
632862,2021-08-18,2021,COL,SDN,7,5,7-5,COL,9,true,35,39,74,134,142,276,13,12,25,2,3:10
632820,2021-08-14,2021,PIT,MIL,14,4,14-4,PIT,7,true,40,28,68,103,162,265,23,8,31,2,2:43
632765,2021-08-29,2021,CHA,CHN,13,1,13-1,CHA,9,true,39,33,72,147,133,280,17,7,24,2,3:00
632908,2021-08-17,2021,CHA,OAK,9,0,9-0,CHA,9,true,38,31,69,111,158,269,15,8,23,1,2:46
632322,2021-09-28,2021,COL,WAS,3,1,3-1,COL,9,true,36,35,71,117,142,259,14,12,26,1,3:00
632562,2021-09-09,2021,OAK,CHA,3,1,3-1,OAK,9,true,32,34,66,127,129,256,9,8,17,0,2:41
633581,2021-09-14,2021,MIN,CLE,1,3,3-1,CLE,7,false,24,29,53,99,83,182,4,8,12,1,2:06
632992,2021-08-05,2021,WAS,PHI,6,7,7-6,PHI,9,false,42,41,83,146,170,316,16,15,31,2,3:43
632533,2021-09-11,2021,CLE,MIL,0,3,3-0,MIL,9,false,28,38,66,134,124,258,1,11,12,0,2:39
632842,2021-08-21,2021,OAK,SFN,5,6,6-5,SFN,9,false,38,42,80,164,149,313,11,16,27,2,3:33
633053,2021-08-04,2021,CHA,KCA,1,9,9-1,KCA,9,false,32,40,72,168,147,315,6,14,20,0,3:14
632907,2021-08-14,2021,SEA,TOR,9,3,9-3,SEA,9,true,36,40,76,176,140,316,13,13,26,4,3:32
632673,2021-08-29,2021,PHI,ARI,7,4,7-4,PHI,9,true,39,41,80,168,143,311,17,14,31,2,3:25
632382,2021-09-22,2021,PHI,BAL,4,3,4-3,PHI,9,true,35,38,73,165,142,307,13,13,26,3,3:19
633037,2021-08-04,2021,SLN,ATL,4,7,7-4,ATL,9,false,38,40,78,162,153,315,11,13,24,2,3:28
633001,2021-08-07,2021,COL,MIA,7,4,7-4,COL,9,true,40,41,81,158,133,291,18,14,32,2,3:17
632295,2021-09-29,2021,TEX,ANA,2,7,7-2,ANA,9,false,36,39,75,161,135,296,9,14,23,3,3:20
632386,2021-09-22,2021,MIL,SLN,2,10,10-2,SLN,9,false,32,46,78,172,119,291,5,17,22,2,2:57
632419,2021-09-19,2021,BOS,BAL,8,6,8-6,BOS,9,true,36,40,76,151,124,275,13,14,27,3,2:55
632503,2021-09-14,2021,PIT,CIN,6,5,6-5,PIT,9,true,35,40,75,154,141,295,12,13,25,1,3:00
632901,2021-08-13,2021,PHI,CIN,1,6,6-1,CIN,9,false,33,36,69,138,144,282,6,11,17,0,2:58
632487,2021-09-15,2021,PIT,CIN,5,4,5-4,PIT,9,false,40,37,77,145,138,283,15,11,26,1,3:03 (:25 delay)
632536,2021-09-09,2021,MIA,NYN,3,2,3-2,MIA,9,true,30,36,66,138,116,254,8,11,19,3,2:59
632274,2021-10-01,2021,CHA,DET,8,1,8-1,CHA,9,true,43,35,78,151,151,302,19,11,30,1,3:25
633025,2021-08-03,2021,ARI,SFN,3,1,3-1,ARI,9,true,39,34,73,137,159,296,15,8,23,0,3:10
632800,2021-08-27,2021,NYN,WAS,1,2,2-1,WAS,9,false,31,36,67,157,128,285,5,9,14,0,3:03 (:21 delay)
632323,2021-09-27,2021,SEA,OAK,13,4,13-4,SEA,9,true,42,35,77,143,157,300,19,8,27,2,3:20
632811,2021-08-20,2021,LAN,NYN,3,2,3-2,LAN,9,true,30,35,65,129,110,239,6,8,14,1,2:39
632493,2021-09-14,2021,MIN,CLE,6,3,6-3,MIN,7,true,26,28,54,112,95,207,10,7,17,2,2:17
632615,2021-09-04,2021,COL,ATL,7,6,7-6,COL,9,true,37,38,75,151,138,289,14,10,24,3,3:10
632625,2021-09-04,2021,ANA,TEX,4,1,4-1,ANA,9,true,31,31,62,100,112,212,7,5,12,1,2:21
633043,2021-08-05,2021,SLN,ATL,4,8,8-4,ATL,9,false,37,43,80,161,156,317,12,19,31,4,3:30
632966,2021-08-10,2021,NYN,WAS,8,7,8-7,NYN,9,true,39,41,80,161,139,300,14,14,28,2,3:37 (1:57 delay)
632966,2021-08-10,2021,NYN,WAS,8,7,8-7,NYN,9,true,39,41,80,161,139,300,14,14,28,2,3:37 (1:57 delay)
632825,2021-08-17,2021,WAS,TOR,12,6,12-6,WAS,9,true,38,41,79,163,137,300,16,15,31,2,3:25
633026,2021-08-05,2021,DET,BOS,8,1,8-1,DET,9,true,39,39,78,152,166,318,15,12,27,2,3:14
632866,2021-08-15,2021,MIN,TBA,5,4,5-4,MIN,9,false,38,38,76,149,166,315,14,10,24,2,3:21
632302,2021-09-29,2021,KCA,CLE,10,5,10-5,KCA,9,true,40,39,79,168,137,305,17,13,30,1,3:16
633101,2021-08-01,2021,ARI,LAN,0,13,13-0,LAN,9,false,31,50,81,195,122,317,5,24,29,1,3:13
632961,2021-08-15,2021,BOS,BAL,6,2,6-2,BOS,9,true,38,37,75,139,161,300,16,11,27,2,3:07
632999,2021-08-07,2021,CIN,PIT,11,3,11-3,CIN,9,true,41,36,77,149,164,313,20,11,31,2,3:15
632262,2021-10-02,2021,ATL,NYN,6,5,6-5,ATL,9,true,37,41,78,161,148,309,14,14,28,1,3:13
632244,2021-10-02,2021,WAS,BOS,3,5,5-3,BOS,9,false,37,40,77,170,142,312,10,14,24,5,3:53
633056,2021-08-03,2021,TEX,ANA,3,11,11-3,ANA,9,false,35,44,79,178,134,312,8,19,27,3,3:23
632242,2021-10-03,2021,LAN,MIL,10,3,10-3,LAN,9,true,39,37,76,147,158,305,16,9,25,3,3:20
633072,2021-08-02,2021,MIL,PIT,6,2,6-2,MIL,9,true,37,37,74,162,156,318,15,11,26,2,3:30
632350,2021-09-25,2021,MIN,TOR,1,6,6-1,TOR,9,false,36,39,75,154,150,304,10,14,24,0,3:18
632902,2021-08-13,2021,BOS,BAL,8,1,8-1,BOS,9,true,40,36,76,141,159,300,16,9,25,0,3:05
632959,2021-08-11,2021,SDN,MIA,0,7,7-0,MIA,9,false,33,44,77,180,125,305,7,20,27,2,3:07
632936,2021-08-13,2021,TEX,OAK,8,6,8-6,TEX,9,true,40,39,79,154,139,293,15,14,29,2,3:02
632565,2021-09-08,2021,MIL,PHI,4,3,4-3,MIL,9,true,36,35,71,168,143,311,12,10,22,2,3:29
632920,2021-08-13,2021,DET,CLE,4,7,7-4,CLE,9,false,35,41,76,155,137,292,8,13,21,1,2:57
632937,2021-08-11,2021,CLE,OAK,3,6,6-3,OAK,9,false,33,38,71,149,152,301,9,13,22,2,3:14 (:50 delay)
632208,2021-08-10,2021,TOR,ANA,3,6,6-3,ANA,7,false,31,35,66,144,111,255,12,14,26,2,2:43
632820,2021-08-14,2021,PIT,MIL,14,4,14-4,PIT,7,true,40,28,68,103,162,265,23,8,31,2,2:43
632606,2021-09-05,2021,COL,ATL,2,9,9-2,ATL,9,false,31,39,70,136,107,243,4,13,17,2,2:38
632860,2021-08-15,2021,KCA,SLN,2,7,7-2,SLN,9,false,37,41,78,147,135,282,11,15,26,2,3:04
632363,2021-09-24,2021,CLE,CHA,0,1,1-0,CHA,9,false,32,31,63,111,147,258,7,5,12,2,2:48
632626,2021-09-04,2021,MIA,PHI,3,2,3-2,MIA,9,true,32,37,69,149,124,273,8,12,20,1,3:06
632716,2021-08-28,2021,MIN,MIL,6,4,6-4,MIN,9,true,36,36,72,117,129,246,13,9,22,2,2:47
633028,2021-08-06,2021,LAN,ANA,3,4,4-3,ANA,10,false,43,37,80,141,181,322,13,11,24,4,4:01
633042,2021-08-05,2021,ARI,SFN,4,5,5-4,SFN,10,false,42,43,85,160,161,321,13,13,26,2,3:40
633071,2021-08-04,2021,CIN,MIN,6,5,6-5,CIN,9,true,37,41,78,181,159,340,14,16,30,3,3:15
633011,2021-08-04,2021,TOR,CLE,8,6,8-6,TOR,9,true,38,44,82,161,165,326,15,17,32,3,3:16
632974,2021-08-06,2021,TOR,BOS,12,4,12-4,TOR,9,true,44,40,84,171,148,319,21,14,35,2,3:34
632960,2021-08-10,2021,BAL,DET,4,9,9-4,DET,9,false,38,40,78,171,162,333,11,15,26,2,3:13 (1:54 delay)
632425,2021-09-18,2021,MIL,CHN,6,4,6-4,MIL,9,true,38,41,79,151,159,310,13,14,27,1,3:35
632332,2021-09-26,2021,CHN,SLN,2,4,4-2,SLN,9,false,39,41,80,159,160,319,14,15,29,3,3:36
632623,2021-09-04,2021,ARI,SEA,5,8,8-5,SEA,9,false,39,42,81,155,145,300,14,16,30,1,3:10
632373,2021-09-24,2021,BOS,NYA,3,8,8-3,NYA,9,false,37,44,81,166,148,314,12,18,30,2,3:31
632276,2021-10-01,2021,ARI,COL,7,9,9-7,COL,9,false,37,42,79,157,152,309,10,15,25,2,3:22
632259,2021-10-02,2021,NYA,TBA,2,12,12-2,TBA,9,false,35,47,82,175,140,315,7,23,30,4,3:26
632368,2021-09-23,2021,OAK,SEA,5,6,6-5,SEA,9,false,40,37,77,149,155,304,13,10,23,2,3:16
632435,2021-09-20,2021,CIN,PIT,9,5,9-5,CIN,9,true,41,35,76,130,184,314,17,9,26,2,3:25 (1:25 delay)
632691,2021-08-30,2021,WAS,PHI,4,7,7-4,PHI,9,false,40,42,82,164,146,310,13,15,28,1,3:37
632508,2021-09-12,2021,CHN,SFN,5,6,6-5,SFN,9,false,39,40,79,152,126,278,12,15,27,1,3:02
632696,2021-08-29,2021,TEX,HOU,13,2,13-2,TEX,9,true,45,34,79,132,157,289,20,8,28,3,3:12
632889,2021-08-14,2021,SFN,COL,1,4,4-1,COL,9,false,34,37,71,138,156,294,10,10,20,1,3:07
632614,2021-09-05,2021,KCA,CHA,6,0,6-0,KCA,9,true,36,34,70,139,142,281,11,8,19,1,2:54
632926,2021-08-13,2021,MIN,TBA,4,10,10-4,TBA,9,false,38,44,82,152,146,298,13,16,29,2,3:14
632671,2021-09-01,2021,CHA,PIT,6,3,6-3,CHA,9,true,38,36,74,132,134,266,16,10,26,2,2:59
632284,2021-09-30,2021,KCA,CLE,1,6,6-1,CLE,9,false,37,39,76,137,148,285,11,12,23,0,3:04
632814,2021-08-20,2021,BAL,ATL,0,3,3-0,ATL,9,false,29,39,68,152,90,242,4,11,15,2,2:29
633017,2021-08-06,2021,OAK,TEX,4,1,4-1,OAK,11,false,38,38,76,153,153,306,11,6,17,0,3:30
632345,2021-09-26,2021,BOS,NYA,3,6,6-3,NYA,9,false,38,37,75,149,130,279,12,14,26,3,3:42 (:04 delay)
632929,2021-08-12,2021,ATL,CIN,3,12,12-3,CIN,9,false,38,44,82,170,155,325,10,17,27,1,3:12
633046,2021-08-04,2021,ARI,SFN,1,7,7-1,SFN,9,false,34,41,75,183,143,326,7,13,20,1,3:31
632978,2021-08-10,2021,CLE,OAK,3,4,4-3,OAK,10,false,40,41,81,166,168,334,12,14,26,1,3:42
632915,2021-08-11,2021,PHI,LAN,2,8,8-2,LAN,9,false,36,45,81,206,123,329,9,19,28,1,3:50 (:57 delay)
632359,2021-09-24,2021,ANA,SEA,5,6,6-5,SEA,9,false,42,37,79,156,161,317,18,10,28,5,3:40
632253,2021-10-03,2021,ARI,COL,5,4,5-4,ARI,9,false,38,38,76,150,162,312,13,11,24,2,3:21
632248,2021-10-01,2021,TEX,CLE,6,9,9-6,CLE,9,false,37,43,80,167,139,306,11,15,26,2,3:06
632273,2021-10-01,2021,LAN,MIL,8,6,8-6,LAN,9,true,37,39,76,172,132,304,15,12,27,4,3:38
632596,2021-09-06,2021,HOU,SEA,11,2,11-2,HOU,9,true,47,36,83,140,162,302,22,13,35,3,3:23
632369,2021-09-24,2021,BAL,TEX,5,8,8-5,TEX,9,false,38,42,80,146,159,305,12,17,29,5,3:33
632445,2021-09-17,2021,KCA,SEA,2,6,6-2,SEA,9,false,39,38,77,169,145,314,14,15,29,4,3:35
632459,2021-09-17,2021,TEX,CHA,0,8,8-0,CHA,9,false,39,44,83,169,150,319,13,17,30,1,3:27
632454,2021-09-17,2021,BOS,BAL,7,1,7-1,BOS,9,true,40,32,72,150,181,331,17,6,23,2,3:27
632810,2021-08-21,2021,SLN,PIT,4,5,5-4,PIT,9,false,40,38,78,135,152,287,12,15,27,1,3:25
632892,2021-08-16,2021,CHA,OAK,5,2,5-2,CHA,9,true,37,37,74,144,151,295,14,11,25,0,3:16
632664,2021-08-30,2021,TBA,BOS,6,1,6-1,TBA,9,true,40,34,74,144,167,311,16,8,24,2,3:20
632335,2021-09-25,2021,TBA,MIA,7,3,7-3,TBA,9,true,38,41,79,166,119,285,14,16,30,2,2:59
632283,2021-09-30,2021,NYN,MIA,12,3,12-3,NYN,9,true,41,38,79,156,150,306,20,11,31,2,3:25
632832,2021-08-20,2021,CIN,MIA,5,3,5-3,CIN,9,true,34,35,69,135,101,236,10,7,17,1,2:35
632251,2021-10-02,2021,TEX,CLE,7,2,7-2,TEX,9,true,37,32,69,127,149,276,15,7,22,1,2:50
632517,2021-09-11,2021,SEA,ARI,3,7,7-3,ARI,9,false,36,38,74,149,132,281,9,13,22,2,2:57
632392,2021-09-22,2021,ARI,ATL,2,9,9-2,ATL,9,false,33,39,72,149,147,296,7,15,22,1,3:00
632905,2021-08-14,2021,BOS,BAL,16,2,16-2,BOS,9,true,44,34,78,143,153,296,23,9,32,2,3:12
632667,2021-09-04,2021,MIL,SLN,4,0,4-0,MIL,9,true,30,29,59,100,131,231,10,3,13,1,2:26
632775,2021-08-21,2021,TOR,DET,3,0,3-0,TOR,9,true,30,31,61,131,88,219,8,7,15,0,2:17
632401,2021-09-21,2021,OAK,SEA,2,5,5-2,SEA,9,false,36,39,75,152,145,297,10,13,23,0,2:59
632985,2021-08-08,2021,SLN,KCA,5,6,6-5,KCA,9,false,43,40,83,143,188,331,18,12,30,3,3:43 (2:10 delay)
633007,2021-08-08,2021,TOR,BOS,9,8,9-8,TOR,9,true,38,45,83,167,158,325,15,18,33,5,4:04
632751,2021-08-25,2021,SLN,DET,3,2,3-2,SLN,10,false,42,40,82,152,163,315,15,15,30,0,3:20
632971,2021-08-08,2021,BAL,TBA,6,9,9-6,TBA,9,false,41,41,82,180,165,345,17,15,32,2,3:32
632867,2021-08-15,2021,WAS,ATL,5,6,6-5,ATL,9,false,41,41,82,157,162,319,16,13,29,1,3:19
632551,2021-09-11,2021,NYN,NYA,7,8,8-7,NYA,9,false,44,38,82,145,188,333,17,11,28,2,3:58
632662,2021-09-01,2021,KCA,CLE,3,5,5-3,CLE,11,false,44,45,89,171,137,308,10,18,28,2,3:36
632411,2021-09-19,2021,MIA,PIT,6,5,6-5,MIA,10,false,41,40,81,158,161,319,15,10,25,2,3:36
632249,2021-10-02,2021,HOU,OAK,10,4,10-4,HOU,9,true,39,42,81,163,160,323,15,18,33,3,3:48
633029,2021-08-06,2021,HOU,MIN,4,5,5-4,MIN,11,false,46,43,89,152,179,331,12,9,21,1,3:54
632911,2021-08-13,2021,NYN,LAN,5,6,6-5,LAN,10,false,43,42,85,182,158,340,16,14,30,2,4:18
632448,2021-09-18,2021,MIA,PIT,3,6,6-3,PIT,9,false,33,43,76,163,146,309,8,16,24,1,3:30
632506,2021-09-14,2021,CHA,ANA,9,3,9-3,CHA,9,true,40,39,79,184,131,315,19,13,32,2,3:21
632466,2021-09-17,2021,ANA,OAK,4,5,5-4,OAK,9,false,38,43,81,178,127,305,11,18,29,3,3:19
632256,2021-10-02,2021,SFN,SDN,2,3,3-2,SDN,10,false,36,41,77,154,145,299,6,14,20,2,3:41
633014,2021-08-07,2021,BAL,TBA,3,12,12-3,TBA,9,false,35,47,82,174,125,299,9,17,26,1,3:02 (:27 delay)
632886,2021-08-16,2021,SFN,NYN,7,5,7-5,SFN,9,true,37,41,78,154,145,299,14,13,27,3,3:23
632266,2021-10-01,2021,SLN,CHN,4,3,4-3,SLN,9,false,38,38,76,154,140,294,14,14,28,2,3:25
633337,2021-09-24,2021,CHN,SLN,4,12,12-4,SLN,7,false,30,39,69,150,103,253,9,19,28,3,2:41
632750,2021-08-29,2021,DET,TOR,1,2,2-1,TOR,9,false,36,42,78,160,128,288,8,17,25,1,2:54 (:26 delay)
632577,2021-09-07,2021,NYA,TOR,1,5,5-1,TOR,9,false,34,37,71,147,132,279,8,11,19,2,2:56
633005,2021-08-03,2021,TBA,SEA,2,4,4-2,SEA,9,false,36,37,73,165,134,299,10,9,19,0,3:12
632730,2021-09-13,2021,NYA,MIN,6,5,6-5,NYA,10,false,36,42,78,168,151,319,10,12,22,5,3:31
632275,2021-09-30,2021,TEX,ANA,7,6,7-6,TEX,9,true,36,40,76,167,149,316,13,14,27,2,3:18
632885,2021-08-14,2021,WAS,ATL,2,12,12-2,ATL,9,false,36,45,81,181,128,309,8,19,27,2,3:17
632644,2021-09-03,2021,COL,ATL,4,3,4-3,COL,9,true,31,31,62,94,127,221,8,7,15,1,2:31
632849,2021-08-18,2021,TBA,BAL,8,4,8-4,TBA,9,true,41,35,76,156,149,305,18,8,26,1,3:09
632835,2021-08-19,2021,LAN,NYN,4,1,4-1,LAN,9,true,31,33,64,125,122,247,9,7,16,1,2:46
632545,2021-09-08,2021,OAK,CHA,5,1,5-1,OAK,9,true,35,35,70,127,123,250,12,10,22,1,2:50
632709,2021-08-27,2021,DET,TOR,2,1,2-1,DET,9,true,31,35,66,117,116,233,7,8,15,0,2:32
632656,2021-09-01,2021,LAN,ATL,4,3,4-3,LAN,9,true,34,34,68,129,146,275,10,7,17,3,3:00
633006,2021-08-06,2021,BAL,TBA,6,10,10-6,TBA,9,false,42,47,89,180,168,348,16,19,35,3,3:47
632584,2021-09-06,2021,MIL,PHI,0,12,12-0,PHI,9,false,34,47,81,179,139,318,7,20,27,2,3:21
632272,2021-10-01,2021,KCA,MIN,11,6,11-6,KCA,9,true,45,40,85,159,162,321,22,15,37,3,3:30
632269,2021-10-02,2021,ARI,COL,11,2,11-2,ARI,9,true,45,35,80,148,162,310,22,10,32,1,3:17
632235,2021-10-03,2021,TOR,BAL,12,4,12-4,TOR,9,true,41,44,85,154,168,322,18,17,35,1,3:22
632375,2021-09-23,2021,MIN,TOR,7,2,7-2,MIN,9,true,39,40,79,140,169,309,19,15,34,2,3:34
632467,2021-09-17,2021,NYN,PHI,3,4,4-3,PHI,9,false,38,37,75,161,167,328,12,10,22,3,3:52
632354,2021-09-25,2021,BOS,NYA,3,5,5-3,NYA,9,false,37,35,72,151,167,318,10,9,19,4,3:33
632280,2021-09-30,2021,TOR,NYA,2,6,6-2,NYA,9,false,38,37,75,162,163,325,12,10,22,2,3:29
632948,2021-08-10,2021,PIT,SLN,1,4,4-1,SLN,9,false,30,37,67,148,124,272,4,12,16,1,2:51
632969,2021-08-12,2021,PHI,LAN,2,1,2-1,PHI,9,true,32,36,68,147,121,268,10,10,20,2,3:10
632931,2021-08-11,2021,BOS,TBA,20,8,20-8,BOS,9,true,53,38,91,135,167,302,32,11,43,1,3:17
632444,2021-09-18,2021,ANA,OAK,1,3,3-1,OAK,9,false,35,35,70,134,143,277,8,9,17,1,3:06
632816,2021-08-19,2021,CIN,MIA,6,1,6-1,CIN,9,true,35,34,69,131,128,259,14,9,23,0,2:43
632315,2021-09-28,2021,KCA,CLE,6,4,6-4,KCA,9,true,33,39,72,137,151,288,8,13,21,7,3:24
632699,2021-09-01,2021,CIN,SLN,4,5,5-4,SLN,7,false,30,35,65,120,108,228,10,16,26,0,2:20
632367,2021-09-23,2021,MIL,SLN,5,8,8-5,SLN,9,false,38,39,77,149,165,314,12,15,27,1,3:31
632627,2021-09-03,2021,TBA,MIN,5,3,5-3,TBA,9,true,31,35,66,139,96,235,6,7,13,0,2:25
632659,2021-09-02,2021,SFN,MIL,5,1,5-1,SFN,9,true,33,31,64,122,116,238,8,6,14,1,2:31
632352,2021-09-24,2021,SDN,ATL,0,4,4-0,ATL,9,false,29,36,65,121,98,219,3,8,11,1,2:28
632824,2021-08-21,2021,CHN,KCA,2,4,4-2,KCA,9,false,30,38,68,136,117,253,3,11,14,1,3:02 (:34 delay)
632643,2021-09-08,2021,SLN,LAN,5,4,5-4,SLN,9,true,34,33,67,112,117,229,10,7,17,1,2:35
632873,2021-08-16,2021,MIN,CLE,5,4,5-4,MIN,10,false,48,41,89,152,175,327,24,12,36,1,3:43
632477,2021-09-15,2021,WAS,MIA,6,8,8-6,MIA,9,false,47,42,89,143,179,322,20,16,36,5,3:53
632878,2021-08-16,2021,CIN,CHN,14,5,14-5,CIN,9,true,46,38,84,150,204,354,22,12,34,3,3:37
633062,2021-08-06,2021,NYA,SEA,3,2,3-2,NYA,11,false,45,42,87,176,178,354,16,10,26,4,4:16
633224,2021-07-21,2021,ATL,SDN,5,6,6-5,SDN,7,false,31,33,64,156,162,318,11,14,25,3,3:17 (4:08 delay)
632349,2021-09-25,2021,COL,SFN,2,7,7-2,SFN,9,false,40,41,81,156,157,313,13,14,27,3,3:36
633070,2021-08-02,2021,TBA,SEA,2,8,8-2,SEA,9,false,35,45,80,187,150,337,9,19,28,1,3:20
632285,2021-09-30,2021,MIN,DET,7,10,10-7,DET,9,false,41,41,82,154,162,316,14,14,28,5,3:33
632900,2021-08-12,2021,CLE,OAK,0,17,17-0,OAK,9,false,31,54,85,203,107,310,6,27,33,3,3:27
632857,2021-08-15,2021,SEA,TOR,3,8,8-3,TOR,9,false,38,39,77,162,166,328,11,12,23,0,3:05
632925,2021-08-14,2021,ANA,HOU,2,8,8-2,HOU,9,false,39,42,81,153,151,304,13,17,30,3,3:35
632818,2021-08-14,2021,KCA,SLN,4,9,9-4,SLN,9,false,40,41,81,168,153,321,15,14,29,3,3:25
632257,2021-10-02,2021,SLN,CHN,5,6,6-5,CHN,9,false,39,40,79,152,175,327,13,15,28,0,3:25
632686,2021-09-02,2021,DET,OAK,6,8,8-6,OAK,9,false,41,44,85,164,162,326,14,17,31,3,3:36
632313,2021-09-28,2021,PIT,CHN,8,6,8-6,PIT,9,true,36,42,78,167,122,289,13,17,30,3,3:04
632361,2021-09-24,2021,DET,KCA,1,3,3-1,KCA,9,false,36,33,69,119,166,285,13,6,19,2,3:07
632358,2021-09-24,2021,TBA,MIA,8,0,8-0,TBA,9,true,41,29,70,115,173,288,17,4,21,0,2:59
632362,2021-09-24,2021,COL,SFN,2,7,7-2,SFN,9,false,39,40,79,160,123,283,12,14,26,2,3:06
632255,2021-10-02,2021,SEA,ANA,6,4,6-4,SEA,9,true,41,37,78,152,166,318,17,11,28,4,3:37
632799,2021-08-20,2021,NYA,MIN,10,2,10-2,NYA,9,true,41,34,75,135,171,306,19,8,27,1,3:02
633022,2021-08-03,2021,OAK,SDN,1,8,8-1,SDN,9,false,36,44,80,184,156,340,10,17,27,1,3:20
632841,2021-08-19,2021,ARI,PHI,6,2,6-2,ARI,9,true,33,37,70,131,125,256,9,10,19,1,2:48
632742,2021-08-27,2021,MIA,CIN,0,6,6-0,CIN,9,false,34,37,71,118,134,252,9,11,20,0,2:28
633372,2021-08-30,2021,DET,MIN,2,3,3-2,MIN,9,false,34,34,68,119,125,244,8,8,16,1,2:42
632782,2021-08-27,2021,ANA,SDN,0,5,5-0,SDN,9,false,32,41,73,144,111,255,5,13,18,2,2:42
632684,2021-08-29,2021,MIA,CIN,2,1,2-1,MIA,9,true,28,32,60,138,114,252,6,6,12,1,2:36
632261,2021-10-01,2021,WAS,BOS,2,4,4-2,BOS,9,false,41,40,81,137,170,307,15,14,29,3,3:25
632499,2021-09-14,2021,DET,MIL,1,0,1-0,DET,11,false,37,39,76,153,139,292,8,8,16,1,3:16 (1:49 delay)
632278,2021-09-30,2021,SFN,ARI,5,4,5-4,SFN,9,false,37,43,80,173,137,310,13,17,30,3,3:28
632699,2021-09-01,2021,CIN,SLN,4,5,5-4,SLN,7,false,30,35,65,120,108,228,10,16,26,0,2:20
632628,2021-09-06,2021,SLN,LAN,1,5,5-1,LAN,9,false,33,33,66,137,115,252,6,7,13,0,2:37
632733,2021-08-28,2021,ATL,SFN,0,5,5-0,SFN,9,false,35,39,74,153,134,287,9,12,21,0,2:53
632647,2021-09-05,2021,SDN,HOU,4,3,4-3,SDN,9,false,31,35,66,106,114,220,10,9,19,2,2:58
632727,2021-08-25,2021,PHI,TBA,4,7,7-4,TBA,9,false,36,39,75,118,122,240,11,11,22,2,2:48
632707,2021-08-28,2021,LAN,COL,5,2,5-2,LAN,9,true,35,31,66,133,166,299,15,5,20,5,3:42
632793,2021-08-22,2021,HOU,SEA,3,6,6-3,SEA,11,false,47,43,90,170,171,341,17,11,28,4,3:58
632670,2021-09-02,2021,WAS,PHI,6,7,7-6,PHI,9,false,42,41,83,181,161,342,15,13,28,5,3:52
632500,2021-09-14,2021,BAL,NYA,2,7,7-2,NYA,9,false,38,41,79,166,182,348,11,17,28,1,3:28
632258,2021-10-02,2021,PIT,CIN,8,6,8-6,PIT,9,true,44,39,83,161,174,335,24,14,38,2,3:42
632850,2021-08-18,2021,SFN,NYN,2,6,6-2,NYN,12,false,45,49,94,184,158,342,12,14,26,1,4:02
632279,2021-10-01,2021,HOU,OAK,6,8,8-6,OAK,9,false,44,40,84,157,178,335,17,10,27,6,3:54
632887,2021-08-18,2021,LAN,PIT,9,0,9-0,LAN,9,true,40,31,71,111,151,262,16,5,21,1,2:34
632653,2021-09-01,2021,TBA,BOS,2,3,3-2,BOS,9,false,36,35,71,161,131,292,12,10,22,2,3:13
632252,2021-10-03,2021,CHA,DET,2,5,5-2,DET,9,false,38,40,78,163,153,316,12,12,24,1,3:16
632243,2021-10-03,2021,KCA,MIN,3,7,7-3,MIN,9,false,38,36,74,145,151,296,12,10,22,2,3:10
632821,2021-08-21,2021,NYA,MIN,7,1,7-1,NYA,9,true,37,34,71,131,147,278,12,7,19,1,3:04
632631,2021-09-08,2021,SDN,ANA,8,5,8-5,SDN,9,true,39,36,75,151,169,320,16,9,25,4,3:31
632413,2021-09-19,2021,MIL,CHN,4,6,6-4,CHN,9,false,42,40,82,183,155,338,16,14,30,4,3:46
632693,2021-08-29,2021,SEA,KCA,4,3,4-3,SEA,9,true,34,36,70,133,135,268,9,10,19,0,2:51
632722,2021-08-28,2021,CHA,CHN,0,7,7-0,CHN,9,false,32,38,70,153,109,262,7,12,19,1,2:45
632804,2021-08-21,2021,TBA,CHA,8,4,8-4,TBA,9,true,37,35,72,130,124,254,15,10,25,2,2:27
632702,2021-08-28,2021,TEX,HOU,2,5,5-2,HOU,9,false,35,41,76,136,112,248,8,17,25,0,2:48
632372,2021-09-23,2021,CLE,CHA,5,3,5-3,CLE,7,false,29,31,60,123,115,238,12,11,23,2,2:34
632568,2021-09-12,2021,LAN,SDN,8,0,8-0,LAN,9,true,40,28,68,98,140,238,17,1,18,3,2:45
632287,2021-09-29,2021,PIT,CHN,2,3,3-2,CHN,9,false,36,44,80,176,144,320,10,20,30,2,3:44
632381,2021-09-22,2021,NYA,TEX,7,3,7-3,NYA,9,true,37,36,73,142,139,281,15,8,23,3,3:21
633082,2021-08-01,2021,PIT,PHI,4,15,15-4,PHI,9,false,36,52,88,204,151,355,9,25,34,2,3:44
632899,2021-08-15,2021,CHA,NYA,3,5,5-3,NYA,9,false,38,46,84,209,150,359,14,18,32,3,3:48
632914,2021-08-12,2021,ARI,SDN,12,3,12-3,ARI,9,true,46,36,82,143,204,347,24,10,34,4,3:42
632237,2021-10-03,2021,SEA,ANA,3,7,7-3,ANA,9,false,39,44,83,173,156,329,12,19,31,6,3:56
632307,2021-09-28,2021,SFN,ARI,6,4,6-4,SFN,9,true,42,37,79,155,181,336,18,11,29,1,3:42
632234,2021-10-03,2021,WAS,BOS,5,7,7-5,BOS,9,false,39,43,82,168,151,319,15,17,32,4,3:46
632338,2021-09-25,2021,CIN,WAS,7,6,7-6,CIN,9,false,39,43,82,159,164,323,17,17,34,4,3:41
632428,2021-09-21,2021,ARI,ATL,1,6,6-1,ATL,9,false,38,37,75,151,135,286,12,9,21,3,3:07
632868,2021-08-17,2021,DET,ANA,2,8,8-2,ANA,9,false,38,48,86,197,127,324,11,22,33,2,3:30
632976,2021-08-10,2021,SDN,MIA,6,5,6-5,SDN,9,true,37,37,74,153,134,287,14,12,26,4,3:24
632827,2021-08-20,2021,BOS,TEX,6,0,6-0,BOS,9,true,37,34,71,128,149,277,14,9,23,1,3:13
632787,2021-08-23,2021,TOR,CHA,2,1,2-1,TOR,9,true,31,36,67,143,104,247,7,11,18,0,2:44
632747,2021-08-25,2021,NYN,SFN,2,3,3-2,SFN,9,false,38,32,70,112,134,246,14,6,20,2,2:52
632597,2021-09-06,2021,CHN,CIN,4,3,4-3,CHN,9,true,32,36,68,124,125,249,7,10,17,1,2:45
632488,2021-09-18,2021,SLN,SDN,3,2,3-2,SLN,9,true,31,35,66,131,115,246,7,9,16,0,2:59
632398,2021-09-21,2021,CLE,KCA,4,1,4-1,CLE,9,true,32,36,68,131,129,260,9,11,20,1,2:35
633051,2021-08-08,2021,SDN,ARI,2,0,2-0,SDN,9,true,31,33,64,144,107,251,9,6,15,0,2:43
632389,2021-09-22,2021,BOS,NYN,12,5,12-5,BOS,9,true,40,41,81,161,162,323,17,16,33,1,3:42
632858,2021-08-16,2021,MIA,ATL,2,12,12-2,ATL,9,false,33,52,85,199,132,331,6,25,31,2,3:28
632343,2021-09-25,2021,SDN,ATL,8,10,10-8,ATL,10,false,42,49,91,202,142,344,13,19,32,2,4:07
632795,2021-08-21,2021,LAN,NYN,4,3,4-3,LAN,9,true,34,39,73,155,122,277,11,12,23,2,3:16
632981,2021-08-07,2021,PHI,NYN,5,3,5-3,PHI,9,true,35,39,74,172,141,313,11,11,22,3,3:35
632809,2021-08-20,2021,OAK,SFN,4,1,4-1,OAK,9,true,34,35,69,137,152,289,10,9,19,2,3:06
632797,2021-08-21,2021,CIN,MIA,7,4,7-4,CIN,9,true,33,37,70,130,122,252,12,16,28,3,2:52
632744,2021-08-24,2021,PIT,ARI,4,2,4-2,PIT,9,true,34,37,71,149,118,267,15,11,26,0,2:46
632903,2021-08-12,2021,BOS,TBA,1,8,8-1,TBA,9,false,31,41,72,151,117,268,5,17,22,4,2:59
632731,2021-09-01,2021,CIN,SLN,12,2,12-2,CIN,7,true,37,25,62,104,155,259,19,4,23,3,2:48
632470,2021-09-17,2021,CIN,LAN,3,1,3-1,CIN,9,true,32,36,68,136,118,254,9,9,18,1,2:34
633059,2021-08-03,2021,MIL,PIT,5,8,8-5,PIT,10,false,43,46,89,199,163,362,14,16,30,4,4:06
632370,2021-09-23,2021,SDN,SFN,7,6,7-6,SDN,10,false,44,40,84,174,181,355,17,11,28,3,4:10
632453,2021-09-17,2021,SFN,ATL,6,5,6-5,SFN,11,false,46,42,88,139,177,316,21,9,30,1,3:15
632661,2021-09-01,2021,SFN,MIL,2,5,5-2,MIL,9,false,39,42,81,165,164,329,14,15,29,1,3:45
632815,2021-08-20,2021,SLN,PIT,0,4,4-0,PIT,9,false,39,35,74,136,149,285,13,8,21,1,2:54
632794,2021-08-22,2021,SLN,PIT,3,0,3-0,SLN,9,true,37,31,68,119,150,269,14,4,18,0,2:55
632840,2021-08-19,2021,NYA,MIN,7,5,7-5,NYA,9,true,33,34,67,142,143,285,9,8,17,2,2:54
632529,2021-09-11,2021,HOU,ANA,2,4,4-2,ANA,9,false,38,40,78,138,171,309,12,15,27,2,3:42
632777,2021-08-24,2021,PHI,TBA,1,3,3-1,TBA,9,false,34,36,70,145,116,261,7,11,18,2,2:57
632544,2021-09-10,2021,OAK,TEX,10,5,10-5,OAK,9,true,44,38,82,155,163,318,20,11,31,2,3:25
632663,2021-08-31,2021,LAN,ATL,3,2,3-2,LAN,9,true,35,33,68,122,153,275,12,6,18,1,2:55
632485,2021-09-15,2021,TEX,HOU,2,7,7-2,HOU,9,false,32,39,71,148,113,261,5,14,19,2,2:56
632455,2021-09-18,2021,CIN,LAN,1,5,5-1,LAN,9,false,34,39,73,131,126,257,6,10,16,1,3:05
632433,2021-09-19,2021,SFN,ATL,0,3,3-0,ATL,9,false,30,37,67,133,121,254,5,11,16,2,2:51
632855,2021-08-18,2021,TEX,SEA,1,3,3-1,SEA,9,false,34,33,67,134,150,284,9,9,18,2,3:00
632534,2021-09-10,2021,SLN,CIN,2,4,4-2,CIN,9,false,35,36,71,129,140,269,7,10,17,0,2:43
632823,2021-08-19,2021,CHA,OAK,4,5,5-4,OAK,9,false,40,40,80,155,129,284,13,13,26,0,2:57
632566,2021-09-08,2021,CHN,CIN,4,1,4-1,CHN,10,false,33,35,68,115,141,256,6,7,13,0,2:49
632620,2021-09-06,2021,ANA,TEX,0,4,4-0,TEX,9,false,32,37,69,121,122,243,7,12,19,0,2:37
632706,2021-08-28,2021,OAK,NYA,3,2,3-2,OAK,9,true,34,32,66,126,128,254,10,6,16,1,2:45
633077,2021-08-02,2021,ARI,SFN,8,11,11-8,SFN,10,false,44,45,89,176,176,352,14,16,30,3,4:04
632579,2021-09-08,2021,CLE,MIN,0,3,3-0,MIN,9,false,28,33,61,126,110,236,1,8,9,0,2:23
632501,2021-09-11,2021,PIT,WAS,10,7,10-7,PIT,9,true,42,43,85,184,173,357,17,19,36,1,3:53
632531,2021-09-11,2021,CHA,BOS,8,9,9-8,BOS,10,false,44,46,90,186,160,346,17,16,33,3,4:12
632865,2021-08-18,2021,MIA,ATL,9,11,11-9,ATL,9,false,43,49,92,202,168,370,16,24,40,3,3:49
632833,2021-08-19,2021,TBA,BAL,7,2,7-2,TBA,9,true,37,35,72,142,151,293,14,9,23,1,2:49
632469,2021-09-17,2021,HOU,ARI,4,3,4-3,HOU,10,false,36,41,77,180,123,303,10,13,23,3,3:40
632749,2021-08-26,2021,OAK,NYA,6,7,7-6,NYA,9,false,39,39,78,170,173,343,12,13,25,2,3:43
632356,2021-09-24,2021,OAK,HOU,14,2,14-2,OAK,9,true,42,37,79,146,185,331,20,10,30,1,3:46
632896,2021-08-20,2021,MIL,WAS,1,4,4-1,WAS,9,false,31,41,72,148,128,276,5,17,22,3,3:09
632891,2021-08-15,2021,PHI,CIN,4,7,7-4,CIN,9,false,41,41,82,174,154,328,14,15,29,4,3:54
632991,2021-08-08,2021,CLE,DET,7,5,7-5,CLE,9,true,38,38,76,174,140,314,13,9,22,2,3:02 (:24 delay)
632717,2021-08-28,2021,NYN,WAS,5,3,5-3,NYN,9,true,34,37,71,134,124,258,11,12,23,2,3:02 (:23 delay)
632591,2021-09-06,2021,CLE,MIN,2,5,5-2,MIN,9,false,34,39,73,144,120,264,9,13,22,1,2:52
632680,2021-08-31,2021,TEX,COL,4,3,4-3,TEX,9,true,35,35,70,139,146,285,12,9,21,3,3:16
632309,2021-09-29,2021,BAL,BOS,0,6,6-0,BOS,9,false,34,39,73,160,131,291,6,14,20,1,3:02
632740,2021-08-27,2021,LAN,COL,2,4,4-2,COL,9,false,33,37,70,145,140,285,6,11,17,2,3:10
632542,2021-09-10,2021,LAN,SDN,3,0,3-0,LAN,9,true,33,36,69,126,130,256,11,9,20,0,2:53
632683,2021-08-31,2021,CHA,PIT,4,2,4-2,CHA,9,true,34,35,69,143,117,260,10,9,19,2,2:57
632311,2021-09-28,2021,NYN,MIA,5,2,5-2,NYN,7,true,31,26,57,103,110,213,11,7,18,0,2:22
632412,2021-09-20,2021,OAK,SEA,2,4,4-2,SEA,9,false,34,36,70,137,124,261,8,11,19,1,2:47
632296,2021-09-29,2021,TOR,NYA,6,5,6-5,TOR,9,true,34,35,69,146,123,269,10,8,18,1,2:52
632980,2021-08-06,2021,CHN,CHA,6,8,8-6,CHA,10,false,43,47,90,191,180,371,13,20,33,5,4:27 (:16 delay)
632408,2021-09-20,2021,MIA,WAS,8,7,8-7,MIA,10,false,39,49,88,179,180,359,12,22,34,3,3:55
632481,2021-09-15,2021,SEA,BOS,4,9,9-4,BOS,10,false,38,46,84,204,150,354,10,15,25,5,3:58
632837,2021-08-20,2021,CLE,ANA,9,1,9-1,CLE,9,true,43,32,75,114,176,290,19,5,24,0,3:02
632632,2021-09-03,2021,ANA,TEX,3,2,3-2,ANA,9,true,34,37,71,144,139,283,11,11,22,1,3:22
632657,2021-08-31,2021,SEA,HOU,4,0,4-0,SEA,9,true,34,35,69,122,167,289,11,10,21,1,3:13
632715,2021-08-31,2021,TOR,BAL,2,4,4-2,BAL,9,false,37,35,72,146,138,284,10,8,18,2,2:55
632675,2021-08-31,2021,ANA,NYA,6,4,6-4,ANA,9,true,32,37,69,153,132,285,9,15,24,4,3:12
632621,2021-09-03,2021,MIA,PHI,10,3,10-3,MIA,9,true,36,36,72,142,122,264,15,10,25,3,3:08
632757,2021-08-28,2021,MIA,CIN,6,1,6-1,MIA,9,true,39,35,74,130,151,281,15,9,24,0,3:00
632527,2021-09-11,2021,MIN,KCA,9,2,9-2,MIN,9,true,40,37,77,133,167,300,16,12,28,3,3:13
632320,2021-09-28,2021,ATL,PHI,2,1,2-1,ATL,9,true,31,35,66,146,116,262,6,8,14,0,2:46
632555,2021-09-10,2021,PIT,WAS,4,3,4-3,PIT,9,false,37,35,72,140,122,262,13,8,21,2,2:52
632509,2021-09-13,2021,LAN,ARI,5,1,5-1,LAN,9,true,40,36,76,129,145,274,16,9,25,3,3:15
632700,2021-08-29,2021,OAK,NYA,3,1,3-1,OAK,9,true,36,35,71,148,121,269,10,10,20,0,3:12
632805,2021-08-23,2021,ATL,NYA,1,5,5-1,NYA,9,false,35,38,73,154,123,277,9,11,20,1,2:58
632482,2021-09-14,2021,TEX,HOU,8,1,8-1,TEX,9,true,36,32,68,133,122,255,12,8,20,1,2:45
632658,2021-09-06,2021,BAL,KCA,2,3,3-2,KCA,9,false,34,38,72,144,131,275,8,12,20,2,3:02
632660,2021-09-03,2021,CHN,PIT,6,5,6-5,CHN,9,true,37,35,72,127,140,267,17,8,25,2,3:02
632687,2021-08-30,2021,SFN,MIL,1,3,3-1,MIL,9,false,34,38,72,140,129,269,7,12,19,3,3:15
632348,2021-09-25,2021,CLE,CHA,6,0,6-0,CLE,9,true,32,31,63,118,131,249,8,5,13,0,2:40
632575,2021-09-08,2021,BOS,TBA,2,1,2-1,BOS,9,true,32,34,66,132,115,247,10,9,19,2,2:46
632400,2021-09-22,2021,CHN,MIN,4,5,5-4,MIN,9,false,35,37,72,127,145,272,9,10,19,1,3:02
632808,2021-08-27,2021,PHI,ARI,7,6,7-6,PHI,11,false,47,42,89,182,180,362,17,9,26,1,4:12 (:26 delay)
632774,2021-08-20,2021,HOU,SEA,12,3,12-3,HOU,9,true,43,36,79,147,157,304,20,9,29,1,3:05
632854,2021-08-18,2021,CHA,OAK,3,2,3-2,CHA,9,true,35,40,75,170,110,280,12,13,25,4,3:20
632791,2021-08-22,2021,OAK,SFN,1,2,2-1,SFN,9,false,34,34,68,150,135,285,9,8,17,0,3:10
632360,2021-09-24,2021,PHI,PIT,8,6,8-6,PHI,9,true,38,42,80,152,153,305,14,16,30,3,3:39
632888,2021-08-20,2021,TOR,DET,1,4,4-1,DET,10,false,37,40,77,146,138,284,11,10,21,1,3:06
632848,2021-08-18,2021,ARI,PHI,4,2,4-2,ARI,9,true,38,34,72,136,147,283,17,8,25,2,2:57
632772,2021-08-22,2021,BAL,ATL,1,3,3-1,ATL,9,false,36,34,70,132,148,280,12,9,21,3,2:55
632712,2021-08-28,2021,PHI,ARI,7,0,7-0,PHI,9,true,36,31,67,151,129,280,13,4,17,0,2:57
632594,2021-09-07,2021,BAL,KCA,7,3,7-3,BAL,9,true,34,39,73,145,136,281,10,11,21,1,2:47
632748,2021-08-24,2021,SDN,LAN,2,5,5-2,LAN,9,false,36,35,71,130,159,289,9,9,18,3,3:23
632552,2021-09-10,2021,NYN,NYA,10,3,10-3,NYN,9,true,40,34,74,122,151,273,17,8,25,1,3:23
632355,2021-09-25,2021,BAL,TEX,3,2,3-2,BAL,9,true,31,35,66,146,123,269,10,11,21,3,2:54
632595,2021-09-07,2021,ARI,TEX,1,3,3-1,TEX,9,false,32,35,67,139,119,258,5,6,11,1,2:47
632692,2021-08-30,2021,CIN,SLN,1,3,3-1,SLN,9,false,32,36,68,152,125,277,4,10,14,2,2:47
632792,2021-08-23,2021,CHN,COL,6,4,6-4,CHN,9,false,37,36,73,130,140,270,14,10,24,1,2:58
632895,2021-08-15,2021,NYN,LAN,4,14,14-4,LAN,9,false,41,51,92,205,143,348,11,24,35,2,3:48
632677,2021-08-31,2021,WAS,PHI,6,12,12-6,PHI,9,false,43,51,94,177,163,340,17,26,43,5,3:50
632819,2021-08-14,2021,DET,CLE,6,4,6-4,DET,9,true,36,40,76,158,157,315,14,14,28,2,3:27
632752,2021-08-25,2021,TOR,CHA,3,1,3-1,TOR,9,true,36,34,70,140,151,291,11,8,19,1,3:06
632758,2021-08-23,2021,OAK,SEA,3,5,5-3,SEA,9,false,33,37,70,165,138,303,7,10,17,2,3:07
632762,2021-08-27,2021,PIT,SLN,3,4,4-3,SLN,9,false,38,37,75,140,146,286,13,12,25,1,3:18
632676,2021-08-31,2021,KCA,CLE,2,7,7-2,CLE,9,false,33,39,72,158,136,294,8,13,21,1,2:54
632634,2021-09-04,2021,BOS,CLE,4,3,4-3,BOS,9,false,40,35,75,136,153,289,16,10,26,4,3:09
632672,2021-08-31,2021,ARI,SDN,0,3,3-0,SDN,9,false,32,39,71,157,141,298,5,13,18,0,3:05
632314,2021-09-28,2021,SLN,MIL,6,2,6-2,SLN,9,true,35,38,73,137,118,255,12,12,24,0,2:54
632618,2021-09-05,2021,CIN,DET,1,4,4-1,DET,9,false,34,34,68,128,145,273,8,9,17,2,2:54
632540,2021-09-11,2021,PHI,COL,6,1,6-1,PHI,9,true,38,36,74,145,136,281,15,12,27,1,3:17
632593,2021-09-06,2021,NYA,TOR,0,8,8-0,TOR,9,false,30,40,70,140,121,261,5,13,18,0,2:45
632474,2021-09-16,2021,TBA,DET,5,2,5-2,TBA,9,true,37,32,69,136,129,265,14,8,22,1,2:38
632581,2021-09-07,2021,SDN,ANA,0,4,4-0,ANA,9,false,33,34,67,138,124,262,7,7,14,2,2:53
632769,2021-08-24,2021,OAK,SEA,1,5,5-1,SEA,9,false,36,40,76,167,128,295,10,14,24,2,3:09
632396,2021-09-21,2021,NYA,TEX,7,1,7-1,NYA,9,true,35,33,68,139,144,283,13,7,20,2,3:00
632607,2021-09-05,2021,TOR,OAK,8,0,8-0,TOR,9,true,41,32,73,145,147,292,17,5,22,2,3:02
632645,2021-09-03,2021,SFN,LAN,3,2,3-2,SFN,11,false,50,44,94,161,199,360,17,12,29,4,4:32
632732,2021-08-27,2021,ATL,SFN,6,5,6-5,ATL,9,true,34,35,69,143,123,266,10,9,19,1,2:54 (:35 delay)
632846,2021-08-19,2021,DET,ANA,10,13,13-10,ANA,9,false,43,52,95,205,158,363,16,24,40,7,3:58
632395,2021-09-22,2021,ANA,HOU,5,9,9-5,HOU,12,false,48,51,99,195,165,360,18,17,35,4,4:18
632831,2021-08-18,2021,MIN,CLE,8,7,8-7,MIN,11,false,48,50,98,197,145,342,18,18,36,3,4:16
632979,2021-08-09,2021,KCA,NYA,6,8,8-6,NYA,11,false,49,47,96,199,185,384,17,16,33,6,4:52
632522,2021-09-12,2021,NYN,NYA,7,6,7-6,NYN,9,true,40,40,80,190,146,336,15,14,29,3,4:06
632760,2021-08-25,2021,MIA,WAS,4,3,4-3,MIA,10,false,43,36,79,125,143,268,19,10,29,1,3:22
632739,2021-08-26,2021,SEA,KCA,4,6,6-4,KCA,9,false,39,39,78,135,154,289,13,12,25,3,3:26
632690,2021-08-30,2021,ANA,NYA,8,7,8-7,ANA,9,true,36,39,75,155,132,287,13,13,26,2,3:10
632513,2021-09-12,2021,CHA,BOS,2,1,2-1,CHA,9,false,33,33,66,131,137,268,9,7,16,2,2:57
633039,2021-08-08,2021,OAK,TEX,6,3,6-3,OAK,9,true,38,35,73,129,155,284,16,8,24,2,3:00
632530,2021-09-11,2021,LAN,SDN,5,4,5-4,LAN,9,true,29,37,66,131,142,273,7,11,18,2,3:02
632705,2021-08-29,2021,MIN,MIL,2,6,6-2,MIL,9,false,34,40,74,144,138,282,7,14,21,0,2:52
632668,2021-08-30,2021,TOR,BAL,7,3,7-3,TOR,9,true,34,34,68,134,138,272,11,8,19,4,2:55
632569,2021-09-07,2021,MIL,PHI,10,0,10-0,MIL,9,true,40,31,71,97,170,267,16,6,22,1,3:05
632637,2021-09-07,2021,CHN,CIN,3,4,4-3,CIN,9,false,35,39,74,125,138,263,8,14,22,1,2:49
632484,2021-09-15,2021,LAN,ARI,5,3,5-3,LAN,9,true,39,35,74,132,141,273,19,9,28,4,3:26
632674,2021-08-30,2021,LAN,ATL,5,3,5-3,LAN,9,true,35,35,70,130,134,264,12,8,20,2,3:00
632383,2021-09-22,2021,OAK,SEA,1,4,4-1,SEA,9,false,32,41,73,152,123,275,6,14,20,3,2:58
632498,2021-09-12,2021,BAL,TOR,7,22,22-7,TOR,9,false,38,55,93,213,164,377,11,29,40,3,3:26
632376,2021-09-23,2021,COL,LAN,5,7,7-5,LAN,10,false,41,45,86,167,177,344,12,16,28,1,4:01
632521,2021-09-15,2021,NYN,SLN,4,11,11-4,SLN,9,false,41,45,86,168,146,314,13,19,32,3,3:34
632834,2021-08-21,2021,HOU,SEA,15,1,15-1,HOU,9,true,42,37,79,152,171,323,18,11,29,2,3:22
632640,2021-09-01,2021,TOR,BAL,5,4,5-4,TOR,9,true,34,38,72,164,130,294,13,14,27,3,3:05
632711,2021-08-29,2021,NYN,WAS,9,4,9-4,NYN,9,true,41,37,78,152,151,303,19,9,28,1,3:26
632430,2021-09-17,2021,TOR,MIN,3,7,7-3,MIN,9,false,35,40,75,153,132,285,7,14,21,2,3:02
632958,2021-08-14,2021,NYN,LAN,1,2,2-1,LAN,10,false,37,36,73,141,146,287,7,7,14,3,3:21
632788,2021-08-26,2021,CLE,TEX,10,6,10-6,CLE,9,true,42,38,80,135,157,292,19,11,30,2,3:12
632585,2021-09-06,2021,PIT,DET,6,3,6-3,PIT,9,true,36,36,72,123,132,255,14,10,24,1,2:46
632317,2021-09-28,2021,BAL,BOS,4,2,4-2,BAL,9,true,34,32,66,116,131,247,11,5,16,1,2:37
632310,2021-09-29,2021,COL,WAS,10,5,10-5,COL,9,true,43,41,84,187,183,370,21,16,37,5,3:57 (2:00 delay)
632828,2021-08-20,2021,COL,ARI,9,4,9-4,COL,9,true,42,44,86,156,135,291,19,18,37,1,3:16
632767,2021-08-25,2021,BOS,MIN,6,9,9-6,MIN,10,false,47,45,92,173,179,352,19,16,35,3,4:07
632624,2021-09-04,2021,CHN,PIT,7,6,7-6,CHN,9,false,38,42,80,169,134,303,15,15,30,3,3:42
632704,2021-08-29,2021,CLE,BOS,7,5,7-5,CLE,9,true,38,38,76,176,140,316,15,13,28,2,3:22 (3:10 delay)
632806,2021-08-21,2021,SDN,PHI,4,3,4-3,SDN,10,false,36,41,77,177,135,312,7,14,21,3,3:43
632830,2021-08-22,2021,SDN,PHI,4,7,7-4,PHI,9,false,37,41,78,168,131,299,11,17,28,1,3:20
632447,2021-09-18,2021,NYN,PHI,3,5,5-3,PHI,9,false,35,40,75,151,136,287,8,14,22,2,3:35
632604,2021-09-06,2021,WAS,NYN,4,3,4-3,WAS,9,false,42,38,80,144,151,295,18,14,32,0,3:25
632669,2021-08-31,2021,TBA,BOS,8,5,8-5,TBA,9,true,37,41,78,158,145,303,12,13,25,2,3:08
632608,2021-09-06,2021,COL,SFN,5,10,10-5,SFN,9,false,37,45,82,163,130,293,10,20,30,2,3:27
632587,2021-09-07,2021,COL,SFN,3,12,12-3,SFN,9,false,37,44,81,160,112,272,11,21,32,2,3:02
632558,2021-09-07,2021,SLN,LAN,2,7,7-2,LAN,9,false,37,39,76,145,137,282,10,12,22,2,3:06
632609,2021-09-08,2021,PIT,DET,1,5,5-1,DET,9,false,33,39,72,144,139,283,8,14,22,0,2:51
632650,2021-09-02,2021,NYN,MIA,4,3,4-3,NYN,9,true,34,35,69,152,123,275,8,8,16,2,2:59
632649,2021-09-04,2021,CIN,DET,7,4,7-4,CIN,9,true,38,39,77,151,155,306,15,13,28,1,3:18
632514,2021-09-12,2021,PHI,COL,4,5,5-4,COL,9,false,37,36,73,149,142,291,10,10,20,3,3:27
632399,2021-09-21,2021,COL,LAN,4,5,5-4,LAN,10,false,44,37,81,129,150,279,14,9,23,2,3:30
632802,2021-08-24,2021,NYN,SFN,0,8,8-0,SFN,9,false,34,44,78,152,158,310,8,17,25,2,3:16
632462,2021-09-16,2021,PIT,CIN,0,1,1-0,CIN,9,false,35,35,70,127,149,276,9,8,17,0,3:05
632630,2021-09-02,2021,TBA,BOS,0,4,4-0,BOS,9,false,33,38,71,152,139,291,7,13,20,2,2:55
632714,2021-08-29,2021,LAN,COL,0,5,5-0,COL,9,false,34,44,78,154,130,284,7,17,24,3,3:21
632796,2021-08-22,2021,LAN,NYN,2,7,7-2,NYN,9,false,33,42,75,157,133,290,7,17,24,1,3:17
632701,2021-08-29,2021,ATL,SFN,9,0,9-0,ATL,9,true,39,36,75,134,160,294,15,10,25,3,3:15
632535,2021-09-11,2021,OAK,TEX,6,8,8-6,TEX,9,false,37,40,77,129,132,261,11,13,24,2,2:46
632353,2021-09-25,2021,ARI,LAN,7,2,7-2,ARI,9,true,37,33,70,132,157,289,13,7,20,2,3:07
632761,2021-08-25,2021,MIL,CIN,4,1,4-1,MIL,9,true,35,32,67,139,139,278,12,6,18,2,3:08
632735,2021-08-27,2021,CLE,BOS,3,4,4-3,BOS,9,false,34,34,68,147,138,285,10,7,17,1,2:58
632486,2021-09-15,2021,PHI,CHN,6,5,6-5,PHI,9,false,37,40,77,142,121,263,14,12,26,2,3:12
632574,2021-09-08,2021,MIA,NYN,2,1,2-1,MIA,10,false,41,35,76,127,141,268,13,7,20,0,3:06
632394,2021-09-22,2021,COL,LAN,10,5,10-5,COL,9,true,41,38,79,145,155,300,17,12,29,4,3:25
632983,2021-08-07,2021,MIL,SFN,6,9,9-6,SFN,11,false,44,51,95,213,153,366,11,19,30,2,4:26
632923,2021-08-11,2021,ATL,CIN,8,6,8-6,ATL,11,false,46,49,95,199,184,383,16,16,32,2,3:58
632426,2021-09-20,2021,ARI,ATL,4,11,11-4,ATL,9,false,37,46,83,184,156,340,13,18,31,1,3:29
632730,2021-09-13,2021,NYA,MIN,6,5,6-5,NYA,10,false,36,42,78,168,151,319,10,12,22,5,3:31
632560,2021-09-07,2021,PIT,DET,3,2,3-2,PIT,9,true,41,37,78,145,156,301,17,13,30,0,3:16
632495,2021-09-14,2021,PHI,CHN,3,6,6-3,CHN,9,false,34,38,72,168,124,292,10,12,22,2,3:24
632351,2021-09-25,2021,CHN,SLN,5,8,8-5,SLN,9,false,40,37,77,143,154,297,16,10,26,1,3:18
632633,2021-09-03,2021,KCA,CHA,7,2,7-2,KCA,9,true,38,36,74,141,159,300,15,9,24,2,3:17 (2:03 delay)
632494,2021-09-15,2021,BAL,NYA,3,4,4-3,NYA,9,false,35,38,73,156,142,298,8,10,18,4,3:18
632289,2021-09-28,2021,MIN,DET,3,2,3-2,MIN,9,true,32,39,71,154,132,286,9,13,22,0,3:03
632548,2021-09-09,2021,PHI,COL,3,4,4-3,COL,9,false,34,38,72,147,133,280,8,12,20,1,3:00
632781,2021-08-24,2021,SLN,DET,3,4,4-3,DET,9,false,35,40,75,151,136,287,10,15,25,5,3:13
632695,2021-09-02,2021,COL,ATL,5,6,6-5,ATL,9,false,35,38,73,141,118,259,10,11,21,1,2:51
632665,2021-08-30,2021,SEA,HOU,3,4,4-3,HOU,9,false,37,41,78,161,144,305,10,14,24,3,3:35
632713,2021-08-28,2021,SEA,KCA,2,4,4-2,KCA,9,false,42,37,79,118,174,292,15,11,26,3,3:13
632427,2021-09-18,2021,TBA,DET,3,4,4-3,DET,9,false,37,34,71,136,131,267,12,7,19,1,2:50
632898,2021-08-14,2021,CHA,NYA,5,7,7-5,NYA,10,false,46,43,89,198,188,386,18,15,33,7,4:20
632728,2021-08-24,2021,MIL,CIN,7,4,7-4,MIL,9,true,38,36,74,158,165,323,14,11,25,3,3:46
632783,2021-08-24,2021,CLE,TEX,3,7,7-3,TEX,9,false,34,43,77,164,147,311,9,17,26,5,3:14
632651,2021-09-03,2021,SDN,HOU,3,6,6-3,HOU,9,false,38,37,75,141,164,305,13,9,22,3,3:37
632602,2021-09-05,2021,MIA,PHI,3,4,4-3,PHI,10,false,37,38,75,142,162,304,6,9,15,4,3:40
632612,2021-09-04,2021,SDN,HOU,10,2,10-2,SDN,9,true,40,37,77,149,145,294,18,11,29,2,3:21
632554,2021-09-08,2021,ATL,WAS,2,4,4-2,WAS,9,false,39,41,80,144,161,305,12,15,27,3,3:35
632599,2021-09-05,2021,SFN,LAN,6,4,6-4,SFN,9,true,37,40,77,167,130,297,16,12,28,4,3:22
632337,2021-09-26,2021,ARI,LAN,0,3,3-0,LAN,9,false,37,40,77,162,140,302,9,14,23,2,3:28
632619,2021-09-05,2021,ANA,TEX,3,7,7-3,TEX,9,false,38,42,80,160,118,278,11,15,26,3,3:15
632870,2021-08-21,2021,BOS,TEX,1,10,10-1,TEX,9,false,33,48,81,174,123,297,8,22,30,1,3:25
632721,2021-08-28,2021,BAL,TBA,3,4,4-3,TBA,9,false,36,35,71,133,145,278,10,9,19,2,2:50
632550,2021-09-10,2021,CHN,SFN,1,6,6-1,SFN,9,false,31,38,69,163,134,297,7,13,20,3,3:04
632785,2021-08-22,2021,TBA,CHA,9,0,9-0,TBA,9,true,39,35,74,144,154,298,17,9,26,2,3:05
632843,2021-08-19,2021,KCA,HOU,3,6,6-3,HOU,10,false,37,44,81,169,147,316,9,16,25,3,3:48
632910,2021-08-15,2021,DET,CLE,0,11,11-0,CLE,9,false,28,45,73,182,116,298,1,18,19,1,2:51
632600,2021-09-04,2021,TBA,MIN,11,4,11-4,TBA,9,true,43,38,81,140,170,310,20,13,33,1,3:09
632586,2021-09-07,2021,CLE,MIN,0,3,3-0,MIN,9,false,38,38,76,156,178,334,12,11,23,2,3:39
632708,2021-09-03,2021,ARI,SEA,5,6,6-5,SEA,10,false,40,45,85,150,157,307,11,15,26,3,3:31
632636,2021-09-04,2021,SFN,LAN,1,6,6-1,LAN,9,false,37,39,76,157,138,295,10,13,23,4,3:28
632434,2021-09-19,2021,TEX,CHA,2,7,7-2,CHA,9,false,35,42,77,148,153,301,9,16,25,2,3:06
632414,2021-09-20,2021,NYA,TEX,4,3,4-3,NYA,9,true,37,36,73,161,143,304,14,9,23,4,3:21
632590,2021-09-07,2021,HOU,SEA,5,4,5-4,HOU,10,false,42,38,80,134,164,298,14,9,23,1,3:29
632670,2021-09-02,2021,WAS,PHI,6,7,7-6,PHI,9,false,42,41,83,181,161,342,15,13,28,5,3:52
632505,2021-09-14,2021,LAN,ARI,8,4,8-4,LAN,9,true,37,36,73,132,157,289,13,10,23,2,3:14
632406,2021-09-20,2021,TBA,TOR,6,4,6-4,TBA,9,true,36,35,71,151,158,309,15,7,22,4,3:23
632984,2021-08-10,2021,PHI,LAN,0,5,5-0,LAN,9,false,35,42,77,161,155,316,9,17,26,5,3:35 (1:44 delay)
632449,2021-09-18,2021,KCA,SEA,8,1,8-1,KCA,9,true,42,31,73,127,180,307,17,7,24,1,3:27
632616,2021-09-04,2021,TOR,OAK,10,8,10-8,TOR,9,true,43,38,81,154,145,299,20,12,32,4,3:13
632532,2021-09-12,2021,HOU,ANA,3,1,3-1,HOU,9,true,36,34,70,152,159,311,14,8,22,1,3:19
632344,2021-09-25,2021,ANA,SEA,14,1,14-1,ANA,9,true,46,32,78,122,176,298,23,7,30,2,3:07
632431,2021-09-18,2021,TOR,MIN,6,2,6-2,TOR,9,true,38,34,72,144,157,301,15,7,22,3,2:58
632463,2021-09-15,2021,MIN,CLE,3,12,12-3,CLE,9,false,33,43,76,164,128,292,6,17,23,3,2:49
632635,2021-09-02,2021,KCA,CLE,2,4,4-2,CLE,9,false,36,37,73,160,128,288,8,10,18,0,2:56
632879,2021-08-21,2021,BAL,ATL,4,5,5-4,ATL,9,false,36,39,75,170,140,310,9,12,21,4,3:01
632461,2021-09-17,2021,MIL,CHN,8,5,8-5,MIL,9,true,40,40,80,164,178,342,18,13,31,3,3:45
632641,2021-09-01,2021,TEX,COL,5,9,9-5,COL,9,false,40,43,83,185,170,355,15,14,29,5,4:01
632844,2021-08-18,2021,SLN,MIL,4,6,6-4,MIL,10,false,44,41,85,157,165,322,14,10,24,0,4:03
632589,2021-09-08,2021,COL,SFN,4,7,7-4,SFN,9,false,39,43,82,176,139,315,14,16,30,4,3:35
632957,2021-08-08,2021,HOU,MIN,5,7,7-5,MIN,9,false,39,46,85,178,181,359,16,19,35,4,4:07
632478,2021-09-13,2021,NYN,SLN,0,7,7-0,SLN,9,false,36,46,82,163,152,315,10,20,30,1,3:41
632697,2021-08-28,2021,ANA,SDN,10,2,10-2,ANA,9,true,40,41,81,166,157,323,18,15,33,4,3:35
632719,2021-08-28,2021,DET,TOR,2,3,3-2,TOR,10,false,36,44,80,185,148,333,7,15,22,2,3:39
632385,2021-09-22,2021,MIA,WAS,5,7,7-5,WAS,9,false,38,44,82,155,151,306,11,19,30,3,3:17
632472,2021-09-16,2021,TEX,HOU,1,12,12-1,HOU,9,false,35,49,84,180,131,311,10,23,33,3,3:28
632468,2021-09-16,2021,KCA,OAK,2,7,7-2,OAK,9,false,38,41,79,155,128,283,12,16,28,4,3:28
632380,2021-09-19,2021,NYA,CLE,1,11,11-1,CLE,9,false,33,47,80,183,145,328,8,20,28,1,3:25
632490,2021-09-15,2021,CHA,ANA,2,3,3-2,ANA,9,false,36,38,74,154,143,297,10,14,24,1,3:12
632379,2021-09-21,2021,MIA,WAS,1,7,7-1,WAS,9,false,34,41,75,160,126,286,8,13,21,2,3:02
632476,2021-09-16,2021,CHA,ANA,3,9,9-3,ANA,9,false,39,40,79,169,151,320,13,14,27,2,3:16
632417,2021-09-18,2021,WAS,COL,0,6,6-0,COL,9,false,35,45,80,155,131,286,11,18,29,0,3:06
632720,2021-08-27,2021,BAL,TBA,3,6,6-3,TBA,9,false,38,35,73,136,117,253,12,8,20,0,2:25
632364,2021-09-24,2021,CIN,WAS,8,7,8-7,CIN,11,false,45,50,95,211,197,408,17,19,36,3,4:24
633016,2021-08-12,2021,CHN,MIL,4,17,17-4,MIL,9,false,42,53,95,200,177,377,13,27,40,2,4:00
632652,2021-09-04,2021,KCA,CHA,7,10,10-7,CHA,9,false,36,46,82,187,137,324,9,21,30,3,3:36
632328,2021-09-26,2021,MIL,NYN,8,4,8-4,MIL,9,true,40,37,77,156,151,307,15,10,25,2,3:24
632573,2021-09-08,2021,ARI,TEX,5,8,8-5,TEX,9,false,39,41,80,160,147,307,12,17,29,5,3:35
632817,2021-08-20,2021,SDN,PHI,3,4,4-3,PHI,9,false,42,35,77,166,178,344,16,9,25,2,3:38
632725,2021-08-27,2021,OAK,NYA,2,8,8-2,NYA,9,false,38,42,80,158,164,322,12,15,27,2,3:27
632996,2021-08-10,2021,BOS,TBA,4,8,8-4,TBA,9,false,38,45,83,165,140,305,13,19,32,3,3:28
632507,2021-09-13,2021,SEA,BOS,5,4,5-4,SEA,9,true,36,35,71,146,144,290,12,8,20,2,3:11
632755,2021-08-24,2021,BOS,MIN,11,9,11-9,BOS,9,true,40,45,85,182,155,337,17,20,37,4,4:09
632759,2021-08-27,2021,MIN,MIL,2,0,2-0,MIN,9,true,35,34,69,139,159,298,12,7,19,4,3:22
632598,2021-09-05,2021,WAS,NYN,6,13,13-6,NYN,9,false,39,46,85,178,141,319,12,21,33,3,3:35
632378,2021-09-21,2021,SDN,SFN,5,6,6-5,SFN,9,false,39,41,80,147,157,304,14,16,30,3,3:45
632326,2021-09-26,2021,DET,KCA,1,2,2-1,KCA,9,false,36,40,76,165,141,306,10,14,24,2,3:18
632324,2021-09-26,2021,OAK,HOU,4,3,4-3,OAK,9,false,40,38,78,170,144,314,16,12,28,3,3:37
632504,2021-09-14,2021,ATL,COL,4,5,5-4,COL,9,false,38,38,76,151,157,308,11,13,24,1,3:12
632629,2021-09-03,2021,TOR,OAK,11,10,11-10,TOR,9,false,38,43,81,149,139,288,14,16,30,2,3:06
632622,2021-09-04,2021,NYA,BAL,3,4,4-3,BAL,9,false,35,43,78,184,159,343,8,15,23,5,3:54
632737,2021-08-28,2021,CLE,BOS,3,5,5-3,BOS,10,false,45,42,87,155,185,340,16,14,30,4,3:59
632638,2021-09-03,2021,MIL,SLN,4,15,15-4,SLN,9,false,37,46,83,185,146,331,12,19,31,3,3:24
632605,2021-09-05,2021,TBA,MIN,5,6,6-5,MIN,9,false,39,45,84,162,165,327,15,19,34,4,3:32
632617,2021-09-03,2021,WAS,NYN,2,6,6-2,NYN,10,false,38,47,85,192,139,331,10,19,29,0,3:49
632465,2021-09-15,2021,ATL,COL,2,3,3-2,COL,10,false,43,37,80,169,169,338,15,7,22,2,4:16
632405,2021-09-21,2021,DET,CHA,5,3,5-3,DET,9,true,39,43,82,170,151,321,19,18,37,3,3:27
632741,2021-08-26,2021,BOS,MIN,12,2,12-2,BOS,9,true,42,37,79,150,169,319,18,10,28,2,3:33
632770,2021-08-23,2021,HOU,KCA,1,7,7-1,KCA,9,false,38,43,81,169,147,316,12,17,29,4,3:35
632543,2021-09-10,2021,DET,TBA,10,4,10-4,DET,9,true,39,42,81,150,156,306,15,15,30,3,3:26
632410,2021-09-21,2021,BOS,NYN,6,3,6-3,BOS,9,true,37,37,74,159,150,309,14,11,25,4,3:38
632771,2021-08-22,2021,CHN,KCA,1,9,9-1,KCA,9,false,34,45,79,176,131,307,8,20,28,1,3:25
632441,2021-09-18,2021,NYA,CLE,3,11,11-3,CLE,9,false,37,46,83,165,181,346,13,19,32,2,3:26
632480,2021-09-14,2021,SEA,BOS,4,8,8-4,BOS,9,false,39,43,82,195,155,350,12,17,29,5,3:59
632511,2021-09-14,2021,KCA,OAK,10,7,10-7,KCA,9,true,41,41,82,174,159,333,18,15,33,4,3:59
632334,2021-09-26,2021,BAL,TEX,4,7,7-4,TEX,9,false,37,40,77,179,143,322,12,13,25,5,3:11
632559,2021-09-10,2021,CHA,BOS,4,3,4-3,CHA,9,true,39,37,76,168,153,321,15,10,25,4,3:48
632576,2021-09-08,2021,BAL,KCA,9,8,9-8,BAL,9,true,39,41,80,146,174,320,13,17,30,5,3:32
632391,2021-09-21,2021,TBA,TOR,2,4,4-2,TOR,9,false,41,36,77,131,154,285,17,10,27,0,3:19
632557,2021-09-10,2021,CLE,MIL,3,10,10-3,MIL,9,false,38,45,83,161,150,311,9,17,26,2,3:24
632319,2021-09-27,2021,COL,WAS,4,5,5-4,WAS,9,false,42,40,82,153,162,315,15,16,31,1,3:45
632578,2021-09-07,2021,OAK,CHA,3,6,6-3,CHA,9,false,34,46,80,200,113,313,9,20,29,3,3:20
632639,2021-09-03,2021,BOS,CLE,8,5,8-5,BOS,9,true,39,41,80,152,155,307,16,14,30,4,3:09
632421,2021-09-19,2021,TBA,DET,0,2,2-0,DET,9,false,34,36,70,133,133,266,10,9,19,1,2:44
632329,2021-09-26,2021,PHI,PIT,0,6,6-0,PIT,9,false,36,44,80,169,153,322,10,21,31,1,3:31
632930,2021-08-13,2021,MIA,CHN,14,10,14-10,MIA,9,true,44,50,94,199,202,401,21,23,44,3,4:14
632786,2021-08-22,2021,MIL,WAS,7,3,7-3,MIL,9,true,43,39,82,173,190,363,21,14,35,2,3:53
632473,2021-09-16,2021,SFN,SDN,4,7,7-4,SDN,9,false,40,42,82,162,177,339,15,17,32,3,3:39
632763,2021-08-24,2021,ATL,NYA,4,5,5-4,NYA,9,false,39,37,76,155,157,312,14,10,24,2,3:35
632773,2021-08-23,2021,BOS,TEX,8,4,8-4,BOS,11,false,45,45,90,171,162,333,15,12,27,3,3:44
632452,2021-09-16,2021,BAL,NYA,3,2,3-2,BAL,10,false,39,41,80,175,164,339,13,14,27,3,4:04
632288,2021-09-28,2021,TOR,NYA,2,7,7-2,NYA,9,false,33,41,74,183,141,324,7,15,22,3,3:36
632432,2021-09-19,2021,CIN,LAN,5,8,8-5,LAN,9,false,35,43,78,169,139,308,10,18,28,1,3:09
632539,2021-09-11,2021,BAL,TOR,10,11,11-10,TOR,7,false,39,38,77,132,162,294,18,17,35,3,3:11
632682,2021-08-31,2021,SFN,MIL,2,6,6-2,MIL,9,false,38,41,79,155,158,313,12,15,27,1,3:10
632798,2021-08-23,2021,PIT,ARI,6,5,6-5,PIT,9,true,39,39,78,164,177,341,15,12,27,3,3:40
632418,2021-09-21,2021,ANA,HOU,5,10,10-5,HOU,9,false,37,43,80,166,142,308,11,17,28,3,3:08
632388,2021-09-27,2021,CIN,PIT,13,1,13-1,CIN,9,true,46,34,80,146,194,340,20,8,28,1,3:11
632836,2021-08-20,2021,TBA,CHA,5,7,7-5,CHA,11,false,42,49,91,196,162,358,10,14,24,1,3:49
632646,2021-09-02,2021,CHN,PIT,6,5,6-5,CHN,11,false,48,44,92,159,174,333,20,11,31,2,3:55
632537,2021-09-10,2021,PHI,COL,2,11,11-2,COL,9,false,41,43,84,192,162,354,14,16,30,2,3:39
632610,2021-09-05,2021,MIL,SLN,6,5,6-5,MIL,9,false,40,46,86,197,147,344,18,19,37,4,4:08
632325,2021-09-26,2021,SDN,ATL,3,4,4-3,ATL,9,false,43,42,85,164,165,329,18,16,34,4,3:48
632773,2021-08-23,2021,BOS,TEX,8,4,8-4,BOS,11,false,45,45,90,171,162,333,15,12,27,3,3:44
632768,2021-08-25,2021,HOU,KCA,6,5,6-5,HOU,10,false,44,39,83,151,175,326,16,11,27,3,3:45
632736,2021-08-29,2021,BAL,TBA,8,12,12-8,TBA,9,false,45,42,87,152,162,314,18,17,35,3,3:09
632330,2021-09-26,2021,CLE,CHA,2,5,5-2,CHA,9,false,38,45,83,159,154,313,11,19,30,2,3:38
632779,2021-08-24,2021,TOR,CHA,2,5,5-2,CHA,9,false,36,44,80,168,143,311,11,20,31,1,3:12
632549,2021-09-10,2021,HOU,ANA,10,5,10-5,HOU,9,true,44,41,85,150,169,319,21,14,35,1,3:37
632703,2021-08-30,2021,ARI,SDN,5,7,7-5,SDN,9,false,37,42,79,166,169,335,10,17,27,4,3:35
632496,2021-09-14,2021,WAS,MIA,8,2,8-2,WAS,9,true,41,33,74,154,165,319,21,5,26,3,3:21
632829,2021-08-21,2021,MIL,WAS,9,6,9-6,MIL,9,true,41,44,85,186,170,356,17,19,36,5,4:18
632807,2021-08-24,2021,BAL,ANA,8,14,14-8,ANA,9,false,46,52,98,170,192,362,18,25,43,8,3:50
632571,2021-09-10,2021,ATL,MIA,6,2,6-2,ATL,9,true,37,37,74,159,168,327,13,9,22,1,3:24
632803,2021-08-22,2021,COL,ARI,4,8,8-4,ARI,9,false,38,45,83,191,150,341,12,19,31,3,3:50
632572,2021-09-07,2021,MIA,NYN,4,9,9-4,NYN,9,false,41,42,83,174,162,336,12,13,25,2,3:59
632613,2021-09-05,2021,CHN,PIT,11,8,11-8,CHN,9,true,43,45,88,192,184,376,19,20,39,6,4:12
632580,2021-09-08,2021,HOU,SEA,5,8,8-5,SEA,9,false,39,47,86,181,129,310,13,20,33,5,3:46
632642,2021-09-03,2021,NYA,BAL,4,3,4-3,NYA,11,false,40,44,84,173,179,352,9,14,23,3,3:48
632601,2021-09-05,2021,ARI,SEA,4,10,10-4,SEA,11,false,40,49,89,173,153,326,8,17,25,2,3:49
632393,2021-09-27,2021,DET,CHA,7,8,8-7,CHA,9,false,44,41,85,168,189,357,18,19,37,2,3:44
632723,2021-08-28,2021,PIT,SLN,0,13,13-0,SLN,9,false,34,53,87,222,134,356,8,27,35,0,3:45
632838,2021-08-19,2021,TEX,SEA,8,9,9-8,SEA,11,false,44,51,95,192,162,354,14,18,32,2,4:02
632592,2021-09-05,2021,BOS,CLE,5,11,11-5,CLE,9,false,44,44,88,184,171,355,17,19,36,3,3:59
632563,2021-09-10,2021,BAL,TOR,6,3,6-3,BAL,9,true,41,43,84,164,179,343,18,15,33,3,3:34
632393,2021-09-27,2021,DET,CHA,7,8,8-7,CHA,9,false,44,41,85,168,189,357,18,19,37,2,3:44
632456,2021-09-18,2021,HOU,ARI,4,6,6-4,ARI,10,false,40,43,83,178,134,312,13,13,26,2,3:44
632402,2021-09-21,2021,PHI,BAL,3,2,3-2,PHI,10,false,40,41,81,149,151,300,13,13,26,3,3:40
632784,2021-08-22,2021,TOR,DET,3,5,5-3,DET,11,false,48,45,93,189,177,366,15,11,26,3,3:59
632822,2021-08-25,2021,CHN,COL,10,13,13-10,COL,10,false,44,48,92,199,149,348,15,20,35,5,4:18
632567,2021-09-08,2021,NYA,TOR,3,6,6-3,TOR,9,false,37,44,81,195,157,352,11,18,29,4,3:54
632388,2021-09-27,2021,CIN,PIT,13,1,13-1,CIN,9,true,46,34,80,146,194,340,20,8,28,1,3:11
632546,2021-09-09,2021,NYA,TOR,4,6,6-4,TOR,9,false,36,44,80,192,157,349,12,18,30,2,3:30
632397,2021-09-21,2021,MIL,SLN,1,2,2-1,SLN,9,false,36,34,70,137,160,297,10,7,17,0,3:24
634556,2021-09-04,2021,WAS,NYN,9,11,11-9,NYN,9,false,45,43,88,180,174,354,19,15,34,1,4:05
632822,2021-08-25,2021,CHN,COL,10,13,13-10,COL,10,false,44,48,92,199,149,348,15,20,35,5,4:18
632512,2021-09-12,2021,DET,TBA,8,7,8-7,DET,11,false,48,47,95,172,171,343,17,16,33,2,3:48
632502,2021-09-13,2021,TEX,HOU,1,15,15-1,HOU,9,false,36,48,84,192,161,353,11,22,33,3,3:53
632582,2021-09-05,2021,NYA,BAL,7,8,8-7,BAL,9,false,41,44,85,189,175,364,14,18,32,6,4:01
632570,2021-09-09,2021,ATL,WAS,7,6,7-6,ATL,10,false,42,44,86,168,182,350,15,15,30,3,3:47
632890,2021-08-16,2021,TBA,BAL,9,2,9-2,TBA,9,true,40,36,76,147,153,300,16,10,26,3,2:53
632192,2021-04-11,2021,NYN,MIA,6,5,6-5,NYN,9,false,42,43,85,199,161,360,16,16,32,4,4:05 (2:10 delay)
632403,2021-09-21,2021,CIN,PIT,2,6,6-2,PIT,9,false,40,41,81,176,145,321,16,15,31,4,3:36
632464,2021-09-15,2021,SFN,SDN,6,9,9-6,SDN,9,false,40,46,86,190,169,359,15,20,35,2,4:06
632547,2021-09-11,2021,CHN,SFN,4,15,15-4,SFN,9,false,37,50,87,212,137,349,12,26,38,2,3:47
632778,2021-08-25,2021,PIT,ARI,2,5,5-2,ARI,9,false,38,38,76,155,135,290,10,11,21,2,3:18 (:09 delay)
632450,2021-09-17,2021,WAS,COL,8,9,9-8,COL,9,false,46,39,85,171,179,350,20,13,33,2,4:04
632694,2021-08-31,2021,MIN,CHN,1,3,3-1,CHN,9,false,35,36,71,172,144,316,12,9,21,4,3:34
632475,2021-09-16,2021,PHI,CHN,17,8,17-8,PHI,9,true,48,41,89,176,182,358,24,17,41,6,3:58
632492,2021-09-14,2021,NYN,SLN,6,7,7-6,SLN,11,false,44,47,91,173,184,357,15,14,29,4,4:34
632654,2021-09-03,2021,CIN,DET,5,15,15-5,DET,9,false,42,48,90,191,199,390,15,21,36,4,4:00
632746,2021-08-26,2021,PHI,ARI,7,8,8-7,ARI,9,false,42,45,87,160,193,353,12,19,31,4,3:54
632541,2021-09-10,2021,MIN,KCA,4,6,6-4,KCA,11,false,42,44,86,148,162,310,9,11,20,0,3:37
632471,2021-09-15,2021,KCA,OAK,10,12,12-10,OAK,9,false,48,48,96,173,188,361,23,23,46,4,4:02
632404,2021-09-21,2021,CHN,MIN,5,9,9-5,MIN,9,false,44,48,92,185,168,353,20,21,41,3,4:05
632384,2021-09-22,2021,SDN,SFN,6,8,8-6,SFN,9,false,46,41,87,168,170,338,20,15,35,3,3:56
632718,2021-08-27,2021,CHA,CHN,17,13,17-13,CHA,9,true,52,42,94,173,209,382,26,16,42,5,4:09
632753,2021-08-27,2021,SEA,KCA,7,8,8-7,KCA,12,false,53,53,106,189,207,396,18,19,37,3,4:40
632603,2021-09-06,2021,BOS,TBA,10,11,11-10,TBA,10,false,51,52,103,186,219,405,25,21,46,4,4:54
632333,2021-09-26,2021,CIN,WAS,9,2,9-2,CIN,9,true,48,38,86,164,194,358,24,10,34,2,3:43
632754,2021-08-26,2021,MIA,WAS,7,5,7-5,MIA,9,true,37,43,80,161,143,304,12,17,29,2,3:25
632852,2021-08-18,2021,NYA,BOS,5,2,5-2,NYA,9,true,37,33,70,154,166,320,14,7,21,3,3:41
632938,2021-08-12,2021,BAL,DET,4,6,6-4,DET,9,false,38,38,76,157,136,293,13,13,26,1,3:00
632681,2021-09-01,2021,ARI,SDN,8,3,8-3,ARI,9,true,44,33,77,114,178,292,21,7,28,2,3:16
632764,2021-08-25,2021,SDN,LAN,3,5,5-3,LAN,16,false,62,63,125,273,216,489,21,18,39,2,5:49
632440,2021-09-17,2021,TBA,DET,7,4,7-4,TBA,10,false,43,38,81,127,168,295,15,8,23,2,3:17
633064,2021-08-05,2021,COL,CHN,6,5,6-5,COL,9,true,37,37,74,144,131,275,15,11,26,3,3:10
632331,2021-09-26,2021,COL,SFN,2,6,6-2,SFN,9,false,34,41,75,158,147,305,5,15,20,3,3:31
632451,2021-09-18,2021,BOS,BAL,9,3,9-3,BOS,9,true,40,38,78,156,146,302,17,12,29,3,3:09