API Key,Date,Year,Home Team,Away Team,Home Score,Away Score,Final Score,Winning Team,# Innings,End Top Inning?,Home Team PA #,Away Team PA #,Total Number PA,Homne Team # Pitches,Away Team # Pitches,Total # Pitches,Home Team Baserunners,Away Team Baserunners,Total # Baserunners,Pitching Changes,Time
662766,2022-04-07,2022,KCA,CLE,3,1,3-1,KCA,9,true,31,37,68,152,123,275,6,11,17,3,2:49
661042,2022-04-07,2022,ANA,HOU,1,3,3-1,HOU,9,false,31,38,69,140,111,251,6,12,18,5,3:15
662021,2022-04-07,2022,SLN,PIT,9,0,9-0,SLN,9,true,41,32,73,121,168,289,16,8,24,1,3:08
661577,2022-04-07,2022,ATL,CIN,3,6,6-3,CIN,9,false,36,38,74,142,158,300,9,12,21,1,3:01
663418,2022-04-07,2022,ARI,SDN,4,2,4-2,ARI,9,false,34,36,70,165,143,308,11,11,22,4,3:18
663178,2022-04-07,2022,CHN,MIL,5,4,5-4,CHN,9,true,35,40,75,153,151,304,13,15,28,4,3:18
662571,2022-04-07,2022,WAS,NYN,1,5,5-1,NYN,9,false,35,42,77,169,134,303,8,19,27,2,3:31 (1:16 delay)
663417,2022-04-08,2022,ARI,SDN,0,3,3-0,SDN,9,false,30,38,68,141,114,255,3,15,18,2,2:44
661750,2022-04-08,2022,MIN,SEA,1,2,2-1,SEA,9,false,34,39,73,141,132,273,9,13,22,0,2:53
661750,2022-04-08,2022,MIN,SEA,1,2,2-1,SEA,9,false,34,39,73,141,132,273,9,13,22,0,2:53
661131,2022-04-08,2022,PHI,OAK,9,5,9-5,PHI,9,true,39,35,74,115,164,279,16,7,23,2,3:14
662933,2022-04-08,2022,COL,LAN,3,5,5-3,LAN,9,false,38,41,79,152,137,289,10,13,23,2,3:09
661918,2022-04-08,2022,TBA,BAL,2,1,2-1,TBA,9,true,35,37,72,148,146,294,11,11,22,4,3:14
662559,2022-04-08,2022,WAS,NYN,3,7,7-3,NYN,9,false,33,45,78,181,113,294,7,20,27,3,3:43 (:52 delay)
662888,2022-04-08,2022,DET,CHA,5,4,5-4,DET,9,false,39,37,76,158,157,315,14,11,25,2,3:30
661576,2022-04-08,2022,ATL,CIN,7,6,7-6,ATL,9,true,39,37,76,140,148,288,15,10,25,2,3:07
661782,2022-04-08,2022,TOR,TEX,10,8,10-8,TOR,9,true,37,41,78,157,145,302,14,14,28,3,3:26
662124,2022-04-08,2022,SFN,MIA,6,5,6-5,SFN,10,false,40,42,82,156,151,307,14,12,26,4,3:26
661333,2022-04-08,2022,NYA,BOS,6,5,6-5,NYA,11,false,46,43,89,157,162,319,17,14,31,4,3:56
661333,2022-04-08,2022,NYA,BOS,6,5,6-5,NYA,11,false,46,43,89,157,162,319,17,14,31,4,3:56
661041,2022-04-08,2022,ANA,HOU,6,13,13-6,HOU,9,false,41,43,84,167,161,328,13,17,30,4,3:44
661917,2022-04-09,2022,TBA,BAL,5,3,5-3,TBA,9,true,33,36,69,124,114,238,11,10,21,1,2:33
661803,2022-04-09,2022,TOR,TEX,4,3,4-3,TOR,9,true,37,36,73,122,113,235,13,10,23,1,2:39
661130,2022-04-09,2022,PHI,OAK,4,2,4-2,PHI,9,true,34,31,65,115,133,248,12,6,18,1,2:37
662123,2022-04-09,2022,SFN,MIA,1,2,2-1,MIA,9,false,33,35,68,137,131,268,7,8,15,2,2:57
662931,2022-04-09,2022,COL,LAN,3,2,3-2,COL,9,true,34,34,68,125,139,264,10,7,17,1,2:48
662765,2022-04-09,2022,KCA,CLE,1,0,1-0,KCA,10,false,34,35,69,130,126,256,8,7,15,3,2:49
663404,2022-04-09,2022,ARI,SDN,2,5,5-2,SDN,9,false,33,39,72,153,123,276,7,14,21,0,2:52
661575,2022-04-09,2022,ATL,CIN,2,1,2-1,ATL,9,true,36,32,68,130,134,264,14,5,19,3,2:50
661332,2022-04-09,2022,NYA,BOS,4,2,4-2,NYA,9,true,30,37,67,150,109,259,7,9,16,2,2:58
661040,2022-04-09,2022,ANA,HOU,2,0,2-0,ANA,9,true,33,32,65,123,138,261,11,5,16,3,3:02
662588,2022-04-09,2022,WAS,NYN,0,5,5-0,NYN,9,false,32,41,73,153,130,283,5,15,20,2,3:14
661756,2022-04-09,2022,MIN,SEA,3,4,4-3,SEA,9,false,34,39,73,152,146,298,7,13,20,1,3:09
662864,2022-04-09,2022,DET,CHA,2,5,5-2,CHA,9,false,36,37,73,133,150,283,12,10,22,5,3:11
662020,2022-04-09,2022,SLN,PIT,6,2,6-2,SLN,9,true,38,40,78,171,144,315,15,13,28,4,3:32
663205,2022-04-09,2022,CHN,MIL,9,0,9-0,CHN,9,true,44,33,77,140,184,324,20,9,29,2,3:28
661129,2022-04-10,2022,PHI,OAK,1,4,4-1,OAK,9,false,32,39,71,144,103,247,6,13,19,2,2:57
662122,2022-04-10,2022,SFN,MIA,3,2,3-2,SFN,9,true,31,37,68,129,106,235,7,13,20,3,2:43
662570,2022-04-10,2022,WAS,NYN,4,2,4-2,WAS,9,true,31,37,68,141,115,256,6,11,17,3,3:01
661039,2022-04-10,2022,ANA,HOU,1,4,4-1,HOU,9,false,34,39,73,148,131,279,8,13,21,2,3:15
662887,2022-04-10,2022,DET,CHA,1,10,10-1,CHA,9,false,32,43,75,156,134,290,6,16,22,1,2:56
661738,2022-04-10,2022,MIN,SEA,10,4,10-4,MIN,9,true,38,37,75,147,157,304,13,11,24,2,3:11
662934,2022-04-10,2022,COL,LAN,9,4,9-4,COL,9,true,39,38,77,145,156,301,15,12,27,3,3:13
663204,2022-04-10,2022,CHN,MIL,4,5,5-4,MIL,9,false,36,36,72,149,162,311,10,10,20,2,3:03
662019,2022-04-10,2022,SLN,PIT,4,9,9-4,PIT,9,false,35,44,79,180,138,318,9,18,27,1,3:08
661573,2022-04-10,2022,ATL,CIN,3,6,6-3,CIN,9,false,35,40,75,181,142,323,9,13,22,4,3:14
661916,2022-04-10,2022,TBA,BAL,8,0,8-0,TBA,9,true,38,37,75,166,155,321,16,11,27,4,3:10
662755,2022-04-10,2022,KCA,CLE,3,17,17-3,CLE,9,false,36,53,89,194,124,318,9,27,36,2,3:09
661802,2022-04-10,2022,TOR,TEX,6,12,12-6,TEX,9,false,38,45,83,175,143,318,12,18,30,3,3:24
663395,2022-04-10,2022,ARI,SDN,5,10,10-5,SDN,9,false,39,43,82,178,174,352,14,15,29,1,3:15
661316,2022-04-10,2022,NYA,BOS,3,4,4-3,BOS,9,false,41,37,78,137,170,307,16,10,26,3,3:40
662863,2022-04-11,2022,DET,BOS,3,1,3-1,DET,9,true,35,31,66,109,145,254,11,4,15,3,2:50
661036,2022-04-11,2022,ANA,MIA,6,2,6-2,ANA,9,true,36,30,66,124,145,269,13,3,16,1,2:42
661637,2022-04-11,2022,PHI,NYN,5,4,5-4,PHI,9,true,34,37,71,141,142,283,12,10,22,4,3:05
661754,2022-04-11,2022,MIN,SEA,4,0,4-0,MIN,9,true,36,34,70,130,161,291,13,5,18,1,3:00
661315,2022-04-11,2022,NYA,TOR,0,3,3-0,TOR,9,false,35,38,73,135,131,266,10,11,21,2,3:03
661915,2022-04-11,2022,TBA,OAK,2,13,13-2,OAK,9,false,36,45,81,158,140,298,9,17,26,2,3:00
663403,2022-04-11,2022,BAL,MIL,2,0,2-0,BAL,9,true,37,36,73,141,162,303,12,10,22,3,3:24
662116,2022-04-11,2022,SFN,SDN,2,4,4-2,SDN,9,false,40,42,82,170,153,323,15,15,30,2,3:30
662754,2022-04-11,2022,KCA,CLE,7,10,10-7,CLE,9,false,42,44,86,172,154,326,16,18,34,6,3:37
661572,2022-04-11,2022,ATL,WAS,2,11,11-2,WAS,9,false,34,49,83,201,146,347,7,23,30,2,3:33
662042,2022-04-11,2022,TEX,COL,4,6,6-4,COL,10,false,40,47,87,177,167,344,13,19,32,3,4:01
662017,2022-04-12,2022,SLN,KCA,6,5,6-5,SLN,9,true,36,36,72,134,121,255,12,10,22,0,2:36
662318,2022-04-12,2022,PIT,CHN,1,2,2-1,CHN,9,false,33,34,67,125,136,261,6,10,16,1,2:51
661636,2022-04-12,2022,PHI,NYN,0,2,2-0,NYN,9,false,32,34,66,136,133,269,6,8,14,4,3:12
661314,2022-04-12,2022,NYA,TOR,4,0,4-0,NYA,9,true,33,33,66,134,147,281,11,5,16,2,3:07
661038,2022-04-12,2022,ANA,MIA,4,3,4-3,ANA,9,false,32,38,70,153,131,284,7,12,19,1,2:59
663411,2022-04-12,2022,ARI,HOU,1,2,2-1,HOU,9,false,36,39,75,134,148,282,9,13,22,3,3:20
661995,2022-04-12,2022,TEX,COL,1,4,4-1,COL,9,false,37,38,75,149,133,282,10,12,22,2,3:09
662862,2022-04-12,2022,DET,BOS,3,5,5-3,BOS,9,false,33,38,71,147,112,259,7,12,19,3,2:49
662104,2022-04-12,2022,SFN,SDN,13,2,13-2,SFN,9,true,43,36,79,152,176,328,20,11,31,2,3:13
661538,2022-04-12,2022,CHA,SEA,3,2,3-2,CHA,9,true,33,40,73,150,140,290,9,13,22,3,3:22
663295,2022-04-12,2022,BAL,MIL,4,5,5-4,MIL,9,false,41,39,80,158,169,327,13,12,25,4,3:38
663088,2022-04-12,2022,CIN,CLE,5,10,10-5,CLE,9,false,32,42,74,197,143,340,8,17,25,2,3:30
661753,2022-04-12,2022,MIN,LAN,2,7,7-2,LAN,9,false,37,45,82,205,151,356,9,18,27,6,4:00 (1:28 delay)
661571,2022-04-12,2022,ATL,WAS,16,4,16-4,ATL,9,true,52,36,88,150,204,354,29,10,39,2,3:37
661944,2022-04-12,2022,TBA,OAK,9,8,9-8,TBA,10,false,51,45,96,185,212,397,22,19,41,6,4:12
662115,2022-04-13,2022,SFN,SDN,2,1,2-1,SFN,9,true,29,34,63,115,112,227,6,7,13,0,2:11
661570,2022-04-13,2022,ATL,WAS,1,3,3-1,WAS,9,false,31,34,65,128,128,256,7,7,14,1,2:57
661530,2022-04-13,2022,CHA,SEA,6,4,6-4,CHA,9,true,36,36,72,149,117,266,14,9,23,1,2:54 (:47 delay)
662317,2022-04-13,2022,PIT,CHN,6,2,6-2,PIT,9,true,35,35,70,143,139,282,13,9,22,2,2:49
661734,2022-04-13,2022,MIN,LAN,0,7,7-0,LAN,9,false,29,44,73,154,107,261,2,16,18,0,2:34
663433,2022-04-13,2022,BAL,MIL,2,4,4-2,MIL,9,false,36,37,73,133,145,278,10,11,21,2,3:04
661313,2022-04-13,2022,NYA,TOR,4,6,6-4,TOR,9,false,39,38,77,135,131,266,13,10,23,3,3:10
661943,2022-04-13,2022,TBA,OAK,2,4,4-2,OAK,9,false,38,36,74,153,134,287,10,9,19,3,3:02
663117,2022-04-13,2022,CIN,CLE,3,7,7-3,CLE,9,false,35,46,81,181,151,332,9,19,28,1,3:07 (:43 delay)
662885,2022-04-13,2022,DET,BOS,7,9,9-7,BOS,9,false,42,46,88,169,194,363,15,19,34,4,3:51
663341,2022-04-13,2022,ARI,HOU,3,2,3-2,ARI,10,false,47,40,87,138,210,348,18,11,29,2,3:50
661643,2022-04-13,2022,PHI,NYN,6,9,9-6,NYN,9,false,42,43,85,176,182,358,16,18,34,5,4:04
661942,2022-04-14,2022,TBA,OAK,3,6,6-3,OAK,9,false,33,38,71,134,106,240,7,12,19,2,2:33
661312,2022-04-14,2022,NYA,TOR,3,0,3-0,NYA,9,true,32,38,70,153,113,266,9,12,21,4,3:06 (1:30 delay)
661292,2022-04-14,2022,MIL,SLN,5,1,5-1,MIL,9,true,36,33,69,143,140,283,12,6,18,1,3:04
662950,2022-04-14,2022,COL,CHN,2,5,5-2,CHN,9,false,41,36,77,111,161,272,14,13,27,3,3:02
661418,2022-04-14,2022,MIA,PHI,4,3,4-3,MIA,9,true,34,39,73,134,148,282,11,14,25,3,3:23
661529,2022-04-14,2022,CHA,SEA,1,5,5-1,SEA,9,false,33,42,75,172,130,302,5,14,19,3,3:01
662237,2022-04-14,2022,SDN,ATL,12,1,12-1,SDN,9,true,48,32,80,124,168,292,23,6,29,1,3:07
662702,2022-04-14,2022,KCA,DET,2,4,4-2,DET,9,false,37,36,73,146,145,291,10,12,22,2,3:10
662627,2022-04-14,2022,LAN,CIN,9,3,9-3,LAN,9,true,39,35,74,146,161,307,17,9,26,4,3:10
661993,2022-04-14,2022,TEX,ANA,10,5,10-5,TEX,9,true,42,42,84,189,150,339,17,17,34,2,3:30
662307,2022-04-14,2022,PIT,WAS,9,4,9-4,PIT,9,true,46,41,87,155,197,352,22,14,36,2,3:37
662701,2022-04-15,2022,KCA,DET,1,2,2-1,DET,9,false,33,32,65,102,128,230,5,5,10,1,2:18
661528,2022-04-15,2022,CHA,TBA,3,2,3-2,CHA,9,true,30,34,64,141,107,248,6,8,14,1,2:51
661792,2022-04-15,2022,TOR,OAK,4,1,4-1,TOR,9,true,38,33,71,137,125,262,19,6,25,5,3:00
662192,2022-04-15,2022,SEA,HOU,11,1,11-1,SEA,9,true,44,32,76,113,165,278,23,6,29,2,3:04
662236,2022-04-15,2022,SDN,ATL,2,5,5-2,ATL,9,false,34,39,73,162,145,307,7,13,20,2,3:22
662620,2022-04-15,2022,LAN,CIN,3,1,3-1,LAN,9,true,36,36,72,142,145,287,14,9,23,1,3:15
662291,2022-04-15,2022,PIT,WAS,2,7,7-2,WAS,9,false,34,42,76,165,148,313,7,17,24,1,3:14
661417,2022-04-15,2022,MIA,PHI,7,1,7-1,MIA,9,true,39,37,76,160,156,316,16,11,27,2,3:15
662485,2022-04-15,2022,NYN,ARI,10,3,10-3,NYN,9,true,41,35,76,161,158,319,17,9,26,1,3:24
662960,2022-04-15,2022,COL,CHN,6,5,6-5,COL,9,true,36,44,80,163,149,312,13,20,33,3,3:26
663265,2022-04-15,2022,BOS,MIN,4,8,8-4,MIN,9,false,34,44,78,197,127,324,8,19,27,0,3:33
661267,2022-04-15,2022,MIL,SLN,1,10,10-1,SLN,9,false,36,46,82,164,143,307,9,20,29,2,3:10
662014,2022-04-15,2022,TEX,ANA,6,9,9-6,ANA,9,false,41,39,80,156,161,317,15,13,28,4,3:32
663136,2022-04-15,2022,CLE,SFN,1,4,4-1,SFN,9,false,32,41,73,146,116,262,6,13,19,3,2:56
663357,2022-04-15,2022,BAL,NYA,2,1,2-1,BAL,11,false,47,40,87,165,190,355,17,10,27,4,4:15
663238,2022-04-16,2022,BOS,MIN,4,0,4-0,BOS,9,true,31,33,64,133,108,241,8,9,17,3,2:45
662619,2022-04-16,2022,LAN,CIN,5,2,5-2,LAN,9,true,33,32,65,136,140,276,10,6,16,2,2:53
661759,2022-04-16,2022,TOR,OAK,5,7,7-5,OAK,9,false,37,37,74,134,143,277,11,11,22,1,3:05
662235,2022-04-16,2022,SDN,ATL,2,5,5-2,ATL,9,false,32,39,71,140,142,282,5,14,19,2,2:57
662798,2022-04-16,2022,KCA,DET,3,1,3-1,KCA,9,true,33,36,69,157,127,284,10,11,21,2,3:02
661527,2022-04-16,2022,CHA,TBA,3,2,3-2,CHA,9,true,32,36,68,159,116,275,7,11,18,0,2:50
662966,2022-04-16,2022,COL,CHN,9,6,9-6,COL,9,true,38,39,77,143,139,282,15,14,29,2,2:58
661335,2022-04-16,2022,MIL,SLN,1,2,2-1,SLN,9,false,31,37,68,146,128,274,5,11,16,3,2:55
662626,2022-04-16,2022,NYN,ARI,2,3,3-2,ARI,9,false,34,40,74,163,131,294,9,15,24,3,3:12
661981,2022-04-16,2022,TEX,ANA,2,7,7-2,ANA,9,false,33,44,77,191,113,304,6,16,22,1,3:10
662290,2022-04-16,2022,PIT,WAS,6,4,6-4,PIT,9,true,36,42,78,152,141,293,13,14,27,4,3:25
663266,2022-04-16,2022,BAL,NYA,2,5,5-2,NYA,9,false,37,43,80,161,138,299,10,17,27,5,3:26 (1:15 delay)
663076,2022-04-16,2022,CLE,SFN,2,4,4-2,SFN,9,false,37,38,75,178,129,307,11,10,21,4,3:19
661416,2022-04-16,2022,MIA,PHI,3,10,10-3,PHI,9,false,37,45,82,200,129,329,12,17,29,1,3:23
662206,2022-04-16,2022,SEA,HOU,0,4,4-0,HOU,9,false,30,38,68,133,102,235,4,11,15,1,2:36
662234,2022-04-17,2022,SDN,ATL,2,1,2-1,SDN,9,true,36,32,68,125,150,275,12,5,17,2,2:54
663308,2022-04-17,2022,BOS,MIN,8,1,8-1,BOS,9,true,37,33,70,148,122,270,13,7,20,2,2:51
663365,2022-04-17,2022,BAL,NYA,5,0,5-0,BAL,9,true,37,34,71,127,154,281,13,7,20,3,3:16
662625,2022-04-17,2022,NYN,ARI,5,0,5-0,NYN,9,true,36,36,72,150,138,288,12,9,21,4,2:59
661804,2022-04-17,2022,TOR,OAK,4,3,4-3,TOR,9,true,36,36,72,123,139,262,13,10,23,4,3:05
662618,2022-04-17,2022,LAN,CIN,9,1,9-1,LAN,9,true,41,34,75,137,169,306,17,8,25,3,3:02
663132,2022-04-17,2022,CLE,SFN,1,8,8-1,SFN,9,false,34,39,73,164,148,312,9,13,22,1,2:57
662930,2022-04-17,2022,COL,CHN,4,6,6-4,CHN,9,false,39,44,83,157,159,316,13,19,32,4,3:19
661462,2022-04-17,2022,CHA,TBA,3,9,9-3,TBA,9,false,35,45,80,161,146,307,9,18,27,3,3:35
662294,2022-04-17,2022,PIT,WAS,5,3,5-3,PIT,9,true,35,40,75,174,132,306,12,15,27,4,3:20
662174,2022-04-17,2022,SEA,HOU,7,2,7-2,SEA,9,true,36,35,71,160,122,282,12,12,24,1,2:56
662038,2022-04-17,2022,TEX,ANA,3,8,8-3,ANA,9,false,38,43,81,162,139,301,12,18,30,3,3:25
661226,2022-04-17,2022,MIL,SLN,6,5,6-5,MIL,9,true,39,40,79,185,176,361,16,13,29,2,3:51
661415,2022-04-17,2022,MIA,PHI,11,3,11-3,MIA,9,true,48,38,86,148,167,315,24,12,36,2,3:32
662929,2022-04-18,2022,COL,PHI,4,1,4-1,COL,9,true,34,32,66,118,126,244,12,7,19,2,2:53
662233,2022-04-18,2022,SDN,CIN,4,1,4-1,SDN,9,true,36,36,72,135,140,275,13,9,22,0,2:50
663197,2022-04-18,2022,CHN,TBA,4,2,4-2,CHN,9,true,32,35,67,144,131,275,9,10,19,2,2:43
662407,2022-04-18,2022,OAK,BAL,5,1,5-1,OAK,9,true,34,35,69,143,139,282,8,10,18,1,2:59
662617,2022-04-18,2022,LAN,ATL,7,4,7-4,LAN,9,true,38,37,75,147,161,308,14,10,24,2,3:14
662928,2022-04-18,2022,HOU,ANA,8,3,8-3,HOU,9,true,40,36,76,128,168,296,16,10,26,3,3:22
663236,2022-04-18,2022,BOS,MIN,3,8,8-3,MIN,9,false,40,42,82,165,147,312,14,17,31,3,3:28
661242,2022-04-18,2022,MIL,PIT,6,1,6-1,MIL,9,true,34,37,71,142,131,273,11,10,21,0,2:44
662583,2022-04-19,2022,WAS,ARI,1,0,1-0,WAS,9,true,30,35,65,136,97,233,6,8,14,2,2:31
661211,2022-04-19,2022,MIL,PIT,5,2,5-2,MIL,9,true,30,31,61,127,133,260,5,4,9,0,2:29
662616,2022-04-19,2022,NYN,SFN,3,1,3-1,NYN,9,true,34,32,66,128,150,278,11,5,16,1,2:41
662616,2022-04-19,2022,NYN,SFN,3,1,3-1,NYN,9,true,34,32,66,128,150,278,11,5,16,1,2:41
662232,2022-04-19,2022,SDN,CIN,6,2,6-2,SDN,9,true,34,34,68,136,124,260,11,7,18,2,2:41
662587,2022-04-19,2022,WAS,ARI,6,1,6-1,WAS,9,true,36,34,70,150,138,288,13,9,22,2,3:08
662753,2022-04-19,2022,KCA,MIN,4,3,4-3,KCA,9,true,34,39,73,150,123,273,12,13,25,3,3:06
662587,2022-04-19,2022,WAS,ARI,6,1,6-1,WAS,9,true,36,34,70,150,138,288,13,9,22,2,3:08
662406,2022-04-19,2022,OAK,BAL,2,1,2-1,OAK,9,true,35,38,73,159,129,288,12,11,23,3,3:11
663196,2022-04-19,2022,CHN,TBA,5,6,6-5,TBA,9,false,37,39,76,149,142,291,10,14,24,3,3:09
662925,2022-04-19,2022,COL,PHI,6,5,6-5,COL,9,true,36,37,73,133,142,275,12,14,26,1,3:02
661405,2022-04-19,2022,MIA,SLN,1,5,5-1,SLN,9,false,36,38,74,150,140,290,10,12,22,3,3:04
662717,2022-04-19,2022,LAN,ATL,1,3,3-1,ATL,9,false,29,38,67,130,121,251,3,13,16,0,2:49
662927,2022-04-19,2022,HOU,ANA,2,7,7-2,ANA,9,false,37,43,80,171,155,326,9,19,28,3,3:36
662350,2022-04-19,2022,NYN,SFN,5,4,5-4,NYN,10,false,39,42,81,148,139,287,11,13,24,1,3:33
663249,2022-04-19,2022,BOS,TOR,2,1,2-1,BOS,9,true,31,36,67,152,138,290,6,9,15,2,3:10
662896,2022-04-19,2022,DET,NYA,2,4,4-2,NYA,9,false,39,42,81,197,174,371,13,14,27,4,3:59
662161,2022-04-19,2022,SEA,TEX,6,2,6-2,SEA,9,true,34,34,68,118,133,251,11,7,18,1,2:37
663146,2022-04-20,2022,CHN,TBA,2,8,8-2,TBA,6,true,23,30,53,104,105,209,7,11,18,1,2:07 (1:04 delay)
662703,2022-04-20,2022,KCA,MIN,2,0,2-0,KCA,9,true,29,32,61,135,107,242,6,8,14,1,2:29
661404,2022-04-20,2022,MIA,SLN,0,2,2-0,SLN,9,false,35,33,68,117,153,270,8,7,15,1,3:03
661203,2022-04-20,2022,MIL,PIT,4,2,4-2,MIL,9,true,34,35,69,148,124,272,10,9,19,3,2:55
663075,2022-04-20,2022,CLE,CHA,2,1,2-1,CLE,9,true,33,34,67,134,144,278,9,8,17,4,3:01
663094,2022-04-20,2022,CLE,CHA,11,1,11-1,CLE,9,true,40,32,72,123,147,270,14,6,20,1,2:41
662231,2022-04-20,2022,SDN,CIN,6,0,6-0,SDN,9,true,36,33,69,135,130,265,15,7,22,1,2:56
662926,2022-04-20,2022,HOU,ANA,0,6,6-0,ANA,9,false,29,40,69,165,114,279,2,14,16,2,3:08
662734,2022-04-20,2022,LAN,ATL,5,1,5-1,LAN,9,true,37,31,68,125,138,263,13,7,20,2,2:43
662178,2022-04-20,2022,SEA,TEX,4,2,4-2,SEA,9,true,37,34,71,134,148,282,15,8,23,2,2:56
662861,2022-04-20,2022,DET,NYA,3,5,5-3,NYA,9,false,38,36,74,145,141,286,14,8,22,1,3:06
662392,2022-04-20,2022,OAK,BAL,0,1,1-0,BAL,9,false,35,34,69,127,143,270,9,8,17,2,3:02
662924,2022-04-20,2022,COL,PHI,6,9,9-6,PHI,9,false,41,44,85,140,145,285,14,17,31,2,3:09
663075,2022-04-20,2022,CLE,CHA,2,1,2-1,CLE,9,true,33,34,67,134,144,278,9,8,17,4,3:01
662560,2022-04-20,2022,WAS,ARI,2,11,11-2,ARI,9,false,37,42,79,162,150,312,10,14,24,1,3:12
663247,2022-04-20,2022,BOS,TOR,1,6,6-1,TOR,9,false,39,42,81,173,129,302,12,15,27,1,3:07
662349,2022-04-20,2022,NYN,SFN,2,5,5-2,SFN,9,false,39,37,76,153,166,319,13,11,24,1,3:20
663225,2022-04-21,2022,BOS,TOR,2,3,3-2,TOR,9,false,33,37,70,146,106,252,9,11,20,3,2:59
662391,2022-04-21,2022,OAK,BAL,6,4,6-4,OAK,9,true,35,34,69,133,127,260,11,9,20,3,2:50
663093,2022-04-21,2022,CLE,CHA,6,3,6-3,CLE,9,true,40,34,74,122,151,273,15,9,24,3,3:07
662593,2022-04-21,2022,NYN,SFN,6,2,6-2,NYN,9,true,39,32,71,105,136,241,16,5,21,1,2:35
661391,2022-04-21,2022,MIA,SLN,5,0,5-0,MIA,9,true,34,32,66,133,129,262,11,5,16,1,2:43
663145,2022-04-21,2022,CHN,PIT,3,4,4-3,PIT,9,false,35,40,75,176,155,331,9,15,24,3,3:35
662850,2022-04-21,2022,DET,NYA,3,0,3-0,DET,9,true,33,34,67,112,122,234,12,8,20,2,2:34
662742,2022-04-21,2022,KCA,MIN,0,1,1-0,MIN,9,false,30,34,64,149,125,274,5,10,15,0,2:43
662558,2022-04-21,2022,WAS,ARI,3,4,4-3,ARI,9,false,38,39,77,153,125,278,12,13,25,2,3:00
662177,2022-04-21,2022,SEA,TEX,6,8,8-6,TEX,9,false,45,43,88,180,192,372,19,13,32,4,3:47
662175,2022-04-22,2022,SEA,KCA,4,1,4-1,SEA,9,true,35,33,68,112,138,250,10,9,19,2,2:42
661037,2022-04-22,2022,ANA,BAL,3,5,5-3,BAL,9,false,32,36,68,128,128,256,9,9,18,2,2:55
661755,2022-04-22,2022,MIN,CHA,2,1,2-1,MIN,9,true,30,36,66,155,129,284,8,9,17,1,3:04
662557,2022-04-22,2022,WAS,SFN,1,7,7-1,SFN,9,false,31,42,73,161,112,273,7,17,24,1,2:53
661311,2022-04-22,2022,NYA,CLE,4,1,4-1,NYA,9,true,35,35,70,144,150,294,11,9,20,0,2:58
663195,2022-04-22,2022,CHN,PIT,2,4,4-2,PIT,9,false,37,35,72,131,158,289,11,10,21,2,3:08
662922,2022-04-22,2022,HOU,TOR,3,4,4-3,TOR,9,false,36,34,70,133,133,266,9,8,17,0,2:53
661569,2022-04-22,2022,ATL,MIA,3,0,3-0,ATL,9,true,33,36,69,144,150,294,9,9,18,2,3:04
663169,2022-04-22,2022,CIN,SLN,2,4,4-2,SLN,9,false,38,43,81,160,143,303,13,17,30,3,3:19
662390,2022-04-22,2022,OAK,TEX,1,8,8-1,TEX,9,false,32,40,72,179,130,309,5,14,19,2,3:05
661914,2022-04-22,2022,TBA,BOS,3,4,4-3,BOS,9,false,38,37,75,135,162,297,11,12,23,2,3:21
663394,2022-04-22,2022,ARI,NYN,5,6,6-5,NYN,10,false,40,40,80,160,147,307,11,10,21,3,3:29
662230,2022-04-22,2022,SDN,LAN,1,6,6-1,LAN,9,false,35,40,75,185,136,321,7,15,22,4,3:25
661621,2022-04-22,2022,PHI,MIL,4,2,4-2,PHI,9,true,37,37,74,163,157,320,13,10,23,2,3:20
662849,2022-04-23,2022,DET,COL,2,3,3-2,COL,9,false,36,33,69,131,146,277,9,6,15,0,2:47
662875,2022-04-23,2022,HOU,TOR,2,3,3-2,TOR,9,false,35,35,70,131,133,264,9,10,19,3,2:54
661620,2022-04-23,2022,PHI,MIL,3,5,5-3,MIL,9,false,33,36,69,144,117,261,8,10,18,2,2:57
662849,2022-04-23,2022,DET,COL,2,3,3-2,COL,9,false,36,33,69,131,146,277,9,6,15,0,2:47
661941,2022-04-23,2022,TBA,BOS,3,2,3-2,TBA,10,false,34,38,72,146,133,279,5,7,12,2,3:05
662549,2022-04-23,2022,WAS,SFN,2,5,5-2,SFN,9,false,35,38,73,140,134,274,8,13,21,1,2:48
662276,2022-04-23,2022,SDN,LAN,3,2,3-2,SDN,10,false,37,37,74,156,149,305,9,9,18,2,3:27
663144,2022-04-23,2022,CHN,PIT,21,0,21-0,CHN,9,true,53,30,83,106,169,275,28,3,31,1,2:47
661035,2022-04-23,2022,ANA,BAL,4,5,5-4,BAL,9,false,39,42,81,145,154,299,11,13,24,2,3:11
661310,2022-04-23,2022,NYA,CLE,5,4,5-4,NYA,9,false,36,32,68,133,139,272,13,6,19,3,2:50
661752,2022-04-23,2022,MIN,CHA,9,2,9-2,MIN,9,true,43,36,79,151,193,344,19,9,28,2,3:32 (:05 delay)
663384,2022-04-23,2022,ARI,NYN,5,2,5-2,ARI,9,true,38,35,73,141,168,309,14,10,24,3,3:19
662848,2022-04-23,2022,DET,COL,13,0,13-0,DET,9,true,45,34,79,138,162,300,23,9,32,2,3:02
661568,2022-04-23,2022,ATL,MIA,7,9,9-7,MIA,9,false,39,48,87,188,159,347,12,22,34,4,3:44
662389,2022-04-23,2022,OAK,TEX,0,2,2-0,TEX,9,false,32,32,64,112,127,239,5,7,12,1,2:41
662191,2022-04-23,2022,SEA,KCA,13,7,13-7,SEA,9,true,48,43,91,178,192,370,24,16,40,6,4:06
663100,2022-04-23,2022,CIN,SLN,0,5,5-0,SLN,9,false,31,42,73,174,120,294,8,16,24,2,3:13
661640,2022-04-24,2022,PHI,MIL,0,1,1-0,MIL,9,false,34,30,64,113,132,245,7,4,11,0,2:49
661931,2022-04-24,2022,TBA,BOS,5,2,5-2,TBA,9,true,37,34,71,114,126,240,16,7,23,3,2:38
663361,2022-04-24,2022,ARI,NYN,2,6,6-2,NYN,9,false,34,41,75,144,118,262,7,14,21,3,2:56
662388,2022-04-24,2022,OAK,TEX,2,0,2-0,OAK,9,true,33,34,67,136,144,280,12,6,18,1,2:56
661317,2022-04-24,2022,NYA,CLE,10,2,10-2,NYA,9,true,40,35,75,143,129,272,17,9,26,1,2:43
662853,2022-04-24,2022,DET,COL,2,6,6-2,COL,9,false,36,39,75,161,131,292,10,13,23,1,2:55
662539,2022-04-24,2022,WAS,SFN,3,12,12-3,SFN,9,false,35,48,83,181,122,303,9,21,30,5,3:19
661033,2022-04-24,2022,ANA,BAL,7,6,7-6,ANA,9,true,40,40,80,159,159,318,18,15,33,7,3:42
663166,2022-04-24,2022,CHN,PIT,3,4,4-3,PIT,9,false,41,40,81,178,156,334,16,13,29,3,3:37 (:55 delay)
662921,2022-04-24,2022,HOU,TOR,8,7,8-7,HOU,10,false,44,43,87,138,179,317,16,13,29,4,3:45
661590,2022-04-24,2022,ATL,MIA,4,5,5-4,MIA,9,false,42,44,86,178,165,343,15,18,33,6,3:42
663111,2022-04-24,2022,CIN,SLN,4,1,4-1,CIN,9,true,32,35,67,137,117,254,12,8,20,2,2:47
662274,2022-04-24,2022,SDN,LAN,2,10,10-2,LAN,9,false,35,42,77,159,140,299,10,13,23,2,3:02
661781,2022-04-24,2022,MIN,CHA,6,4,6-4,MIN,10,false,46,40,86,153,186,339,18,12,30,1,3:50
662188,2022-04-24,2022,SEA,KCA,5,4,5-4,SEA,12,false,48,47,95,179,194,373,18,13,31,2,4:12
661034,2022-04-25,2022,ANA,CLE,3,0,3-0,ANA,9,true,33,32,65,119,117,236,10,7,17,1,2:22
661760,2022-04-25,2022,TOR,BOS,6,2,6-2,TOR,9,true,32,34,66,109,97,206,10,8,18,2,2:16
663382,2022-04-25,2022,ARI,LAN,0,4,4-0,LAN,9,false,31,38,69,148,108,256,4,12,16,0,2:33
661210,2022-04-25,2022,MIL,SFN,2,4,4-2,SFN,9,false,33,36,69,150,130,280,6,12,18,1,3:01
662008,2022-04-25,2022,SLN,NYN,2,5,5-2,NYN,9,false,36,38,74,135,147,282,8,11,19,1,3:00
661979,2022-04-25,2022,TEX,HOU,6,2,6-2,TEX,9,true,39,38,77,149,149,298,15,11,26,3,3:14
661639,2022-04-25,2022,PHI,COL,8,2,8-2,PHI,9,true,38,32,70,129,157,286,12,8,20,3,3:09
661589,2022-04-26,2022,ATL,CHN,3,1,3-1,ATL,9,true,30,32,62,126,118,244,6,6,12,0,2:31
661032,2022-04-26,2022,ANA,CLE,4,1,4-1,ANA,9,true,32,32,64,125,116,241,9,5,14,2,2:34
663383,2022-04-26,2022,ARI,LAN,5,3,5-3,ARI,9,true,33,36,69,142,129,271,8,16,24,1,2:53
662540,2022-04-26,2022,WAS,MIA,2,5,5-2,MIA,9,false,35,40,75,145,138,283,12,13,25,1,3:13
661980,2022-04-26,2022,TEX,HOU,1,5,5-1,HOU,9,false,32,36,68,160,128,288,6,10,16,1,3:02
661733,2022-04-26,2022,MIN,DET,5,4,5-4,MIN,9,false,34,37,71,166,143,309,10,12,22,3,3:05
662007,2022-04-26,2022,SLN,NYN,0,3,3-0,NYN,9,false,35,39,74,154,141,295,9,15,24,2,3:32
661567,2022-04-26,2022,PHI,COL,10,3,10-3,PHI,9,true,40,37,77,157,162,319,15,10,25,2,3:19
663079,2022-04-26,2022,CIN,SDN,6,9,9-6,SDN,9,false,36,43,79,179,136,315,9,17,26,1,3:11
661309,2022-04-26,2022,NYA,BAL,12,8,12-8,NYA,9,true,40,39,79,139,166,305,15,12,27,5,3:19 (:09 delay)
661536,2022-04-26,2022,CHA,KCA,0,6,6-0,KCA,9,false,35,44,79,189,149,338,8,17,25,2,3:20
662297,2022-04-26,2022,PIT,MIL,8,12,12-8,MIL,9,false,45,43,88,155,178,333,17,18,35,6,3:29
661929,2022-04-26,2022,TBA,SEA,4,8,8-4,SEA,9,false,40,43,83,169,191,360,14,13,27,1,3:15
661758,2022-04-26,2022,TOR,BOS,6,5,6-5,TOR,10,false,42,40,82,163,180,343,15,11,26,5,3:47
662086,2022-04-26,2022,SFN,OAK,8,2,8-2,SFN,9,true,35,35,70,162,134,296,11,8,19,2,3:01
661909,2022-04-27,2022,TBA,SEA,3,2,3-2,TBA,9,true,34,34,68,138,124,262,11,7,18,3,2:41
661638,2022-04-27,2022,PHI,COL,7,3,7-3,PHI,9,true,38,38,76,151,149,300,16,14,30,2,3:20
663439,2022-04-27,2022,ANA,CLE,9,5,9-5,ANA,9,true,41,38,79,146,162,308,17,12,29,2,3:12
662546,2022-04-27,2022,WAS,MIA,1,2,2-1,MIA,9,false,36,35,71,164,154,318,9,10,19,4,3:20
663393,2022-04-27,2022,ARI,LAN,3,1,3-1,ARI,9,true,31,34,65,127,114,241,6,8,14,0,2:36
661306,2022-04-27,2022,NYA,BAL,5,2,5-2,NYA,9,true,34,34,68,124,134,258,10,8,18,3,2:57
661533,2022-04-27,2022,CHA,KCA,7,3,7-3,CHA,9,true,35,36,71,144,128,272,12,10,22,2,2:42
662066,2022-04-27,2022,SFN,OAK,0,1,1-0,OAK,9,false,32,35,67,123,155,278,6,10,16,2,3:00
661739,2022-04-27,2022,MIN,DET,5,0,5-0,MIN,9,true,34,30,64,120,114,234,12,3,15,0,2:23
663148,2022-04-27,2022,CIN,SDN,5,8,8-5,SDN,9,false,43,40,83,157,175,332,15,15,30,2,3:28
662048,2022-04-27,2022,SLN,NYN,10,5,10-5,SLN,9,true,43,38,81,160,156,316,21,14,35,3,3:29
662289,2022-04-27,2022,PIT,MIL,1,3,3-1,MIL,9,false,34,37,71,152,139,291,8,9,17,3,3:01
661964,2022-04-27,2022,TEX,HOU,3,4,4-3,HOU,9,false,37,38,75,149,164,313,11,11,22,1,3:17
661757,2022-04-27,2022,TOR,BOS,1,7,7-1,BOS,9,false,35,43,78,162,141,303,8,16,24,3,3:05
661552,2022-04-27,2022,ATL,CHN,3,6,6-3,CHN,10,false,43,45,88,209,180,389,13,17,30,3,4:04
661729,2022-04-28,2022,MIN,DET,7,1,7-1,MIN,9,true,39,40,79,145,144,289,15,15,30,1,3:09
661908,2022-04-28,2022,TBA,SEA,2,1,2-1,TBA,9,true,33,35,68,133,128,261,12,10,22,4,3:04
662538,2022-04-28,2022,WAS,MIA,2,3,3-2,MIA,9,false,34,36,70,121,134,255,8,9,17,2,2:46
661641,2022-04-28,2022,PHI,COL,7,1,7-1,PHI,9,true,35,37,72,153,136,289,10,11,21,2,3:08
662295,2022-04-28,2022,PIT,MIL,2,3,3-2,MIL,9,false,33,39,72,152,147,299,6,12,18,2,3:08
661532,2022-04-28,2022,CHA,KCA,2,5,5-2,KCA,10,false,34,44,78,193,132,325,6,15,21,1,3:20
661305,2022-04-28,2022,NYA,BAL,10,5,10-5,NYA,9,true,40,45,85,175,167,342,17,18,35,5,3:51
663078,2022-04-28,2022,CIN,SDN,5,7,7-5,SDN,9,false,38,43,81,175,157,332,12,18,30,3,3:35
661551,2022-04-28,2022,ATL,CHN,5,1,5-1,ATL,9,true,37,32,69,124,124,248,14,8,22,2,2:49
662047,2022-04-28,2022,SLN,ARI,8,3,8-3,SLN,9,true,41,37,78,139,156,295,18,10,28,2,3:01
661912,2022-04-28,2022,TEX,HOU,2,3,3-2,HOU,9,false,33,32,65,115,117,232,6,5,11,0,2:37
661827,2022-04-28,2022,TOR,BOS,1,0,1-0,TOR,9,true,34,32,66,114,131,245,9,5,14,1,2:42
663432,2022-04-28,2022,ANA,CLE,4,1,4-1,ANA,9,true,34,32,66,145,127,272,10,6,16,0,2:35
663337,2022-04-29,2022,BAL,BOS,1,3,3-1,BOS,9,false,35,35,70,128,143,271,9,8,17,3,2:57
662592,2022-04-29,2022,NYN,PHI,3,0,3-0,NYN,9,true,32,32,64,159,134,293,11,6,17,2,3:18
661390,2022-04-29,2022,MIA,SEA,8,6,8-6,MIA,9,true,37,38,75,157,144,301,15,11,26,1,3:06
662405,2022-04-29,2022,OAK,CLE,8,9,9-8,CLE,9,false,40,41,81,173,144,317,13,16,29,3,3:21
661209,2022-04-29,2022,MIL,CHN,11,1,11-1,MIL,9,true,40,35,75,154,170,324,18,8,26,3,3:15
661535,2022-04-29,2022,CHA,ANA,1,5,5-1,ANA,9,false,32,40,72,159,129,288,5,16,21,4,3:19
661826,2022-04-29,2022,TOR,HOU,7,11,11-7,HOU,9,false,44,48,92,178,165,343,17,22,39,3,3:42
662081,2022-04-29,2022,SFN,WAS,4,14,14-4,WAS,9,false,39,52,91,181,162,343,13,25,38,4,3:46
662037,2022-04-29,2022,SLN,ARI,2,6,6-2,ARI,9,false,35,40,75,161,153,314,8,15,23,3,3:24
661911,2022-04-29,2022,TEX,ATL,3,6,6-3,ATL,9,false,35,42,77,173,145,318,8,16,24,3,3:23
661907,2022-04-29,2022,TBA,MIN,6,1,6-1,TBA,9,true,34,30,64,114,129,243,11,4,15,0,2:16
662699,2022-04-29,2022,LAN,DET,5,1,5-1,LAN,9,true,34,32,66,109,144,253,10,7,17,1,2:43
662741,2022-04-29,2022,KCA,NYA,2,12,12-2,NYA,8,false,33,39,72,162,130,292,10,13,23,2,2:58 (:34 delay)
662296,2022-04-29,2022,PIT,SDN,3,7,7-3,SDN,9,false,38,42,80,170,135,305,12,17,29,3,3:19
663009,2022-04-29,2022,COL,CIN,10,4,10-4,COL,9,true,47,40,87,135,195,330,23,17,40,3,3:25
663008,2022-04-30,2022,COL,CIN,4,3,4-3,COL,9,true,30,31,61,98,124,222,9,5,14,3,2:31
661901,2022-04-30,2022,TEX,ATL,3,1,3-1,TEX,9,true,30,31,61,115,102,217,8,4,12,2,2:16
661389,2022-04-30,2022,MIA,SEA,3,1,3-1,MIA,9,true,34,33,67,134,132,266,11,8,19,1,2:46
662393,2022-04-30,2022,OAK,CLE,1,3,3-1,CLE,9,false,35,36,71,145,128,273,9,12,21,1,2:42
662288,2022-04-30,2022,PIT,SDN,7,6,7-6,PIT,10,false,38,38,76,146,148,294,11,9,20,2,3:07
662698,2022-04-30,2022,LAN,DET,1,5,5-1,DET,9,false,33,41,74,147,138,285,7,14,21,2,3:05
663364,2022-04-30,2022,BAL,BOS,2,1,2-1,BAL,10,false,35,40,75,140,133,273,7,11,18,3,3:09
661208,2022-04-30,2022,MIL,CHN,9,1,9-1,MIL,9,true,41,35,76,136,165,301,15,9,24,0,3:03
661825,2022-04-30,2022,TOR,HOU,2,1,2-1,TOR,9,true,32,39,71,124,106,230,9,11,20,2,2:43
662797,2022-04-30,2022,KCA,NYA,0,3,3-0,NYA,9,false,38,40,78,170,129,299,11,17,28,0,3:08
662084,2022-04-30,2022,SFN,WAS,9,3,9-3,SFN,9,true,42,36,78,128,173,301,18,12,30,4,3:20
662591,2022-04-30,2022,NYN,PHI,1,4,4-1,PHI,9,false,41,35,76,149,180,329,12,10,22,5,3:48
661534,2022-04-30,2022,CHA,ANA,4,0,4-0,CHA,9,true,35,33,68,138,121,259,13,7,20,2,2:55 (1:01 delay)
661906,2022-04-30,2022,TBA,MIN,1,9,9-1,MIN,9,false,34,45,79,183,137,320,7,17,24,3,3:05
662036,2022-04-30,2022,SLN,ARI,0,2,2-0,ARI,9,false,32,33,65,118,136,254,4,5,9,1,2:38
663007,2022-05-01,2022,COL,CIN,10,1,10-1,COL,9,true,42,31,73,99,178,277,18,6,24,1,2:56
662293,2022-05-01,2022,PIT,SDN,2,5,5-2,SDN,9,false,36,39,75,144,132,276,11,11,22,2,3:02 (1:22 delay)
661905,2022-05-01,2022,TBA,MIN,3,9,9-3,MIN,9,false,35,43,78,164,130,294,9,16,25,1,2:53
661988,2022-05-01,2022,SLN,ARI,7,5,7-5,SLN,9,true,36,37,73,153,155,308,11,11,22,4,3:14
662397,2022-05-01,2022,OAK,CLE,3,7,7-3,CLE,9,false,37,43,80,174,143,317,10,15,25,4,3:13
663363,2022-05-01,2022,BAL,BOS,9,5,9-5,BAL,9,true,41,42,83,160,165,325,19,17,36,4,3:19 (2:05 delay)
662691,2022-05-01,2022,KCA,NYA,4,6,6-4,NYA,9,false,39,40,79,178,149,327,13,15,28,2,3:23
661531,2022-05-01,2022,CHA,ANA,5,6,6-5,ANA,9,false,41,42,83,173,129,302,16,18,34,4,3:15
662579,2022-05-01,2022,NYN,PHI,10,6,10-6,NYN,9,true,41,36,77,142,160,302,18,10,28,2,3:20
661824,2022-05-01,2022,TOR,HOU,3,2,3-2,TOR,9,true,29,35,64,129,118,247,6,8,14,2,2:52
661216,2022-05-01,2022,MIL,CHN,0,2,2-0,CHN,9,false,31,34,65,129,139,268,6,7,13,2,2:43
662716,2022-05-01,2022,LAN,DET,6,3,6-3,LAN,9,true,34,39,73,162,119,281,8,13,21,2,2:57
661935,2022-05-01,2022,TEX,ATL,7,3,7-3,TEX,9,true,41,37,78,146,157,303,17,11,28,1,3:00
661365,2022-05-01,2022,MIA,SEA,3,7,7-3,SEA,9,false,42,40,82,151,175,326,14,19,33,2,3:22
662106,2022-05-01,2022,SFN,WAS,5,11,11-5,WAS,9,false,40,46,86,175,157,332,13,20,33,4,3:37
662009,2022-05-02,2022,SLN,KCA,1,0,1-0,SLN,9,true,28,33,61,144,124,268,5,6,11,0,2:40
661526,2022-05-02,2022,CHA,ANA,3,0,3-0,CHA,9,true,33,30,63,125,128,253,10,3,13,0,2:39
662009,2022-05-02,2022,SLN,KCA,1,0,1-0,SLN,9,true,28,33,61,144,124,268,5,6,11,0,2:40
662920,2022-05-02,2022,HOU,SEA,3,0,3-0,HOU,9,true,34,31,65,130,117,247,10,8,18,1,2:48
663362,2022-05-02,2022,BAL,MIN,1,2,2-1,MIN,9,false,32,33,65,128,135,263,6,8,14,3,2:56
661823,2022-05-02,2022,TOR,NYA,2,3,3-2,NYA,9,false,35,35,70,126,125,251,11,8,19,3,2:54
662387,2022-05-02,2022,OAK,TBA,1,6,6-1,TBA,9,false,30,39,69,143,126,269,3,12,15,0,2:37
662578,2022-05-02,2022,NYN,ATL,2,5,5-2,ATL,9,false,36,37,73,134,149,283,8,11,19,1,3:18
661362,2022-05-02,2022,MIA,ARI,4,5,5-4,ARI,9,false,38,37,75,154,157,311,12,12,24,2,3:27
663463,2022-05-03,2022,BAL,MIN,2,7,7-2,MIN,9,false,37,41,78,151,128,279,10,15,25,3,3:00
661796,2022-05-03,2022,TOR,NYA,1,9,9-1,NYA,9,false,35,41,76,158,113,271,8,13,21,2,2:57
662459,2022-05-03,2022,NYN,ATL,3,0,3-0,NYN,9,true,32,34,66,104,108,212,10,9,19,0,2:18
661635,2022-05-03,2022,PHI,TEX,4,6,6-4,TEX,9,false,37,39,76,158,133,291,12,11,23,2,3:05
661364,2022-05-03,2022,MIA,ARI,4,5,5-4,ARI,9,false,37,40,77,149,163,312,10,13,23,3,3:24
663237,2022-05-03,2022,BOS,ANA,4,0,4-0,BOS,9,true,33,30,63,101,115,216,10,6,16,1,2:23
662690,2022-05-03,2022,KCA,SLN,7,1,7-1,KCA,9,true,40,34,74,123,128,251,18,10,28,3,2:47
662708,2022-05-03,2022,LAN,SFN,3,1,3-1,LAN,9,true,32,35,67,129,136,265,8,9,17,2,3:05
662994,2022-05-03,2022,COL,WAS,2,10,10-2,WAS,9,false,35,44,79,138,123,261,9,20,29,0,2:39
662569,2022-05-03,2022,NYN,ATL,5,4,5-4,NYN,9,true,35,37,72,151,126,277,12,9,21,1,2:49
663165,2022-05-03,2022,CHN,CHA,1,3,3-1,CHA,9,false,35,36,71,128,150,278,9,11,20,2,3:01
662919,2022-05-03,2022,HOU,SEA,4,0,4-0,HOU,9,true,34,33,67,151,142,293,11,7,18,2,3:12
661200,2022-05-03,2022,MIL,CIN,6,3,6-3,MIL,9,true,35,33,68,144,167,311,11,6,17,3,3:10
662386,2022-05-03,2022,OAK,TBA,7,10,10-7,TBA,10,false,41,45,86,153,148,301,14,18,32,5,3:21
662382,2022-05-04,2022,OAK,TBA,0,3,3-0,TBA,9,false,32,38,70,154,90,244,5,11,16,2,2:39
663164,2022-05-04,2022,CHN,CHA,3,4,4-3,CHA,9,false,33,36,69,121,146,267,7,12,19,3,3:05
663462,2022-05-04,2022,BAL,MIN,9,4,9-4,BAL,9,true,37,34,71,130,125,255,14,13,27,1,2:43
661634,2022-05-04,2022,PHI,TEX,1,2,2-1,TEX,10,false,37,37,74,114,133,247,10,11,21,2,3:14
661795,2022-05-04,2022,TOR,NYA,2,1,2-1,TOR,9,true,31,35,66,129,129,258,8,9,17,1,2:44
662835,2022-05-04,2022,HOU,SEA,7,2,7-2,HOU,9,true,37,31,68,128,164,292,15,5,20,1,3:01
661363,2022-05-04,2022,MIA,ARI,7,8,8-7,ARI,9,false,40,40,80,149,160,309,14,14,28,3,3:25
662839,2022-05-04,2022,DET,PIT,2,7,7-2,PIT,9,false,39,41,80,164,129,293,11,17,28,1,3:07
662739,2022-05-04,2022,KCA,SLN,0,10,10-0,SLN,9,false,32,44,76,202,117,319,5,17,22,2,3:02
662707,2022-05-04,2022,LAN,SFN,9,1,9-1,LAN,9,true,37,33,70,120,161,281,16,8,24,3,3:00
661197,2022-05-04,2022,MIL,CIN,18,4,18-4,MIL,9,true,51,38,89,158,211,369,28,10,38,5,3:46
662577,2022-05-04,2022,NYN,ATL,2,9,9-2,ATL,9,false,38,41,79,161,146,307,13,13,26,3,3:28
663068,2022-05-04,2022,CLE,SDN,6,5,6-5,CLE,10,false,42,43,85,175,181,356,16,17,33,3,3:46
663248,2022-05-04,2022,BOS,ANA,5,10,10-5,ANA,10,false,40,42,82,180,148,328,13,12,25,3,3:42
662993,2022-05-04,2022,COL,WAS,5,2,5-2,COL,9,true,35,31,66,124,94,218,9,9,18,1,2:18 (:25 delay)
662838,2022-05-04,2022,DET,PIT,3,2,3-2,DET,9,true,31,33,64,143,113,256,5,7,12,2,2:41
662839,2022-05-04,2022,DET,PIT,2,7,7-2,PIT,9,false,39,41,80,164,129,293,11,17,28,1,3:07
663067,2022-05-04,2022,CLE,SDN,4,5,5-4,SDN,9,false,40,39,79,144,163,307,13,11,24,2,3:15
663068,2022-05-04,2022,CLE,SDN,6,5,6-5,CLE,10,false,42,43,85,175,181,356,16,17,33,3,3:46
663066,2022-05-05,2022,CLE,TOR,6,5,6-5,CLE,9,true,36,38,74,157,140,297,13,11,24,2,3:03
662105,2022-05-05,2022,SFN,SLN,1,7,7-1,SLN,9,false,38,40,78,154,150,304,14,14,28,3,3:01
661204,2022-05-05,2022,MIL,CIN,10,5,10-5,MIL,9,true,40,38,78,139,167,306,16,10,26,1,3:05
662189,2022-05-05,2022,SEA,TBA,3,4,4-3,TBA,9,false,34,35,69,127,130,257,8,8,16,3,2:50
661341,2022-05-05,2022,BAL,MIN,5,3,5-3,BAL,9,true,35,37,72,132,138,270,12,14,26,5,3:03
662262,2022-05-05,2022,SDN,MIA,2,1,2-1,SDN,9,true,32,32,64,133,130,263,10,6,16,2,2:50
662816,2022-05-05,2022,HOU,DET,3,2,3-2,HOU,9,false,33,34,67,140,140,280,10,10,20,0,2:55
663227,2022-05-05,2022,BOS,ANA,0,8,8-0,ANA,9,false,34,38,72,154,127,281,6,11,17,1,2:55
661619,2022-05-05,2022,PHI,NYN,7,8,8-7,NYN,9,false,42,39,81,140,134,274,15,12,27,2,3:15
663013,2022-05-05,2022,COL,WAS,9,7,9-7,COL,9,true,38,43,81,157,153,310,14,18,32,4,3:25
663360,2022-05-06,2022,ARI,COL,4,1,4-1,ARI,9,true,34,36,70,114,135,249,10,10,20,2,2:47
663431,2022-05-06,2022,ANA,WAS,3,0,3-0,ANA,9,true,33,33,66,110,131,241,12,8,20,0,2:28
662815,2022-05-06,2022,HOU,DET,3,2,3-2,HOU,9,true,36,32,68,120,139,259,12,4,16,2,3:06
662103,2022-05-06,2022,SFN,SLN,2,3,3-2,SLN,9,false,34,35,69,131,128,259,9,8,17,3,2:52
661775,2022-05-06,2022,MIN,OAK,2,1,2-1,MIN,9,true,36,32,68,125,136,261,12,6,18,1,2:44
662187,2022-05-06,2022,SEA,TBA,7,8,8-7,TBA,9,false,43,43,86,181,167,348,17,18,35,5,3:54
662272,2022-05-06,2022,SDN,MIA,3,2,3-2,SDN,9,true,35,34,69,129,168,297,11,7,18,1,3:19
661541,2022-05-06,2022,ATL,MIL,3,6,6-3,MIL,9,false,32,43,75,176,139,315,6,15,21,3,3:15
663224,2022-05-06,2022,BOS,CHA,2,4,4-2,CHA,9,false,37,40,77,162,137,299,12,15,27,1,3:29
662796,2022-05-07,2022,HOU,DET,3,2,3-2,HOU,9,true,34,38,72,135,129,264,11,13,24,2,3:01
663359,2022-05-07,2022,ARI,COL,1,4,4-1,COL,9,false,37,38,75,148,133,281,13,10,23,2,3:19
663057,2022-05-07,2022,CLE,TOR,8,2,8-2,CLE,9,true,39,30,69,134,164,298,15,6,21,0,2:55
663142,2022-05-07,2022,CHN,LAN,2,6,6-2,LAN,9,false,36,39,75,168,129,297,8,12,20,1,3:05
663430,2022-05-07,2022,ANA,WAS,3,7,7-3,WAS,9,false,37,40,77,156,137,293,10,13,23,3,3:02
663226,2022-05-07,2022,BOS,CHA,1,3,3-1,CHA,10,false,40,43,83,160,148,308,10,13,23,1,3:42
663057,2022-05-07,2022,CLE,TOR,8,2,8-2,CLE,9,true,39,30,69,134,164,298,15,6,21,0,2:55
663162,2022-05-07,2022,CHN,LAN,0,7,7-0,LAN,9,false,32,40,72,162,121,283,8,15,23,1,2:43
662261,2022-05-07,2022,SDN,MIA,0,8,8-0,MIA,9,false,34,41,75,162,108,270,7,14,21,1,2:54
662102,2022-05-07,2022,SFN,SLN,13,7,13-7,SFN,9,true,44,43,87,159,178,337,19,17,36,2,3:22
662159,2022-05-07,2022,SEA,TBA,2,8,8-2,TBA,9,false,34,41,75,164,137,301,8,16,24,2,3:01
661701,2022-05-07,2022,MIN,OAK,1,0,1-0,MIN,9,true,31,33,64,129,132,261,8,7,15,3,2:55
661540,2022-05-07,2022,ATL,MIL,3,2,3-2,ATL,9,true,35,33,68,131,135,266,11,8,19,0,2:57
663142,2022-05-07,2022,CHN,LAN,2,6,6-2,LAN,9,false,36,39,75,168,129,297,8,12,20,1,3:05
663089,2022-05-07,2022,CIN,PIT,9,2,9-2,CIN,9,true,39,36,75,133,158,291,15,10,25,3,3:09
663056,2022-05-07,2022,CLE,TOR,3,8,8-3,TOR,9,false,36,45,81,193,153,346,10,20,30,3,3:23
663070,2022-05-07,2022,CIN,PIT,5,8,8-5,PIT,9,false,40,45,85,199,170,369,14,19,33,4,3:46
662795,2022-05-08,2022,HOU,DET,5,0,5-0,HOU,9,true,34,31,65,127,137,264,11,4,15,0,2:44
661626,2022-05-08,2022,PHI,NYN,3,2,3-2,PHI,9,true,35,33,68,134,141,275,12,9,21,0,2:58
663278,2022-05-08,2022,BOS,CHA,2,3,3-2,CHA,9,false,35,36,71,130,134,264,10,10,20,3,3:21
661304,2022-05-08,2022,NYA,TEX,2,4,4-2,TEX,9,false,36,35,71,117,156,273,10,9,19,3,3:07
663086,2022-05-08,2022,CLE,TOR,4,3,4-3,CLE,9,true,35,35,70,142,146,288,13,7,20,3,3:02
662260,2022-05-08,2022,SDN,MIA,3,2,3-2,SDN,9,false,36,34,70,129,155,284,10,7,17,1,3:07
661304,2022-05-08,2022,NYA,TEX,2,4,4-2,TEX,9,false,36,35,71,117,156,273,10,9,19,3,3:07
661302,2022-05-08,2022,NYA,TEX,2,1,2-1,NYA,9,false,34,34,68,144,144,288,8,7,15,2,2:54
661345,2022-05-08,2022,BAL,KCA,4,2,4-2,BAL,9,true,37,33,70,110,155,265,13,7,20,1,2:43
662098,2022-05-08,2022,SFN,SLN,4,3,4-3,SFN,9,true,38,39,77,153,142,295,14,12,26,1,3:08
661307,2022-05-08,2022,BAL,KCA,4,6,6-4,KCA,9,false,42,41,83,134,153,287,16,14,30,3,3:17
661627,2022-05-08,2022,PHI,NYN,1,6,6-1,NYN,9,false,35,41,76,171,147,318,7,14,21,2,3:15
663368,2022-05-08,2022,ARI,COL,4,0,4-0,ARI,9,true,34,33,67,115,133,248,12,6,18,1,2:44
661550,2022-05-08,2022,ATL,MIL,9,2,9-2,ATL,9,true,39,34,73,142,149,291,16,9,25,0,2:52
661627,2022-05-08,2022,PHI,NYN,1,6,6-1,NYN,9,false,35,41,76,171,147,318,7,14,21,2,3:15
663069,2022-05-08,2022,CIN,PIT,7,3,7-3,CIN,9,true,37,33,70,155,160,315,12,6,18,1,3:01
662160,2022-05-08,2022,SEA,TBA,2,1,2-1,SEA,10,false,38,35,73,146,119,265,12,8,20,0,3:04
663429,2022-05-08,2022,ANA,WAS,5,4,5-4,ANA,9,false,40,39,79,156,165,321,15,14,29,2,3:26
661345,2022-05-08,2022,BAL,KCA,4,2,4-2,BAL,9,true,37,33,70,110,155,265,13,7,20,1,2:43
663161,2022-05-08,2022,CHN,LAN,1,7,7-1,LAN,9,false,33,40,73,152,130,282,7,14,21,0,2:57
661700,2022-05-08,2022,MIN,OAK,4,3,4-3,MIN,9,true,33,36,69,158,136,294,10,10,20,2,3:19
663366,2022-05-09,2022,ARI,MIA,4,3,4-3,ARI,9,true,34,35,69,123,126,249,10,10,20,3,2:50
662837,2022-05-09,2022,DET,OAK,0,2,2-0,OAK,9,false,32,34,66,125,130,255,6,8,14,2,2:49
661349,2022-05-09,2022,BAL,KCA,6,1,6-1,BAL,9,true,36,37,73,148,134,282,13,10,23,2,2:53
661349,2022-05-09,2022,BAL,KCA,6,1,6-1,BAL,9,true,36,37,73,148,134,282,13,10,23,2,2:53
662259,2022-05-09,2022,SDN,CHN,0,6,6-0,CHN,9,false,30,38,68,159,123,282,4,13,17,1,2:59
662097,2022-05-09,2022,SFN,COL,8,5,8-5,SFN,9,true,39,38,77,163,160,323,16,13,29,1,3:15
662158,2022-05-09,2022,SEA,PHI,0,9,9-0,PHI,9,false,34,46,80,161,139,300,8,19,27,1,3:01
663101,2022-05-09,2022,CIN,MIL,10,5,10-5,CIN,9,true,40,37,77,159,166,325,17,10,27,4,3:18
661303,2022-05-09,2022,NYA,TEX,1,0,1-0,NYA,9,true,31,32,63,127,136,263,9,6,15,2,2:41
663438,2022-05-09,2022,ANA,TBA,11,3,11-3,ANA,9,true,38,40,78,142,147,289,14,12,26,2,3:02
661525,2022-05-09,2022,CHA,CLE,9,12,12-9,CLE,11,false,51,51,102,186,192,378,16,16,32,2,4:13
661303,2022-05-09,2022,NYA,TEX,1,0,1-0,NYA,9,true,31,32,63,127,136,263,9,6,15,2,2:41
662287,2022-05-09,2022,PIT,LAN,5,1,5-1,PIT,9,true,37,37,74,143,110,253,15,10,25,2,2:41
663416,2022-05-10,2022,ANA,TBA,12,0,12-0,ANA,9,true,43,28,71,108,138,246,19,1,20,0,2:19
661524,2022-05-10,2022,CHA,CLE,4,1,4-1,CHA,9,true,33,35,68,123,118,241,9,10,19,2,2:43
662412,2022-05-10,2022,OAK,DET,0,6,6-0,DET,9,false,32,41,73,155,115,270,7,16,23,1,2:56
661696,2022-05-10,2022,MIN,HOU,0,5,5-0,HOU,9,false,29,45,74,180,110,290,5,17,22,3,3:10
661987,2022-05-10,2022,SLN,BAL,3,5,5-3,BAL,9,false,32,40,72,143,123,266,8,14,22,3,2:53
662258,2022-05-10,2022,SDN,CHN,5,4,5-4,SDN,9,true,38,41,79,172,122,294,16,14,30,2,3:08
662016,2022-05-10,2022,TEX,KCA,6,4,6-4,TEX,9,true,37,36,73,147,143,290,13,8,21,2,3:01
662537,2022-05-10,2022,WAS,NYN,2,4,4-2,NYN,9,false,32,43,75,170,115,285,9,16,25,2,3:08
662855,2022-05-10,2022,DET,OAK,1,4,4-1,OAK,9,false,38,36,74,136,147,283,11,10,21,1,2:59
662292,2022-05-10,2022,PIT,LAN,1,11,11-1,LAN,9,false,37,44,81,167,145,312,11,18,29,1,3:02
662157,2022-05-10,2022,SEA,PHI,5,4,5-4,SEA,9,true,40,35,75,171,157,328,15,8,23,3,3:36
663090,2022-05-10,2022,CIN,MIL,4,5,5-4,MIL,9,false,39,43,82,174,167,341,13,17,30,4,3:50
663350,2022-05-10,2022,ARI,MIA,9,3,9-3,ARI,9,true,39,38,77,144,178,322,17,10,27,2,3:17
661301,2022-05-10,2022,NYA,TOR,6,5,6-5,NYA,9,false,38,38,76,178,157,335,13,12,25,5,3:39
662096,2022-05-10,2022,SFN,COL,9,2,9-2,SFN,9,true,42,38,80,159,175,334,18,12,30,3,3:10
661549,2022-05-10,2022,ATL,BOS,4,9,9-4,BOS,9,false,38,45,83,183,174,357,11,18,29,1,3:47
661300,2022-05-11,2022,NYA,TOR,5,3,5-3,NYA,9,true,33,39,72,136,127,263,9,12,21,4,2:50
663358,2022-05-11,2022,ARI,MIA,3,11,11-3,MIA,9,false,34,43,77,168,124,292,7,18,25,2,2:58
662176,2022-05-11,2022,SEA,PHI,2,4,4-2,PHI,9,false,37,35,72,144,144,288,10,10,20,3,3:11
661548,2022-05-11,2022,ATL,BOS,5,3,5-3,ATL,9,false,35,37,72,163,125,288,10,11,21,3,3:11
662526,2022-05-11,2022,WAS,NYN,8,3,8-3,WAS,9,true,38,37,75,134,150,284,15,10,25,3,3:05
662095,2022-05-11,2022,SFN,COL,7,1,7-1,SFN,9,true,42,32,74,132,176,308,16,6,22,3,3:14
662006,2022-05-11,2022,SLN,BAL,10,1,10-1,SLN,9,true,40,33,73,132,169,301,16,6,22,1,2:58
662385,2022-05-11,2022,PIT,LAN,5,3,5-3,PIT,9,true,39,37,76,154,163,317,15,10,25,3,3:20
662873,2022-05-11,2022,DET,OAK,0,9,9-0,OAK,9,false,33,43,76,177,126,303,7,18,25,1,3:04
663074,2022-05-11,2022,CIN,MIL,14,11,14-11,CIN,9,true,44,45,89,162,148,310,21,19,40,3,3:26
661702,2022-05-11,2022,MIN,HOU,3,11,11-3,HOU,9,false,42,45,87,173,163,336,14,18,32,1,3:33 (1:21 delay)
662273,2022-05-11,2022,SDN,CHN,5,7,7-5,CHN,9,false,43,37,80,147,167,314,16,12,28,0,3:26
663450,2022-05-11,2022,ANA,TBA,2,4,4-2,TBA,10,false,37,38,75,151,156,307,8,8,16,1,3:17
661702,2022-05-11,2022,MIN,HOU,3,11,11-3,HOU,9,false,42,45,87,173,163,336,14,18,32,1,3:33 (1:21 delay)
661899,2022-05-11,2022,TEX,KCA,2,8,8-2,KCA,9,false,32,42,74,148,113,261,7,13,20,2,2:55
662548,2022-05-12,2022,WAS,NYN,1,4,4-1,NYN,9,false,30,36,66,158,119,277,5,11,16,1,2:45
662372,2022-05-12,2022,PIT,CIN,0,4,4-0,CIN,9,false,31,39,70,152,124,276,8,12,20,2,2:52
662872,2022-05-12,2022,DET,OAK,3,5,5-3,OAK,9,false,35,35,70,143,131,274,9,9,18,0,2:57
661694,2022-05-12,2022,MIN,HOU,0,5,5-0,HOU,9,false,36,41,77,160,143,303,9,15,24,2,3:20
662706,2022-05-12,2022,LAN,PHI,7,9,9-7,PHI,9,false,44,40,84,140,172,312,17,13,30,2,3:29
661883,2022-05-12,2022,TEX,KCA,3,1,3-1,TEX,9,true,35,37,72,128,135,263,11,10,21,2,2:52
662005,2022-05-12,2022,SLN,BAL,2,3,3-2,BAL,9,false,34,35,69,128,160,288,10,8,18,3,3:05
661519,2022-05-12,2022,CHA,NYA,7,15,15-7,NYA,9,false,40,48,88,211,152,363,12,22,34,2,3:56
662381,2022-05-13,2022,OAK,ANA,0,2,2-0,ANA,9,false,30,33,63,126,120,246,4,6,10,0,2:30
661882,2022-05-13,2022,TEX,BOS,1,7,7-1,BOS,9,false,33,40,73,145,120,265,6,14,20,1,2:46
663349,2022-05-13,2022,ARI,CHN,4,3,4-3,ARI,9,true,37,35,72,142,129,271,14,9,23,3,2:56
661491,2022-05-13,2022,CHA,NYA,4,10,10-4,NYA,9,false,37,44,81,162,133,295,10,18,28,1,3:21
661361,2022-05-13,2022,MIA,MIL,1,2,2-1,MIL,9,false,30,36,66,147,114,261,5,8,13,1,2:53
661986,2022-05-13,2022,SLN,SFN,2,8,8-2,SFN,9,false,35,43,78,154,138,292,10,17,27,2,3:06
661698,2022-05-13,2022,MIN,CLE,12,8,12-8,MIN,9,true,41,44,85,168,161,329,19,16,35,4,3:26
663012,2022-05-13,2022,COL,KCA,10,14,14-10,KCA,9,false,45,48,93,153,190,343,17,21,38,6,3:53
661904,2022-05-13,2022,TBA,TOR,5,2,5-2,TBA,9,true,33,33,66,128,119,247,9,7,16,4,2:49
662705,2022-05-13,2022,LAN,PHI,10,12,12-10,PHI,10,false,48,51,99,190,185,375,19,23,42,4,4:18
662494,2022-05-13,2022,PIT,CIN,2,8,8-2,CIN,9,false,36,40,76,149,160,309,9,14,23,1,3:02
662525,2022-05-13,2022,WAS,HOU,1,6,6-1,HOU,9,false,36,36,72,134,120,254,10,10,20,1,2:45
662523,2022-05-13,2022,NYN,SEA,1,2,2-1,SEA,9,false,35,35,70,137,140,277,8,10,18,1,2:56
662851,2022-05-13,2022,DET,BAL,4,2,4-2,DET,9,true,32,43,75,169,117,286,9,17,26,4,3:10
661547,2022-05-13,2022,ATL,SDN,6,11,11-6,SDN,9,false,42,47,89,164,170,334,16,20,36,3,3:42
662704,2022-05-14,2022,LAN,PHI,3,8,8-3,PHI,9,false,36,36,72,122,137,259,9,10,19,0,2:38
663011,2022-05-14,2022,COL,KCA,10,4,10-4,COL,9,true,38,33,71,124,145,269,15,6,21,1,2:39
661985,2022-05-14,2022,SLN,SFN,4,0,4-0,SLN,9,true,34,37,71,148,134,282,10,12,22,2,3:05
661903,2022-05-14,2022,TBA,TOR,1,5,5-1,TOR,9,false,35,39,74,143,142,285,9,11,20,2,3:03
661546,2022-05-14,2022,ATL,SDN,6,5,6-5,ATL,9,true,34,35,69,134,128,262,12,6,18,3,2:55
661490,2022-05-14,2022,CHA,NYA,3,2,3-2,CHA,9,false,39,37,76,142,150,292,15,13,28,2,3:27
662379,2022-05-14,2022,OAK,ANA,4,3,4-3,OAK,9,false,34,41,75,143,144,287,12,16,28,5,3:18
662568,2022-05-14,2022,NYN,SEA,5,4,5-4,NYN,9,true,34,41,75,173,137,310,8,16,24,2,3:30 (1:08 delay)
661147,2022-05-14,2022,TEX,BOS,3,11,11-3,BOS,9,false,35,46,81,174,132,306,8,18,26,2,3:23
662844,2022-05-14,2022,DET,BAL,3,0,3-0,DET,9,true,30,31,61,133,99,232,8,6,14,2,2:29
661695,2022-05-14,2022,MIN,CLE,2,3,3-2,CLE,10,false,43,37,80,150,177,327,14,9,23,2,3:31
662547,2022-05-14,2022,WAS,HOU,13,6,13-6,WAS,9,true,43,43,86,164,172,336,19,17,36,2,3:27
663348,2022-05-14,2022,ARI,CHN,2,4,4-2,CHN,9,false,39,35,74,158,160,318,12,8,20,3,3:22
662399,2022-05-14,2022,OAK,ANA,1,9,9-1,ANA,9,false,32,41,73,165,128,293,9,15,24,0,2:47
662384,2022-05-14,2022,PIT,CIN,3,1,3-1,PIT,9,true,29,34,63,142,139,281,7,8,15,1,2:54
661414,2022-05-14,2022,MIA,MIL,9,3,9-3,MIA,9,true,41,35,76,150,170,320,15,9,24,2,3:30
661902,2022-05-15,2022,TBA,TOR,3,0,3-0,TBA,9,true,32,31,63,128,106,234,7,6,13,2,2:47
662519,2022-05-15,2022,PIT,CIN,1,0,1-0,PIT,9,true,30,32,62,126,127,253,6,6,12,1,2:34
661732,2022-05-15,2022,MIN,CLE,3,1,3-1,MIN,9,true,30,33,63,137,114,251,6,6,12,1,2:38
661146,2022-05-15,2022,TEX,BOS,7,1,7-1,TEX,9,true,33,37,70,154,128,282,9,10,19,1,2:57
663367,2022-05-15,2022,ARI,CHN,2,3,3-2,CHN,9,false,34,37,71,155,122,277,8,10,18,4,3:05
662380,2022-05-15,2022,OAK,ANA,1,4,4-1,ANA,9,false,38,37,75,152,145,297,11,11,22,3,3:29
662843,2022-05-15,2022,DET,BAL,5,1,5-1,DET,9,true,36,33,69,148,135,283,15,6,21,2,3:00
662696,2022-05-15,2022,LAN,PHI,5,4,5-4,LAN,9,false,36,41,77,156,146,302,13,15,28,1,3:33
662567,2022-05-15,2022,NYN,SEA,7,8,8-7,SEA,9,false,40,42,82,163,151,314,15,17,32,3,3:22
661984,2022-05-15,2022,SLN,SFN,15,6,15-6,SLN,9,true,48,37,85,148,166,314,24,11,35,2,3:05
661403,2022-05-15,2022,MIA,MIL,3,7,7-3,MIL,9,false,36,43,79,175,149,324,7,16,23,1,3:33
661545,2022-05-15,2022,ATL,SDN,3,7,7-3,SDN,11,false,42,44,86,157,170,327,9,11,20,1,3:33
662528,2022-05-15,2022,WAS,HOU,0,8,8-0,HOU,9,false,34,40,74,130,161,291,8,14,22,1,3:07
663010,2022-05-15,2022,COL,KCA,7,8,8-7,KCA,9,false,42,41,83,147,182,329,15,16,31,4,3:23
661489,2022-05-15,2022,CHA,NYA,1,5,5-1,NYA,9,false,31,34,65,149,114,263,4,7,11,0,2:32
661212,2022-05-16,2022,MIL,ATL,1,0,1-0,MIL,9,true,31,30,61,133,129,262,7,3,10,0,2:31
663151,2022-05-16,2022,CHN,PIT,9,0,9-0,CHN,9,true,41,30,71,112,150,262,17,3,20,1,2:29
661961,2022-05-16,2022,TBA,DET,2,3,3-2,DET,9,false,34,35,69,127,135,262,9,8,17,2,2:43
661145,2022-05-16,2022,TEX,ANA,7,4,7-4,TEX,9,true,37,37,74,124,142,266,11,11,22,2,2:51
663275,2022-05-16,2022,BOS,HOU,6,3,6-3,BOS,9,true,34,38,72,143,121,264,11,12,23,3,3:07 (1:38 delay)
661402,2022-05-16,2022,MIA,WAS,8,2,8-2,MIA,9,true,39,36,75,115,156,271,20,8,28,2,3:01
662695,2022-05-16,2022,LAN,ARI,5,4,5-4,LAN,9,true,38,35,73,133,152,285,16,8,24,0,2:56
662378,2022-05-16,2022,OAK,MIN,1,3,3-1,MIN,9,false,32,38,70,152,132,284,6,11,17,1,2:54
662728,2022-05-16,2022,KCA,CHA,3,5,5-3,CHA,10,false,36,42,78,157,135,292,8,12,20,1,3:05
661308,2022-05-16,2022,BAL,NYA,2,6,6-2,NYA,9,false,32,42,74,162,147,309,6,16,22,1,2:59
663005,2022-05-16,2022,COL,SFN,6,7,7-6,SFN,9,false,42,40,82,159,163,322,16,12,28,3,3:23
661794,2022-05-16,2022,TOR,SEA,6,2,6-2,TOR,9,true,39,38,77,160,156,316,16,10,26,3,3:23
663157,2022-05-17,2022,CHN,PIT,7,0,7-0,CHN,9,true,35,31,66,113,128,241,11,7,18,2,2:38
661765,2022-05-17,2022,TOR,SEA,3,0,3-0,TOR,9,true,34,32,66,117,123,240,11,8,19,1,2:20
662053,2022-05-17,2022,TBA,DET,8,1,8-1,TBA,9,true,37,33,70,122,126,248,13,7,20,2,2:38
661625,2022-05-17,2022,PHI,SDN,0,3,3-0,SDN,9,false,32,37,69,142,127,269,5,10,15,1,2:53
662697,2022-05-17,2022,LAN,ARI,12,3,12-3,LAN,9,true,41,36,77,118,143,261,18,11,29,0,2:45
662727,2022-05-17,2022,KCA,CHA,2,1,2-1,KCA,9,true,33,32,65,125,146,271,10,7,17,0,2:35
662507,2022-05-17,2022,NYN,SLN,3,1,3-1,NYN,9,true,34,36,70,152,136,288,9,9,18,1,2:54
661401,2022-05-17,2022,MIA,WAS,5,1,5-1,MIA,9,true,36,36,72,147,146,293,12,11,23,6,3:28
662370,2022-05-17,2022,OAK,MIN,5,2,5-2,OAK,9,true,39,37,76,156,148,304,16,10,26,3,3:20
661342,2022-05-17,2022,BAL,NYA,4,5,5-4,NYA,9,false,37,43,80,145,138,283,10,17,27,2,3:06
661196,2022-05-17,2022,MIL,ATL,0,3,3-0,ATL,9,false,37,38,75,171,136,307,11,11,22,2,3:14
662780,2022-05-17,2022,KCA,CHA,0,3,3-0,CHA,9,false,39,37,76,144,158,302,13,12,25,1,3:10
663271,2022-05-17,2022,BOS,HOU,4,13,13-4,HOU,9,false,44,45,89,131,166,297,16,17,33,1,3:12
663032,2022-05-17,2022,CLE,CIN,4,5,5-4,CIN,10,false,39,42,81,168,147,315,9,17,26,1,3:22
662566,2022-05-17,2022,NYN,SLN,3,4,4-3,SLN,9,false,39,43,82,155,176,331,11,17,28,3,3:42
662566,2022-05-17,2022,NYN,SLN,3,4,4-3,SLN,9,false,39,43,82,155,176,331,11,17,28,3,3:42
661126,2022-05-17,2022,TEX,ANA,10,5,10-5,TEX,9,true,39,42,81,179,168,347,17,16,33,5,3:58
663004,2022-05-17,2022,COL,SFN,7,10,10-7,SFN,9,false,40,49,89,200,148,348,15,21,36,1,3:40
662628,2022-05-17,2022,LAN,ARI,7,6,7-6,LAN,9,true,34,39,73,182,139,321,11,12,23,4,3:10
663270,2022-05-18,2022,BOS,HOU,5,1,5-1,BOS,9,true,33,29,62,112,128,240,8,2,10,0,2:38
661624,2022-05-18,2022,PHI,SDN,3,0,3-0,PHI,9,true,32,30,62,116,140,256,8,4,12,1,2:44
661344,2022-05-18,2022,BAL,NYA,2,3,3-2,NYA,9,false,33,34,67,139,120,259,7,7,14,1,2:34
663003,2022-05-18,2022,COL,SFN,5,3,5-3,COL,9,true,34,38,72,147,117,264,10,11,21,2,2:42
662054,2022-05-18,2022,TBA,DET,6,1,6-1,TBA,9,true,35,32,67,142,145,287,14,6,20,1,2:55
661767,2022-05-18,2022,TOR,SEA,1,5,5-1,SEA,9,false,35,38,73,143,134,277,11,12,23,1,2:47
662744,2022-05-18,2022,LAN,ARI,5,3,5-3,LAN,9,true,33,38,71,158,132,290,9,12,21,2,3:01
661125,2022-05-18,2022,TEX,ANA,6,5,6-5,TEX,10,false,43,41,84,141,162,303,17,11,28,1,3:23
663156,2022-05-18,2022,CHN,PIT,2,3,3-2,PIT,9,false,36,37,73,159,149,308,10,11,21,2,3:02
662726,2022-05-18,2022,KCA,CHA,6,2,6-2,KCA,9,true,37,38,75,154,141,295,14,11,25,1,3:11
662554,2022-05-18,2022,NYN,SLN,11,4,11-4,NYN,9,true,42,38,80,146,164,310,19,12,31,2,3:29
661400,2022-05-18,2022,MIA,WAS,4,5,5-4,WAS,10,false,41,44,85,177,153,330,11,16,27,1,3:56
662377,2022-05-18,2022,OAK,MIN,4,14,14-4,MIN,9,false,40,50,90,187,139,326,13,25,38,1,3:25
661202,2022-05-18,2022,MIL,ATL,7,6,7-6,MIL,11,false,44,45,89,170,172,342,16,13,29,1,4:03
662778,2022-05-19,2022,HOU,TEX,5,1,5-1,HOU,9,true,38,35,73,125,147,272,17,8,25,1,3:10
663043,2022-05-19,2022,CLE,CIN,2,4,4-2,CIN,9,false,34,33,67,133,149,282,8,9,17,3,2:48
663193,2022-05-19,2022,CHN,ARI,1,3,3-1,ARI,9,false,37,34,71,133,151,284,9,7,16,3,3:10
661623,2022-05-19,2022,PHI,SDN,0,2,2-0,SDN,9,false,35,38,73,154,156,310,9,11,20,3,3:31
662520,2022-05-19,2022,NYN,SLN,7,6,7-6,NYN,10,false,40,44,84,151,152,303,14,16,30,2,3:41
663269,2022-05-19,2022,BOS,SEA,12,6,12-6,BOS,9,true,44,41,85,168,158,326,21,14,35,4,3:38
661347,2022-05-19,2022,BAL,NYA,9,6,9-6,BAL,9,false,40,40,80,167,166,333,14,16,30,5,4:01
662715,2022-05-19,2022,KCA,CHA,4,7,7-4,CHA,9,false,38,45,83,182,152,334,12,20,32,2,3:47
663043,2022-05-19,2022,CLE,CIN,2,4,4-2,CIN,9,false,34,33,67,133,149,282,8,9,17,3,2:48
662764,2022-05-20,2022,HOU,TEX,0,3,3-0,TEX,9,false,32,34,66,136,108,244,9,8,17,2,2:57
663135,2022-05-20,2022,CLE,DET,6,1,6-1,CLE,9,true,32,31,63,128,115,243,10,4,14,2,2:38
661195,2022-05-20,2022,MIL,WAS,7,0,7-0,MIL,9,true,37,33,70,109,144,253,15,7,22,2,2:46
661766,2022-05-20,2022,TOR,CIN,2,1,2-1,TOR,9,true,33,35,68,137,113,250,10,9,19,1,2:42
663268,2022-05-20,2022,BOS,SEA,7,3,7-3,BOS,9,true,34,36,70,151,120,271,10,9,19,2,2:54
663449,2022-05-20,2022,ANA,OAK,2,4,4-2,OAK,9,false,36,38,74,152,156,308,9,11,20,3,3:24
662506,2022-05-20,2022,PIT,SLN,3,5,5-3,SLN,9,false,36,40,76,170,134,304,10,13,23,3,3:38
663143,2022-05-20,2022,CHN,ARI,6,10,10-6,ARI,9,false,40,42,82,151,150,301,13,16,29,2,3:06
661339,2022-05-20,2022,MIA,ATL,3,5,5-3,ATL,9,false,39,41,80,178,149,327,13,14,27,1,3:32
661632,2022-05-20,2022,PHI,LAN,1,4,4-1,LAN,9,false,35,41,76,194,156,350,8,16,24,2,3:44
662714,2022-05-20,2022,KCA,MIN,4,6,6-4,MIN,9,false,38,41,79,194,145,339,13,13,26,4,3:22
662078,2022-05-20,2022,SFN,SDN,7,8,8-7,SDN,10,false,45,42,87,156,170,326,15,13,28,2,3:23
661348,2022-05-20,2022,BAL,TBA,8,6,8-6,BAL,13,false,53,51,104,177,165,342,17,14,31,7,4:22
661793,2022-05-21,2022,TOR,CIN,3,1,3-1,TOR,9,true,33,32,65,99,106,205,10,7,17,0,2:19
662763,2022-05-21,2022,HOU,TEX,2,1,2-1,HOU,9,true,31,36,67,138,117,255,8,10,18,0,2:52
661291,2022-05-21,2022,BAL,TBA,1,6,6-1,TBA,9,false,36,36,72,142,132,274,10,11,21,2,2:53
663234,2022-05-21,2022,BOS,SEA,6,5,6-5,BOS,9,true,37,38,75,145,123,268,14,12,26,2,2:59
663448,2022-05-21,2022,ANA,OAK,5,3,5-3,ANA,9,true,34,37,71,135,136,271,11,11,22,5,3:12
663002,2022-05-21,2022,COL,NYN,1,5,5-1,NYN,9,false,37,42,79,145,137,282,10,15,25,1,2:55
662077,2022-05-21,2022,SFN,SDN,1,2,2-1,SDN,9,false,35,40,75,148,130,278,9,13,22,1,3:05
662713,2022-05-21,2022,KCA,MIN,2,9,9-2,MIN,9,false,37,41,78,140,136,276,10,15,25,2,2:54
663002,2022-05-21,2022,COL,NYN,1,5,5-1,NYN,9,false,37,42,79,145,137,282,10,15,25,1,2:55
663001,2022-05-21,2022,COL,NYN,11,3,11-3,COL,9,true,40,36,76,137,144,281,16,10,26,2,2:58
661399,2022-05-21,2022,MIA,ATL,3,4,4-3,ATL,9,false,39,38,77,150,167,317,13,14,27,2,3:28
661280,2022-05-21,2022,MIL,WAS,5,1,5-1,MIL,9,true,39,36,75,161,135,296,15,11,26,1,3:13
661289,2022-05-21,2022,NYA,CHA,7,5,7-5,NYA,9,true,37,41,78,182,162,344,15,13,28,1,3:40
662478,2022-05-21,2022,PIT,SLN,4,5,5-4,SLN,9,false,37,40,77,162,155,317,11,12,23,3,3:19
663194,2022-05-21,2022,CHN,ARI,6,7,7-6,ARI,10,false,39,44,83,188,148,336,10,16,26,4,3:42 (1:35 delay)
661631,2022-05-21,2022,PHI,LAN,4,7,7-4,LAN,9,false,35,43,78,177,150,327,9,18,27,8,3:57
663447,2022-05-22,2022,ANA,OAK,4,1,4-1,ANA,9,true,38,32,70,113,129,242,14,5,19,1,2:49
661290,2022-05-22,2022,NYA,CHA,0,5,5-0,CHA,9,false,32,41,73,136,120,256,5,15,20,1,2:51
663150,2022-05-22,2022,CHN,ARI,5,4,5-4,CHN,9,true,37,36,73,130,144,274,14,10,24,1,2:43
661290,2022-05-22,2022,NYA,CHA,0,5,5-0,CHA,9,false,32,41,73,136,120,256,5,15,20,1,2:51
662857,2022-05-22,2022,HOU,TEX,5,2,5-2,HOU,9,true,36,37,73,133,146,279,13,11,24,3,3:10
663120,2022-05-22,2022,CLE,DET,2,4,4-2,DET,9,false,34,35,69,130,134,264,11,9,20,2,2:46 (:20 delay)
661763,2022-05-22,2022,TOR,CIN,2,3,3-2,CIN,9,false,36,37,73,161,133,294,8,11,19,5,3:17
661288,2022-05-22,2022,NYA,CHA,1,3,3-1,CHA,9,false,36,37,73,138,146,284,12,10,22,2,3:09
661398,2022-05-22,2022,MIA,ATL,4,3,4-3,MIA,9,true,37,35,72,115,136,251,13,8,21,1,2:42
662982,2022-05-22,2022,COL,NYN,0,2,2-0,NYN,9,false,36,32,68,120,129,249,10,7,17,1,2:34
663277,2022-05-22,2022,BOS,SEA,8,4,8-4,BOS,10,false,41,39,80,154,150,304,15,10,25,2,3:18
662076,2022-05-22,2022,SFN,SDN,1,10,10-1,SDN,9,false,33,48,81,165,127,292,7,21,28,1,2:57
661611,2022-05-22,2022,PHI,LAN,4,3,4-3,PHI,10,false,38,42,80,158,152,310,13,13,26,1,3:29
662479,2022-05-22,2022,PIT,SLN,4,18,18-4,SLN,9,false,39,52,91,170,168,338,12,24,36,2,3:19 (:08 delay)
662712,2022-05-22,2022,KCA,MIN,6,7,7-6,MIN,9,false,39,44,83,174,178,352,11,19,30,4,3:37
661248,2022-05-22,2022,MIL,WAS,2,8,8-2,WAS,9,false,35,41,76,162,142,304,11,15,26,2,3:03
661279,2022-05-22,2022,BAL,TBA,7,6,7-6,BAL,11,false,52,49,101,189,217,406,18,16,34,3,4:31 (:51 delay)
661287,2022-05-23,2022,NYA,BAL,4,6,6-4,BAL,9,false,36,37,73,125,149,274,10,10,20,1,2:50
662524,2022-05-23,2022,WAS,LAN,1,10,10-1,LAN,9,false,33,45,78,174,112,286,7,18,25,1,2:52
661999,2022-05-23,2022,SLN,TOR,7,3,7-3,SLN,10,false,39,41,80,150,152,302,15,12,27,3,3:21
663073,2022-05-23,2022,CIN,CHN,4,7,7-4,CHN,9,false,37,39,76,154,156,310,10,13,23,3,3:16
663340,2022-05-23,2022,ARI,KCA,9,5,9-5,ARI,9,true,39,45,84,181,156,337,15,18,33,7,3:36
661730,2022-05-23,2022,MIN,DET,5,4,5-4,MIN,9,false,35,40,75,153,132,285,11,13,24,1,2:55
662075,2022-05-23,2022,SFN,NYN,3,13,13-3,NYN,9,false,35,45,80,142,143,285,9,19,28,1,2:51
661544,2022-05-23,2022,ATL,PHI,3,7,7-3,PHI,9,false,37,44,81,187,153,340,12,18,30,4,3:37
662257,2022-05-23,2022,SDN,MIL,3,2,3-2,SDN,10,false,43,41,84,174,182,356,17,13,30,0,3:54
662858,2022-05-23,2022,HOU,CLE,1,6,6-1,CLE,9,false,32,41,73,154,128,282,6,13,19,2,3:02
662455,2022-05-23,2022,PIT,COL,2,1,2-1,PIT,9,true,34,37,71,127,153,280,13,11,24,3,3:05
662135,2022-05-23,2022,SEA,OAK,7,6,7-6,SEA,9,true,37,40,77,173,156,329,14,14,28,4,3:24
663381,2022-05-24,2022,ANA,TEX,5,3,5-3,ANA,9,true,35,33,68,119,110,229,14,7,21,2,2:30
661699,2022-05-24,2022,MIN,DET,2,0,2-0,MIN,9,true,34,33,67,121,163,284,12,7,19,0,2:53
661978,2022-05-24,2022,TBA,MIA,4,0,4-0,TBA,9,true,34,32,66,150,106,256,11,8,19,0,2:26
662134,2022-05-24,2022,SEA,OAK,5,7,7-5,OAK,9,false,40,41,81,143,144,287,14,15,29,3,3:25
662229,2022-05-24,2022,SDN,MIL,1,4,4-1,MIL,9,false,35,34,69,149,149,298,10,7,17,1,3:14
662536,2022-05-24,2022,WAS,LAN,4,9,9-4,LAN,9,false,40,44,84,185,146,331,14,17,31,1,3:19
662454,2022-05-24,2022,PIT,COL,1,2,2-1,COL,10,false,39,39,78,150,158,308,9,9,18,2,3:21
661543,2022-05-24,2022,ATL,PHI,6,5,6-5,ATL,9,false,38,41,79,162,176,338,16,15,31,1,3:58
662846,2022-05-24,2022,HOU,CLE,7,3,7-3,HOU,9,true,35,35,70,134,126,260,11,8,19,1,2:45
661998,2022-05-24,2022,SLN,TOR,1,8,8-1,TOR,9,false,37,47,84,182,166,348,9,20,29,2,3:30
661285,2022-05-24,2022,NYA,BAL,7,6,7-6,NYA,11,false,45,41,86,153,163,316,17,8,25,4,3:36
661488,2022-05-24,2022,CHA,BOS,3,16,16-3,BOS,9,false,37,51,88,204,152,356,10,24,34,2,3:41
663339,2022-05-24,2022,ARI,KCA,8,6,8-6,ARI,9,true,38,37,75,150,154,304,17,12,29,2,3:09
662074,2022-05-24,2022,SFN,NYN,13,12,13-12,SFN,9,false,50,47,97,168,193,361,25,20,45,4,3:50
663103,2022-05-24,2022,CIN,CHN,4,11,11-4,CHN,9,false,38,48,86,168,156,324,11,20,31,1,3:12
661487,2022-05-25,2022,CHA,BOS,3,1,3-1,CHA,9,true,32,40,72,155,122,277,8,14,22,2,2:58 (:30 delay)
662845,2022-05-25,2022,HOU,CLE,2,1,2-1,HOU,9,true,33,34,67,152,122,274,11,7,18,2,3:00
662052,2022-05-25,2022,TBA,MIA,5,4,5-4,TBA,9,true,33,38,71,159,129,288,10,13,23,0,3:05
662527,2022-05-25,2022,WAS,LAN,1,0,1-0,WAS,9,true,30,36,66,149,113,262,9,11,20,0,2:53
661772,2022-05-25,2022,MIN,DET,2,4,4-2,DET,10,false,41,43,84,170,175,345,10,14,24,4,3:45 (:56 delay)
663082,2022-05-25,2022,CIN,CHN,4,3,4-3,CIN,9,true,33,37,70,175,123,298,9,10,19,0,3:04
662093,2022-05-25,2022,SFN,NYN,9,3,9-3,SFN,9,true,35,36,71,144,135,279,13,9,22,2,2:44
662133,2022-05-25,2022,SEA,OAK,2,4,4-2,OAK,9,false,35,37,72,141,143,284,12,11,23,1,3:10
662228,2022-05-25,2022,SDN,MIL,1,2,2-1,MIL,9,false,36,32,68,146,141,287,8,8,16,2,3:05
661286,2022-05-25,2022,NYA,BAL,2,0,2-0,NYA,9,true,30,36,66,150,124,274,6,8,14,1,3:07
662453,2022-05-25,2022,PIT,COL,10,5,10-5,PIT,9,true,39,40,79,169,170,339,15,16,31,2,3:20
663446,2022-05-25,2022,ANA,TEX,2,7,7-2,TEX,9,false,34,39,73,127,134,261,8,12,20,1,2:49
661542,2022-05-25,2022,ATL,PHI,8,4,8-4,ATL,9,true,41,41,82,164,185,349,20,15,35,2,3:30
661574,2022-05-26,2022,ATL,PHI,1,4,4-1,PHI,9,false,34,35,69,122,124,246,7,9,16,2,2:43
662515,2022-05-26,2022,WAS,COL,7,3,7-3,WAS,9,true,38,36,74,113,133,246,14,10,24,1,2:40
662051,2022-05-26,2022,TBA,NYA,2,7,7-2,NYA,9,false,34,39,73,150,124,274,7,12,19,3,2:49
661771,2022-05-26,2022,MIN,KCA,2,3,3-2,KCA,9,false,41,35,76,127,164,291,14,9,23,2,3:05
663081,2022-05-26,2022,CIN,CHN,20,5,20-5,CIN,9,true,49,38,87,136,167,303,28,11,39,1,3:10 (:59 delay)
662842,2022-05-26,2022,DET,CLE,4,3,4-3,DET,9,false,39,35,74,135,158,293,14,9,23,1,2:52
661997,2022-05-26,2022,SLN,MIL,3,4,4-3,MIL,9,false,41,40,81,155,169,324,14,13,27,0,3:21
663445,2022-05-26,2022,ANA,TOR,3,6,6-3,TOR,9,false,36,36,72,146,129,275,11,10,21,0,2:56
661486,2022-05-26,2022,CHA,BOS,7,16,16-7,BOS,9,false,42,51,93,218,178,396,15,24,39,3,4:02
662376,2022-05-26,2022,OAK,TEX,1,4,4-1,TEX,9,false,34,36,70,131,123,254,8,9,17,1,2:44
663338,2022-05-26,2022,ARI,LAN,1,14,14-1,LAN,9,false,36,54,90,198,143,341,10,28,38,1,3:21
662132,2022-05-27,2022,SEA,HOU,6,1,6-1,SEA,9,true,37,37,74,144,119,263,13,11,24,0,2:45
661960,2022-05-27,2022,TBA,NYA,0,2,2-0,NYA,9,false,28,34,62,124,108,232,2,7,9,1,2:23
663080,2022-05-27,2022,CIN,SFN,5,1,5-1,CIN,9,true,38,35,73,134,158,292,14,10,24,3,3:16 (2:08 delay)
663444,2022-05-27,2022,ANA,TOR,3,4,4-3,TOR,9,false,35,37,72,126,139,265,7,13,20,3,3:05
661992,2022-05-27,2022,SLN,MIL,4,2,4-2,SLN,9,true,31,37,68,162,114,276,6,12,18,2,2:54
663347,2022-05-27,2022,ARI,LAN,4,6,6-4,LAN,9,false,41,37,78,144,167,311,16,11,27,1,3:11
662369,2022-05-27,2022,OAK,TEX,5,8,8-5,TEX,9,false,34,38,72,144,125,269,8,14,22,3,2:54
661777,2022-05-27,2022,MIN,KCA,10,7,10-7,MIN,9,true,47,45,92,169,160,329,23,21,44,6,3:40
662543,2022-05-27,2022,NYN,PHI,8,6,8-6,NYN,9,true,38,40,78,146,167,313,16,13,29,3,3:41
663276,2022-05-27,2022,BOS,BAL,8,12,12-8,BAL,9,false,46,45,91,158,168,326,20,19,39,6,3:38
661539,2022-05-27,2022,ATL,MIA,6,4,6-4,ATL,9,true,33,35,68,144,145,289,9,8,17,3,3:02
662281,2022-05-27,2022,SDN,PIT,4,3,4-3,SDN,9,true,34,34,68,125,149,274,12,7,19,1,2:56
663257,2022-05-28,2022,BOS,BAL,5,3,5-3,BOS,9,true,39,33,72,108,170,278,16,8,24,2,2:58
661518,2022-05-28,2022,CHA,CHN,1,5,5-1,CHN,9,false,35,39,74,130,139,269,10,16,26,2,3:03
661991,2022-05-28,2022,SLN,MIL,8,3,8-3,SLN,9,true,37,37,74,152,119,271,13,10,23,0,2:45
663309,2022-05-28,2022,BOS,BAL,2,4,4-2,BAL,9,false,37,38,75,137,137,274,10,11,21,3,3:09
663330,2022-05-28,2022,ARI,LAN,2,3,3-2,LAN,9,false,33,36,69,139,137,276,6,13,19,2,3:12
662852,2022-05-28,2022,DET,CLE,1,8,8-1,CLE,9,false,36,42,78,158,114,272,11,15,26,1,2:50
661933,2022-05-28,2022,TBA,NYA,3,1,3-1,TBA,9,true,33,29,62,125,132,257,10,4,14,1,2:47
662556,2022-05-28,2022,NYN,PHI,8,2,8-2,NYN,9,true,36,38,74,138,140,278,14,11,25,2,3:09
663400,2022-05-28,2022,ANA,TOR,5,6,6-5,TOR,9,false,45,41,86,163,161,324,20,16,36,4,3:45
663118,2022-05-28,2022,CIN,SFN,3,2,3-2,CIN,9,true,30,40,70,157,132,289,6,14,20,2,3:00
661774,2022-05-28,2022,MIN,KCA,3,7,7-3,KCA,9,false,41,42,83,163,150,313,14,14,28,3,3:12
661537,2022-05-28,2022,ATL,MIA,1,4,4-1,MIA,9,false,31,40,71,155,131,286,7,14,21,0,2:48
662280,2022-05-28,2022,SDN,PIT,2,4,4-2,PIT,9,false,45,40,85,155,189,344,18,13,31,1,3:43
662513,2022-05-28,2022,WAS,COL,2,3,3-2,COL,9,false,36,41,77,133,134,267,9,14,23,1,2:53
662131,2022-05-28,2022,SEA,HOU,6,0,6-0,SEA,9,true,43,34,77,136,152,288,18,7,25,1,3:01
662514,2022-05-28,2022,WAS,COL,13,7,13-7,WAS,9,true,45,41,86,168,186,354,22,14,36,3,3:37
662375,2022-05-28,2022,OAK,TEX,4,11,11-4,TEX,9,false,39,49,88,180,139,319,12,24,36,2,3:15
662514,2022-05-28,2022,WAS,COL,13,7,13-7,WAS,9,true,45,41,86,168,186,354,22,14,36,3,3:37
662130,2022-05-29,2022,SEA,HOU,1,2,2-1,HOU,9,false,35,35,70,125,128,253,9,10,19,2,3:00
663328,2022-05-29,2022,ARI,LAN,1,3,3-1,LAN,9,false,37,32,69,123,131,254,11,6,17,1,2:47
662279,2022-05-29,2022,SDN,PIT,4,2,4-2,SDN,10,false,35,37,72,124,132,256,10,9,19,0,2:50
661910,2022-05-29,2022,TBA,NYA,4,2,4-2,TBA,9,true,31,36,67,133,131,264,7,9,16,1,2:35
661990,2022-05-29,2022,SLN,MIL,0,8,8-0,MIL,9,false,32,40,72,167,122,289,5,15,20,2,2:48
661731,2022-05-29,2022,MIN,KCA,7,3,7-3,MIN,9,true,38,35,73,134,149,283,15,8,23,1,3:05
663072,2022-05-29,2022,CIN,SFN,4,6,6-4,SFN,9,false,36,39,75,163,127,290,12,12,24,3,3:10
661517,2022-05-29,2022,ATL,MIA,6,3,6-3,ATL,9,true,35,38,73,153,151,304,11,12,23,0,3:09
662840,2022-05-29,2022,DET,CLE,2,1,2-1,DET,9,true,29,35,64,146,91,237,5,8,13,2,2:37
662512,2022-05-29,2022,WAS,COL,6,5,6-5,WAS,9,true,37,40,77,162,138,300,13,14,27,2,3:13
663299,2022-05-29,2022,BOS,BAL,12,2,12-2,BOS,9,true,43,36,79,139,191,330,20,12,32,1,3:27
662374,2022-05-29,2022,OAK,TEX,6,5,6-5,OAK,9,false,48,39,87,132,177,309,22,11,33,4,3:38
662555,2022-05-29,2022,NYN,PHI,5,4,5-4,NYN,10,false,41,40,81,171,144,315,14,12,26,3,3:51
661461,2022-05-29,2022,CHA,CHN,5,4,5-4,CHA,12,false,48,46,94,177,162,339,13,11,24,0,3:54
663414,2022-05-29,2022,ANA,TOR,10,11,11-10,TOR,9,false,44,48,92,199,190,389,17,22,39,7,4:13
663147,2022-05-30,2022,CHN,MIL,1,3,3-1,MIL,9,false,33,37,70,157,131,288,8,9,17,1,2:52
663327,2022-05-30,2022,ARI,ATL,6,2,6-2,ARI,9,true,34,37,71,133,132,265,10,10,20,2,2:53
662373,2022-05-30,2022,OAK,HOU,1,5,5-1,HOU,9,false,30,38,68,148,114,262,5,10,15,2,2:58
661613,2022-05-30,2022,PHI,SFN,4,5,5-4,SFN,10,false,34,39,73,159,125,284,5,10,15,1,3:13
663147,2022-05-30,2022,CHN,MIL,1,3,3-1,MIL,9,false,33,37,70,157,131,288,8,9,17,1,2:52
663109,2022-05-30,2022,CLE,KCA,7,3,7-3,CLE,9,true,38,38,76,135,132,267,14,13,27,2,2:49
662854,2022-05-30,2022,DET,MIN,7,5,7-5,DET,9,true,40,38,78,142,145,287,16,12,28,2,3:04
662743,2022-05-30,2022,LAN,PIT,5,6,6-5,PIT,9,false,40,39,79,149,171,320,13,12,25,1,3:18
662992,2022-05-30,2022,COL,MIA,7,1,7-1,COL,9,true,37,33,70,118,156,274,15,6,21,1,2:56
663149,2022-05-30,2022,CHN,MIL,6,7,7-6,MIL,9,false,44,36,80,147,172,319,17,10,27,1,3:17
662545,2022-05-30,2022,NYN,WAS,13,5,13-5,NYN,9,true,43,40,83,143,180,323,20,16,36,3,3:29
661989,2022-05-30,2022,SLN,SDN,6,3,6-3,SLN,9,true,38,39,77,154,140,294,16,13,29,5,3:33
661900,2022-05-30,2022,TEX,TBA,9,5,9-5,TEX,9,true,40,41,81,152,156,308,17,15,32,2,3:21
663298,2022-05-30,2022,BOS,BAL,0,10,10-0,BAL,9,false,32,42,74,162,123,285,5,17,22,1,3:05
661884,2022-05-31,2022,TEX,TBA,3,0,3-0,TEX,9,true,33,30,63,106,114,220,10,3,13,1,2:21
662836,2022-05-31,2022,DET,MIN,4,0,4-0,DET,9,true,34,32,66,112,140,252,10,5,15,0,2:29
662735,2022-05-31,2022,LAN,PIT,3,5,5-3,PIT,9,false,38,40,78,136,159,295,12,14,26,2,3:09
661075,2022-05-31,2022,BAL,SEA,0,10,10-0,SEA,9,false,33,45,78,157,129,286,7,18,25,2,2:51
663034,2022-05-31,2022,CLE,KCA,8,3,8-3,CLE,9,true,41,37,78,145,134,279,19,11,30,2,2:50
662367,2022-05-31,2022,OAK,HOU,1,3,3-1,HOU,9,false,39,36,75,147,154,301,13,11,24,3,3:23
662806,2022-05-31,2022,DET,MIN,2,8,8-2,MIN,9,false,35,40,75,161,134,295,8,11,19,1,2:46
661331,2022-05-31,2022,NYA,ANA,9,1,9-1,NYA,9,true,38,36,74,129,149,278,16,10,26,2,2:54
663329,2022-05-31,2022,ARI,ATL,8,7,8-7,ARI,10,false,42,42,84,139,169,308,19,17,36,4,3:35
662544,2022-05-31,2022,NYN,WAS,10,0,10-0,NYN,9,true,44,35,79,139,182,321,21,10,31,2,3:31
661977,2022-05-31,2022,SLN,SDN,3,2,3-2,SLN,10,false,40,37,77,175,158,333,13,8,21,0,3:37
663154,2022-05-31,2022,CHN,MIL,8,7,8-7,CHN,9,true,41,40,81,177,174,351,18,13,31,2,3:33
661797,2022-05-31,2022,TOR,CHA,6,5,6-5,TOR,9,true,39,41,80,162,157,319,15,16,31,2,3:24
663297,2022-05-31,2022,BOS,CIN,1,2,2-1,CIN,9,false,33,37,70,148,145,293,7,10,17,4,3:04
661618,2022-05-31,2022,PHI,SFN,4,7,7-4,SFN,11,false,49,49,98,208,183,391,19,18,37,6,4:52
662991,2022-06-01,2022,COL,MIA,13,12,13-12,COL,10,false,49,51,100,184,203,387,24,22,46,5,4:14
662833,2022-06-01,2022,DET,MIN,5,0,5-0,DET,9,true,32,30,62,124,106,230,9,3,12,0,2:13
663296,2022-06-01,2022,BOS,CIN,7,1,7-1,BOS,9,true,36,31,67,106,143,249,13,7,20,2,2:40
662457,2022-06-01,2022,NYN,WAS,5,0,5-0,NYN,9,true,37,38,75,150,125,275,14,12,26,3,3:02
663031,2022-06-01,2022,CLE,KCA,4,0,4-0,CLE,9,true,38,36,74,142,144,286,13,9,22,0,2:48
661982,2022-06-01,2022,SLN,SDN,5,2,5-2,SLN,9,true,32,36,68,155,101,256,10,9,19,2,2:43
663326,2022-06-01,2022,ARI,ATL,0,6,6-0,ATL,9,false,34,43,77,177,129,306,8,16,24,1,2:59
661343,2022-06-01,2022,BAL,SEA,9,2,9-2,BAL,9,true,37,36,73,129,160,289,16,11,27,2,3:07
661612,2022-06-01,2022,PHI,SFN,6,5,6-5,PHI,9,true,36,33,69,128,148,276,11,6,17,1,3:02
662366,2022-06-01,2022,OAK,HOU,4,5,5-4,HOU,9,false,33,42,75,154,123,277,7,17,24,4,3:07
663184,2022-06-01,2022,CHN,MIL,4,3,4-3,CHN,10,false,37,38,75,156,134,290,12,10,22,0,3:03
662981,2022-06-01,2022,COL,MIA,1,14,14-1,MIA,9,false,36,50,86,167,142,309,9,24,33,1,3:00
661764,2022-06-01,2022,TOR,CHA,7,3,7-3,TOR,9,true,41,36,77,134,185,319,18,10,28,1,3:14
662721,2022-06-01,2022,LAN,PIT,4,8,8-4,PIT,9,false,38,41,79,154,161,315,15,15,30,3,3:28
661963,2022-06-01,2022,TEX,TBA,3,4,4-3,TBA,11,false,48,42,90,153,208,361,16,10,26,2,4:01
662991,2022-06-01,2022,COL,MIA,13,12,13-12,COL,10,false,49,51,100,184,203,387,24,22,46,5,4:14
662832,2022-06-02,2022,DET,MIN,3,2,3-2,DET,9,true,29,37,66,150,100,250,7,10,17,1,2:38
662693,2022-06-02,2022,LAN,NYN,2,0,2-0,LAN,9,true,34,31,65,127,138,265,11,4,15,1,2:54
661397,2022-06-02,2022,MIA,SFN,3,0,3-0,MIA,9,true,33,32,65,140,128,268,10,6,16,1,2:34
663091,2022-06-02,2022,CIN,WAS,8,1,8-1,CIN,9,true,37,33,70,118,139,257,15,6,21,2,2:40
661762,2022-06-02,2022,TOR,CHA,8,3,8-3,TOR,9,true,40,35,75,128,143,271,17,9,26,3,3:05
661329,2022-06-02,2022,NYA,ANA,2,1,2-1,NYA,9,true,36,32,68,130,162,292,13,5,18,3,3:08
661330,2022-06-02,2022,NYA,ANA,6,1,6-1,NYA,9,true,38,38,76,147,145,292,16,12,28,2,3:07 (1:28 delay)
661330,2022-06-02,2022,NYA,ANA,6,1,6-1,NYA,9,true,38,38,76,147,145,292,16,12,28,2,3:07 (1:28 delay)
661934,2022-06-02,2022,TEX,TBA,1,3,3-1,TBA,9,false,34,41,75,168,119,287,8,16,24,2,3:04
663000,2022-06-02,2022,COL,ATL,6,13,13-6,ATL,9,false,40,47,87,157,159,316,16,20,36,0,2:58
663139,2022-06-02,2022,CHN,SLN,7,5,7-5,CHN,9,true,41,38,79,132,166,298,18,12,30,3,3:04
661340,2022-06-02,2022,MIL,SDN,5,4,5-4,MIL,9,false,37,41,78,168,162,330,14,15,29,1,3:20
661247,2022-06-02,2022,BAL,SEA,6,7,7-6,SEA,10,false,42,46,88,166,168,334,12,18,30,5,4:00
661913,2022-06-03,2022,TEX,SEA,3,4,4-3,SEA,9,false,37,34,71,120,157,277,9,7,16,0,2:51
662720,2022-06-03,2022,LAN,NYN,6,1,6-1,LAN,9,true,35,34,69,136,144,280,10,8,18,2,2:55
661642,2022-06-03,2022,PHI,ANA,10,0,10-0,PHI,9,true,38,33,71,117,143,260,14,6,20,2,2:41
661318,2022-06-03,2022,NYA,DET,13,0,13-0,NYA,9,true,41,30,71,126,139,265,21,3,24,1,2:39
661058,2022-06-03,2022,BAL,CLE,3,6,6-3,CLE,9,false,34,40,74,132,135,267,7,14,21,3,2:52
662692,2022-06-03,2022,KCA,HOU,3,10,10-3,HOU,9,false,35,42,77,140,136,276,8,18,26,2,2:48
661761,2022-06-03,2022,TOR,MIN,3,9,9-3,MIN,9,false,34,39,73,160,144,304,7,14,21,3,3:02
663119,2022-06-03,2022,CIN,WAS,5,8,8-5,WAS,9,false,38,42,80,155,140,295,11,14,25,3,3:09
661334,2022-06-03,2022,MIL,SDN,0,7,7-0,SDN,9,false,32,45,77,180,128,308,5,16,21,2,3:03
662365,2022-06-03,2022,OAK,BOS,2,7,7-2,BOS,9,false,36,43,79,157,150,307,10,20,30,5,3:15
661897,2022-06-03,2022,TBA,CHA,6,3,6-3,TBA,9,true,35,41,76,164,137,301,12,14,26,3,3:09
662980,2022-06-03,2022,COL,ATL,1,3,3-1,ATL,10,false,34,43,77,178,128,306,4,16,20,1,3:32
662452,2022-06-03,2022,PIT,ARI,6,8,8-6,ARI,9,false,41,44,85,160,149,309,16,16,32,2,3:15
661396,2022-06-03,2022,MIA,SFN,6,15,15-6,SFN,9,false,39,48,87,189,153,342,11,21,32,1,3:10
663153,2022-06-03,2022,CHN,SLN,5,14,14-5,SLN,9,false,40,44,84,164,181,345,15,18,33,0,3:14
661346,2022-06-04,2022,BAL,CLE,5,4,5-4,BAL,9,true,31,35,66,140,97,237,7,11,18,1,2:33
661936,2022-06-04,2022,TEX,SEA,3,2,3-2,TEX,9,true,30,36,66,154,97,251,6,10,16,0,2:30
662451,2022-06-04,2022,PIT,ARI,2,1,2-1,PIT,9,false,30,35,65,137,118,255,7,7,14,2,2:46
661395,2022-06-04,2022,MIA,SFN,5,4,5-4,MIA,9,false,33,34,67,147,137,284,9,7,16,1,2:54
661896,2022-06-04,2022,TBA,CHA,2,3,3-2,CHA,9,false,38,33,71,119,166,285,12,8,20,3,3:03
662689,2022-06-04,2022,KCA,HOU,6,0,6-0,KCA,9,true,35,37,72,151,130,281,11,10,21,1,3:10 (:51 delay)
661214,2022-06-04,2022,MIL,SDN,0,4,4-0,SDN,9,false,36,33,69,129,151,280,9,6,15,0,2:43
661749,2022-06-04,2022,TOR,MIN,12,3,12-3,TOR,9,true,47,35,82,120,172,292,23,9,32,1,3:01
661278,2022-06-04,2022,NYA,DET,3,0,3-0,NYA,9,true,31,28,59,111,129,240,7,2,9,1,2:28
663179,2022-06-04,2022,CHN,SLN,6,1,6-1,CHN,9,true,41,36,77,160,154,314,18,9,27,1,3:05
662687,2022-06-04,2022,LAN,NYN,4,9,9-4,NYN,9,false,38,41,79,154,182,336,11,15,26,5,3:33
663102,2022-06-04,2022,CIN,WAS,8,10,10-8,WAS,9,false,41,46,87,189,170,359,14,19,33,2,3:44
663152,2022-06-04,2022,CHN,SLN,4,7,7-4,SLN,10,false,45,45,90,191,172,363,18,17,35,3,4:11
662987,2022-06-04,2022,COL,ATL,2,6,6-2,ATL,11,false,41,45,86,148,176,324,9,11,20,1,3:34
662364,2022-06-04,2022,OAK,BOS,0,8,8-0,BOS,9,false,32,43,75,165,125,290,6,18,24,2,3:07
661615,2022-06-04,2022,PHI,ANA,7,2,7-2,PHI,9,true,37,36,73,136,143,279,14,10,24,3,3:05
662363,2022-06-05,2022,OAK,BOS,2,5,5-2,BOS,9,false,35,36,71,145,135,280,8,8,16,1,3:01
662450,2022-06-05,2022,PIT,ARI,3,0,3-0,PIT,9,true,35,34,69,146,137,283,12,7,19,0,2:56
663058,2022-06-05,2022,CIN,WAS,4,5,5-4,WAS,9,false,37,39,76,145,140,285,14,12,26,2,3:22
661151,2022-06-05,2022,BAL,CLE,2,3,3-2,CLE,9,false,35,36,71,131,154,285,8,9,17,4,2:58
661394,2022-06-05,2022,MIA,SFN,1,5,5-1,SFN,9,false,34,40,74,170,141,311,7,14,21,2,3:10
661895,2022-06-05,2022,TBA,CHA,5,6,6-5,CHA,9,false,36,44,80,170,141,311,11,19,30,2,3:18
661747,2022-06-05,2022,TOR,MIN,6,8,8-6,MIN,9,false,38,44,82,173,138,311,13,19,32,3,3:20
662990,2022-06-05,2022,COL,ATL,7,8,8-7,ATL,9,false,43,43,86,171,165,336,16,15,31,2,3:33
661277,2022-06-05,2022,NYA,DET,5,4,5-4,NYA,10,false,40,38,78,151,152,303,13,10,23,3,3:24
662688,2022-06-05,2022,KCA,HOU,4,7,7-4,HOU,9,false,40,45,85,171,155,326,14,19,33,4,3:30
661962,2022-06-05,2022,TEX,SEA,5,6,6-5,SEA,10,false,40,47,87,177,154,331,11,17,28,2,3:39
663138,2022-06-05,2022,CHN,SLN,3,5,5-3,SLN,11,false,45,46,91,166,160,326,15,15,30,0,3:44
662612,2022-06-05,2022,LAN,NYN,4,5,5-4,NYN,10,false,40,43,83,177,167,344,9,14,23,3,3:59
661633,2022-06-05,2022,PHI,ANA,9,7,9-7,PHI,9,false,45,38,83,160,183,343,17,12,29,5,3:57
661241,2022-06-05,2022,MIL,SDN,4,6,6-4,SDN,10,false,41,42,83,162,174,336,12,11,23,2,3:30
663065,2022-06-06,2022,CIN,ARI,7,0,7-0,CIN,7,false,35,21,56,87,140,227,16,1,17,0,2:13 (:59 delay)
663399,2022-06-06,2022,ANA,BOS,0,1,1-0,BOS,9,false,29,35,64,132,105,237,4,8,12,0,2:32
662613,2022-06-06,2022,KCA,TOR,0,8,8-0,TOR,9,false,30,43,73,168,110,278,3,16,19,2,2:50 (2:05 delay)
662762,2022-06-06,2022,HOU,SEA,4,7,7-4,SEA,9,false,40,42,82,181,154,335,15,14,29,4,3:46
662278,2022-06-06,2022,SDN,NYN,5,11,11-5,NYN,9,false,35,47,82,189,140,329,9,21,30,3,3:43
661516,2022-06-07,2022,ATL,OAK,3,2,3-2,ATL,9,true,33,31,64,113,120,233,10,5,15,1,2:19
661460,2022-06-07,2022,CHA,LAN,4,0,4-0,CHA,9,true,34,33,67,146,117,263,11,8,19,2,2:49
662761,2022-06-07,2022,HOU,SEA,4,1,4-1,HOU,9,true,35,37,72,144,139,283,12,11,23,2,3:19
662449,2022-06-07,2022,PIT,DET,3,5,5-3,DET,9,false,33,39,72,156,111,267,8,13,21,2,2:50 (2:05 delay)
663122,2022-06-07,2022,CLE,TEX,6,3,6-3,CLE,9,true,40,36,76,111,159,270,16,9,25,0,2:40 (1:19 delay)
661205,2022-06-07,2022,MIL,PHI,2,3,3-2,PHI,9,false,36,38,74,141,140,281,10,12,22,0,3:00
662678,2022-06-07,2022,KCA,TOR,0,7,7-0,TOR,9,false,35,41,76,157,137,294,10,18,28,2,3:09
662277,2022-06-07,2022,SDN,NYN,7,0,7-0,SDN,9,true,37,31,68,118,144,262,12,5,17,1,2:48
661894,2022-06-07,2022,TBA,SLN,4,2,4-2,TBA,10,false,35,42,77,154,138,292,6,13,19,0,3:13
661169,2022-06-07,2022,MIA,WAS,12,2,12-2,MIA,9,true,42,38,80,145,145,290,18,11,29,2,2:57
662092,2022-06-07,2022,SFN,COL,3,5,5-3,COL,9,false,37,38,75,176,148,324,10,10,20,1,3:13
663134,2022-06-07,2022,CLE,TEX,3,6,6-3,TEX,9,false,36,44,80,176,139,315,9,17,26,1,3:10
663134,2022-06-07,2022,CLE,TEX,3,6,6-3,TEX,9,false,36,44,80,176,139,315,9,17,26,1,3:10
663064,2022-06-07,2022,CIN,ARI,14,8,14-8,CIN,9,true,46,38,84,140,174,314,22,12,34,3,3:12 (1:03 delay)
663391,2022-06-07,2022,ANA,BOS,5,6,6-5,BOS,10,false,42,45,87,170,167,337,13,17,30,1,3:56
661170,2022-06-07,2022,BAL,CHN,9,3,9-3,BAL,9,true,35,41,76,172,123,295,13,14,27,1,2:53
661693,2022-06-07,2022,MIN,NYA,4,10,10-4,NYA,9,false,40,50,90,219,155,374,14,24,38,4,3:50
661459,2022-06-08,2022,CHA,LAN,1,4,4-1,LAN,9,false,33,34,67,133,125,258,6,7,13,0,2:36
661188,2022-06-08,2022,MIL,PHI,0,10,10-0,PHI,9,false,31,41,72,147,113,260,5,15,20,0,2:50
662094,2022-06-08,2022,SFN,COL,2,1,2-1,SFN,10,false,37,35,72,134,145,279,10,6,16,0,2:49
661150,2022-06-08,2022,MIA,WAS,2,1,2-1,MIA,10,false,40,37,77,119,177,296,12,7,19,1,3:29
663398,2022-06-08,2022,ANA,BOS,0,1,1-0,BOS,9,false,34,38,72,157,129,286,8,11,19,3,3:09
662223,2022-06-08,2022,SDN,NYN,13,2,13-2,SDN,9,true,44,34,78,123,169,292,20,8,28,1,2:58
662448,2022-06-08,2022,PIT,DET,1,3,3-1,DET,9,false,33,37,70,157,144,301,7,11,18,1,2:57
663055,2022-06-08,2022,CLE,TEX,4,0,4-0,CLE,9,true,35,31,66,100,119,219,12,6,18,1,2:07 (2:07 delay)
661681,2022-06-08,2022,MIN,NYA,8,1,8-1,MIN,9,true,37,33,70,126,157,283,14,9,23,2,3:00
662760,2022-06-08,2022,HOU,SEA,3,6,6-3,SEA,9,false,36,43,79,164,148,312,11,18,29,2,3:09
663050,2022-06-08,2022,CIN,ARI,0,7,7-0,ARI,9,false,35,44,79,189,134,323,9,18,27,2,3:18 (1:40 delay)
661892,2022-06-08,2022,TBA,SLN,11,3,11-3,TBA,9,true,47,35,82,130,173,303,22,9,31,3,3:11
662679,2022-06-08,2022,KCA,TOR,8,4,8-4,KCA,9,true,43,40,83,171,179,350,20,13,33,3,3:26
661515,2022-06-08,2022,ATL,OAK,13,2,13-2,ATL,9,true,40,35,75,122,153,275,16,10,26,2,2:47
661891,2022-06-09,2022,TBA,SLN,2,1,2-1,TBA,9,true,26,32,58,111,85,196,3,4,7,0,1:54
661514,2022-06-09,2022,ATL,PIT,3,1,3-1,ATL,9,true,32,33,65,134,109,243,9,8,17,0,2:26
661149,2022-06-09,2022,MIA,WAS,7,4,7-4,MIA,9,true,36,39,75,148,136,284,14,13,27,3,3:09
662091,2022-06-09,2022,SFN,COL,2,4,4-2,COL,9,false,35,39,74,145,143,288,9,12,21,1,2:56
663413,2022-06-09,2022,ANA,BOS,5,2,5-2,ANA,9,true,36,35,71,130,149,279,12,8,20,1,3:09
663015,2022-06-09,2022,CLE,OAK,8,4,8-4,CLE,9,true,40,38,78,147,151,298,18,13,31,5,3:23
663049,2022-06-09,2022,CIN,ARI,4,5,5-4,ARI,9,false,37,43,80,167,144,311,10,17,27,1,3:29
662677,2022-06-09,2022,KCA,BAL,7,5,7-5,KCA,9,true,38,43,81,178,143,321,14,16,30,4,3:17
661697,2022-06-09,2022,MIN,NYA,7,10,10-7,NYA,9,false,39,45,84,169,155,324,13,19,32,4,3:32
661194,2022-06-09,2022,MIL,PHI,3,8,8-3,PHI,9,false,42,43,85,211,189,400,15,16,31,1,4:01
661458,2022-06-09,2022,CHA,LAN,9,11,11-9,LAN,9,false,44,46,90,206,195,401,17,20,37,3,4:13
661513,2022-06-10,2022,ATL,PIT,4,2,4-2,ATL,9,true,36,36,72,147,121,268,14,9,23,4,3:04
662090,2022-06-10,2022,SFN,LAN,7,2,7-2,SFN,9,true,34,35,69,143,124,267,12,8,20,1,2:45
662676,2022-06-10,2022,KCA,BAL,8,1,8-1,KCA,9,true,37,33,70,143,128,271,13,6,19,2,2:55
661617,2022-06-10,2022,PHI,ARI,7,5,7-5,PHI,9,true,35,38,73,154,152,306,13,11,24,4,3:24
662831,2022-06-10,2022,DET,TOR,1,10,10-1,TOR,9,false,32,45,77,176,114,290,6,18,24,1,2:50 (:26 delay)
663390,2022-06-10,2022,ANA,NYN,3,7,7-3,NYN,9,false,37,40,77,141,151,292,12,17,29,4,3:21
662275,2022-06-10,2022,SDN,COL,9,0,9-0,SDN,9,true,44,33,77,139,175,314,22,7,29,1,3:04
662511,2022-06-10,2022,WAS,MIL,11,5,11-5,WAS,9,true,44,37,81,156,164,320,21,11,32,2,3:15
661983,2022-06-10,2022,SLN,CIN,2,0,2-0,SLN,9,true,33,35,68,144,127,271,9,9,18,1,2:47
662759,2022-06-10,2022,HOU,MIA,4,7,7-4,MIA,9,false,42,37,79,157,167,324,16,10,26,5,3:49
661485,2022-06-10,2022,CHA,TEX,8,3,8-3,CHA,9,true,37,34,71,145,136,281,15,7,22,2,2:59
663014,2022-06-10,2022,CLE,OAK,3,2,3-2,CLE,9,false,36,36,72,139,120,259,11,8,19,1,2:50
661678,2022-06-10,2022,MIN,TBA,9,4,9-4,MIN,9,true,41,35,76,149,137,286,16,9,25,2,2:58
661284,2022-06-10,2022,NYA,CHN,2,1,2-1,NYA,13,false,53,49,102,185,185,370,19,14,33,0,4:16
662129,2022-06-10,2022,SEA,BOS,3,4,4-3,BOS,9,false,42,39,81,179,186,365,15,13,28,3,3:48
661276,2022-06-11,2022,NYA,CHN,8,0,8-0,NYA,9,true,36,35,71,125,138,263,12,7,19,0,2:48
661160,2022-06-11,2022,ATL,PIT,10,4,10-4,ATL,9,true,37,35,72,146,120,266,13,9,22,2,2:42
662510,2022-06-11,2022,WAS,MIL,8,6,8-6,WAS,9,true,36,42,78,150,135,285,14,15,29,2,3:02
662674,2022-06-11,2022,KCA,BAL,4,6,6-4,BAL,9,false,38,38,76,143,133,276,12,13,25,2,3:03
662830,2022-06-11,2022,DET,TOR,3,1,3-1,DET,9,true,34,38,72,141,121,262,12,11,23,2,2:51
662756,2022-06-11,2022,HOU,MIA,1,5,5-1,MIA,9,false,37,38,75,142,138,280,10,11,21,1,3:12
662251,2022-06-11,2022,SDN,COL,2,1,2-1,SDN,10,false,32,39,71,136,136,272,4,11,15,1,3:03
661614,2022-06-11,2022,PHI,ARI,4,0,4-0,PHI,9,true,34,34,68,148,138,286,11,7,18,1,2:56
663412,2022-06-11,2022,ANA,NYN,11,6,11-6,ANA,9,true,42,41,83,145,154,299,19,12,31,4,3:21
662128,2022-06-11,2022,SEA,BOS,7,6,7-6,SEA,9,false,44,36,80,146,179,325,19,9,28,3,3:37
661680,2022-06-11,2022,MIN,TBA,6,5,6-5,MIN,9,true,37,38,75,170,149,319,16,13,29,2,3:30
662089,2022-06-11,2022,SFN,LAN,3,2,3-2,SFN,9,true,35,43,78,166,146,312,10,16,26,4,3:32
661976,2022-06-11,2022,SLN,CIN,5,4,5-4,SLN,9,false,37,40,77,137,173,310,14,14,28,2,3:10
662222,2022-06-11,2022,SDN,COL,2,6,6-2,COL,9,false,34,43,77,173,146,319,7,14,21,2,3:20
661484,2022-06-11,2022,CHA,TEX,9,11,11-9,TEX,10,false,49,49,98,184,187,371,18,21,39,3,4:03
663084,2022-06-11,2022,CLE,OAK,5,10,10-5,OAK,9,false,36,42,78,150,134,284,10,15,25,3,3:08
663083,2022-06-12,2022,CLE,OAK,6,3,6-3,CLE,9,true,35,37,72,137,118,255,12,11,23,1,2:31
662085,2022-06-12,2022,SFN,LAN,2,0,2-0,SFN,9,true,31,36,67,144,121,265,7,9,16,1,2:56
662829,2022-06-12,2022,DET,TOR,0,6,6-0,TOR,9,false,28,39,67,153,120,273,2,16,18,0,2:43
661144,2022-06-12,2022,ATL,PIT,5,3,5-3,ATL,9,true,34,34,68,114,146,260,10,9,19,0,2:48
662127,2022-06-12,2022,SEA,BOS,0,2,2-0,BOS,9,false,33,34,67,131,128,259,6,8,14,1,2:52
662256,2022-06-12,2022,SDN,COL,2,4,4-2,COL,9,false,31,38,69,139,122,261,7,11,18,0,2:41
662758,2022-06-12,2022,HOU,MIA,9,4,9-4,HOU,9,true,41,33,74,113,177,290,19,4,23,3,3:21
663397,2022-06-12,2022,ANA,NYN,1,4,4-1,NYN,9,false,34,42,76,146,147,293,9,16,25,2,3:11
661975,2022-06-12,2022,SLN,CIN,6,7,7-6,CIN,9,false,43,35,78,119,171,290,14,14,28,2,3:12
661679,2022-06-12,2022,MIN,TBA,0,6,6-0,TBA,9,false,35,40,75,160,168,328,9,12,21,2,3:17
662673,2022-06-12,2022,KCA,BAL,7,10,10-7,BAL,9,false,43,48,91,190,164,354,15,22,37,6,3:42
661622,2022-06-12,2022,PHI,ARI,1,13,13-1,ARI,9,false,38,50,88,210,158,368,12,24,36,4,3:50
661270,2022-06-12,2022,NYA,CHN,18,4,18-4,NYA,9,true,48,38,86,154,192,346,24,13,37,2,3:23
662542,2022-06-12,2022,WAS,MIL,1,4,4-1,MIL,9,false,38,35,73,149,144,293,12,9,21,2,3:11
661483,2022-06-12,2022,CHA,TEX,6,8,8-6,TEX,12,false,50,52,102,202,179,381,18,16,34,2,4:17
663183,2022-06-13,2022,CHN,SDN,1,4,4-1,SDN,9,false,33,37,70,116,122,238,6,11,17,1,2:45 (1:25 delay)
661629,2022-06-13,2022,PHI,MIA,3,2,3-2,PHI,9,false,38,33,71,126,135,261,13,6,19,1,2:59
661974,2022-06-13,2022,SLN,PIT,7,5,7-5,SLN,9,true,39,36,75,143,150,293,15,9,24,4,3:07
662069,2022-06-13,2022,SFN,KCA,6,2,6-2,SFN,9,true,38,33,71,113,164,277,15,7,22,1,2:48
662126,2022-06-13,2022,SEA,MIN,2,3,3-2,MIN,9,false,37,40,77,140,137,277,10,13,23,2,3:10
661746,2022-06-13,2022,TOR,BAL,11,1,11-1,TOR,9,true,42,36,78,126,166,292,20,8,28,4,3:17
663345,2022-06-13,2022,ARI,CIN,4,5,5-4,CIN,9,false,39,39,78,159,149,308,12,14,26,3,3:20
662828,2022-06-13,2022,DET,CHA,5,9,9-5,CHA,9,false,41,44,85,167,163,330,15,18,33,3,3:20
662505,2022-06-13,2022,WAS,ATL,5,9,9-5,ATL,9,false,40,42,82,170,143,313,15,16,31,2,3:15 (1:33 delay)
661881,2022-06-13,2022,TEX,HOU,5,3,5-3,TEX,9,true,39,36,75,134,143,277,15,10,25,3,3:18
662018,2022-06-14,2022,SLN,PIT,3,1,3-1,SLN,9,true,38,35,73,137,150,287,11,10,21,2,2:56
661880,2022-06-14,2022,TEX,HOU,3,4,4-3,HOU,9,false,34,37,71,132,117,249,9,10,19,1,2:40
662441,2022-06-14,2022,NYN,MIL,4,0,4-0,NYN,9,true,34,29,63,125,144,269,11,4,15,1,2:39
662125,2022-06-14,2022,SEA,MIN,5,0,5-0,SEA,9,true,33,32,65,137,122,259,9,6,15,1,2:36
661328,2022-06-14,2022,NYA,TBA,2,0,2-0,NYA,9,true,34,35,69,142,137,279,9,9,18,1,3:03
662068,2022-06-14,2022,SFN,KCA,4,2,4-2,SFN,9,true,33,36,69,152,143,295,10,12,22,2,3:00
663279,2022-06-14,2022,BOS,OAK,6,1,6-1,BOS,9,true,39,32,71,116,157,273,16,7,23,0,2:43
661745,2022-06-14,2022,TOR,BAL,5,6,6-5,BAL,9,false,40,39,79,142,154,296,13,13,26,4,3:12
662018,2022-06-14,2022,SLN,PIT,3,1,3-1,SLN,9,true,38,35,73,137,150,287,11,10,21,2,2:56
662611,2022-06-14,2022,LAN,ANA,2,0,2-0,LAN,9,true,32,33,65,130,130,260,8,6,14,2,2:58
662935,2022-06-14,2022,COL,CLE,3,4,4-3,CLE,10,false,40,42,82,145,151,296,12,14,26,1,3:02
662884,2022-06-14,2022,DET,CHA,1,5,5-1,CHA,9,false,37,42,79,158,163,321,10,16,26,0,3:20
663182,2022-06-14,2022,CHN,SDN,5,12,12-5,SDN,9,false,36,49,85,174,110,284,11,21,32,5,3:13
661616,2022-06-14,2022,PHI,MIA,9,11,11-9,MIA,9,false,45,42,87,156,187,343,19,15,34,4,3:54
661973,2022-06-14,2022,SLN,PIT,9,1,9-1,SLN,9,true,41,30,71,132,147,279,18,3,21,1,2:48
662503,2022-06-14,2022,WAS,ATL,4,10,10-4,ATL,9,false,35,45,80,166,153,319,8,18,26,1,3:14
663342,2022-06-14,2022,ARI,CIN,3,5,5-3,CIN,12,false,42,48,90,172,159,331,6,16,22,0,3:41
661583,2022-06-15,2022,PHI,MIA,3,1,3-1,PHI,9,false,36,32,68,103,152,255,12,7,19,2,3:12
661845,2022-06-15,2022,TEX,HOU,2,9,9-2,HOU,9,false,33,39,72,136,135,271,6,13,19,1,2:45
661744,2022-06-15,2022,TOR,BAL,7,6,7-6,TOR,10,false,39,37,76,128,131,259,13,7,20,2,2:53
661972,2022-06-15,2022,SLN,PIT,4,6,6-4,PIT,9,false,40,37,77,142,158,300,14,12,26,4,3:14
662173,2022-06-15,2022,SEA,MIN,0,5,5-0,MIN,9,false,34,38,72,149,124,273,8,12,20,3,3:00
662694,2022-06-15,2022,LAN,ANA,4,1,4-1,LAN,9,true,33,33,66,134,148,282,9,6,15,2,2:50
662082,2022-06-15,2022,SFN,KCA,2,3,3-2,KCA,9,false,38,32,70,118,178,296,11,5,16,2,2:52
662893,2022-06-15,2022,COL,CLE,5,7,7-5,CLE,9,false,39,41,80,148,132,280,13,14,27,4,3:02
661327,2022-06-15,2022,NYA,TBA,4,3,4-3,NYA,9,true,28,38,66,155,122,277,6,11,17,2,2:58
662480,2022-06-15,2022,NYN,MIL,2,10,10-2,MIL,9,false,34,44,78,162,152,314,9,21,30,2,3:11
663235,2022-06-15,2022,BOS,OAK,10,1,10-1,BOS,9,true,44,34,78,131,181,312,20,8,28,1,3:08
663155,2022-06-15,2022,CHN,SDN,5,19,19-5,SDN,9,false,44,55,99,208,167,375,17,30,47,4,3:46
662504,2022-06-15,2022,WAS,ATL,2,8,8-2,ATL,9,false,36,46,82,189,162,351,8,20,28,4,3:27
663336,2022-06-15,2022,ARI,CIN,7,4,7-4,ARI,9,true,36,35,71,137,132,269,10,9,19,1,2:50
662883,2022-06-15,2022,DET,CHA,0,13,13-0,CHA,9,false,32,51,83,189,109,298,4,27,31,2,2:51
662172,2022-06-16,2022,SEA,ANA,1,4,4-1,ANA,9,false,34,38,72,137,136,273,7,11,18,1,2:53
662827,2022-06-16,2022,DET,TEX,1,3,3-1,TEX,9,false,36,35,71,148,115,263,9,10,19,0,2:50
661326,2022-06-16,2022,NYA,TBA,2,1,2-1,NYA,9,false,30,31,61,134,112,246,7,5,12,3,2:38
661743,2022-06-16,2022,TOR,BAL,2,10,10-2,BAL,9,false,36,43,79,140,131,271,9,15,24,2,2:58
663267,2022-06-16,2022,BOS,OAK,3,4,4-3,OAK,9,false,43,36,79,117,157,274,16,7,23,4,3:15
663125,2022-06-16,2022,CHN,SDN,4,6,6-4,SDN,9,false,36,43,79,164,136,300,8,17,25,2,3:03
662535,2022-06-16,2022,NYN,MIL,5,4,5-4,NYN,9,true,37,37,74,169,143,312,13,12,25,2,3:26
662501,2022-06-16,2022,WAS,PHI,1,10,10-1,PHI,9,false,33,44,77,172,126,298,7,16,23,1,3:02
662986,2022-06-16,2022,COL,CLE,2,4,4-2,CLE,9,false,39,37,76,136,129,265,13,10,23,2,2:50
662985,2022-06-17,2022,COL,SDN,10,4,10-4,COL,9,true,40,35,75,112,152,264,18,11,29,1,2:55
663124,2022-06-17,2022,CHN,ATL,1,0,1-0,CHN,9,true,29,35,64,145,116,261,6,8,14,1,2:40
662171,2022-06-17,2022,SEA,ANA,8,1,8-1,SEA,9,true,37,33,70,124,140,264,15,6,21,1,2:37
662534,2022-06-17,2022,NYN,MIA,10,4,10-4,NYN,9,true,40,43,83,161,129,290,16,16,32,3,3:23
663063,2022-06-17,2022,CIN,MIL,4,5,5-4,MIL,9,false,35,36,71,154,126,280,10,10,20,2,2:53
662719,2022-06-17,2022,LAN,CLE,1,2,2-1,CLE,10,false,41,38,79,138,166,304,11,9,20,3,3:20
662757,2022-06-17,2022,HOU,CHA,13,3,13-3,HOU,9,true,40,34,74,123,144,267,17,8,25,2,2:55
662826,2022-06-17,2022,DET,TEX,0,7,7-0,TEX,9,false,31,43,74,175,127,302,5,16,21,1,3:01
663335,2022-06-17,2022,ARI,MIN,7,2,7-2,ARI,9,true,38,37,75,135,138,273,13,11,24,1,2:40
662580,2022-06-17,2022,WAS,PHI,3,5,5-3,PHI,9,false,38,43,81,180,146,326,13,16,29,2,3:32
662362,2022-06-17,2022,OAK,KCA,1,5,5-1,KCA,9,false,37,42,79,165,169,334,10,16,26,2,3:28
663256,2022-06-17,2022,BOS,SLN,6,5,6-5,BOS,9,true,35,39,74,157,133,290,13,14,27,5,3:05
661093,2022-06-17,2022,BAL,TBA,1,0,1-0,BAL,9,true,32,33,65,135,118,253,8,9,17,3,2:49
662502,2022-06-17,2022,WAS,PHI,7,8,8-7,PHI,10,false,45,42,87,176,165,341,16,13,29,2,3:45
662437,2022-06-17,2022,PIT,SFN,0,2,2-0,SFN,9,false,30,34,64,163,109,272,4,11,15,1,2:46
661742,2022-06-17,2022,TOR,NYA,3,12,12-3,NYA,9,false,36,46,82,183,148,331,9,21,30,3,3:21
661748,2022-06-18,2022,TOR,NYA,0,4,4-0,NYA,9,false,34,38,72,151,136,287,8,12,20,4,3:05
662686,2022-06-18,2022,LAN,CLE,7,1,7-1,LAN,9,true,42,32,74,128,168,296,17,4,21,2,2:57
662368,2022-06-18,2022,OAK,KCA,0,2,2-0,KCA,9,false,31,40,71,158,120,278,5,13,18,4,2:46
662752,2022-06-18,2022,HOU,CHA,0,7,7-0,CHA,9,false,30,42,72,163,122,285,5,14,19,1,2:51
662170,2022-06-18,2022,SEA,ANA,0,3,3-0,ANA,9,false,35,35,70,137,142,279,8,8,16,1,2:57
661127,2022-06-18,2022,BAL,TBA,6,7,7-6,TBA,9,false,41,43,84,159,182,341,13,17,30,4,3:51
663239,2022-06-18,2022,CHN,ATL,6,3,6-3,CHN,9,true,38,38,76,152,127,279,15,12,27,1,2:55
662802,2022-06-18,2022,DET,TEX,14,7,14-7,DET,9,true,45,36,81,143,174,317,22,11,33,1,2:57
663255,2022-06-18,2022,BOS,SLN,2,11,11-2,SLN,9,false,36,47,83,205,157,362,10,20,30,1,3:28
662533,2022-06-18,2022,NYN,MIA,3,2,3-2,NYN,9,true,33,32,65,143,131,274,9,5,14,3,2:51
662999,2022-06-18,2022,COL,SDN,5,4,5-4,COL,9,true,35,40,75,136,116,252,11,14,25,0,2:42
663351,2022-06-18,2022,ARI,MIN,1,11,11-1,MIN,9,false,31,46,77,179,117,296,4,19,23,1,2:40
661123,2022-06-18,2022,PIT,SFN,5,7,7-5,SFN,9,false,39,46,85,194,167,361,13,20,33,4,3:53
663062,2022-06-18,2022,CIN,MIL,3,7,7-3,MIL,9,false,38,45,83,192,128,320,11,19,30,3,3:21
662194,2022-06-18,2022,SEA,ANA,2,4,4-2,ANA,10,false,41,39,80,150,157,307,11,9,20,2,3:24
662500,2022-06-18,2022,WAS,PHI,1,2,2-1,PHI,10,false,36,41,77,185,139,324,8,11,19,1,3:48
662169,2022-06-19,2022,SEA,ANA,0,4,4-0,ANA,9,false,32,35,67,139,122,261,5,9,14,1,2:44
663334,2022-06-19,2022,ARI,MIN,7,1,7-1,ARI,9,true,34,33,67,139,133,272,10,7,17,2,2:51
661074,2022-06-19,2022,BAL,TBA,2,1,2-1,BAL,9,true,29,38,67,147,112,259,6,12,18,3,2:55
662553,2022-06-19,2022,WAS,PHI,9,3,9-3,WAS,9,true,41,36,77,111,151,262,18,8,26,2,2:57
663218,2022-06-19,2022,CHN,ATL,0,6,6-0,ATL,9,false,35,37,72,136,137,273,10,10,20,3,2:41
663254,2022-06-19,2022,BOS,SLN,6,4,6-4,BOS,9,true,37,38,75,156,131,287,14,12,26,3,3:13
662751,2022-06-19,2022,HOU,CHA,4,3,4-3,HOU,9,true,34,38,72,151,120,271,11,12,23,0,3:05
661741,2022-06-19,2022,TOR,NYA,10,9,10-9,TOR,9,true,40,43,83,187,172,359,15,18,33,5,3:41
663061,2022-06-19,2022,CIN,MIL,3,6,6-3,MIL,9,false,37,42,79,163,146,309,11,15,26,1,3:06
662590,2022-06-19,2022,LAN,CLE,3,5,5-3,CLE,9,false,36,45,81,147,142,289,10,18,28,4,3:08
662532,2022-06-19,2022,NYN,MIA,2,6,6-2,MIA,9,false,35,38,73,160,128,288,9,11,20,2,3:02
661122,2022-06-19,2022,PIT,SFN,4,3,4-3,PIT,9,false,32,37,69,147,117,264,9,12,21,1,2:38
662361,2022-06-19,2022,OAK,KCA,4,0,4-0,OAK,9,true,34,38,72,142,110,252,11,10,21,3,2:46
662807,2022-06-19,2022,DET,TEX,7,3,7-3,DET,9,true,39,35,74,126,156,282,17,9,26,2,3:09
662998,2022-06-19,2022,COL,SDN,8,3,8-3,COL,9,true,38,40,78,152,162,314,16,14,30,3,3:24
663443,2022-06-20,2022,ANA,KCA,2,6,6-2,KCA,9,false,36,39,75,118,146,264,10,14,24,1,2:58
661143,2022-06-20,2022,ATL,SFN,2,1,2-1,ATL,9,false,35,35,70,142,138,280,10,10,20,1,2:54
661186,2022-06-20,2022,MIL,SLN,2,0,2-0,MIL,9,true,33,31,64,140,123,263,9,5,14,1,2:46
663253,2022-06-20,2022,BOS,DET,5,2,5-2,BOS,9,true,36,36,72,134,143,277,11,11,22,3,2:55
661893,2022-06-20,2022,TBA,NYA,2,4,4-2,NYA,9,false,36,36,72,155,159,314,8,9,17,1,3:12
661482,2022-06-20,2022,CHA,TOR,8,7,8-7,CHA,9,true,37,38,75,157,128,285,15,10,25,1,2:55
662522,2022-06-20,2022,NYN,MIA,6,0,6-0,NYN,9,true,39,37,76,153,159,312,14,12,26,1,3:20
661121,2022-06-20,2022,PIT,CHN,12,1,12-1,PIT,9,true,42,41,83,167,160,327,18,15,33,2,3:17
662221,2022-06-20,2022,SDN,ARI,4,1,4-1,SDN,9,true,32,36,68,131,123,254,9,9,18,0,2:36
661890,2022-06-21,2022,TBA,NYA,5,4,5-4,TBA,9,true,33,36,69,140,116,256,9,10,19,3,2:42
661198,2022-06-21,2022,BAL,WAS,0,3,3-0,WAS,9,false,33,37,70,128,143,271,5,9,14,1,2:46
663246,2022-06-21,2022,BOS,DET,5,4,5-4,BOS,9,true,32,39,71,141,131,272,8,14,22,1,2:53
661124,2022-06-21,2022,PIT,CHN,7,1,7-1,PIT,9,true,36,35,71,136,154,290,11,8,19,0,2:44
663041,2022-06-21,2022,CIN,LAN,2,8,8-2,LAN,9,false,33,43,76,161,132,293,7,18,25,1,2:56
661148,2022-06-21,2022,MIA,COL,9,8,9-8,MIA,9,true,41,45,86,176,149,325,15,18,33,3,3:42
661846,2022-06-21,2022,TEX,PHI,7,0,7-0,TEX,9,true,33,35,68,134,136,270,12,9,21,2,3:06
662248,2022-06-21,2022,SDN,ARI,3,2,3-2,SDN,11,false,43,42,85,168,175,343,13,10,23,3,3:55
661142,2022-06-21,2022,ATL,SFN,10,12,12-10,SFN,9,false,42,44,86,172,150,322,15,20,35,4,3:28
662750,2022-06-21,2022,HOU,NYN,8,2,8-2,HOU,9,true,38,37,75,157,152,309,17,9,26,0,3:02
662360,2022-06-21,2022,OAK,SEA,2,8,8-2,SEA,9,false,34,44,78,160,130,290,8,21,29,2,3:03
661192,2022-06-21,2022,MIL,SLN,2,6,6-2,SLN,9,false,36,38,74,148,153,301,10,13,23,2,3:13
661677,2022-06-21,2022,MIN,CLE,5,6,6-5,CLE,11,false,44,46,90,183,168,351,12,16,28,1,3:46
663442,2022-06-21,2022,ANA,KCA,11,12,12-11,KCA,11,false,49,51,100,205,198,403,16,21,37,4,4:14
661481,2022-06-21,2022,CHA,TOR,7,6,7-6,CHA,12,false,53,51,104,224,200,424,22,16,38,1,4:23
661246,2022-06-22,2022,BAL,WAS,7,0,7-0,BAL,6,false,31,25,56,107,131,238,13,8,21,1,2:32 (1:46 delay)
663252,2022-06-22,2022,BOS,DET,6,2,6-2,BOS,9,true,36,35,71,131,156,287,12,8,20,1,3:03
661457,2022-06-22,2022,CHA,TOR,5,9,9-5,TOR,9,false,41,40,81,144,161,305,15,14,29,2,3:07
662245,2022-06-22,2022,SDN,ARI,10,4,10-4,SDN,9,true,44,43,87,160,177,337,20,12,32,1,3:33
662749,2022-06-22,2022,HOU,NYN,5,3,5-3,HOU,9,true,35,37,72,148,125,273,11,11,22,4,3:15
661393,2022-06-22,2022,MIA,COL,7,4,7-4,MIA,9,true,36,37,73,147,152,299,14,11,25,1,3:08
661107,2022-06-22,2022,PIT,CHN,5,14,14-5,CHN,9,false,40,47,87,159,164,323,10,21,31,1,3:07
663389,2022-06-22,2022,ANA,KCA,5,0,5-0,ANA,9,true,38,29,67,120,179,299,14,3,17,2,3:04 (:12 delay)
661141,2022-06-22,2022,ATL,SFN,4,3,4-3,ATL,9,false,34,36,70,147,133,280,8,7,15,1,2:52
661851,2022-06-22,2022,TEX,PHI,4,2,4-2,TEX,9,true,35,35,70,143,154,297,11,7,18,2,3:12
661690,2022-06-22,2022,MIN,CLE,10,11,11-10,CLE,9,false,40,44,84,180,143,323,15,17,32,5,3:35
661230,2022-06-22,2022,MIL,SLN,4,5,5-4,SLN,9,false,37,35,72,157,172,329,11,9,20,2,3:06
663040,2022-06-22,2022,CIN,LAN,4,8,8-4,LAN,9,false,35,43,78,174,139,313,9,16,25,2,3:22
662359,2022-06-22,2022,OAK,SEA,0,9,9-0,SEA,9,false,34,46,80,188,136,324,8,18,26,2,3:13
661889,2022-06-22,2022,TBA,NYA,4,5,5-4,NYA,9,false,37,44,81,174,130,304,14,16,30,3,3:35
662227,2022-06-23,2022,SDN,PHI,2,6,6-2,PHI,9,false,35,35,70,121,117,238,9,9,18,1,2:38
662358,2022-06-23,2022,OAK,SEA,1,2,2-1,SEA,9,false,34,35,69,139,129,268,8,8,16,1,2:54
661183,2022-06-23,2022,MIL,SLN,6,4,6-4,MIL,9,true,36,36,72,139,144,283,15,11,26,3,3:01
661685,2022-06-23,2022,MIN,CLE,1,0,1-0,MIN,9,true,31,35,66,147,132,279,7,8,15,1,2:54
661456,2022-06-23,2022,CHA,BAL,0,4,4-0,BAL,9,false,38,38,76,164,157,321,13,12,25,3,3:11
661325,2022-06-23,2022,NYA,HOU,7,6,7-6,NYA,9,false,38,40,78,135,166,301,12,14,26,2,3:24
661140,2022-06-23,2022,ATL,SFN,7,6,7-6,ATL,9,true,39,41,80,149,153,302,15,18,33,2,3:08
661392,2022-06-23,2022,MIA,COL,3,2,3-2,MIA,9,true,34,42,76,166,118,284,11,15,26,1,3:17
661106,2022-06-23,2022,PIT,CHN,8,7,8-7,PIT,10,false,40,43,83,168,139,307,11,15,26,2,3:27 (:06 delay)
663039,2022-06-23,2022,CIN,LAN,5,10,10-5,LAN,9,false,39,44,83,187,130,317,14,20,34,3,3:14
661455,2022-06-24,2022,CHA,BAL,1,4,4-1,BAL,9,false,30,36,66,144,111,255,3,10,13,3,2:55
661139,2022-06-24,2022,ATL,LAN,1,4,4-1,LAN,9,false,34,40,74,159,136,295,8,13,21,3,3:09
661888,2022-06-24,2022,TBA,PIT,4,3,4-3,TBA,10,false,36,39,75,156,154,310,8,9,17,1,3:14
661971,2022-06-24,2022,SLN,CHN,0,3,3-0,CHN,9,false,33,37,70,127,108,235,7,11,18,1,2:43
661684,2022-06-24,2022,MIN,COL,0,1,1-0,COL,9,false,33,33,66,95,115,210,8,9,17,1,2:17
663333,2022-06-24,2022,ARI,DET,1,5,5-1,DET,9,false,34,37,71,144,138,282,8,10,18,1,2:46
662664,2022-06-24,2022,KCA,OAK,3,1,3-1,KCA,9,true,33,34,67,136,93,229,10,7,17,1,2:22
662067,2022-06-24,2022,SFN,CIN,2,4,4-2,CIN,9,false,34,38,72,140,123,263,8,10,18,1,2:51
662255,2022-06-24,2022,SDN,PHI,1,0,1-0,SDN,9,true,31,37,68,164,113,277,9,10,19,0,3:05
661274,2022-06-24,2022,NYA,HOU,1,3,3-1,HOU,9,false,37,35,72,128,145,273,10,9,19,1,3:05
661382,2022-06-24,2022,MIA,NYN,3,5,5-3,NYN,9,false,39,33,72,125,153,278,16,6,22,2,3:03
661844,2022-06-24,2022,TEX,WAS,1,2,2-1,WAS,9,false,38,35,73,126,157,283,11,11,22,2,3:05
661190,2022-06-24,2022,MIL,TOR,4,9,9-4,TOR,9,false,39,40,79,170,160,330,14,15,29,3,3:16
663054,2022-06-24,2022,CLE,BOS,3,6,6-3,BOS,9,false,39,45,84,181,131,312,13,21,34,1,3:19
663388,2022-06-24,2022,ANA,SEA,3,4,4-3,SEA,9,false,34,47,81,212,139,351,11,21,32,3,3:41
661138,2022-06-25,2022,ATL,LAN,5,3,5-3,ATL,9,true,36,37,73,154,131,285,12,11,23,2,3:12
663042,2022-06-25,2022,CLE,BOS,2,4,4-2,BOS,9,false,36,39,75,133,132,265,10,16,26,2,2:55
662247,2022-06-25,2022,SDN,PHI,2,4,4-2,PHI,9,false,34,36,70,134,130,264,7,10,17,1,2:59
661686,2022-06-25,2022,MIN,COL,6,0,6-0,MIN,9,true,38,33,71,150,134,284,14,6,20,0,2:54
661970,2022-06-25,2022,SLN,CHN,5,3,5-3,SLN,9,true,38,37,75,164,148,312,14,11,25,2,3:22
661898,2022-06-25,2022,TEX,WAS,3,2,3-2,TEX,9,false,30,35,65,136,107,243,7,11,18,0,2:42
662083,2022-06-25,2022,SFN,CIN,9,2,9-2,SFN,9,true,36,34,70,141,147,288,13,8,21,0,2:43
661271,2022-06-25,2022,NYA,HOU,0,3,3-0,HOU,9,false,31,38,69,150,150,300,3,13,16,0,3:14
661381,2022-06-25,2022,MIA,NYN,3,5,5-3,NYN,9,false,32,39,71,152,123,275,6,12,18,1,3:00
663346,2022-06-25,2022,ARI,DET,3,6,6-3,DET,9,false,35,38,73,141,135,276,10,9,19,2,2:54
661454,2022-06-25,2022,CHA,BAL,2,6,6-2,BAL,9,false,37,40,77,150,138,288,10,13,23,1,2:48 (1:21 delay)
661264,2022-06-25,2022,MIL,TOR,5,4,5-4,MIL,9,true,38,36,74,132,167,299,13,10,23,2,3:10
661887,2022-06-25,2022,TBA,PIT,6,5,6-5,TBA,9,false,43,37,80,133,174,307,18,11,29,1,3:09
663441,2022-06-25,2022,ANA,SEA,3,5,5-3,SEA,9,false,39,44,83,168,138,306,16,17,33,4,3:22
662672,2022-06-25,2022,KCA,OAK,7,9,9-7,OAK,9,false,44,46,90,191,170,361,17,18,35,5,3:46
661380,2022-06-26,2022,MIA,NYN,3,2,3-2,MIA,9,false,32,36,68,134,127,261,6,9,15,0,2:44
663121,2022-06-26,2022,CLE,BOS,3,8,8-3,BOS,9,false,37,51,88,202,126,328,12,29,41,0,3:22
663387,2022-06-26,2022,ANA,SEA,2,1,2-1,ANA,9,true,36,32,68,120,135,255,15,7,22,2,3:04
662665,2022-06-26,2022,KCA,OAK,3,5,5-3,OAK,9,false,36,36,72,112,147,259,11,9,20,2,2:43
661453,2022-06-26,2022,CHA,BAL,4,3,4-3,CHA,9,true,33,38,71,136,126,262,9,9,18,0,2:35
661692,2022-06-26,2022,MIN,COL,6,3,6-3,MIN,9,true,36,41,77,176,135,311,12,15,27,2,3:06
662254,2022-06-26,2022,SDN,PHI,5,8,8-5,PHI,9,false,37,39,76,153,137,290,10,15,25,1,3:19
661847,2022-06-26,2022,TEX,WAS,4,6,6-4,WAS,9,false,38,41,79,172,153,325,12,16,28,2,3:17
661886,2022-06-26,2022,TBA,PIT,4,2,4-2,TBA,9,true,39,34,73,133,143,276,17,7,24,2,2:57
661206,2022-06-26,2022,MIL,TOR,10,3,10-3,MIL,9,true,40,34,74,122,154,276,18,9,27,1,2:51
661969,2022-06-26,2022,SLN,CHN,5,6,6-5,CHN,10,false,40,43,83,175,153,328,12,16,28,6,3:50
662061,2022-06-26,2022,SFN,CIN,3,10,10-3,CIN,9,false,34,42,76,156,130,286,7,17,24,2,2:58
661512,2022-06-26,2022,ATL,LAN,3,5,5-3,LAN,11,false,46,48,94,191,195,386,14,17,31,4,4:23
661273,2022-06-26,2022,NYA,HOU,6,3,6-3,NYA,10,false,38,41,79,174,153,327,12,12,24,1,3:45
663331,2022-06-26,2022,ARI,DET,11,7,11-7,ARI,9,true,44,41,85,186,168,354,21,14,35,2,3:36
662681,2022-06-27,2022,KCA,TEX,4,10,10-4,TEX,9,false,37,46,83,170,146,316,10,21,31,2,3:10
663016,2022-06-27,2022,CLE,MIN,1,11,11-1,MIN,9,false,31,43,74,166,121,287,7,18,25,1,2:55
662912,2022-06-27,2022,COL,LAN,4,0,4-0,COL,9,true,34,29,63,102,126,228,12,3,15,0,2:19
663440,2022-06-27,2022,ANA,CHA,4,3,4-3,ANA,9,true,36,33,69,103,135,238,14,7,21,0,2:42
662168,2022-06-27,2022,SEA,BAL,2,9,9-2,BAL,9,false,33,41,74,147,120,267,6,14,20,1,2:39
661968,2022-06-27,2022,SLN,MIA,9,0,9-0,SLN,9,true,36,33,69,117,140,257,12,9,21,0,2:40
662487,2022-06-27,2022,WAS,PIT,3,2,3-2,WAS,9,true,37,36,73,158,122,280,14,9,23,0,2:54
661740,2022-06-27,2022,TOR,BOS,7,2,7-2,TOR,9,true,37,37,74,140,133,273,13,10,23,1,2:59
661275,2022-06-27,2022,NYA,OAK,9,5,9-5,NYA,9,true,40,37,77,132,166,298,15,9,24,3,3:24
662186,2022-06-28,2022,SEA,BAL,2,0,2-0,SEA,9,true,31,32,63,133,122,255,8,5,13,1,2:39
661967,2022-06-28,2022,SLN,MIA,5,3,5-3,SLN,9,true,34,33,67,148,133,281,12,8,20,2,3:01
662521,2022-06-28,2022,NYN,HOU,1,9,9-1,HOU,9,false,37,42,79,172,124,296,12,17,29,2,3:17
663344,2022-06-28,2022,ARI,SDN,7,6,7-6,ARI,9,false,40,40,80,174,172,346,16,13,29,3,3:38
663392,2022-06-28,2022,ANA,CHA,4,11,11-4,CHA,9,false,38,47,85,187,148,335,10,21,31,3,3:16
661728,2022-06-28,2022,TOR,BOS,6,5,6-5,TOR,9,false,39,40,79,154,144,298,17,15,32,3,3:21
661272,2022-06-28,2022,NYA,OAK,2,1,2-1,NYA,9,true,29,34,63,140,134,274,7,9,16,2,3:03
662060,2022-06-28,2022,SFN,DET,4,3,4-3,SFN,9,true,36,38,74,148,172,320,12,14,26,2,3:16
661885,2022-06-28,2022,TBA,MIL,3,5,5-3,MIL,9,false,36,37,73,163,154,317,8,13,21,2,3:21
662484,2022-06-28,2022,WAS,PIT,3,1,3-1,WAS,9,true,36,36,72,133,141,274,10,9,19,0,2:51
662911,2022-06-28,2022,COL,LAN,7,4,7-4,COL,9,true,41,38,79,137,133,270,17,12,29,0,2:45
662615,2022-06-28,2022,KCA,TEX,3,8,8-3,TEX,9,false,33,42,75,161,119,280,9,17,26,1,2:51
663033,2022-06-28,2022,CLE,MIN,0,6,6-0,MIN,9,false,34,42,76,155,127,282,7,18,25,1,3:00
663045,2022-06-28,2022,CLE,MIN,3,2,3-2,CLE,9,true,31,37,68,146,148,294,8,9,17,1,2:59
663231,2022-06-28,2022,CHN,CIN,3,5,5-3,CIN,9,false,40,41,81,150,176,326,14,15,29,2,3:24
661580,2022-06-28,2022,PHI,ATL,3,5,5-3,ATL,9,false,37,37,74,160,152,312,12,10,22,3,3:18
661263,2022-06-29,2022,NYA,OAK,5,3,5-3,NYA,9,true,30,39,69,166,113,279,8,12,20,0,2:52
663325,2022-06-29,2022,ARI,SDN,0,4,4-0,SDN,9,false,33,41,74,179,118,297,6,15,21,1,3:12
662440,2022-06-29,2022,NYN,HOU,0,2,2-0,HOU,9,false,30,36,66,124,111,235,3,10,13,1,2:43
661134,2022-06-29,2022,SLN,MIA,3,4,4-3,MIA,9,false,35,34,69,129,117,246,9,9,18,0,2:35
663396,2022-06-29,2022,ANA,CHA,4,1,4-1,ANA,9,true,31,37,68,173,133,306,7,9,16,2,3:21
661879,2022-06-29,2022,TBA,MIL,3,5,5-3,MIL,9,false,39,39,78,152,176,328,13,11,24,2,4:00
663030,2022-06-29,2022,CLE,MIN,7,6,7-6,CLE,10,false,40,41,81,133,165,298,12,11,23,1,3:19
662675,2022-06-29,2022,KCA,TEX,2,1,2-1,KCA,9,true,31,34,65,134,108,242,10,7,17,0,2:18
661727,2022-06-29,2022,TOR,BOS,5,6,6-5,BOS,10,false,46,43,89,157,193,350,16,15,31,2,3:54
661584,2022-06-29,2022,PHI,ATL,1,4,4-1,ATL,9,false,34,35,69,140,134,274,7,10,17,1,2:47
662080,2022-06-29,2022,SFN,DET,2,3,3-2,DET,9,false,38,35,73,136,154,290,12,9,21,2,2:49
663215,2022-06-29,2022,CHN,CIN,8,3,8-3,CHN,9,true,39,40,79,150,176,326,15,15,30,2,3:22
662151,2022-06-29,2022,SEA,BAL,9,3,9-3,SEA,9,true,40,39,79,152,160,312,14,12,26,1,3:05
662493,2022-06-29,2022,WAS,PIT,7,8,8-7,PIT,9,false,44,41,85,152,179,331,22,15,37,5,3:48
662894,2022-06-29,2022,COL,LAN,4,8,8-4,LAN,9,false,36,42,78,154,131,285,11,16,27,3,2:56
662733,2022-06-30,2022,LAN,SDN,3,1,3-1,LAN,9,true,29,36,65,149,111,260,6,10,16,2,2:50
661105,2022-06-30,2022,PIT,MIL,8,7,8-7,PIT,9,true,36,42,78,160,133,293,13,15,28,2,3:00
662788,2022-06-30,2022,HOU,NYA,2,1,2-1,HOU,9,true,29,35,64,152,113,265,6,8,14,1,2:54
661726,2022-06-30,2022,TOR,TBA,4,1,4-1,TOR,9,true,35,33,68,133,142,275,13,7,20,1,2:55
661579,2022-06-30,2022,PHI,ATL,14,4,14-4,PHI,9,true,42,37,79,139,154,293,18,10,28,1,2:58
662150,2022-06-30,2022,SEA,OAK,8,6,8-6,SEA,9,true,35,40,75,153,131,284,12,13,25,2,2:53
662983,2022-06-30,2022,CLE,MIN,5,3,5-3,CLE,9,false,42,36,78,135,186,321,15,10,25,1,3:19
663199,2022-06-30,2022,CHN,CIN,15,7,15-7,CHN,9,true,50,40,90,153,174,327,27,14,41,1,3:14
662748,2022-07-01,2022,HOU,ANA,8,1,8-1,HOU,9,true,38,29,67,128,147,275,15,3,18,0,2:45
662997,2022-07-01,2022,COL,ARI,3,9,9-3,ARI,9,false,34,41,75,135,135,270,8,14,22,1,2:42
662079,2022-07-01,2022,SFN,CHA,0,1,1-0,CHA,9,false,34,36,70,131,150,281,8,9,17,0,2:59
662609,2022-07-01,2022,LAN,SDN,5,1,5-1,LAN,9,true,38,31,69,105,170,275,14,4,18,2,2:56
661691,2022-07-01,2022,MIN,BAL,3,2,3-2,MIN,9,false,29,33,62,128,117,245,6,5,11,2,2:41
662439,2022-07-01,2022,NYN,TEX,4,3,4-3,NYN,9,true,33,32,65,127,118,245,11,6,17,0,2:38
663038,2022-07-01,2022,CIN,ATL,1,9,9-1,ATL,9,false,35,42,77,149,122,271,8,17,25,0,2:52
662834,2022-07-01,2022,DET,KCA,1,3,3-1,KCA,9,false,38,36,74,122,129,251,12,11,23,2,2:50 (:16 delay)
662149,2022-07-01,2022,SEA,OAK,1,3,3-1,OAK,9,false,36,41,77,139,139,278,9,14,23,1,3:00
661582,2022-07-01,2022,PHI,SLN,5,3,5-3,PHI,9,true,36,36,72,165,142,307,11,11,22,3,3:20
661725,2022-07-01,2022,TOR,TBA,9,2,9-2,TOR,9,true,39,40,79,169,130,299,16,13,29,0,2:58
663185,2022-07-01,2022,CHN,BOS,6,5,6-5,CHN,9,true,41,38,79,162,154,316,17,13,30,4,3:31
661104,2022-07-01,2022,PIT,MIL,2,19,19-2,MIL,9,false,38,51,89,204,166,370,11,23,34,1,3:34
662492,2022-07-01,2022,WAS,MIA,3,6,6-3,MIA,9,false,34,42,76,142,133,275,8,15,23,1,3:05
661724,2022-07-02,2022,TOR,TBA,2,6,6-2,TBA,9,false,34,42,76,148,129,277,8,15,23,2,2:47
661683,2022-07-02,2022,MIN,BAL,4,3,4-3,MIN,9,false,36,37,73,135,142,277,11,12,23,2,3:01 (1:06 delay)
663198,2022-07-02,2022,CHN,BOS,3,1,3-1,CHN,9,true,32,32,64,114,127,241,9,7,16,3,2:48
661836,2022-07-02,2022,TOR,TBA,5,11,11-5,TBA,9,false,38,42,80,127,128,255,14,18,32,2,2:41
661103,2022-07-02,2022,PIT,MIL,7,4,7-4,PIT,9,true,35,40,75,149,135,284,12,16,28,3,2:56
662954,2022-07-02,2022,CLE,NYA,1,6,6-1,NYA,9,false,37,34,71,148,156,304,9,10,19,2,3:09
662482,2022-07-02,2022,WAS,MIA,3,5,5-3,MIA,9,false,35,40,75,161,145,306,9,13,22,1,3:20
663037,2022-07-02,2022,CIN,ATL,1,4,4-1,ATL,9,false,34,40,74,172,150,322,7,15,22,1,3:14
662163,2022-07-02,2022,SEA,OAK,2,1,2-1,SEA,9,false,33,31,64,134,122,256,10,6,16,1,2:50
662904,2022-07-02,2022,DET,KCA,4,3,4-3,DET,9,false,37,36,73,123,149,272,12,9,21,2,2:54
662890,2022-07-02,2022,HOU,ANA,9,1,9-1,HOU,9,true,40,33,73,144,147,291,15,6,21,0,2:51
662718,2022-07-02,2022,LAN,SDN,7,2,7-2,LAN,9,true,36,39,75,151,143,294,11,13,24,2,3:17
661581,2022-07-02,2022,PHI,SLN,6,7,7-6,SLN,9,false,43,43,86,167,179,346,16,16,32,5,4:05
662101,2022-07-02,2022,SFN,CHA,3,5,5-3,CHA,9,false,41,37,78,139,187,326,14,10,24,0,3:18
662964,2022-07-02,2022,CLE,NYA,4,13,13-4,NYA,9,false,38,46,84,172,176,348,12,21,33,2,3:28
662964,2022-07-02,2022,CLE,NYA,4,13,13-4,NYA,9,false,38,46,84,172,176,348,12,21,33,2,3:28
662910,2022-07-02,2022,COL,ARI,11,7,11-7,COL,9,true,40,35,75,117,157,274,16,10,26,2,2:47
662456,2022-07-02,2022,NYN,TEX,3,7,7-3,TEX,9,false,37,38,75,139,128,267,11,12,23,3,2:57
662509,2022-07-03,2022,NYN,TEX,4,1,4-1,NYN,9,true,34,36,70,153,133,286,9,10,19,2,2:58
663052,2022-07-03,2022,CIN,ATL,4,3,4-3,CIN,9,false,33,37,70,139,137,276,10,10,20,0,2:49
662486,2022-07-03,2022,WAS,MIA,4,7,7-4,MIA,10,false,40,41,81,187,154,341,13,12,25,1,3:51
661723,2022-07-03,2022,TOR,TBA,3,7,7-3,TBA,9,false,42,43,85,174,161,335,15,18,33,4,3:27
662684,2022-07-03,2022,LAN,SDN,2,4,4-2,SDN,9,false,40,35,75,132,150,282,15,9,24,2,3:12
662162,2022-07-03,2022,SEA,OAK,2,1,2-1,SEA,9,true,26,32,58,139,94,233,5,6,11,2,2:28
661630,2022-07-03,2022,PHI,SLN,4,0,4-0,PHI,9,true,34,32,66,135,138,273,10,6,16,2,3:03
661689,2022-07-03,2022,MIN,BAL,1,3,3-1,BAL,9,false,34,35,69,129,140,269,7,9,16,1,2:48
662957,2022-07-03,2022,CLE,NYA,2,0,2-0,CLE,9,true,33,33,66,130,136,266,10,5,15,1,2:55
661102,2022-07-03,2022,PIT,MIL,0,2,2-0,MIL,9,false,38,33,71,117,170,287,11,7,18,1,3:08
663186,2022-07-03,2022,CHN,BOS,2,4,4-2,BOS,11,false,46,49,95,205,179,384,16,16,32,2,4:25
662794,2022-07-03,2022,DET,KCA,4,7,7-4,KCA,9,false,37,44,81,175,158,333,13,20,33,3,3:33
662913,2022-07-03,2022,COL,ARI,6,5,6-5,COL,9,true,34,41,75,142,127,269,11,15,26,3,3:09
662889,2022-07-03,2022,HOU,ANA,4,2,4-2,HOU,9,false,38,35,73,147,154,301,13,9,22,2,3:23
662099,2022-07-03,2022,SFN,CHA,4,13,13-4,CHA,9,false,36,48,84,180,158,338,9,20,29,2,3:22
662841,2022-07-04,2022,DET,CLE,5,3,5-3,DET,9,true,37,34,71,123,140,263,12,10,22,2,2:55
663343,2022-07-04,2022,ARI,SFN,8,3,8-3,ARI,9,true,37,37,74,161,158,319,13,12,25,0,3:13
662906,2022-07-04,2022,DET,CLE,4,1,4-1,DET,9,true,37,31,68,126,143,269,14,6,20,3,2:55
662355,2022-07-04,2022,OAK,TOR,5,1,5-1,OAK,9,true,33,32,65,111,130,241,10,5,15,1,2:27
663251,2022-07-04,2022,BOS,TBA,4,0,4-0,BOS,9,true,35,32,67,129,149,278,12,4,16,2,2:57
662732,2022-07-04,2022,LAN,COL,5,3,5-3,LAN,9,true,35,37,72,150,139,289,11,11,22,2,3:06
661511,2022-07-04,2022,ATL,SLN,6,3,6-3,ATL,9,true,34,41,75,163,131,294,14,13,27,1,3:01 (2:37 delay)
663036,2022-07-04,2022,CIN,NYN,4,7,7-4,NYN,9,false,36,43,79,167,140,307,10,17,27,1,3:14
661073,2022-07-04,2022,BAL,TEX,7,6,7-6,BAL,10,false,45,46,91,188,138,326,18,16,34,4,3:33
662541,2022-07-04,2022,WAS,MIA,2,3,3-2,MIA,10,false,36,42,78,134,117,251,10,13,23,1,2:53
661181,2022-07-04,2022,MIL,CHN,5,2,5-2,MIL,10,false,42,39,81,177,158,335,14,11,25,1,3:29
662841,2022-07-04,2022,DET,CLE,5,3,5-3,DET,9,true,37,34,71,123,140,263,12,10,22,2,2:55
661452,2022-07-04,2022,CHA,MIN,3,6,6-3,MIN,10,false,37,43,80,155,135,290,11,15,26,1,3:13
662874,2022-07-04,2022,HOU,KCA,7,6,7-6,HOU,9,false,39,39,78,154,163,317,13,14,27,2,3:19
662270,2022-07-04,2022,SDN,SEA,2,8,8-2,SEA,9,false,38,46,84,185,153,338,12,18,30,3,3:21
662731,2022-07-05,2022,LAN,COL,5,2,5-2,LAN,9,true,35,35,70,148,154,302,13,9,22,2,3:00
662847,2022-07-05,2022,HOU,KCA,9,7,9-7,HOU,9,true,40,40,80,149,138,287,17,14,31,2,3:04
661426,2022-07-05,2022,CHA,MIN,2,8,8-2,MIN,9,false,36,43,79,143,129,272,12,17,29,2,2:59 (:35 delay)
661510,2022-07-05,2022,ATL,SLN,7,1,7-1,ATL,9,true,38,40,78,157,162,319,13,13,26,1,3:07
661187,2022-07-05,2022,MIL,CHN,3,8,8-3,CHN,9,false,36,42,78,153,160,313,10,15,25,2,3:03
662905,2022-07-05,2022,DET,CLE,11,4,11-4,DET,9,true,43,40,83,149,155,304,20,13,33,1,3:03
661244,2022-07-05,2022,BAL,TEX,10,9,10-9,BAL,10,false,46,46,92,179,156,335,19,15,34,4,3:46
661379,2022-07-05,2022,MIA,ANA,2,1,2-1,MIA,9,true,33,32,65,130,142,272,10,5,15,1,2:47
662354,2022-07-05,2022,OAK,TOR,5,3,5-3,OAK,9,true,35,35,70,126,142,268,14,10,24,3,2:40
663035,2022-07-05,2022,CIN,NYN,1,0,1-0,CIN,9,false,33,36,69,148,125,273,9,10,19,3,3:01 (:53 delay)
663320,2022-07-05,2022,ARI,SFN,6,2,6-2,ARI,9,true,34,36,70,142,137,279,11,12,23,3,3:07
661578,2022-07-05,2022,PHI,WAS,11,0,11-0,PHI,9,true,43,32,75,114,190,304,20,7,27,2,3:03
662329,2022-07-05,2022,PIT,NYA,5,2,5-2,PIT,9,true,33,38,71,167,131,298,9,12,21,1,2:59
662226,2022-07-05,2022,SDN,SEA,2,6,6-2,SEA,9,false,40,39,79,147,162,309,12,14,26,1,3:16
663245,2022-07-05,2022,BOS,TBA,4,8,8-4,TBA,9,false,42,42,84,148,185,333,15,18,33,1,3:39
661509,2022-07-06,2022,ATL,SLN,3,0,3-0,ATL,9,true,30,36,66,129,111,240,6,11,17,0,2:32
661245,2022-07-06,2022,BAL,TEX,2,1,2-1,BAL,9,true,31,34,65,118,135,253,8,7,15,2,2:41
662353,2022-07-06,2022,OAK,TOR,1,2,2-1,TOR,9,false,32,37,69,142,118,260,5,12,17,2,2:39
661564,2022-07-06,2022,PHI,WAS,2,3,3-2,WAS,9,false,33,34,67,120,153,273,7,9,16,1,2:57
662814,2022-07-06,2022,DET,CLE,8,2,8-2,DET,9,true,37,37,74,161,128,289,13,11,24,1,3:04
662747,2022-07-06,2022,HOU,KCA,4,7,7-4,KCA,9,false,38,40,78,161,165,326,12,15,27,2,3:29
662328,2022-07-06,2022,PIT,NYA,0,16,16-0,NYA,9,false,32,55,87,195,131,326,5,30,35,1,3:21 (1:09 delay)
663051,2022-07-06,2022,CIN,NYN,3,8,8-3,NYN,10,false,39,47,86,159,184,343,13,19,32,3,3:46
661413,2022-07-06,2022,CHA,MIN,9,8,9-8,CHA,10,false,44,45,89,173,172,345,18,17,35,0,3:47
662630,2022-07-06,2022,LAN,COL,2,1,2-1,LAN,9,false,37,32,69,133,135,268,14,6,20,2,3:01
661378,2022-07-06,2022,MIA,ANA,2,5,5-2,ANA,9,false,35,41,76,139,132,271,8,16,24,1,3:07
661225,2022-07-06,2022,MIL,CHN,1,2,2-1,CHN,9,false,34,35,69,145,145,290,8,9,17,2,3:13
663318,2022-07-06,2022,ARI,SFN,5,7,7-5,SFN,9,false,41,39,80,142,160,302,14,13,27,4,3:23
663244,2022-07-06,2022,BOS,TBA,1,7,7-1,TBA,9,false,34,45,79,181,126,307,6,19,25,0,3:05
663071,2022-07-07,2022,CIN,PIT,2,4,4-2,PIT,9,false,35,37,72,151,134,285,9,12,21,2,2:49
662730,2022-07-07,2022,LAN,CHN,5,3,5-3,LAN,9,true,32,33,65,143,129,272,9,7,16,3,2:55
662156,2022-07-07,2022,SEA,TOR,8,3,8-3,SEA,9,true,34,37,71,125,140,265,12,12,24,2,2:41
662508,2022-07-07,2022,NYN,MIA,10,0,10-0,NYN,9,true,39,28,67,106,151,257,14,2,16,0,2:51
663140,2022-07-07,2022,CIN,PIT,5,1,5-1,CIN,9,true,34,34,68,154,117,271,10,8,18,4,3:01
661425,2022-07-07,2022,CHA,DET,1,2,2-1,DET,9,false,32,36,68,141,136,277,6,9,15,1,3:00
661566,2022-07-07,2022,PHI,WAS,5,3,5-3,PHI,9,true,35,39,74,134,150,284,11,12,23,0,2:56
662253,2022-07-07,2022,SDN,SFN,2,1,2-1,SDN,10,false,36,39,75,147,130,277,12,10,22,0,3:22 (:14 delay)
663071,2022-07-07,2022,CIN,PIT,2,4,4-2,PIT,9,false,35,37,72,151,134,285,9,12,21,2,2:49
663233,2022-07-07,2022,BOS,NYA,5,6,6-5,NYA,9,false,35,39,74,142,133,275,9,12,21,2,2:56
662746,2022-07-07,2022,HOU,KCA,5,2,5-2,HOU,9,true,40,37,77,141,151,292,19,10,29,1,3:04
661091,2022-07-07,2022,BAL,ANA,4,1,4-1,BAL,9,true,37,35,72,142,152,294,12,8,20,3,3:00
663317,2022-07-07,2022,ARI,COL,3,4,4-3,COL,9,false,36,37,73,131,163,294,12,12,24,0,2:57
661521,2022-07-07,2022,ATL,SLN,2,3,3-2,SLN,11,false,45,45,90,179,171,350,14,13,27,2,3:50
661136,2022-07-08,2022,SLN,PHI,0,2,2-0,PHI,9,false,34,31,65,103,116,219,7,5,12,0,2:23
662614,2022-07-08,2022,KCA,CLE,4,3,4-3,KCA,9,false,35,37,72,153,124,277,10,12,22,0,2:44
661177,2022-07-08,2022,MIL,PIT,4,3,4-3,MIL,9,true,35,36,71,146,154,300,15,10,25,0,3:01
663202,2022-07-08,2022,BOS,NYA,5,12,12-5,NYA,9,false,44,49,93,199,171,370,17,22,39,3,3:51
662610,2022-07-08,2022,LAN,CHN,4,3,4-3,LAN,10,false,40,35,75,114,166,280,13,5,18,2,3:01
661843,2022-07-08,2022,TEX,MIN,6,5,6-5,TEX,9,true,35,41,76,151,147,298,12,13,25,3,3:22
663053,2022-07-08,2022,CIN,TBA,2,1,2-1,CIN,10,false,35,38,73,162,165,327,9,9,18,0,3:18
663319,2022-07-08,2022,ARI,COL,5,6,6-5,COL,9,false,38,40,78,157,142,299,14,14,28,2,3:28
662498,2022-07-08,2022,NYN,MIA,2,5,5-2,MIA,9,false,39,37,76,151,173,324,12,11,23,1,3:37
661108,2022-07-08,2022,BAL,ANA,5,4,5-4,BAL,9,false,38,40,78,160,172,332,12,14,26,1,3:30
662352,2022-07-08,2022,OAK,HOU,3,8,8-3,HOU,9,false,32,44,76,179,107,286,5,17,22,1,2:57
661522,2022-07-08,2022,ATL,WAS,12,2,12-2,ATL,9,true,42,33,75,135,153,288,19,8,27,2,2:51 (1:15 delay)
661412,2022-07-08,2022,CHA,DET,5,7,7-5,DET,9,false,40,38,78,135,141,276,14,11,25,2,2:56
662225,2022-07-08,2022,SDN,SFN,6,3,6-3,SDN,9,true,40,36,76,149,160,309,16,9,25,3,3:16
662155,2022-07-08,2022,SEA,TOR,5,2,5-2,SEA,11,false,41,46,87,180,170,350,15,15,30,3,4:08
662351,2022-07-09,2022,OAK,HOU,3,2,3-2,OAK,9,true,30,35,65,137,96,233,7,8,15,1,2:33
661508,2022-07-09,2022,ATL,WAS,4,3,4-3,ATL,9,true,32,39,71,124,127,251,11,14,25,1,2:36
662497,2022-07-09,2022,NYN,MIA,5,4,5-4,NYN,10,false,37,39,76,154,158,312,8,12,20,3,3:41
662663,2022-07-09,2022,KCA,CLE,1,13,13-1,CLE,9,false,37,54,91,202,146,348,13,29,42,2,3:10
663092,2022-07-09,2022,CIN,TBA,5,4,5-4,CIN,10,false,45,42,87,181,190,371,18,15,33,2,4:00
662147,2022-07-09,2022,SEA,TOR,2,1,2-1,SEA,9,true,30,34,64,143,116,259,7,9,16,1,2:42
662683,2022-07-09,2022,LAN,CHN,4,2,4-2,LAN,9,true,35,33,68,118,125,243,11,6,17,2,2:41
661071,2022-07-09,2022,BAL,ANA,1,0,1-0,BAL,9,true,31,35,66,155,120,275,8,10,18,2,2:59
661224,2022-07-09,2022,MIL,PIT,3,4,4-3,PIT,9,false,39,36,75,147,160,307,13,9,22,3,3:14
661842,2022-07-09,2022,TEX,MIN,9,7,9-7,TEX,9,true,40,39,79,141,158,299,19,13,32,2,3:19
663310,2022-07-09,2022,ARI,COL,9,2,9-2,ARI,9,true,39,36,75,154,152,306,16,9,25,1,3:03
662266,2022-07-09,2022,SDN,SFN,1,3,3-1,SFN,9,false,32,38,70,145,112,257,5,11,16,0,2:51
661137,2022-07-09,2022,SLN,PHI,0,1,1-0,PHI,9,false,33,35,68,145,127,272,6,9,15,1,2:58
661411,2022-07-09,2022,CHA,DET,8,0,8-0,CHA,9,true,38,31,69,117,154,271,14,6,20,0,2:35
663223,2022-07-09,2022,BOS,NYA,6,5,6-5,BOS,10,false,41,40,81,172,130,302,12,13,25,3,3:38
663307,2022-07-10,2022,ARI,COL,2,3,3-2,COL,9,false,33,36,69,131,133,264,6,7,13,2,2:43
662662,2022-07-10,2022,KCA,CLE,5,1,5-1,KCA,9,true,37,35,72,162,140,302,13,8,21,1,2:48
662215,2022-07-10,2022,OAK,HOU,1,6,6-1,HOU,9,false,32,38,70,131,131,262,6,12,18,0,2:39
661410,2022-07-10,2022,CHA,DET,4,2,4-2,CHA,9,true,34,34,68,130,121,251,10,9,19,2,2:46
662183,2022-07-10,2022,SEA,TOR,6,5,6-5,SEA,9,true,34,37,71,135,129,264,10,10,20,2,2:45
661092,2022-07-10,2022,BAL,ANA,9,5,9-5,BAL,9,true,38,36,74,142,118,260,15,10,25,2,2:48
661520,2022-07-10,2022,ATL,WAS,4,3,4-3,ATL,12,false,49,45,94,180,173,353,18,12,30,3,3:53
662496,2022-07-10,2022,NYN,MIA,0,2,2-0,MIA,10,false,39,36,75,140,138,278,9,8,17,0,2:57
661808,2022-07-10,2022,TEX,MIN,5,6,6-5,MIN,9,false,37,40,77,152,147,299,11,17,28,1,3:12
663048,2022-07-10,2022,CIN,TBA,10,5,10-5,CIN,9,true,40,41,81,177,150,327,15,15,30,1,3:19
661135,2022-07-10,2022,SLN,PHI,4,3,4-3,SLN,9,true,38,37,75,142,157,299,15,12,27,2,3:09
663232,2022-07-10,2022,BOS,NYA,11,6,11-6,BOS,9,true,41,38,79,167,152,319,15,13,28,2,3:32
662198,2022-07-10,2022,SDN,SFN,0,12,12-0,SFN,9,false,34,48,82,187,126,313,8,21,29,2,3:06
661178,2022-07-10,2022,MIL,PIT,6,8,8-6,PIT,9,false,39,42,81,191,155,346,12,16,28,3,3:31
662729,2022-07-10,2022,LAN,CHN,11,9,11-9,LAN,9,true,45,41,86,165,205,370,21,15,36,4,3:59
662700,2022-07-11,2022,KCA,DET,3,1,3-1,KCA,9,true,34,33,67,116,116,232,10,5,15,1,2:30
662700,2022-07-11,2022,KCA,DET,3,1,3-1,KCA,9,true,34,33,67,116,116,232,10,5,15,1,2:30
661507,2022-07-11,2022,ATL,NYN,1,4,4-1,NYN,9,false,32,41,73,165,124,289,5,16,21,0,3:03
661324,2022-07-11,2022,MIA,PIT,1,5,5-1,PIT,9,false,35,41,76,161,129,290,8,15,23,2,3:03
662661,2022-07-11,2022,KCA,DET,7,3,7-3,KCA,9,true,40,38,78,145,140,285,16,12,28,2,3:00
661120,2022-07-11,2022,SLN,PHI,6,1,6-1,SLN,9,true,33,32,65,134,117,251,9,8,17,2,2:41
661814,2022-07-11,2022,TEX,OAK,10,8,10-8,TEX,9,true,40,42,82,166,161,327,15,15,30,4,3:28
662996,2022-07-11,2022,COL,SDN,5,6,6-5,SDN,9,false,39,41,80,154,145,299,12,15,27,2,3:01
662956,2022-07-11,2022,CLE,CHA,8,4,8-4,CLE,9,true,39,34,73,114,152,266,17,9,26,2,2:51
661878,2022-07-11,2022,TBA,BOS,10,5,10-5,TBA,9,true,41,38,79,166,157,323,19,12,31,1,3:31
662100,2022-07-11,2022,SFN,ARI,3,4,4-3,ARI,9,false,38,42,80,170,152,322,12,18,30,4,3:46
663087,2022-07-12,2022,CLE,CHA,4,1,4-1,CLE,9,true,31,30,61,95,114,209,11,4,15,0,2:09
662984,2022-07-12,2022,COL,SDN,5,3,5-3,COL,9,true,34,39,73,157,113,270,10,14,24,3,3:11
662660,2022-07-12,2022,KCA,DET,5,7,7-5,DET,9,false,39,43,82,151,134,285,13,14,27,3,3:08
663402,2022-07-12,2022,ANA,HOU,5,6,6-5,HOU,9,false,38,43,81,169,162,331,9,16,25,2,3:37
663087,2022-07-12,2022,CLE,CHA,4,1,4-1,CLE,9,true,31,30,61,95,114,209,11,4,15,0,2:09
661722,2022-07-12,2022,TOR,PHI,4,3,4-3,TOR,9,true,35,35,70,136,132,268,16,7,23,1,2:52
662108,2022-07-12,2022,SFN,ARI,13,0,13-0,SFN,9,true,41,37,78,143,158,301,17,10,27,1,2:45
661688,2022-07-12,2022,MIN,MIL,3,6,6-3,MIL,9,false,37,35,72,153,156,309,11,9,20,1,3:02 (1:43 delay)
661119,2022-07-12,2022,SLN,LAN,7,6,7-6,SLN,9,true,39,43,82,186,130,316,16,16,32,3,3:28
662976,2022-07-12,2022,CLE,CHA,0,7,7-0,CHA,9,false,39,41,80,167,159,326,12,13,25,1,3:15
661377,2022-07-12,2022,MIA,PIT,2,3,3-2,PIT,9,false,32,33,65,117,126,243,5,8,13,1,2:43
661877,2022-07-12,2022,TBA,BOS,3,2,3-2,TBA,9,true,33,34,67,142,126,268,9,9,18,2,2:49
663187,2022-07-12,2022,CHN,BAL,2,4,4-2,BAL,9,false,33,40,73,148,122,270,8,15,23,2,2:54
661262,2022-07-12,2022,NYA,CIN,3,4,4-3,CIN,9,false,38,38,76,153,163,316,14,11,25,1,3:21 (1:01 delay)
661506,2022-07-12,2022,ATL,NYN,4,1,4-1,ATL,9,true,33,36,69,165,153,318,9,10,19,3,3:04
661813,2022-07-12,2022,TEX,OAK,7,14,14-7,OAK,12,false,49,54,103,180,174,354,15,20,35,3,4:03
662949,2022-07-13,2022,CLE,CHA,1,2,2-1,CHA,9,false,33,36,69,140,128,268,6,10,16,2,2:57
662517,2022-07-13,2022,WAS,SEA,4,6,6-4,SEA,9,false,40,37,77,147,132,279,15,11,26,2,2:53
662107,2022-07-13,2022,SFN,ARI,4,3,4-3,SFN,9,false,35,38,73,158,131,289,13,13,26,3,3:05
661505,2022-07-13,2022,ATL,NYN,3,7,7-3,NYN,9,false,36,39,75,168,139,307,10,11,21,1,3:05
661269,2022-07-13,2022,NYA,CIN,7,6,7-6,NYA,10,false,39,43,82,166,173,339,11,15,26,2,3:56
661721,2022-07-13,2022,TOR,PHI,8,2,8-2,TOR,9,true,35,30,65,107,137,244,13,2,15,1,2:31
661812,2022-07-13,2022,TEX,OAK,5,2,5-2,TEX,9,true,32,32,64,124,131,255,9,5,14,1,2:34
663230,2022-07-13,2022,CHN,BAL,1,7,7-1,BAL,9,false,36,42,78,155,153,308,9,16,25,2,3:11
663401,2022-07-13,2022,ANA,HOU,7,1,7-1,ANA,9,true,42,34,76,146,183,329,18,7,25,2,3:45
661876,2022-07-13,2022,TBA,BOS,4,1,4-1,TBA,9,true,34,30,64,113,139,252,10,5,15,1,2:30
661118,2022-07-13,2022,SLN,LAN,6,7,7-6,LAN,9,false,38,46,84,203,146,349,11,20,31,2,3:46
662531,2022-07-13,2022,WAS,SEA,1,2,2-1,SEA,9,false,34,36,70,143,129,272,11,11,22,3,2:58
662531,2022-07-13,2022,WAS,SEA,1,2,2-1,SEA,9,false,34,36,70,143,129,272,11,11,22,3,2:58
662659,2022-07-13,2022,KCA,DET,5,2,5-2,KCA,9,true,34,39,73,152,115,267,8,15,23,1,2:44
661687,2022-07-13,2022,MIN,MIL,4,1,4-1,MIN,9,false,41,34,75,138,170,308,18,8,26,3,3:20
661376,2022-07-13,2022,MIA,PIT,5,4,5-4,MIA,10,false,41,39,80,159,148,307,15,13,28,0,3:21
662895,2022-07-13,2022,COL,SDN,10,6,10-6,COL,9,true,44,43,87,177,159,336,20,19,39,4,3:40
663123,2022-07-14,2022,CLE,DET,4,0,4-0,CLE,9,true,38,32,70,120,143,263,16,5,21,1,2:37
662518,2022-07-14,2022,WAS,ATL,4,5,5-4,ATL,9,false,38,33,71,136,147,283,12,8,20,0,2:54
661720,2022-07-14,2022,TOR,KCA,1,3,3-1,KCA,9,false,35,36,71,145,130,275,10,14,24,2,3:00
661101,2022-07-14,2022,CHN,NYN,0,8,8-0,NYN,9,false,35,44,79,175,135,310,10,18,28,1,3:01
661811,2022-07-14,2022,TEX,SEA,5,6,6-5,SEA,9,false,39,44,83,186,132,318,16,17,33,2,3:20
661261,2022-07-14,2022,NYA,CIN,6,7,7-6,CIN,10,false,46,44,90,154,187,341,16,14,30,4,3:44
661675,2022-07-14,2022,MIN,CHA,2,12,12-2,CHA,9,false,39,49,88,159,165,324,13,21,34,1,3:19
661375,2022-07-14,2022,MIA,PIT,3,2,3-2,MIA,11,false,41,45,86,192,182,374,14,15,29,2,4:13
661875,2022-07-14,2022,TBA,BOS,5,4,5-4,TBA,9,true,33,36,69,141,119,260,10,9,19,2,2:45
661100,2022-07-14,2022,COL,SDN,8,5,8-5,COL,9,true,41,37,78,159,196,355,18,11,29,3,3:42
663123,2022-07-14,2022,CLE,DET,4,0,4-0,CLE,9,true,38,32,70,120,143,263,16,5,21,1,2:37
661117,2022-07-14,2022,SLN,LAN,0,4,4-0,LAN,9,false,33,36,69,127,148,275,8,13,21,2,3:00
663386,2022-07-14,2022,ANA,HOU,2,3,3-2,HOU,10,false,45,40,85,151,164,315,15,13,28,0,3:28
662109,2022-07-14,2022,SFN,MIL,2,3,3-2,MIL,10,false,37,46,83,186,156,342,8,17,25,2,3:52
661719,2022-07-15,2022,TOR,KCA,8,1,8-1,TOR,9,true,40,34,74,119,155,274,17,7,24,0,2:48
661674,2022-07-15,2022,MIN,CHA,2,6,6-2,CHA,9,false,36,38,74,143,142,285,11,11,22,2,3:09
661874,2022-07-15,2022,TBA,BAL,5,4,5-4,TBA,9,true,34,39,73,152,125,277,10,12,22,2,3:05
662942,2022-07-15,2022,CLE,DET,6,5,6-5,CLE,9,true,36,37,73,134,138,272,16,9,25,2,2:59
661113,2022-07-15,2022,COL,PIT,13,2,13-2,COL,9,true,42,33,75,116,173,289,21,6,27,1,3:03
661810,2022-07-15,2022,TEX,SEA,3,8,8-3,SEA,9,false,33,42,75,164,140,304,6,16,22,2,3:09
663385,2022-07-15,2022,ANA,LAN,1,9,9-1,LAN,9,false,29,45,74,187,100,287,2,19,21,2,3:01
661374,2022-07-15,2022,MIA,PHI,1,2,2-1,PHI,9,false,35,33,68,133,165,298,8,8,16,0,3:04
662516,2022-07-15,2022,WAS,ATL,4,8,8-4,ATL,9,false,41,42,83,161,174,335,15,14,29,2,3:32
661116,2022-07-15,2022,SLN,CIN,7,3,7-3,SLN,9,true,37,38,75,153,177,330,16,13,29,3,3:33
661260,2022-07-15,2022,NYA,BOS,4,5,5-4,BOS,11,false,44,43,87,176,159,335,16,12,28,1,4:00
662923,2022-07-15,2022,HOU,OAK,1,5,5-1,OAK,9,false,33,36,69,129,123,252,7,9,16,2,2:39
662072,2022-07-15,2022,SFN,MIL,8,5,8-5,SFN,9,false,42,43,85,186,155,341,18,14,32,3,3:34
662197,2022-07-15,2022,SDN,ARI,5,3,5-3,SDN,9,true,35,35,70,144,151,295,12,8,20,0,3:04
662909,2022-07-16,2022,HOU,OAK,5,0,5-0,HOU,9,true,32,34,66,154,99,253,8,8,16,0,2:35
662113,2022-07-16,2022,SFN,MIL,2,1,2-1,SFN,9,true,32,32,64,125,132,257,8,6,14,2,2:49
662483,2022-07-16,2022,WAS,ATL,3,6,6-3,ATL,9,false,32,39,71,147,118,265,7,11,18,1,2:47 (1:49 delay)
662952,2022-07-16,2022,CLE,DET,10,0,10-0,CLE,9,true,40,33,73,137,138,275,16,8,24,1,2:46
661359,2022-07-16,2022,MIA,PHI,0,10,10-0,PHI,9,false,31,43,74,153,116,269,5,18,23,1,2:52
662271,2022-07-16,2022,SDN,ARI,4,3,4-3,SDN,9,true,34,39,73,147,129,276,10,14,24,5,3:02
661673,2022-07-16,2022,MIN,CHA,6,3,6-3,MIN,9,true,36,37,73,158,159,317,12,11,23,2,3:12
661809,2022-07-16,2022,TEX,SEA,2,3,3-2,SEA,10,false,36,44,80,158,152,310,8,16,24,1,3:22
661259,2022-07-16,2022,NYA,BOS,14,1,14-1,NYA,9,true,47,31,78,113,198,311,22,4,26,2,3:09
661115,2022-07-16,2022,CHN,NYN,3,4,4-3,NYN,10,false,41,43,84,168,154,322,14,15,29,3,3:33
661718,2022-07-16,2022,TOR,KCA,6,5,6-5,TOR,10,false,41,40,81,152,170,322,16,11,27,2,3:29
663415,2022-07-16,2022,ANA,LAN,1,7,7-1,LAN,9,false,35,37,72,172,125,297,7,11,18,1,3:07
661114,2022-07-16,2022,CHN,NYN,1,2,2-1,NYN,11,false,39,41,80,188,164,352,9,8,17,3,3:46
661115,2022-07-16,2022,CHN,NYN,3,4,4-3,NYN,10,false,41,43,84,168,154,322,14,15,29,3,3:33
661873,2022-07-16,2022,TBA,BAL,4,6,6-4,BAL,11,false,45,40,85,140,191,331,16,10,26,4,3:51
661081,2022-07-16,2022,COL,PIT,2,0,2-0,COL,9,true,35,34,69,129,131,260,11,9,20,0,2:40
661966,2022-07-16,2022,SLN,CIN,11,3,11-3,SLN,9,true,48,35,83,136,168,304,22,8,30,2,3:20
661373,2022-07-17,2022,MIA,PHI,0,4,4-0,PHI,9,false,31,36,67,123,116,239,5,10,15,1,2:42
661717,2022-07-17,2022,TOR,KCA,4,2,4-2,TOR,9,true,33,32,65,114,110,224,8,8,16,1,2:21
662530,2022-07-17,2022,WAS,ATL,7,3,7-3,WAS,9,true,33,37,70,146,123,269,9,9,18,1,2:54
661258,2022-07-17,2022,NYA,BOS,13,2,13-2,NYA,9,true,47,32,79,136,188,324,23,6,29,4,3:32
662059,2022-07-17,2022,SFN,MIL,9,5,9-5,SFN,9,true,38,36,74,130,142,272,15,11,26,2,2:49
661672,2022-07-17,2022,MIN,CHA,0,11,11-0,CHA,9,false,32,47,79,170,137,307,4,20,24,2,3:09
662908,2022-07-17,2022,HOU,OAK,3,4,4-3,OAK,9,false,37,37,74,142,151,293,9,10,19,2,3:16
661080,2022-07-17,2022,COL,PIT,3,8,8-3,PIT,9,false,37,46,83,175,131,306,13,19,32,2,3:13
661821,2022-07-17,2022,TEX,SEA,2,6,6-2,SEA,9,false,39,39,78,145,172,317,12,14,26,2,3:22
661872,2022-07-17,2022,TBA,BAL,7,5,7-5,TBA,9,true,36,39,75,125,150,275,13,13,26,3,2:58
661082,2022-07-17,2022,CHN,NYN,3,2,3-2,CHN,9,true,33,36,69,155,148,303,10,12,22,2,3:09
662269,2022-07-17,2022,SDN,ARI,1,3,3-1,ARI,9,false,32,40,72,153,135,288,6,12,18,4,3:20
663466,2022-07-19,2022,NAS,AAS,2,3,3-2,AAS,9,false,36,37,73,148,151,299,9,11,20,2,3:11
662408,2022-07-21,2022,OAK,DET,5,0,5-0,OAK,9,true,35,33,68,136,148,284,12,8,20,1,2:45
661421,2022-07-21,2022,MIA,TEX,0,8,8-0,TEX,9,false,36,43,79,163,143,306,10,16,26,0,3:06
662775,2022-07-21,2022,HOU,NYA,7,5,7-5,HOU,9,true,36,39,75,177,127,304,10,13,23,1,3:11
662776,2022-07-21,2022,HOU,NYA,3,2,3-2,HOU,9,false,36,37,73,155,124,279,13,11,24,1,3:14
662685,2022-07-21,2022,LAN,SFN,9,6,9-6,LAN,9,true,38,40,78,166,144,310,15,14,29,4,3:29
662411,2022-07-21,2022,OAK,DET,2,7,7-2,DET,9,false,35,42,77,167,147,314,8,14,22,1,2:58
662327,2022-07-22,2022,PIT,MIA,1,8,8-1,MIA,9,false,30,40,70,135,117,252,3,15,18,1,2:41
662481,2022-07-22,2022,NYN,SDN,1,4,4-1,SDN,9,false,34,39,73,151,126,277,6,13,19,1,3:01 (:31 delay)
663306,2022-07-22,2022,ARI,WAS,10,1,10-1,ARI,9,true,40,32,72,128,159,287,15,4,19,0,2:46
662167,2022-07-22,2022,SEA,HOU,2,5,5-2,HOU,9,false,38,37,75,132,165,297,12,11,23,2,3:04
662344,2022-07-22,2022,OAK,TEX,5,4,5-4,OAK,9,true,38,37,75,125,145,270,14,10,24,4,2:53
662589,2022-07-22,2022,LAN,SFN,5,1,5-1,LAN,9,true,37,37,74,138,147,285,14,10,24,1,3:04
661409,2022-07-22,2022,CHA,CLE,2,8,8-2,CLE,9,false,37,44,81,158,156,314,11,17,28,1,3:20
663060,2022-07-22,2022,CIN,SLN,9,5,9-5,CIN,9,true,35,41,76,183,150,333,11,14,25,2,3:21
662658,2022-07-22,2022,KCA,TBA,3,7,7-3,TBA,9,false,39,43,82,167,156,323,13,17,30,0,3:21
661193,2022-07-22,2022,MIL,COL,6,5,6-5,MIL,13,false,52,52,104,212,197,409,21,14,35,2,4:44
661504,2022-07-22,2022,ATL,ANA,8,1,8-1,ATL,9,true,35,36,71,154,128,282,11,10,21,2,2:59 (:55 delay)
661072,2022-07-22,2022,BAL,NYA,6,7,7-6,NYA,9,false,40,37,77,151,173,324,14,12,26,4,3:47
661560,2022-07-22,2022,PHI,CHN,2,15,15-2,CHN,9,false,39,50,89,184,148,332,12,26,38,1,3:28
663222,2022-07-22,2022,BOS,TOR,5,28,28-5,TOR,9,false,37,63,100,228,169,397,10,35,45,2,3:49
661523,2022-07-23,2022,CHA,CLE,4,7,7-4,CLE,9,false,40,40,80,120,147,267,13,14,27,2,2:58
662146,2022-07-23,2022,SEA,HOU,1,3,3-1,HOU,9,false,33,36,69,134,117,251,7,10,17,1,2:46
662436,2022-07-23,2022,PIT,MIA,1,0,1-0,PIT,9,true,35,33,68,115,122,237,13,8,21,1,3:00
661559,2022-07-23,2022,PHI,CHN,2,6,6-2,CHN,10,false,36,40,76,173,144,317,9,10,19,4,3:36
663305,2022-07-23,2022,ARI,WAS,7,2,7-2,ARI,9,true,36,32,68,113,153,266,13,6,19,1,2:44
663221,2022-07-23,2022,BOS,TOR,1,4,4-1,TOR,9,false,36,35,71,137,148,285,10,11,21,1,3:09
662495,2022-07-23,2022,NYN,SDN,1,2,2-1,SDN,9,false,36,33,69,113,150,263,11,5,16,1,3:10
662902,2022-07-23,2022,DET,MIN,4,8,8-4,MIN,9,false,37,40,77,167,145,312,10,12,22,3,3:21
662657,2022-07-23,2022,KCA,TBA,6,3,6-3,KCA,9,true,39,35,74,135,146,281,18,10,28,1,2:58
661408,2022-07-23,2022,CHA,CLE,5,4,5-4,CHA,9,true,35,37,72,151,140,291,13,10,23,2,3:06
661523,2022-07-23,2022,CHA,CLE,4,7,7-4,CLE,9,false,40,40,80,120,147,267,13,14,27,2,2:58
661503,2022-07-23,2022,ATL,ANA,7,2,7-2,ATL,9,true,37,35,72,132,153,285,14,8,22,0,3:01
662348,2022-07-23,2022,OAK,TEX,3,1,3-1,OAK,9,true,34,37,71,167,143,310,10,11,21,4,3:14
661201,2022-07-23,2022,MIL,COL,9,4,9-4,MIL,9,true,38,36,74,154,149,303,15,9,24,1,3:13
662608,2022-07-23,2022,LAN,SFN,4,2,4-2,LAN,9,true,35,37,72,145,168,313,11,10,21,4,3:21
661057,2022-07-23,2022,BAL,NYA,6,3,6-3,BAL,9,true,36,41,77,160,158,318,14,14,28,1,3:35
663047,2022-07-23,2022,CIN,SLN,3,6,6-3,SLN,9,false,38,46,84,169,158,327,10,21,31,3,3:27
661556,2022-07-24,2022,PHI,CHN,3,4,4-3,CHN,9,false,36,37,73,129,138,267,10,11,21,0,2:50
663059,2022-07-24,2022,CIN,SLN,6,3,6-3,CIN,9,true,33,33,66,119,137,256,10,7,17,1,2:44
662901,2022-07-24,2022,DET,MIN,1,9,9-1,MIN,9,false,32,44,76,176,123,299,5,17,22,2,3:10
662357,2022-07-24,2022,PIT,MIA,5,6,6-5,MIA,10,false,42,40,82,142,176,318,11,12,23,0,3:07
663220,2022-07-24,2022,BOS,TOR,4,8,8-4,TOR,9,false,37,46,83,178,149,327,12,19,31,2,3:33
662656,2022-07-24,2022,KCA,TBA,4,2,4-2,KCA,9,true,37,33,70,115,137,252,14,8,22,1,2:50
661056,2022-07-24,2022,BAL,NYA,0,6,6-0,NYA,9,false,37,43,80,162,150,312,10,17,27,1,3:20
662145,2022-07-24,2022,SEA,HOU,5,8,8-5,HOU,9,false,39,40,79,150,148,298,13,15,28,3,3:10
662458,2022-07-24,2022,NYN,SDN,8,5,8-5,NYN,9,true,39,43,82,182,146,328,16,19,35,2,3:39
663316,2022-07-24,2022,ARI,WAS,3,4,4-3,WAS,9,false,43,41,84,150,168,318,17,17,34,3,3:44
662343,2022-07-24,2022,OAK,TEX,8,11,11-8,TEX,9,false,43,48,91,163,153,316,16,21,37,2,3:22
662682,2022-07-24,2022,LAN,SFN,7,4,7-4,LAN,9,true,39,37,76,161,150,311,16,9,25,3,3:25
661407,2022-07-24,2022,CHA,CLE,6,3,6-3,CHA,9,true,33,40,73,154,99,253,9,14,23,0,2:31
661184,2022-07-24,2022,MIL,COL,10,9,10-9,MIL,9,true,41,47,88,198,199,397,17,21,38,4,4:17
661502,2022-07-24,2022,ATL,ANA,1,9,9-1,ANA,9,false,38,45,83,164,172,336,11,18,29,3,3:17
662166,2022-07-25,2022,SEA,TEX,4,3,4-3,SEA,9,true,35,37,72,140,129,269,12,10,22,3,3:02
663315,2022-07-25,2022,ARI,SFN,7,0,7-0,ARI,9,true,41,28,69,111,141,252,18,4,22,3,2:43
662347,2022-07-25,2022,OAK,HOU,7,5,7-5,OAK,9,true,33,38,71,128,123,251,11,11,22,4,2:55
661231,2022-07-25,2022,MIL,COL,0,2,2-0,COL,9,false,33,33,66,141,133,274,7,7,14,0,2:50
661065,2022-07-25,2022,CHN,PIT,3,2,3-2,CHN,9,true,34,36,70,138,125,263,14,10,24,1,2:52
663219,2022-07-25,2022,BOS,CLE,3,1,3-1,BOS,9,true,33,37,70,132,143,275,9,11,20,4,3:03 (:38 delay)
661555,2022-07-25,2022,PHI,ATL,6,4,6-4,PHI,9,true,36,37,73,149,135,284,12,10,22,0,3:16
662655,2022-07-25,2022,KCA,ANA,7,0,7-0,KCA,9,true,41,33,74,134,144,278,19,7,26,2,3:03
661055,2022-07-25,2022,BAL,TBA,5,1,5-1,BAL,9,true,36,38,74,162,125,287,13,11,24,3,3:11
662809,2022-07-25,2022,DET,SDN,12,4,12-4,DET,9,true,41,38,79,146,151,297,16,12,28,3,3:09
663046,2022-07-25,2022,CIN,MIA,11,2,11-2,CIN,9,true,42,35,77,134,166,300,21,10,31,2,3:16
662576,2022-07-25,2022,LAN,WAS,1,4,4-1,WAS,9,false,37,40,77,150,134,284,9,16,25,1,3:14
661064,2022-07-26,2022,CHN,PIT,4,2,4-2,CHN,9,true,34,32,66,128,113,241,11,4,15,0,2:30
661054,2022-07-26,2022,BAL,TBA,5,3,5-3,BAL,9,true,30,39,69,147,104,251,7,13,20,3,2:43
662184,2022-07-26,2022,SEA,TEX,5,4,5-4,SEA,9,false,39,36,75,123,137,260,16,11,27,2,2:59
661563,2022-07-26,2022,PHI,ATL,3,6,6-3,ATL,9,false,34,38,72,149,145,294,7,12,19,1,3:10
661079,2022-07-26,2022,COL,CHA,1,2,2-1,CHA,9,false,37,38,75,138,151,289,14,12,26,1,3:16
663314,2022-07-26,2022,ARI,SFN,7,3,7-3,ARI,9,true,34,37,71,150,155,305,10,10,20,3,3:10
661716,2022-07-26,2022,TOR,SLN,10,3,10-3,TOR,9,true,39,39,78,149,153,302,18,13,31,3,3:14
662573,2022-07-26,2022,LAN,WAS,3,8,8-3,WAS,9,false,37,43,80,154,150,304,9,16,25,2,3:27
662653,2022-07-26,2022,KCA,ANA,0,6,6-0,ANA,9,false,36,43,79,154,155,309,9,19,28,3,3:24
663203,2022-07-26,2022,BOS,CLE,3,8,8-3,CLE,9,false,37,43,80,176,163,339,11,17,28,1,3:20
663029,2022-07-26,2022,CIN,MIA,1,2,2-1,MIA,9,false,29,39,68,146,112,258,2,13,15,1,2:45
662813,2022-07-26,2022,DET,SDN,4,6,6-4,SDN,10,false,42,45,87,170,149,319,13,15,28,1,3:43
662346,2022-07-26,2022,OAK,HOU,5,3,5-3,OAK,9,true,35,36,71,126,155,281,11,12,23,3,3:04
662438,2022-07-26,2022,NYN,NYA,6,3,6-3,NYN,9,true,35,40,75,154,145,299,12,13,25,2,3:27
661281,2022-07-26,2022,MIL,MIN,7,6,7-6,MIL,9,false,43,39,82,142,183,325,17,13,30,1,3:30
663028,2022-07-27,2022,CIN,MIA,5,3,5-3,CIN,9,true,33,34,67,111,135,246,10,8,18,0,2:32
662652,2022-07-27,2022,KCA,ANA,0,4,4-0,ANA,9,false,35,37,72,136,133,269,8,13,21,2,2:48
662420,2022-07-27,2022,NYN,NYA,3,2,3-2,NYN,9,false,38,38,76,131,142,273,13,11,24,3,3:09
663294,2022-07-27,2022,ARI,SFN,5,3,5-3,ARI,9,true,34,37,71,158,122,280,9,10,19,3,3:03
662900,2022-07-27,2022,DET,SDN,4,3,4-3,DET,9,false,36,36,72,143,137,280,11,9,20,1,3:03 (:20 delay)
663191,2022-07-27,2022,BOS,CLE,6,7,7-6,CLE,9,false,37,42,79,143,137,280,11,13,24,2,3:02
661249,2022-07-27,2022,MIL,MIN,10,4,10-4,MIL,9,true,41,37,78,149,188,337,18,9,27,1,3:27
661053,2022-07-27,2022,BAL,TBA,4,6,6-4,TBA,10,false,43,42,85,163,146,309,14,15,29,4,3:46
661715,2022-07-27,2022,TOR,SLN,1,6,6-1,SLN,9,false,31,39,70,155,122,277,5,16,21,1,2:57
662165,2022-07-27,2022,SEA,TEX,4,2,4-2,SEA,9,true,34,35,69,125,117,242,10,8,18,2,2:40
661554,2022-07-27,2022,PHI,ATL,7,2,7-2,PHI,9,true,35,35,70,145,126,271,12,8,20,1,2:54
662345,2022-07-27,2022,OAK,HOU,4,2,4-2,OAK,9,true,33,34,67,115,137,252,9,8,17,1,2:27
662565,2022-07-27,2022,LAN,WAS,7,1,7-1,LAN,9,true,39,35,74,147,168,315,18,10,28,2,3:03
661078,2022-07-27,2022,COL,CHA,6,5,6-5,COL,9,false,44,37,81,132,181,313,22,13,35,3,3:36
661052,2022-07-28,2022,BAL,TBA,3,0,3-0,BAL,9,true,31,37,68,162,102,264,7,10,17,2,2:54
663380,2022-07-28,2022,ANA,TEX,0,2,2-0,TEX,9,false,32,35,67,136,124,260,5,10,15,0,2:47
663200,2022-07-28,2022,BOS,CLE,4,2,4-2,BOS,9,true,32,33,65,118,110,228,9,7,16,1,2:33
662058,2022-07-28,2022,SFN,CHN,4,2,4-2,SFN,9,true,35,32,67,125,144,269,10,6,16,3,3:00
661077,2022-07-28,2022,COL,LAN,0,13,13-0,LAN,9,false,35,47,82,184,130,314,9,19,28,1,3:06
662907,2022-07-28,2022,HOU,SEA,4,2,4-2,HOU,9,true,33,33,66,137,131,268,9,7,16,1,2:51
661257,2022-07-28,2022,NYA,KCA,1,0,1-0,NYA,9,false,29,35,64,146,119,265,4,8,12,0,2:38
661714,2022-07-28,2022,TOR,DET,5,3,5-3,TOR,9,true,37,35,72,126,140,266,13,7,20,2,2:52
662326,2022-07-28,2022,PIT,PHI,7,8,8-7,PHI,9,false,39,42,81,152,138,290,13,15,28,2,3:11
663027,2022-07-28,2022,CIN,MIA,6,7,7-6,MIA,9,false,40,39,79,143,169,312,14,14,28,5,3:40
661871,2022-07-29,2022,TBA,CLE,1,4,4-1,CLE,9,false,34,38,72,162,122,284,8,11,19,0,2:43
661256,2022-07-29,2022,NYA,KCA,11,5,11-5,NYA,9,true,41,37,78,144,151,295,16,10,26,1,3:12 (:23 delay)
662268,2022-07-29,2022,SDN,MIN,10,1,10-1,SDN,9,true,37,32,69,123,140,263,13,6,19,1,2:47
663026,2022-07-29,2022,CIN,BAL,2,6,6-2,BAL,9,false,34,42,76,159,146,305,10,16,26,5,3:29
662477,2022-07-29,2022,WAS,SLN,2,6,6-2,SLN,9,false,36,35,71,143,120,263,9,8,17,1,2:42
661406,2022-07-29,2022,CHA,OAK,3,7,7-3,OAK,9,false,34,37,71,152,123,275,7,9,16,1,2:54
663379,2022-07-29,2022,ANA,TEX,2,7,7-2,TEX,9,false,34,40,74,155,128,283,6,13,19,2,3:13
661713,2022-07-29,2022,TOR,DET,2,4,4-2,DET,9,false,34,41,75,159,152,311,7,14,21,2,3:20
663190,2022-07-29,2022,BOS,MIL,1,4,4-1,MIL,9,false,36,39,75,139,153,292,9,16,25,3,3:27
662745,2022-07-29,2022,HOU,SEA,11,1,11-1,HOU,9,true,47,34,81,112,183,295,23,8,31,2,3:06
661372,2022-07-29,2022,MIA,NYN,4,6,6-4,NYN,9,false,37,44,81,169,139,308,12,18,30,0,3:16
662057,2022-07-29,2022,SFN,CHN,2,4,4-2,CHN,9,false,42,38,80,152,152,304,16,11,27,2,3:17
661076,2022-07-29,2022,COL,LAN,4,5,5-4,LAN,9,false,34,45,79,169,136,305,8,18,26,1,3:12
661501,2022-07-29,2022,ATL,ARI,5,2,5-2,ATL,9,true,33,38,71,132,123,255,12,10,22,1,2:40
662435,2022-07-29,2022,PIT,PHI,2,4,4-2,PHI,10,false,38,42,80,161,135,296,10,14,24,3,3:30
662415,2022-07-30,2022,PIT,PHI,1,2,2-1,PHI,10,false,35,38,73,139,136,275,6,10,16,0,2:54
662476,2022-07-30,2022,WAS,SLN,7,6,7-6,WAS,9,true,37,38,75,140,140,280,13,13,26,5,3:18
662112,2022-07-30,2022,SFN,CHN,5,4,5-4,SFN,9,true,36,40,76,153,156,309,12,12,24,3,3:06
661451,2022-07-30,2022,CHA,OAK,3,2,3-2,CHA,9,false,36,35,71,128,132,260,12,9,21,1,2:50
661371,2022-07-30,2022,MIA,NYN,0,4,4-0,NYN,9,false,30,37,67,133,107,240,6,11,17,2,2:35
661712,2022-07-30,2022,TOR,DET,5,3,5-3,TOR,9,true,31,39,70,128,116,244,9,14,23,3,2:46
663025,2022-07-30,2022,CIN,BAL,8,2,8-2,CIN,9,true,38,31,69,136,141,277,15,6,21,1,2:54
661499,2022-07-30,2022,ATL,ARI,6,2,6-2,ATL,9,true,36,34,70,155,152,307,13,6,19,0,2:51
662989,2022-07-30,2022,COL,LAN,5,3,5-3,COL,9,true,34,35,69,132,125,257,11,8,19,2,2:43
661870,2022-07-30,2022,TBA,CLE,6,4,6-4,TBA,9,true,36,39,75,138,148,286,13,12,25,1,2:58
663378,2022-07-30,2022,ANA,TEX,9,7,9-7,ANA,9,true,40,40,80,161,135,296,17,15,32,1,3:04
662196,2022-07-30,2022,SDN,MIN,4,7,7-4,MIN,9,false,39,38,77,162,156,318,12,13,25,2,3:34
662738,2022-07-30,2022,HOU,SEA,4,5,5-4,SEA,9,false,39,38,77,150,161,311,13,13,26,2,3:28
661255,2022-07-30,2022,NYA,KCA,8,2,8-2,NYA,9,true,40,36,76,155,177,332,15,10,25,2,3:20
663192,2022-07-30,2022,BOS,MIL,4,9,9-4,MIL,9,false,40,46,86,179,185,364,14,21,35,3,3:49
661711,2022-07-31,2022,TOR,DET,4,1,4-1,TOR,9,true,33,31,64,107,117,224,8,4,12,0,2:19
661498,2022-07-31,2022,ATL,ARI,1,0,1-0,ATL,9,false,31,32,63,134,107,241,7,8,15,0,2:52
661388,2022-07-31,2022,CHA,OAK,4,1,4-1,CHA,9,true,31,33,64,144,120,264,8,8,16,1,2:42
663377,2022-07-31,2022,ANA,TEX,2,5,5-2,TEX,9,false,36,35,71,145,132,277,12,10,22,1,2:56
662918,2022-07-31,2022,HOU,SEA,3,2,3-2,HOU,10,false,39,37,76,142,146,288,12,7,19,0,3:08
661370,2022-07-31,2022,MIA,NYN,3,9,9-3,NYN,9,false,40,46,86,168,166,334,13,21,34,2,3:23
662988,2022-07-31,2022,COL,LAN,3,7,7-3,LAN,9,false,36,41,77,146,163,309,10,15,25,2,3:11
661869,2022-07-31,2022,TBA,CLE,3,5,5-3,CLE,9,false,38,41,79,163,147,310,13,14,27,3,3:03
661254,2022-07-31,2022,NYA,KCA,6,8,8-6,KCA,9,false,40,42,82,182,169,351,13,16,29,5,4:00
662267,2022-07-31,2022,SDN,MIN,3,2,3-2,SDN,9,true,32,34,66,114,137,251,7,8,15,1,2:45
662475,2022-07-31,2022,WAS,SLN,0,5,5-0,SLN,9,false,31,40,71,165,112,277,6,12,18,1,2:50
662071,2022-07-31,2022,SFN,CHN,4,0,4-0,SFN,9,true,39,31,70,132,151,283,16,4,20,1,2:58
663024,2022-07-31,2022,CIN,BAL,3,2,3-2,CIN,9,true,33,37,70,150,143,293,11,10,21,5,3:22
663189,2022-07-31,2022,BOS,MIL,7,2,7-2,BOS,9,true,38,37,75,137,151,288,14,14,28,3,2:58
662414,2022-07-31,2022,PIT,PHI,2,8,8-2,PHI,9,false,37,43,80,150,141,291,11,18,29,1,3:07
662224,2022-08-01,2022,SDN,COL,4,1,4-1,SDN,9,true,33,35,68,132,138,270,12,8,20,1,2:51
662737,2022-08-01,2022,HOU,BOS,2,3,3-2,BOS,9,false,36,33,69,129,146,275,9,7,16,1,3:02
661387,2022-08-01,2022,CHA,KCA,1,2,2-1,KCA,9,false,37,33,70,123,146,269,11,7,18,2,2:55
661369,2022-08-01,2022,MIA,CIN,1,3,3-1,CIN,9,false,36,37,73,147,137,284,9,11,20,1,2:55
661820,2022-08-01,2022,TEX,BAL,2,7,7-2,BAL,9,false,33,44,77,157,127,284,7,16,23,1,2:55
662070,2022-08-01,2022,SFN,LAN,2,8,8-2,LAN,9,false,35,40,75,148,137,285,8,15,23,0,2:50
661268,2022-08-01,2022,NYA,SEA,7,2,7-2,NYA,9,true,37,36,73,142,143,285,13,10,23,1,2:58
662474,2022-08-01,2022,WAS,NYN,3,7,7-3,NYN,9,false,36,42,78,176,139,315,9,18,27,4,3:20
661671,2022-08-01,2022,MIN,DET,5,3,5-3,MIN,10,false,42,38,80,141,158,299,15,8,23,2,3:17
662947,2022-08-01,2022,CLE,ARI,6,5,6-5,CLE,11,false,47,43,90,154,173,327,16,12,28,4,3:42
661868,2022-08-02,2022,TBA,TOR,1,3,3-1,TOR,9,false,30,36,66,145,112,257,4,11,15,0,2:45
663376,2022-08-02,2022,ANA,OAK,3,1,3-1,ANA,9,true,31,37,68,135,111,246,9,11,20,1,2:33
661959,2022-08-02,2022,SLN,CHN,6,0,6-0,SLN,9,true,35,34,69,131,133,264,14,9,23,1,2:37
662736,2022-08-02,2022,HOU,BOS,1,2,2-1,BOS,9,false,37,32,69,134,141,275,11,6,17,1,2:59
661386,2022-08-02,2022,CHA,KCA,9,2,9-2,CHA,9,true,40,37,77,137,121,258,17,10,27,1,2:52
661368,2022-08-02,2022,MIA,CIN,1,2,2-1,CIN,9,false,32,37,69,151,113,264,5,9,14,2,2:46
662529,2022-08-02,2022,WAS,NYN,5,1,5-1,WAS,9,true,33,35,68,124,133,257,10,9,19,1,2:48
661661,2022-08-02,2022,MIN,DET,3,5,5-3,DET,9,false,37,37,74,153,128,281,12,11,23,2,3:10
662941,2022-08-02,2022,CLE,ARI,3,6,6-3,ARI,9,false,36,36,72,137,141,278,10,11,21,1,2:50
662298,2022-08-02,2022,PIT,MIL,5,3,5-3,PIT,9,true,35,39,74,141,142,283,11,12,23,3,3:02
662056,2022-08-02,2022,SFN,LAN,5,9,9-5,LAN,9,false,37,41,78,147,130,277,11,15,26,3,3:03
661819,2022-08-02,2022,TEX,BAL,2,8,8-2,BAL,9,false,39,40,79,161,159,320,12,14,26,3,3:17
662220,2022-08-02,2022,SDN,COL,3,2,3-2,SDN,9,false,35,36,71,173,148,321,10,10,20,2,3:10
661496,2022-08-02,2022,ATL,PHI,13,1,13-1,ATL,9,true,43,36,79,151,177,328,22,9,31,4,3:27
662250,2022-08-02,2022,SDN,COL,13,5,13-5,SDN,9,true,47,39,86,143,176,319,26,14,40,2,3:35
661253,2022-08-02,2022,NYA,SEA,6,8,8-6,SEA,9,false,40,39,79,166,161,327,17,12,29,5,3:43 (:11 delay)
661367,2022-08-03,2022,MIA,CIN,3,0,3-0,MIA,9,true,33,31,64,105,112,217,11,7,18,1,2:09
661385,2022-08-03,2022,CHA,KCA,4,1,4-1,CHA,9,true,36,32,68,131,120,251,14,5,19,0,2:35 (1:05 delay)
661664,2022-08-03,2022,MIN,DET,4,1,4-1,MIN,9,true,33,33,66,128,128,256,10,7,17,0,2:40
661500,2022-08-03,2022,ATL,PHI,1,3,3-1,PHI,9,false,33,36,69,135,121,256,7,9,16,3,2:40
662725,2022-08-03,2022,HOU,BOS,6,1,6-1,HOU,9,true,36,33,69,126,137,263,13,6,19,1,2:42
661867,2022-08-03,2022,TBA,TOR,3,2,3-2,TBA,9,true,34,33,67,126,145,271,10,6,16,1,2:48
662055,2022-08-03,2022,SFN,LAN,0,3,3-0,LAN,9,false,37,37,74,141,133,274,11,10,21,2,3:06
661293,2022-08-03,2022,NYA,SEA,3,7,7-3,SEA,9,false,34,36,70,132,130,262,8,11,19,2,2:47
662946,2022-08-03,2022,CLE,ARI,7,4,7-4,CLE,9,true,36,36,72,162,142,304,13,9,22,1,3:03
662244,2022-08-03,2022,SDN,COL,9,1,9-1,SDN,9,true,39,34,73,161,152,313,16,7,23,0,3:04
661818,2022-08-03,2022,TEX,BAL,3,6,6-3,BAL,9,false,38,42,80,165,147,312,11,16,27,3,3:24
662324,2022-08-03,2022,PIT,MIL,8,7,8-7,PIT,9,false,38,43,81,174,151,325,15,17,32,6,3:49
662552,2022-08-03,2022,WAS,NYN,5,9,9-5,NYN,9,false,39,45,84,188,142,330,14,19,33,2,3:18
663375,2022-08-03,2022,ANA,OAK,1,3,3-1,OAK,9,false,36,36,72,138,136,274,9,9,18,2,3:08
661817,2022-08-04,2022,TEX,CHA,3,2,3-2,TEX,9,true,32,38,70,165,106,271,12,11,23,0,2:45
661565,2022-08-04,2022,PHI,WAS,5,4,5-4,PHI,5,false,19,25,44,79,71,150,7,11,18,0,1:39 (2:06 delay)
662651,2022-08-04,2022,KCA,BOS,7,3,7-3,KCA,9,true,36,35,71,147,138,285,14,10,24,0,3:04
662419,2022-08-04,2022,NYN,ATL,6,4,6-4,NYN,9,true,35,35,70,135,130,265,12,8,20,0,2:49
661945,2022-08-04,2022,SLN,CHN,4,3,4-3,SLN,9,false,33,38,71,139,125,264,9,10,19,2,2:51
662812,2022-08-04,2022,DET,TBA,2,6,6-2,TBA,9,false,34,42,76,142,126,268,6,17,23,0,2:59
662975,2022-08-04,2022,CLE,HOU,0,6,6-0,HOU,9,false,32,44,76,157,128,285,4,17,21,1,3:03
662219,2022-08-04,2022,SDN,COL,3,7,7-3,COL,9,false,39,39,78,163,175,338,15,15,30,2,3:41
662303,2022-08-04,2022,PIT,MIL,5,4,5-4,PIT,10,false,41,42,83,156,133,289,19,16,35,2,3:22
661932,2022-08-04,2022,SLN,CHN,7,2,7-2,SLN,9,true,41,32,73,140,176,316,20,8,28,0,3:08
663374,2022-08-04,2022,ANA,OAK,7,8,8-7,OAK,9,false,38,41,79,180,152,332,12,16,28,3,3:27
661945,2022-08-04,2022,SLN,CHN,4,3,4-3,SLN,9,false,33,38,71,139,125,264,9,10,19,2,2:51
662114,2022-08-04,2022,SFN,LAN,3,5,5-3,LAN,9,false,33,37,70,171,130,301,7,10,17,1,3:08
661660,2022-08-04,2022,MIN,TOR,3,9,9-3,TOR,9,false,36,44,80,194,143,337,9,19,28,1,3:34
662945,2022-08-05,2022,CLE,HOU,3,9,9-3,HOU,9,false,38,41,79,161,131,292,13,16,29,2,3:01
661174,2022-08-05,2022,MIL,CIN,5,1,5-1,MIL,9,true,38,37,75,140,155,295,14,12,26,2,3:14
661048,2022-08-05,2022,BAL,PIT,1,0,1-0,BAL,9,true,36,33,69,128,115,243,14,7,21,2,2:42 (1:49 delay)
662564,2022-08-05,2022,LAN,SDN,8,1,8-1,LAN,9,true,39,34,73,167,148,315,15,7,22,1,3:03
661562,2022-08-05,2022,PHI,WAS,7,2,7-2,PHI,9,true,35,33,68,124,123,247,12,7,19,1,2:46
661816,2022-08-05,2022,TEX,CHA,1,2,2-1,CHA,9,false,36,34,70,151,129,280,8,8,16,0,3:00
662164,2022-08-05,2022,SEA,ANA,3,4,4-3,ANA,10,false,42,38,80,150,181,331,14,11,25,1,3:36
662418,2022-08-05,2022,NYN,ATL,6,9,9-6,ATL,9,false,43,44,87,153,170,323,17,18,35,4,3:38
662811,2022-08-05,2022,DET,TBA,3,5,5-3,TBA,9,false,37,45,82,191,140,331,11,20,31,4,3:40
661063,2022-08-05,2022,CHN,MIA,2,1,2-1,CHN,9,true,32,39,71,169,146,315,9,11,20,4,3:20
663313,2022-08-05,2022,ARI,COL,6,5,6-5,ARI,9,true,37,40,77,136,157,293,14,13,27,2,3:02
662650,2022-08-05,2022,KCA,BOS,4,7,7-4,BOS,9,false,41,44,85,187,156,343,14,18,32,4,3:44
661946,2022-08-05,2022,SLN,NYA,4,3,4-3,SLN,9,true,35,39,74,156,141,297,11,15,26,3,3:19
661659,2022-08-05,2022,MIN,TOR,6,5,6-5,MIN,10,false,43,41,84,159,152,311,16,13,29,2,3:24
661062,2022-08-06,2022,CHN,MIA,4,0,4-0,CHN,9,true,36,32,68,130,131,261,13,6,19,2,2:46
661662,2022-08-06,2022,MIN,TOR,7,3,7-3,MIN,9,true,40,38,78,138,164,302,15,11,26,5,3:32
661815,2022-08-06,2022,TEX,CHA,8,0,8-0,TEX,9,true,38,30,68,134,175,309,13,3,16,1,3:00
662417,2022-08-06,2022,NYN,ATL,6,2,6-2,NYN,9,true,37,34,71,141,129,270,11,7,18,0,3:02
662154,2022-08-06,2022,SEA,ANA,2,1,2-1,SEA,9,true,34,35,69,112,145,257,10,8,18,2,2:48
662193,2022-08-06,2022,SEA,ANA,1,7,7-1,ANA,9,false,35,39,74,151,130,281,9,11,20,0,2:47
662937,2022-08-06,2022,CLE,HOU,4,1,4-1,CLE,9,true,35,33,68,130,109,239,11,7,18,0,2:30
661949,2022-08-06,2022,SLN,NYA,1,0,1-0,SLN,9,true,29,31,60,145,131,276,7,5,12,2,3:06
661050,2022-08-06,2022,BAL,PIT,6,3,6-3,BAL,9,true,42,35,77,131,163,294,18,9,27,3,3:17
663288,2022-08-06,2022,ARI,COL,2,3,3-2,COL,9,false,34,34,68,117,121,238,10,11,21,1,2:33
661561,2022-08-06,2022,PHI,WAS,11,5,11-5,PHI,9,true,42,44,86,174,186,360,18,18,36,2,3:39
661173,2022-08-06,2022,MIL,CIN,5,7,7-5,CIN,9,false,40,42,82,155,177,332,15,16,31,3,3:30
662499,2022-08-06,2022,NYN,ATL,8,5,8-5,NYN,9,true,44,44,88,165,172,337,22,18,40,5,3:53
662308,2022-08-06,2022,OAK,SFN,3,7,7-3,SFN,9,false,38,44,82,153,167,320,11,17,28,2,3:21
662649,2022-08-06,2022,KCA,BOS,5,4,5-4,KCA,9,false,33,36,69,130,126,256,8,9,17,0,2:44
662654,2022-08-06,2022,LAN,SDN,8,3,8-3,LAN,9,true,37,36,73,139,136,275,12,8,20,3,3:08
662856,2022-08-06,2022,DET,TBA,9,1,9-1,DET,9,true,36,39,75,153,123,276,13,12,25,2,2:54
662944,2022-08-07,2022,CLE,HOU,1,0,1-0,CLE,9,true,34,29,63,100,129,229,10,3,13,1,2:29
662563,2022-08-07,2022,LAN,SDN,4,0,4-0,LAN,9,true,35,30,65,114,137,251,11,4,15,0,2:48
662810,2022-08-07,2022,DET,TBA,0,7,7-0,TBA,9,false,30,41,71,151,110,261,3,15,18,1,2:50
661558,2022-08-07,2022,PHI,WAS,13,1,13-1,PHI,9,true,46,36,82,136,154,290,22,10,32,1,3:19
661061,2022-08-07,2022,CHN,MIA,0,3,3-0,MIA,9,false,31,36,67,137,121,258,4,11,15,0,2:36 (:56 delay)
661049,2022-08-07,2022,BAL,PIT,1,8,8-1,PIT,9,false,32,39,71,158,120,278,5,12,17,3,2:58
662416,2022-08-07,2022,NYN,ATL,5,2,5-2,NYN,9,true,37,30,67,120,150,270,14,3,17,2,2:58 (:20 delay)
661172,2022-08-07,2022,MIL,CIN,2,4,4-2,CIN,10,false,39,40,79,169,174,343,11,11,22,2,3:47
662153,2022-08-07,2022,SEA,ANA,6,3,6-3,SEA,9,true,36,35,71,130,161,291,13,9,22,1,2:54
662648,2022-08-07,2022,KCA,BOS,13,5,13-5,KCA,9,true,40,38,78,137,141,278,18,13,31,3,3:00
663300,2022-08-07,2022,ARI,COL,6,4,6-4,ARI,9,true,36,41,77,153,129,282,15,17,32,3,3:17
661835,2022-08-07,2022,TEX,CHA,2,8,8-2,CHA,9,false,40,45,85,156,172,328,14,17,31,1,3:27
662332,2022-08-07,2022,OAK,SFN,4,6,6-4,SFN,9,false,41,41,82,150,153,303,14,16,30,2,3:18
661948,2022-08-07,2022,SLN,NYA,12,9,12-9,SLN,9,true,44,48,92,207,173,380,20,22,42,5,4:25
661653,2022-08-07,2022,MIN,TOR,2,3,3-2,TOR,10,false,42,39,81,170,142,312,12,12,24,2,3:41
662331,2022-08-08,2022,OAK,ANA,0,1,1-0,ANA,9,false,31,30,61,109,112,221,4,5,9,0,2:14
662218,2022-08-08,2022,SDN,SFN,0,1,1-0,SFN,9,false,31,36,67,162,114,276,6,9,15,2,3:15
661047,2022-08-08,2022,BAL,TOR,7,4,7-4,BAL,9,true,33,41,74,148,116,264,13,15,28,4,2:55
663304,2022-08-08,2022,ARI,PIT,3,0,3-0,ARI,9,true,32,30,62,112,119,231,9,6,15,2,2:36
661060,2022-08-08,2022,CHN,WAS,6,3,6-3,CHN,9,true,37,36,73,140,142,282,15,10,25,1,2:48
662152,2022-08-08,2022,SEA,NYA,4,9,9-4,NYA,9,false,37,44,81,171,147,318,10,17,27,2,3:24
662445,2022-08-08,2022,NYN,CIN,5,1,5-1,NYN,9,true,36,39,75,133,133,266,13,12,25,1,2:56
662444,2022-08-09,2022,NYN,CIN,6,2,6-2,NYN,9,true,36,38,74,135,143,278,15,11,26,3,2:59 (:51 delay)
662647,2022-08-09,2022,KCA,CHA,4,2,4-2,KCA,9,true,35,36,71,132,113,245,10,9,19,2,2:36
662793,2022-08-09,2022,DET,CLE,2,5,5-2,CLE,9,false,36,37,73,119,127,246,9,12,21,1,2:41
662979,2022-08-09,2022,COL,SLN,16,5,16-5,COL,9,true,48,40,88,151,156,307,24,13,37,3,3:05
661046,2022-08-09,2022,BAL,TOR,6,5,6-5,BAL,9,true,38,38,76,133,130,263,15,12,27,2,3:02 (1:18 delay)
661553,2022-08-09,2022,PHI,MIA,4,1,4-1,PHI,9,true,31,36,67,144,123,267,10,9,19,1,2:46 (1:00 delay)
662246,2022-08-09,2022,SDN,SFN,7,4,7-4,SDN,9,false,39,40,79,153,160,313,15,14,29,3,3:32
661182,2022-08-09,2022,MIL,TBA,5,3,5-3,MIL,9,true,36,31,67,118,147,265,13,5,18,1,2:46
662779,2022-08-09,2022,KCA,CHA,2,3,3-2,CHA,9,false,34,37,71,146,129,275,7,11,18,2,2:54
662562,2022-08-09,2022,LAN,MIN,10,3,10-3,LAN,9,true,41,34,75,126,177,303,17,7,24,1,3:13
662724,2022-08-09,2022,HOU,TEX,7,5,7-5,HOU,9,true,33,38,71,153,115,268,10,12,22,1,2:49
663303,2022-08-09,2022,ARI,PIT,6,4,6-4,ARI,9,true,38,37,75,125,142,267,15,10,25,4,3:00
662330,2022-08-09,2022,OAK,ANA,1,5,5-1,ANA,9,false,35,43,78,162,141,303,10,15,25,2,3:15
661059,2022-08-09,2022,CHN,WAS,5,6,6-5,WAS,9,false,42,37,79,149,160,309,17,12,29,2,3:17
662148,2022-08-09,2022,SEA,NYA,1,0,1-0,SEA,13,false,45,42,87,178,189,367,14,9,23,1,4:07
663201,2022-08-09,2022,BOS,ATL,7,9,9-7,ATL,11,false,46,51,97,200,186,386,15,21,36,4,4:13
661207,2022-08-10,2022,MIL,TBA,4,3,4-3,MIL,10,false,38,36,74,126,150,276,12,7,19,1,3:03
661557,2022-08-10,2022,PHI,MIA,4,3,4-3,PHI,9,true,32,35,67,131,93,224,9,11,20,1,2:38
662791,2022-08-10,2022,DET,CLE,2,3,3-2,CLE,9,false,37,35,72,137,148,285,10,9,19,1,3:02
662185,2022-08-10,2022,SEA,NYA,4,3,4-3,SEA,9,true,29,36,65,144,122,266,6,9,15,2,2:44
662723,2022-08-10,2022,HOU,TEX,4,8,8-4,TEX,10,false,44,43,87,161,165,326,14,15,29,1,3:41
662639,2022-08-10,2022,KCA,CHA,8,3,8-3,KCA,9,true,40,38,78,153,150,303,18,10,28,2,3:19
663188,2022-08-10,2022,BOS,ATL,4,8,8-4,ATL,9,false,37,39,76,174,139,313,11,14,25,2,3:06
663229,2022-08-10,2022,CHN,WAS,4,2,4-2,CHN,9,true,34,36,70,134,126,260,11,10,21,3,2:45
662443,2022-08-10,2022,NYN,CIN,10,2,10-2,NYN,9,true,40,38,78,121,180,301,20,11,31,0,3:01
662217,2022-08-10,2022,SDN,SFN,13,7,13-7,SDN,9,true,43,43,86,154,165,319,19,18,37,4,3:32
662892,2022-08-10,2022,COL,SLN,5,9,9-5,SLN,9,false,41,46,87,169,153,322,15,21,36,1,3:21
662575,2022-08-10,2022,LAN,MIN,8,5,8-5,LAN,9,true,37,39,76,165,142,307,14,12,26,2,3:15
663302,2022-08-10,2022,ARI,PIT,4,6,6-4,PIT,9,false,36,41,77,159,147,306,11,16,27,2,3:12
662316,2022-08-10,2022,OAK,ANA,4,5,5-4,ANA,12,false,45,44,89,164,171,335,13,10,23,4,3:45
663023,2022-08-11,2022,CIN,CHN,2,4,4-2,CHN,9,false,37,41,78,161,151,312,11,16,27,2,3:21
661608,2022-08-11,2022,PHI,MIA,0,3,3-0,MIA,9,false,37,36,73,128,165,293,11,9,20,2,3:07
662722,2022-08-11,2022,HOU,TEX,7,3,7-3,HOU,9,true,37,38,75,156,139,295,13,11,24,1,2:53
663274,2022-08-11,2022,BOS,BAL,4,3,4-3,BOS,9,true,31,36,67,134,119,253,9,10,19,2,2:46
662891,2022-08-11,2022,COL,SLN,8,6,8-6,COL,9,true,37,40,77,176,142,318,15,15,30,3,3:15
663293,2022-08-11,2022,ARI,PIT,9,3,9-3,ARI,9,true,39,36,75,152,164,316,16,8,24,3,3:20
662645,2022-08-11,2022,KCA,CHA,5,3,5-3,KCA,9,true,35,41,76,145,153,298,12,15,27,3,3:11
662790,2022-08-11,2022,DET,CLE,3,4,4-3,CLE,10,false,40,43,83,168,161,329,11,12,23,3,3:37
661710,2022-08-12,2022,TOR,CLE,0,8,8-0,CLE,9,false,29,45,74,150,132,282,3,19,22,0,2:33
662817,2022-08-12,2022,HOU,OAK,7,5,7-5,HOU,9,true,37,38,75,140,142,282,15,15,30,4,3:19
662978,2022-08-12,2022,COL,ARI,5,3,5-3,COL,9,true,33,34,67,132,120,252,8,8,16,1,2:33
661384,2022-08-12,2022,CHA,DET,2,0,2-0,CHA,9,true,36,32,68,134,123,257,15,6,21,1,2:53
662434,2022-08-12,2022,NYN,PHI,1,2,2-1,PHI,10,false,35,40,75,137,120,257,9,11,20,0,2:54
661866,2022-08-12,2022,TBA,BAL,3,10,10-3,BAL,9,false,34,46,80,144,141,285,6,21,27,3,3:07
661366,2022-08-12,2022,MIA,ATL,3,4,4-3,ATL,9,false,43,34,77,148,186,334,19,8,27,2,3:37
661947,2022-08-12,2022,SLN,MIL,3,1,3-1,SLN,9,true,33,36,69,161,129,290,9,10,19,1,2:53
663177,2022-08-12,2022,BOS,NYA,3,2,3-2,BOS,10,false,37,41,78,168,145,313,12,13,25,1,3:24
663373,2022-08-12,2022,ANA,MIN,0,4,4-0,MIN,9,false,33,37,70,157,123,280,7,13,20,0,2:56
662551,2022-08-12,2022,WAS,SDN,5,10,10-5,SDN,9,false,44,49,93,195,190,385,17,20,37,3,4:03
662671,2022-08-12,2022,KCA,LAN,3,8,8-3,LAN,9,false,36,42,78,192,126,318,8,15,23,3,3:12
661791,2022-08-12,2022,TEX,SEA,2,6,6-2,SEA,9,false,36,44,80,198,139,337,11,17,28,3,3:44
662111,2022-08-12,2022,SFN,PIT,5,3,5-3,SFN,9,true,37,38,75,158,154,312,15,11,26,4,3:15
662428,2022-08-13,2022,NYN,PHI,1,0,1-0,NYN,9,true,28,32,60,130,96,226,5,5,10,0,2:24
661383,2022-08-13,2022,CHA,DET,6,4,6-4,CHA,9,true,39,37,76,124,129,253,15,12,27,2,2:46
662882,2022-08-13,2022,COL,ARI,0,6,6-0,ARI,9,false,31,38,69,131,139,270,5,13,18,1,2:47
663022,2022-08-13,2022,CIN,CHN,2,7,7-2,CHN,9,false,40,40,80,138,174,312,13,14,27,2,3:20
661360,2022-08-13,2022,MIA,ATL,2,6,6-2,ATL,9,false,36,38,74,157,147,304,9,12,21,3,3:12
661709,2022-08-13,2022,TOR,CLE,2,1,2-1,TOR,9,true,29,37,66,152,117,269,8,10,18,4,2:55
661865,2022-08-13,2022,TBA,BAL,8,2,8-2,TBA,9,true,40,40,80,151,153,304,16,13,29,3,3:22
661790,2022-08-13,2022,TEX,SEA,7,4,7-4,TEX,9,true,40,37,77,171,137,308,18,12,30,1,3:16
662824,2022-08-13,2022,HOU,OAK,8,0,8-0,HOU,9,true,36,33,69,138,143,281,15,9,24,1,2:51
663176,2022-08-13,2022,BOS,NYA,2,3,3-2,NYA,9,false,39,37,76,141,136,277,13,11,24,1,3:14
661951,2022-08-13,2022,SLN,MIL,2,3,3-2,MIL,10,false,36,35,71,125,139,264,6,5,11,0,3:01
661428,2022-08-13,2022,MIA,ATL,2,5,5-2,ATL,9,false,33,40,73,167,131,298,8,14,22,0,3:01
662670,2022-08-13,2022,KCA,LAN,3,13,13-3,LAN,9,false,38,48,86,175,153,328,12,22,34,2,3:05
662473,2022-08-13,2022,WAS,SDN,4,3,4-3,WAS,9,true,34,43,77,182,142,324,11,17,28,1,3:31
663372,2022-08-13,2022,ANA,MIN,5,3,5-3,ANA,11,false,40,48,88,203,138,341,13,19,32,1,3:46
662110,2022-08-13,2022,SFN,PIT,2,0,2-0,SFN,9,true,35,34,69,114,158,272,11,8,19,1,2:45
661864,2022-08-14,2022,TBA,BAL,4,1,4-1,TBA,9,true,33,29,62,95,137,232,10,1,11,4,2:37
663371,2022-08-14,2022,ANA,MIN,4,2,4-2,ANA,9,true,34,33,67,125,121,246,11,6,17,0,2:45
662669,2022-08-14,2022,KCA,LAN,4,0,4-0,KCA,9,true,33,34,67,158,126,284,10,8,18,1,2:49
662801,2022-08-14,2022,HOU,OAK,6,3,6-3,HOU,9,true,35,38,73,154,112,266,11,12,23,1,2:40
661957,2022-08-14,2022,SLN,MIL,6,3,6-3,SLN,9,true,33,32,65,115,123,238,10,6,16,1,2:17
661708,2022-08-14,2022,TOR,CLE,2,7,7-2,CLE,9,false,35,40,75,159,122,281,8,15,23,1,2:54
661338,2022-08-14,2022,MIA,ATL,1,3,3-1,ATL,9,false,35,43,78,178,136,314,8,20,28,0,3:08
663175,2022-08-14,2022,BOS,NYA,3,0,3-0,BOS,9,true,29,30,59,117,102,219,6,3,9,0,2:15
662035,2022-08-14,2022,SFN,PIT,8,7,8-7,SFN,9,false,42,42,84,162,157,319,18,16,34,3,3:26
661789,2022-08-14,2022,TEX,SEA,5,3,5-3,TEX,9,true,35,39,74,148,122,270,12,11,23,1,3:03
662881,2022-08-14,2022,COL,ARI,4,7,7-4,ARI,9,false,41,41,82,148,148,296,15,14,29,2,3:08
662427,2022-08-14,2022,NYN,PHI,6,0,6-0,NYN,9,true,36,39,75,172,138,310,13,12,25,2,3:22
662472,2022-08-14,2022,WAS,SDN,0,6,6-0,SDN,9,false,33,42,75,172,138,310,7,15,22,1,3:18
661450,2022-08-14,2022,CHA,DET,5,3,5-3,CHA,9,true,38,34,72,133,156,289,14,8,22,1,2:57
663021,2022-08-14,2022,CIN,CHN,8,5,8-5,CIN,9,true,42,43,85,161,189,350,18,17,35,4,3:29
662948,2022-08-15,2022,CLE,DET,5,7,7-5,DET,9,false,36,42,78,147,130,277,12,16,28,2,3:01
663370,2022-08-15,2022,ANA,SEA,2,6,6-2,SEA,9,false,36,42,78,154,156,310,10,14,24,2,3:26
661449,2022-08-15,2022,CHA,HOU,4,2,4-2,CHA,9,true,34,37,71,114,115,229,13,10,23,2,2:33
663020,2022-08-15,2022,CIN,PHI,3,4,4-3,PHI,9,false,34,42,76,171,95,266,9,15,24,1,2:53
661358,2022-08-15,2022,MIA,SDN,3,0,3-0,MIA,9,true,35,35,70,151,153,304,12,8,20,0,3:04
661283,2022-08-15,2022,NYA,TBA,0,4,4-0,TBA,9,false,34,38,72,172,121,293,9,12,21,3,3:21
662471,2022-08-15,2022,WAS,CHN,5,4,5-4,WAS,9,true,35,38,73,152,141,293,10,10,20,1,2:59
662034,2022-08-15,2022,SFN,ARI,6,1,6-1,SFN,9,true,36,37,73,145,133,278,12,12,24,2,3:00
661834,2022-08-15,2022,TEX,OAK,2,1,2-1,TEX,9,true,35,37,72,150,144,294,11,12,23,1,3:10
661707,2022-08-15,2022,TOR,BAL,3,7,7-3,BAL,9,false,38,40,78,166,145,311,13,14,27,3,3:20
662948,2022-08-15,2022,CLE,DET,5,7,7-5,DET,9,false,36,42,78,147,130,277,12,16,28,2,3:01
662977,2022-08-15,2022,CLE,DET,4,1,4-1,CLE,9,true,36,32,68,119,143,262,12,5,17,2,2:54
661497,2022-08-15,2022,ATL,NYN,13,1,13-1,ATL,9,true,43,35,78,156,162,318,19,8,27,3,3:18 (:55 delay)
661676,2022-08-15,2022,MIN,KCA,4,2,4-2,MIN,9,true,37,37,74,125,127,252,16,11,27,3,2:57
661199,2022-08-15,2022,MIL,LAN,0,4,4-0,LAN,9,false,33,39,72,176,151,327,6,11,17,0,3:12
662004,2022-08-16,2022,SFN,ARI,2,1,2-1,SFN,9,false,34,33,67,132,130,262,9,6,15,0,2:46
661250,2022-08-16,2022,NYA,TBA,1,3,3-1,TBA,9,false,32,31,63,125,147,272,5,4,9,2,2:51
662302,2022-08-16,2022,PIT,BOS,3,5,5-3,BOS,9,false,35,35,70,124,139,263,8,9,17,1,2:37
661357,2022-08-16,2022,MIA,SDN,4,3,4-3,MIA,9,true,33,42,75,192,128,320,10,16,26,3,3:33
661706,2022-08-16,2022,TOR,BAL,2,4,4-2,BAL,9,false,33,40,73,147,121,268,8,12,20,1,2:54
661495,2022-08-16,2022,ATL,NYN,5,0,5-0,ATL,9,true,35,30,65,130,126,256,14,5,19,3,2:51
661682,2022-08-16,2022,MIN,KCA,9,0,9-0,MIN,9,true,44,32,76,135,158,293,19,6,25,2,3:01
663369,2022-08-16,2022,ANA,SEA,2,8,8-2,SEA,9,false,36,38,74,150,148,298,10,11,21,1,3:04
661833,2022-08-16,2022,TEX,OAK,1,5,5-1,OAK,9,false,36,40,76,139,137,276,12,15,27,1,3:07
662943,2022-08-16,2022,CLE,DET,3,4,4-3,DET,9,false,37,41,78,164,146,310,10,15,25,1,3:20
661448,2022-08-16,2022,CHA,HOU,4,3,4-3,CHA,9,true,34,39,73,156,121,277,12,13,25,0,3:10
661955,2022-08-16,2022,SLN,COL,5,4,5-4,SLN,9,false,38,36,74,138,154,292,16,9,25,3,3:08
661191,2022-08-16,2022,MIL,LAN,5,4,5-4,MIL,11,false,44,44,88,191,188,379,13,11,24,1,3:52
662550,2022-08-16,2022,WAS,CHN,5,7,7-5,CHN,11,false,47,43,90,166,187,353,17,13,30,2,3:47
663019,2022-08-16,2022,CIN,PHI,4,11,11-4,PHI,9,false,35,47,82,171,139,310,9,20,29,2,3:20
663017,2022-08-17,2022,CIN,PHI,1,0,1-0,CIN,9,false,35,33,68,115,135,250,9,8,17,0,2:27
661938,2022-08-17,2022,SLN,COL,5,1,5-1,SLN,9,true,38,34,72,135,147,282,16,9,25,2,3:06
661788,2022-08-17,2022,TEX,OAK,2,7,7-2,OAK,9,false,37,40,77,147,139,286,11,13,24,2,3:00
661654,2022-08-17,2022,MIN,KCA,4,0,4-0,MIN,9,true,33,33,66,143,129,272,9,8,17,2,2:49
661171,2022-08-17,2022,MIL,LAN,1,2,2-1,LAN,9,false,34,33,67,135,139,274,8,9,17,0,2:49
661705,2022-08-17,2022,TOR,BAL,6,1,6-1,TOR,9,true,36,31,67,105,141,246,12,4,16,3,2:47
661447,2022-08-17,2022,CHA,HOU,2,3,3-2,HOU,9,false,36,35,71,133,135,268,12,8,20,0,3:06
662301,2022-08-17,2022,PIT,BOS,3,8,8-3,BOS,9,false,33,45,78,160,115,275,6,20,26,1,2:43
662470,2022-08-17,2022,WAS,CHN,2,3,3-2,CHN,9,false,33,34,67,132,149,281,7,7,14,2,2:56
662003,2022-08-17,2022,SFN,ARI,2,3,3-2,ARI,9,false,37,37,74,153,132,285,11,9,20,1,3:07
662951,2022-08-17,2022,CLE,DET,8,4,8-4,CLE,9,true,43,36,79,142,167,309,19,9,28,2,3:14
661266,2022-08-17,2022,NYA,TBA,8,7,8-7,NYA,10,false,41,46,87,171,152,323,15,16,31,4,3:48 (1:03 delay)
661494,2022-08-17,2022,ATL,NYN,7,9,9-7,NYN,9,false,37,43,80,168,144,312,12,16,28,3,3:22 (:34 delay)
661356,2022-08-17,2022,MIA,SDN,3,10,10-3,SDN,9,false,38,47,85,181,160,341,12,23,35,3,3:44
663408,2022-08-17,2022,ANA,SEA,7,11,11-7,SEA,9,false,40,45,85,174,148,322,13,18,31,2,3:14
661109,2022-08-18,2022,BAL,CHN,2,3,3-2,CHN,9,false,37,35,72,125,148,273,10,8,18,4,3:03
661493,2022-08-18,2022,ATL,NYN,3,2,3-2,ATL,9,true,30,33,63,122,119,241,6,6,12,2,2:41
661937,2022-08-18,2022,SLN,COL,13,0,13-0,SLN,9,true,43,30,73,111,161,272,20,5,25,1,2:45
661179,2022-08-18,2022,MIL,LAN,5,3,5-3,MIL,9,true,34,36,70,145,139,284,9,10,19,3,2:58
661863,2022-08-18,2022,TBA,KCA,7,1,7-1,TBA,9,true,37,36,73,138,142,280,14,9,23,2,2:48
662413,2022-08-18,2022,PIT,BOS,8,2,8-2,PIT,9,true,36,34,70,127,138,265,12,8,20,1,2:37
661109,2022-08-18,2022,BAL,CHN,2,3,3-2,CHN,9,false,37,35,72,125,148,273,10,8,18,4,3:03
661787,2022-08-18,2022,TEX,OAK,10,3,10-3,TEX,9,true,40,36,76,141,145,286,19,9,28,1,2:52
662182,2022-08-18,2022,SDN,WAS,1,3,3-1,WAS,9,false,36,35,71,113,171,284,10,8,18,3,3:19
662002,2022-08-18,2022,SFN,ARI,0,5,5-0,ARI,9,false,30,41,71,164,112,276,4,17,21,2,2:55
661265,2022-08-18,2022,NYA,TOR,2,9,9-2,TOR,9,false,37,43,80,163,127,290,10,16,26,1,3:09
661446,2022-08-18,2022,CHA,HOU,5,21,21-5,HOU,9,false,44,55,99,209,177,386,19,29,48,1,3:53
662808,2022-08-19,2022,DET,ANA,0,1,1-0,ANA,9,false,28,31,59,114,97,211,4,4,8,0,2:15
661655,2022-08-19,2022,MIN,TEX,2,1,2-1,MIN,9,true,32,34,66,142,121,263,8,8,16,1,2:54
663292,2022-08-19,2022,ARI,SLN,1,5,5-1,SLN,9,false,33,40,73,157,127,284,6,15,21,2,2:52
661319,2022-08-19,2022,NYA,TOR,0,4,4-0,TOR,9,false,32,37,69,132,113,245,5,10,15,2,2:52
662574,2022-08-19,2022,LAN,MIA,2,1,2-1,LAN,9,true,33,34,67,124,127,251,10,8,18,1,2:41
662341,2022-08-19,2022,OAK,SEA,2,10,10-2,SEA,9,false,35,44,79,154,120,274,9,17,26,2,2:44
662936,2022-08-19,2022,CLE,CHA,5,2,5-2,CLE,9,true,37,34,71,133,154,287,15,8,23,3,3:14
662396,2022-08-19,2022,PIT,CIN,5,4,5-4,PIT,9,false,40,35,75,120,126,246,17,7,24,3,2:48
663228,2022-08-19,2022,CHN,MIL,8,7,8-7,CHN,9,true,36,39,75,151,141,292,12,13,25,2,2:54
662880,2022-08-19,2022,COL,SFN,7,4,7-4,COL,9,true,36,37,73,153,135,288,12,10,22,2,2:56
661607,2022-08-19,2022,PHI,NYN,2,7,7-2,NYN,9,false,38,43,81,169,143,312,11,16,27,0,3:28
662181,2022-08-19,2022,SDN,WAS,3,6,6-3,WAS,9,false,37,42,79,166,158,324,9,14,23,3,3:46
661492,2022-08-19,2022,ATL,HOU,6,2,6-2,ATL,9,true,40,34,74,123,142,265,17,8,25,0,3:04
661862,2022-08-19,2022,TBA,KCA,2,3,3-2,KCA,10,false,36,37,73,136,140,276,10,8,18,0,2:48
661044,2022-08-19,2022,BAL,BOS,15,10,15-10,BAL,9,true,45,48,93,184,168,352,22,21,43,5,4:06
661628,2022-08-20,2022,PHI,NYN,2,8,8-2,NYN,9,false,37,43,80,186,145,331,10,18,28,4,3:42
662180,2022-08-20,2022,SDN,WAS,2,1,2-1,SDN,9,true,37,36,73,139,148,287,12,9,21,0,3:18
661240,2022-08-20,2022,NYA,TOR,2,5,5-2,TOR,9,false,38,35,73,147,146,293,10,10,20,0,3:11
661861,2022-08-20,2022,TBA,KCA,5,2,5-2,TBA,9,true,35,33,68,131,134,265,12,5,17,2,2:50
661606,2022-08-20,2022,PHI,NYN,4,1,4-1,PHI,9,true,39,35,74,130,177,307,14,9,23,3,3:23
661043,2022-08-20,2022,BAL,BOS,3,4,4-3,BOS,9,false,35,39,74,142,123,265,9,13,22,2,3:04
662917,2022-08-20,2022,DET,ANA,4,3,4-3,DET,9,true,38,35,73,139,123,262,14,9,23,1,2:40
662879,2022-08-20,2022,COL,SFN,4,3,4-3,COL,10,false,39,37,76,148,120,268,14,7,21,1,3:07
662395,2022-08-20,2022,PIT,CIN,1,10,10-1,CIN,9,false,38,46,84,171,164,335,12,17,29,1,3:34
662561,2022-08-20,2022,LAN,MIA,7,0,7-0,LAN,9,true,38,32,70,115,163,278,15,5,20,0,2:39
661628,2022-08-20,2022,PHI,NYN,2,8,8-2,NYN,9,false,37,43,80,186,145,331,10,18,28,4,3:42
662340,2022-08-20,2022,OAK,SEA,4,3,4-3,OAK,10,false,40,41,81,147,141,288,13,12,25,0,3:19
663291,2022-08-20,2022,ARI,SLN,7,16,16-7,SLN,9,false,41,49,90,181,157,338,14,23,37,4,3:43
661610,2022-08-20,2022,ATL,HOU,5,4,5-4,ATL,11,false,42,44,86,193,179,372,13,11,24,1,3:59
661670,2022-08-20,2022,MIN,TEX,3,4,4-3,TEX,10,false,42,43,85,153,162,315,11,13,24,2,3:27
663116,2022-08-20,2022,CHN,MIL,6,5,6-5,CHN,11,false,47,45,92,154,192,346,16,12,28,3,3:51 (:41 delay)
662953,2022-08-20,2022,CLE,CHA,0,2,2-0,CHA,9,false,33,35,68,128,119,247,6,9,15,2,2:39 (2:55 delay)
662179,2022-08-21,2022,SDN,WAS,2,1,2-1,SDN,9,true,32,33,65,99,125,224,11,7,18,1,2:30
662805,2022-08-21,2022,DET,ANA,4,0,4-0,DET,9,true,35,37,72,140,141,281,12,10,22,0,2:56
661051,2022-08-21,2022,BAL,BOS,5,3,5-3,BAL,9,true,39,33,72,134,167,301,15,9,24,6,3:23
661480,2022-08-21,2022,ATL,HOU,4,5,5-4,HOU,9,false,34,41,75,156,125,281,9,14,23,1,3:11
661860,2022-08-21,2022,TBA,KCA,3,2,3-2,TBA,9,true,33,36,69,152,120,272,11,8,19,3,2:59
661239,2022-08-21,2022,NYA,TOR,4,2,4-2,NYA,9,true,33,36,69,154,132,286,9,9,18,2,2:59
662300,2022-08-21,2022,PIT,CIN,5,9,9-5,CIN,9,false,38,45,83,156,151,307,12,20,32,3,3:22
661652,2022-08-21,2022,MIN,TEX,0,7,7-0,TEX,9,false,31,40,71,142,114,256,5,15,20,2,2:54
662600,2022-08-21,2022,LAN,MIA,10,3,10-3,LAN,9,true,44,36,80,136,187,323,21,10,31,2,3:18
663115,2022-08-21,2022,CHN,MIL,2,5,5-2,MIL,9,false,33,35,68,158,151,309,7,10,17,2,3:04
662315,2022-08-21,2022,OAK,SEA,5,3,5-3,OAK,9,true,36,38,74,171,142,313,15,13,28,3,3:28
661602,2022-08-21,2022,PHI,NYN,9,10,10-9,NYN,9,false,45,48,93,206,189,395,19,22,41,2,4:26 (:46 delay)
663301,2022-08-21,2022,ARI,SLN,4,6,6-4,SLN,9,false,39,43,82,160,144,304,13,19,32,5,3:35
662878,2022-08-21,2022,COL,SFN,8,9,9-8,SFN,11,false,45,48,93,160,162,322,13,14,27,5,3:47
661601,2022-08-22,2022,PHI,CIN,4,1,4-1,PHI,9,true,34,32,66,118,130,248,10,6,16,1,2:40 (:57 delay)
662394,2022-08-22,2022,PIT,ATL,1,2,2-1,ATL,9,false,32,33,65,116,132,248,6,7,13,0,2:40 (1:02 delay)
661658,2022-08-22,2022,MIN,TEX,1,2,2-1,TEX,9,false,35,32,67,107,162,269,10,7,17,1,2:58
663114,2022-08-22,2022,CHN,SLN,0,1,1-0,SLN,9,false,28,32,60,126,99,225,1,7,8,0,2:16
661859,2022-08-22,2022,TBA,ANA,2,1,2-1,TBA,9,true,34,37,71,141,143,284,12,10,22,1,3:00
662594,2022-08-22,2022,LAN,MIL,0,4,4-0,MIL,9,false,36,36,72,144,159,303,11,9,20,1,3:02
662767,2022-08-22,2022,KCA,CHA,6,4,6-4,KCA,9,true,38,42,80,165,165,330,16,18,34,6,3:36
662314,2022-08-22,2022,OAK,MIA,0,3,3-0,MIA,9,false,32,39,71,173,116,289,6,13,19,0,2:44
661238,2022-08-22,2022,NYA,NYN,4,2,4-2,NYA,9,true,34,32,66,119,119,238,10,6,16,3,2:48
662383,2022-08-23,2022,PIT,ATL,1,6,6-1,ATL,9,false,31,37,68,132,104,236,4,11,15,1,2:15
662339,2022-08-23,2022,OAK,MIA,3,5,5-3,MIA,9,false,36,36,72,137,137,274,11,9,20,2,2:46
662914,2022-08-23,2022,DET,SFN,1,3,3-1,SFN,9,false,33,35,68,136,136,272,8,10,18,0,2:52
661237,2022-08-23,2022,NYA,NYN,4,2,4-2,NYA,9,true,35,39,74,157,136,293,13,14,27,3,3:23
663163,2022-08-23,2022,CHN,SLN,2,0,2-0,CHN,9,true,34,38,72,170,131,301,9,10,19,2,3:09
662142,2022-08-23,2022,SEA,WAS,4,2,4-2,SEA,9,true,32,33,65,145,132,277,8,7,15,2,2:48
662605,2022-08-23,2022,LAN,MIL,10,1,10-1,LAN,9,true,42,32,74,130,165,295,17,6,23,2,3:02
663113,2022-08-23,2022,CHN,SLN,3,13,13-3,SLN,9,false,35,49,84,187,119,306,8,25,33,5,3:15
662800,2022-08-23,2022,HOU,MIN,4,2,4-2,HOU,9,true,36,35,71,154,135,289,14,8,22,4,3:19
662213,2022-08-23,2022,SDN,CLE,1,3,3-1,CLE,9,false,38,34,72,137,169,306,11,7,18,2,3:20
661600,2022-08-23,2022,PHI,CIN,7,6,7-6,PHI,9,false,36,42,78,153,136,289,11,15,26,2,3:12
661858,2022-08-23,2022,TBA,ANA,11,1,11-1,TBA,9,true,42,34,76,123,170,293,18,7,25,3,2:57
662668,2022-08-23,2022,KCA,ARI,3,7,7-3,ARI,9,false,34,48,82,187,133,320,8,22,30,4,3:29
663461,2022-08-23,2022,BAL,CHA,5,3,5-3,BAL,9,true,31,43,74,167,139,306,8,16,24,5,3:36
662876,2022-08-23,2022,COL,TEX,7,6,7-6,COL,9,true,36,37,73,135,127,262,13,11,24,0,2:37
663174,2022-08-23,2022,BOS,TOR,3,9,9-3,TOR,9,false,41,44,85,172,150,322,14,18,32,3,3:18 (1:01 delay)
662799,2022-08-24,2022,HOU,MIN,5,3,5-3,HOU,9,true,31,36,67,139,116,255,10,9,19,0,2:40
662640,2022-08-24,2022,KCA,ARI,5,3,5-3,KCA,9,true,34,32,66,140,138,278,10,6,16,2,2:59
662916,2022-08-24,2022,DET,SFN,6,1,6-1,DET,9,true,35,38,73,152,151,303,10,11,21,1,2:53
663216,2022-08-24,2022,CHN,SLN,7,1,7-1,CHN,9,true,35,36,71,139,129,268,12,9,21,2,2:46
662144,2022-08-24,2022,SEA,WAS,1,3,3-1,WAS,9,false,35,36,71,113,148,261,10,11,21,3,2:57
663460,2022-08-24,2022,BAL,CHA,3,5,5-3,CHA,9,false,34,46,80,173,136,309,9,19,28,4,3:24
662371,2022-08-24,2022,PIT,ATL,2,14,14-2,ATL,9,false,35,50,85,207,111,318,8,23,31,2,3:08
662212,2022-08-24,2022,SDN,CLE,0,7,7-0,CLE,9,false,34,41,75,159,121,280,7,15,22,1,3:02
663173,2022-08-24,2022,BOS,TOR,2,3,3-2,TOR,10,false,41,40,81,130,157,287,15,11,26,1,3:12
661857,2022-08-24,2022,TBA,ANA,4,3,4-3,TBA,11,false,41,44,85,182,162,344,11,11,22,1,3:40
662604,2022-08-24,2022,LAN,MIL,12,6,12-6,LAN,9,true,43,41,84,147,174,321,19,14,33,3,3:07
662338,2022-08-24,2022,OAK,MIA,3,2,3-2,OAK,10,false,34,38,72,136,134,270,6,8,14,1,2:40
662877,2022-08-24,2022,COL,TEX,4,16,16-4,TEX,9,false,36,50,86,183,139,322,10,23,33,2,3:08
661605,2022-08-24,2022,PHI,CIN,7,5,7-5,PHI,9,true,44,39,83,143,164,307,22,12,34,3,3:16
661604,2022-08-25,2022,PHI,CIN,4,0,4-0,PHI,9,true,32,33,65,101,127,228,9,6,15,1,2:36
662141,2022-08-25,2022,SEA,CLE,3,1,3-1,SEA,9,true,32,33,65,155,139,294,9,7,16,1,2:46
662433,2022-08-25,2022,NYN,COL,3,1,3-1,NYN,9,true,36,36,72,136,145,281,13,9,22,2,2:58
662711,2022-08-25,2022,HOU,MIN,6,3,6-3,HOU,9,true,35,33,68,139,157,296,14,8,22,0,3:11
661856,2022-08-25,2022,TBA,ANA,8,3,8-3,TBA,9,true,38,37,75,146,137,283,13,11,24,1,3:00
662337,2022-08-25,2022,OAK,NYA,4,13,13-4,NYA,9,false,40,53,93,201,160,361,13,26,39,4,3:34
663172,2022-08-25,2022,BOS,TOR,5,6,6-5,TOR,10,false,46,48,94,190,182,372,19,20,39,3,4:22
663459,2022-08-25,2022,BAL,CHA,4,3,4-3,BAL,11,false,39,41,80,141,157,298,9,11,20,0,3:29
663240,2022-08-25,2022,CHN,SLN,3,8,8-3,SLN,9,false,36,44,80,150,138,288,10,18,28,1,2:52
661445,2022-08-26,2022,CHA,ARI,2,7,7-2,ARI,9,false,35,37,72,140,135,275,10,10,20,0,2:40
662342,2022-08-26,2022,OAK,NYA,2,3,3-2,NYA,9,false,35,40,75,136,136,272,7,17,24,1,2:50
661669,2022-08-26,2022,MIN,SFN,9,0,9-0,MIN,9,true,38,32,70,147,147,294,14,8,22,0,2:55
662432,2022-08-26,2022,NYN,COL,7,6,7-6,NYN,9,false,40,39,79,119,147,266,15,14,29,1,3:09
662710,2022-08-26,2022,HOU,BAL,0,2,2-0,BAL,9,false,33,37,70,144,113,257,7,11,18,1,2:57
662469,2022-08-26,2022,WAS,CIN,3,7,7-3,CIN,9,false,36,40,76,162,142,304,10,14,24,1,3:07
661189,2022-08-26,2022,MIL,CHN,3,4,4-3,CHN,10,false,42,34,76,150,169,319,14,4,18,3,3:16
662143,2022-08-26,2022,SEA,CLE,3,2,3-2,SEA,11,false,39,43,82,157,141,298,11,13,24,2,3:29
663171,2022-08-26,2022,BOS,TBA,9,8,9-8,BOS,9,true,43,39,82,144,171,315,19,13,32,2,3:30
661603,2022-08-26,2022,PHI,PIT,7,4,7-4,PHI,9,true,36,33,69,113,154,267,11,8,19,1,2:55
661786,2022-08-26,2022,TEX,DET,7,6,7-6,TEX,9,true,35,40,75,157,143,300,13,12,25,0,3:03
661940,2022-08-26,2022,SLN,ATL,4,11,11-4,ATL,9,false,40,47,87,185,170,355,14,23,37,4,3:43
661704,2022-08-26,2022,TOR,ANA,0,12,12-0,ANA,9,false,39,46,85,159,184,343,12,18,30,1,3:20
662667,2022-08-26,2022,KCA,SDN,5,13,13-5,SDN,9,false,41,49,90,190,143,333,14,23,37,3,3:37
661355,2022-08-26,2022,MIA,LAN,6,10,10-6,LAN,10,false,45,51,96,237,166,403,12,21,33,3,4:18
661354,2022-08-27,2022,MIA,LAN,2,1,2-1,MIA,9,true,29,34,63,111,107,218,7,8,15,0,2:17
663170,2022-08-27,2022,BOS,TBA,5,1,5-1,BOS,9,true,31,35,66,141,107,248,9,8,17,1,2:24
662140,2022-08-27,2022,SEA,CLE,3,4,4-3,CLE,9,false,30,36,66,168,117,285,3,8,11,0,2:48
661599,2022-08-27,2022,PHI,PIT,6,0,6-0,PHI,9,true,39,33,72,125,149,274,16,8,24,0,2:59
662666,2022-08-27,2022,KCA,SDN,3,4,4-3,SDN,9,false,37,37,74,148,130,278,10,12,22,0,2:59
662442,2022-08-27,2022,NYN,COL,3,0,3-0,NYN,9,true,34,32,66,144,143,287,11,5,16,0,2:54
661090,2022-08-27,2022,HOU,BAL,1,3,3-1,BAL,9,false,29,35,64,157,111,268,4,11,15,2,2:55
661703,2022-08-27,2022,TOR,ANA,0,2,2-0,ANA,9,false,31,37,68,155,133,288,3,11,14,0,3:20
661444,2022-08-27,2022,CHA,ARI,5,10,10-5,ARI,9,false,34,46,80,183,126,309,8,19,27,4,3:32
661785,2022-08-27,2022,TEX,DET,2,11,11-2,DET,9,false,36,47,83,173,122,295,13,21,34,2,3:00
662336,2022-08-27,2022,OAK,NYA,3,2,3-2,OAK,11,false,41,36,77,135,134,269,8,7,15,3,3:07
661180,2022-08-27,2022,MIL,CHN,7,0,7-0,MIL,9,true,40,35,75,152,154,306,15,9,24,1,3:04
662468,2022-08-27,2022,WAS,CIN,2,6,6-2,CIN,9,false,36,39,75,163,143,306,11,13,24,2,3:05
661939,2022-08-27,2022,SLN,ATL,6,5,6-5,SLN,9,false,42,37,79,133,159,292,17,11,28,1,3:20
661657,2022-08-27,2022,MIN,SFN,3,2,3-2,MIN,10,false,44,38,82,168,190,358,18,9,27,2,3:57 (:51 delay)
662467,2022-08-28,2022,WAS,CIN,3,2,3-2,WAS,9,true,31,33,64,117,123,240,9,6,15,0,2:21
662139,2022-08-28,2022,SEA,CLE,4,0,4-0,SEA,9,true,31,31,62,132,118,250,7,5,12,1,2:31
661950,2022-08-28,2022,SLN,ATL,6,3,6-3,SLN,9,true,33,36,69,128,132,260,9,10,19,4,3:06 (:59 delay)
661443,2022-08-28,2022,CHA,ARI,2,3,3-2,ARI,9,false,37,32,69,119,138,257,12,6,18,1,2:50
661598,2022-08-28,2022,PHI,PIT,0,5,5-0,PIT,9,false,34,36,70,137,134,271,7,10,17,1,2:51
662446,2022-08-28,2022,NYN,COL,0,1,1-0,COL,9,false,32,36,68,145,130,275,5,10,15,0,2:50
661089,2022-08-28,2022,HOU,BAL,3,1,3-1,HOU,9,true,33,34,67,147,138,285,10,9,19,2,3:08
662335,2022-08-28,2022,OAK,NYA,4,1,4-1,OAK,9,true,33,34,67,159,148,307,11,7,18,4,3:19
661773,2022-08-28,2022,TOR,ANA,3,8,8-3,ANA,9,false,41,43,84,150,176,326,16,15,31,3,3:16
661784,2022-08-28,2022,TEX,DET,8,9,9-8,DET,9,false,41,44,85,185,155,340,14,18,32,3,3:35
661168,2022-08-28,2022,MIL,CHN,9,7,9-7,MIL,9,true,42,43,85,172,173,345,20,17,37,4,3:24
661353,2022-08-28,2022,MIA,LAN,1,8,8-1,LAN,9,false,33,44,77,168,147,315,6,19,25,1,3:14
661663,2022-08-28,2022,MIN,SFN,8,3,8-3,MIN,9,true,37,40,77,180,155,335,14,14,28,3,3:27
662638,2022-08-28,2022,KCA,SDN,15,7,15-7,KCA,9,true,50,44,94,189,197,386,25,16,41,5,4:00
663211,2022-08-28,2022,BOS,TBA,4,12,12-4,TBA,9,false,40,49,89,199,132,331,14,23,37,0,3:14
663424,2022-08-29,2022,ANA,NYA,4,3,4-3,ANA,9,true,33,36,69,130,111,241,10,11,21,3,3:00
662001,2022-08-29,2022,SFN,SDN,5,6,6-5,SDN,9,false,39,39,78,163,162,325,14,13,27,1,3:44 (:40 delay)
661651,2022-08-29,2022,MIN,BOS,4,2,4-2,MIN,9,true,36,38,74,141,161,302,13,11,24,3,3:27
661352,2022-08-29,2022,MIA,LAN,2,3,3-2,LAN,10,false,42,41,83,150,165,315,11,11,22,2,3:27
663018,2022-08-29,2022,CIN,SLN,4,13,13-4,SLN,9,false,36,46,82,169,144,313,11,18,29,3,3:01 (2:07 delay)
661167,2022-08-29,2022,MIL,PIT,7,5,7-5,MIL,9,false,39,40,79,164,173,337,16,14,30,2,3:32
661801,2022-08-29,2022,TOR,CHN,5,4,5-4,TOR,11,false,45,44,89,168,161,329,17,17,34,3,3:43
663332,2022-08-29,2022,ARI,PHI,13,7,13-7,ARI,9,true,44,41,85,161,179,340,19,15,34,3,3:35
661832,2022-08-30,2022,TEX,HOU,2,4,4-2,HOU,9,false,33,40,73,149,119,268,7,14,21,1,2:56
663137,2022-08-30,2022,CIN,SLN,5,1,5-1,CIN,9,true,34,32,66,132,124,256,12,6,18,1,2:33
663437,2022-08-30,2022,ANA,NYA,4,7,7-4,NYA,9,false,33,40,73,150,138,288,7,12,19,3,2:59
662973,2022-08-30,2022,CLE,BAL,5,1,5-1,CLE,9,true,35,32,67,133,134,267,11,5,16,2,2:37
661351,2022-08-30,2022,MIA,TBA,2,7,7-2,TBA,9,false,34,44,78,149,144,293,10,17,27,1,3:12
662426,2022-08-30,2022,NYN,LAN,3,4,4-3,LAN,9,false,37,43,80,165,139,304,12,17,29,2,3:12
661648,2022-08-30,2022,MIN,BOS,10,5,10-5,MIN,9,true,40,38,78,152,149,301,16,12,28,3,3:27
662466,2022-08-30,2022,WAS,OAK,6,10,10-6,OAK,9,false,40,45,85,186,153,339,14,19,33,3,3:24
661166,2022-08-30,2022,MIL,PIT,2,4,4-2,PIT,9,false,34,39,73,149,141,290,9,15,24,1,2:43
662804,2022-08-30,2022,DET,SEA,3,9,9-3,SEA,9,false,36,40,76,165,140,305,8,13,21,1,2:53
662000,2022-08-30,2022,SFN,SDN,3,4,4-3,SDN,9,false,40,40,80,171,159,330,13,12,25,3,3:35
663286,2022-08-30,2022,ARI,PHI,12,3,12-3,ARI,9,true,44,31,75,117,158,275,19,6,25,0,2:59
661800,2022-08-30,2022,TOR,CHN,5,3,5-3,TOR,9,true,36,36,72,148,146,294,12,11,23,3,3:03
661479,2022-08-30,2022,ATL,COL,2,3,3-2,COL,9,false,39,40,79,164,161,325,11,12,23,0,3:34
661442,2022-08-30,2022,CHA,KCA,7,9,9-7,KCA,9,false,42,42,84,175,158,333,15,16,31,4,3:21
662972,2022-08-31,2022,CLE,BAL,0,4,4-0,BAL,9,false,34,37,71,156,115,271,8,11,19,3,2:54
661779,2022-08-31,2022,TOR,CHN,5,7,7-5,CHN,9,false,37,36,73,147,137,284,10,11,21,5,3:07
662033,2022-08-31,2022,SFN,SDN,4,5,5-4,SDN,9,false,36,38,74,156,137,293,10,13,23,3,3:13
661831,2022-08-31,2022,TEX,HOU,3,5,5-3,HOU,9,false,36,45,81,172,141,313,9,18,27,0,3:23
661478,2022-08-31,2022,ATL,COL,3,2,3-2,ATL,9,true,31,35,66,123,122,245,9,9,18,1,2:29
661441,2022-08-31,2022,CHA,KCA,4,2,4-2,CHA,9,true,36,33,69,121,142,263,15,7,22,1,2:43
663410,2022-08-31,2022,ANA,NYA,3,2,3-2,ANA,9,true,30,34,64,125,108,233,7,8,15,0,2:43
661350,2022-08-31,2022,MIA,TBA,1,2,2-1,TBA,10,false,37,40,77,145,127,272,8,13,21,0,3:07
662465,2022-08-31,2022,WAS,OAK,5,1,5-1,WAS,9,true,35,35,70,130,135,265,11,10,21,1,2:51
661165,2022-08-31,2022,MIL,PIT,6,1,6-1,MIL,9,true,43,33,76,135,180,315,19,5,24,2,3:16
662447,2022-08-31,2022,NYN,LAN,2,1,2-1,NYN,9,true,31,31,62,118,101,219,8,4,12,0,2:19
662903,2022-08-31,2022,DET,SEA,3,5,5-3,SEA,9,false,39,39,78,154,141,295,13,12,25,1,3:00
661649,2022-08-31,2022,MIN,BOS,5,6,6-5,BOS,9,false,38,43,81,166,151,317,12,15,27,0,3:19
663312,2022-08-31,2022,ARI,PHI,2,18,18-2,PHI,9,false,34,57,91,189,108,297,8,32,40,3,3:26
662995,2022-08-31,2022,CIN,SLN,3,5,5-3,SLN,13,false,57,53,110,223,195,418,24,16,40,5,4:48
663290,2022-09-01,2022,ARI,MIL,5,0,5-0,ARI,9,true,37,30,67,117,124,241,13,4,17,1,2:28
662971,2022-09-01,2022,CLE,BAL,0,3,3-0,BAL,9,false,33,35,68,136,123,259,6,8,14,0,2:41
661477,2022-09-01,2022,ATL,COL,3,0,3-0,ATL,9,true,30,30,60,114,126,240,6,2,8,1,2:23
663210,2022-09-01,2022,BOS,TEX,9,8,9-8,BOS,9,false,44,47,91,184,185,369,21,20,41,3,3:41
661440,2022-09-01,2022,CHA,KCA,7,1,7-1,CHA,9,true,38,39,77,166,146,312,14,10,24,4,3:22
662410,2022-09-01,2022,NYN,LAN,5,3,5-3,NYN,9,true,34,37,71,153,141,294,10,12,22,0,3:14
662785,2022-09-01,2022,DET,SEA,0,7,7-0,SEA,9,false,32,42,74,174,112,286,5,15,20,0,2:47
662491,2022-09-01,2022,WAS,OAK,7,5,7-5,WAS,10,false,47,44,91,166,180,346,18,16,34,4,4:02
663133,2022-09-02,2022,CIN,COL,3,2,3-2,CIN,9,false,37,33,70,131,154,285,15,9,24,1,2:58
662356,2022-09-02,2022,PIT,TOR,0,4,4-0,TOR,9,false,32,42,74,178,120,298,6,17,23,1,3:24
663212,2022-09-02,2022,BOS,TEX,9,1,9-1,BOS,9,true,42,35,77,114,176,290,19,9,28,2,3:11
661476,2022-09-02,2022,ATL,MIA,8,1,8-1,ATL,9,true,38,34,72,138,158,296,15,8,23,2,2:57
661855,2022-09-02,2022,TBA,NYA,9,0,9-0,TBA,9,true,40,37,77,151,150,301,17,9,26,5,3:24
663285,2022-09-02,2022,ARI,MIL,2,1,2-1,ARI,9,true,29,39,68,171,111,282,7,13,20,2,2:51
662961,2022-09-02,2022,CLE,SEA,1,6,6-1,SEA,9,false,36,40,76,154,140,294,11,12,23,1,2:57
661920,2022-09-02,2022,SLN,CHN,8,0,8-0,SLN,9,true,38,35,73,132,169,301,15,9,24,1,3:06
663356,2022-09-02,2022,BAL,OAK,5,2,5-2,BAL,9,true,36,32,68,124,117,241,14,7,21,2,2:46
662915,2022-09-02,2022,DET,KCA,5,4,5-4,DET,9,true,37,36,73,129,147,276,14,10,24,2,3:00
661439,2022-09-02,2022,CHA,MIN,4,3,4-3,CHA,9,false,39,38,77,150,134,284,14,13,27,0,3:17
663428,2022-09-02,2022,ANA,HOU,2,4,4-2,HOU,9,false,39,38,77,139,140,279,12,11,23,3,3:09
662032,2022-09-02,2022,SFN,PHI,13,1,13-1,SFN,9,true,46,32,78,106,200,306,22,6,28,2,3:05
662409,2022-09-02,2022,NYN,WAS,7,3,7-3,NYN,9,true,36,40,76,161,141,302,15,12,27,2,3:09
662603,2022-09-02,2022,LAN,SDN,1,7,7-1,SDN,9,false,36,43,79,173,155,328,9,17,26,1,3:30
662286,2022-09-03,2022,PIT,TOR,1,4,4-1,TOR,9,false,34,39,73,159,114,273,8,11,19,3,3:06
662803,2022-09-03,2022,DET,KCA,2,12,12-2,KCA,9,false,37,45,82,163,135,298,11,19,30,1,2:59
663355,2022-09-03,2022,BAL,OAK,8,1,8-1,BAL,9,true,39,36,75,145,157,302,15,10,25,3,3:17
662031,2022-09-03,2022,SFN,PHI,5,4,5-4,SFN,9,true,40,39,79,148,170,318,16,15,31,5,3:33
663214,2022-09-03,2022,BOS,TEX,5,3,5-3,BOS,9,true,38,38,76,139,156,295,12,11,23,1,3:12
661854,2022-09-03,2022,TBA,NYA,2,1,2-1,TBA,9,true,31,31,62,116,109,225,10,3,13,3,2:39
661438,2022-09-03,2022,CHA,MIN,13,0,13-0,CHA,9,true,40,29,69,103,140,243,17,3,20,1,2:21
662425,2022-09-03,2022,NYN,WAS,1,7,7-1,WAS,9,false,33,41,74,150,116,266,6,17,23,1,2:52
661475,2022-09-03,2022,ATL,MIA,2,1,2-1,ATL,9,false,36,34,70,130,156,286,13,8,21,1,3:05
661928,2022-09-03,2022,SLN,CHN,8,4,8-4,SLN,9,true,39,37,76,125,162,287,16,14,30,1,3:02
662963,2022-09-03,2022,CLE,SEA,0,4,4-0,SEA,9,false,36,41,77,167,139,306,11,14,25,1,3:19
663436,2022-09-03,2022,ANA,HOU,2,1,2-1,ANA,12,false,45,44,89,157,169,326,11,9,20,2,4:11
663321,2022-09-03,2022,ARI,MIL,6,8,8-6,MIL,10,false,43,46,89,178,199,377,14,16,30,3,4:12
662597,2022-09-03,2022,LAN,SDN,12,1,12-1,LAN,9,true,42,32,74,104,158,262,18,5,23,1,2:42
663354,2022-09-04,2022,BAL,OAK,0,5,5-0,OAK,9,false,34,38,72,117,144,261,9,12,21,2,2:59
662424,2022-09-04,2022,NYN,WAS,1,7,7-1,WAS,9,false,34,41,75,133,138,271,8,16,24,1,2:54
662030,2022-09-04,2022,SFN,PHI,5,3,5-3,SFN,9,false,38,38,76,153,165,318,13,11,24,0,3:10
661927,2022-09-04,2022,SLN,CHN,2,0,2-0,SLN,9,true,30,29,59,109,114,223,7,4,11,1,2:22 (1:28 delay)
663311,2022-09-04,2022,ARI,MIL,5,1,5-1,ARI,9,true,36,32,68,128,144,272,13,5,18,1,2:39
663435,2022-09-04,2022,ANA,HOU,1,9,9-1,HOU,9,false,34,41,75,132,146,278,8,16,24,1,2:43
661474,2022-09-04,2022,ATL,MIA,7,1,7-1,ATL,9,true,39,32,71,124,170,294,17,6,23,1,2:59 (1:51 delay)
663108,2022-09-04,2022,CIN,COL,10,0,10-0,CIN,9,true,37,36,73,158,131,289,13,12,25,3,2:49 (:10 delay)
663213,2022-09-04,2022,BOS,TEX,5,2,5-2,BOS,9,true,38,34,72,157,143,300,17,8,25,2,3:07
662299,2022-09-04,2022,PIT,TOR,3,4,4-3,TOR,9,false,36,40,76,151,150,301,9,15,24,1,3:02
663107,2022-09-04,2022,CIN,COL,4,8,8-4,COL,9,false,35,41,76,177,125,302,9,14,23,1,2:58
661853,2022-09-04,2022,TBA,NYA,1,2,2-1,NYA,9,false,37,40,77,138,172,310,8,10,18,3,3:37
662786,2022-09-04,2022,DET,KCA,2,3,3-2,KCA,9,false,36,43,79,179,157,336,12,18,30,4,3:39
662962,2022-09-04,2022,CLE,SEA,3,6,6-3,SEA,11,false,46,47,93,185,151,336,18,16,34,3,3:47 (4:33 delay)
662599,2022-09-04,2022,LAN,SDN,9,4,9-4,LAN,9,true,41,42,83,202,151,353,16,15,31,7,4:08
663108,2022-09-04,2022,CIN,COL,10,0,10-0,CIN,9,true,37,36,73,158,131,289,13,12,25,3,2:49 (:10 delay)
661437,2022-09-04,2022,CHA,MIN,1,5,5-1,MIN,9,false,34,41,75,165,123,288,8,14,22,2,3:21
662121,2022-09-05,2022,SEA,CHA,2,3,3-2,CHA,9,false,35,35,70,126,146,272,8,7,15,0,2:48
661045,2022-09-05,2022,BAL,TOR,4,8,8-4,TOR,9,false,39,40,79,145,136,281,12,13,25,2,2:57
663434,2022-09-05,2022,ANA,DET,10,0,10-0,ANA,9,true,42,34,76,125,149,274,17,6,23,1,2:53
662211,2022-09-05,2022,SDN,ARI,0,5,5-0,ARI,9,false,31,36,67,151,106,257,4,10,14,0,2:51
661852,2022-09-05,2022,TBA,BOS,4,3,4-3,TBA,9,true,34,39,73,171,125,296,10,13,23,1,3:00
662860,2022-09-05,2022,COL,MIL,4,6,6-4,MIL,9,false,38,38,76,142,155,297,11,12,23,2,3:15
661088,2022-09-05,2022,HOU,TEX,1,0,1-0,HOU,9,true,31,30,61,122,112,234,9,4,13,0,2:37
661236,2022-09-05,2022,NYA,MIN,5,2,5-2,NYA,9,true,31,36,67,136,135,271,11,10,21,2,2:58
661045,2022-09-05,2022,BAL,TOR,4,8,8-4,TOR,9,false,39,40,79,145,136,281,12,13,25,2,2:57
663353,2022-09-05,2022,BAL,TOR,3,7,7-3,TOR,9,false,35,42,77,154,128,282,8,18,26,5,3:17
661926,2022-09-05,2022,SLN,WAS,0,6,6-0,WAS,9,false,32,47,79,176,123,299,5,20,25,1,3:05
662602,2022-09-05,2022,LAN,SFN,4,7,7-4,SFN,9,false,35,40,75,161,144,305,9,13,22,2,3:01
662646,2022-09-05,2022,KCA,CLE,5,6,6-5,CLE,10,false,40,43,83,159,161,320,10,16,26,1,3:17
662601,2022-09-06,2022,LAN,SFN,6,3,6-3,LAN,9,true,33,35,68,111,125,236,10,8,18,1,2:43
661925,2022-09-06,2022,SLN,WAS,4,1,4-1,SLN,9,true,32,33,65,140,127,267,9,8,17,0,2:49
662282,2022-09-06,2022,PIT,NYN,8,2,8-2,PIT,9,true,39,37,76,152,152,304,16,12,28,2,3:10
662859,2022-09-06,2022,COL,MIL,10,7,10-7,COL,10,false,41,41,82,157,132,289,14,13,27,4,3:01
662205,2022-09-06,2022,SDN,ARI,6,5,6-5,SDN,9,false,36,38,74,159,138,297,10,12,22,2,3:13
662313,2022-09-06,2022,OAK,ATL,9,10,10-9,ATL,9,false,40,43,83,149,166,315,14,18,32,5,3:09
661087,2022-09-06,2022,HOU,TEX,3,4,4-3,TEX,9,false,39,39,78,137,165,302,11,12,23,2,3:23
662138,2022-09-06,2022,SEA,CHA,3,0,3-0,SEA,9,true,34,36,70,161,127,288,11,10,21,1,3:02
662043,2022-09-06,2022,TBA,BOS,8,4,8-4,TBA,9,true,37,34,71,129,137,266,16,8,24,0,2:37
663242,2022-09-06,2022,CHN,CIN,9,3,9-3,CHN,9,true,43,35,78,130,190,320,21,7,28,4,3:08
662644,2022-09-06,2022,KCA,CLE,1,4,4-1,CLE,9,false,30,37,67,132,111,243,5,12,17,1,2:32
661597,2022-09-06,2022,PHI,MIA,3,2,3-2,PHI,9,false,33,36,69,142,118,260,11,11,22,2,3:06
663407,2022-09-06,2022,ANA,DET,5,4,5-4,ANA,10,false,36,40,76,136,128,264,9,12,21,2,3:01
663458,2022-09-06,2022,BAL,TOR,9,6,9-6,BAL,9,true,41,41,82,155,158,313,16,15,31,5,3:53 (:17 delay)
662283,2022-09-07,2022,PIT,NYN,1,5,5-1,NYN,9,false,34,38,72,122,133,255,8,11,19,0,2:36
661596,2022-09-07,2022,PHI,MIA,4,3,4-3,PHI,9,true,32,36,68,133,127,260,9,10,19,1,3:02
662283,2022-09-07,2022,PIT,NYN,1,5,5-1,NYN,9,false,34,38,72,122,133,255,8,11,19,0,2:36
662065,2022-09-07,2022,TBA,BOS,1,0,1-0,TBA,9,true,31,37,68,140,129,269,9,10,19,0,2:51
663409,2022-09-07,2022,ANA,DET,4,5,5-4,DET,9,false,42,41,83,151,185,336,15,16,31,1,3:35
662582,2022-09-07,2022,LAN,SFN,7,3,7-3,LAN,9,true,42,37,79,139,167,306,18,11,29,4,3:13
661235,2022-09-07,2022,NYA,MIN,7,1,7-1,NYA,9,true,39,37,76,148,178,326,17,10,27,1,3:17
662285,2022-09-07,2022,PIT,NYN,0,10,10-0,NYN,9,false,31,50,81,206,121,327,5,25,30,1,3:17
662312,2022-09-07,2022,OAK,ATL,3,7,7-3,ATL,9,false,34,40,74,162,155,317,7,14,21,3,3:06
661235,2022-09-07,2022,NYA,MIN,7,1,7-1,NYA,9,true,39,37,76,148,178,326,17,10,27,1,3:17
661251,2022-09-07,2022,NYA,MIN,5,4,5-4,NYA,12,false,46,48,94,176,182,358,15,14,29,2,4:03
663457,2022-09-07,2022,BAL,TOR,1,4,4-1,TOR,9,false,31,40,71,145,111,256,4,13,17,1,3:07
662871,2022-09-07,2022,COL,MIL,8,4,8-4,COL,9,true,35,35,70,144,123,267,11,8,19,1,2:35
662216,2022-09-07,2022,SDN,ARI,6,3,6-3,SDN,9,true,38,34,72,132,126,258,14,10,24,2,3:03
663168,2022-09-07,2022,CHN,CIN,1,7,7-1,CIN,9,false,37,38,75,164,128,292,13,12,25,3,2:54
662643,2022-09-07,2022,KCA,CLE,2,1,2-1,KCA,9,false,39,37,76,127,155,282,15,10,25,3,3:12
661924,2022-09-07,2022,SLN,WAS,6,5,6-5,SLN,9,false,36,38,74,144,154,298,11,13,24,4,3:18
661086,2022-09-07,2022,HOU,TEX,4,3,4-3,HOU,10,false,39,38,77,152,169,321,14,8,22,3,3:37
662137,2022-09-07,2022,SEA,CHA,6,9,9-6,CHA,9,false,42,40,82,156,167,323,13,12,25,4,3:32
661252,2022-09-08,2022,NYA,MIN,3,4,4-3,MIN,9,false,40,35,75,134,152,286,14,9,23,4,3:21
661219,2022-09-08,2022,MIL,SFN,2,1,2-1,MIL,9,true,28,30,58,112,111,223,5,4,9,0,2:20
661923,2022-09-08,2022,SLN,WAS,6,11,11-6,WAS,9,false,43,47,90,174,175,349,16,20,36,4,3:57
661595,2022-09-08,2022,PHI,MIA,5,6,6-5,MIA,9,false,34,44,78,154,124,278,9,17,26,0,3:04
661233,2022-09-08,2022,MIL,SFN,4,2,4-2,MIL,9,true,37,35,72,150,149,299,14,8,22,5,3:08
663241,2022-09-08,2022,CHN,CIN,3,4,4-3,CIN,9,false,35,40,75,162,136,298,9,15,24,6,3:14
662334,2022-09-08,2022,OAK,CHA,2,14,14-2,CHA,9,false,35,50,85,195,148,343,8,24,32,1,3:16
661594,2022-09-09,2022,PHI,WAS,5,3,5-3,PHI,9,true,34,36,70,127,91,218,14,10,24,3,2:39
661830,2022-09-09,2022,TEX,TOR,3,4,4-3,TOR,9,false,35,37,72,153,108,261,8,13,21,3,2:49
661185,2022-09-09,2022,MIL,CIN,2,8,8-2,CIN,9,false,30,43,73,155,122,277,6,19,25,1,2:42
662333,2022-09-09,2022,OAK,CHA,3,5,5-3,CHA,9,false,34,38,72,141,135,276,9,9,18,1,2:53
662284,2022-09-09,2022,PIT,SLN,8,2,8-2,PIT,9,true,38,37,75,155,160,315,18,9,27,3,3:12
661337,2022-09-09,2022,MIA,NYN,6,3,6-3,MIA,9,true,38,36,74,151,151,302,16,11,27,4,3:05
661650,2022-09-09,2022,MIN,CLE,6,7,7-6,CLE,9,false,43,42,85,157,173,330,17,16,33,2,3:36 (1:16 delay)
662870,2022-09-09,2022,COL,ARI,13,10,13-10,COL,9,false,44,40,84,140,164,304,22,14,36,3,3:05
662637,2022-09-09,2022,KCA,DET,2,10,10-2,DET,9,false,35,47,82,189,133,322,9,20,29,2,3:05
662136,2022-09-09,2022,SEA,ATL,4,6,6-4,ATL,9,false,36,40,76,166,139,305,10,13,23,1,3:06
663456,2022-09-09,2022,BAL,BOS,3,2,3-2,BAL,9,true,34,39,73,165,144,309,12,13,25,5,3:29
661085,2022-09-09,2022,HOU,ANA,4,3,4-3,HOU,9,true,35,33,68,137,137,274,13,6,19,1,3:00
663217,2022-09-09,2022,CHN,SFN,4,2,4-2,CHN,9,true,30,36,66,149,131,280,8,8,16,4,2:52
661234,2022-09-09,2022,NYA,TBA,2,4,4-2,TBA,9,false,38,42,80,145,148,293,11,16,27,2,3:32
661850,2022-09-09,2022,SDN,LAN,5,4,5-4,SDN,10,false,41,39,80,180,138,318,14,9,23,1,3:47 (:45 delay)
662088,2022-09-10,2022,SEA,ATL,3,1,3-1,SEA,9,true,33,30,63,117,133,250,9,3,12,1,2:49
661849,2022-09-10,2022,SDN,LAN,4,8,8-4,LAN,9,false,36,41,77,160,112,272,11,16,27,2,3:07
661084,2022-09-10,2022,HOU,ANA,1,6,6-1,ANA,9,false,34,39,73,152,129,281,10,14,24,1,3:08
661175,2022-09-10,2022,MIL,CIN,5,1,5-1,MIL,9,true,34,30,64,120,156,276,12,3,15,1,2:34
662265,2022-09-10,2022,PIT,SLN,5,7,7-5,SLN,9,false,39,41,80,142,149,291,15,15,30,0,3:14
662869,2022-09-10,2022,COL,ARI,4,1,4-1,COL,9,true,37,32,69,132,140,272,14,8,22,1,3:01
662636,2022-09-10,2022,KCA,DET,4,8,8-4,DET,8,true,28,36,64,146,114,260,6,14,20,2,2:38 (:58 delay)
661593,2022-09-10,2022,PHI,WAS,8,5,8-5,PHI,9,true,39,40,79,147,145,292,15,13,28,2,3:15
662322,2022-09-10,2022,OAK,CHA,2,10,10-2,CHA,9,false,35,49,84,198,153,351,6,24,30,3,3:43
663127,2022-09-10,2022,CHN,SFN,2,5,5-2,SFN,9,false,34,38,72,149,130,279,8,13,21,0,2:43
661282,2022-09-10,2022,NYA,TBA,10,3,10-3,NYA,9,true,40,35,75,127,116,243,16,8,24,2,2:47
661323,2022-09-10,2022,MIA,NYN,3,11,11-3,NYN,9,false,36,47,83,173,129,302,10,21,31,1,3:13
663455,2022-09-10,2022,BAL,BOS,4,17,17-4,BOS,9,false,36,54,90,209,114,323,8,29,37,3,3:25
661665,2022-09-10,2022,MIN,CLE,4,6,6-4,CLE,9,false,40,42,82,170,146,316,14,16,30,3,3:27
661841,2022-09-10,2022,TEX,TOR,7,11,11-7,TOR,9,false,41,49,90,189,163,352,15,23,38,3,3:37
662325,2022-09-11,2022,PIT,SLN,3,4,4-3,SLN,9,false,36,35,71,131,128,259,9,10,19,2,2:40
661322,2022-09-11,2022,MIA,NYN,3,9,9-3,NYN,9,false,34,46,80,178,120,298,8,21,29,1,3:01
661232,2022-09-11,2022,NYA,TBA,10,4,10-4,NYA,9,true,37,39,76,137,168,305,14,13,27,4,3:11 (1:47 delay)
661176,2022-09-11,2022,MIL,CIN,7,6,7-6,MIL,9,true,39,38,77,149,155,304,15,11,26,0,3:05
661839,2022-09-11,2022,TEX,TOR,4,1,4-1,TEX,9,true,36,38,74,157,144,301,12,12,24,3,3:17
663264,2022-09-11,2022,BAL,BOS,0,1,1-0,BOS,9,false,36,33,69,137,137,274,9,8,17,1,2:57 (1:12 delay)
661647,2022-09-11,2022,MIN,CLE,1,4,4-1,CLE,9,false,35,43,78,153,148,301,8,18,26,4,3:19
662120,2022-09-11,2022,SEA,ATL,8,7,8-7,SEA,9,false,39,38,77,169,155,324,14,11,25,3,3:24
661592,2022-09-11,2022,PHI,WAS,7,5,7-5,PHI,9,true,39,40,79,168,160,328,16,13,29,2,3:29 (3:36 delay)
663130,2022-09-11,2022,CHN,SFN,2,4,4-2,SFN,9,false,38,36,74,166,153,319,14,10,24,3,3:21
662635,2022-09-11,2022,KCA,DET,4,0,4-0,KCA,9,true,33,31,64,113,112,225,11,5,16,0,2:11
661083,2022-09-11,2022,HOU,ANA,12,4,12-4,HOU,9,true,44,39,83,144,198,342,22,13,35,2,3:27
662868,2022-09-11,2022,COL,ARI,6,12,12-6,ARI,9,false,36,51,87,199,152,351,9,24,33,5,3:46
662323,2022-09-11,2022,OAK,CHA,10,3,10-3,OAK,9,true,41,33,74,118,148,266,17,7,24,2,2:44
661848,2022-09-11,2022,SDN,LAN,2,11,11-2,LAN,9,false,37,41,78,138,139,277,9,18,27,3,3:01
661799,2022-09-12,2022,TOR,TBA,3,2,3-2,TOR,9,true,31,35,66,131,111,242,8,9,17,3,2:39
662782,2022-09-12,2022,DET,HOU,0,7,7-0,HOU,9,false,32,42,74,159,107,266,7,16,23,0,2:43
663324,2022-09-12,2022,ARI,LAN,0,6,6-0,LAN,9,false,31,38,69,140,108,248,7,11,18,1,2:37
662029,2022-09-12,2022,SFN,ATL,3,2,3-2,SFN,9,true,34,35,69,132,133,265,11,11,22,1,2:47
662970,2022-09-12,2022,CLE,ANA,5,4,5-4,CLE,9,true,36,36,72,148,139,287,14,9,23,3,3:08 (:08 delay)
661420,2022-09-12,2022,MIA,TEX,2,3,3-2,TEX,9,false,36,37,73,141,132,273,10,11,21,3,3:00
662423,2022-09-12,2022,NYN,CHN,2,5,5-2,CHN,9,false,39,35,74,150,146,296,12,11,23,3,3:09
661419,2022-09-12,2022,MIA,TEX,10,6,10-6,MIA,9,true,39,39,78,155,138,293,15,13,28,5,3:09
663085,2022-09-12,2022,CIN,PIT,3,6,6-3,PIT,9,false,38,44,82,161,141,302,13,15,28,1,2:54
663106,2022-09-13,2022,CIN,PIT,0,1,1-0,PIT,9,false,32,30,62,115,131,246,6,4,10,3,2:32
661645,2022-09-13,2022,MIN,KCA,6,3,6-3,MIN,9,true,35,32,67,146,124,270,14,6,20,0,2:43
662430,2022-09-13,2022,NYN,CHN,1,4,4-1,CHN,9,false,34,37,71,141,137,278,9,9,18,1,2:55
663158,2022-09-13,2022,CIN,PIT,1,6,6-1,PIT,9,false,35,43,78,149,133,282,9,16,25,2,2:56
661436,2022-09-13,2022,CHA,COL,4,2,4-2,CHA,9,true,34,33,67,129,122,251,10,6,16,1,2:40
661798,2022-09-13,2022,TOR,TBA,7,2,7-2,TOR,9,true,35,37,72,144,106,250,11,11,22,5,3:03
661922,2022-09-13,2022,SLN,MIL,4,8,8-4,MIL,9,false,36,44,80,147,129,276,10,17,27,5,3:07
661838,2022-09-13,2022,TEX,OAK,8,7,8-7,TEX,9,false,38,38,76,150,130,280,13,11,24,2,2:51
663323,2022-09-13,2022,ARI,LAN,0,4,4-0,LAN,9,false,31,43,74,175,111,286,5,17,22,0,2:54
663160,2022-09-13,2022,BOS,NYA,6,7,7-6,NYA,10,false,40,40,80,161,156,317,10,14,24,3,3:37
661320,2022-09-13,2022,MIA,PHI,1,2,2-1,PHI,9,false,31,34,65,128,123,251,4,9,13,0,2:34
662965,2022-09-13,2022,CLE,ANA,3,1,3-1,CLE,9,true,34,34,68,137,136,273,12,9,21,2,2:58
662787,2022-09-13,2022,DET,HOU,3,6,6-3,HOU,9,false,33,41,74,138,121,259,8,14,22,1,2:52
661840,2022-09-13,2022,TOR,TBA,2,4,4-2,TBA,9,false,39,35,74,119,156,275,11,9,20,1,2:59
662028,2022-09-13,2022,SFN,ATL,1,5,5-1,ATL,9,false,34,39,73,162,150,312,9,13,22,3,3:01
662464,2022-09-13,2022,WAS,BAL,3,4,4-3,BAL,9,false,39,42,81,158,124,282,10,17,27,4,3:18
662119,2022-09-13,2022,SEA,SDN,0,2,2-0,SDN,9,false,29,40,69,166,118,284,3,13,16,1,3:04
662027,2022-09-14,2022,SFN,ATL,4,1,4-1,SFN,9,true,34,32,66,133,143,276,10,7,17,3,2:45
662118,2022-09-14,2022,SEA,SDN,6,1,6-1,SEA,9,true,34,37,71,150,126,276,12,10,22,1,2:53
662463,2022-09-14,2022,WAS,BAL,2,6,6-2,BAL,9,false,33,40,73,152,115,267,6,14,20,1,2:53
663159,2022-09-14,2022,BOS,NYA,3,5,5-3,NYA,9,false,36,41,77,171,115,286,9,13,22,1,3:07
661921,2022-09-14,2022,SLN,MIL,4,1,4-1,SLN,9,true,35,40,75,171,133,304,13,14,27,1,3:10
661336,2022-09-14,2022,MIA,PHI,1,6,6-1,PHI,9,false,33,40,73,171,143,314,8,15,23,2,3:12
662422,2022-09-14,2022,NYN,CHN,3,6,6-3,CHN,9,false,35,40,75,176,143,319,10,13,23,3,3:14
661770,2022-09-14,2022,TOR,TBA,5,1,5-1,TOR,9,true,34,36,70,143,121,264,14,9,23,1,2:35
662969,2022-09-14,2022,CLE,ANA,5,3,5-3,CLE,9,true,35,35,70,124,128,252,14,10,24,3,2:56
661646,2022-09-14,2022,MIN,KCA,4,0,4-0,MIN,9,true,36,33,69,120,160,280,13,6,19,1,2:43
661435,2022-09-14,2022,CHA,COL,0,3,3-0,COL,9,false,36,37,73,166,133,299,11,9,20,1,3:07
662792,2022-09-14,2022,DET,HOU,1,2,2-1,HOU,9,false,32,37,69,162,138,300,5,10,15,1,2:58
663322,2022-09-14,2022,ARI,LAN,5,3,5-3,ARI,10,false,36,40,76,175,132,307,7,9,16,2,3:18
663006,2022-09-14,2022,CIN,PIT,4,10,10-4,PIT,9,false,36,43,79,181,139,320,9,17,26,1,3:05
661829,2022-09-14,2022,TEX,OAK,7,8,8-7,OAK,9,false,41,43,84,182,148,330,15,15,30,4,3:40
661919,2022-09-15,2022,SLN,CIN,2,3,3-2,CIN,9,false,33,37,70,146,143,289,7,12,19,1,2:45
663284,2022-09-15,2022,ARI,SDN,4,0,4-0,ARI,9,true,33,31,64,117,134,251,9,4,13,2,2:38
661644,2022-09-15,2022,MIN,KCA,3,2,3-2,MIN,9,true,32,34,66,144,138,282,10,7,17,0,2:49
661321,2022-09-15,2022,MIA,PHI,5,3,5-3,MIA,9,true,35,35,70,153,124,277,12,10,22,1,3:02
662398,2022-09-15,2022,NYN,PIT,7,1,7-1,NYN,9,true,41,33,74,138,161,299,18,6,24,0,2:53
662974,2022-09-15,2022,CLE,CHA,2,8,8-2,CHA,9,false,38,40,78,161,148,309,11,16,27,2,3:04
661822,2022-09-15,2022,TOR,TBA,0,11,11-0,TBA,9,false,34,42,76,167,129,296,7,16,23,2,3:06
662709,2022-09-15,2022,HOU,OAK,5,2,5-2,HOU,9,true,37,34,71,148,144,292,14,7,21,3,3:14
662974,2022-09-15,2022,CLE,CHA,2,8,8-2,CHA,9,false,38,40,78,161,148,309,11,16,27,2,3:04
663126,2022-09-16,2022,CHN,COL,2,1,2-1,CHN,9,true,34,33,67,108,108,216,10,8,18,0,2:10
662404,2022-09-16,2022,NYN,PIT,4,3,4-3,NYN,9,true,34,33,67,117,119,236,12,6,18,1,2:39
663427,2022-09-16,2022,ANA,SEA,8,7,8-7,ANA,9,true,38,42,80,182,132,314,14,16,30,4,3:29
662959,2022-09-16,2022,CLE,MIN,4,3,4-3,CLE,9,true,36,35,71,112,134,246,13,8,21,1,2:46
661776,2022-09-16,2022,TOR,BAL,6,3,6-3,TOR,9,true,33,33,66,127,135,262,10,7,17,0,2:40
663209,2022-09-16,2022,BOS,KCA,2,1,2-1,BOS,9,true,33,34,67,116,128,244,11,9,20,2,2:38
662026,2022-09-16,2022,SFN,LAN,0,5,5-0,LAN,9,false,29,39,68,167,120,287,3,12,15,1,2:59
662740,2022-09-16,2022,HOU,OAK,5,0,5-0,HOU,9,true,36,33,69,156,152,308,12,7,19,0,3:01
662490,2022-09-16,2022,WAS,MIA,5,4,5-4,WAS,9,true,34,39,73,155,144,299,14,14,28,2,3:00
661473,2022-09-16,2022,ATL,PHI,7,2,7-2,ATL,9,true,36,35,71,147,151,298,12,9,21,3,3:15
663283,2022-09-16,2022,ARI,SDN,3,12,12-3,SDN,9,false,33,43,76,163,120,283,7,17,24,1,2:58
662781,2022-09-16,2022,DET,CHA,3,2,3-2,DET,10,false,38,38,76,134,160,294,9,6,15,1,3:18
661953,2022-09-16,2022,SLN,CIN,6,5,6-5,SLN,9,true,36,41,77,153,153,306,13,14,27,6,3:17
662064,2022-09-16,2022,TBA,TEX,3,4,4-3,TEX,9,false,42,35,77,134,155,289,15,9,24,3,3:12
661164,2022-09-16,2022,MIL,NYA,7,6,7-6,MIL,9,false,45,44,89,180,200,380,18,18,36,4,4:09
661965,2022-09-17,2022,SLN,CIN,5,1,5-1,SLN,9,true,38,36,74,117,155,272,15,10,25,0,2:45
663426,2022-09-17,2022,ANA,SEA,2,1,2-1,ANA,9,true,29,32,61,139,113,252,6,7,13,0,2:48
661163,2022-09-17,2022,MIL,NYA,4,1,4-1,MIL,9,true,33,33,66,113,140,253,9,7,16,0,2:56
663208,2022-09-17,2022,BOS,KCA,0,9,9-0,KCA,9,false,33,44,77,158,119,277,7,17,24,2,2:39
663289,2022-09-17,2022,ARI,SDN,0,2,2-0,SDN,9,false,32,34,66,149,125,274,5,8,13,1,2:51
661965,2022-09-17,2022,SLN,CIN,5,1,5-1,SLN,9,true,38,36,74,117,155,272,15,10,25,0,2:45
662462,2022-09-17,2022,WAS,MIA,5,3,5-3,WAS,9,true,34,34,68,146,148,294,10,8,18,2,3:02
662403,2022-09-17,2022,NYN,PIT,5,1,5-1,NYN,9,true,41,34,75,135,158,293,17,8,25,2,3:06
661769,2022-09-17,2022,TOR,BAL,6,3,6-3,TOR,9,true,35,39,74,154,134,288,11,13,24,1,3:00
662024,2022-09-17,2022,SFN,LAN,2,7,7-2,LAN,9,false,36,43,79,149,142,291,8,17,25,2,3:12
662823,2022-09-17,2022,HOU,OAK,5,8,8-5,OAK,9,false,35,41,76,140,98,238,10,14,24,0,2:28
662015,2022-09-17,2022,TBA,TEX,5,1,5-1,TBA,9,true,32,35,67,128,124,252,10,9,19,4,3:00
663141,2022-09-17,2022,CLE,MIN,5,1,5-1,CLE,9,true,39,30,69,101,139,240,18,4,22,0,2:32
663129,2022-09-17,2022,CHN,COL,1,3,3-1,COL,9,false,38,34,72,129,149,278,12,6,18,0,2:48
661472,2022-09-17,2022,ATL,PHI,4,3,4-3,ATL,9,true,34,38,72,168,116,284,10,11,21,3,3:18
661952,2022-09-17,2022,SLN,CIN,1,0,1-0,SLN,11,false,39,37,76,146,150,296,11,4,15,1,3:11
662784,2022-09-17,2022,DET,CHA,3,4,4-3,CHA,11,false,40,41,81,154,154,308,7,8,15,1,3:29
662958,2022-09-17,2022,CLE,MIN,7,6,7-6,CLE,15,false,65,58,123,211,235,446,26,16,42,6,5:24
662968,2022-09-18,2022,CLE,MIN,0,3,3-0,MIN,9,false,32,38,70,126,117,243,7,13,20,1,2:43
661994,2022-09-18,2022,TBA,TEX,5,3,5-3,TBA,9,true,35,35,70,141,132,273,12,7,19,3,2:58
662783,2022-09-18,2022,DET,CHA,5,11,11-5,CHA,9,false,36,44,80,166,136,302,10,16,26,2,3:14
661930,2022-09-18,2022,SLN,CIN,0,3,3-0,CIN,9,false,32,37,69,141,120,261,6,12,18,3,2:50
663425,2022-09-18,2022,ANA,SEA,5,1,5-1,ANA,9,true,34,36,70,153,122,275,11,9,20,2,2:43
662461,2022-09-18,2022,WAS,MIA,1,3,3-1,MIA,9,false,33,37,70,148,103,251,9,11,20,0,2:27
663287,2022-09-18,2022,ARI,SDN,1,6,6-1,SDN,9,false,33,39,72,138,143,281,5,13,18,1,3:03
661471,2022-09-18,2022,ATL,PHI,5,2,5-2,ATL,9,true,36,36,72,158,132,290,12,8,20,1,3:06
662822,2022-09-18,2022,HOU,OAK,11,2,11-2,HOU,9,true,41,33,74,124,159,283,18,6,24,3,3:09
661162,2022-09-18,2022,MIL,NYA,8,12,12-8,NYA,9,false,43,47,90,191,170,361,16,20,36,6,3:46
661780,2022-09-18,2022,TOR,BAL,4,5,5-4,BAL,9,false,39,41,80,149,148,297,14,17,31,1,3:18
663112,2022-09-18,2022,CHN,COL,3,4,4-3,COL,9,false,35,40,75,167,135,302,8,13,21,1,3:07
662402,2022-09-18,2022,NYN,PIT,7,3,7-3,NYN,9,true,44,33,77,159,167,326,19,6,25,3,3:29
663207,2022-09-18,2022,BOS,KCA,13,3,13-3,BOS,9,true,48,40,88,171,178,349,25,13,38,2,3:32
662025,2022-09-18,2022,SFN,LAN,3,4,4-3,LAN,10,false,42,42,84,169,187,356,13,14,27,4,4:11 (:20 delay)
662622,2022-09-19,2022,LAN,ARI,5,2,5-2,LAN,9,true,34,35,69,131,133,264,13,9,22,0,2:46
662013,2022-09-19,2022,TBA,HOU,0,4,4-0,HOU,9,false,37,34,71,114,148,262,10,7,17,0,2:45
661470,2022-09-19,2022,ATL,WAS,5,2,5-2,ATL,9,true,35,36,71,133,134,267,14,10,24,0,2:46
661161,2022-09-19,2022,MIL,NYN,2,7,7-2,NYN,9,false,31,41,72,164,114,278,4,16,20,1,2:49
663044,2022-09-19,2022,CLE,MIN,11,4,11-4,CLE,9,true,44,37,81,129,170,299,20,13,33,3,3:10
661299,2022-09-19,2022,MIA,CHN,10,3,10-3,MIA,9,true,42,38,80,150,170,320,18,13,31,1,2:57
662886,2022-09-19,2022,COL,SFN,7,10,10-7,SFN,10,false,48,48,96,176,160,336,19,19,38,2,3:45
663263,2022-09-19,2022,BAL,DET,0,11,11-0,DET,9,false,32,45,77,168,120,288,6,18,24,2,2:58
663423,2022-09-19,2022,ANA,SEA,1,9,9-1,SEA,9,false,37,43,80,172,147,319,10,17,27,1,3:08
662204,2022-09-20,2022,SDN,SLN,5,0,5-0,SDN,9,true,35,34,69,136,152,288,12,8,20,1,2:56
662634,2022-09-20,2022,KCA,MIN,5,4,5-4,KCA,9,true,35,38,73,132,132,264,13,13,26,3,2:58
661469,2022-09-20,2022,ATL,WAS,3,2,3-2,ATL,9,true,32,40,72,151,135,286,8,14,22,3,3:18
661298,2022-09-20,2022,MIA,CHN,1,2,2-1,CHN,9,false,34,35,69,146,127,273,10,8,18,1,2:48
662621,2022-09-20,2022,LAN,ARI,6,5,6-5,LAN,9,true,45,40,85,158,188,346,19,12,31,2,3:30
662321,2022-09-20,2022,OAK,SEA,4,1,4-1,OAK,9,true,34,33,67,139,132,271,11,6,17,1,2:49
662607,2022-09-20,2022,LAN,ARI,2,5,5-2,ARI,9,false,35,39,74,129,126,255,9,11,20,1,2:49
661837,2022-09-20,2022,TEX,ANA,2,5,5-2,ANA,9,false,33,36,69,144,135,279,9,13,22,3,2:50
663262,2022-09-20,2022,BAL,DET,2,3,3-2,DET,9,false,38,36,74,109,148,257,11,10,21,2,2:58
662867,2022-09-20,2022,COL,SFN,3,6,6-3,SFN,9,false,37,39,76,152,140,292,12,13,25,3,3:07
662012,2022-09-20,2022,TBA,HOU,0,5,5-0,HOU,9,false,35,38,73,152,154,306,9,14,23,2,3:10
663104,2022-09-20,2022,CIN,BOS,3,5,5-3,BOS,9,false,40,41,81,170,144,314,14,16,30,3,3:27
661159,2022-09-20,2022,MIL,NYN,5,7,7-5,NYN,9,false,42,37,79,136,183,319,15,10,25,6,3:19
661229,2022-09-20,2022,NYA,PIT,9,8,9-8,NYA,9,false,41,44,85,171,168,339,15,16,31,3,3:33
661434,2022-09-20,2022,CHA,CLE,7,10,10-7,CLE,11,false,45,49,94,190,149,339,12,19,31,2,3:57 (:40 delay)
661591,2022-09-20,2022,PHI,TOR,11,18,18-11,TOR,9,false,45,53,98,175,163,338,18,25,43,3,3:41
661158,2022-09-21,2022,MIL,NYN,6,0,6-0,MIL,9,true,34,36,70,142,117,259,12,10,22,3,2:47
663261,2022-09-21,2022,BAL,DET,8,1,8-1,BAL,9,true,39,29,68,94,152,246,14,3,17,1,2:27
661297,2022-09-21,2022,MIA,CHN,3,4,4-3,CHN,9,false,35,36,71,156,139,295,8,7,15,2,2:47
661228,2022-09-21,2022,NYA,PIT,14,2,14-2,NYA,9,true,40,35,75,126,155,281,16,8,24,3,2:51
662606,2022-09-21,2022,LAN,ARI,1,6,6-1,ARI,9,false,31,39,70,137,136,273,5,12,17,0,2:53
661468,2022-09-21,2022,ATL,WAS,2,3,3-2,WAS,9,false,37,39,76,143,164,307,13,12,25,3,3:13
662320,2022-09-21,2022,OAK,SEA,2,1,2-1,OAK,9,true,33,30,63,116,135,251,10,5,15,1,2:39
661070,2022-09-21,2022,CIN,BOS,5,1,5-1,CIN,9,true,33,31,64,140,119,259,10,7,17,1,2:37
661588,2022-09-21,2022,PHI,TOR,4,3,4-3,PHI,10,false,45,42,87,179,168,347,17,14,31,2,4:08
662899,2022-09-21,2022,COL,SFN,1,6,6-1,SFN,9,false,34,42,76,141,128,269,7,16,23,3,2:39
661783,2022-09-21,2022,TEX,ANA,7,2,7-2,TEX,9,true,35,32,67,128,130,258,11,8,19,1,2:35
662011,2022-09-21,2022,TBA,HOU,2,5,5-2,HOU,9,false,37,38,75,115,140,255,10,12,22,0,2:47
661433,2022-09-21,2022,CHA,CLE,2,8,8-2,CLE,9,false,34,42,76,147,111,258,7,15,22,0,2:31
662203,2022-09-21,2022,SDN,SLN,1,0,1-0,SDN,9,true,32,31,63,141,139,280,9,4,13,1,2:55
662633,2022-09-21,2022,KCA,MIN,5,2,5-2,KCA,9,true,34,36,70,158,126,284,11,10,21,2,2:56
663260,2022-09-22,2022,BAL,HOU,2,0,2-0,BAL,9,true,29,29,58,106,124,230,7,2,9,1,2:37
662632,2022-09-22,2022,KCA,MIN,4,1,4-1,KCA,9,true,35,32,67,138,120,258,11,6,17,0,2:34
662586,2022-09-22,2022,LAN,ARI,3,2,3-2,LAN,9,false,33,34,67,144,128,272,8,7,15,2,3:05
662898,2022-09-22,2022,COL,SFN,0,3,3-0,SFN,9,false,34,38,72,164,121,285,11,13,24,2,3:02
661806,2022-09-22,2022,TEX,ANA,5,3,5-3,TEX,9,true,32,38,70,131,146,277,10,11,21,2,2:49
662306,2022-09-22,2022,OAK,SEA,5,9,9-5,SEA,9,false,40,40,80,145,155,300,13,15,28,3,3:22
661432,2022-09-22,2022,CHA,CLE,2,4,4-2,CLE,9,false,33,37,70,125,116,241,7,10,17,1,2:33
661243,2022-09-22,2022,NYA,BOS,5,4,5-4,NYA,10,false,40,42,82,177,141,318,18,13,31,1,3:34
661609,2022-09-22,2022,PHI,ATL,1,0,1-0,PHI,9,true,32,36,68,114,154,268,8,9,17,1,3:08
661069,2022-09-22,2022,CIN,MIL,1,5,5-1,MIL,9,false,33,36,69,151,142,293,7,9,16,1,2:50
662202,2022-09-22,2022,SDN,SLN,4,5,5-4,SLN,9,false,37,38,75,139,138,277,11,12,23,1,3:03
662264,2022-09-22,2022,PIT,CHN,2,3,3-2,CHN,9,false,39,35,74,148,142,290,14,10,24,2,3:04 (:26 delay)
662041,2022-09-22,2022,TBA,TOR,10,5,10-5,TBA,9,true,41,37,78,161,182,343,17,11,28,1,3:30
663259,2022-09-23,2022,BAL,HOU,6,0,6-0,BAL,9,true,35,31,66,106,141,247,11,6,17,2,2:40
661222,2022-09-23,2022,NYA,BOS,5,4,5-4,NYA,9,true,35,35,70,145,141,286,12,10,22,0,3:00
662642,2022-09-23,2022,KCA,SEA,5,1,5-1,KCA,9,true,35,35,70,144,124,268,11,10,21,0,2:29
662305,2022-09-23,2022,OAK,NYN,2,9,9-2,NYN,9,false,32,43,75,140,104,244,7,18,25,1,2:31
662585,2022-09-23,2022,LAN,SLN,0,11,11-0,SLN,9,false,34,44,78,166,141,307,9,15,24,2,2:57
661668,2022-09-23,2022,MIN,ANA,2,4,4-2,ANA,9,false,37,37,74,149,148,297,12,11,23,4,3:21
661431,2022-09-23,2022,CHA,DET,3,5,5-3,DET,9,false,39,38,77,144,135,279,12,12,24,1,3:04
661587,2022-09-23,2022,PHI,ATL,9,1,9-1,PHI,9,true,42,35,77,146,165,311,19,9,28,0,3:20
661068,2022-09-23,2022,CIN,MIL,3,5,5-3,MIL,9,false,37,44,81,174,136,310,11,17,28,3,3:22
662897,2022-09-23,2022,COL,SDN,4,3,4-3,COL,10,false,43,38,81,160,156,316,17,8,25,2,3:23
662040,2022-09-23,2022,TBA,TOR,10,6,10-6,TBA,9,true,40,40,80,155,153,308,18,13,31,2,3:21
661296,2022-09-23,2022,MIA,WAS,5,2,5-2,MIA,9,true,37,35,72,123,132,255,14,8,22,2,2:41
663282,2022-09-23,2022,ARI,SFN,5,6,6-5,SFN,9,false,42,41,83,155,182,337,15,15,30,3,3:37
661807,2022-09-23,2022,TEX,CLE,3,6,6-3,CLE,9,false,41,37,78,159,175,334,14,10,24,2,3:31
662263,2022-09-23,2022,PIT,CHN,5,6,6-5,CHN,9,false,40,44,84,185,171,356,14,19,33,1,3:33
661805,2022-09-24,2022,TEX,CLE,2,4,4-2,CLE,9,false,36,35,71,117,119,236,10,10,20,1,2:30
662249,2022-09-24,2022,PIT,CHN,6,0,6-0,PIT,9,true,35,33,68,124,126,250,10,6,16,1,2:26
661295,2022-09-24,2022,MIA,WAS,4,1,4-1,MIA,9,true,34,31,65,112,125,237,11,5,16,1,2:18
662039,2022-09-24,2022,TBA,TOR,1,3,3-1,TOR,9,false,35,34,69,131,147,278,9,9,18,3,3:18
661430,2022-09-24,2022,CHA,DET,2,7,7-2,DET,9,false,36,41,77,152,127,279,9,16,25,1,3:01
662311,2022-09-24,2022,OAK,NYN,10,4,10-4,OAK,9,true,44,37,81,131,147,278,20,13,33,1,2:55
662584,2022-09-24,2022,LAN,SLN,6,2,6-2,LAN,9,true,35,35,70,128,146,274,12,9,21,0,2:50
661067,2022-09-24,2022,CIN,MIL,2,10,10-2,MIL,9,false,34,42,76,159,145,304,9,17,26,1,2:57
661656,2022-09-24,2022,MIN,ANA,8,4,8-4,MIN,9,true,38,39,77,153,132,285,12,11,23,2,2:49
663281,2022-09-24,2022,ARI,SFN,5,2,5-2,ARI,9,true,34,32,66,115,134,249,10,5,15,0,2:37
662866,2022-09-24,2022,COL,SDN,3,9,9-3,SDN,9,false,36,42,78,167,131,298,9,16,25,2,3:14
661221,2022-09-24,2022,NYA,BOS,7,5,7-5,NYA,9,true,36,43,79,159,155,314,14,16,30,3,3:25
661586,2022-09-24,2022,PHI,ATL,3,6,6-3,ATL,9,false,35,40,75,166,154,320,6,15,21,3,3:22
662641,2022-09-24,2022,KCA,SEA,5,6,6-5,SEA,9,false,37,47,84,201,119,320,11,22,33,4,3:25
663258,2022-09-24,2022,BAL,HOU,10,11,11-10,HOU,9,false,46,43,89,164,170,334,18,18,36,4,3:58
661220,2022-09-25,2022,NYA,BOS,2,0,2-0,NYA,6,false,27,21,48,101,95,196,8,3,11,0,2:07 (1:38 delay)
661828,2022-09-25,2022,TEX,CLE,4,10,10-4,CLE,9,false,35,42,77,151,147,298,7,15,22,1,2:54
663280,2022-09-25,2022,ARI,SFN,2,3,3-2,SFN,9,false,35,42,77,160,138,298,8,17,25,4,3:19
662598,2022-09-25,2022,LAN,SLN,4,1,4-1,LAN,9,true,35,34,69,118,148,266,11,8,19,1,2:48
661066,2022-09-25,2022,CIN,MIL,2,1,2-1,CIN,9,true,34,31,65,137,147,284,11,6,17,1,2:46
662063,2022-09-25,2022,TBA,TOR,1,7,7-1,TOR,9,false,36,40,76,159,137,296,9,14,23,1,3:04
662631,2022-09-25,2022,KCA,SEA,13,12,13-12,KCA,9,true,42,48,90,174,178,352,21,23,44,6,3:43
661667,2022-09-25,2022,MIN,ANA,3,10,10-3,ANA,9,false,40,46,86,190,160,350,13,19,32,5,3:47
661429,2022-09-25,2022,CHA,DET,1,4,4-1,DET,9,false,33,41,74,153,130,283,9,16,25,1,3:04
662310,2022-09-25,2022,OAK,NYN,4,13,13-4,NYN,9,false,36,49,85,170,144,314,10,23,33,2,3:07
662243,2022-09-25,2022,PIT,CHN,3,8,8-3,CHN,9,false,36,44,80,184,132,316,10,15,25,3,3:08
661294,2022-09-25,2022,MIA,WAS,1,6,6-1,WAS,9,false,35,40,75,140,152,292,9,14,23,2,3:09
663454,2022-09-25,2022,BAL,HOU,3,6,6-3,HOU,11,false,39,44,83,192,165,357,9,14,23,5,4:02 (:46 delay)
662865,2022-09-25,2022,COL,SDN,6,13,13-6,SDN,9,false,41,50,91,187,160,347,15,23,38,4,3:43
661585,2022-09-25,2022,PHI,ATL,7,8,8-7,ATL,11,false,46,48,94,179,182,361,16,17,33,1,4:09 (2:09 delay)
662460,2022-09-26,2022,WAS,ATL,0,8,8-0,ATL,9,false,32,38,70,144,106,250,7,13,20,1,2:24
662242,2022-09-26,2022,PIT,CIN,8,3,8-3,PIT,9,true,43,34,77,129,194,323,19,6,25,3,3:05 (:38 delay)
663250,2022-09-26,2022,BOS,BAL,8,14,14-8,BAL,9,false,42,48,90,192,148,340,18,22,40,2,3:19 (1:40 delay)
661768,2022-09-26,2022,TOR,NYA,3,2,3-2,TOR,10,false,39,38,77,153,150,303,11,11,22,3,3:29
663128,2022-09-27,2022,CHN,PHI,2,1,2-1,CHN,9,true,29,32,61,112,87,199,8,8,16,1,2:15
661666,2022-09-27,2022,MIN,CHA,4,0,4-0,MIN,9,true,35,29,64,116,151,267,12,3,15,2,2:38
662046,2022-09-27,2022,SFN,COL,5,2,5-2,SFN,9,true,34,37,71,135,125,260,10,11,21,0,2:33
662241,2022-09-27,2022,PIT,CIN,4,1,4-1,PIT,9,true,37,36,73,151,148,299,14,11,25,0,3:01
662774,2022-09-27,2022,DET,KCA,4,3,4-3,DET,10,false,39,40,79,142,140,282,14,12,26,2,3:00
661155,2022-09-27,2022,MIL,SLN,2,6,6-2,SLN,9,false,35,41,76,178,142,320,9,15,24,4,3:13
662210,2022-09-27,2022,SDN,LAN,4,3,4-3,SDN,10,false,41,46,87,207,147,354,12,15,27,2,4:09
663422,2022-09-27,2022,ANA,OAK,4,3,4-3,ANA,9,true,37,36,73,140,131,271,13,11,24,3,3:14
661778,2022-09-27,2022,TOR,NYA,2,5,5-2,NYA,9,false,32,42,74,166,111,277,8,16,24,3,2:55
662401,2022-09-27,2022,NYN,MIA,4,6,6-4,MIA,9,false,34,42,76,180,140,320,7,17,24,0,3:17
662489,2022-09-27,2022,WAS,ATL,2,8,8-2,ATL,9,false,34,41,75,153,131,284,7,13,20,1,2:47
663206,2022-09-27,2022,BOS,BAL,13,9,13-9,BOS,9,true,46,44,90,176,204,380,23,18,41,4,3:57
662117,2022-09-27,2022,SEA,TEX,0,5,5-0,TEX,9,false,36,37,73,144,177,321,10,12,22,3,3:22
662821,2022-09-27,2022,HOU,ARI,10,2,10-2,HOU,9,true,44,35,79,138,191,329,20,8,28,2,3:28
662955,2022-09-27,2022,CLE,TBA,5,6,6-5,TBA,11,false,50,41,91,159,212,371,20,8,28,1,4:06 (:23 delay)
663181,2022-09-28,2022,BOS,BAL,3,1,3-1,BOS,9,true,33,34,67,140,132,272,11,9,20,1,2:39
662967,2022-09-28,2022,CLE,TBA,2,1,2-1,CLE,10,false,36,37,73,152,159,311,11,9,20,2,3:19 (1:03 delay)
662773,2022-09-28,2022,DET,KCA,2,1,2-1,DET,9,true,32,41,73,153,138,291,8,16,24,1,2:50
661112,2022-09-28,2022,SEA,TEX,3,1,3-1,SEA,9,true,33,31,64,117,128,245,10,6,16,0,2:34
663098,2022-09-28,2022,CHN,PHI,4,2,4-2,CHN,9,true,32,41,73,139,119,258,7,14,21,4,2:59
661099,2022-09-28,2022,WAS,ATL,3,2,3-2,WAS,10,false,38,39,77,143,149,292,9,9,18,1,3:13
662240,2022-09-28,2022,PIT,CIN,4,3,4-3,PIT,10,false,43,38,81,118,148,266,15,9,24,0,2:37
663421,2022-09-28,2022,ANA,OAK,4,1,4-1,ANA,9,true,34,35,69,151,148,299,9,8,17,4,3:23
661737,2022-09-28,2022,TOR,NYA,3,8,8-3,NYA,9,false,34,43,77,158,140,298,8,15,23,5,3:20
661133,2022-09-28,2022,MIN,CHA,8,4,8-4,MIN,9,true,39,37,76,156,128,284,18,11,29,2,3:06
662820,2022-09-28,2022,HOU,ARI,2,5,5-2,ARI,10,false,38,40,78,143,149,292,10,11,21,1,3:29
661154,2022-09-28,2022,MIL,SLN,5,1,5-1,MIL,9,true,38,39,77,163,156,319,15,14,29,4,3:31
662214,2022-09-28,2022,SDN,LAN,0,1,1-0,LAN,10,false,37,41,78,177,148,325,9,11,20,0,3:44
662045,2022-09-28,2022,SFN,COL,6,3,6-3,SFN,9,true,37,36,73,157,167,324,13,8,21,1,3:19
662400,2022-09-28,2022,NYN,MIA,5,4,5-4,NYN,10,false,42,40,82,164,166,330,15,10,25,4,3:26
663420,2022-09-29,2022,ANA,OAK,4,2,4-2,ANA,9,true,37,32,69,135,140,275,16,6,22,1,3:07
661156,2022-09-29,2022,MIL,MIA,2,4,4-2,MIA,9,false,37,35,72,136,148,284,13,7,20,2,3:08
663110,2022-09-29,2022,CHN,PHI,2,0,2-0,CHN,9,true,37,36,73,138,143,281,13,10,23,1,2:55
662050,2022-09-29,2022,SFN,COL,6,4,6-4,SFN,9,true,34,35,69,176,120,296,12,8,20,2,2:57
663180,2022-09-29,2022,BOS,BAL,5,3,5-3,BOS,9,true,35,38,73,155,149,304,11,10,21,1,3:00
662209,2022-09-29,2022,SDN,LAN,2,5,5-2,LAN,9,false,39,37,76,154,160,314,13,10,23,3,3:17
662772,2022-09-29,2022,DET,KCA,10,3,10-3,DET,9,true,42,41,83,140,161,301,17,14,31,4,3:03
661132,2022-09-29,2022,MIN,CHA,3,4,4-3,CHA,9,false,39,37,76,142,159,301,12,10,22,2,3:11
662932,2022-09-29,2022,CLE,TBA,2,1,2-1,CLE,9,true,32,35,67,145,114,259,8,8,16,0,2:43
661128,2022-09-29,2022,SEA,TEX,10,9,10-9,SEA,11,false,46,47,93,188,191,379,18,16,34,2,3:48
661157,2022-09-30,2022,MIL,MIA,1,0,1-0,MIL,9,true,29,32,61,130,100,230,5,7,12,0,2:28
663406,2022-09-30,2022,ANA,TEX,4,1,4-1,ANA,9,true,37,33,70,130,130,260,12,6,18,1,2:35
662940,2022-09-30,2022,CLE,KCA,6,3,6-3,CLE,9,true,35,30,65,114,129,243,11,4,15,1,2:27
661467,2022-09-30,2022,ATL,NYN,5,2,5-2,ATL,9,true,31,35,66,140,123,263,8,10,18,1,2:54
661111,2022-09-30,2022,SEA,OAK,2,1,2-1,SEA,9,false,33,30,63,109,153,262,10,5,15,0,2:47
663099,2022-09-30,2022,CHN,CIN,6,1,6-1,CHN,9,true,35,32,67,121,131,252,11,6,17,1,2:29
662819,2022-09-30,2022,HOU,TBA,3,7,7-3,TBA,9,false,34,42,76,150,104,254,7,15,22,1,2:54
661751,2022-09-30,2022,TOR,BOS,9,0,9-0,TOR,9,true,40,32,72,141,146,287,16,6,22,0,3:04
661218,2022-09-30,2022,NYA,BAL,1,2,2-1,BAL,9,false,33,38,71,155,134,289,7,12,19,3,3:12
661958,2022-09-30,2022,SLN,PIT,2,1,2-1,SLN,9,true,33,39,72,154,127,281,10,12,22,1,3:01
662771,2022-09-30,2022,DET,MIN,0,7,7-0,MIN,9,false,35,45,80,164,144,308,8,19,27,1,3:17
662208,2022-09-30,2022,SDN,CHA,1,3,3-1,CHA,9,false,36,36,72,134,172,306,10,9,19,2,3:23
662596,2022-09-30,2022,LAN,COL,10,1,10-1,LAN,9,true,42,35,77,122,156,278,18,9,27,1,2:45
662049,2022-09-30,2022,SFN,ARI,10,4,10-4,SFN,9,true,39,40,79,151,148,299,15,15,30,1,2:59
661097,2022-09-30,2022,WAS,PHI,1,5,5-1,PHI,9,false,36,41,77,174,162,336,11,13,24,1,3:17
663405,2022-10-01,2022,ANA,TEX,3,2,3-2,ANA,9,true,32,29,61,115,113,228,9,2,11,1,2:27
662207,2022-10-01,2022,SDN,CHA,5,2,5-2,SDN,9,true,37,32,69,121,152,273,14,7,21,2,3:07
661110,2022-10-01,2022,SEA,OAK,5,1,5-1,SEA,9,true,34,31,65,122,132,254,11,4,15,0,2:36
661217,2022-10-01,2022,NYA,BAL,8,0,8-0,NYA,9,true,39,32,71,118,124,242,19,6,25,1,2:38 (:27 delay)
662818,2022-10-01,2022,HOU,TBA,2,1,2-1,HOU,9,true,31,33,64,147,101,248,7,8,15,0,2:44
663167,2022-10-01,2022,CHN,CIN,2,1,2-1,CHN,9,true,34,33,67,123,146,269,10,5,15,2,2:32
661466,2022-10-01,2022,ATL,NYN,4,2,4-2,ATL,9,true,33,36,69,132,133,265,11,9,20,2,2:54
661098,2022-10-01,2022,WAS,PHI,2,8,8-2,PHI,9,false,36,42,78,152,126,278,9,15,24,2,2:49
662770,2022-10-01,2022,DET,MIN,3,2,3-2,DET,9,true,32,39,71,179,118,297,7,15,22,3,3:12
662572,2022-10-01,2022,WAS,PHI,13,4,13-4,WAS,9,true,42,37,79,137,155,292,18,11,29,2,2:58 (:41 delay)
661956,2022-10-01,2022,SLN,PIT,13,3,13-3,SLN,9,true,43,35,78,129,168,297,18,8,26,2,3:01
661152,2022-10-01,2022,MIL,MIA,3,4,4-3,MIA,9,false,39,33,72,137,172,309,12,6,18,4,3:28
661098,2022-10-01,2022,WAS,PHI,2,8,8-2,PHI,9,false,36,42,78,152,126,278,9,15,24,2,2:49
662023,2022-10-01,2022,SFN,ARI,4,8,8-4,ARI,9,false,37,44,81,147,150,297,11,16,27,2,3:10
662939,2022-10-01,2022,CLE,KCA,1,7,7-1,KCA,9,false,35,43,78,163,164,327,10,17,27,2,3:21
661736,2022-10-01,2022,TOR,BOS,10,0,10-0,TOR,9,true,46,33,79,135,169,304,24,6,30,1,3:09
662595,2022-10-01,2022,LAN,COL,6,4,6-4,LAN,9,true,45,36,81,145,167,312,21,12,33,4,3:29
661096,2022-10-02,2022,WAS,PHI,1,8,8-1,PHI,6,false,22,33,55,123,96,219,4,15,19,1,2:20 (1:28 delay)
662087,2022-10-02,2022,SEA,OAK,3,10,10-3,OAK,9,false,38,43,81,137,158,295,11,16,27,1,3:11
663419,2022-10-02,2022,ANA,TEX,8,3,8-3,ANA,9,true,39,39,78,142,141,283,20,11,31,1,2:50
662825,2022-10-02,2022,HOU,TBA,3,1,3-1,HOU,9,true,35,36,71,147,124,271,11,10,21,0,2:56
661215,2022-10-02,2022,NYA,BAL,1,3,3-1,BAL,9,false,35,42,77,168,147,315,9,16,25,4,3:35
661735,2022-10-02,2022,TOR,BOS,6,3,6-3,TOR,9,true,35,35,70,136,141,277,12,8,20,0,2:50
662581,2022-10-02,2022,LAN,COL,1,4,4-1,COL,9,false,34,38,72,143,132,275,7,12,19,0,2:49
662190,2022-10-02,2022,SDN,CHA,1,2,2-1,CHA,9,false,36,35,71,154,134,288,9,8,17,0,3:06
661465,2022-10-02,2022,ATL,NYN,5,3,5-3,ATL,9,true,34,39,73,140,155,295,10,13,23,5,3:21
663097,2022-10-02,2022,CHN,CIN,8,1,8-1,CHN,9,true,42,36,78,120,188,308,18,9,27,1,2:53
662938,2022-10-02,2022,CLE,KCA,7,5,7-5,CLE,9,true,37,43,80,175,143,318,14,16,30,2,3:00
661954,2022-10-02,2022,SLN,PIT,5,7,7-5,PIT,9,false,42,39,81,144,163,307,15,12,27,3,3:18
662769,2022-10-02,2022,DET,MIN,5,2,5-2,DET,9,true,33,36,69,159,147,306,10,8,18,1,3:09
662022,2022-10-02,2022,SFN,ARI,4,3,4-3,SFN,10,false,40,42,82,148,172,320,13,15,28,1,3:36
661153,2022-10-02,2022,MIL,MIA,3,4,4-3,MIA,12,false,48,47,95,198,181,379,17,13,30,4,4:12
663453,2022-10-03,2022,BOS,TBA,4,3,4-3,BOS,9,true,35,32,67,128,141,269,10,6,16,1,2:35
663273,2022-10-03,2022,BAL,TOR,1,5,5-1,TOR,8,true,27,34,61,123,105,228,6,13,19,0,2:16 (:54 delay)
662201,2022-10-03,2022,SEA,DET,3,4,4-3,DET,9,false,36,39,75,170,122,292,10,13,23,1,3:11
662044,2022-10-03,2022,TEX,NYA,1,3,3-1,NYA,9,false,29,36,65,126,114,240,3,15,18,0,2:29
663096,2022-10-03,2022,CIN,CHN,3,1,3-1,CIN,9,true,33,31,64,131,125,256,11,7,18,1,2:31
661464,2022-10-03,2022,CHA,MIN,3,2,3-2,CHA,9,true,31,36,67,138,123,261,6,10,16,0,2:32
662309,2022-10-03,2022,PIT,SLN,3,2,3-2,PIT,9,false,33,38,71,159,136,295,10,11,21,5,3:10
662629,2022-10-03,2022,LAN,COL,1,2,2-1,COL,9,false,32,37,69,160,130,290,6,10,16,1,3:02
662777,2022-10-03,2022,HOU,PHI,0,3,3-0,PHI,9,false,29,38,67,167,121,288,2,14,16,1,2:59
661424,2022-10-03,2022,MIA,ATL,4,0,4-0,MIA,9,true,34,32,66,131,139,270,11,5,16,0,2:29
663105,2022-10-03,2022,CLE,KCA,2,5,5-2,KCA,10,false,41,38,79,150,159,309,11,7,18,0,3:02
661213,2022-10-03,2022,MIL,ARI,6,5,6-5,MIL,10,false,39,39,78,164,148,312,12,9,21,2,3:19
662431,2022-10-03,2022,OAK,ANA,5,4,5-4,OAK,10,false,45,41,86,149,165,314,15,14,29,3,3:49
662239,2022-10-03,2022,SDN,SFN,7,4,7-4,SDN,9,true,35,39,74,160,140,300,14,13,27,2,3:12
662624,2022-10-04,2022,LAN,COL,2,5,5-2,COL,9,false,34,38,72,145,122,267,7,10,17,0,2:48
662252,2022-10-04,2022,SDN,SFN,6,2,6-2,SDN,9,true,39,33,72,110,149,259,17,7,24,1,2:44
662010,2022-10-04,2022,TEX,NYA,3,2,3-2,TEX,9,true,28,36,64,140,127,267,6,10,16,0,2:36
661094,2022-10-04,2022,NYN,WAS,4,2,4-2,NYN,9,true,37,35,72,147,142,289,13,9,22,2,3:12
662429,2022-10-04,2022,OAK,ANA,2,1,2-1,OAK,10,false,40,39,79,134,137,271,13,11,24,1,3:07
663452,2022-10-04,2022,BOS,TBA,6,0,6-0,BOS,5,false,25,18,43,64,101,165,10,4,14,1,1:44 (:52 delay)
661095,2022-10-04,2022,NYN,WAS,8,0,8-0,NYN,9,true,40,35,75,155,161,316,17,9,26,2,3:09
662199,2022-10-04,2022,SEA,DET,9,6,9-6,SEA,9,true,42,41,83,149,178,327,18,13,31,2,3:22
663243,2022-10-04,2022,CIN,CHN,3,2,3-2,CIN,9,false,33,35,68,135,140,275,10,6,16,3,2:52
663077,2022-10-04,2022,CLE,KCA,5,3,5-3,CLE,9,true,34,34,68,134,130,264,11,6,17,1,2:33
662062,2022-10-04,2022,TEX,NYA,4,5,5-4,NYA,9,false,37,37,74,129,138,267,11,10,21,1,2:45
661095,2022-10-04,2022,NYN,WAS,8,0,8-0,NYN,9,true,40,35,75,155,161,316,17,9,26,2,3:09
662768,2022-10-04,2022,HOU,PHI,10,0,10-0,HOU,9,true,43,32,75,140,142,282,21,5,26,2,3:01
661423,2022-10-04,2022,MIA,ATL,1,2,2-1,ATL,9,false,35,42,77,158,144,302,8,18,26,1,3:09
662200,2022-10-04,2022,SEA,DET,7,6,7-6,SEA,10,false,43,41,84,163,174,337,16,11,27,2,3:24
662319,2022-10-04,2022,PIT,SLN,7,8,8-7,SLN,10,false,47,45,92,159,186,345,20,14,34,4,3:53
661463,2022-10-04,2022,CHA,MIN,8,3,8-3,CHA,9,true,34,34,68,116,147,263,10,8,18,1,2:52
661223,2022-10-04,2022,MIL,ARI,3,0,3-0,MIL,9,true,35,33,68,152,150,302,11,6,17,0,3:02
662789,2022-10-05,2022,HOU,PHI,3,2,3-2,HOU,9,true,33,33,66,159,117,276,14,6,20,1,2:49
662623,2022-10-05,2022,LAN,COL,6,1,6-1,LAN,9,true,36,33,69,128,147,275,12,6,18,1,2:44
662304,2022-10-05,2022,PIT,SLN,5,3,5-3,PIT,9,true,35,36,71,133,141,274,14,10,24,1,2:42
661427,2022-10-05,2022,CHA,MIN,1,10,10-1,MIN,9,false,38,42,80,165,137,302,11,16,27,1,2:46
662421,2022-10-05,2022,OAK,ANA,3,2,3-2,OAK,9,true,31,33,64,131,119,250,6,8,14,2,2:44
663095,2022-10-05,2022,CLE,KCA,9,2,9-2,CLE,9,true,43,34,77,119,138,257,20,7,27,1,2:39
663131,2022-10-05,2022,CIN,CHN,2,15,15-2,CHN,9,false,40,48,88,182,164,346,12,23,35,3,3:20
661996,2022-10-05,2022,TEX,NYA,4,2,4-2,TEX,9,true,35,34,69,130,134,264,14,9,23,1,2:48
662238,2022-10-05,2022,SDN,SFN,1,8,8-1,SFN,9,false,31,44,75,151,135,286,5,17,22,2,3:07
663451,2022-10-05,2022,BAL,TOR,5,4,5-4,BAL,9,true,35,41,76,155,122,277,12,16,28,2,2:46
663272,2022-10-05,2022,BAL,TOR,1,5,5-1,TOR,9,false,35,40,75,153,143,296,9,13,22,4,3:04
663272,2022-10-05,2022,BAL,TOR,1,5,5-1,TOR,9,false,35,40,75,153,143,296,9,13,22,4,3:04
663352,2022-10-05,2022,BOS,TBA,6,3,6-3,BOS,9,true,36,39,75,188,156,344,14,14,28,1,3:21
661422,2022-10-05,2022,MIA,ATL,12,9,12-9,MIA,9,true,41,46,87,200,156,356,19,19,38,5,3:40
662488,2022-10-05,2022,NYN,WAS,9,2,9-2,NYN,9,true,36,35,71,128,139,267,13,9,22,1,2:44 (1:51 delay)
661227,2022-10-05,2022,MIL,ARI,2,4,4-2,ARI,9,false,35,36,71,128,137,265,10,11,21,1,2:43
662195,2022-10-05,2022,SEA,DET,5,4,5-4,SEA,9,false,38,37,75,130,157,287,13,10,23,1,2:48