ID,API Key,Date,Year,Home Team,Away Team,Home Score,Away Score,Final Score,Winning Team,# Innings,End Top Inning?,Home Team PA #,Away Team PA #,Total Number PA,Homne Team # Pitches,Away Team # Pitches,Total # Pitches,Home Team Baserunners,Away Team Baserunners,Total # Baserunners,Pitching Changes,Time
1,385475,2014-03-30,2014,HOU,VRA,6,1,6-1,HOU,9,1,37,32,69,116,130,246,15,7,22,2,2:31
2,380546,2014-03-30,2014,SDN,LAN,3,1,3-1,SDN,9,1,33,34,67,133,125,258,9,7,16,3,2:49
3,380547,2014-03-31,2014,CHA,MIN,5,3,5-3,CHA,9,1,34,34,68,133,130,263,13,8,21,3,2:35
4,380544,2014-03-31,2014,MIA,COL,10,1,10-1,MIA,9,1,41,33,74,128,155,283,17,7,24,1,2:58
5,380551,2014-03-31,2014,CIN,SLN,0,1,1-0,SLN,9,0,36,34,70,128,140,268,9,7,16,3,2:56
6,380552,2014-03-31,2014,TBA,TOR,9,2,9-2,TBA,9,1,44,34,78,129,154,283,21,8,29,1,3:04
7,380543,2014-03-31,2014,OAK,CLE,0,2,2-0,CLE,9,0,36,40,76,161,141,302,9,13,22,2,3:15
8,380545,2014-03-31,2014,DET,KCA,4,3,4-3,DET,9,0,35,38,73,141,155,296,11,10,21,2,3:01
9,380542,2014-03-31,2014,PIT,CHN,1,0,1-0,PIT,10,0,33,38,71,154,128,282,9,10,19,1,3:16
10,380541,2014-03-31,2014,BAL,BOS,2,1,2-1,BAL,9,1,29,40,69,169,117,286,7,13,20,1,2:53
11,380550,2014-03-31,2014,ARI,SFN,8,9,9-8,SFN,9,0,46,41,87,141,167,308,19,14,33,3,3:25
12,380553,2014-03-31,2014,NYN,WAS,7,9,9-7,WAS,10,0,40,45,85,179,163,342,10,15,25,4,3:47
13,380548,2014-03-31,2014,TEX,PHI,10,14,14-10,PHI,9,0,44,50,94,192,172,364,18,23,41,3,3:36
14,380540,2014-03-31,2014,MIL,ATL,2,0,2-0,MIL,9,1,30,34,64,137,105,242,9,7,16,1,2:45
15,380549,2014-03-31,2014,ANA,SEA,3,10,10-3,SEA,9,0,36,45,81,167,145,312,8,20,28,4,3:17
16,380561,2014-04-01,2014,ARI,SFN,5,4,5-4,ARI,9,1,36,36,72,123,147,270,15,9,24,0,2:46
17,380554,2014-04-01,2014,MIL,ATL,2,5,5-2,ATL,9,0,35,37,72,125,133,258,10,11,21,1,2:34
18,380556,2014-04-01,2014,MIA,COL,4,3,4-3,MIA,9,1,29,37,66,147,107,254,6,11,17,1,2:24
19,380557,2014-04-01,2014,SDN,LAN,2,3,3-2,LAN,9,0,36,37,73,161,153,314,10,10,20,2,3:38
20,380562,2014-04-01,2014,TBA,TOR,2,4,4-2,TOR,9,0,36,37,73,168,141,309,11,11,22,2,3:32
21,380558,2014-04-01,2014,HOU,NYA,6,2,6-2,HOU,9,1,34,37,71,138,127,265,10,11,21,2,2:51
22,380560,2014-04-01,2014,ANA,SEA,3,8,8-3,SEA,9,0,35,39,74,176,121,297,10,14,24,2,3:05
23,380559,2014-04-01,2014,TEX,PHI,3,2,3-2,TEX,9,0,40,35,75,141,144,285,17,10,27,2,3:14
24,380575,2014-04-02,2014,CIN,SLN,1,0,1-0,CIN,9,0,36,33,69,137,141,278,11,6,17,1,2:45 (2:40 delay)
25,380574,2014-04-02,2014,ARI,SFN,0,2,2-0,SFN,9,0,31,37,68,149,123,272,3,10,13,2,2:49
26,380573,2014-04-02,2014,ANA,SEA,2,8,8-2,SEA,9,0,32,42,74,155,132,287,5,17,22,1,2:39
27,380564,2014-04-02,2014,BAL,BOS,2,6,6-2,BOS,9,0,35,40,75,147,139,286,7,16,23,1,2:43
28,380577,2014-04-02,2014,NYN,WAS,1,5,5-1,WAS,9,0,32,40,72,160,139,299,5,13,18,0,3:00
29,380569,2014-04-02,2014,SDN,LAN,1,5,5-1,LAN,9,0,34,39,73,151,132,283,6,13,19,2,3:02
30,380572,2014-04-02,2014,TEX,PHI,4,3,4-3,TEX,9,0,37,38,75,148,131,279,12,12,24,1,3:02
31,380576,2014-04-02,2014,TBA,TOR,0,3,3-0,TOR,9,0,32,42,74,167,118,285,6,16,22,4,2:55
32,380567,2014-04-02,2014,MIA,COL,5,6,6-5,COL,9,0,40,42,82,141,167,308,13,16,29,2,3:23
33,380568,2014-04-02,2014,DET,KCA,2,1,2-1,DET,10,0,37,37,74,144,158,302,9,9,18,0,3:22
34,380566,2014-04-02,2014,OAK,CLE,6,1,6-1,OAK,9,1,42,32,74,132,172,304,17,5,22,2,3:05
35,380571,2014-04-02,2014,HOU,NYA,3,1,3-1,HOU,9,1,32,36,68,160,129,289,9,10,19,3,3:18
36,380555,2014-04-02,2014,OAK,CLE,4,6,6-4,CLE,9,0,39,44,83,177,160,337,14,18,32,5,3:33
37,380555,2014-04-02,2014,OAK,CLE,4,6,6-4,CLE,9,0,39,44,83,177,160,337,14,18,32,5,3:33
38,380570,2014-04-02,2014,CHA,MIN,7,6,7-6,CHA,11,0,49,53,102,228,187,415,18,19,37,5,4:19
39,380565,2014-04-02,2014,PIT,CHN,4,3,4-3,PIT,16,0,65,70,135,258,256,514,21,24,45,1,5:55
40,380563,2014-04-02,2014,MIL,ATL,0,1,1-0,ATL,9,0,30,32,62,113,123,236,3,5,8,2,2:36
41,380580,2014-04-03,2014,MIA,COL,8,5,8-5,MIA,9,1,41,39,80,140,143,283,17,13,30,1,3:14
42,380587,2014-04-03,2014,TBA,TOR,7,2,7-2,TBA,9,1,38,36,74,150,157,307,16,9,25,2,3:21
43,380586,2014-04-03,2014,CIN,SLN,6,7,7-6,SLN,9,0,41,42,83,177,173,350,13,18,31,4,3:41 (3:42 delay)
44,380584,2014-04-03,2014,OAK,SEA,3,2,3-2,OAK,12,0,46,45,91,164,199,363,16,9,25,3,4:02
45,380588,2014-04-03,2014,NYN,WAS,2,8,8-2,WAS,9,0,37,44,81,174,139,313,11,18,29,1,3:21
46,380582,2014-04-03,2014,CHA,MIN,9,10,10-9,MIN,9,0,44,43,87,192,165,357,17,15,32,2,3:42
47,380583,2014-04-03,2014,HOU,NYA,2,4,4-2,NYA,9,0,36,37,73,154,128,282,13,11,24,2,3:17
48,380578,2014-04-03,2014,BAL,BOS,3,4,4-3,BOS,9,0,37,40,77,148,121,269,11,16,27,2,2:55
49,380579,2014-04-03,2014,PIT,CHN,2,3,3-2,CHN,9,0,34,33,67,129,133,262,8,8,16,3,2:39
50,380585,2014-04-03,2014,ARI,SFN,5,8,8-5,SFN,9,0,36,41,77,155,150,305,10,15,25,5,3:11
51,380594,2014-04-04,2014,NYN,CIN,4,3,4-3,NYN,9,1,33,40,73,151,132,283,9,14,23,3,2:59
52,380599,2014-04-04,2014,MIA,SDN,8,2,8-2,MIA,9,1,40,37,77,128,138,266,17,11,28,0,2:37
53,380591,2014-04-04,2014,WAS,ATL,1,2,2-1,ATL,9,0,36,35,71,125,138,263,12,9,21,1,3:03
54,380595,2014-04-04,2014,BOS,MIL,2,6,6-2,MIL,9,0,34,43,77,145,153,298,11,16,27,2,3:19
55,380598,2014-04-04,2014,CHN,PHI,2,7,7-2,PHI,9,0,32,43,75,171,128,299,6,15,21,5,3:16
56,380601,2014-04-04,2014,LAN,SFN,4,8,8-4,SFN,9,0,38,39,77,156,171,327,12,13,25,2,3:25
57,380592,2014-04-04,2014,DET,BAL,10,4,10-4,DET,9,1,42,38,80,150,151,301,21,11,32,2,3:07 (:44 delay)
58,380590,2014-04-04,2014,COL,ARI,12,2,12-2,COL,9,1,47,37,84,127,180,307,25,9,34,1,3:13
59,380603,2014-04-04,2014,TBA,TEX,8,1,8-1,TBA,9,1,44,35,79,141,171,312,18,9,27,1,3:10
60,380596,2014-04-04,2014,CLE,MIN,7,2,7-2,CLE,9,1,38,37,75,148,131,279,15,13,28,4,3:01 (2:13 delay)
61,380593,2014-04-04,2014,KCA,CHA,7,5,7-5,KCA,9,1,43,41,84,171,166,337,21,14,35,3,3:37
62,380602,2014-04-04,2014,PIT,SLN,12,2,12-2,PIT,9,1,41,37,78,149,164,313,22,10,32,2,3:07 (1:05 delay)
63,380597,2014-04-04,2014,TOR,NYA,3,7,7-3,NYA,9,0,35,45,80,170,134,304,8,21,29,4,3:26
64,380589,2014-04-04,2014,HOU,ANA,1,11,11-1,ANA,9,0,40,46,86,163,186,349,14,19,33,1,3:35
65,380615,2014-04-05,2014,OAK,SEA,1,3,3-1,SEA,9,0,34,35,69,132,113,245,7,9,16,1,2:22
66,380604,2014-04-05,2014,HOU,ANA,1,5,5-1,ANA,9,0,32,44,76,162,107,269,5,17,22,0,3:02
67,380612,2014-04-05,2014,TOR,NYA,4,0,4-0,TOR,9,1,32,37,69,155,125,280,9,12,21,3,2:45
68,380609,2014-04-05,2014,NYN,CIN,6,3,6-3,NYN,9,0,36,35,71,131,129,260,12,8,20,1,2:48
69,380613,2014-04-05,2014,CHN,PHI,0,2,2-0,PHI,9,0,37,37,74,151,136,287,11,14,25,1,2:53
70,380617,2014-04-05,2014,PIT,SLN,1,6,6-1,SLN,9,0,39,39,78,143,146,289,12,12,24,1,2:58
71,380608,2014-04-05,2014,KCA,CHA,4,3,4-3,KCA,9,1,34,39,73,154,134,288,12,12,24,2,2:59
72,380611,2014-04-05,2014,CLE,MIN,3,7,7-3,MIN,9,0,36,42,78,143,143,286,11,16,27,2,2:50
73,380606,2014-04-05,2014,WAS,ATL,2,6,6-2,ATL,9,0,37,45,82,170,151,321,11,17,28,1,3:36
74,380616,2014-04-05,2014,LAN,SFN,2,7,7-2,SFN,9,0,36,42,78,178,162,340,12,17,29,3,3:42
75,380605,2014-04-05,2014,COL,ARI,9,4,9-4,COL,9,1,36,38,74,177,114,291,13,9,22,1,3:09
76,380607,2014-04-05,2014,DET,BAL,7,6,7-6,DET,9,1,38,39,77,149,167,316,15,13,28,3,3:20
77,380614,2014-04-05,2014,MIA,SDN,5,0,5-0,MIA,9,1,39,35,74,148,153,301,16,8,24,2,2:49
78,380618,2014-04-05,2014,TBA,TEX,5,4,5-4,TBA,9,1,34,37,71,131,123,254,13,10,23,0,2:48
79,380610,2014-04-05,2014,BOS,MIL,6,7,7-6,MIL,11,0,42,53,95,188,179,367,10,20,30,5,4:23
80,380632,2014-04-06,2014,PIT,SLN,2,1,2-1,PIT,9,1,30,31,61,112,115,227,8,6,14,1,2:29
81,380631,2014-04-06,2014,LAN,SFN,6,2,6-2,LAN,9,1,31,35,66,140,101,241,7,8,15,1,2:51
82,380624,2014-04-06,2014,NYN,CIN,1,2,2-1,CIN,9,0,32,37,69,139,102,241,6,11,17,1,2:35
83,380633,2014-04-06,2014,TBA,TEX,0,3,3-0,TEX,9,0,37,35,72,140,119,259,10,8,18,2,3:01
84,380619,2014-04-06,2014,HOU,ANA,7,4,7-4,HOU,9,1,32,37,69,148,126,274,8,11,19,2,2:52
85,380629,2014-04-06,2014,MIA,SDN,2,4,4-2,SDN,9,0,32,36,68,136,129,265,6,10,16,1,2:44
86,380620,2014-04-06,2014,COL,ARI,3,5,5-3,ARI,9,0,33,42,75,126,113,239,11,18,29,0,2:29
87,380621,2014-04-06,2014,WAS,ATL,2,1,2-1,WAS,9,1,29,37,66,137,120,257,4,10,14,3,2:44
88,380623,2014-04-06,2014,KCA,CHA,1,5,5-1,CHA,9,0,33,38,71,146,131,277,8,12,20,1,2:49
89,380630,2014-04-06,2014,OAK,SEA,6,3,6-3,OAK,9,1,35,37,72,137,143,280,13,11,24,1,2:57
90,380628,2014-04-06,2014,CHN,PHI,8,3,8-3,CHN,9,1,38,40,78,142,150,292,14,13,27,2,3:14
91,380622,2014-04-06,2014,DET,BAL,1,3,3-1,BAL,9,0,33,37,70,128,127,255,6,10,16,1,2:34
92,380627,2014-04-06,2014,TOR,NYA,4,6,6-4,NYA,9,0,37,40,77,161,137,298,10,14,24,1,2:57
93,380626,2014-04-06,2014,CLE,MIN,7,10,10-7,MIN,9,0,46,45,91,194,196,390,21,21,42,4,3:55
94,380625,2014-04-06,2014,BOS,MIL,0,4,4-0,MIL,9,0,36,38,74,141,141,282,9,11,20,2,2:57
95,380641,2014-04-07,2014,KCA,TBA,4,2,4-2,KCA,9,1,35,35,70,128,137,265,13,7,20,3,2:56
96,380636,2014-04-07,2014,COL,CHA,8,1,8-1,COL,9,1,42,33,75,119,151,270,18,7,25,2,2:42
97,380634,2014-04-07,2014,HOU,ANA,1,9,9-1,ANA,9,0,31,43,74,160,132,292,5,15,20,0,2:44
98,380639,2014-04-07,2014,MIN,OAK,3,8,8-3,OAK,9,0,40,40,80,151,153,304,13,14,27,1,3:05
99,380642,2014-04-07,2014,BOS,TEX,5,1,5-1,BOS,9,1,40,35,75,132,153,285,18,10,28,1,3:07
100,380635,2014-04-07,2014,NYA,BAL,4,2,4-2,NYA,9,1,36,34,70,125,163,288,14,9,23,4,3:05
101,380637,2014-04-07,2014,SLN,CIN,5,3,5-3,SLN,9,1,39,37,76,132,154,286,16,13,29,2,2:59
102,380650,2014-04-08,2014,WAS,MIA,5,0,5-0,WAS,9,1,34,34,68,159,120,279,11,8,19,2,2:58
103,380643,2014-04-08,2014,SEA,ANA,5,3,5-3,SEA,9,1,38,34,72,120,151,271,14,8,22,5,2:59
104,380644,2014-04-08,2014,SFN,ARI,7,3,7-3,SFN,9,1,36,33,69,112,159,271,14,8,22,1,2:39
105,380654,2014-04-08,2014,KCA,TBA,0,1,1-0,TBA,9,0,37,33,70,159,133,292,12,6,18,1,3:13
106,380648,2014-04-08,2014,LAN,DET,3,2,3-2,LAN,10,0,38,35,73,155,145,300,12,7,19,1,3:23
107,380649,2014-04-08,2014,TOR,HOU,5,2,5-2,TOR,9,1,34,39,73,147,149,296,12,13,25,2,2:52
108,380651,2014-04-08,2014,ATL,NYN,0,4,4-0,NYN,9,0,37,39,76,156,137,293,8,13,21,3,3:07
109,380646,2014-04-08,2014,COL,CHA,3,15,15-3,CHA,9,0,35,50,85,174,119,293,10,26,36,2,3:10
110,380647,2014-04-08,2014,SLN,CIN,7,5,7-5,SLN,9,1,41,37,78,147,159,306,18,10,28,0,3:10
111,380655,2014-04-08,2014,BOS,TEX,7,10,10-7,TEX,9,0,40,44,84,148,160,308,18,17,35,2,3:11
112,380638,2014-04-08,2014,PHI,MIL,4,10,10-4,MIL,9,0,42,46,88,164,181,345,15,19,34,1,3:32
113,380638,2014-04-08,2014,PHI,MIL,4,10,10-4,MIL,9,0,42,46,88,164,181,345,15,19,34,1,3:32
114,380653,2014-04-08,2014,CLE,SDN,8,6,8-6,CLE,9,1,37,42,79,170,138,308,13,15,28,3,3:15
115,380652,2014-04-08,2014,CHN,PIT,6,7,7-6,PIT,9,0,38,45,83,164,140,304,11,20,31,2,3:20
116,380645,2014-04-08,2014,NYA,BAL,5,14,14-5,BAL,9,0,42,48,90,163,180,343,15,23,38,3,3:28
117,380660,2014-04-09,2014,SLN,CIN,0,4,4-0,CIN,9,0,29,40,69,131,112,243,5,13,18,0,2:19
118,380668,2014-04-09,2014,CLE,SDN,2,0,2-0,CLE,9,1,32,34,66,120,129,249,8,7,15,3,2:30
119,380665,2014-04-09,2014,ATL,NYN,4,3,4-3,ATL,9,1,33,35,68,122,131,253,9,8,17,2,2:40
120,380656,2014-04-09,2014,SEA,ANA,0,2,2-0,ANA,9,0,33,36,69,148,132,280,5,9,14,2,2:53
121,380669,2014-04-09,2014,KCA,TBA,7,3,7-3,KCA,9,1,35,36,71,136,128,264,12,10,22,0,2:46
122,380670,2014-04-09,2014,BOS,TEX,4,2,4-2,BOS,9,1,32,35,67,145,141,286,11,9,20,3,2:57
123,380640,2014-04-09,2014,CLE,SDN,1,2,2-1,SDN,9,0,35,35,70,129,146,275,8,8,16,1,2:51
124,380640,2014-04-09,2014,CLE,SDN,1,2,2-1,SDN,9,0,35,35,70,129,146,275,8,8,16,1,2:51
125,380667,2014-04-09,2014,CHN,PIT,7,5,7-5,CHN,9,1,41,34,75,130,150,280,19,7,26,0,2:41
126,380662,2014-04-09,2014,TOR,HOU,7,3,7-3,TOR,9,1,39,34,73,141,171,312,17,7,24,3,3:09
127,380658,2014-04-09,2014,NYA,BAL,4,5,5-4,BAL,9,0,36,41,77,156,134,290,13,14,27,2,3:06
128,380659,2014-04-09,2014,COL,CHA,10,4,10-4,COL,9,1,41,36,77,141,154,295,19,10,29,5,3:23
129,380664,2014-04-09,2014,PHI,MIL,4,9,9-4,MIL,9,0,39,45,84,173,136,309,12,16,28,0,3:24
130,380666,2014-04-09,2014,MIN,OAK,4,7,7-4,OAK,11,0,48,45,93,198,179,377,18,13,31,3,3:41
131,380663,2014-04-09,2014,WAS,MIA,10,7,10-7,WAS,9,1,41,46,87,195,169,364,17,20,37,4,3:56
132,380661,2014-04-09,2014,LAN,DET,6,7,7-6,DET,10,0,42,45,87,187,195,382,14,18,32,3,4:16
133,380657,2014-04-09,2014,SFN,ARI,3,7,7-3,ARI,9,0,38,41,79,150,143,293,12,14,26,0,2:52
134,380672,2014-04-10,2014,NYA,BOS,4,1,4-1,NYA,9,1,30,33,63,141,119,260,7,6,13,2,2:55
135,380675,2014-04-10,2014,WAS,MIA,7,1,7-1,WAS,9,1,37,33,70,127,147,274,14,5,19,3,2:53
136,380673,2014-04-10,2014,CHA,CLE,7,3,7-3,CHA,9,1,36,34,70,136,157,293,13,8,21,2,2:52
137,380674,2014-04-10,2014,TOR,HOU,4,6,6-4,HOU,9,0,38,37,75,146,139,285,11,12,23,1,2:49
138,380677,2014-04-10,2014,ATL,NYN,4,6,6-4,NYN,9,0,37,42,79,164,135,299,11,15,26,2,3:26
139,380671,2014-04-10,2014,SFN,ARI,5,6,6-5,ARI,10,0,45,47,92,180,175,355,18,19,37,5,4:10
140,380676,2014-04-10,2014,PHI,MIL,2,6,6-2,MIL,9,0,35,38,73,134,143,277,9,12,21,1,2:48
141,380679,2014-04-10,2014,CHN,PIT,4,5,5-4,PIT,9,0,37,40,77,166,156,322,11,13,24,3,3:20
142,380678,2014-04-10,2014,MIN,OAK,1,6,6-1,OAK,9,0,32,43,75,162,135,297,6,18,24,1,2:51
143,380693,2014-04-11,2014,BAL,TOR,0,2,2-0,TOR,9,0,35,32,67,115,120,235,8,4,12,2,2:20
144,380687,2014-04-11,2014,ARI,LAN,0,6,6-0,LAN,9,0,30,36,66,116,124,240,4,11,15,1,2:26
145,380692,2014-04-11,2014,CIN,TBA,1,2,2-1,TBA,9,0,35,38,73,153,139,292,8,12,20,1,3:22
146,380680,2014-04-11,2014,NYA,BOS,2,4,4-2,BOS,9,0,35,37,72,149,145,294,9,10,19,2,3:01
147,380690,2014-04-11,2014,SEA,OAK,6,4,6-4,SEA,9,1,38,37,75,140,142,282,12,9,21,4,3:09
148,380688,2014-04-11,2014,PHI,MIA,6,3,6-3,PHI,9,1,39,40,79,173,141,314,17,15,32,2,3:15
149,380691,2014-04-11,2014,MIL,PIT,4,2,4-2,MIL,9,1,32,33,65,131,123,254,8,6,14,0,2:41
150,380686,2014-04-11,2014,MIN,KCA,10,1,10-1,MIN,9,1,43,35,78,139,191,330,18,9,27,2,3:13
151,380689,2014-04-11,2014,ANA,NYN,5,4,5-4,ANA,11,0,53,41,94,148,195,343,24,10,34,3,3:54
152,380694,2014-04-11,2014,ATL,WAS,7,6,7-6,ATL,10,0,41,46,87,159,177,336,16,19,35,1,3:49
153,380681,2014-04-11,2014,SLN,CHN,3,6,6-3,CHN,11,0,47,45,92,179,189,368,16,16,32,2,4:09
154,380682,2014-04-11,2014,CHA,CLE,9,6,9-6,CHA,9,1,43,42,85,181,168,349,21,15,36,1,3:28
155,380685,2014-04-11,2014,TEX,HOU,1,0,1-0,TEX,12,0,52,40,92,156,211,367,22,5,27,1,4:11
156,380684,2014-04-11,2014,SDN,DET,6,0,6-0,SDN,9,1,36,30,66,108,122,230,13,3,16,1,2:25
157,380683,2014-04-11,2014,SFN,COL,6,5,6-5,SFN,9,1,35,38,73,156,138,294,10,13,23,2,3:16
158,380698,2014-04-12,2014,SFN,COL,0,1,1-0,COL,9,0,33,34,67,135,116,251,7,8,15,0,2:48
159,380701,2014-04-12,2014,MIN,KCA,7,1,7-1,MIN,9,1,35,34,69,117,160,277,9,7,16,1,2:35
160,380696,2014-04-12,2014,SLN,CHN,10,4,10-4,SLN,9,1,40,36,76,130,125,255,15,9,24,1,2:40
161,380695,2014-04-12,2014,NYA,BOS,7,4,7-4,NYA,9,1,38,38,76,138,146,284,15,11,26,4,3:07
162,380699,2014-04-12,2014,SDN,DET,2,6,6-2,DET,9,0,38,42,80,146,143,289,11,16,27,0,3:05
163,380703,2014-04-12,2014,PHI,MIA,5,4,5-4,PHI,10,0,38,46,84,159,160,319,11,16,27,2,3:29
164,380707,2014-04-12,2014,CIN,TBA,0,1,1-0,TBA,9,0,30,33,63,113,114,227,6,6,12,0,2:31
165,380709,2014-04-12,2014,ATL,WAS,6,3,6-3,ATL,9,1,40,41,81,193,148,341,16,16,32,0,3:33
166,380706,2014-04-12,2014,MIL,PIT,3,2,3-2,MIL,9,1,34,33,67,137,117,254,9,10,19,2,2:53
167,380704,2014-04-12,2014,ANA,NYN,6,7,7-6,NYN,13,0,47,57,104,243,184,427,11,20,31,4,4:29
168,380705,2014-04-12,2014,SEA,OAK,1,3,3-1,OAK,9,0,36,37,73,166,127,293,9,11,20,1,3:08
169,380708,2014-04-12,2014,BAL,TOR,2,1,2-1,BAL,12,0,44,46,90,190,176,366,13,13,26,1,3:39
170,380700,2014-04-12,2014,TEX,HOU,5,6,6-5,HOU,10,0,42,42,84,147,172,319,16,12,28,1,3:15
171,380697,2014-04-12,2014,CHA,CLE,6,12,12-6,CLE,9,0,43,47,90,189,155,344,15,21,36,4,3:28
172,380702,2014-04-12,2014,ARI,LAN,5,8,8-5,LAN,9,0,43,46,89,177,182,359,16,18,34,4,3:47
173,380721,2014-04-13,2014,MIL,PIT,4,1,4-1,MIL,9,1,34,31,65,103,105,208,11,4,15,1,2:11
174,380713,2014-04-13,2014,SFN,COL,5,4,5-4,SFN,10,0,34,36,70,120,109,229,11,8,19,2,2:41
175,380710,2014-04-13,2014,NYA,BOS,3,2,3-2,NYA,9,1,34,37,71,137,118,255,11,11,22,3,3:08
176,380716,2014-04-13,2014,MIN,KCA,4,3,4-3,MIN,9,1,33,34,67,106,153,259,11,8,19,3,2:47
177,380724,2014-04-13,2014,ATL,WAS,10,2,10-2,ATL,9,1,42,34,76,149,144,293,17,8,25,1,2:56
178,380714,2014-04-13,2014,SDN,DET,5,1,5-1,SDN,9,1,34,37,71,141,150,291,9,10,19,1,2:53
179,380718,2014-04-13,2014,PHI,MIA,4,3,4-3,PHI,9,1,41,37,78,151,140,291,20,9,29,0,3:12
180,380711,2014-04-13,2014,SLN,CHN,6,4,6-4,SLN,9,1,37,37,74,137,156,293,15,10,25,2,3:10 (:46 delay)
181,380715,2014-04-13,2014,TEX,HOU,1,0,1-0,TEX,9,1,29,29,58,119,102,221,5,8,13,0,2:15
182,380720,2014-04-13,2014,SEA,OAK,0,3,3-0,OAK,9,0,31,40,71,149,118,267,3,13,16,1,2:44
183,380717,2014-04-13,2014,ARI,LAN,6,8,8-6,LAN,9,0,42,41,83,172,170,342,17,13,30,5,3:39
184,380722,2014-04-13,2014,CIN,TBA,12,4,12-4,CIN,9,1,44,39,83,151,188,339,22,13,35,3,3:41
185,380712,2014-04-13,2014,CHA,CLE,4,3,4-3,CHA,9,0,35,39,74,171,123,294,11,12,23,2,3:18 (2:00 delay)
186,380719,2014-04-13,2014,ANA,NYN,14,2,14-2,ANA,9,1,46,34,80,150,156,306,24,10,34,0,3:05
187,380723,2014-04-13,2014,BAL,TOR,3,11,11-3,TOR,9,0,37,46,83,167,130,297,9,21,30,2,2:45
188,380731,2014-04-14,2014,MIL,SLN,0,4,4-0,SLN,9,0,33,37,70,126,131,257,6,12,18,1,2:48
189,380728,2014-04-14,2014,ANA,OAK,2,3,3-2,OAK,9,0,33,36,69,146,122,268,5,11,16,1,2:56
190,380732,2014-04-14,2014,BAL,TBA,7,1,7-1,BAL,9,1,38,33,71,130,119,249,14,9,23,1,2:46
191,380729,2014-04-14,2014,CIN,PIT,7,8,8-7,PIT,9,0,37,42,79,176,113,289,10,15,25,0,3:07 (1:38 delay)
192,380733,2014-04-14,2014,MIA,WAS,2,9,9-2,WAS,9,0,36,45,81,154,126,280,10,18,28,1,2:56
193,380729,2014-04-14,2014,CIN,PIT,7,8,8-7,PIT,9,0,37,42,79,176,113,289,10,15,25,0,3:07 (1:38 delay)
194,380730,2014-04-14,2014,TEX,SEA,1,7,7-1,SEA,9,0,34,42,76,161,149,310,11,14,25,3,3:01
195,380726,2014-04-14,2014,SDN,COL,5,4,5-4,SDN,9,1,34,40,74,150,146,296,13,14,27,1,3:19
196,380727,2014-04-14,2014,ARI,NYN,3,7,7-3,NYN,9,0,37,45,82,184,132,316,12,17,29,1,3:08
197,380725,2014-04-14,2014,PHI,ATL,6,9,9-6,ATL,9,0,39,45,84,187,154,341,12,19,31,2,3:41
198,380745,2014-04-15,2014,MIL,SLN,1,6,6-1,SLN,9,0,32,35,67,137,127,264,7,10,17,0,2:41
199,380744,2014-04-15,2014,TEX,SEA,5,0,5-0,TEX,9,1,34,36,70,113,115,228,14,9,23,1,2:22
200,380741,2014-04-15,2014,ARI,NYN,0,9,9-0,NYN,9,0,32,42,74,148,125,273,5,15,20,1,2:49
201,380739,2014-04-15,2014,HOU,KCA,2,4,4-2,KCA,9,0,34,37,71,148,132,280,7,10,17,0,2:45
202,380748,2014-04-15,2014,MIA,WAS,11,2,11-2,MIA,9,1,43,36,79,141,154,295,20,10,30,0,2:54
203,380743,2014-04-15,2014,CIN,PIT,7,5,7-5,CIN,9,1,40,39,79,157,147,304,20,11,31,2,3:13
204,380747,2014-04-15,2014,MIN,TOR,3,9,9-3,TOR,9,0,41,45,86,170,180,350,14,19,33,5,3:31
205,380740,2014-04-15,2014,SFN,LAN,3,2,3-2,SFN,12,0,54,51,105,207,211,418,23,16,39,3,4:54
206,380735,2014-04-15,2014,CHA,BOS,2,1,2-1,CHA,9,0,38,34,72,147,174,321,12,7,19,6,3:36
207,380738,2014-04-15,2014,SDN,COL,2,3,3-2,COL,9,0,35,39,74,170,132,302,11,14,25,4,3:29
208,380742,2014-04-15,2014,ANA,OAK,9,10,10-9,OAK,11,0,50,52,102,191,187,378,17,23,40,5,4:12
209,380758,2014-04-16,2014,CIN,PIT,4,0,4-0,CIN,9,1,36,30,66,107,116,223,12,3,15,0,2:22
210,380736,2014-04-16,2014,NYA,CHN,3,0,3-0,NYA,9,1,32,31,63,129,123,252,9,4,13,1,2:41
211,380736,2014-04-16,2014,NYA,CHN,3,0,3-0,NYA,9,1,32,31,63,129,123,252,9,4,13,1,2:41
212,380760,2014-04-16,2014,MIL,SLN,5,1,5-1,MIL,9,1,37,36,73,130,127,257,12,10,22,2,2:56
213,380753,2014-04-16,2014,SDN,COL,4,2,4-2,SDN,9,1,33,37,70,128,123,251,10,11,21,1,2:53
214,380756,2014-04-16,2014,ARI,NYN,2,5,5-2,NYN,9,0,34,42,76,148,107,255,8,16,24,2,2:46
215,380759,2014-04-16,2014,TEX,SEA,3,2,3-2,TEX,9,0,35,36,71,126,137,263,8,9,17,2,2:47
216,380749,2014-04-16,2014,PHI,ATL,0,1,1-0,ATL,9,0,30,38,68,128,115,243,3,12,15,0,2:29
217,380755,2014-04-16,2014,SFN,LAN,2,1,2-1,SFN,9,1,34,32,66,118,123,241,13,9,22,3,2:53
218,380761,2014-04-16,2014,BAL,TBA,3,0,3-0,BAL,9,1,34,36,70,153,133,286,10,10,20,0,2:53
219,380763,2014-04-16,2014,MIA,WAS,3,6,6-3,WAS,9,0,35,37,72,144,124,268,9,9,18,2,2:37
220,380752,2014-04-16,2014,DET,CLE,2,3,3-2,CLE,9,0,36,37,73,161,157,318,11,11,22,1,3:23
221,380751,2014-04-16,2014,NYA,CHN,2,0,2-0,NYA,9,1,38,35,73,149,144,293,13,9,22,4,3:08
222,380757,2014-04-16,2014,ANA,OAK,5,4,5-4,ANA,12,0,52,49,101,179,188,367,15,15,30,3,4:19
223,380754,2014-04-16,2014,HOU,KCA,4,6,6-4,KCA,11,0,49,48,97,193,191,384,16,17,33,2,4:05
224,380750,2014-04-16,2014,CHA,BOS,4,6,6-4,BOS,14,0,56,64,120,275,229,504,14,24,38,6,5:17
225,380764,2014-04-17,2014,PHI,ATL,1,0,1-0,PHI,9,1,29,32,61,129,103,232,9,6,15,0,2:28
226,380767,2014-04-17,2014,SDN,COL,1,3,3-1,COL,9,0,31,33,64,119,123,242,7,7,14,0,2:38
227,380768,2014-04-17,2014,HOU,KCA,1,5,5-1,KCA,9,0,33,35,68,118,121,239,7,10,17,0,2:37
228,380765,2014-04-17,2014,CHA,BOS,1,3,3-1,BOS,9,0,34,36,70,162,125,287,8,12,20,1,2:54
229,380770,2014-04-17,2014,PIT,MIL,11,2,11-2,PIT,9,1,41,34,75,94,174,268,18,9,27,1,3:06
230,380771,2014-04-17,2014,TBA,NYA,2,10,10-2,NYA,9,0,36,44,80,168,138,306,11,17,28,1,3:13
231,380774,2014-04-17,2014,MIN,TOR,7,0,7-0,MIN,9,1,39,31,70,115,180,295,15,5,20,1,2:38
232,380769,2014-04-17,2014,SFN,LAN,1,2,2-1,LAN,9,0,37,36,73,145,170,315,9,12,21,1,3:08
233,380773,2014-04-17,2014,WAS,SLN,0,8,8-0,SLN,9,0,32,50,82,192,110,302,6,21,27,1,3:10
234,380766,2014-04-17,2014,DET,CLE,7,5,7-5,DET,9,1,37,41,78,183,138,321,15,15,30,5,3:38
235,380772,2014-04-17,2014,TEX,SEA,8,6,8-6,TEX,9,1,41,41,82,165,170,335,19,15,34,3,3:28
236,380762,2014-04-17,2014,MIN,TOR,9,5,9-5,MIN,9,1,43,43,86,189,177,366,20,16,36,5,3:37
237,380762,2014-04-17,2014,MIN,TOR,9,5,9-5,MIN,9,1,43,43,86,189,177,366,20,16,36,5,3:37
238,380788,2014-04-18,2014,WAS,SLN,3,1,3-1,WAS,9,1,30,34,64,149,108,257,5,8,13,1,2:32
239,380779,2014-04-18,2014,TEX,CHA,12,0,12-0,TEX,9,1,45,31,76,109,160,269,24,4,28,1,2:41
240,380787,2014-04-18,2014,SDN,SFN,2,1,2-1,SDN,9,1,30,33,63,131,113,244,7,7,14,0,2:35
241,380789,2014-04-18,2014,CLE,TOR,2,3,3-2,TOR,9,0,41,39,80,148,159,307,14,14,28,4,3:15
242,380785,2014-04-18,2014,COL,PHI,12,1,12-1,COL,9,1,45,31,76,110,177,287,22,3,25,1,2:48
243,380777,2014-04-18,2014,NYN,ATL,0,6,6-0,ATL,9,0,34,41,75,161,151,312,7,16,23,1,2:55
244,380786,2014-04-18,2014,MIA,SEA,8,4,8-4,MIA,9,0,39,40,79,152,137,289,20,14,34,2,3:09
245,380780,2014-04-18,2014,CHN,CIN,1,4,4-1,CIN,9,0,36,40,76,161,145,306,10,12,22,2,3:09
246,380782,2014-04-18,2014,PIT,MIL,3,5,5-3,MIL,9,0,41,39,80,124,161,285,12,15,27,3,3:07
247,380784,2014-04-18,2014,TBA,NYA,11,5,11-5,TBA,9,1,44,39,83,152,183,335,22,11,33,7,3:56
248,380778,2014-04-18,2014,BOS,BAL,4,8,8-4,BAL,9,0,43,46,89,156,190,346,17,20,37,2,3:26
249,380776,2014-04-18,2014,LAN,ARI,2,4,4-2,ARI,12,0,47,48,95,189,201,390,13,13,26,3,4:13
250,380781,2014-04-18,2014,OAK,HOU,11,3,11-3,OAK,9,1,43,42,85,150,182,332,20,14,34,3,3:22
251,380775,2014-04-18,2014,DET,ANA,6,11,11-6,ANA,9,0,42,43,85,174,165,339,16,18,34,2,3:34
252,380783,2014-04-18,2014,KCA,MIN,5,0,5-0,KCA,9,1,35,34,69,140,134,274,12,9,21,1,2:39
253,380800,2014-04-19,2014,COL,PHI,3,1,3-1,COL,9,1,30,33,63,114,92,206,6,6,12,1,2:23
254,380802,2014-04-19,2014,SDN,SFN,3,1,3-1,SDN,9,1,32,30,62,118,107,225,9,4,13,1,2:36
255,380803,2014-04-19,2014,WAS,SLN,3,4,4-3,SLN,9,0,39,36,75,119,133,252,12,11,23,2,2:44
256,380794,2014-04-19,2014,TEX,CHA,6,3,6-3,TEX,9,1,36,37,73,132,145,277,15,12,27,2,2:49
257,380798,2014-04-19,2014,KCA,MIN,5,4,5-4,KCA,9,1,37,39,76,151,130,281,13,13,26,0,2:54
258,380799,2014-04-19,2014,TBA,NYA,16,1,16-1,TBA,9,1,46,29,75,114,181,295,22,3,25,3,3:15
259,380790,2014-04-19,2014,DET,ANA,5,2,5-2,DET,9,1,39,32,71,142,165,307,17,6,23,0,3:13
260,380793,2014-04-19,2014,BOS,BAL,4,2,4-2,BOS,9,1,31,36,67,137,123,260,8,9,17,2,2:47
261,380792,2014-04-19,2014,NYN,ATL,5,7,7-5,ATL,9,0,43,41,84,146,155,301,16,15,31,1,3:13
262,380796,2014-04-19,2014,OAK,HOU,4,3,4-3,OAK,9,0,43,34,77,119,159,278,18,9,27,1,3:07
263,380804,2014-04-19,2014,CLE,TOR,0,5,5-0,TOR,9,0,34,40,74,144,142,286,9,13,22,2,2:42
264,380791,2014-04-19,2014,LAN,ARI,8,6,8-6,LAN,9,1,35,39,74,139,126,265,10,12,22,2,2:48
265,380795,2014-04-19,2014,CHN,CIN,8,4,8-4,CHN,9,1,38,39,77,139,165,304,16,13,29,2,3:20
266,380801,2014-04-19,2014,MIA,SEA,7,0,7-0,MIA,9,1,39,28,67,90,147,237,17,2,19,1,2:20
267,380797,2014-04-19,2014,PIT,MIL,7,8,8-7,MIL,9,0,41,42,83,139,140,279,15,15,30,1,3:04
268,380806,2014-04-20,2014,LAN,ARI,4,1,4-1,LAN,9,1,30,33,63,147,117,264,8,7,15,2,2:45
269,380811,2014-04-20,2014,OAK,HOU,4,1,4-1,OAK,9,1,37,37,74,149,134,283,15,9,24,1,2:54
270,380817,2014-04-20,2014,SDN,SFN,3,4,4-3,SFN,9,0,35,34,69,148,145,293,12,7,19,2,2:59
271,380805,2014-04-20,2014,DET,ANA,2,1,2-1,DET,9,1,34,33,67,131,166,297,11,8,19,2,3:28
272,380816,2014-04-20,2014,MIA,SEA,3,2,3-2,MIA,9,1,34,35,69,132,135,267,11,9,20,6,2:58
273,380808,2014-04-20,2014,BOS,BAL,6,5,6-5,BOS,9,0,41,43,84,141,171,312,14,17,31,7,3:32
274,380813,2014-04-20,2014,KCA,MIN,3,8,8-3,MIN,9,0,38,46,84,191,129,320,12,21,33,3,3:08
275,380810,2014-04-20,2014,CHN,CIN,2,8,8-2,CIN,9,0,43,45,88,190,179,369,18,18,36,2,3:50
276,380815,2014-04-20,2014,COL,PHI,9,10,10-9,PHI,9,0,46,44,90,175,165,340,22,16,38,4,4:08
277,380807,2014-04-20,2014,NYN,ATL,4,3,4-3,NYN,14,0,56,54,110,210,205,415,15,16,31,1,4:37
278,380819,2014-04-20,2014,CLE,TOR,6,4,6-4,CLE,9,1,34,40,74,140,151,291,11,14,25,4,2:55
279,380814,2014-04-20,2014,TBA,NYA,1,5,5-1,NYA,12,0,48,50,98,173,176,349,12,16,28,6,4:23
280,380818,2014-04-20,2014,WAS,SLN,3,2,3-2,WAS,9,0,46,34,80,121,171,292,19,8,27,2,3:18
281,380812,2014-04-20,2014,PIT,MIL,2,3,3-2,MIL,14,0,55,55,110,175,219,394,14,19,33,1,4:21
282,380809,2014-04-20,2014,TEX,CHA,2,16,16-2,CHA,9,0,33,49,82,175,144,319,11,21,32,1,3:16
283,380829,2014-04-21,2014,MIL,SDN,4,3,4-3,MIL,9,1,34,39,73,130,124,254,15,11,26,1,2:47
284,380826,2014-04-21,2014,CLE,KCA,4,3,4-3,CLE,9,1,34,34,68,128,123,251,11,7,18,2,2:37
285,380828,2014-04-21,2014,LAN,PHI,0,7,7-0,PHI,9,0,31,42,73,159,124,283,5,14,19,0,2:47
286,380821,2014-04-21,2014,CHN,ARI,5,1,5-1,CHN,9,1,35,35,70,135,136,271,13,8,21,1,2:40 (1:01 delay)
287,380823,2014-04-21,2014,DET,CHA,1,3,3-1,CHA,9,0,38,34,72,131,136,267,13,7,20,3,3:06
288,380827,2014-04-21,2014,ATL,MIA,4,2,4-2,ATL,10,0,43,42,85,159,159,318,16,12,28,2,3:41
289,380820,2014-04-21,2014,WAS,ANA,2,4,4-2,ANA,9,0,37,41,78,147,163,310,11,16,27,2,3:18
290,380824,2014-04-21,2014,PIT,CIN,6,5,6-5,PIT,9,0,41,41,82,139,128,267,17,16,33,2,3:02
291,380832,2014-04-21,2014,OAK,TEX,3,4,4-3,TEX,9,0,41,41,82,146,166,312,14,16,30,3,3:25
292,380822,2014-04-21,2014,BOS,BAL,6,7,7-6,BAL,9,0,41,37,78,127,177,304,17,14,31,2,3:18
293,380831,2014-04-21,2014,NYN,SLN,2,0,2-0,NYN,9,1,35,34,69,133,118,251,13,9,22,2,2:34
294,380825,2014-04-21,2014,SEA,HOU,2,7,7-2,HOU,9,0,35,38,73,122,155,277,8,11,19,0,2:49
295,380830,2014-04-21,2014,COL,SFN,8,2,8-2,COL,9,1,38,37,75,161,132,293,16,10,26,1,3:13
296,380845,2014-04-22,2014,COL,SFN,2,1,2-1,COL,9,1,33,37,70,137,97,234,11,11,22,2,2:41
297,380833,2014-04-22,2014,WAS,ANA,2,7,7-2,ANA,9,0,33,38,71,124,115,239,8,10,18,0,2:43
298,380846,2014-04-22,2014,NYN,SLN,0,3,3-0,SLN,9,0,31,39,70,154,110,264,6,15,21,0,2:40
299,380840,2014-04-22,2014,ATL,MIA,0,1,1-0,MIA,9,0,30,31,61,113,117,230,3,4,7,0,2:08
300,380838,2014-04-22,2014,SEA,HOU,2,5,5-2,HOU,9,0,32,41,73,164,128,292,6,14,20,2,3:02
301,380841,2014-04-22,2014,TBA,MIN,7,3,7-3,TBA,9,1,39,33,72,113,159,272,16,7,23,1,2:53
302,380837,2014-04-22,2014,PIT,CIN,1,4,4-1,CIN,9,0,33,38,71,138,117,255,6,12,18,1,2:47
303,380835,2014-04-22,2014,TOR,BAL,9,3,9-3,TOR,9,1,40,40,80,143,158,301,15,14,29,5,2:54
304,380847,2014-04-22,2014,OAK,TEX,4,5,5-4,TEX,9,0,39,38,77,115,141,256,13,15,28,3,3:01
305,380839,2014-04-22,2014,CLE,KCA,2,8,8-2,KCA,9,0,39,44,83,170,159,329,11,19,30,4,3:34
306,380842,2014-04-22,2014,BOS,NYA,3,9,9-3,NYA,9,0,35,45,80,177,131,308,9,19,28,2,3:17
307,380834,2014-04-22,2014,CHN,ARI,9,2,9-2,CHN,9,1,39,31,70,150,174,324,15,6,21,2,3:05
308,380843,2014-04-22,2014,LAN,PHI,2,3,3-2,PHI,10,0,39,44,83,171,138,309,9,15,24,1,3:36
309,380844,2014-04-22,2014,MIL,SDN,1,2,2-1,SDN,12,0,48,44,92,169,201,370,12,9,21,0,4:04
310,380836,2014-04-22,2014,DET,CHA,8,6,8-6,DET,9,1,42,42,84,170,159,329,18,17,35,3,3:22
311,380862,2014-04-23,2014,OAK,TEX,0,3,3-0,TEX,9,0,30,38,68,140,109,249,5,12,17,0,2:35
312,380859,2014-04-23,2014,MIL,SDN,5,2,5-2,MIL,9,1,33,35,68,142,131,273,11,7,18,1,2:38
313,380853,2014-04-23,2014,SEA,HOU,5,3,5-3,SEA,9,0,33,39,72,158,128,286,10,13,23,1,2:50
314,380851,2014-04-23,2014,DET,CHA,4,6,6-4,CHA,9,0,35,36,71,143,130,273,9,12,21,3,2:51
315,380855,2014-04-23,2014,ATL,MIA,3,1,3-1,ATL,9,1,35,35,70,145,153,298,11,10,21,4,3:01
316,380854,2014-04-23,2014,CLE,KCA,5,3,5-3,CLE,9,1,38,39,77,136,150,286,16,12,28,3,3:05
317,380849,2014-04-23,2014,CHN,ARI,5,7,7-5,ARI,9,0,35,42,77,161,147,308,8,14,22,4,3:11
318,380858,2014-04-23,2014,LAN,PHI,5,2,5-2,LAN,9,1,36,33,69,134,126,260,13,7,20,3,2:52
319,380861,2014-04-23,2014,NYN,SLN,3,2,3-2,NYN,9,1,35,39,74,146,170,316,10,13,23,4,3:08
320,380848,2014-04-23,2014,WAS,ANA,5,4,5-4,WAS,9,0,40,40,80,160,142,302,14,16,30,3,3:18
321,380850,2014-04-23,2014,TOR,BAL,8,10,10-8,BAL,9,0,45,42,87,160,163,323,20,18,38,5,3:11
322,380860,2014-04-23,2014,COL,SFN,10,12,12-10,SFN,11,0,52,53,105,209,191,400,21,24,45,2,4:26
323,380852,2014-04-23,2014,PIT,CIN,2,5,5-2,CIN,9,0,39,39,78,166,151,317,11,15,26,2,3:20
324,380857,2014-04-23,2014,BOS,NYA,5,1,5-1,BOS,9,1,38,35,73,125,164,289,14,8,22,3,3:12
325,380856,2014-04-23,2014,TBA,MIN,4,6,6-4,MIN,12,0,51,52,103,233,182,415,15,19,34,5,4:48
326,380867,2014-04-24,2014,CLE,KCA,5,1,5-1,CLE,9,1,31,31,62,101,115,216,8,4,12,1,2:15
327,380866,2014-04-24,2014,PIT,CIN,1,2,2-1,CIN,9,0,36,35,71,129,136,265,9,10,19,0,2:46
328,380871,2014-04-24,2014,LAN,PHI,3,7,7-3,PHI,9,0,40,44,84,171,157,328,13,19,32,2,3:33
329,380864,2014-04-24,2014,TOR,BAL,4,11,11-4,BAL,9,0,35,45,80,179,120,299,10,19,29,3,2:54
330,380865,2014-04-24,2014,DET,CHA,7,4,7-4,DET,9,1,38,39,77,166,148,314,15,13,28,1,3:14
331,380873,2014-04-24,2014,NYN,SLN,4,1,4-1,NYN,9,1,33,34,67,154,125,279,10,6,16,3,3:03
332,380870,2014-04-24,2014,HOU,OAK,1,10,10-1,OAK,9,0,39,48,87,177,145,322,14,20,34,2,3:29
333,380868,2014-04-24,2014,TBA,MIN,7,9,9-7,MIN,9,0,41,49,90,206,149,355,17,22,39,3,3:42
334,380869,2014-04-24,2014,BOS,NYA,5,14,14-5,NYA,9,0,40,56,96,217,163,380,12,27,39,4,3:51
335,380872,2014-04-24,2014,WAS,SDN,3,4,4-3,SDN,12,0,53,46,99,188,195,383,19,12,31,2,4:14
336,380863,2014-04-24,2014,CHN,ARI,2,5,5-2,ARI,9,0,35,36,71,128,129,257,7,11,18,2,2:51
337,380878,2014-04-25,2014,SFN,CLE,5,1,5-1,SFN,9,1,31,37,68,142,128,270,8,9,17,1,2:42
338,380877,2014-04-25,2014,ATL,CIN,5,4,5-4,ATL,9,1,33,38,71,128,120,248,11,13,24,4,2:41
339,380876,2014-04-25,2014,MIL,CHN,5,2,5-2,MIL,9,1,38,33,71,127,142,269,14,6,20,0,3:12
340,380886,2014-04-25,2014,WAS,SDN,11,1,11-1,WAS,9,1,45,37,82,146,161,307,21,12,33,1,3:08 (:57 delay)
341,380879,2014-04-25,2014,LAN,COL,4,5,5-4,COL,11,0,43,42,85,139,166,305,11,9,20,2,3:40
342,380885,2014-04-25,2014,SLN,PIT,1,0,1-0,SLN,9,1,35,35,70,157,123,280,12,11,23,1,3:03
343,380884,2014-04-25,2014,ARI,PHI,5,4,5-4,ARI,9,1,35,40,75,183,135,318,11,14,25,2,3:21
344,380875,2014-04-25,2014,TOR,BOS,1,8,8-1,BOS,9,0,34,47,81,184,144,328,8,23,31,2,2:57
345,380874,2014-04-25,2014,NYA,ANA,1,13,13-1,ANA,9,0,37,45,82,175,177,352,11,17,28,2,3:30
346,380887,2014-04-25,2014,CHA,TBA,9,6,9-6,CHA,9,0,39,44,83,196,148,344,15,21,36,3,4:04
347,380880,2014-04-25,2014,MIN,DET,6,10,10-6,DET,9,0,40,43,83,160,176,336,13,17,30,6,3:32
348,380883,2014-04-25,2014,HOU,OAK,5,12,12-5,OAK,9,0,41,52,93,214,148,362,14,25,39,3,4:06
349,380888,2014-04-25,2014,SEA,TEX,6,5,6-5,SEA,9,1,37,39,76,148,144,292,15,15,30,2,2:55
350,380882,2014-04-25,2014,NYN,MIA,4,3,4-3,NYN,9,0,38,37,75,152,142,294,13,10,23,0,2:59
351,380881,2014-04-25,2014,BAL,KCA,0,5,5-0,KCA,9,0,36,41,77,149,124,273,10,15,25,1,2:40 (:55 delay)
352,380892,2014-04-26,2014,ATL,CIN,4,1,4-1,ATL,9,1,32,31,63,123,99,222,9,5,14,1,2:17
353,380896,2014-04-26,2014,BAL,KCA,3,2,3-2,BAL,10,0,39,43,82,141,143,284,10,14,24,4,3:09
354,380900,2014-04-26,2014,SLN,PIT,1,6,6-1,PIT,9,0,37,36,73,108,167,275,10,9,19,3,3:02
355,380897,2014-04-26,2014,NYN,MIA,6,7,7-6,MIA,10,0,41,44,85,151,162,313,11,14,25,2,3:35
356,380903,2014-04-26,2014,SEA,TEX,3,6,6-3,TEX,9,0,38,41,79,155,140,295,12,15,27,4,3:13
357,380902,2014-04-26,2014,CHA,TBA,0,4,4-0,TBA,9,0,34,41,75,184,117,301,8,13,21,2,3:11
358,380901,2014-04-26,2014,WAS,SDN,4,0,4-0,WAS,9,1,37,31,68,105,136,241,12,4,16,0,2:19
359,380898,2014-04-26,2014,HOU,OAK,7,6,7-6,HOU,9,1,33,39,72,155,126,281,10,14,24,4,3:13
360,380890,2014-04-26,2014,TOR,BOS,6,7,7-6,BOS,9,0,44,38,82,158,164,322,17,14,31,4,3:23
361,380891,2014-04-26,2014,MIL,CHN,5,3,5-3,MIL,9,1,35,31,66,128,130,258,12,4,16,2,2:51
362,380889,2014-04-26,2014,NYA,ANA,4,3,4-3,NYA,9,1,34,40,74,161,125,286,10,13,23,5,3:05
363,380894,2014-04-26,2014,LAN,COL,6,3,6-3,LAN,9,1,39,37,76,145,154,299,17,13,30,2,3:38
364,380899,2014-04-26,2014,ARI,PHI,5,6,6-5,PHI,9,0,40,44,84,161,131,292,16,17,33,3,3:05
365,380895,2014-04-26,2014,MIN,DET,5,3,5-3,MIN,9,1,36,35,71,142,163,305,13,9,22,3,3:13
366,380893,2014-04-26,2014,SFN,CLE,5,3,5-3,SFN,9,1,32,39,71,148,118,266,8,13,21,3,2:47
367,380915,2014-04-27,2014,SLN,PIT,7,0,7-0,SLN,9,1,33,32,65,114,112,226,10,6,16,1,2:35
368,380913,2014-04-27,2014,HOU,OAK,5,1,5-1,HOU,9,1,34,33,67,117,123,240,9,6,15,2,2:32
369,380908,2014-04-27,2014,SFN,CLE,4,1,4-1,SFN,9,0,35,31,66,130,131,261,11,5,16,1,2:43
370,380907,2014-04-27,2014,ATL,CIN,1,0,1-0,ATL,10,0,39,36,75,136,142,278,10,7,17,2,3:02
371,380917,2014-04-27,2014,CHA,TBA,9,2,9-2,CHA,9,1,38,35,73,124,131,255,13,12,25,2,2:55
372,380914,2014-04-27,2014,ARI,PHI,0,2,2-0,PHI,9,0,33,35,68,123,120,243,7,9,16,0,2:37
373,380911,2014-04-27,2014,BAL,KCA,3,9,9-3,KCA,9,0,34,44,78,176,140,316,7,17,24,1,3:08
374,380905,2014-04-27,2014,TOR,BOS,7,1,7-1,TOR,9,1,33,34,67,132,139,271,9,7,16,2,2:28
375,380918,2014-04-27,2014,SEA,TEX,6,5,6-5,SEA,9,1,36,38,74,163,144,307,12,11,23,1,3:10
376,380904,2014-04-27,2014,NYA,ANA,3,2,3-2,NYA,9,1,32,37,69,156,140,296,8,12,20,3,3:28
377,380912,2014-04-27,2014,NYN,MIA,4,0,4-0,NYN,9,1,35,32,67,125,153,278,11,7,18,0,2:42
378,380909,2014-04-27,2014,LAN,COL,1,6,6-1,COL,9,0,38,39,77,134,136,270,12,12,24,1,3:09
379,380916,2014-04-27,2014,WAS,SDN,2,4,4-2,SDN,9,0,33,39,72,160,142,302,6,14,20,2,3:12
380,380906,2014-04-27,2014,MIL,CHN,0,4,4-0,CHN,9,0,32,36,68,132,120,252,5,10,15,1,2:47
381,380920,2014-04-28,2014,ANA,CLE,6,3,6-3,ANA,9,1,34,34,68,136,125,261,11,7,18,1,2:39
382,380921,2014-04-28,2014,ARI,COL,5,8,8-5,COL,9,0,38,40,78,147,144,291,13,15,28,2,3:03
383,380923,2014-04-28,2014,TEX,OAK,0,4,4-0,OAK,9,0,30,38,68,171,108,279,4,15,19,1,3:03
384,380925,2014-04-28,2014,CHA,TBA,7,3,7-3,CHA,9,1,40,38,78,141,156,297,18,10,28,2,3:19
385,380922,2014-04-28,2014,SLN,MIL,3,5,5-3,MIL,12,0,52,52,104,183,212,395,16,18,34,2,4:16
386,380924,2014-04-28,2014,SFN,SDN,4,6,6-4,SDN,9,0,36,43,79,158,149,307,12,14,26,2,3:29
387,380926,2014-04-29,2014,MIA,ATL,9,0,9-0,MIA,9,1,37,32,69,109,111,220,14,5,19,1,2:07
388,380936,2014-04-29,2014,SFN,SDN,6,0,6-0,SFN,9,1,36,29,65,105,112,217,13,3,16,1,2:28
389,380930,2014-04-29,2014,CHA,DET,3,4,4-3,DET,9,0,36,36,72,159,141,300,12,9,21,0,3:04 (:21 delay)
390,380927,2014-04-29,2014,CIN,CHN,3,2,3-2,CIN,9,1,38,37,75,151,146,297,16,12,28,2,3:00 (1:45 delay)
391,380934,2014-04-29,2014,TEX,OAK,3,9,9-3,OAK,9,0,37,41,78,146,147,293,11,16,27,2,3:08
392,380929,2014-04-29,2014,ARI,COL,4,5,5-4,COL,9,0,42,39,81,140,146,286,15,12,27,2,3:10
393,380940,2014-04-29,2014,HOU,WAS,3,4,4-3,WAS,9,0,37,41,78,167,156,323,10,16,26,2,3:25
394,380933,2014-04-29,2014,PHI,NYN,1,6,6-1,NYN,9,0,34,39,73,154,148,302,7,15,22,1,2:53 (1:28 delay)
395,380932,2014-04-29,2014,SLN,MIL,4,5,5-4,MIL,11,0,46,44,90,174,182,356,15,11,26,0,3:39
396,380928,2014-04-29,2014,ANA,CLE,6,4,6-4,ANA,9,1,44,40,84,145,161,306,21,15,36,7,3:36
397,380938,2014-04-29,2014,BOS,TBA,7,4,7-4,BOS,9,1,41,37,78,134,198,332,18,10,28,2,3:40
398,380937,2014-04-29,2014,NYA,SEA,3,6,6-3,SEA,9,0,39,44,83,180,172,352,12,17,29,3,3:33
399,380939,2014-04-29,2014,KCA,TOR,10,7,10-7,KCA,9,1,39,42,81,133,164,297,16,15,31,5,3:08 (:27 delay)
400,380951,2014-04-30,2014,SFN,SDN,3,2,3-2,SFN,9,1,34,32,66,94,117,211,11,5,16,2,2:17
401,380954,2014-04-30,2014,KCA,TOR,4,2,4-2,KCA,9,1,31,41,72,178,117,295,7,14,21,1,2:59
402,380941,2014-04-30,2014,MIA,ATL,9,3,9-3,MIA,9,1,41,33,74,126,158,284,17,7,24,2,2:50
403,380945,2014-04-30,2014,CHA,DET,1,5,5-1,DET,9,0,36,41,77,160,142,302,9,13,22,2,3:03
404,380955,2014-04-30,2014,HOU,WAS,0,7,7-0,WAS,9,0,37,41,78,144,145,289,11,16,27,2,3:02
405,380949,2014-04-30,2014,TEX,OAK,1,12,12-1,OAK,9,0,32,49,81,184,122,306,5,20,25,1,2:57
406,380947,2014-04-30,2014,SLN,MIL,9,3,9-3,SLN,9,1,44,39,83,135,180,315,20,13,33,2,3:25
407,380942,2014-04-30,2014,CIN,CHN,4,9,9-4,CHN,9,0,36,47,83,185,143,328,9,20,29,3,3:39
408,380943,2014-04-30,2014,ANA,CLE,7,1,7-1,ANA,9,1,36,30,66,126,145,271,13,5,18,2,2:46
409,380944,2014-04-30,2014,ARI,COL,5,4,5-4,ARI,10,0,40,39,79,136,159,295,13,10,23,0,2:57
410,380946,2014-04-30,2014,MIN,LAN,4,6,6-4,LAN,9,0,40,44,84,140,190,330,14,16,30,4,3:38
411,380959,2014-05-01,2014,COL,NYN,7,4,7-4,COL,9,1,36,35,71,135,122,257,13,9,22,1,2:48
412,380958,2014-05-01,2014,CIN,MIL,8,3,8-3,CIN,9,1,44,35,79,115,154,269,23,9,32,1,2:52
413,380935,2014-05-01,2014,BAL,PIT,5,1,5-1,BAL,9,1,35,41,76,162,134,296,12,15,27,5,3:08 (:21 delay)
414,380960,2014-05-01,2014,NYA,SEA,2,4,4-2,SEA,9,0,35,35,70,131,138,269,9,9,18,1,2:47
415,380956,2014-05-01,2014,MIA,ATL,5,4,5-4,MIA,9,1,37,39,76,135,133,268,13,13,26,3,2:54
416,380962,2014-05-01,2014,KCA,TOR,3,7,7-3,TOR,9,0,35,44,79,167,116,283,9,17,26,2,2:35
417,380957,2014-05-01,2014,MIN,LAN,4,9,9-4,LAN,9,0,37,45,82,156,139,295,10,21,31,2,3:01
418,380935,2014-05-01,2014,BAL,PIT,5,1,5-1,BAL,9,1,35,41,76,162,134,296,12,15,27,5,3:08 (:21 delay)
419,380953,2014-05-01,2014,BOS,TBA,1,2,2-1,TBA,9,0,39,35,74,150,161,311,13,10,23,2,3:27
420,380953,2014-05-01,2014,BOS,TBA,1,2,2-1,TBA,9,0,39,35,74,150,161,311,13,10,23,2,3:27
421,380961,2014-05-01,2014,BOS,TBA,5,6,6-5,TBA,9,0,42,38,80,146,175,321,17,11,28,3,3:44
422,380950,2014-05-01,2014,BAL,PIT,6,5,6-5,BAL,10,0,41,50,91,212,165,377,15,21,36,6,3:57 (:46 delay)
423,380950,2014-05-01,2014,BAL,PIT,6,5,6-5,BAL,10,0,41,50,91,212,165,377,15,21,36,6,3:57 (:46 delay)
424,380931,2014-05-01,2014,MIN,LAN,3,4,4-3,LAN,12,0,49,56,105,255,223,478,13,23,36,7,5:11
425,380931,2014-05-01,2014,MIN,LAN,3,4,4-3,LAN,12,0,49,56,105,255,223,478,13,23,36,7,5:11
426,380964,2014-05-02,2014,MIN,BAL,0,3,3-0,BAL,9,0,33,36,69,110,151,261,5,10,15,1,2:29
427,380968,2014-05-02,2014,CIN,MIL,0,2,2-0,MIL,9,0,32,34,66,118,122,240,5,9,14,0,2:35
428,380967,2014-05-02,2014,MIA,LAN,6,3,6-3,MIA,9,1,36,37,73,139,138,277,14,11,25,2,3:08
429,380966,2014-05-02,2014,KCA,DET,2,8,8-2,DET,9,0,31,42,73,139,116,255,4,16,20,1,2:41
430,380972,2014-05-02,2014,ATL,SFN,1,2,2-1,SFN,9,0,40,36,76,136,150,286,13,10,23,2,3:08
431,380969,2014-05-02,2014,COL,NYN,10,3,10-3,COL,9,1,38,38,76,145,128,273,14,13,27,0,3:02
432,380977,2014-05-02,2014,PHI,WAS,3,5,5-3,WAS,9,0,36,41,77,166,126,292,11,14,25,2,3:11
433,380963,2014-05-02,2014,SDN,ARI,0,2,2-0,ARI,9,0,31,36,67,134,114,248,4,10,14,0,2:24
434,380975,2014-05-02,2014,ANA,TEX,2,5,5-2,TEX,9,0,38,38,76,146,140,286,11,12,23,6,3:14
435,380976,2014-05-02,2014,PIT,TOR,6,5,6-5,PIT,9,0,42,40,82,161,169,330,19,12,31,0,3:21
436,380973,2014-05-02,2014,CHN,SLN,6,5,6-5,CHN,9,1,36,36,72,143,146,289,14,9,23,1,3:08
437,380965,2014-05-02,2014,CLE,CHA,12,5,12-5,CLE,9,1,43,40,83,164,168,332,19,14,33,3,3:26
438,380971,2014-05-02,2014,HOU,SEA,5,4,5-4,HOU,11,0,49,42,91,162,184,346,18,12,30,3,4:02
439,380974,2014-05-02,2014,NYA,TBA,5,10,10-5,TBA,14,0,60,65,125,260,228,488,21,30,51,5,5:49
440,380970,2014-05-02,2014,BOS,OAK,7,1,7-1,BOS,9,1,41,36,77,155,186,341,19,10,29,4,3:37
441,380980,2014-05-03,2014,CLE,CHA,2,0,2-0,CLE,9,1,31,33,64,129,127,256,7,7,14,1,2:38
442,380978,2014-05-03,2014,SDN,ARI,3,4,4-3,ARI,9,0,36,42,78,168,131,299,11,16,27,2,3:11
443,380988,2014-05-03,2014,CHN,SLN,3,0,3-0,CHN,9,1,33,35,68,123,126,249,9,9,18,3,2:43
444,380985,2014-05-03,2014,BOS,OAK,6,3,6-3,BOS,9,1,34,34,68,143,120,263,10,8,18,2,2:44
445,380987,2014-05-03,2014,ATL,SFN,1,3,3-1,SFN,9,0,35,32,67,109,145,254,10,5,15,1,2:51
446,380981,2014-05-03,2014,KCA,DET,2,9,9-2,DET,9,0,33,43,76,160,126,286,7,20,27,1,2:55
447,380983,2014-05-03,2014,CIN,MIL,6,2,6-2,CIN,9,1,38,31,69,119,124,243,14,4,18,0,2:30
448,380992,2014-05-03,2014,PHI,WAS,7,2,7-2,PHI,9,1,39,35,74,139,153,292,15,7,22,1,2:57 (:24 delay)
449,380986,2014-05-03,2014,HOU,SEA,8,9,9-8,SEA,9,0,41,41,82,131,148,279,16,14,30,6,3:24
450,380990,2014-05-03,2014,ANA,TEX,5,3,5-3,ANA,9,1,42,38,80,149,175,324,18,13,31,1,3:24
451,380991,2014-05-03,2014,PIT,TOR,8,6,8-6,PIT,9,1,42,42,84,161,163,324,20,15,35,3,3:19
452,380984,2014-05-03,2014,COL,NYN,11,10,11-10,COL,9,0,42,49,91,178,133,311,19,22,41,4,3:47
453,380979,2014-05-03,2014,MIN,BAL,6,1,6-1,MIN,9,1,36,34,70,131,159,290,13,7,20,2,2:51
454,380989,2014-05-03,2014,NYA,TBA,9,3,9-3,NYA,9,1,40,36,76,145,177,322,17,9,26,1,3:31
455,380982,2014-05-03,2014,MIA,LAN,7,9,9-7,LAN,11,0,53,48,101,170,204,374,24,18,42,1,4:07
456,381004,2014-05-04,2014,NYA,TBA,1,5,5-1,TBA,9,0,36,41,77,149,126,275,9,14,23,2,3:14
457,380995,2014-05-04,2014,CLE,CHA,3,4,4-3,CHA,9,0,42,34,76,139,164,303,15,8,23,2,2:55
458,381002,2014-05-04,2014,ATL,SFN,1,4,4-1,SFN,9,0,34,41,75,168,141,309,6,16,22,2,3:15
459,381007,2014-05-04,2014,PHI,WAS,1,0,1-0,PHI,9,1,30,36,66,135,116,251,8,9,17,3,2:45
460,380998,2014-05-04,2014,CIN,MIL,4,3,4-3,CIN,10,0,41,37,78,123,155,278,14,9,23,3,3:06
461,380993,2014-05-04,2014,SDN,ARI,4,3,4-3,SDN,9,0,35,37,72,142,134,276,10,10,20,0,2:56
462,380997,2014-05-04,2014,MIA,LAN,5,4,5-4,MIA,9,0,38,40,78,152,138,290,12,15,27,1,3:06
463,381001,2014-05-04,2014,HOU,SEA,7,8,8-7,SEA,9,0,40,42,82,157,157,314,13,16,29,1,3:30
464,381000,2014-05-04,2014,BOS,OAK,2,3,3-2,OAK,10,0,37,42,79,191,147,338,11,15,26,5,3:45
465,380996,2014-05-04,2014,KCA,DET,4,9,9-4,DET,9,0,39,46,85,184,150,334,12,21,33,0,3:11
466,381005,2014-05-04,2014,ANA,TEX,3,14,14-3,TEX,9,0,37,52,89,216,158,374,11,26,37,3,3:57
467,380994,2014-05-04,2014,MIN,BAL,5,2,5-2,MIN,9,1,40,37,77,136,155,291,17,9,26,5,3:02
468,380999,2014-05-04,2014,COL,NYN,1,5,5-1,NYN,9,0,35,41,76,135,158,293,9,17,26,2,3:03
469,381003,2014-05-04,2014,CHN,SLN,4,5,5-4,SLN,9,0,39,39,78,157,154,311,12,15,27,1,3:14
470,381006,2014-05-04,2014,PIT,TOR,2,7,7-2,TOR,9,0,34,41,75,138,139,277,8,15,23,1,2:49
471,381016,2014-05-05,2014,OAK,SEA,2,4,4-2,SEA,9,0,32,38,70,133,116,249,7,12,19,4,2:36
472,381019,2014-05-05,2014,COL,TEX,8,2,8-2,COL,9,1,40,35,75,126,148,274,18,11,29,3,3:01
473,381010,2014-05-05,2014,DET,HOU,2,0,2-0,DET,9,1,33,31,64,124,121,245,10,6,16,0,2:53
474,381014,2014-05-05,2014,ANA,NYA,4,1,4-1,ANA,9,1,35,32,67,120,159,279,12,7,19,3,3:09
475,381012,2014-05-05,2014,WAS,LAN,4,0,4-0,WAS,9,1,36,33,69,111,147,258,14,8,22,0,2:59 (3:17 delay)
476,381018,2014-05-05,2014,ATL,SLN,3,4,4-3,SLN,9,0,38,38,76,146,143,289,12,10,22,1,3:15
477,381015,2014-05-05,2014,MIA,NYN,4,3,4-3,MIA,9,0,40,34,74,135,168,303,16,8,24,2,2:53
478,381013,2014-05-05,2014,CLE,MIN,0,1,1-0,MIN,10,0,34,41,75,165,144,309,6,10,16,2,3:09
479,381008,2014-05-05,2014,MIL,ARI,8,3,8-3,MIL,9,1,38,42,80,149,165,314,16,15,31,1,3:19
480,381009,2014-05-05,2014,CHN,CHA,1,3,3-1,CHA,12,0,44,47,91,177,170,347,9,11,20,2,3:51
481,381011,2014-05-05,2014,SDN,KCA,6,5,6-5,SDN,12,0,46,52,98,184,190,374,11,18,29,2,3:57
482,381017,2014-05-05,2014,PIT,SFN,10,11,11-10,SFN,13,0,58,61,119,200,241,441,25,27,52,4,5:29
483,381020,2014-05-05,2014,PHI,TOR,0,3,3-0,TOR,9,0,38,37,75,143,147,290,12,11,23,1,2:59
484,381030,2014-05-06,2014,MIA,NYN,3,0,3-0,MIA,9,1,33,31,64,111,108,219,10,7,17,0,2:08
485,381028,2014-05-06,2014,CLE,MIN,4,2,4-2,CLE,9,1,32,35,67,141,110,251,8,6,14,1,2:28
486,381032,2014-05-06,2014,PIT,SFN,2,1,2-1,PIT,9,0,32,35,67,137,108,245,7,9,16,0,2:41
487,381033,2014-05-06,2014,ATL,SLN,2,1,2-1,ATL,9,1,32,33,65,131,124,255,9,8,17,1,2:42
488,381029,2014-05-06,2014,ANA,NYA,3,4,4-3,NYA,9,0,34,37,71,139,132,271,7,12,19,1,2:57
489,381021,2014-05-06,2014,MIL,ARI,5,7,7-5,ARI,9,0,37,40,77,149,143,292,9,13,22,1,3:05
490,381035,2014-05-06,2014,PHI,TOR,5,6,6-5,TOR,10,0,40,42,82,155,138,293,11,15,26,1,3:06
491,381023,2014-05-06,2014,CHN,CHA,1,5,5-1,CHA,9,0,34,38,72,143,152,295,7,13,20,2,3:30
492,381027,2014-05-06,2014,WAS,LAN,3,8,8-3,LAN,9,0,40,41,81,152,135,287,15,16,31,2,3:15
493,381026,2014-05-06,2014,SDN,KCA,1,3,3-1,KCA,11,0,38,44,82,161,139,300,7,13,20,0,3:03
494,381022,2014-05-06,2014,TBA,BAL,3,5,5-3,BAL,9,0,39,42,81,182,145,327,13,15,28,3,3:36 (:19 delay)
495,381031,2014-05-06,2014,OAK,SEA,3,8,8-3,SEA,9,0,39,43,82,163,159,322,12,19,31,4,3:19
496,381034,2014-05-06,2014,COL,TEX,12,1,12-1,COL,9,1,46,39,85,162,159,321,24,15,39,3,3:32
497,381024,2014-05-06,2014,BOS,CIN,4,3,4-3,BOS,12,0,50,49,99,174,195,369,19,14,33,3,4:04
498,381025,2014-05-06,2014,DET,HOU,11,4,11-4,DET,9,1,42,36,78,138,162,300,19,10,29,2,3:27
499,380600,2014-05-07,2014,OAK,SEA,2,0,2-0,OAK,9,1,31,31,62,114,125,239,8,4,12,0,2:21
500,380600,2014-05-07,2014,OAK,SEA,2,0,2-0,OAK,9,1,31,31,62,114,125,239,8,4,12,0,2:21
501,381050,2014-05-07,2014,ATL,SLN,1,7,7-1,SLN,9,0,35,41,76,154,113,267,8,15,23,1,2:43
502,381046,2014-05-07,2014,MIA,NYN,1,0,1-0,MIA,9,0,33,30,63,106,147,253,9,3,12,1,2:40
503,381047,2014-05-07,2014,TOR,PHI,10,0,10-0,TOR,9,1,37,32,69,120,142,262,13,5,18,2,2:23
504,381043,2014-05-07,2014,WAS,LAN,3,2,3-2,WAS,9,1,35,35,70,139,135,274,12,9,21,2,2:59 (1:40 delay)
505,381049,2014-05-07,2014,PIT,SFN,4,3,4-3,PIT,9,1,36,34,70,118,135,253,14,8,22,0,2:47
506,381037,2014-05-07,2014,TBA,BAL,3,4,4-3,BAL,9,0,38,35,73,117,155,272,12,9,21,3,3:08
507,381039,2014-05-07,2014,BOS,CIN,4,3,4-3,BOS,9,1,37,33,70,135,128,263,17,9,26,4,2:47
508,381036,2014-05-07,2014,MIL,ARI,2,3,3-2,ARI,9,0,32,43,75,155,107,262,9,15,24,1,2:43
509,381045,2014-05-07,2014,ANA,NYA,2,9,9-2,NYA,9,0,36,43,79,151,129,280,9,17,26,3,3:01
510,381040,2014-05-07,2014,TEX,COL,2,9,9-2,COL,9,0,35,44,79,158,146,304,8,18,26,2,3:06
511,381048,2014-05-07,2014,OAK,SEA,4,6,6-4,SEA,10,0,46,43,89,170,147,317,18,16,34,4,3:24
512,381042,2014-05-07,2014,SDN,KCA,0,8,8-0,KCA,9,0,35,46,81,168,149,317,11,19,30,0,3:09
513,381041,2014-05-07,2014,DET,HOU,3,2,3-2,DET,9,1,33,35,68,141,123,264,9,10,19,2,3:06 (:09 delay)
514,381044,2014-05-07,2014,CLE,MIN,4,3,4-3,CLE,9,0,36,38,74,146,138,284,10,11,21,1,2:57
515,381038,2014-05-07,2014,CHA,CHN,8,3,8-3,CHA,9,1,40,33,73,136,151,287,17,6,23,1,3:03
516,381054,2014-05-08,2014,DET,HOU,2,6,6-2,HOU,9,0,33,36,69,135,115,250,7,12,19,2,2:37
517,381055,2014-05-08,2014,SEA,KCA,1,0,1-0,SEA,9,1,30,31,61,110,113,223,7,6,13,1,2:25
518,381053,2014-05-08,2014,TEX,COL,5,0,5-0,TEX,9,1,37,34,71,155,117,272,15,9,24,3,2:59
519,381058,2014-05-08,2014,TOR,PHI,12,6,12-6,TOR,9,1,39,41,80,168,147,315,17,14,31,2,3:00
520,381051,2014-05-08,2014,TBA,BAL,1,3,3-1,BAL,9,0,39,37,76,145,176,321,14,11,25,4,3:33
521,381057,2014-05-08,2014,CLE,MIN,9,4,9-4,CLE,9,1,43,38,81,144,162,306,20,11,31,4,3:14
522,381059,2014-05-08,2014,LAN,SFN,1,3,3-1,SFN,10,0,36,42,78,173,139,312,8,13,21,4,3:47
523,381052,2014-05-08,2014,CHA,CHN,5,12,12-5,CHN,9,0,43,52,95,186,173,359,17,25,42,4,4:07
524,381056,2014-05-08,2014,SDN,MIA,1,3,3-1,MIA,11,0,41,40,81,172,159,331,9,7,16,0,3:22
525,381069,2014-05-09,2014,DET,MIN,1,2,2-1,MIN,9,0,36,38,74,148,113,261,10,12,22,2,3:00 (:27 delay)
526,381066,2014-05-09,2014,BAL,HOU,4,3,4-3,BAL,9,1,32,33,65,126,113,239,8,8,16,0,2:29
527,381073,2014-05-09,2014,PIT,SLN,6,4,6-4,PIT,9,1,36,39,75,152,131,283,13,14,27,1,2:48 (:25 delay)
528,381074,2014-05-09,2014,OAK,WAS,8,0,8-0,OAK,9,1,40,33,73,126,152,278,16,6,22,2,2:42
529,381067,2014-05-09,2014,SEA,KCA,1,6,6-1,KCA,9,0,34,42,76,131,135,266,8,17,25,1,2:45
530,381060,2014-05-09,2014,TOR,ANA,3,4,4-3,ANA,9,0,35,42,77,170,132,302,9,19,28,1,3:09
531,381072,2014-05-09,2014,LAN,SFN,1,3,3-1,SFN,9,0,31,36,67,145,122,267,5,12,17,1,2:57
532,381061,2014-05-09,2014,CHA,ARI,9,3,9-3,CHA,9,1,39,35,74,142,134,276,16,6,22,2,2:45
533,381064,2014-05-09,2014,TBA,CLE,3,6,6-3,CLE,9,0,39,43,82,187,161,348,14,15,29,5,4:10 (:01 delay)
534,381062,2014-05-09,2014,TEX,BOS,8,0,8-0,TEX,9,1,38,31,69,132,161,293,16,4,20,2,3:10
535,381070,2014-05-09,2014,MIL,NYA,3,5,5-3,NYA,9,0,34,36,70,163,144,307,9,9,18,2,3:02
536,381068,2014-05-09,2014,SDN,MIA,10,1,10-1,SDN,9,1,40,33,73,138,160,298,16,8,24,1,2:54
537,381063,2014-05-09,2014,ATL,CHN,3,2,3-2,ATL,10,0,39,36,75,151,161,312,13,7,20,1,3:07 (:18 delay)
538,381065,2014-05-09,2014,CIN,COL,4,3,4-3,CIN,9,0,31,35,66,126,108,234,7,8,15,0,2:34
539,381071,2014-05-09,2014,NYN,PHI,2,3,3-2,PHI,11,0,50,53,103,226,195,421,17,24,41,2,4:39
540,381089,2014-05-10,2014,OAK,WAS,4,3,4-3,OAK,10,0,37,38,75,120,121,241,7,9,16,1,2:32
541,381082,2014-05-10,2014,SEA,KCA,3,1,3-1,SEA,9,1,33,31,64,106,116,222,11,4,15,1,2:18
542,381078,2014-05-10,2014,ATL,CHN,2,0,2-0,ATL,9,1,31,32,63,122,96,218,7,8,15,1,2:19 (1:07 delay)
543,381079,2014-05-10,2014,TBA,CLE,7,1,7-1,TBA,9,1,37,33,70,143,128,271,15,7,22,2,3:03
544,381075,2014-05-10,2014,TOR,ANA,3,5,5-3,ANA,9,0,33,38,71,153,113,266,6,13,19,2,2:46
545,381084,2014-05-10,2014,DET,MIN,9,3,9-3,DET,9,1,37,38,75,156,122,278,13,12,25,0,2:50
546,381085,2014-05-10,2014,MIL,NYA,5,4,5-4,MIL,9,1,37,36,73,125,144,269,12,11,23,2,2:48
547,381087,2014-05-10,2014,LAN,SFN,6,2,6-2,LAN,9,1,36,41,77,141,134,275,15,14,29,2,3:22
548,381076,2014-05-10,2014,CHA,ARI,3,4,4-3,ARI,9,0,33,39,72,160,133,293,7,16,23,0,2:58
549,381086,2014-05-10,2014,NYN,PHI,4,5,5-4,PHI,9,0,39,41,80,138,154,292,12,15,27,2,3:16 (:39 delay)
550,381077,2014-05-10,2014,TEX,BOS,3,8,8-3,BOS,9,0,36,43,79,170,134,304,10,20,30,3,3:09
551,381088,2014-05-10,2014,PIT,SLN,4,3,4-3,PIT,9,1,37,40,77,167,132,299,14,14,28,2,3:30
552,381081,2014-05-10,2014,BAL,HOU,5,4,5-4,BAL,10,0,43,43,86,146,147,293,16,15,31,3,3:29 (:55 delay)
553,381080,2014-05-10,2014,CIN,COL,2,11,11-2,COL,9,0,36,45,81,168,135,303,9,20,29,0,3:10
554,381083,2014-05-10,2014,SDN,MIA,9,3,9-3,SDN,9,1,45,38,83,158,194,352,22,11,33,0,3:21
555,381092,2014-05-11,2014,TEX,BOS,2,5,5-2,BOS,9,0,34,37,71,147,134,281,8,11,19,3,2:47
556,381097,2014-05-11,2014,SEA,KCA,7,9,9-7,KCA,9,0,38,42,80,165,146,311,13,15,28,1,3:01
557,381096,2014-05-11,2014,BAL,HOU,2,5,5-2,HOU,9,0,36,43,79,164,149,313,11,16,27,1,3:21
558,381100,2014-05-11,2014,MIL,NYA,6,5,6-5,MIL,9,0,41,41,82,158,137,295,17,15,32,3,3:40
559,381090,2014-05-11,2014,TOR,ANA,3,9,9-3,ANA,9,0,36,46,82,204,146,350,9,20,29,3,3:24
560,381094,2014-05-11,2014,TBA,CLE,5,6,6-5,CLE,9,0,39,43,82,179,163,342,11,18,29,4,3:48
561,381103,2014-05-11,2014,PIT,SLN,5,6,6-5,SLN,9,0,43,42,85,157,163,320,18,16,34,2,3:37
562,381098,2014-05-11,2014,SDN,MIA,5,4,5-4,SDN,9,1,39,41,80,177,166,343,16,14,30,2,3:29
563,381101,2014-05-11,2014,NYN,PHI,5,4,5-4,NYN,11,0,53,49,102,179,213,392,24,18,42,2,4:22
564,381093,2014-05-11,2014,ATL,CHN,5,2,5-2,ATL,9,1,33,37,70,149,115,264,10,12,22,1,2:54
565,381095,2014-05-11,2014,CIN,COL,4,1,4-1,CIN,9,1,32,33,65,142,119,261,7,7,14,1,2:49
566,381099,2014-05-11,2014,DET,MIN,3,4,4-3,MIN,9,0,35,36,71,164,130,294,9,13,22,2,3:08
567,381104,2014-05-11,2014,OAK,WAS,9,1,9-1,OAK,9,1,41,33,74,123,150,273,17,7,24,1,2:40
568,381102,2014-05-11,2014,LAN,SFN,4,7,7-4,SFN,10,0,45,44,89,159,145,304,17,17,34,2,3:54
569,381091,2014-05-11,2014,CHA,ARI,1,5,5-1,ARI,9,0,30,42,72,185,120,305,5,17,22,2,3:10
570,381107,2014-05-12,2014,OAK,CHA,5,4,5-4,OAK,9,1,37,37,74,113,167,280,15,10,25,4,2:57
571,381105,2014-05-12,2014,TOR,ANA,7,3,7-3,TOR,9,1,36,38,74,146,154,300,13,13,26,2,2:45
572,381114,2014-05-12,2014,ARI,WAS,5,6,6-5,WAS,9,0,38,38,76,149,130,279,13,11,24,1,2:53
573,381113,2014-05-12,2014,HOU,TEX,0,4,4-0,TEX,9,0,39,39,78,138,180,318,14,12,26,3,3:16
574,381109,2014-05-12,2014,BAL,DET,1,4,4-1,DET,9,0,34,33,67,133,122,255,6,8,14,1,2:48 (:35 delay)
575,381112,2014-05-12,2014,SEA,TBA,12,5,12-5,SEA,9,1,42,37,79,159,144,303,17,11,28,2,3:10
576,381108,2014-05-12,2014,SLN,CHN,5,17,17-5,CHN,9,0,37,50,87,179,131,310,11,22,33,1,3:12
577,381110,2014-05-12,2014,LAN,MIA,6,5,6-5,LAN,9,1,42,35,77,128,203,331,20,9,29,3,3:31
578,381111,2014-05-12,2014,NYA,NYN,7,9,9-7,NYN,9,0,41,41,82,164,150,314,16,15,31,4,3:34
579,381106,2014-05-12,2014,SFN,ATL,4,2,4-2,SFN,9,1,33,33,66,131,118,249,9,8,17,3,2:43
580,381121,2014-05-13,2014,KCA,COL,5,1,5-1,KCA,9,1,36,32,68,129,141,270,15,6,21,0,2:50
581,381128,2014-05-13,2014,HOU,TEX,8,0,8-0,HOU,9,1,40,31,71,108,177,285,16,8,24,1,2:45
582,381129,2014-05-13,2014,ARI,WAS,3,1,3-1,ARI,9,1,32,33,65,110,109,219,8,8,16,0,2:21
583,381126,2014-05-13,2014,CIN,SDN,1,2,2-1,SDN,9,0,36,33,69,126,125,251,9,7,16,0,2:31
584,381123,2014-05-13,2014,LAN,MIA,7,1,7-1,LAN,9,1,36,35,71,151,127,278,14,8,22,2,3:02
585,381127,2014-05-13,2014,SEA,TBA,1,2,2-1,TBA,9,0,32,36,68,126,109,235,6,9,15,1,2:48
586,381122,2014-05-13,2014,BAL,DET,1,4,4-1,DET,9,0,35,32,67,138,140,278,9,9,18,1,2:57
587,381118,2014-05-13,2014,OAK,CHA,11,0,11-0,OAK,9,1,43,31,74,121,158,279,20,6,26,0,2:50
588,381120,2014-05-13,2014,TOR,CLE,5,4,5-4,TOR,9,1,34,38,72,146,115,261,10,11,21,3,2:29
589,381116,2014-05-13,2014,SFN,ATL,0,5,5-0,ATL,9,0,35,37,72,129,147,276,8,10,18,2,2:51
590,381115,2014-05-13,2014,PHI,ANA,3,4,4-3,ANA,9,0,34,39,73,141,119,260,8,9,17,0,2:49
591,381117,2014-05-13,2014,MIN,BOS,8,6,8-6,MIN,9,0,42,40,82,175,166,341,18,14,32,5,3:25
592,381119,2014-05-13,2014,SLN,CHN,4,3,4-3,SLN,12,0,51,49,100,202,214,416,19,17,36,3,4:39
593,381124,2014-05-13,2014,NYA,NYN,7,12,12-7,NYN,9,0,43,45,88,193,196,389,19,17,36,2,3:58
594,381125,2014-05-13,2014,MIL,PIT,5,2,5-2,MIL,9,1,40,37,77,158,134,292,18,11,29,1,3:14
595,381136,2014-05-14,2014,KCA,COL,3,2,3-2,KCA,9,1,33,34,67,138,118,256,10,8,18,1,2:34
596,381144,2014-05-14,2014,ARI,WAS,1,5,5-1,WAS,9,0,32,36,68,136,126,262,7,9,16,1,2:33
597,381137,2014-05-14,2014,BAL,DET,5,7,7-5,DET,9,0,41,39,80,163,171,334,14,12,26,1,3:27
598,381130,2014-05-14,2014,PHI,ANA,0,3,3-0,ANA,9,0,33,39,72,175,125,300,5,14,19,0,3:08
599,381143,2014-05-14,2014,HOU,TEX,5,4,5-4,HOU,9,0,41,39,80,130,181,311,16,15,31,6,3:36
600,381135,2014-05-14,2014,TOR,CLE,4,15,15-4,CLE,9,0,36,54,90,210,140,350,9,27,36,3,3:37
601,381139,2014-05-14,2014,NYN,NYA,0,4,4-0,NYA,9,0,30,37,67,157,114,271,4,10,14,0,3:00
602,381140,2014-05-14,2014,MIL,PIT,1,4,4-1,PIT,9,0,36,38,74,139,133,272,11,12,23,0,3:01
603,381142,2014-05-14,2014,SEA,TBA,0,2,2-0,TBA,9,0,30,36,66,164,140,304,5,10,15,1,3:21
604,381131,2014-05-14,2014,SFN,ATL,10,4,10-4,SFN,9,1,45,35,80,149,160,309,21,9,30,1,3:18
605,381132,2014-05-14,2014,MIN,BOS,4,9,9-4,BOS,9,0,40,43,83,171,163,334,13,15,28,1,3:07
606,381133,2014-05-14,2014,OAK,CHA,2,4,4-2,CHA,9,0,32,36,68,142,145,287,6,10,16,3,2:57
607,381138,2014-05-14,2014,LAN,MIA,3,13,13-3,MIA,9,0,38,48,86,181,136,317,11,23,34,1,3:20
608,381145,2014-05-15,2014,KCA,BAL,1,2,2-1,BAL,9,0,34,36,70,147,142,289,8,11,19,4,2:56
609,381152,2014-05-15,2014,CIN,SDN,5,0,5-0,CIN,9,1,39,29,68,116,141,257,16,5,21,0,2:36
610,381149,2014-05-15,2014,SFN,MIA,6,4,6-4,SFN,9,1,39,37,76,122,151,273,16,10,26,2,2:53
611,381153,2014-05-15,2014,ANA,TBA,6,5,6-5,ANA,9,0,38,37,75,147,143,290,12,11,23,5,3:42
612,381147,2014-05-15,2014,SLN,CHN,5,3,5-3,SLN,9,1,33,38,71,149,143,292,10,11,21,2,2:49
613,381148,2014-05-15,2014,TOR,CLE,4,2,4-2,TOR,9,1,38,38,76,144,176,320,15,12,27,6,3:23
614,381150,2014-05-15,2014,NYN,NYA,0,1,1-0,NYA,9,0,33,34,67,134,136,270,6,10,16,4,3:04
615,381151,2014-05-15,2014,MIL,PIT,4,3,4-3,MIL,9,0,33,37,70,151,126,277,10,11,21,2,3:00
616,381141,2014-05-15,2014,CIN,SDN,1,6,6-1,SDN,9,0,35,39,74,150,131,281,9,12,21,1,2:47
617,381141,2014-05-15,2014,CIN,SDN,1,6,6-1,SDN,9,0,35,39,74,150,131,281,9,12,21,1,2:47
618,381146,2014-05-15,2014,MIN,BOS,4,3,4-3,MIN,10,0,44,40,84,149,157,306,18,10,28,0,3:21
619,381168,2014-05-16,2014,TEX,TOR,0,2,2-0,TOR,9,0,30,34,64,128,105,233,4,9,13,0,2:27
620,381157,2014-05-16,2014,PHI,CIN,0,3,3-0,CIN,9,0,36,34,70,141,133,274,9,7,16,1,2:48
621,381159,2014-05-16,2014,ARI,LAN,0,7,7-0,LAN,9,0,32,42,74,160,124,284,8,15,23,0,2:54
622,381167,2014-05-16,2014,ANA,TBA,0,3,3-0,TBA,9,0,37,38,75,145,155,300,10,12,22,2,3:27
623,381166,2014-05-16,2014,MIN,SEA,5,4,5-4,MIN,9,1,37,41,78,139,116,255,13,13,26,2,2:42
624,381158,2014-05-16,2014,BOS,DET,0,1,1-0,DET,9,0,32,34,66,138,146,284,9,9,18,3,3:14 (:47 delay)
625,381165,2014-05-16,2014,COL,SDN,3,1,3-1,COL,9,1,35,33,68,134,125,259,10,7,17,3,3:02
626,381156,2014-05-16,2014,HOU,CHA,2,7,7-2,CHA,9,0,39,44,83,160,162,322,13,18,31,3,3:31
627,381154,2014-05-16,2014,SLN,ATL,5,2,5-2,SLN,9,1,37,34,71,131,155,286,16,10,26,1,2:55
628,381163,2014-05-16,2014,CLE,OAK,1,11,11-1,OAK,9,0,34,43,77,173,143,316,7,18,25,2,3:07
629,381161,2014-05-16,2014,CHN,MIL,3,4,4-3,MIL,9,0,34,40,74,171,114,285,9,13,22,1,3:05
630,381162,2014-05-16,2014,WAS,NYN,5,2,5-2,WAS,9,1,37,38,75,154,139,293,14,12,26,0,3:08
631,381155,2014-05-16,2014,KCA,BAL,0,4,4-0,BAL,9,0,32,36,68,129,117,246,6,9,15,0,2:22
632,381160,2014-05-16,2014,SFN,MIA,5,7,7-5,MIA,9,0,39,43,82,152,123,275,13,16,29,3,3:17
633,381170,2014-05-17,2014,KCA,BAL,1,0,1-0,KCA,9,1,31,32,63,135,104,239,6,5,11,3,2:37
634,381181,2014-05-17,2014,MIN,SEA,4,3,4-3,MIN,9,1,30,36,66,136,105,241,8,9,17,0,2:26
635,381179,2014-05-17,2014,NYA,PIT,7,1,7-1,NYA,9,1,33,36,69,156,107,263,10,12,22,1,2:56
636,381176,2014-05-17,2014,CHN,MIL,3,0,3-0,CHN,9,1,30,32,62,141,119,260,6,5,11,0,2:57
637,381172,2014-05-17,2014,PHI,CIN,12,1,12-1,PHI,9,1,43,33,76,115,184,299,19,6,25,2,2:54
638,381178,2014-05-17,2014,CLE,OAK,2,6,6-2,OAK,9,0,34,38,72,137,122,259,10,10,20,2,3:00
639,381173,2014-05-17,2014,BOS,DET,1,6,6-1,DET,9,0,34,40,74,138,122,260,8,13,21,1,2:49
640,381169,2014-05-17,2014,SLN,ATL,4,1,4-1,SLN,9,1,30,33,63,124,127,251,9,9,18,2,2:31
641,381183,2014-05-17,2014,TEX,TOR,2,4,4-2,TOR,9,0,34,43,77,182,129,311,9,18,27,5,3:09
642,381175,2014-05-17,2014,SFN,MIA,0,5,5-0,MIA,9,0,36,40,76,152,130,282,9,13,22,2,2:57
643,381182,2014-05-17,2014,ANA,TBA,6,0,6-0,ANA,9,1,37,31,68,127,141,268,14,7,21,2,2:59
644,381174,2014-05-17,2014,ARI,LAN,18,7,18-7,ARI,9,1,50,42,92,165,183,348,27,15,42,6,3:55
645,381177,2014-05-17,2014,WAS,NYN,2,5,5-2,NYN,9,0,33,38,71,159,119,278,7,11,18,0,2:48
646,381171,2014-05-17,2014,HOU,CHA,6,5,6-5,HOU,9,1,40,41,81,170,147,317,17,16,33,3,3:26
647,381180,2014-05-17,2014,COL,SDN,5,8,8-5,SDN,9,0,37,45,82,196,130,326,15,20,35,2,3:39
648,381191,2014-05-18,2014,CHN,MIL,4,2,4-2,CHN,9,1,34,33,67,137,138,275,11,6,17,0,2:47
649,381197,2014-05-18,2014,ANA,TBA,6,2,6-2,ANA,9,1,36,35,71,129,135,264,12,8,20,2,2:59
650,381189,2014-05-18,2014,ARI,LAN,5,3,5-3,ARI,9,1,35,37,72,133,133,266,11,11,22,1,2:50
651,381190,2014-05-18,2014,SFN,MIA,4,1,4-1,SFN,9,1,34,37,71,138,155,293,10,11,21,1,3:04
652,381186,2014-05-18,2014,HOU,CHA,8,2,8-2,HOU,9,1,37,35,72,135,154,289,15,10,25,2,2:46
653,381184,2014-05-18,2014,SLN,ATL,5,6,6-5,ATL,9,0,44,37,81,136,167,303,19,13,32,4,3:20
654,381194,2014-05-18,2014,NYA,PIT,4,3,4-3,NYA,9,1,30,35,65,133,126,259,8,8,16,2,2:52
655,381164,2014-05-18,2014,NYA,PIT,3,5,5-3,PIT,9,0,37,37,74,136,153,289,12,11,23,3,3:04
656,381192,2014-05-18,2014,WAS,NYN,6,3,6-3,WAS,9,1,35,35,70,133,139,272,12,10,22,0,2:45
657,381164,2014-05-18,2014,NYA,PIT,3,5,5-3,PIT,9,0,37,37,74,136,153,289,12,11,23,3,3:04
658,381196,2014-05-18,2014,MIN,SEA,2,6,6-2,SEA,9,0,34,42,76,176,115,291,9,16,25,1,3:02
659,381187,2014-05-18,2014,PHI,CIN,8,3,8-3,PHI,9,1,37,40,77,162,140,302,14,12,26,1,3:03
660,381195,2014-05-18,2014,COL,SDN,8,6,8-6,COL,10,0,42,42,84,154,164,318,17,14,31,0,3:34
661,381193,2014-05-18,2014,CLE,OAK,3,13,13-3,OAK,9,0,42,47,89,163,177,340,16,22,38,5,3:21
662,381198,2014-05-18,2014,TEX,TOR,6,2,6-2,TEX,9,1,36,37,73,145,134,279,10,11,21,2,2:52
663,381185,2014-05-18,2014,KCA,BAL,8,6,8-6,KCA,9,1,39,41,80,133,168,301,15,15,30,1,2:58
664,381188,2014-05-18,2014,BOS,DET,2,6,6-2,DET,9,0,36,42,78,145,143,288,10,17,27,3,3:19
665,381203,2014-05-19,2014,ATL,MIL,9,3,9-3,ATL,9,1,45,36,81,147,180,327,22,10,32,3,3:29
666,381199,2014-05-19,2014,KCA,CHA,6,7,7-6,CHA,9,0,40,39,79,137,150,287,14,14,28,3,3:16
667,381201,2014-05-19,2014,CLE,DET,5,4,5-4,CLE,10,0,48,41,89,133,194,327,21,13,34,1,3:51
668,381200,2014-05-19,2014,WAS,CIN,3,4,4-3,CIN,15,0,61,63,124,214,218,432,17,21,38,1,4:58
669,381202,2014-05-19,2014,ANA,HOU,2,5,5-2,HOU,9,0,32,35,67,126,135,261,7,12,19,1,2:40
670,381216,2014-05-20,2014,TEX,SEA,2,6,6-2,SEA,9,0,32,42,74,161,112,273,7,17,24,1,2:54
671,381207,2014-05-20,2014,WAS,CIN,9,4,9-4,WAS,9,1,39,39,78,149,151,300,13,11,24,3,3:03
672,381214,2014-05-20,2014,TBA,OAK,0,3,3-0,OAK,9,0,33,41,74,183,150,333,9,14,23,2,3:31
673,381205,2014-05-20,2014,PIT,BAL,2,9,9-2,BAL,9,0,36,42,78,154,141,295,12,15,27,2,2:55
674,381210,2014-05-20,2014,NYN,LAN,4,9,9-4,LAN,9,0,41,48,89,194,176,370,14,22,36,6,4:08
675,381213,2014-05-20,2014,CHN,NYA,6,1,6-1,CHN,9,1,39,38,77,156,139,295,16,11,27,4,3:25
676,381209,2014-05-20,2014,ANA,HOU,9,3,9-3,ANA,9,1,42,38,80,146,176,322,17,12,29,3,3:34
677,381215,2014-05-20,2014,MIA,PHI,5,6,6-5,PHI,9,0,42,42,84,175,175,350,15,17,32,1,3:30
678,381206,2014-05-20,2014,KCA,CHA,6,7,7-6,CHA,9,0,42,38,80,154,168,322,15,12,27,3,3:19
679,381211,2014-05-20,2014,ATL,MIL,5,0,5-0,ATL,9,1,36,37,73,128,128,256,12,9,21,1,2:53
680,381208,2014-05-20,2014,CLE,DET,6,2,6-2,CLE,9,1,37,33,70,129,150,279,15,10,25,1,3:06
681,381218,2014-05-20,2014,BOS,TOR,4,7,7-4,TOR,9,0,40,41,81,147,146,293,15,15,30,6,3:17
682,381204,2014-05-20,2014,SLN,ARI,5,0,5-0,SLN,9,1,34,28,62,115,106,221,10,1,11,0,2:20
683,381217,2014-05-20,2014,COL,SFN,5,4,5-4,COL,9,0,41,36,77,143,162,305,15,10,25,0,3:33
684,381212,2014-05-20,2014,SDN,MIN,3,5,5-3,MIN,9,0,35,36,71,155,145,300,8,10,18,2,3:05
685,381226,2014-05-21,2014,ATL,MIL,1,6,6-1,MIL,9,0,32,40,72,124,116,240,5,14,19,0,2:26
686,381222,2014-05-21,2014,WAS,CIN,1,2,2-1,CIN,9,0,34,39,73,132,116,248,8,13,21,0,2:52 (1:01 delay)
687,381224,2014-05-21,2014,ANA,HOU,2,1,2-1,ANA,9,1,30,30,60,94,125,219,6,4,10,0,2:26
688,381225,2014-05-21,2014,NYN,LAN,3,4,4-3,LAN,9,0,39,34,73,134,142,276,14,10,24,1,3:01
689,381221,2014-05-21,2014,KCA,CHA,3,1,3-1,KCA,9,1,34,33,67,131,130,261,12,8,20,1,2:41
690,381231,2014-05-21,2014,TEX,SEA,4,3,4-3,TEX,9,1,35,34,69,138,128,266,12,8,20,3,2:47
691,381232,2014-05-21,2014,COL,SFN,1,5,5-1,SFN,9,0,33,36,69,169,100,269,7,10,17,4,3:00
692,381233,2014-05-21,2014,BOS,TOR,4,6,6-4,TOR,9,0,42,44,86,157,165,322,14,16,30,5,3:23
693,381230,2014-05-21,2014,MIA,PHI,14,5,14-5,MIA,9,1,46,42,88,167,186,353,21,17,38,1,3:39
694,381228,2014-05-21,2014,CHN,NYA,2,4,4-2,NYA,13,0,53,56,109,215,190,405,15,18,33,3,4:39
695,381219,2014-05-21,2014,SLN,ARI,3,2,3-2,SLN,12,0,51,46,97,182,199,381,21,11,32,2,4:00
696,381223,2014-05-21,2014,CLE,DET,11,10,11-10,CLE,13,0,59,63,122,269,206,475,25,24,49,6,5:16
697,381229,2014-05-21,2014,TBA,OAK,2,3,3-2,OAK,9,0,37,36,73,172,154,326,11,8,19,3,3:53
698,381227,2014-05-21,2014,SDN,MIN,0,2,2-0,MIN,9,0,34,34,68,136,119,255,8,7,15,0,2:32
699,381220,2014-05-21,2014,PIT,BAL,9,8,9-8,PIT,9,1,39,45,84,182,129,311,17,19,36,3,3:28 (:10 delay)
700,381238,2014-05-22,2014,NYN,LAN,5,3,5-3,NYN,9,1,34,33,67,121,149,270,10,8,18,1,2:59
701,381234,2014-05-22,2014,SLN,ARI,4,2,4-2,SLN,9,1,38,36,74,123,133,256,16,9,25,2,2:40
702,381235,2014-05-22,2014,SDN,CHN,1,5,5-1,CHN,9,0,34,36,70,128,147,275,8,9,17,1,2:56
703,381237,2014-05-22,2014,SEA,HOU,3,1,3-1,SEA,9,1,35,35,70,146,141,287,13,8,21,2,3:09
704,381242,2014-05-22,2014,MIA,PHI,4,3,4-3,MIA,9,0,37,38,75,137,128,265,12,11,23,1,2:46
705,381239,2014-05-22,2014,ATL,MIL,5,4,5-4,ATL,9,1,35,38,73,143,130,273,13,14,27,4,3:36
706,381241,2014-05-22,2014,TBA,OAK,5,2,5-2,TBA,11,0,43,42,85,168,143,311,12,11,23,3,3:45
707,381246,2014-05-22,2014,PIT,WAS,3,1,3-1,PIT,9,1,38,38,76,153,141,294,15,11,26,1,3:13
708,381243,2014-05-22,2014,COL,SFN,2,4,4-2,SFN,9,0,41,35,76,128,160,288,17,12,29,2,3:13 (2:46 delay)
709,381243,2014-05-22,2014,COL,SFN,2,4,4-2,SFN,9,0,41,35,76,128,160,288,17,12,29,2,3:13 (2:46 delay)
710,381240,2014-05-22,2014,CHA,NYA,3,2,3-2,CHA,9,1,34,31,65,134,128,262,10,4,14,0,2:45
711,381245,2014-05-22,2014,BOS,TOR,2,7,7-2,TOR,9,0,34,42,76,166,131,297,7,17,24,2,2:58 (:08 delay)
712,381244,2014-05-22,2014,DET,TEX,2,9,9-2,TEX,9,0,35,46,81,192,126,318,10,21,31,2,3:30
713,381236,2014-05-22,2014,BAL,CLE,7,8,8-7,CLE,13,0,57,54,111,194,207,401,23,16,39,6,4:22
714,381253,2014-05-23,2014,ANA,KCA,6,1,6-1,ANA,9,1,37,38,75,134,125,259,15,11,26,2,2:51
715,381260,2014-05-23,2014,DET,TEX,7,2,7-2,DET,9,1,36,32,68,131,123,254,15,8,23,0,2:30
716,381259,2014-05-23,2014,CIN,SLN,5,3,5-3,CIN,9,1,34,36,70,127,121,248,10,12,22,1,2:35
717,381248,2014-05-23,2014,TBA,BOS,1,0,1-0,TBA,9,0,34,36,70,155,128,283,8,10,18,3,3:25
718,381255,2014-05-23,2014,MIA,MIL,5,9,9-5,MIL,9,0,37,42,79,137,146,283,9,15,24,1,2:54
719,381252,2014-05-23,2014,SEA,HOU,6,1,6-1,SEA,9,1,36,32,68,115,112,227,14,6,20,2,2:40
720,381258,2014-05-23,2014,TOR,OAK,3,2,3-2,TOR,9,1,30,38,68,137,108,245,7,13,20,2,2:37
721,381256,2014-05-23,2014,SFN,MIN,6,2,6-2,SFN,9,1,31,39,70,153,106,259,6,14,20,1,2:43
722,381250,2014-05-23,2014,BAL,CLE,8,4,8-4,BAL,9,1,39,36,75,143,111,254,22,12,34,1,2:43
723,381251,2014-05-23,2014,ATL,COL,3,2,3-2,ATL,9,1,36,35,71,128,136,264,12,8,20,2,3:13
724,381249,2014-05-23,2014,SDN,CHN,11,1,11-1,SDN,9,1,39,35,74,142,156,298,15,10,25,0,3:04
725,381261,2014-05-23,2014,PIT,WAS,4,3,4-3,PIT,9,1,34,41,75,178,125,303,10,16,26,2,3:13
726,381257,2014-05-23,2014,CHA,NYA,6,5,6-5,CHA,9,0,41,41,82,175,170,345,16,16,32,4,3:52
727,381254,2014-05-23,2014,PHI,LAN,0,2,2-0,LAN,9,0,35,40,75,143,149,292,7,16,23,2,3:15 (:43 delay)
728,381273,2014-05-24,2014,TOR,OAK,5,2,5-2,TOR,9,1,35,34,69,127,135,262,12,7,19,3,2:35
729,381276,2014-05-24,2014,PIT,WAS,3,2,3-2,PIT,9,1,33,37,70,142,127,269,13,10,23,1,2:59
730,381272,2014-05-24,2014,CHA,NYA,3,4,4-3,NYA,10,0,38,40,78,143,138,281,11,9,20,2,2:56
731,381262,2014-05-24,2014,NYN,ARI,2,3,3-2,ARI,9,0,37,38,75,148,150,298,11,10,21,3,3:18
732,381264,2014-05-24,2014,SDN,CHN,2,3,3-2,CHN,9,0,32,37,69,118,111,229,5,11,16,2,2:34
733,381271,2014-05-24,2014,SFN,MIN,2,1,2-1,SFN,9,1,31,35,66,140,124,264,8,6,14,3,2:51
734,381270,2014-05-24,2014,MIA,MIL,2,1,2-1,MIA,9,1,34,37,71,131,133,264,11,12,23,2,3:03
735,381267,2014-05-24,2014,SEA,HOU,4,9,9-4,HOU,9,0,37,44,81,173,131,304,9,16,25,2,3:18
736,381274,2014-05-24,2014,CIN,SLN,3,6,6-3,SLN,9,0,38,42,80,142,142,284,12,16,28,4,3:09
737,381266,2014-05-24,2014,ATL,COL,1,3,3-1,COL,9,0,35,35,70,139,147,286,8,9,17,2,3:10
738,381275,2014-05-24,2014,DET,TEX,2,12,12-2,TEX,9,0,40,48,88,178,158,336,15,23,38,2,3:43
739,381269,2014-05-24,2014,PHI,LAN,5,3,5-3,PHI,9,1,33,35,68,127,144,271,10,9,19,0,2:37
740,381268,2014-05-24,2014,ANA,KCA,4,7,7-4,KCA,13,0,53,58,111,218,204,422,16,18,34,2,4:53
741,381263,2014-05-24,2014,TBA,BOS,6,5,6-5,TBA,15,0,60,56,116,207,240,447,19,13,32,2,5:16
742,381265,2014-05-24,2014,BAL,CLE,0,9,9-0,CLE,9,0,37,43,80,174,134,308,10,18,28,2,3:05
743,381282,2014-05-25,2014,SEA,HOU,1,4,4-1,HOU,9,0,30,35,65,132,106,238,4,12,16,0,2:28
744,381281,2014-05-25,2014,ATL,COL,7,0,7-0,ATL,9,1,34,33,67,115,137,252,10,5,15,1,2:48
745,381283,2014-05-25,2014,ANA,KCA,4,3,4-3,ANA,9,1,36,34,70,150,140,290,14,9,23,1,3:04
746,381279,2014-05-25,2014,SDN,CHN,4,3,4-3,SDN,9,1,32,34,66,148,134,282,9,8,17,3,3:02
747,381289,2014-05-25,2014,CIN,SLN,0,4,4-0,SLN,9,0,34,42,76,141,134,275,7,14,21,2,3:15
748,381284,2014-05-25,2014,PHI,LAN,0,6,6-0,LAN,9,0,30,39,69,124,128,252,3,12,15,0,2:37
749,381286,2014-05-25,2014,SFN,MIN,8,1,8-1,SFN,9,1,35,32,67,131,132,263,13,5,18,1,2:40
750,381288,2014-05-25,2014,TOR,OAK,3,1,3-1,TOR,9,1,36,35,71,148,142,290,14,8,22,1,3:08
751,381291,2014-05-25,2014,PIT,WAS,2,5,5-2,WAS,9,0,35,41,76,162,131,293,9,15,24,2,3:08
752,381287,2014-05-25,2014,CHA,NYA,1,7,7-1,NYA,9,0,35,42,77,170,152,322,10,14,24,1,3:17
753,381277,2014-05-25,2014,NYN,ARI,1,2,2-1,ARI,9,0,38,39,77,176,120,296,15,13,28,2,3:09
754,381278,2014-05-25,2014,TBA,BOS,8,5,8-5,TBA,9,1,39,39,78,159,141,300,15,12,27,2,3:27
755,381290,2014-05-25,2014,DET,TEX,4,12,12-4,TEX,9,0,42,50,92,179,154,333,17,22,39,5,3:43
756,381247,2014-05-25,2014,NYN,ARI,4,2,4-2,NYN,9,1,41,35,76,138,146,284,18,7,25,3,3:12
757,381247,2014-05-25,2014,NYN,ARI,4,2,4-2,NYN,9,1,41,35,76,138,146,284,18,7,25,3,3:12
758,381280,2014-05-25,2014,BAL,CLE,4,2,4-2,BAL,9,1,37,36,73,155,162,317,13,11,24,2,3:12
759,381285,2014-05-25,2014,MIA,MIL,1,7,7-1,MIL,9,0,36,43,79,163,150,313,10,17,27,1,3:16
760,381304,2014-05-26,2014,ARI,SDN,7,5,7-5,ARI,9,0,37,36,73,118,139,257,12,12,24,2,2:59
761,381299,2014-05-26,2014,OAK,DET,10,0,10-0,OAK,9,1,41,35,76,122,156,278,14,7,21,1,2:53
762,381296,2014-05-26,2014,LAN,CIN,4,3,4-3,LAN,9,1,34,35,69,139,140,279,9,8,17,3,3:07
763,381292,2014-05-26,2014,SEA,ANA,5,1,5-1,SEA,9,1,34,31,65,127,115,242,12,6,18,1,2:40
764,381298,2014-05-26,2014,PHI,COL,9,0,9-0,PHI,9,1,37,36,73,126,147,273,14,11,25,3,3:06
765,381306,2014-05-26,2014,MIN,TEX,2,7,7-2,TEX,9,0,35,39,74,116,135,251,10,13,23,2,2:52
766,381300,2014-05-26,2014,KCA,HOU,2,9,9-2,HOU,9,0,38,46,84,184,138,322,12,21,33,1,3:23
767,381294,2014-05-26,2014,ATL,BOS,6,8,8-6,BOS,9,0,42,41,83,184,154,338,17,15,32,2,3:40 (1:26 delay)
768,381295,2014-05-26,2014,SFN,CHN,4,8,8-4,CHN,9,0,35,41,76,127,143,270,7,16,23,2,3:11
769,381293,2014-05-26,2014,MIL,BAL,6,7,7-6,BAL,10,0,45,44,89,167,172,339,17,16,33,2,3:42
770,381302,2014-05-26,2014,SLN,NYA,4,6,6-4,NYA,12,0,47,46,93,172,168,340,12,13,25,3,3:41 (1:01 delay)
771,381301,2014-05-26,2014,WAS,MIA,2,3,3-2,MIA,9,0,34,34,68,128,142,270,6,9,15,1,2:46
772,381297,2014-05-26,2014,CHA,CLE,6,2,6-2,CHA,9,1,35,37,72,163,154,317,10,11,21,4,3:22
773,381303,2014-05-26,2014,NYN,PIT,3,5,5-3,PIT,9,0,36,45,81,195,120,315,10,20,30,3,3:30
774,381305,2014-05-26,2014,TOR,TBA,10,5,10-5,TOR,9,1,42,41,83,139,137,276,18,17,35,1,2:58
775,381311,2014-05-27,2014,LAN,CIN,6,3,6-3,LAN,9,1,36,34,70,119,132,251,15,8,23,2,2:58
776,381310,2014-05-27,2014,SFN,CHN,4,0,4-0,SFN,9,1,34,33,67,117,118,235,10,6,16,0,2:39
777,381321,2014-05-27,2014,MIN,TEX,4,3,4-3,MIN,9,0,36,35,71,121,140,261,9,9,18,1,2:43
778,381317,2014-05-27,2014,SLN,NYA,6,0,6-0,SLN,9,1,37,34,71,126,157,283,13,8,21,0,2:41
779,381312,2014-05-27,2014,CHA,CLE,2,1,2-1,CHA,9,1,36,33,69,139,152,291,12,9,21,3,3:05 (2:39 delay)
780,381315,2014-05-27,2014,KCA,HOU,0,3,3-0,HOU,9,0,32,41,73,153,122,275,5,17,22,1,3:02
781,381314,2014-05-27,2014,OAK,DET,5,6,6-5,DET,9,0,38,38,76,151,145,296,12,12,24,2,3:19
782,381309,2014-05-27,2014,ATL,BOS,3,6,6-3,BOS,9,0,39,43,82,156,160,316,14,17,31,4,3:32
783,381308,2014-05-27,2014,MIL,BAL,7,6,7-6,MIL,10,0,44,41,85,168,156,324,17,11,28,2,3:44
784,381307,2014-05-27,2014,SEA,ANA,4,6,6-4,ANA,9,0,41,40,81,133,163,296,15,14,29,2,3:03
785,381320,2014-05-27,2014,TOR,TBA,9,6,9-6,TOR,9,1,40,39,79,141,133,274,17,14,31,3,3:00
786,381318,2014-05-27,2014,NYN,PIT,4,2,4-2,NYN,9,1,38,40,78,175,165,340,13,14,27,2,3:43
787,381319,2014-05-27,2014,ARI,SDN,3,4,4-3,SDN,9,0,38,38,76,143,129,272,12,11,23,3,2:53
788,381313,2014-05-27,2014,PHI,COL,2,6,6-2,COL,9,0,39,37,76,147,151,298,13,11,24,2,3:21 (1:22 delay)
789,381326,2014-05-28,2014,LAN,CIN,2,3,3-2,CIN,9,0,34,36,70,138,116,254,7,9,16,2,3:08
790,381335,2014-05-28,2014,TOR,TBA,3,2,3-2,TOR,9,0,36,34,70,143,148,291,13,7,20,2,3:23
791,381322,2014-05-28,2014,SEA,ANA,3,1,3-1,SEA,9,1,30,31,61,119,119,238,8,6,14,2,2:30
792,381330,2014-05-28,2014,KCA,HOU,3,9,9-3,HOU,9,0,38,49,87,186,165,351,11,22,33,1,3:21
793,381325,2014-05-28,2014,SFN,CHN,5,0,5-0,SFN,9,1,36,36,72,151,143,294,14,8,22,5,3:18
794,381332,2014-05-28,2014,SLN,NYA,4,7,7-4,NYA,9,0,44,42,86,150,164,314,16,15,31,4,3:22 (:05 delay)
795,381331,2014-05-28,2014,WAS,MIA,5,8,8-5,MIA,10,0,50,45,95,176,182,358,21,21,42,2,3:47
796,381327,2014-05-28,2014,CHA,CLE,3,2,3-2,CHA,9,0,36,35,71,118,147,265,11,9,20,3,2:46
797,381336,2014-05-28,2014,MIN,TEX,0,1,1-0,TEX,9,0,36,34,70,143,151,294,10,8,18,4,3:12
798,381329,2014-05-28,2014,OAK,DET,3,1,3-1,OAK,9,0,30,30,60,103,117,220,6,6,12,1,2:26
799,381333,2014-05-28,2014,NYN,PIT,5,0,5-0,NYN,9,1,37,35,72,140,168,308,14,8,22,2,3:08
800,381323,2014-05-28,2014,BOS,ATL,4,0,4-0,BOS,9,1,39,37,76,135,172,307,17,10,27,2,3:09
801,381324,2014-05-28,2014,MIL,BAL,8,3,8-3,MIL,9,1,37,39,76,148,152,300,14,14,28,3,3:29
802,381334,2014-05-28,2014,ARI,SDN,12,6,12-6,ARI,9,1,45,42,87,163,171,334,21,14,35,3,3:29
803,381328,2014-05-28,2014,PHI,COL,6,3,6-3,PHI,9,0,40,45,85,172,160,332,14,19,33,3,3:46
804,381343,2014-05-29,2014,PHI,NYN,1,4,4-1,NYN,9,0,31,39,70,136,137,273,4,12,16,4,2:55
805,381345,2014-05-29,2014,SLN,SFN,5,6,6-5,SFN,9,0,38,36,74,123,146,269,13,11,24,2,3:08
806,381346,2014-05-29,2014,MIN,TEX,4,5,5-4,TEX,9,0,41,41,82,159,168,327,15,14,29,4,3:34
807,381340,2014-05-29,2014,ARI,CIN,4,0,4-0,ARI,9,1,36,27,63,94,147,241,14,3,17,1,2:30
808,381337,2014-05-29,2014,SEA,ANA,5,7,7-5,ANA,9,0,34,46,80,161,140,301,7,20,27,3,3:08
809,381339,2014-05-29,2014,HOU,BAL,3,1,3-1,HOU,9,1,36,34,70,122,148,270,10,7,17,0,2:56
810,381341,2014-05-29,2014,OAK,DET,4,5,5-4,DET,9,0,45,39,84,142,178,320,19,13,32,1,3:28
811,381344,2014-05-29,2014,LAN,PIT,3,6,6-3,PIT,9,0,35,40,75,143,117,260,9,16,25,2,2:58
812,381338,2014-05-29,2014,BOS,ATL,4,3,4-3,BOS,9,0,38,37,75,120,155,275,16,10,26,2,3:00
813,381342,2014-05-29,2014,TOR,KCA,6,8,8-6,KCA,10,0,37,49,86,188,146,334,9,19,28,2,3:26
814,381349,2014-05-30,2014,HOU,BAL,2,1,2-1,HOU,9,1,30,32,62,109,113,222,8,6,14,3,2:40
815,381353,2014-05-30,2014,SEA,DET,3,6,6-3,DET,9,0,35,36,71,132,151,283,9,12,21,1,3:05
816,381352,2014-05-30,2014,CLE,COL,5,2,5-2,CLE,9,1,35,32,67,126,141,267,12,6,18,2,3:07
817,381360,2014-05-30,2014,BOS,TBA,3,2,3-2,BOS,10,0,42,37,79,159,149,308,13,9,22,2,3:55
818,381358,2014-05-30,2014,CHA,SDN,1,4,4-1,SDN,9,0,33,39,72,150,140,290,8,13,21,0,2:51
819,381350,2014-05-30,2014,MIL,CHN,11,5,11-5,MIL,9,1,39,42,81,169,134,303,17,16,33,1,3:15
820,381359,2014-05-30,2014,SLN,SFN,4,9,9-4,SFN,9,0,35,42,77,171,150,321,9,15,24,3,3:14
821,381354,2014-05-30,2014,TOR,KCA,1,6,6-1,KCA,9,0,42,38,80,135,182,317,15,11,26,1,3:01
822,381356,2014-05-30,2014,PHI,NYN,6,5,6-5,PHI,14,0,62,59,121,225,239,464,25,20,45,4,5:23
823,381351,2014-05-30,2014,ARI,CIN,4,6,6-4,CIN,9,0,36,36,72,128,128,256,8,12,20,0,2:40
824,381361,2014-05-30,2014,WAS,TEX,9,2,9-2,WAS,9,1,40,36,76,119,130,249,18,9,27,1,2:45
825,381357,2014-05-30,2014,LAN,PIT,1,2,2-1,PIT,9,0,36,35,71,174,139,313,9,11,20,1,3:25
826,381355,2014-05-30,2014,NYA,MIN,1,6,6-1,MIN,9,0,37,39,76,150,155,305,13,12,25,1,3:04
827,381347,2014-05-30,2014,OAK,ANA,9,5,9-5,OAK,9,1,42,38,80,156,146,302,18,11,29,3,3:04
828,381348,2014-05-30,2014,MIA,ATL,2,3,3-2,ATL,9,0,32,37,69,133,127,260,6,14,20,2,2:53
829,381364,2014-05-31,2014,HOU,BAL,1,4,4-1,BAL,9,0,34,38,72,129,132,261,9,12,21,1,2:45
830,381366,2014-05-31,2014,ARI,CIN,0,5,5-0,CIN,9,0,35,38,73,136,135,271,9,14,23,3,2:57
831,381367,2014-05-31,2014,CLE,COL,7,6,7-6,CLE,9,1,37,36,73,147,129,276,14,10,24,3,3:05
832,381365,2014-05-31,2014,MIL,CHN,0,8,8-0,CHN,9,0,31,38,69,155,132,287,6,12,18,1,3:00
833,381370,2014-05-31,2014,NYA,MIN,3,1,3-1,NYA,9,1,36,34,70,133,145,278,16,7,23,1,3:04 (:34 delay)
834,381362,2014-05-31,2014,OAK,ANA,11,3,11-3,OAK,9,1,41,37,78,110,157,267,19,12,31,3,3:13
835,381373,2014-05-31,2014,CHA,SDN,2,4,4-2,SDN,9,0,36,40,76,162,137,299,9,18,27,2,3:16
836,381376,2014-05-31,2014,WAS,TEX,10,2,10-2,WAS,9,1,38,32,70,146,155,301,15,6,21,0,2:47
837,381372,2014-05-31,2014,LAN,PIT,12,2,12-2,LAN,9,1,42,38,80,148,146,294,17,11,28,1,3:07
838,381374,2014-05-31,2014,SLN,SFN,2,0,2-0,SLN,9,1,31,31,62,132,113,245,9,4,13,0,2:29 (1:38 delay)
839,381368,2014-05-31,2014,SEA,DET,3,2,3-2,SEA,9,1,32,37,69,162,156,318,9,10,19,3,3:18
840,381371,2014-05-31,2014,PHI,NYN,4,5,5-4,NYN,14,0,57,58,115,253,227,480,16,20,36,3,5:32
841,381375,2014-05-31,2014,BOS,TBA,7,1,7-1,BOS,9,1,38,33,71,143,141,284,15,7,22,1,3:07
842,381369,2014-05-31,2014,TOR,KCA,12,2,12-2,TOR,9,1,44,38,82,133,176,309,21,11,32,1,2:53
843,381363,2014-05-31,2014,MIA,ATL,5,9,9-5,ATL,9,0,40,48,88,168,152,320,16,22,38,5,3:28
844,381385,2014-06-01,2014,NYA,MIN,2,7,7-2,MIN,9,0,31,41,72,161,109,270,5,15,20,2,2:58
845,381384,2014-06-01,2014,TOR,KCA,4,0,4-0,TOR,9,1,34,34,68,110,119,229,12,7,19,0,2:14
846,381388,2014-06-01,2014,CHA,SDN,4,1,4-1,CHA,9,1,31,28,59,100,128,228,8,2,10,0,2:08
847,381382,2014-06-01,2014,CLE,COL,6,4,6-4,CLE,9,0,37,37,74,154,133,287,12,9,21,2,3:11
848,381380,2014-06-01,2014,MIL,CHN,9,0,9-0,MIL,9,1,35,31,66,93,121,214,13,4,17,0,2:18
849,381391,2014-06-01,2014,WAS,TEX,0,2,2-0,TEX,9,0,34,38,72,155,112,267,7,15,22,1,3:06
850,381377,2014-06-01,2014,OAK,ANA,6,3,6-3,OAK,9,1,37,37,74,155,123,278,16,11,27,1,2:58
851,381381,2014-06-01,2014,ARI,CIN,3,4,4-3,CIN,9,0,36,38,74,151,134,285,10,11,21,2,2:59
852,381383,2014-06-01,2014,SEA,DET,4,0,4-0,SEA,9,1,34,31,65,111,145,256,11,5,16,2,2:46
853,381378,2014-06-01,2014,MIA,ATL,2,4,4-2,ATL,9,0,37,36,73,125,131,256,13,10,23,1,2:39
854,381389,2014-06-01,2014,SLN,SFN,0,8,8-0,SFN,9,0,34,47,81,175,135,310,7,20,27,1,3:04
855,381379,2014-06-01,2014,HOU,BAL,4,9,9-4,BAL,9,0,38,41,79,150,160,310,11,16,27,2,3:14
856,381387,2014-06-01,2014,LAN,PIT,3,5,5-3,PIT,9,0,37,37,74,148,137,285,10,11,21,0,3:22
857,381386,2014-06-01,2014,PHI,NYN,3,4,4-3,NYN,11,0,41,46,87,186,131,317,10,17,27,1,3:29
858,381390,2014-06-01,2014,BOS,TBA,4,0,4-0,BOS,9,1,38,35,73,141,170,311,15,8,23,1,3:12
859,381394,2014-06-02,2014,SLN,KCA,0,6,6-0,KCA,9,0,31,37,68,118,131,249,5,11,16,2,2:41
860,381395,2014-06-02,2014,MIL,MIN,6,2,6-2,MIL,9,1,33,38,71,164,106,270,10,14,24,4,3:02
861,381397,2014-06-02,2014,MIA,TBA,3,1,3-1,MIA,9,1,29,33,62,119,118,237,7,7,14,1,2:33
862,381392,2014-06-02,2014,CLE,BOS,3,2,3-2,CLE,9,1,31,34,65,135,96,231,10,9,19,1,2:21
863,380952,2014-06-02,2014,NYA,SEA,2,10,10-2,SEA,9,0,34,42,76,139,136,275,9,15,24,1,2:54
864,380952,2014-06-02,2014,NYA,SEA,2,10,10-2,SEA,9,0,34,42,76,139,136,275,9,15,24,1,2:54
865,380948,2014-06-02,2014,PHI,NYN,2,11,11-2,NYN,9,0,35,44,79,187,135,322,10,19,29,4,3:17
866,380948,2014-06-02,2014,PHI,NYN,2,11,11-2,NYN,9,0,35,44,79,187,135,322,10,19,29,4,3:17
867,381393,2014-06-02,2014,LAN,CHA,5,2,5-2,LAN,9,1,35,32,67,114,135,249,9,5,14,0,2:41
868,381396,2014-06-02,2014,SDN,PIT,3,10,10-3,PIT,9,0,41,53,94,249,156,405,13,26,39,4,4:04
869,381411,2014-06-03,2014,MIA,TBA,1,0,1-0,MIA,9,1,29,30,59,88,106,194,7,8,15,0,2:10
870,381407,2014-06-03,2014,WAS,PHI,7,0,7-0,WAS,9,1,38,35,73,124,144,268,14,8,22,0,2:42
871,381399,2014-06-03,2014,COL,ARI,2,4,4-2,ARI,9,0,35,38,73,136,135,271,10,13,23,0,3:03
872,381401,2014-06-03,2014,CLE,BOS,5,3,5-3,CLE,9,1,35,41,76,152,138,290,12,16,28,5,3:09
873,381402,2014-06-03,2014,LAN,CHA,1,4,4-1,CHA,9,0,40,34,74,125,165,290,13,9,22,2,3:05
874,381400,2014-06-03,2014,TEX,BAL,3,8,8-3,BAL,9,0,38,46,84,164,151,315,12,21,33,5,3:15
875,381398,2014-06-03,2014,HOU,ANA,7,2,7-2,HOU,9,1,39,37,76,147,176,323,18,8,26,3,3:31
876,381403,2014-06-03,2014,SLN,KCA,7,8,8-7,KCA,9,0,41,41,82,148,145,293,14,17,31,2,3:12
877,381405,2014-06-03,2014,CHN,NYN,2,1,2-1,CHN,9,0,33,38,71,169,148,317,8,12,20,4,3:19
878,381409,2014-06-03,2014,ATL,SEA,5,7,7-5,SEA,9,0,39,42,81,147,149,296,14,15,29,1,3:08
879,381410,2014-06-03,2014,CIN,SFN,8,3,8-3,CIN,9,1,37,34,71,134,139,273,12,7,19,1,2:57
880,381408,2014-06-03,2014,SDN,PIT,1,4,4-1,PIT,9,0,33,35,68,126,139,265,7,8,15,2,2:43
881,381406,2014-06-03,2014,NYA,OAK,2,5,5-2,OAK,10,0,40,39,79,171,161,332,10,11,21,4,3:33 (1:12 delay)
882,381404,2014-06-03,2014,MIL,MIN,4,6,6-4,MIN,9,0,40,36,76,149,174,323,16,10,26,0,3:18
883,381412,2014-06-03,2014,DET,TOR,3,5,5-3,TOR,9,0,33,34,67,144,140,284,6,7,13,3,2:51
884,381423,2014-06-04,2014,SDN,PIT,3,2,3-2,SDN,9,1,34,35,69,129,153,282,13,8,21,0,2:49
885,381413,2014-06-04,2014,HOU,ANA,0,4,4-0,ANA,9,0,33,39,72,155,118,273,6,12,18,1,2:53
886,381425,2014-06-04,2014,CIN,SFN,2,3,3-2,SFN,9,0,35,37,72,137,131,268,9,11,20,4,3:12
887,381415,2014-06-04,2014,TEX,BAL,5,6,6-5,BAL,9,0,39,45,84,166,144,310,14,20,34,4,3:33
888,381418,2014-06-04,2014,TBA,MIA,4,5,5-4,MIA,9,0,40,38,78,140,161,301,16,10,26,1,3:17
889,381424,2014-06-04,2014,ATL,SEA,0,2,2-0,SEA,9,0,32,39,71,139,122,261,6,13,19,1,2:51
890,381427,2014-06-04,2014,DET,TOR,2,8,8-2,TOR,9,0,40,40,80,170,143,313,13,16,29,3,3:14
891,381421,2014-06-04,2014,NYA,OAK,4,7,7-4,OAK,9,0,39,44,83,174,149,323,11,18,29,3,3:22
892,381420,2014-06-04,2014,CHN,NYN,5,4,5-4,CHN,9,1,38,41,79,167,160,327,16,15,31,6,3:40
893,381416,2014-06-04,2014,CLE,BOS,7,4,7-4,CLE,12,0,47,48,95,183,181,364,14,12,26,6,4:29 (2:28 delay)
894,381426,2014-06-04,2014,KCA,SLN,2,5,5-2,SLN,11,0,41,50,91,192,153,345,8,18,26,2,3:46
895,381419,2014-06-04,2014,MIN,MIL,6,4,6-4,MIN,9,1,39,34,73,115,146,261,15,7,22,1,2:52
896,381417,2014-06-04,2014,LAN,CHA,1,2,2-1,CHA,9,0,34,37,71,136,131,267,8,12,20,2,3:03
897,381422,2014-06-04,2014,WAS,PHI,8,4,8-4,WAS,9,1,38,38,76,147,135,282,15,10,25,0,3:00 (1:48 delay)
898,381414,2014-06-04,2014,COL,ARI,8,16,16-8,ARI,9,0,44,51,95,191,158,349,18,26,44,4,3:58
899,381432,2014-06-05,2014,MIN,MIL,5,8,8-5,MIL,9,0,39,40,79,157,165,322,14,13,27,3,3:26
900,381436,2014-06-05,2014,CIN,SFN,1,6,6-1,SFN,9,0,30,41,71,154,118,272,3,15,18,1,2:49
901,381437,2014-06-05,2014,KCA,SLN,3,2,3-2,KCA,9,1,31,36,67,130,114,244,9,10,19,0,2:26
902,381429,2014-06-05,2014,COL,ARI,7,12,12-7,ARI,9,0,42,47,89,167,147,314,15,21,36,4,3:36
903,381433,2014-06-05,2014,CHN,NYN,7,4,7-4,CHN,9,1,37,42,79,163,150,313,14,15,29,2,3:16
904,381430,2014-06-05,2014,TEX,BAL,8,6,8-6,TEX,9,1,39,37,76,147,153,300,18,11,29,3,3:11
905,381431,2014-06-05,2014,TBA,MIA,6,11,11-6,MIA,9,0,43,44,87,189,159,348,16,17,33,5,3:45
906,381434,2014-06-05,2014,NYA,OAK,2,1,2-1,NYA,9,1,31,36,67,157,117,274,8,9,17,0,2:57
907,381428,2014-06-05,2014,HOU,ANA,8,5,8-5,HOU,9,1,40,39,79,152,169,321,18,11,29,5,3:33
908,381438,2014-06-05,2014,DET,TOR,3,7,7-3,TOR,9,0,35,39,74,132,134,266,12,14,26,2,2:52
909,381435,2014-06-05,2014,WAS,PHI,4,2,4-2,WAS,9,1,36,32,68,119,118,237,14,5,19,1,2:38
910,381442,2014-06-06,2014,TEX,CLE,6,4,6-4,TEX,9,1,32,40,72,145,122,267,10,14,24,3,3:01
911,381440,2014-06-06,2014,DET,BOS,6,2,6-2,DET,9,1,35,35,70,142,125,267,15,8,23,2,2:49
912,381448,2014-06-06,2014,SFN,NYN,4,2,4-2,SFN,9,1,34,29,63,115,115,230,11,5,16,0,2:17
913,381446,2014-06-06,2014,PIT,MIL,15,5,15-5,PIT,9,1,46,39,85,127,172,299,23,14,37,2,3:11
914,381449,2014-06-06,2014,BAL,OAK,3,4,4-3,OAK,11,0,43,45,88,171,148,319,15,13,28,1,3:36
915,381451,2014-06-06,2014,TBA,SEA,4,0,4-0,TBA,9,1,43,33,76,146,153,299,21,6,27,0,3:17
916,381444,2014-06-06,2014,COL,LAN,2,7,7-2,LAN,9,0,40,43,83,136,161,297,13,17,30,1,3:23
917,381445,2014-06-06,2014,CHN,MIA,5,3,5-3,CHN,13,0,48,51,99,204,170,374,12,14,26,4,4:02
918,381441,2014-06-06,2014,ANA,CHA,8,4,8-4,ANA,9,1,34,43,77,177,128,305,13,18,31,1,3:10
919,381452,2014-06-06,2014,TOR,SLN,3,1,3-1,TOR,9,1,39,37,76,132,164,296,16,11,27,4,3:12
920,381453,2014-06-06,2014,SDN,WAS,0,6,6-0,WAS,9,0,32,38,70,135,116,251,3,10,13,1,2:32
921,381450,2014-06-06,2014,CIN,PHI,0,8,8-0,PHI,9,0,34,43,77,176,139,315,7,16,23,2,3:18
922,381439,2014-06-06,2014,ARI,ATL,2,5,5-2,ATL,9,0,34,41,75,146,123,269,7,14,21,4,3:03
923,381447,2014-06-06,2014,KCA,NYA,2,4,4-2,NYA,9,0,33,37,70,152,125,277,8,13,21,0,2:51
924,381443,2014-06-06,2014,MIN,HOU,4,5,5-4,HOU,9,0,40,34,74,129,154,283,12,8,20,2,3:00 (1:21 delay)
925,381466,2014-06-07,2014,TBA,SEA,4,7,7-4,SEA,9,0,34,40,74,135,110,245,7,13,20,3,2:46
926,381467,2014-06-07,2014,TOR,SLN,0,5,5-0,SLN,9,0,31,43,74,171,105,276,4,19,23,1,2:37
927,381468,2014-06-07,2014,SDN,WAS,4,3,4-3,SDN,11,0,42,41,83,153,126,279,11,9,20,1,3:12
928,381456,2014-06-07,2014,ANA,CHA,6,5,6-5,ANA,9,1,35,37,72,150,140,290,11,11,22,2,2:53
929,381462,2014-06-07,2014,KCA,NYA,8,4,8-4,KCA,9,1,39,37,76,150,141,291,16,11,27,3,3:10
930,381463,2014-06-07,2014,SFN,NYN,5,4,5-4,SFN,9,0,41,43,84,149,138,287,15,16,31,1,3:33
931,381455,2014-06-07,2014,DET,BOS,8,6,8-6,DET,9,1,41,43,84,168,152,320,20,17,37,3,3:36
932,381461,2014-06-07,2014,PIT,MIL,3,9,9-3,MIL,9,0,38,44,82,158,132,290,14,17,31,1,3:23
933,381465,2014-06-07,2014,CIN,PHI,6,5,6-5,CIN,9,1,35,37,72,134,146,280,12,12,24,1,2:56
934,381457,2014-06-07,2014,TEX,CLE,3,8,8-3,CLE,9,0,34,42,76,139,111,250,8,16,24,3,2:53
935,381458,2014-06-07,2014,MIN,HOU,8,0,8-0,MIN,9,1,42,35,77,135,182,317,16,8,24,3,3:24
936,381464,2014-06-07,2014,BAL,OAK,6,3,6-3,BAL,9,1,36,35,71,141,148,289,12,9,21,2,2:51
937,381459,2014-06-07,2014,COL,LAN,5,4,5-4,COL,10,0,43,44,87,157,141,298,17,16,33,4,3:35
938,381454,2014-06-07,2014,ARI,ATL,4,3,4-3,ARI,11,0,47,42,89,148,174,322,16,9,25,3,3:31
939,381460,2014-06-07,2014,CHN,MIA,5,2,5-2,CHN,9,1,34,33,67,126,154,280,12,6,18,2,2:49
940,381474,2014-06-08,2014,COL,LAN,1,6,6-1,LAN,6,1,18,26,44,116,73,189,3,10,13,1,2:04 (1:35 delay)
941,381481,2014-06-08,2014,TBA,SEA,0,5,5-0,SEA,9,0,32,41,73,153,120,273,6,14,20,2,3:10
942,381472,2014-06-08,2014,TEX,CLE,2,3,3-2,CLE,9,0,35,40,75,145,148,293,10,15,25,3,3:09
943,381477,2014-06-08,2014,KCA,NYA,2,1,2-1,KCA,9,1,28,37,65,163,95,258,7,10,17,0,2:48
944,381469,2014-06-08,2014,ARI,ATL,6,5,6-5,ARI,9,1,37,39,76,162,150,312,15,12,27,3,3:07
945,381478,2014-06-08,2014,SFN,NYN,6,4,6-4,SFN,9,1,36,36,72,154,146,300,14,11,25,5,3:24
946,381483,2014-06-08,2014,SDN,WAS,0,6,6-0,WAS,9,0,29,42,71,150,114,264,2,16,18,1,2:38
947,381476,2014-06-08,2014,PIT,MIL,0,1,1-0,MIL,9,0,37,31,68,94,159,253,10,5,15,1,2:57
948,381475,2014-06-08,2014,CHN,MIA,3,4,4-3,MIA,9,0,40,38,78,159,142,301,14,13,27,3,3:18
949,381470,2014-06-08,2014,DET,BOS,3,5,5-3,BOS,9,0,34,42,76,186,125,311,8,16,24,2,3:35
950,381479,2014-06-08,2014,BAL,OAK,1,11,11-1,OAK,9,0,36,46,82,188,140,328,10,21,31,3,3:27
951,381473,2014-06-08,2014,MIN,HOU,5,14,14-5,HOU,9,0,43,50,93,196,191,387,17,24,41,3,3:45
952,381471,2014-06-08,2014,ANA,CHA,4,2,4-2,ANA,9,1,39,34,73,138,146,284,17,11,28,2,3:01
953,381482,2014-06-08,2014,TOR,SLN,0,5,5-0,SLN,9,0,36,38,74,145,141,286,8,12,20,0,2:42
954,381480,2014-06-08,2014,CIN,PHI,4,1,4-1,CIN,9,1,30,36,66,137,132,269,7,9,16,0,2:40
955,381493,2014-06-09,2014,ANA,OAK,4,1,4-1,ANA,9,1,38,32,70,136,130,266,15,5,20,2,2:55
956,381484,2014-06-09,2014,COL,ATL,1,3,3-1,ATL,9,0,35,39,74,133,131,264,8,13,21,1,2:55
957,381485,2014-06-09,2014,BAL,BOS,4,0,4-0,BAL,9,1,32,32,64,108,110,218,9,6,15,0,2:21
958,381486,2014-06-09,2014,PIT,CHN,6,2,6-2,PIT,9,1,37,35,72,106,126,232,13,8,21,0,2:33
959,381489,2014-06-09,2014,ARI,HOU,3,4,4-3,HOU,9,0,36,39,75,136,151,287,10,13,23,3,3:12
960,381487,2014-06-09,2014,TEX,CLE,7,17,17-7,CLE,9,0,40,47,87,180,159,339,13,21,34,2,3:20
961,381495,2014-06-09,2014,SFN,WAS,2,9,9-2,WAS,9,0,34,43,77,144,137,281,9,16,25,1,3:01
962,381488,2014-06-09,2014,CHA,DET,6,5,6-5,CHA,9,1,38,38,76,140,145,285,15,11,26,3,3:13
963,381491,2014-06-09,2014,TOR,MIN,5,4,5-4,TOR,9,0,38,37,75,149,163,312,16,13,29,3,2:53
964,381490,2014-06-09,2014,CIN,LAN,2,6,6-2,LAN,9,0,36,42,78,167,146,313,13,17,30,2,3:26
965,381494,2014-06-09,2014,TBA,SEA,0,3,3-0,SEA,9,0,37,35,72,131,146,277,11,8,19,3,3:11
966,381501,2014-06-10,2014,ARI,HOU,4,1,4-1,ARI,9,1,34,33,67,118,136,254,12,9,21,0,2:40
967,381502,2014-06-10,2014,CIN,LAN,1,6,6-1,LAN,9,0,38,42,80,164,163,327,12,16,28,2,3:34 (2:05 delay)
968,381497,2014-06-10,2014,BAL,BOS,0,1,1-0,BOS,9,0,29,37,66,137,95,232,3,11,14,1,2:32 (1:33 delay)
969,381508,2014-06-10,2014,PHI,SDN,5,2,5-2,PHI,9,1,33,35,68,125,131,256,9,8,17,2,2:40
970,381503,2014-06-10,2014,TEX,MIA,5,8,8-5,MIA,9,0,39,48,87,200,145,345,12,20,32,3,3:39
971,381496,2014-06-10,2014,COL,ATL,10,13,13-10,ATL,9,0,46,46,92,160,182,342,20,21,41,5,3:49
972,381504,2014-06-10,2014,NYN,MIL,6,2,6-2,NYN,9,1,34,36,70,147,124,271,10,11,21,0,2:45
973,381510,2014-06-10,2014,SFN,WAS,1,2,2-1,WAS,9,0,37,35,72,129,139,268,12,11,23,0,2:55
974,381509,2014-06-10,2014,TBA,SLN,0,1,1-0,SLN,9,0,38,33,71,133,128,261,14,5,19,3,2:52
975,381505,2014-06-10,2014,TOR,MIN,0,4,4-0,MIN,9,0,35,41,76,173,145,318,8,16,24,2,3:07
976,381499,2014-06-10,2014,KCA,CLE,9,5,9-5,KCA,9,1,39,39,78,140,140,280,15,13,28,5,3:00
977,381498,2014-06-10,2014,PIT,CHN,3,7,7-3,CHN,9,0,39,38,77,138,145,283,14,14,28,4,3:20
978,381507,2014-06-10,2014,ANA,OAK,2,1,2-1,ANA,14,0,53,52,105,209,196,405,17,12,29,1,4:39
979,381506,2014-06-10,2014,SEA,NYA,2,3,3-2,NYA,9,0,36,35,71,125,152,277,10,11,21,2,2:50
980,381520,2014-06-11,2014,TOR,MIN,2,7,7-2,MIN,9,0,38,42,80,155,134,289,11,17,28,1,2:57
981,381519,2014-06-11,2014,NYN,MIL,1,3,3-1,MIL,9,0,32,40,72,154,127,281,6,14,20,4,3:09
982,381517,2014-06-11,2014,CIN,LAN,5,0,5-0,CIN,9,1,35,32,67,177,153,330,12,7,19,2,3:19
983,381523,2014-06-11,2014,PHI,SDN,3,0,3-0,PHI,9,0,35,33,68,132,136,268,11,7,18,0,2:55
984,381511,2014-06-11,2014,HOU,ARI,5,1,5-1,HOU,9,1,34,31,65,111,113,224,12,6,18,2,2:22
985,381514,2014-06-11,2014,PIT,CHN,4,2,4-2,PIT,9,1,38,37,75,139,134,273,17,9,26,0,2:56 (1:38 delay)
986,381515,2014-06-11,2014,KCA,CLE,4,1,4-1,KCA,9,1,36,36,72,125,153,278,12,9,21,1,2:53
987,381518,2014-06-11,2014,TEX,MIA,6,0,6-0,TEX,9,1,36,32,68,117,142,259,12,9,21,0,2:37
988,381522,2014-06-11,2014,ANA,OAK,1,7,7-1,OAK,9,0,37,40,77,166,131,297,12,13,25,4,3:19
989,381516,2014-06-11,2014,CHA,DET,8,2,8-2,CHA,9,1,42,39,81,129,170,299,20,13,33,2,3:17
990,381524,2014-06-11,2014,TBA,SLN,6,3,6-3,TBA,9,1,36,41,77,162,134,296,12,14,26,4,3:10
991,381512,2014-06-11,2014,COL,ATL,8,2,8-2,COL,9,1,37,34,71,102,128,230,15,7,22,2,2:40
992,381513,2014-06-11,2014,BAL,BOS,6,0,6-0,BAL,9,1,38,29,67,121,148,269,15,5,20,1,2:49 (1:38 delay)
993,381525,2014-06-11,2014,SFN,WAS,2,6,6-2,WAS,9,0,34,41,75,175,131,306,8,14,22,2,3:19
994,381521,2014-06-11,2014,SEA,NYA,2,4,4-2,NYA,9,0,32,39,71,154,110,264,7,13,20,0,2:44
995,381526,2014-06-12,2014,HOU,ARI,5,4,5-4,HOU,10,0,42,40,82,144,170,314,18,9,27,4,3:27
996,381535,2014-06-12,2014,BAL,TOR,4,2,4-2,BAL,9,1,36,36,72,146,148,294,12,11,23,2,2:59
997,381527,2014-06-12,2014,COL,ATL,10,3,10-3,COL,9,1,39,35,74,125,129,254,18,9,27,4,2:39
998,381534,2014-06-12,2014,PHI,SDN,7,3,7-3,PHI,9,1,37,35,72,149,141,290,13,8,21,2,3:05
999,381528,2014-06-12,2014,PIT,CHN,4,0,4-0,PIT,9,1,34,35,69,124,120,244,14,9,23,2,2:46 (1:35 delay)
1000,381529,2014-06-12,2014,BOS,CLE,5,2,5-2,BOS,9,1,36,35,71,127,152,279,15,9,24,3,3:08
1001,381532,2014-06-12,2014,NYN,MIL,1,5,5-1,MIL,13,0,50,56,106,188,179,367,12,18,30,3,4:08 (:03 delay)
1002,381533,2014-06-12,2014,SEA,NYA,3,6,6-3,NYA,9,0,36,41,77,151,113,264,9,14,23,3,2:56
1003,381531,2014-06-12,2014,CIN,LAN,4,1,4-1,CIN,9,1,32,36,68,125,112,237,10,10,20,0,2:43
1004,381536,2014-06-12,2014,SFN,WAS,7,1,7-1,SFN,9,1,39,35,74,134,141,275,17,10,27,0,2:59
1005,381530,2014-06-12,2014,CHA,DET,0,4,4-0,DET,9,0,34,36,70,160,113,273,6,10,16,0,2:52
1006,381550,2014-06-13,2014,BAL,TOR,0,4,4-0,TOR,9,0,36,35,71,138,136,274,10,10,20,2,2:44 (:21 delay)
1007,381537,2014-06-13,2014,ATL,ANA,4,3,4-3,ATL,9,1,35,36,71,148,126,274,11,10,21,0,2:59
1008,381547,2014-06-13,2014,NYN,SDN,6,2,6-2,NYN,9,1,36,35,71,157,133,290,13,8,21,3,3:01 (1:56 delay)
1009,381545,2014-06-13,2014,OAK,NYA,0,7,7-0,NYA,9,0,31,42,73,172,135,307,5,17,22,1,3:05
1010,381538,2014-06-13,2014,LAN,ARI,4,3,4-3,LAN,9,1,39,42,81,151,160,311,17,15,32,1,3:32
1011,381546,2014-06-13,2014,MIA,PIT,6,8,8-6,PIT,13,0,55,57,112,216,200,416,18,20,38,3,4:26
1012,381544,2014-06-13,2014,DET,MIN,0,2,2-0,MIN,9,0,35,37,72,149,137,286,8,10,18,1,3:00
1013,381541,2014-06-13,2014,BOS,CLE,10,3,10-3,BOS,9,1,40,36,76,139,171,310,19,8,27,6,3:13
1014,381549,2014-06-13,2014,SEA,TEX,0,1,1-0,TEX,9,0,30,32,62,121,104,225,4,6,10,2,2:30
1015,381542,2014-06-13,2014,SFN,COL,4,7,7-4,COL,9,0,38,37,75,161,146,307,13,13,26,3,3:36
1016,381543,2014-06-13,2014,CHA,KCA,2,7,7-2,KCA,9,0,40,43,83,179,155,334,13,16,29,1,3:22
1017,381548,2014-06-13,2014,HOU,TBA,1,6,6-1,TBA,9,0,35,40,75,151,156,307,8,15,23,2,3:30
1018,381551,2014-06-13,2014,SLN,WAS,1,0,1-0,SLN,9,1,26,29,55,129,76,205,4,2,6,0,2:03
1019,381539,2014-06-13,2014,PHI,CHN,1,2,2-1,CHN,9,0,34,32,66,122,140,262,7,7,14,1,2:51
1020,381540,2014-06-13,2014,MIL,CIN,5,6,6-5,CIN,9,0,39,40,79,136,151,287,14,11,25,2,3:23
1021,381555,2014-06-14,2014,MIL,CIN,4,2,4-2,MIL,9,1,31,33,64,139,114,253,7,9,16,1,2:55
1022,381561,2014-06-14,2014,MIA,PIT,6,8,8-6,PIT,9,0,38,46,84,159,151,310,14,22,36,1,3:09
1023,381553,2014-06-14,2014,LAN,ARI,6,4,6-4,LAN,9,1,33,36,69,126,118,244,12,9,21,1,2:39
1024,381565,2014-06-14,2014,BAL,TOR,3,2,3-2,BAL,9,1,34,38,72,145,111,256,9,14,23,4,3:02
1025,381564,2014-06-14,2014,SEA,TEX,3,4,4-3,TEX,9,0,38,38,76,165,148,313,11,13,24,1,3:34
1026,381562,2014-06-14,2014,NYN,SDN,0,5,5-0,SDN,9,0,34,41,75,184,139,323,7,16,23,0,3:13
1027,381552,2014-06-14,2014,ATL,ANA,6,11,11-6,ANA,13,0,59,58,117,209,243,452,24,22,46,4,4:57
1028,381566,2014-06-14,2014,SLN,WAS,4,1,4-1,SLN,9,1,35,34,69,131,121,252,13,9,22,3,2:44
1029,381563,2014-06-14,2014,HOU,TBA,7,3,7-3,HOU,9,1,37,37,74,132,170,302,13,11,24,2,3:39
1030,381559,2014-06-14,2014,DET,MIN,12,9,12-9,DET,9,1,46,44,90,197,173,370,23,17,40,6,3:48
1031,381556,2014-06-14,2014,BOS,CLE,2,3,3-2,CLE,9,0,36,43,79,157,155,312,12,16,28,5,3:24
1032,381560,2014-06-14,2014,OAK,NYA,5,1,5-1,OAK,9,1,36,33,69,132,143,275,12,6,18,1,2:45 (:38 delay)
1033,381558,2014-06-14,2014,CHA,KCA,1,9,9-1,KCA,9,0,36,43,79,169,121,290,9,17,26,2,3:03
1034,381557,2014-06-14,2014,SFN,COL,4,5,5-4,COL,9,0,37,39,76,164,132,296,10,14,24,2,3:23
1035,381554,2014-06-14,2014,PHI,CHN,7,4,7-4,PHI,9,1,37,36,73,148,140,288,13,11,24,1,3:04
1036,381569,2014-06-15,2014,PHI,CHN,0,3,3-0,CHN,9,0,33,35,68,115,123,238,6,8,14,0,2:35
1037,381567,2014-06-15,2014,ATL,ANA,7,3,7-3,ATL,9,1,38,41,79,176,147,323,16,14,30,3,3:31
1038,381573,2014-06-15,2014,CHA,KCA,3,6,6-3,KCA,9,0,43,39,82,144,162,306,16,15,31,2,3:10
1039,381574,2014-06-15,2014,DET,MIN,4,3,4-3,DET,9,0,41,39,80,144,157,301,16,11,27,2,3:19
1040,381576,2014-06-15,2014,MIA,PIT,3,2,3-2,MIA,10,0,40,43,83,168,155,323,11,16,27,0,3:22
1041,381571,2014-06-15,2014,BOS,CLE,2,3,3-2,CLE,11,0,43,46,89,182,186,368,13,12,25,3,4:03
1042,381575,2014-06-15,2014,OAK,NYA,10,5,10-5,OAK,9,1,40,40,80,156,163,319,16,14,30,2,3:06
1043,381568,2014-06-15,2014,LAN,ARI,3,6,6-3,ARI,9,0,39,37,76,131,154,285,14,10,24,2,3:04
1044,381579,2014-06-15,2014,SEA,TEX,5,1,5-1,SEA,9,1,37,32,69,119,125,244,15,6,21,1,2:46
1045,381577,2014-06-15,2014,NYN,SDN,3,1,3-1,NYN,9,1,38,35,73,139,168,307,14,10,24,2,3:15
1046,381572,2014-06-15,2014,SFN,COL,7,8,8-7,COL,9,0,46,40,86,154,167,321,20,16,36,4,3:43
1047,381581,2014-06-15,2014,SLN,WAS,5,2,5-2,SLN,9,1,35,39,74,148,127,275,12,12,24,1,2:40
1048,381578,2014-06-15,2014,HOU,TBA,3,4,4-3,TBA,9,0,33,43,76,169,131,300,6,17,23,4,3:41
1049,381570,2014-06-15,2014,MIL,CIN,4,13,13-4,CIN,9,0,39,48,87,202,121,323,15,20,35,2,3:19
1050,381580,2014-06-15,2014,BAL,TOR,2,5,5-2,TOR,9,0,36,41,77,129,141,270,10,14,24,3,3:07
1051,381588,2014-06-16,2014,BOS,MIN,1,0,1-0,BOS,9,1,32,32,64,141,135,276,9,7,16,1,2:45
1052,381589,2014-06-16,2014,SLN,NYN,6,2,6-2,SLN,9,1,36,36,72,145,134,279,14,11,25,3,2:52
1053,381587,2014-06-16,2014,ARI,MIL,3,9,9-3,MIL,9,0,36,39,75,140,135,275,12,16,28,1,3:00
1054,381584,2014-06-16,2014,MIA,CHN,4,5,5-4,CHN,13,0,55,53,108,199,209,408,17,15,32,4,4:39
1055,381590,2014-06-16,2014,ATL,PHI,1,6,6-1,PHI,13,0,52,55,107,217,206,423,17,18,35,2,4:47
1056,381582,2014-06-16,2014,CLE,ANA,4,3,4-3,CLE,9,1,32,40,72,152,126,278,9,14,23,1,2:59
1057,381586,2014-06-16,2014,DET,KCA,8,11,11-8,KCA,9,0,42,48,90,156,157,313,17,22,39,2,3:26
1058,381592,2014-06-16,2014,OAK,TEX,8,14,14-8,TEX,9,0,47,47,94,161,182,343,22,18,40,6,3:41
1059,381585,2014-06-16,2014,LAN,COL,6,1,6-1,LAN,9,1,41,32,73,141,144,285,18,5,23,1,3:11
1060,381583,2014-06-16,2014,TBA,BAL,5,4,5-4,TBA,9,1,36,38,74,162,137,299,12,11,23,4,3:21
1061,381591,2014-06-16,2014,SEA,SDN,5,1,5-1,SEA,9,1,38,33,71,138,138,276,15,8,23,2,2:44
1062,381602,2014-06-17,2014,SLN,NYN,5,2,5-2,SLN,9,1,38,36,74,124,117,241,13,9,22,1,2:36
1063,381601,2014-06-17,2014,BOS,MIN,2,1,2-1,BOS,9,1,31,33,64,149,105,254,8,6,14,2,2:48
1064,381600,2014-06-17,2014,ARI,MIL,5,7,7-5,MIL,9,0,40,39,79,133,135,268,12,12,24,2,2:52
1065,381605,2014-06-17,2014,CHA,SFN,8,2,8-2,CHA,9,1,35,38,73,131,125,256,11,11,22,1,2:42
1066,381603,2014-06-17,2014,ATL,PHI,2,5,5-2,PHI,9,0,33,43,76,176,114,290,7,18,25,1,3:05
1067,381595,2014-06-17,2014,MIA,CHN,6,5,6-5,MIA,9,1,38,39,77,154,152,306,14,13,27,2,3:11
1068,381606,2014-06-17,2014,OAK,TEX,10,6,10-6,OAK,9,1,41,37,78,132,158,290,19,9,28,6,3:28
1069,381599,2014-06-17,2014,DET,KCA,4,11,11-4,KCA,9,0,36,45,81,179,136,315,13,20,33,1,3:14
1070,381596,2014-06-17,2014,PIT,CIN,5,6,6-5,CIN,9,0,45,41,86,169,192,361,20,15,35,3,3:54
1071,381604,2014-06-17,2014,SEA,SDN,6,1,6-1,SEA,9,1,37,31,68,117,165,282,13,5,18,0,2:42
1072,381593,2014-06-17,2014,CLE,ANA,3,9,9-3,ANA,9,0,34,43,77,177,121,298,8,17,25,2,3:08 (:11 delay)
1073,381598,2014-06-17,2014,WAS,HOU,6,5,6-5,WAS,9,1,39,43,82,159,161,320,15,17,32,4,3:41
1074,381594,2014-06-17,2014,TBA,BAL,5,7,7-5,BAL,9,0,40,40,80,168,152,320,14,15,29,3,3:31
1075,381597,2014-06-17,2014,LAN,COL,4,2,4-2,LAN,9,1,34,42,76,184,131,315,11,16,27,1,3:33
1076,381607,2014-06-17,2014,NYA,TOR,3,1,3-1,NYA,9,1,34,36,70,151,168,319,10,9,19,1,3:07
1077,381617,2014-06-18,2014,SLN,NYN,2,3,3-2,NYN,9,0,32,36,68,129,107,236,8,12,20,2,2:38
1078,381612,2014-06-18,2014,LAN,COL,8,0,8-0,LAN,9,1,37,28,65,107,150,257,15,0,15,1,2:58
1079,381622,2014-06-18,2014,NYA,TOR,7,3,7-3,NYA,9,1,39,37,76,172,140,312,14,10,24,2,3:02
1080,381613,2014-06-18,2014,WAS,HOU,6,5,6-5,WAS,9,1,39,39,78,178,143,321,17,15,32,3,3:42
1081,381618,2014-06-18,2014,ATL,PHI,5,10,10-5,PHI,9,0,40,49,89,177,154,331,17,22,39,0,3:32
1082,381616,2014-06-18,2014,BOS,MIN,2,1,2-1,BOS,10,0,32,34,66,118,136,254,4,5,9,1,2:31
1083,381610,2014-06-18,2014,MIA,CHN,1,6,6-1,CHN,9,0,34,40,74,133,139,272,7,13,20,1,2:54
1084,381620,2014-06-18,2014,CHA,SFN,7,6,7-6,CHA,9,1,36,44,80,173,118,291,13,18,31,4,3:12 (:12 delay)
1085,381621,2014-06-18,2014,OAK,TEX,4,2,4-2,OAK,9,1,36,35,71,118,141,259,14,8,22,0,2:50
1086,381614,2014-06-18,2014,DET,KCA,1,2,2-1,KCA,9,0,33,34,67,133,140,273,6,9,15,2,2:53
1087,381619,2014-06-18,2014,SDN,SEA,2,1,2-1,SDN,9,1,30,36,66,114,125,239,6,11,17,1,2:40
1088,381609,2014-06-18,2014,TBA,BAL,0,2,2-0,BAL,9,0,32,40,72,139,145,284,6,12,18,1,3:09
1089,381615,2014-06-18,2014,ARI,MIL,4,3,4-3,ARI,9,0,35,35,70,124,115,239,9,9,18,2,2:39
1090,381611,2014-06-18,2014,PIT,CIN,4,11,11-4,CIN,9,0,40,48,88,178,150,328,14,21,35,3,3:25 (1:15 delay)
1091,381626,2014-06-19,2014,MIN,CHA,4,2,4-2,MIN,9,1,34,33,67,120,137,257,12,7,19,0,2:43 (2:06 delay)
1092,381631,2014-06-19,2014,SLN,PHI,1,4,4-1,PHI,9,0,32,37,69,128,126,254,6,11,17,3,2:48
1093,381625,2014-06-19,2014,OAK,BOS,4,2,4-2,OAK,9,1,33,32,65,134,143,277,12,5,17,1,2:39
1094,381629,2014-06-19,2014,ARI,MIL,1,4,4-1,MIL,9,0,33,34,67,127,135,262,7,11,18,2,2:56
1095,380581,2014-06-19,2014,DET,KCA,2,1,2-1,DET,9,1,28,33,61,131,109,240,5,7,12,0,2:27
1096,380581,2014-06-19,2014,DET,KCA,2,1,2-1,DET,9,1,28,33,61,131,109,240,5,7,12,0,2:27
1097,381633,2014-06-19,2014,NYA,TOR,6,4,6-4,NYA,9,1,41,37,78,157,167,324,18,11,29,5,3:47
1098,381624,2014-06-19,2014,WAS,ATL,0,3,3-0,ATL,9,0,31,40,71,140,109,249,5,13,18,1,2:56
1099,381623,2014-06-19,2014,CLE,ANA,5,3,5-3,CLE,10,0,42,40,82,185,172,357,13,13,26,4,3:36
1100,381630,2014-06-19,2014,MIA,NYN,0,1,1-0,NYN,9,0,28,34,62,144,111,255,4,11,15,0,2:35
1101,381628,2014-06-19,2014,TBA,HOU,5,0,5-0,TBA,9,1,37,33,70,139,128,267,12,6,18,1,3:06
1102,381632,2014-06-19,2014,SDN,SEA,4,1,4-1,SDN,9,1,33,36,69,120,107,227,9,10,19,1,2:42
1103,381627,2014-06-19,2014,PIT,CIN,4,3,4-3,PIT,12,0,53,45,98,167,202,369,20,10,30,3,4:16 (:35 delay)
1104,381639,2014-06-20,2014,TBA,HOU,1,3,3-1,HOU,9,0,35,38,73,140,126,266,9,12,21,0,2:59
1105,381644,2014-06-20,2014,CHN,PIT,6,3,6-3,CHN,9,1,37,37,74,159,137,296,13,12,25,1,3:03
1106,381638,2014-06-20,2014,CLE,DET,4,6,6-4,DET,9,0,37,38,75,150,166,316,12,15,27,3,3:22
1107,381643,2014-06-20,2014,SLN,PHI,1,5,5-1,PHI,9,0,35,40,75,155,111,266,10,13,23,1,2:48 (:50 delay)
1108,381646,2014-06-20,2014,ARI,SFN,4,1,4-1,ARI,9,1,30,35,65,159,115,274,8,9,17,1,2:52
1109,381647,2014-06-20,2014,ANA,TEX,7,3,7-3,ANA,9,1,37,39,76,182,143,325,14,13,27,2,3:23
1110,381640,2014-06-20,2014,SDN,LAN,6,5,6-5,SDN,9,0,38,37,75,157,148,305,12,11,23,2,3:12
1111,381645,2014-06-20,2014,KCA,SEA,5,7,7-5,SEA,9,0,41,41,82,155,148,303,17,16,33,4,3:31
1112,381635,2014-06-20,2014,NYA,BAL,5,3,5-3,NYA,9,0,42,40,82,168,162,330,18,12,30,4,3:38
1113,381641,2014-06-20,2014,COL,MIL,10,13,13-10,MIL,9,0,44,49,93,188,167,355,17,22,39,2,3:59
1114,381636,2014-06-20,2014,OAK,BOS,4,3,4-3,OAK,9,1,38,38,76,158,151,309,13,13,26,3,3:21
1115,381634,2014-06-20,2014,WAS,ATL,4,6,6-4,ATL,13,0,53,53,106,208,210,418,16,15,31,0,4:34
1116,381648,2014-06-20,2014,CIN,TOR,9,14,14-9,TOR,9,0,40,50,90,207,151,358,12,25,37,4,4:00
1117,381637,2014-06-20,2014,MIN,CHA,5,4,5-4,MIN,9,0,38,39,77,164,145,309,12,15,27,4,3:16
1118,381642,2014-06-20,2014,MIA,NYN,3,2,3-2,MIA,9,1,33,36,69,151,130,281,11,13,24,3,3:19
1119,381658,2014-06-21,2014,SLN,PHI,4,1,4-1,SLN,9,1,34,35,69,124,131,255,11,8,19,1,2:48
1120,381660,2014-06-21,2014,KCA,SEA,1,2,2-1,SEA,9,0,29,35,64,120,124,244,5,10,15,1,2:42
1121,381650,2014-06-21,2014,NYA,BAL,1,6,6-1,BAL,9,0,36,41,77,155,139,294,10,13,23,2,2:57
1122,381659,2014-06-21,2014,CHN,PIT,3,5,5-3,PIT,9,0,33,36,69,153,111,264,6,10,16,2,2:54 (2:01 delay)
1123,381654,2014-06-21,2014,TBA,HOU,8,0,8-0,TBA,9,1,42,30,72,134,156,290,18,3,21,2,3:05
1124,381655,2014-06-21,2014,SDN,LAN,2,4,4-2,LAN,9,0,37,37,74,135,143,278,11,11,22,1,3:07
1125,381656,2014-06-21,2014,COL,MIL,4,9,9-4,MIL,9,0,37,41,78,131,126,257,10,15,25,2,2:58 (:23 delay)
1126,381652,2014-06-21,2014,MIN,CHA,4,3,4-3,MIN,9,1,35,41,76,169,128,297,12,13,25,2,3:07
1127,381653,2014-06-21,2014,CLE,DET,4,5,5-4,DET,10,0,42,41,83,151,162,313,12,14,26,3,3:41
1128,381661,2014-06-21,2014,ARI,SFN,4,6,6-4,SFN,9,0,39,43,82,146,152,298,13,16,29,1,3:15
1129,381649,2014-06-21,2014,WAS,ATL,3,0,3-0,WAS,9,1,33,34,67,131,115,246,9,7,16,0,2:44
1130,381663,2014-06-21,2014,CIN,TOR,11,1,11-1,CIN,9,1,39,33,72,122,147,269,15,6,21,0,2:35
1131,381657,2014-06-21,2014,MIA,NYN,0,4,4-0,NYN,9,0,35,35,70,121,125,246,10,10,20,0,2:38
1132,381662,2014-06-21,2014,ANA,TEX,3,2,3-2,ANA,10,0,32,37,69,140,128,268,6,8,14,2,3:00
1133,381651,2014-06-21,2014,OAK,BOS,2,1,2-1,OAK,10,0,37,39,76,146,146,292,9,11,20,2,3:04
1134,381676,2014-06-22,2014,ARI,SFN,1,4,4-1,SFN,9,0,31,35,66,120,123,243,5,10,15,4,2:39
1135,381675,2014-06-22,2014,KCA,SEA,1,2,2-1,SEA,9,0,36,35,71,122,121,243,10,9,19,3,2:54
1136,381667,2014-06-22,2014,MIN,CHA,6,5,6-5,MIN,9,1,36,35,71,131,137,268,15,9,24,2,2:55
1137,381674,2014-06-22,2014,CHN,PIT,1,2,2-1,PIT,9,0,34,35,69,142,119,261,8,9,17,1,2:50
1138,381672,2014-06-22,2014,MIA,NYN,5,11,11-5,NYN,9,0,37,46,83,169,133,302,11,20,31,2,3:09
1139,381669,2014-06-22,2014,TBA,HOU,5,2,5-2,TBA,9,1,35,37,72,165,111,276,16,11,27,1,2:51
1140,381671,2014-06-22,2014,COL,MIL,5,6,6-5,MIL,9,0,44,40,84,155,146,301,20,14,34,2,3:38
1141,381677,2014-06-22,2014,ANA,TEX,5,2,5-2,ANA,9,1,35,34,69,132,136,268,11,11,22,1,2:54
1142,381678,2014-06-22,2014,CIN,TOR,4,3,4-3,CIN,9,1,35,37,72,138,120,258,12,9,21,1,2:42
1143,381670,2014-06-22,2014,SDN,LAN,1,2,2-1,LAN,9,0,33,35,68,133,133,266,6,11,17,1,2:45
1144,381666,2014-06-22,2014,OAK,BOS,6,7,7-6,BOS,10,0,41,43,84,166,147,313,12,14,26,2,3:22
1145,381665,2014-06-22,2014,NYA,BAL,0,8,8-0,BAL,9,0,35,41,76,155,143,298,9,16,25,0,3:03
1146,381664,2014-06-22,2014,WAS,ATL,4,1,4-1,WAS,9,1,32,35,67,135,125,260,10,7,17,3,2:54
1147,381673,2014-06-22,2014,SLN,PHI,5,3,5-3,SLN,9,1,36,36,72,147,133,280,14,8,22,2,2:54
1148,381668,2014-06-22,2014,CLE,DET,4,10,10-4,DET,9,0,40,46,86,189,150,339,13,16,29,4,3:44
1149,381680,2014-06-23,2014,BAL,CHA,6,4,6-4,BAL,9,0,41,37,78,144,161,305,18,11,29,1,3:08
1150,381690,2014-06-23,2014,MIL,WAS,0,3,3-0,WAS,9,0,33,36,69,146,159,305,7,10,17,0,3:11
1151,381679,2014-06-23,2014,SEA,BOS,12,3,12-3,SEA,9,1,42,35,77,127,166,293,19,8,27,2,2:57
1152,381686,2014-06-23,2014,TOR,NYA,8,3,8-3,TOR,9,1,41,34,75,131,168,299,18,8,26,2,2:45
1153,381684,2014-06-23,2014,PHI,MIA,0,4,4-0,MIA,9,0,32,40,72,161,133,294,8,14,22,4,3:14
1154,381681,2014-06-23,2014,CHN,CIN,1,6,6-1,CIN,9,0,33,41,74,184,135,319,6,15,21,1,3:21
1155,381689,2014-06-23,2014,COL,SLN,0,8,8-0,SLN,9,0,30,39,69,140,122,262,3,13,16,1,2:41
1156,381688,2014-06-23,2014,SFN,SDN,0,6,6-0,SDN,9,0,30,35,65,125,109,234,4,9,13,2,2:34
1157,381683,2014-06-23,2014,KCA,LAN,5,3,5-3,KCA,9,1,34,34,68,112,133,245,11,8,19,2,2:46
1158,381687,2014-06-23,2014,TBA,PIT,1,8,8-1,PIT,9,0,32,42,74,174,127,301,8,16,24,1,3:22
1159,381697,2014-06-24,2014,KCA,LAN,0,2,2-0,LAN,9,0,33,36,69,157,120,277,7,11,18,1,3:02
1160,381703,2014-06-24,2014,SFN,SDN,2,7,7-2,SDN,9,0,33,40,73,119,137,256,6,15,21,2,2:56
1161,381698,2014-06-24,2014,PHI,MIA,7,4,7-4,PHI,9,1,36,40,76,175,150,325,11,14,25,2,3:15
1162,381700,2014-06-24,2014,TOR,NYA,7,6,7-6,TOR,9,0,38,40,78,141,158,299,14,12,26,2,3:05
1163,381691,2014-06-24,2014,HOU,ATL,2,3,3-2,ATL,9,0,39,34,73,141,161,302,12,7,19,1,3:06
1164,381692,2014-06-24,2014,SEA,BOS,8,2,8-2,SEA,9,1,37,41,78,161,129,290,12,14,26,4,3:14
1165,381693,2014-06-24,2014,BAL,CHA,2,4,4-2,CHA,9,0,36,39,75,126,149,275,13,15,28,1,3:09
1166,381696,2014-06-24,2014,TEX,DET,2,8,8-2,DET,9,0,38,42,80,165,162,327,11,19,30,4,3:32
1167,381699,2014-06-24,2014,ANA,MIN,8,6,8-6,ANA,9,1,37,39,76,157,136,293,14,13,27,1,2:59
1168,381701,2014-06-24,2014,NYN,OAK,10,1,10-1,NYN,9,1,37,32,69,123,125,248,14,5,19,0,2:24
1169,381695,2014-06-24,2014,ARI,CLE,9,8,9-8,ARI,14,0,68,62,130,235,278,513,32,21,53,6,5:32
1170,381702,2014-06-24,2014,TBA,PIT,5,6,6-5,PIT,9,0,40,36,76,121,145,266,15,10,25,2,3:03
1171,381704,2014-06-24,2014,COL,SLN,10,5,10-5,COL,9,1,47,39,86,133,179,312,25,13,38,4,3:55
1172,381705,2014-06-24,2014,MIL,WAS,2,4,4-2,WAS,16,0,61,61,122,254,231,485,19,13,32,0,5:22
1173,381694,2014-06-24,2014,CHN,CIN,7,3,7-3,CHN,9,1,34,33,67,124,138,262,11,6,17,4,3:00 (:53 delay)
1174,381717,2014-06-25,2014,TBA,PIT,5,1,5-1,TBA,9,1,35,32,67,133,139,272,10,6,16,2,2:51
1175,381713,2014-06-25,2014,PHI,MIA,2,3,3-2,MIA,9,0,37,35,72,139,127,266,11,9,20,1,2:53
1176,381714,2014-06-25,2014,ANA,MIN,6,2,6-2,ANA,9,1,36,37,73,138,146,284,12,10,22,1,2:55
1177,381712,2014-06-25,2014,KCA,LAN,4,5,5-4,LAN,9,0,37,39,76,141,162,303,12,14,26,2,3:23
1178,381711,2014-06-25,2014,TEX,DET,6,8,8-6,DET,9,0,42,41,83,150,172,322,13,17,30,4,3:38
1179,381718,2014-06-25,2014,SFN,SDN,4,0,4-0,SFN,9,1,38,28,66,113,161,274,15,1,16,3,2:37
1180,381706,2014-06-25,2014,HOU,ATL,0,4,4-0,ATL,9,0,31,34,65,130,109,239,4,9,13,1,2:33
1181,381716,2014-06-25,2014,NYN,OAK,5,8,8-5,OAK,9,0,37,40,77,133,138,271,12,15,27,1,2:55
1182,381720,2014-06-25,2014,MIL,WAS,9,2,9-2,MIL,9,1,40,33,73,146,142,288,18,6,24,2,3:01
1183,381715,2014-06-25,2014,TOR,NYA,3,5,5-3,NYA,9,0,37,40,77,143,138,281,12,15,27,4,3:02
1184,381719,2014-06-25,2014,COL,SLN,6,9,9-6,SLN,9,0,40,43,83,184,155,339,13,16,29,1,3:38
1185,381710,2014-06-25,2014,ARI,CLE,1,6,6-1,CLE,9,0,32,41,73,138,158,296,8,14,22,1,3:00
1186,381709,2014-06-25,2014,CHN,CIN,1,4,4-1,CIN,9,0,33,37,70,148,137,285,6,13,19,1,3:10
1187,381708,2014-06-25,2014,BAL,CHA,5,4,5-4,BAL,12,0,46,50,96,185,163,348,16,17,33,6,4:03 (1:09 delay)
1188,381707,2014-06-25,2014,SEA,BOS,4,5,5-4,BOS,9,0,34,37,71,139,106,245,9,12,21,2,2:40
1189,381728,2014-06-26,2014,LAN,SLN,1,0,1-0,LAN,9,1,29,31,60,130,100,230,6,7,13,0,2:32
1190,381729,2014-06-26,2014,CHN,WAS,5,3,5-3,CHN,9,1,32,35,67,125,140,265,10,13,23,1,2:41
1191,381725,2014-06-26,2014,TEX,DET,0,6,6-0,DET,9,0,30,44,74,153,115,268,6,19,25,1,2:58
1192,381722,2014-06-26,2014,TOR,CHA,7,0,7-0,TOR,9,1,39,33,72,137,156,293,14,6,20,2,3:00
1193,381685,2014-06-26,2014,ANA,MIN,6,4,6-4,ANA,9,1,36,40,76,165,137,302,15,14,29,3,3:17
1194,381724,2014-06-26,2014,MIL,COL,7,4,7-4,MIL,9,1,39,39,78,154,160,314,16,14,30,2,3:50
1195,381726,2014-06-26,2014,PHI,MIA,5,3,5-3,PHI,14,0,57,53,110,207,227,434,18,15,33,1,4:41
1196,381721,2014-06-26,2014,HOU,ATL,6,1,6-1,HOU,9,1,35,33,68,131,130,261,11,9,20,2,2:52
1197,381723,2014-06-26,2014,SFN,CIN,1,3,3-1,CIN,9,0,33,36,69,141,119,260,6,10,16,0,2:46
1198,381727,2014-06-26,2014,PIT,NYN,5,2,5-2,PIT,9,1,35,36,71,129,124,253,15,12,27,1,2:53
1199,381730,2014-06-27,2014,KCA,ANA,8,6,8-6,KCA,9,1,40,37,77,142,133,275,16,10,26,2,3:02
1200,381734,2014-06-27,2014,TOR,CHA,4,5,5-4,CHA,9,0,38,37,75,147,175,322,10,11,21,3,2:58 (:04 delay)
1201,381732,2014-06-27,2014,PHI,ATL,2,4,4-2,ATL,9,0,35,39,74,140,150,290,9,12,21,0,3:11
1202,381741,2014-06-27,2014,MIA,OAK,5,9,9-5,OAK,9,0,40,45,85,149,159,308,15,19,34,2,3:14
1203,381731,2014-06-27,2014,SDN,ARI,1,2,2-1,ARI,9,0,32,34,66,138,113,251,6,10,16,1,2:34
1204,381740,2014-06-27,2014,PIT,NYN,3,2,3-2,PIT,11,0,45,42,87,150,154,304,15,11,26,2,3:45
1205,380746,2014-06-27,2014,BAL,TBA,2,5,5-2,TBA,9,0,33,38,71,147,153,300,7,14,21,2,3:14
1206,380746,2014-06-27,2014,BAL,TBA,2,5,5-2,TBA,9,0,33,38,71,147,153,300,7,14,21,2,3:14
1207,381733,2014-06-27,2014,NYA,BOS,6,0,6-0,NYA,9,1,35,33,68,138,130,268,11,6,17,1,2:42
1208,381736,2014-06-27,2014,SEA,CLE,3,2,3-2,SEA,9,1,35,38,73,155,134,289,13,11,24,4,3:05
1209,381735,2014-06-27,2014,SFN,CIN,2,6,6-2,CIN,9,0,32,39,71,140,115,255,6,14,20,1,2:44
1210,381738,2014-06-27,2014,HOU,DET,4,3,4-3,HOU,11,0,41,41,82,150,176,326,12,11,23,2,4:05
1211,381743,2014-06-27,2014,BAL,TBA,4,1,4-1,BAL,9,1,38,32,70,118,152,270,15,6,21,0,3:05
1212,381742,2014-06-27,2014,LAN,SLN,1,3,3-1,SLN,9,0,34,36,70,128,144,272,12,10,22,3,2:48
1213,381744,2014-06-27,2014,CHN,WAS,7,2,7-2,CHN,9,1,39,33,72,132,145,277,17,8,25,2,2:49
1214,381737,2014-06-27,2014,MIL,COL,3,2,3-2,MIL,9,0,38,35,73,134,133,267,14,11,25,2,3:09
1215,381739,2014-06-27,2014,TEX,MIN,5,4,5-4,TEX,9,1,33,38,71,148,134,282,10,10,20,2,2:59
1216,381758,2014-06-28,2014,BAL,TBA,4,5,5-4,TBA,9,0,34,40,74,170,127,297,8,13,21,3,3:13
1217,381745,2014-06-28,2014,KCA,ANA,2,6,6-2,ANA,9,0,35,40,75,144,138,282,8,14,22,0,2:48 (4:05 delay)
1218,381751,2014-06-28,2014,SEA,CLE,0,5,5-0,CLE,9,0,28,34,62,137,111,248,1,9,10,0,2:24
1219,380734,2014-06-28,2014,PHI,ATL,1,5,5-1,ATL,9,0,36,40,76,146,143,289,8,15,23,1,3:09
1220,381748,2014-06-28,2014,NYA,BOS,1,2,2-1,BOS,9,0,34,33,67,116,129,245,8,8,16,0,2:47
1221,380734,2014-06-28,2014,PHI,ATL,1,5,5-1,ATL,9,0,36,40,76,146,143,289,8,15,23,1,3:09
1222,381754,2014-06-28,2014,TEX,MIN,5,0,5-0,TEX,9,1,34,32,66,122,102,224,13,5,18,1,2:27
1223,381752,2014-06-28,2014,MIL,COL,7,4,7-4,MIL,9,1,36,35,71,143,117,260,14,11,25,2,3:11
1224,381746,2014-06-28,2014,SDN,ARI,1,3,3-1,ARI,9,0,37,37,74,143,147,290,10,11,21,3,3:07
1225,381753,2014-06-28,2014,HOU,DET,3,4,4-3,DET,9,0,35,39,74,134,149,283,9,12,21,1,3:15
1226,381757,2014-06-28,2014,LAN,SLN,9,1,9-1,LAN,9,1,40,34,74,146,142,288,17,7,24,0,3:02
1227,381759,2014-06-28,2014,CHN,WAS,0,3,3-0,WAS,9,0,31,36,67,135,137,272,5,12,17,2,2:42
1228,381755,2014-06-28,2014,PIT,NYN,3,5,5-3,NYN,9,0,37,40,77,176,118,294,10,14,24,0,3:08
1229,381774,2014-06-28,2014,CHN,WAS,2,7,7-2,WAS,9,0,34,41,75,139,130,269,7,14,21,0,2:45 (:55 delay)
1230,381749,2014-06-28,2014,TOR,CHA,3,4,4-3,CHA,9,0,39,36,75,143,149,292,13,11,24,4,2:58
1231,381747,2014-06-28,2014,PHI,ATL,3,10,10-3,ATL,9,0,37,43,80,163,122,285,10,15,25,2,3:08
1232,381750,2014-06-28,2014,SFN,CIN,3,7,7-3,CIN,11,0,43,47,90,183,153,336,12,19,31,2,3:59
1233,381756,2014-06-28,2014,MIA,OAK,6,7,7-6,OAK,14,0,62,61,123,223,209,432,22,24,46,2,4:47
1234,381769,2014-06-29,2014,TEX,MIN,2,3,3-2,MIN,9,0,32,34,66,135,105,240,8,8,16,2,2:39
1235,381765,2014-06-29,2014,SFN,CIN,0,4,4-0,CIN,9,0,30,36,66,129,107,236,4,9,13,2,2:38
1236,381767,2014-06-29,2014,MIL,COL,4,10,10-4,COL,9,0,34,45,79,157,150,307,8,17,25,1,3:33
1237,381771,2014-06-29,2014,MIA,OAK,3,4,4-3,OAK,9,0,34,33,67,116,127,243,8,8,16,2,2:48
1238,381761,2014-06-29,2014,SDN,ARI,2,1,2-1,SDN,9,1,32,33,65,133,120,253,9,9,18,2,2:45
1239,381764,2014-06-29,2014,TOR,CHA,0,4,4-0,CHA,9,0,32,36,68,130,141,271,6,11,17,0,2:32
1240,381772,2014-06-29,2014,LAN,SLN,6,0,6-0,LAN,9,1,37,36,73,138,121,259,14,8,22,0,2:46
1241,381762,2014-06-29,2014,PHI,ATL,2,3,3-2,ATL,9,0,39,38,77,160,129,289,15,12,27,0,3:06
1242,381768,2014-06-29,2014,HOU,DET,6,4,6-4,HOU,9,1,40,37,77,154,153,307,21,12,33,3,3:25
1243,381760,2014-06-29,2014,KCA,ANA,5,4,5-4,KCA,9,0,42,37,79,142,162,304,19,12,31,2,3:31
1244,381763,2014-06-29,2014,NYA,BOS,5,8,8-5,BOS,9,0,37,42,79,197,157,354,11,20,31,3,3:38
1245,381766,2014-06-29,2014,SEA,CLE,3,0,3-0,SEA,9,1,33,30,63,117,108,225,10,4,14,1,2:17
1246,381773,2014-06-29,2014,BAL,TBA,7,12,12-7,TBA,9,0,41,48,89,162,172,334,15,24,39,4,3:51
1247,381770,2014-06-29,2014,PIT,NYN,5,2,5-2,PIT,9,1,33,40,73,159,114,273,9,15,24,1,2:58
1248,381777,2014-06-30,2014,SDN,CIN,1,0,1-0,SDN,9,1,27,32,59,147,107,254,3,8,11,0,2:42
1249,381782,2014-06-30,2014,DET,OAK,5,4,5-4,DET,9,0,37,39,76,146,149,295,13,12,25,3,3:23
1250,381779,2014-06-30,2014,WAS,COL,7,3,7-3,WAS,9,1,36,36,72,121,136,257,14,11,25,1,2:58
1251,381776,2014-06-30,2014,BOS,CHN,0,2,2-0,CHN,9,0,29,35,64,155,138,293,3,9,12,1,2:59
1252,381783,2014-06-30,2014,HOU,SEA,4,10,10-4,SEA,9,0,36,43,79,168,130,298,11,17,28,0,3:07
1253,381780,2014-06-30,2014,MIN,KCA,1,6,6-1,KCA,9,0,39,39,78,153,161,314,12,13,25,4,3:13
1254,381781,2014-06-30,2014,ATL,NYN,5,3,5-3,ATL,9,1,40,35,75,146,158,304,15,9,24,3,3:25
1255,381785,2014-06-30,2014,BAL,TEX,7,1,7-1,BAL,9,1,39,33,72,131,164,295,14,6,20,0,2:53
1256,381784,2014-06-30,2014,NYA,TBA,3,4,4-3,TBA,12,0,47,53,100,212,179,391,12,19,31,2,4:35
1257,381778,2014-06-30,2014,LAN,CLE,1,0,1-0,LAN,9,1,31,29,60,130,124,254,8,2,10,1,2:34
1258,381787,2014-07-01,2014,PIT,ARI,3,2,3-2,PIT,9,0,31,38,69,128,122,250,8,12,20,1,2:33
1259,381793,2014-07-01,2014,TOR,MIL,4,1,4-1,TOR,9,1,32,35,67,138,129,267,10,9,19,2,2:56
1260,381798,2014-07-01,2014,SFN,SLN,5,0,5-0,SFN,9,1,35,35,70,124,123,247,15,8,23,1,2:28
1261,381795,2014-07-01,2014,DET,OAK,3,0,3-0,DET,9,1,31,31,62,95,116,211,9,4,13,1,2:13
1262,381791,2014-07-01,2014,WAS,COL,7,1,7-1,WAS,9,1,42,34,76,134,172,306,17,8,25,3,3:19
1263,381786,2014-07-01,2014,CHA,ANA,4,8,8-4,ANA,9,0,34,42,76,174,133,307,8,15,23,2,2:54
1264,381797,2014-07-01,2014,HOU,SEA,2,13,13-2,SEA,9,0,41,51,92,188,144,332,13,24,37,1,3:36
1265,381775,2014-07-01,2014,CHA,ANA,5,7,7-5,ANA,9,0,38,41,79,137,138,275,12,21,33,3,3:08
1266,381775,2014-07-01,2014,CHA,ANA,5,7,7-5,ANA,9,0,38,41,79,137,138,275,12,21,33,3,3:08
1267,381790,2014-07-01,2014,LAN,CLE,3,10,10-3,CLE,9,0,40,41,81,147,171,318,16,15,31,3,3:21
1268,381794,2014-07-01,2014,ATL,NYN,5,4,5-4,ATL,9,1,35,38,73,178,130,308,11,11,22,1,3:17
1269,381792,2014-07-01,2014,MIN,KCA,10,2,10-2,MIN,9,1,46,36,82,141,193,334,20,11,31,1,3:23
1270,381796,2014-07-01,2014,MIA,PHI,5,4,5-4,MIA,11,0,47,43,90,138,190,328,17,10,27,1,3:37
1271,381799,2014-07-01,2014,NYA,TBA,1,2,2-1,TBA,9,0,36,37,73,124,150,274,9,10,19,0,3:13
1272,381800,2014-07-01,2014,BAL,TEX,8,3,8-3,BAL,9,1,37,35,72,125,150,275,11,11,22,1,2:58
1273,381789,2014-07-01,2014,SDN,CIN,8,2,8-2,SDN,9,1,40,39,79,142,123,265,18,13,31,2,2:49
1274,381788,2014-07-01,2014,BOS,CHN,1,2,2-1,CHN,9,0,38,34,72,147,152,299,14,9,23,2,3:35
1275,381811,2014-07-02,2014,MIA,PHI,5,0,5-0,MIA,9,1,37,34,71,134,163,297,14,7,21,1,3:11
1276,381804,2014-07-02,2014,SDN,CIN,3,0,3-0,SDN,9,1,33,30,63,120,122,242,10,3,13,0,2:20
1277,381807,2014-07-02,2014,MIN,KCA,0,4,4-0,KCA,9,0,33,41,74,163,145,308,7,14,21,0,3:00
1278,381801,2014-07-02,2014,CHA,ANA,3,2,3-2,CHA,9,0,35,35,70,141,113,254,11,9,20,2,2:49
1279,381806,2014-07-02,2014,WAS,COL,4,3,4-3,WAS,9,1,30,36,66,122,119,241,8,10,18,1,2:42 (:30 delay)
1280,381813,2014-07-02,2014,SFN,SLN,0,2,2-0,SLN,9,0,32,34,66,123,130,253,7,9,16,2,2:51
1281,381808,2014-07-02,2014,TOR,MIL,7,4,7-4,TOR,9,0,41,34,75,121,156,277,19,7,26,2,3:01
1282,381814,2014-07-02,2014,NYA,TBA,3,6,6-3,TBA,9,0,39,42,81,166,155,321,12,19,31,4,3:32
1283,381805,2014-07-02,2014,LAN,CLE,4,5,5-4,CLE,9,0,40,40,80,152,172,324,13,13,26,3,3:30
1284,381812,2014-07-02,2014,HOU,SEA,2,5,5-2,SEA,9,0,31,39,70,151,129,280,4,13,17,2,2:47
1285,381815,2014-07-02,2014,BAL,TEX,6,4,6-4,BAL,9,1,36,39,75,143,139,282,14,13,27,2,3:14 (1:38 delay)
1286,381809,2014-07-02,2014,ATL,NYN,3,1,3-1,ATL,9,1,35,34,69,138,153,291,11,8,19,1,3:11
1287,381810,2014-07-02,2014,DET,OAK,9,3,9-3,DET,9,1,39,38,77,134,152,286,18,12,30,2,3:02
1288,381802,2014-07-02,2014,PIT,ARI,5,1,5-1,PIT,9,1,40,38,78,139,158,297,18,12,30,1,3:14
1289,381803,2014-07-02,2014,BOS,CHN,9,16,16-9,CHN,9,0,50,48,98,192,197,389,22,22,44,5,4:19
1290,381818,2014-07-03,2014,COL,LAN,2,3,3-2,LAN,9,0,36,36,72,139,115,254,12,9,21,0,3:02
1291,381819,2014-07-03,2014,MIN,NYA,4,7,7-4,NYA,9,0,34,36,70,127,124,251,10,11,21,1,2:36
1292,381824,2014-07-03,2014,OAK,TOR,4,1,4-1,OAK,9,1,32,32,64,123,126,249,9,8,17,0,2:23
1293,381822,2014-07-03,2014,DET,TBA,8,1,8-1,DET,9,1,39,30,69,119,145,264,17,3,20,1,2:41
1294,381821,2014-07-03,2014,SFN,SLN,2,7,7-2,SLN,9,0,36,44,80,175,139,314,9,19,28,0,3:12
1295,381820,2014-07-03,2014,MIA,PHI,4,5,5-4,PHI,9,0,37,40,77,175,124,299,11,12,23,1,3:12
1296,381823,2014-07-03,2014,BAL,TEX,5,2,5-2,BAL,9,1,38,36,74,130,144,274,17,10,27,3,3:12 (:56 delay)
1297,381816,2014-07-03,2014,PIT,ARI,2,10,10-2,ARI,9,0,37,42,79,153,152,305,14,16,30,2,3:16
1298,381817,2014-07-03,2014,ANA,HOU,5,2,5-2,ANA,9,1,33,37,70,145,124,269,12,12,24,1,3:00
1299,381837,2014-07-04,2014,DET,TBA,3,6,6-3,TBA,9,0,35,41,76,157,138,295,10,14,24,2,3:18
1300,381836,2014-07-04,2014,SDN,SFN,2,0,2-0,SDN,9,1,32,32,64,121,126,247,11,6,17,1,2:31
1301,381835,2014-07-04,2014,CHA,SEA,7,1,7-1,CHA,9,1,35,32,67,112,131,243,11,6,17,0,2:28
1302,381828,2014-07-04,2014,ANA,HOU,7,6,7-6,ANA,9,0,38,37,75,129,140,269,17,10,27,5,3:02
1303,381825,2014-07-04,2014,ATL,ARI,5,2,5-2,ATL,9,1,36,34,70,132,133,265,13,8,21,3,2:54
1304,381832,2014-07-04,2014,CIN,MIL,4,2,4-2,CIN,9,1,35,35,70,118,149,267,11,9,20,1,2:49
1305,381829,2014-07-04,2014,CLE,KCA,1,7,7-1,KCA,9,0,34,40,74,150,124,274,8,13,21,2,2:50
1306,381827,2014-07-04,2014,WAS,CHN,2,7,7-2,CHN,9,0,35,41,76,139,131,270,9,17,26,3,2:54
1307,381831,2014-07-04,2014,SLN,MIA,3,2,3-2,SLN,9,1,31,40,71,169,137,306,9,15,24,1,3:01
1308,381830,2014-07-04,2014,COL,LAN,0,9,9-0,LAN,9,0,30,49,79,196,107,303,4,23,27,1,3:13
1309,381834,2014-07-04,2014,PIT,PHI,8,2,8-2,PIT,9,1,41,33,74,137,158,295,19,7,26,2,3:13
1310,381833,2014-07-04,2014,MIN,NYA,5,6,6-5,NYA,9,0,39,39,78,146,170,316,13,12,25,2,3:17
1311,381838,2014-07-04,2014,NYN,TEX,6,5,6-5,NYN,9,1,37,44,81,177,164,341,14,18,32,3,4:08
1312,381839,2014-07-04,2014,OAK,TOR,1,0,1-0,OAK,12,0,45,46,91,171,197,368,13,12,25,1,4:05
1313,381849,2014-07-05,2014,PIT,PHI,3,2,3-2,PIT,9,1,32,35,67,129,108,237,9,9,18,1,2:40
1314,381847,2014-07-05,2014,CIN,MIL,0,1,1-0,MIL,9,0,30,35,65,132,111,243,4,11,15,0,2:47
1315,381841,2014-07-05,2014,BOS,BAL,4,7,7-4,BAL,9,0,37,45,82,175,150,325,12,18,30,5,3:36
1316,381842,2014-07-05,2014,WAS,CHN,13,0,13-0,WAS,9,1,46,31,77,116,187,303,22,6,28,3,3:10
1317,381844,2014-07-05,2014,CLE,KCA,7,3,7-3,CLE,9,1,40,38,78,131,146,277,17,14,31,2,2:48
1318,381854,2014-07-05,2014,OAK,TOR,5,1,5-1,OAK,9,1,37,33,70,136,136,272,13,7,20,1,2:37
1319,381845,2014-07-05,2014,COL,LAN,8,7,8-7,COL,9,1,35,41,76,166,137,303,13,16,29,3,3:25
1320,381840,2014-07-05,2014,ATL,ARI,10,4,10-4,ATL,9,1,44,35,79,123,174,297,19,12,31,1,3:00
1321,381853,2014-07-05,2014,NYN,TEX,3,5,5-3,TEX,9,0,38,38,76,135,151,286,11,13,24,2,3:10
1322,381843,2014-07-05,2014,ANA,HOU,11,5,11-5,ANA,9,1,43,39,82,150,190,340,19,13,32,2,3:36
1323,381851,2014-07-05,2014,SDN,SFN,3,5,5-3,SFN,10,0,38,42,80,179,160,339,10,13,23,2,3:44
1324,381848,2014-07-05,2014,MIN,NYA,2,1,2-1,MIN,11,0,43,42,85,180,170,350,13,9,22,0,3:41
1325,381850,2014-07-05,2014,CHA,SEA,2,3,3-2,SEA,14,0,50,56,106,230,190,420,7,16,23,3,4:38
1326,381826,2014-07-05,2014,BOS,BAL,3,2,3-2,BOS,9,0,36,33,69,130,119,249,12,5,17,0,2:40
1327,381826,2014-07-05,2014,BOS,BAL,3,2,3-2,BOS,9,0,36,33,69,130,119,249,12,5,17,0,2:40
1328,381852,2014-07-05,2014,DET,TBA,2,7,7-2,TBA,9,0,36,41,77,152,116,268,10,17,27,3,3:05
1329,381846,2014-07-05,2014,SLN,MIA,5,6,6-5,MIA,9,0,41,42,83,174,149,323,15,15,30,4,3:31
1330,381859,2014-07-06,2014,CLE,KCA,4,1,4-1,CLE,9,1,34,32,66,113,125,238,11,5,16,1,2:32
1331,381869,2014-07-06,2014,OAK,TOR,4,2,4-2,OAK,9,1,38,32,70,130,142,272,14,6,20,1,2:46
1332,381866,2014-07-06,2014,SDN,SFN,3,5,5-3,SFN,9,0,35,36,71,125,144,269,9,9,18,3,2:58
1333,381855,2014-07-06,2014,ATL,ARI,1,3,3-1,ARI,9,0,36,34,70,135,133,268,10,9,19,2,2:43
1334,381862,2014-07-06,2014,CIN,MIL,4,2,4-2,CIN,9,1,33,31,64,105,116,221,11,5,16,0,2:38
1335,381858,2014-07-06,2014,ANA,HOU,6,1,6-1,ANA,9,1,34,34,68,132,145,277,13,8,21,3,3:07
1336,381864,2014-07-06,2014,PIT,PHI,6,2,6-2,PIT,9,1,37,31,68,112,137,249,13,5,18,1,2:43
1337,381860,2014-07-06,2014,COL,LAN,2,8,8-2,LAN,9,0,38,44,82,166,164,330,12,19,31,3,3:44
1338,381863,2014-07-06,2014,MIN,NYA,7,9,9-7,NYA,9,0,42,41,83,138,166,304,17,16,33,1,3:11
1339,381857,2014-07-06,2014,WAS,CHN,2,1,2-1,WAS,9,1,32,40,72,162,122,284,12,13,25,1,3:12
1340,381867,2014-07-06,2014,DET,TBA,3,7,7-3,TBA,9,0,36,45,81,161,112,273,10,20,30,3,3:12
1341,381868,2014-07-06,2014,NYN,TEX,8,4,8-4,NYN,9,1,36,39,75,159,134,293,13,12,25,4,3:21
1342,381861,2014-07-06,2014,SLN,MIA,4,8,8-4,MIA,9,0,39,49,88,191,145,336,13,24,37,3,3:13
1343,381856,2014-07-06,2014,BOS,BAL,6,7,7-6,BAL,12,0,50,54,104,213,234,447,18,20,38,6,5:05
1344,381865,2014-07-06,2014,CHA,SEA,1,0,1-0,CHA,9,1,34,36,70,118,136,254,11,8,19,1,2:50
1345,381876,2014-07-07,2014,ARI,MIA,9,1,9-1,ARI,9,1,39,38,77,145,138,283,14,12,26,2,2:56
1346,381882,2014-07-07,2014,OAK,SFN,5,0,5-0,OAK,9,1,38,34,72,142,138,280,13,8,21,3,3:10
1347,381877,2014-07-07,2014,SEA,MIN,2,0,2-0,SEA,9,1,32,32,64,131,112,243,8,4,12,0,2:34
1348,381872,2014-07-07,2014,BOS,CHA,0,4,4-0,CHA,9,0,32,32,64,136,138,274,5,7,12,1,2:55 (:39 delay)
1349,381880,2014-07-07,2014,SLN,PIT,2,0,2-0,SLN,9,0,30,39,69,151,98,249,7,13,20,0,2:37 (:58 delay)
1350,381875,2014-07-07,2014,TBA,KCA,0,6,6-0,KCA,9,0,32,43,75,152,129,281,6,16,22,0,2:51
1351,381878,2014-07-07,2014,CLE,NYA,3,5,5-3,NYA,9,0,33,41,74,150,116,266,7,17,24,2,3:00
1352,381881,2014-07-07,2014,COL,SDN,1,6,6-1,SDN,9,0,33,40,73,146,129,275,9,16,25,1,2:47 (:56 delay)
1353,381883,2014-07-07,2014,ANA,TOR,5,2,5-2,ANA,9,1,39,33,72,138,164,302,14,6,20,4,3:16
1354,381873,2014-07-07,2014,CIN,CHN,9,3,9-3,CIN,9,1,39,39,78,145,150,295,15,12,27,0,3:19 (:21 delay)
1355,381874,2014-07-07,2014,TEX,HOU,7,12,12-7,HOU,9,0,41,45,86,173,163,336,14,19,33,4,3:48
1356,381871,2014-07-07,2014,WAS,BAL,2,8,8-2,BAL,11,0,43,48,91,179,163,342,11,15,26,1,3:39
1357,381870,2014-07-07,2014,NYN,ATL,4,3,4-3,NYN,11,0,44,47,91,161,171,332,14,17,31,4,3:50
1358,381879,2014-07-07,2014,MIL,PHI,2,3,3-2,PHI,9,0,35,38,73,167,135,302,10,11,21,1,3:25
1359,381892,2014-07-08,2014,SEA,MIN,0,2,2-0,MIN,9,0,33,35,68,132,103,235,8,11,19,2,2:34
1360,381891,2014-07-08,2014,ARI,MIA,1,2,2-1,MIA,9,0,39,33,72,121,122,243,11,7,18,2,2:33
1361,381898,2014-07-08,2014,ANA,TOR,0,4,4-0,TOR,9,0,32,38,70,132,120,252,6,15,21,1,2:45
1362,381897,2014-07-08,2014,OAK,SFN,6,1,6-1,OAK,9,1,36,37,73,124,110,234,14,10,24,1,2:47
1363,381896,2014-07-08,2014,COL,SDN,2,1,2-1,COL,9,1,32,37,69,151,134,285,8,11,19,2,3:11
1364,381895,2014-07-08,2014,SLN,PIT,5,4,5-4,SLN,9,0,35,38,73,136,125,261,12,12,24,1,2:44
1365,381894,2014-07-08,2014,MIL,PHI,7,9,9-7,PHI,9,0,42,40,82,159,143,302,15,13,28,3,3:24
1366,381884,2014-07-08,2014,NYN,ATL,8,3,8-3,NYN,9,1,42,40,82,166,143,309,20,14,34,3,3:20
1367,380919,2014-07-08,2014,CIN,CHN,4,2,4-2,CIN,9,1,35,38,73,143,144,287,13,11,24,3,2:51
1368,381893,2014-07-08,2014,CLE,NYA,5,3,5-3,CLE,9,1,35,34,69,143,122,265,11,6,17,1,2:55
1369,380919,2014-07-08,2014,CIN,CHN,4,2,4-2,CIN,9,1,35,38,73,143,144,287,13,11,24,3,2:51
1370,381889,2014-07-08,2014,TBA,KCA,4,3,4-3,TBA,9,1,36,41,77,165,144,309,11,15,26,3,3:31
1371,381886,2014-07-08,2014,BOS,CHA,3,8,8-3,CHA,9,0,39,41,80,156,144,300,14,17,31,2,3:11
1372,381890,2014-07-08,2014,DET,LAN,14,5,14-5,DET,9,1,46,36,82,142,174,316,25,10,35,3,3:29
1373,381887,2014-07-08,2014,CIN,CHN,6,5,6-5,CIN,9,0,37,44,81,168,155,323,16,17,33,2,3:33 (:35 delay)
1374,381888,2014-07-08,2014,TEX,HOU,3,8,8-3,HOU,9,0,38,43,81,147,169,316,12,17,29,7,3:33
1375,381904,2014-07-09,2014,DET,LAN,4,1,4-1,DET,9,1,33,32,65,131,132,263,10,6,16,0,2:48
1376,381899,2014-07-09,2014,NYN,ATL,4,1,4-1,NYN,9,1,29,34,63,116,101,217,8,9,17,1,2:23
1377,381902,2014-07-09,2014,TEX,HOU,4,8,8-4,HOU,9,0,39,39,78,152,141,293,12,14,26,1,3:05
1378,381911,2014-07-09,2014,COL,SDN,6,3,6-3,COL,9,1,32,40,72,168,108,276,8,14,22,1,3:09
1379,381909,2014-07-09,2014,MIL,PHI,1,4,4-1,PHI,9,0,32,34,66,120,93,213,5,7,12,0,2:15
1380,381912,2014-07-09,2014,ANA,TOR,8,7,8-7,ANA,9,1,37,46,83,187,145,332,14,19,33,7,3:47
1381,381900,2014-07-09,2014,BOS,CHA,5,4,5-4,BOS,9,0,37,35,72,133,138,271,12,10,22,2,2:54
1382,381903,2014-07-09,2014,TBA,KCA,4,5,5-4,KCA,9,0,42,43,85,150,176,326,16,15,31,4,3:35
1383,381901,2014-07-09,2014,CIN,CHN,4,1,4-1,CIN,9,1,33,34,67,162,125,287,11,7,18,1,2:52
1384,381908,2014-07-09,2014,SFN,OAK,5,2,5-2,SFN,9,1,37,34,71,143,157,300,13,7,20,0,3:02
1385,381910,2014-07-09,2014,SLN,PIT,5,2,5-2,SLN,9,1,41,35,76,142,153,295,19,9,28,2,3:24
1386,381905,2014-07-09,2014,ARI,MIA,4,3,4-3,ARI,10,0,39,39,78,147,137,284,13,12,25,1,2:53
1387,381906,2014-07-09,2014,SEA,MIN,1,8,8-1,MIN,9,0,40,42,82,175,151,326,13,16,29,2,3:11
1388,381907,2014-07-09,2014,CLE,NYA,4,5,5-4,NYA,14,0,57,56,113,207,219,426,16,15,31,5,4:51
1389,381913,2014-07-09,2014,BAL,WAS,2,6,6-2,WAS,9,0,35,37,72,143,137,280,10,10,20,2,2:50
1390,381924,2014-07-10,2014,LAN,SDN,2,1,2-1,LAN,9,1,33,31,64,115,128,243,9,4,13,0,2:31
1391,381919,2014-07-10,2014,SEA,MIN,2,4,4-2,MIN,9,0,39,39,78,139,155,294,14,15,29,3,3:11
1392,381923,2014-07-10,2014,SLN,PIT,1,9,9-1,PIT,9,0,32,43,75,169,114,283,9,15,24,0,3:05
1393,381921,2014-07-10,2014,SFN,OAK,1,6,6-1,OAK,9,0,35,39,74,130,127,257,7,15,22,2,3:01
1394,381925,2014-07-10,2014,BAL,WAS,4,3,4-3,BAL,9,1,32,39,71,133,125,258,9,14,23,2,2:45
1395,381918,2014-07-10,2014,KCA,DET,4,16,16-4,DET,9,0,37,52,89,193,144,337,10,26,36,3,3:17
1396,381916,2014-07-10,2014,BOS,CHA,4,3,4-3,BOS,10,0,35,41,76,152,154,306,8,12,20,2,3:22
1397,381914,2014-07-10,2014,TEX,ANA,6,15,15-6,ANA,9,0,38,45,83,167,138,305,11,18,29,1,3:10
1398,381917,2014-07-10,2014,CIN,CHN,4,6,6-4,CHN,12,0,51,50,101,184,188,372,16,18,34,0,4:10
1399,381915,2014-07-10,2014,NYN,ATL,1,3,3-1,ATL,9,0,37,36,73,114,143,257,10,11,21,1,2:50
1400,381922,2014-07-10,2014,MIL,PHI,1,9,9-1,PHI,9,0,32,41,73,163,127,290,6,15,21,2,3:06
1401,381920,2014-07-10,2014,CLE,NYA,9,3,9-3,CLE,9,1,42,41,83,147,160,307,19,15,34,5,3:30
1402,381927,2014-07-11,2014,SFN,ARI,5,0,5-0,SFN,9,1,37,32,69,134,131,265,13,7,20,1,2:35
1403,381932,2014-07-11,2014,NYN,MIA,7,1,7-1,NYN,9,1,35,34,69,133,125,258,12,8,20,2,2:43
1404,381926,2014-07-11,2014,TEX,ANA,0,3,3-0,ANA,9,0,35,32,67,119,132,251,9,8,17,1,2:41
1405,381933,2014-07-11,2014,COL,MIN,6,2,6-2,COL,9,1,33,37,70,170,100,270,11,13,24,1,2:59
1406,381935,2014-07-11,2014,SEA,OAK,3,2,3-2,SEA,9,1,28,35,63,127,98,225,6,9,15,0,2:22
1407,381928,2014-07-11,2014,CHN,ATL,5,4,5-4,CHN,9,0,38,36,74,116,142,258,12,10,22,2,3:01
1408,381931,2014-07-11,2014,KCA,DET,1,2,2-1,DET,9,0,37,34,71,130,127,257,12,7,19,1,2:58
1409,381940,2014-07-11,2014,PHI,WAS,6,2,6-2,PHI,9,1,34,36,70,126,116,242,11,10,21,3,2:44
1410,381930,2014-07-11,2014,CLE,CHA,7,4,7-4,CLE,9,1,38,37,75,145,134,279,16,11,27,3,3:16
1411,381936,2014-07-11,2014,CIN,PIT,6,5,6-5,CIN,9,1,37,37,74,157,126,283,14,10,24,2,3:11
1412,381929,2014-07-11,2014,HOU,BOS,3,8,8-3,BOS,9,0,40,41,81,167,171,338,13,18,31,1,3:27
1413,381937,2014-07-11,2014,LAN,SDN,3,6,6-3,SDN,9,0,39,40,79,160,153,313,13,14,27,2,3:25
1414,381938,2014-07-11,2014,MIL,SLN,6,7,7-6,SLN,9,0,43,40,83,177,161,338,16,14,30,4,3:53
1415,381939,2014-07-11,2014,TBA,TOR,5,8,8-5,TOR,9,0,41,42,83,184,172,356,15,17,32,4,3:41
1416,381934,2014-07-11,2014,BAL,NYA,3,2,3-2,BAL,10,0,36,39,75,130,136,266,8,9,17,0,3:05
1417,381942,2014-07-12,2014,SFN,ARI,0,2,2-0,ARI,9,0,33,37,70,132,119,251,7,11,18,3,2:44
1418,381945,2014-07-12,2014,CLE,CHA,2,6,6-2,CHA,9,0,36,37,73,125,155,280,9,12,21,4,3:10
1419,381943,2014-07-12,2014,CHN,ATL,6,11,11-6,ATL,9,0,37,42,79,144,126,270,13,17,30,1,3:02
1420,381950,2014-07-12,2014,SEA,OAK,6,2,6-2,SEA,9,1,40,32,72,105,130,235,17,5,22,3,2:43
1421,381952,2014-07-12,2014,LAN,SDN,1,0,1-0,LAN,9,0,34,31,65,107,145,252,11,5,16,1,2:47
1422,381949,2014-07-12,2014,BAL,NYA,0,3,3-0,NYA,9,0,33,38,71,131,125,256,7,14,21,3,3:02
1423,381946,2014-07-12,2014,KCA,DET,1,5,5-1,DET,9,0,34,37,71,164,116,280,9,13,22,1,3:08
1424,381947,2014-07-12,2014,NYN,MIA,5,4,5-4,NYN,9,1,34,38,72,156,125,281,10,11,21,2,2:52
1425,381948,2014-07-12,2014,COL,MIN,3,9,9-3,MIN,9,0,40,45,85,154,136,290,16,17,33,2,3:17
1426,381953,2014-07-12,2014,MIL,SLN,2,10,10-2,SLN,9,0,34,45,79,187,121,308,7,17,24,1,3:17
1427,381954,2014-07-12,2014,TBA,TOR,10,3,10-3,TBA,9,1,43,38,81,144,176,320,20,11,31,3,3:19
1428,381955,2014-07-12,2014,PHI,WAS,3,5,5-3,WAS,10,0,42,42,84,175,182,357,13,11,24,2,4:03
1429,381951,2014-07-12,2014,CIN,PIT,5,6,6-5,PIT,11,0,46,49,95,178,176,354,17,17,34,3,4:06
1430,381941,2014-07-12,2014,TEX,ANA,2,5,5-2,ANA,9,0,36,41,77,148,128,276,8,16,24,1,3:17
1431,381944,2014-07-12,2014,HOU,BOS,3,2,3-2,HOU,9,1,34,38,72,148,124,272,11,15,26,4,3:06
1432,381964,2014-07-13,2014,BAL,NYA,3,1,3-1,BAL,5,0,20,18,38,78,79,157,8,4,12,1,1:39 (2:22 delay)
1433,381967,2014-07-13,2014,LAN,SDN,1,0,1-0,LAN,9,1,32,33,65,137,133,270,9,6,15,3,3:15
1434,381965,2014-07-13,2014,SEA,OAK,1,4,4-1,OAK,9,0,34,36,70,136,125,261,9,9,18,2,2:43
1435,381969,2014-07-13,2014,TBA,TOR,3,0,3-0,TBA,9,1,35,32,67,127,137,264,11,7,18,2,2:45
1436,381961,2014-07-13,2014,KCA,DET,5,2,5-2,KCA,9,1,37,34,71,137,135,272,15,9,24,4,3:02
1437,381957,2014-07-13,2014,SFN,ARI,8,4,8-4,SFN,9,1,40,35,75,132,153,285,15,10,25,3,3:01
1438,381968,2014-07-13,2014,MIL,SLN,11,2,11-2,MIL,9,1,45,34,79,119,131,250,24,6,30,1,2:55
1439,381960,2014-07-13,2014,CLE,CHA,3,2,3-2,CLE,9,1,37,41,78,161,133,294,13,16,29,1,3:00
1440,381959,2014-07-13,2014,HOU,BOS,0,11,11-0,BOS,9,0,30,49,79,199,109,308,3,25,28,4,3:23
1441,381962,2014-07-13,2014,NYN,MIA,9,1,9-1,NYN,9,1,45,32,77,141,174,315,22,8,30,2,3:19
1442,381956,2014-07-13,2014,TEX,ANA,7,10,10-7,ANA,9,0,36,46,82,161,149,310,11,20,31,2,3:38
1443,381963,2014-07-13,2014,COL,MIN,5,13,13-5,MIN,9,0,40,48,88,177,153,330,14,22,36,1,3:23
1444,381958,2014-07-13,2014,CHN,ATL,7,10,10-7,ATL,9,0,39,44,83,169,147,316,14,18,32,4,3:18
1445,381970,2014-07-13,2014,PHI,WAS,3,10,10-3,WAS,9,0,35,40,75,149,141,290,7,14,21,2,3:03
1446,381966,2014-07-13,2014,CIN,PIT,6,3,6-3,CIN,9,1,41,36,77,148,168,316,17,8,25,0,3:08 (:56 delay)
1447,381971,2014-07-15,2014,AAS,NAS,5,3,5-3,AAS,9,1,33,37,70,139,129,268,8,10,18,4,3:13
1448,381986,2014-07-18,2014,TOR,TEX,1,5,5-1,TEX,9,0,37,36,73,142,159,301,10,11,21,2,2:56
1449,381973,2014-07-18,2014,ARI,CHN,5,4,5-4,ARI,9,1,35,35,70,128,151,279,13,9,22,3,3:15
1450,381982,2014-07-18,2014,ATL,PHI,6,4,6-4,ATL,9,1,35,34,69,142,115,257,11,10,21,0,2:45
1451,381981,2014-07-18,2014,SDN,NYN,4,5,5-4,NYN,9,0,35,42,77,169,138,307,9,17,26,1,3:10
1452,381977,2014-07-18,2014,CHA,HOU,3,2,3-2,CHA,9,1,32,32,64,165,122,287,10,5,15,0,2:50
1453,381974,2014-07-18,2014,NYA,CIN,4,3,4-3,NYA,9,1,35,36,71,135,119,254,11,8,19,1,2:36
1454,381980,2014-07-18,2014,WAS,MIL,2,4,4-2,MIL,9,0,36,35,71,132,127,259,11,10,21,1,3:00
1455,381978,2014-07-18,2014,BOS,KCA,5,4,5-4,BOS,9,1,37,39,76,149,160,309,13,12,25,2,3:31
1456,381984,2014-07-18,2014,MIA,SFN,1,9,9-1,SFN,9,0,35,42,77,165,137,302,9,15,24,2,3:00
1457,381976,2014-07-18,2014,PIT,COL,4,2,4-2,PIT,9,1,37,40,77,164,158,322,13,13,26,2,3:46
1458,381975,2014-07-18,2014,DET,CLE,3,9,9-3,CLE,9,0,38,43,81,168,156,324,13,19,32,3,3:32
1459,381983,2014-07-18,2014,ANA,SEA,3,2,3-2,ANA,16,0,59,64,123,233,191,424,14,19,33,6,5:14
1460,381972,2014-07-18,2014,OAK,BAL,5,4,5-4,OAK,9,0,32,34,66,122,125,247,8,11,19,1,2:31
1461,381985,2014-07-18,2014,MIN,TBA,2,6,6-2,TBA,9,0,38,38,76,137,156,293,11,14,25,3,3:04
1462,381979,2014-07-18,2014,SLN,LAN,3,2,3-2,SLN,9,1,35,37,72,155,141,296,12,10,22,2,3:02
1463,381989,2014-07-19,2014,NYA,CIN,7,1,7-1,NYA,9,1,35,34,69,133,132,265,10,7,17,1,2:41
1464,382001,2014-07-19,2014,TOR,TEX,4,1,4-1,TOR,9,1,38,35,73,148,153,301,16,8,24,2,3:02
1465,381997,2014-07-19,2014,ATL,PHI,1,2,2-1,PHI,9,0,31,39,70,157,112,269,6,12,18,2,2:57
1466,381993,2014-07-19,2014,BOS,KCA,2,1,2-1,BOS,9,1,32,35,67,126,113,239,9,9,18,1,2:39
1467,381996,2014-07-19,2014,SDN,NYN,6,0,6-0,SDN,9,1,32,34,66,138,135,273,8,8,16,2,2:41
1468,381992,2014-07-19,2014,CHA,HOU,4,3,4-3,CHA,9,1,39,38,77,136,137,273,16,13,29,2,3:18
1469,381999,2014-07-19,2014,MIA,SFN,3,5,5-3,SFN,9,0,35,39,74,146,114,260,11,15,26,3,3:01
1470,382000,2014-07-19,2014,MIN,TBA,1,5,5-1,TBA,9,0,34,36,70,121,146,267,7,14,21,1,2:51
1471,381994,2014-07-19,2014,SLN,LAN,4,2,4-2,SLN,9,1,36,34,70,144,139,283,15,9,24,2,3:02
1472,381991,2014-07-19,2014,PIT,COL,3,2,3-2,PIT,11,0,44,37,81,124,177,301,14,10,24,2,3:31
1473,381990,2014-07-19,2014,DET,CLE,2,5,5-2,CLE,9,0,36,41,77,165,171,336,9,15,24,2,3:40
1474,381995,2014-07-19,2014,WAS,MIL,8,3,8-3,WAS,9,1,40,36,76,150,164,314,16,10,26,1,3:17
1475,381998,2014-07-19,2014,ANA,SEA,2,3,3-2,SEA,12,0,45,47,92,164,191,355,13,13,26,3,4:07
1476,380737,2014-07-19,2014,DET,CLE,2,6,6-2,CLE,9,0,34,39,73,155,121,276,8,17,25,3,3:02
1477,380737,2014-07-19,2014,DET,CLE,2,6,6-2,CLE,9,0,34,39,73,155,121,276,8,17,25,3,3:02
1478,381987,2014-07-19,2014,OAK,BAL,4,8,8-4,BAL,9,0,36,44,80,177,145,322,10,19,29,3,3:14
1479,381988,2014-07-19,2014,ARI,CHN,9,3,9-3,ARI,9,1,40,37,77,121,144,265,16,12,28,1,2:55
1480,382012,2014-07-20,2014,ATL,PHI,8,2,8-2,ATL,9,1,41,35,76,142,147,289,17,9,26,0,2:44 (1:39 delay)
1481,382014,2014-07-20,2014,MIA,SFN,3,2,3-2,MIA,9,1,32,33,65,121,123,244,8,7,15,1,2:41
1482,382015,2014-07-20,2014,MIN,TBA,3,5,5-3,TBA,9,0,38,44,82,177,156,333,11,18,29,2,3:40
1483,382005,2014-07-20,2014,DET,CLE,5,1,5-1,DET,9,1,35,33,68,133,134,267,12,8,20,3,2:54
1484,382008,2014-07-20,2014,BOS,KCA,6,0,6-0,BOS,9,1,40,33,73,125,153,278,16,7,23,2,2:56
1485,382010,2014-07-20,2014,WAS,MIL,5,4,5-4,WAS,9,0,39,39,78,175,155,330,15,12,27,1,3:35
1486,382006,2014-07-20,2014,PIT,COL,5,3,5-3,PIT,9,1,40,35,75,129,146,275,18,12,30,1,3:05
1487,382007,2014-07-20,2014,CHA,HOU,7,11,11-7,HOU,9,0,43,44,87,151,162,313,15,20,35,4,3:39
1488,382011,2014-07-20,2014,SDN,NYN,2,1,2-1,SDN,9,0,39,35,74,138,152,290,16,8,24,3,3:07
1489,382002,2014-07-20,2014,OAK,BAL,10,2,10-2,OAK,9,1,42,35,77,143,161,304,18,5,23,3,3:14
1490,382013,2014-07-20,2014,ANA,SEA,6,5,6-5,ANA,9,0,44,37,81,134,159,293,22,11,33,2,3:15
1491,382003,2014-07-20,2014,ARI,CHN,3,2,3-2,ARI,9,1,33,34,67,126,130,256,9,7,16,2,2:50
1492,382004,2014-07-20,2014,NYA,CIN,3,2,3-2,NYA,9,0,41,35,76,136,191,327,16,8,24,2,3:32
1493,382009,2014-07-20,2014,SLN,LAN,3,4,4-3,LAN,9,0,35,40,75,140,143,283,11,16,27,3,3:28
1494,382016,2014-07-20,2014,TOR,TEX,9,6,9-6,TOR,9,1,41,42,83,154,164,318,18,16,34,3,3:07
1495,382017,2014-07-21,2014,ANA,BAL,2,4,4-2,BAL,9,0,37,33,70,127,125,252,10,7,17,3,3:02
1496,382018,2014-07-21,2014,TOR,BOS,1,14,14-1,BOS,9,0,30,46,76,186,99,285,3,19,22,2,2:45
1497,382023,2014-07-21,2014,PIT,LAN,2,5,5-2,LAN,9,0,34,43,77,144,136,280,7,19,26,2,3:12
1498,382021,2014-07-21,2014,ARI,DET,3,4,4-3,DET,9,0,37,37,74,147,151,298,12,11,23,2,3:09
1499,382024,2014-07-21,2014,ATL,MIA,1,3,3-1,MIA,10,0,40,43,83,182,134,316,9,14,23,2,3:36
1500,382025,2014-07-21,2014,SEA,NYN,5,2,5-2,SEA,9,1,37,39,76,164,123,287,16,12,28,4,2:53
1501,382027,2014-07-21,2014,NYA,TEX,2,4,4-2,TEX,9,0,35,43,78,176,130,306,9,14,23,3,3:31
1502,382022,2014-07-21,2014,CHA,KCA,3,1,3-1,CHA,9,1,35,34,69,131,125,256,14,10,24,1,2:46
1503,382019,2014-07-21,2014,MIL,CIN,5,2,5-2,MIL,9,1,34,34,68,129,119,248,9,8,17,0,2:55
1504,382020,2014-07-21,2014,MIN,CLE,4,3,4-3,MIN,9,1,34,38,72,158,135,293,12,11,23,2,3:01
1505,382028,2014-07-21,2014,COL,WAS,2,7,7-2,WAS,9,0,37,45,82,145,123,268,12,19,31,1,3:01
1506,382026,2014-07-21,2014,PHI,SFN,4,7,7-4,SFN,9,0,42,42,84,135,165,300,14,18,32,3,3:28
1507,382039,2014-07-22,2014,CHN,SDN,6,0,6-0,CHN,9,1,38,33,71,108,149,257,14,9,23,0,2:35
1508,382030,2014-07-22,2014,TOR,BOS,7,3,7-3,TOR,9,1,38,39,77,158,137,295,17,14,31,3,3:07
1509,382031,2014-07-22,2014,MIL,CIN,4,3,4-3,MIL,9,0,32,35,67,122,129,251,9,9,18,1,3:01
1510,382037,2014-07-22,2014,ATL,MIA,5,6,6-5,MIA,9,0,36,43,79,156,147,303,11,17,28,2,3:13
1511,382032,2014-07-22,2014,MIN,CLE,2,8,8-2,CLE,9,0,39,41,80,151,147,298,13,15,28,4,3:06
1512,382029,2014-07-22,2014,ANA,BAL,2,4,4-2,BAL,9,0,33,37,70,161,125,286,7,10,17,2,3:08
1513,382036,2014-07-22,2014,PIT,LAN,12,7,12-7,PIT,9,1,44,43,87,152,157,309,20,15,35,4,3:39
1514,382033,2014-07-22,2014,ARI,DET,5,4,5-4,ARI,9,1,32,40,72,159,103,262,9,17,26,5,3:09
1515,382038,2014-07-22,2014,SEA,NYN,1,3,3-1,NYN,9,0,33,36,69,146,132,278,7,11,18,0,2:49
1516,382041,2014-07-22,2014,SLN,TBA,2,7,7-2,TBA,9,0,38,41,79,138,166,304,12,13,25,2,3:23
1517,382043,2014-07-22,2014,COL,WAS,4,7,7-4,WAS,9,0,39,41,80,166,143,309,13,15,28,2,3:34
1518,382035,2014-07-22,2014,CHA,KCA,1,7,7-1,KCA,9,0,38,48,86,166,160,326,12,22,34,3,3:35
1519,382042,2014-07-22,2014,NYA,TEX,2,1,2-1,NYA,14,0,54,51,105,202,209,411,19,12,31,5,4:51
1520,382034,2014-07-22,2014,OAK,HOU,2,3,3-2,HOU,12,0,46,46,92,184,174,358,11,13,24,3,4:09
1521,382040,2014-07-22,2014,PHI,SFN,6,9,9-6,SFN,14,0,63,65,128,259,248,507,22,25,47,5,5:46
1522,382057,2014-07-23,2014,NYA,TEX,2,1,2-1,NYA,5,0,18,18,36,72,67,139,5,5,10,0,1:36 (1:49 delay)
1523,382052,2014-07-23,2014,ATL,MIA,6,1,6-1,ATL,9,1,36,36,72,146,120,266,11,11,22,1,2:42
1524,382044,2014-07-23,2014,ANA,BAL,3,2,3-2,ANA,9,1,38,34,72,122,145,267,15,7,22,2,2:55
1525,382047,2014-07-23,2014,MIN,CLE,3,1,3-1,MIN,9,1,33,34,67,130,123,253,11,7,18,2,2:46
1526,382056,2014-07-23,2014,SLN,TBA,0,3,3-0,TBA,9,0,31,41,72,166,125,291,5,15,20,2,3:12
1527,382050,2014-07-23,2014,CHA,KCA,1,2,2-1,KCA,9,0,33,39,72,162,127,289,7,18,25,1,3:03
1528,382055,2014-07-23,2014,PHI,SFN,1,3,3-1,SFN,9,0,32,38,70,160,109,269,7,14,21,0,3:02 (:59 delay)
1529,382049,2014-07-23,2014,OAK,HOU,9,7,9-7,OAK,9,1,44,40,84,159,168,327,20,12,32,5,3:30
1530,382045,2014-07-23,2014,TOR,BOS,6,4,6-4,TOR,9,1,36,37,73,130,125,255,14,10,24,0,2:35
1531,382051,2014-07-23,2014,PIT,LAN,6,1,6-1,PIT,9,1,34,34,68,128,125,253,14,10,24,0,2:38
1532,382054,2014-07-23,2014,CHN,SDN,3,8,8-3,SDN,9,0,37,46,83,193,142,335,10,20,30,3,3:36
1533,382048,2014-07-23,2014,ARI,DET,5,11,11-5,DET,9,0,38,44,82,159,134,293,14,17,31,1,3:10
1534,382058,2014-07-23,2014,COL,WAS,6,4,6-4,COL,9,1,38,41,79,144,137,281,16,12,28,2,3:17
1535,382053,2014-07-23,2014,SEA,NYN,2,3,3-2,NYN,9,0,33,38,71,149,127,276,6,12,18,4,3:05
1536,382046,2014-07-23,2014,MIL,CIN,5,1,5-1,MIL,9,1,35,34,69,130,113,243,12,7,19,1,2:33
1537,382065,2014-07-24,2014,ATL,MIA,2,3,3-2,MIA,9,0,32,36,68,138,119,257,7,10,17,0,2:33
1538,382060,2014-07-24,2014,TOR,BOS,8,0,8-0,TOR,9,1,40,30,70,142,153,295,19,6,25,1,2:56
1539,382059,2014-07-24,2014,SEA,BAL,0,4,4-0,BAL,9,0,33,35,68,124,128,252,6,8,14,0,2:44
1540,382066,2014-07-24,2014,MIL,NYN,9,1,9-1,MIL,9,1,36,31,67,123,136,259,12,4,16,0,2:38
1541,382067,2014-07-24,2014,CHN,SDN,3,13,13-3,SDN,9,0,40,48,88,159,169,328,11,19,30,3,3:36
1542,382061,2014-07-24,2014,MIN,CHA,2,5,5-2,CHA,9,0,31,41,72,149,124,273,4,14,18,2,2:46
1543,382063,2014-07-24,2014,ANA,DET,4,6,6-4,DET,9,0,35,41,76,153,137,290,9,15,24,0,3:17
1544,382064,2014-07-24,2014,OAK,HOU,13,1,13-1,OAK,9,1,45,33,78,117,178,295,23,6,29,1,3:03
1545,382062,2014-07-24,2014,KCA,CLE,2,1,2-1,KCA,14,0,44,53,97,229,168,397,6,13,19,3,4:23
1546,382068,2014-07-24,2014,PHI,SFN,2,1,2-1,PHI,9,1,35,35,70,126,130,256,11,8,19,0,2:46
1547,382069,2014-07-24,2014,NYA,TEX,4,2,4-2,NYA,9,1,34,34,68,149,111,260,10,8,18,3,2:47
1548,382080,2014-07-25,2014,COL,PIT,8,1,8-1,COL,9,1,36,37,73,154,124,278,13,12,25,4,2:56
1549,382077,2014-07-25,2014,HOU,MIA,0,2,2-0,MIA,9,0,29,38,67,149,125,274,5,13,18,1,2:59
1550,382071,2014-07-25,2014,SEA,BAL,1,2,2-1,BAL,10,0,39,35,74,148,151,299,11,6,17,3,3:16
1551,382081,2014-07-25,2014,ATL,SDN,2,5,5-2,SDN,9,0,37,40,77,152,135,287,10,15,25,2,3:08
1552,382083,2014-07-25,2014,NYA,TOR,6,4,6-4,NYA,9,1,35,37,72,128,127,255,12,11,23,2,2:40
1553,382079,2014-07-25,2014,TEX,OAK,4,1,4-1,TEX,9,1,33,34,67,139,124,263,11,8,19,2,2:52
1554,382078,2014-07-25,2014,MIL,NYN,2,3,3-2,NYN,9,0,38,35,73,129,147,276,9,8,17,2,3:01
1555,382072,2014-07-25,2014,TBA,BOS,6,4,6-4,TBA,9,1,36,37,73,129,155,284,12,10,22,1,3:04
1556,382076,2014-07-25,2014,SFN,LAN,1,8,8-1,LAN,9,0,36,44,80,179,148,327,9,17,26,1,3:29
1557,382084,2014-07-25,2014,CIN,WAS,1,4,4-1,WAS,9,0,34,43,77,171,126,297,7,17,24,1,3:07
1558,382070,2014-07-25,2014,PHI,ARI,9,5,9-5,PHI,9,1,41,40,81,170,155,325,17,15,32,2,3:23
1559,382075,2014-07-25,2014,ANA,DET,2,1,2-1,ANA,9,1,32,34,66,152,124,276,10,8,18,2,3:02
1560,382074,2014-07-25,2014,KCA,CLE,6,4,6-4,KCA,9,1,34,37,71,140,142,282,11,9,20,5,3:02
1561,382073,2014-07-25,2014,MIN,CHA,5,9,9-5,CHA,9,0,36,48,84,158,139,297,9,21,30,0,2:51
1562,382082,2014-07-25,2014,CHN,SLN,7,6,7-6,CHN,9,1,40,41,81,179,157,336,16,14,30,4,3:44
1563,382099,2014-07-26,2014,CIN,WAS,1,0,1-0,CIN,9,1,27,34,61,131,107,238,6,10,16,1,2:29
1564,382088,2014-07-26,2014,MIN,CHA,0,7,7-0,CHA,9,0,35,40,75,126,126,252,8,14,22,1,2:30
1565,382091,2014-07-26,2014,SFN,LAN,0,5,5-0,LAN,9,0,30,40,70,146,113,259,4,14,18,0,2:53
1566,382098,2014-07-26,2014,NYA,TOR,4,6,6-4,TOR,9,0,42,44,86,161,135,296,15,17,32,3,3:14
1567,382095,2014-07-26,2014,COL,PIT,8,1,8-1,COL,9,1,40,33,73,119,147,266,18,7,25,1,2:49
1568,382086,2014-07-26,2014,SEA,BAL,4,3,4-3,SEA,9,1,33,37,70,149,115,264,12,10,22,3,2:49
1569,382093,2014-07-26,2014,MIL,NYN,5,2,5-2,MIL,9,1,34,38,72,167,135,302,10,12,22,2,3:02
1570,382089,2014-07-26,2014,KCA,CLE,7,5,7-5,KCA,9,1,35,41,76,168,129,297,11,16,27,3,3:06
1571,382096,2014-07-26,2014,ATL,SDN,5,3,5-3,ATL,9,1,39,38,77,149,157,306,17,11,28,3,3:26
1572,382085,2014-07-26,2014,PHI,ARI,6,10,10-6,ARI,10,0,50,50,100,167,208,375,22,22,44,2,4:20
1573,382090,2014-07-26,2014,ANA,DET,4,0,4-0,ANA,9,1,36,30,66,100,134,234,12,4,16,1,2:47
1574,382087,2014-07-26,2014,TBA,BOS,3,0,3-0,TBA,9,1,36,36,72,173,131,304,13,11,24,2,3:23
1575,382097,2014-07-26,2014,CHN,SLN,3,6,6-3,SLN,9,0,34,40,74,180,130,310,8,11,19,2,3:20
1576,382094,2014-07-26,2014,TEX,OAK,1,5,5-1,OAK,9,0,36,34,70,117,138,255,12,7,19,1,2:47
1577,382092,2014-07-26,2014,HOU,MIA,3,7,7-3,MIA,9,0,40,41,81,159,150,309,14,14,28,3,3:29
1578,382105,2014-07-27,2014,ANA,DET,2,1,2-1,ANA,9,1,29,30,59,125,118,243,7,3,10,1,2:39
1579,382112,2014-07-27,2014,CHN,SLN,0,1,1-0,SLN,9,0,34,33,67,131,126,257,10,10,20,1,2:41
1580,382111,2014-07-27,2014,ATL,SDN,8,3,8-3,ATL,9,1,35,38,73,144,151,295,12,11,23,2,2:56
1581,382103,2014-07-27,2014,MIN,CHA,4,3,4-3,MIN,9,1,32,35,67,148,112,260,9,10,19,1,2:44
1582,382106,2014-07-27,2014,SFN,LAN,3,4,4-3,LAN,9,0,35,38,73,145,138,283,9,10,19,1,3:13
1583,382114,2014-07-27,2014,CIN,WAS,2,4,4-2,WAS,9,0,35,39,74,160,149,309,8,12,20,1,3:19 (:16 delay)
1584,382108,2014-07-27,2014,MIL,NYN,0,2,2-0,NYN,9,0,35,36,71,121,153,274,8,10,18,2,3:10
1585,382101,2014-07-27,2014,SEA,BAL,2,3,3-2,BAL,10,0,43,44,87,163,152,315,14,17,31,1,3:21
1586,382109,2014-07-27,2014,TEX,OAK,3,9,9-3,OAK,9,0,37,45,82,156,159,315,11,16,27,2,3:26
1587,382102,2014-07-27,2014,TBA,BOS,2,3,3-2,BOS,9,0,36,38,74,158,144,302,11,12,23,3,3:22
1588,382113,2014-07-27,2014,NYA,TOR,4,5,5-4,TOR,9,0,35,41,76,147,154,301,8,17,25,4,3:22
1589,382104,2014-07-27,2014,KCA,CLE,3,10,10-3,CLE,9,0,35,44,79,177,140,317,8,20,28,1,3:03
1590,382110,2014-07-27,2014,COL,PIT,5,7,7-5,PIT,9,0,40,46,86,189,145,334,15,21,36,3,3:58
1591,382100,2014-07-27,2014,PHI,ARI,4,2,4-2,PHI,9,1,32,32,64,98,137,235,7,7,14,1,2:30
1592,382107,2014-07-27,2014,HOU,MIA,2,4,4-2,MIA,9,0,35,37,72,148,136,284,9,10,19,3,3:00
1593,382117,2014-07-28,2014,TBA,MIL,2,1,2-1,TBA,9,1,32,30,62,117,130,247,10,3,13,0,2:35
1594,382122,2014-07-28,2014,ATL,SDN,2,0,2-0,ATL,9,1,34,32,66,115,130,245,10,6,16,1,2:33
1595,382123,2014-07-28,2014,BOS,TOR,1,14,14-1,TOR,9,0,34,48,82,189,137,326,7,23,30,2,3:15
1596,382118,2014-07-28,2014,TEX,NYA,4,2,4-2,TEX,9,1,36,38,74,138,124,262,11,12,23,1,3:01
1597,382120,2014-07-28,2014,NYN,PHI,7,1,7-1,NYN,9,1,36,40,76,149,120,269,12,14,26,2,2:54
1598,382115,2014-07-28,2014,CIN,ARI,1,2,2-1,ARI,15,0,55,54,109,203,217,420,13,11,24,0,4:34
1599,382124,2014-07-28,2014,MIA,WAS,7,6,7-6,MIA,9,0,38,40,78,154,142,296,13,14,27,4,3:17
1600,382121,2014-07-28,2014,SFN,PIT,0,5,5-0,PIT,9,0,29,36,65,144,100,244,5,9,14,1,2:34
1601,382119,2014-07-28,2014,HOU,OAK,7,3,7-3,HOU,9,1,33,38,71,139,128,267,10,12,22,3,2:51
1602,382116,2014-07-28,2014,CHN,COL,4,1,4-1,CHN,9,1,31,33,64,118,117,235,11,7,18,3,2:53
1603,382135,2014-07-29,2014,SFN,PIT,1,3,3-1,PIT,9,0,33,36,69,141,134,275,7,9,16,0,2:45
1604,382131,2014-07-29,2014,KCA,MIN,1,2,2-1,MIN,9,0,33,37,70,170,131,301,7,13,20,0,3:14
1605,382137,2014-07-29,2014,SDN,SLN,3,1,3-1,SDN,9,1,36,38,74,166,155,321,11,12,23,1,3:20
1606,382134,2014-07-29,2014,NYN,PHI,0,6,6-0,PHI,9,0,33,38,71,146,126,272,7,11,18,1,2:36
1607,382130,2014-07-29,2014,TBA,MIL,5,1,5-1,TBA,9,1,34,30,64,116,135,251,14,5,19,1,2:56
1608,382139,2014-07-29,2014,MIA,WAS,3,0,3-0,MIA,9,1,32,38,70,145,133,278,9,12,21,2,3:07
1609,382127,2014-07-29,2014,LAN,ATL,8,4,8-4,LAN,9,1,40,45,85,185,165,350,16,20,36,3,3:46
1610,382138,2014-07-29,2014,BOS,TOR,2,4,4-2,TOR,9,0,37,39,76,153,152,305,11,14,25,1,3:03
1611,382125,2014-07-29,2014,BAL,ANA,7,6,7-6,BAL,12,0,47,50,97,174,179,353,15,13,28,2,4:05
1612,382128,2014-07-29,2014,DET,CHA,4,11,11-4,CHA,9,0,39,45,84,171,143,314,16,19,35,2,3:16
1613,382132,2014-07-29,2014,TEX,NYA,11,12,12-11,NYA,9,0,49,45,94,160,204,364,23,18,41,2,3:51
1614,382129,2014-07-29,2014,CHN,COL,4,3,4-3,CHN,16,0,67,63,130,274,282,556,21,18,39,3,6:27
1615,382136,2014-07-29,2014,CLE,SEA,2,5,5-2,SEA,9,0,35,41,76,148,129,277,9,15,24,4,3:15
1616,382133,2014-07-29,2014,HOU,OAK,4,7,7-4,OAK,9,0,35,43,78,149,132,281,10,17,27,3,3:15
1617,382126,2014-07-29,2014,CIN,ARI,3,0,3-0,CIN,9,1,30,35,65,126,123,249,7,7,14,1,2:33
1618,382151,2014-07-30,2014,CLE,SEA,2,0,2-0,CLE,9,1,30,28,58,85,114,199,6,3,9,0,2:10
1619,382140,2014-07-30,2014,BAL,ANA,4,3,4-3,BAL,9,1,31,33,64,128,119,247,6,7,13,0,2:35
1620,382150,2014-07-30,2014,SFN,PIT,7,5,7-5,SFN,9,1,42,37,79,148,163,311,18,12,30,3,3:24
1621,382143,2014-07-30,2014,DET,CHA,7,2,7-2,DET,9,1,39,33,72,135,129,264,17,8,25,0,2:49 (:29 delay)
1622,382145,2014-07-30,2014,TBA,MIL,0,5,5-0,MIL,9,0,34,39,73,149,132,281,9,12,21,2,3:14
1623,382153,2014-07-30,2014,BOS,TOR,1,6,6-1,TOR,9,0,36,42,78,154,131,285,9,14,23,1,2:48
1624,382152,2014-07-30,2014,SDN,SLN,12,1,12-1,SDN,9,1,42,33,75,126,162,288,22,8,30,2,3:10
1625,382146,2014-07-30,2014,KCA,MIN,3,2,3-2,KCA,9,1,34,38,72,172,120,292,10,14,24,3,3:10
1626,382154,2014-07-30,2014,MIA,WAS,3,4,4-3,WAS,9,0,36,38,74,143,153,296,9,11,20,1,3:20
1627,382141,2014-07-30,2014,CIN,ARI,4,5,5-4,ARI,9,0,41,39,80,148,139,287,17,14,31,3,3:02
1628,382148,2014-07-30,2014,HOU,OAK,8,1,8-1,HOU,9,1,38,33,71,111,155,266,14,7,21,1,2:35
1629,382144,2014-07-30,2014,CHN,COL,4,6,6-4,COL,10,0,41,45,86,188,162,350,14,17,31,0,3:27
1630,382147,2014-07-30,2014,TEX,NYA,3,2,3-2,TEX,9,1,36,33,69,130,137,267,13,6,19,0,2:49
1631,382142,2014-07-30,2014,LAN,ATL,3,2,3-2,LAN,10,0,41,38,79,144,164,308,15,9,24,0,3:25
1632,382149,2014-07-30,2014,NYN,PHI,11,2,11-2,NYN,9,1,44,40,84,155,171,326,21,14,35,3,3:28
1633,382156,2014-07-31,2014,LAN,ATL,2,1,2-1,LAN,9,1,31,32,63,111,118,229,9,9,18,0,2:35
1634,382158,2014-07-31,2014,MIA,CIN,1,3,3-1,CIN,9,0,33,36,69,107,133,240,8,7,15,2,2:43
1635,382165,2014-07-31,2014,HOU,TOR,5,6,6-5,TOR,9,0,39,36,75,117,145,262,13,11,24,2,2:46
1636,382164,2014-07-31,2014,SDN,SLN,2,6,6-2,SLN,9,0,30,38,68,146,120,266,3,13,16,1,2:36
1637,382163,2014-07-31,2014,CLE,SEA,5,6,6-5,SEA,9,0,41,39,80,165,166,331,15,13,28,8,3:33
1638,382157,2014-07-31,2014,DET,CHA,4,7,7-4,CHA,9,0,41,45,86,190,167,357,16,22,38,2,4:01
1639,382155,2014-07-31,2014,BAL,ANA,0,1,1-0,ANA,13,0,48,51,99,188,205,393,10,15,25,2,4:33
1640,382159,2014-07-31,2014,CHN,COL,3,1,3-1,CHN,9,1,31,34,65,138,122,260,10,7,17,2,2:59
1641,382160,2014-07-31,2014,KCA,MIN,6,3,6-3,KCA,9,1,33,41,74,147,131,278,9,12,21,2,2:50
1642,382162,2014-07-31,2014,ARI,PIT,7,4,7-4,ARI,9,1,38,38,76,169,132,301,13,12,25,2,3:08
1643,382161,2014-07-31,2014,WAS,PHI,4,10,10-4,PHI,9,0,36,46,82,176,133,309,10,20,30,4,3:31
1644,382180,2014-08-01,2014,HOU,TOR,3,1,3-1,HOU,9,1,31,34,65,141,119,260,7,7,14,3,2:46
1645,382171,2014-08-01,2014,OAK,KCA,0,1,1-0,KCA,9,0,35,32,67,134,162,296,8,5,13,1,2:54
1646,382178,2014-08-01,2014,NYN,SFN,1,5,5-1,SFN,9,0,28,38,66,98,102,200,3,12,15,1,2:06
1647,382166,2014-08-01,2014,TBA,ANA,3,5,5-3,ANA,9,0,39,39,78,149,172,321,13,15,28,2,3:39
1648,382175,2014-08-01,2014,WAS,PHI,1,2,2-1,PHI,9,0,34,34,68,121,116,237,9,8,17,0,2:28
1649,382177,2014-08-01,2014,BAL,SEA,2,1,2-1,BAL,9,1,31,34,65,126,103,229,9,7,16,2,2:29
1650,382173,2014-08-01,2014,CHA,MIN,10,8,10-8,CHA,9,1,45,43,88,166,165,331,22,16,38,4,3:47
1651,382169,2014-08-01,2014,MIA,CIN,2,5,5-2,CIN,9,0,36,38,74,146,120,266,12,10,22,1,2:58
1652,382170,2014-08-01,2014,DET,COL,4,2,4-2,DET,9,1,36,37,73,121,130,251,14,10,24,0,2:56
1653,382172,2014-08-01,2014,SLN,MIL,4,7,7-4,MIL,9,0,38,46,84,155,136,291,12,20,32,3,3:14
1654,382168,2014-08-01,2014,LAN,CHN,2,8,8-2,CHN,9,0,32,44,76,174,132,306,6,17,23,1,3:18
1655,382176,2014-08-01,2014,ARI,PIT,4,9,9-4,PIT,9,0,38,45,83,180,140,320,12,20,32,3,3:25
1656,382167,2014-08-01,2014,SDN,ATL,10,1,10-1,SDN,9,1,45,37,82,158,162,320,23,9,32,2,3:09
1657,382179,2014-08-01,2014,CLE,TEX,12,2,12-2,CLE,9,1,43,39,82,159,151,310,21,13,34,2,3:23
1658,382174,2014-08-01,2014,BOS,NYA,4,3,4-3,BOS,9,1,33,37,70,130,115,245,10,11,21,2,3:03
1659,382193,2014-08-02,2014,NYN,SFN,4,2,4-2,NYN,9,1,29,34,63,121,101,222,5,7,12,1,2:24
1660,382194,2014-08-02,2014,CLE,TEX,2,0,2-0,CLE,9,1,32,36,68,161,115,276,9,8,17,2,3:00
1661,382186,2014-08-02,2014,OAK,KCA,8,3,8-3,OAK,9,1,34,38,72,143,124,267,9,12,21,3,2:45
1662,382184,2014-08-02,2014,MIA,CIN,2,1,2-1,MIA,10,0,37,38,75,147,141,288,10,10,20,3,3:11
1663,382187,2014-08-02,2014,SLN,MIL,9,7,9-7,SLN,9,1,41,38,79,131,144,275,17,13,30,1,2:58
1664,382195,2014-08-02,2014,HOU,TOR,8,2,8-2,HOU,9,1,37,36,73,122,133,255,13,9,22,3,2:38
1665,382185,2014-08-02,2014,DET,COL,11,5,11-5,DET,9,1,39,38,77,142,144,286,19,12,31,2,3:15
1666,382188,2014-08-02,2014,CHA,MIN,6,8,8-6,MIN,9,0,41,40,81,146,125,271,17,16,33,4,2:58
1667,382192,2014-08-02,2014,BAL,SEA,3,6,6-3,SEA,9,0,38,41,79,166,160,326,12,15,27,5,3:38
1668,382190,2014-08-02,2014,WAS,PHI,11,0,11-0,WAS,9,1,43,34,77,119,176,295,18,7,25,2,3:19
1669,382189,2014-08-02,2014,BOS,NYA,4,6,6-4,NYA,9,0,38,43,81,197,169,366,11,17,28,5,3:56
1670,382181,2014-08-02,2014,TBA,ANA,10,3,10-3,TBA,9,1,43,38,81,155,178,333,23,12,35,2,3:34
1671,382191,2014-08-02,2014,ARI,PIT,3,8,8-3,PIT,9,0,41,43,84,182,139,321,14,14,28,2,3:30
1672,382183,2014-08-02,2014,LAN,CHN,5,2,5-2,LAN,12,0,48,50,98,184,200,384,16,16,32,3,4:39
1673,382182,2014-08-02,2014,SDN,ATL,3,2,3-2,SDN,12,0,51,52,103,201,200,401,21,19,40,4,4:35
1674,382202,2014-08-03,2014,SLN,MIL,3,2,3-2,SLN,9,1,30,37,67,155,100,255,7,10,17,1,2:50
1675,382201,2014-08-03,2014,OAK,KCA,2,4,4-2,KCA,9,0,30,38,68,134,112,246,4,15,19,2,2:32
1676,382206,2014-08-03,2014,ARI,PIT,3,2,3-2,ARI,10,0,36,40,76,161,143,304,10,15,25,0,3:13
1677,382205,2014-08-03,2014,WAS,PHI,4,0,4-0,WAS,9,1,34,31,65,128,122,250,10,4,14,1,2:47
1678,382204,2014-08-03,2014,BOS,NYA,7,8,8-7,NYA,9,0,38,40,78,161,176,337,13,15,28,0,3:42
1679,382198,2014-08-03,2014,LAN,CHN,3,7,7-3,CHN,9,0,34,44,78,191,129,320,10,19,29,2,3:34
1680,382208,2014-08-03,2014,NYN,SFN,0,9,9-0,SFN,9,0,30,40,70,157,94,251,3,13,16,2,2:40
1681,382200,2014-08-03,2014,DET,COL,4,0,4-0,DET,9,1,34,32,66,145,128,273,10,4,14,1,2:58
1682,382197,2014-08-03,2014,SDN,ATL,4,3,4-3,SDN,10,0,46,39,85,157,196,353,18,12,30,3,4:01
1683,382209,2014-08-03,2014,CLE,TEX,4,3,4-3,CLE,12,0,48,47,95,163,186,349,18,14,32,3,3:58
1684,382196,2014-08-03,2014,TBA,ANA,5,7,7-5,ANA,9,0,44,42,86,165,178,343,17,16,33,3,3:46 (:19 delay)
1685,382210,2014-08-03,2014,HOU,TOR,6,1,6-1,HOU,9,1,36,33,69,109,140,249,13,10,23,1,2:39
1686,382199,2014-08-03,2014,MIA,CIN,3,7,7-3,CIN,9,0,37,42,79,144,152,296,10,17,27,0,3:05
1687,382207,2014-08-03,2014,BAL,SEA,1,0,1-0,BAL,9,1,30,31,61,127,110,237,7,5,12,1,2:33
1688,382203,2014-08-03,2014,CHA,MIN,3,16,16-3,MIN,9,0,37,58,95,244,134,378,9,31,40,2,4:01 (:45 delay)
1689,382212,2014-08-04,2014,CLE,CIN,7,1,7-1,CLE,9,1,35,39,74,137,110,247,14,11,25,2,2:52
1690,382211,2014-08-04,2014,LAN,ANA,0,5,5-0,ANA,9,0,34,36,70,123,122,245,7,7,14,0,2:49
1691,381885,2014-08-04,2014,WAS,BAL,3,7,7-3,BAL,9,0,36,41,77,144,139,283,10,15,25,3,3:10
1692,382213,2014-08-04,2014,NYA,DET,2,1,2-1,NYA,9,1,33,36,69,151,130,281,12,8,20,1,3:19
1693,381885,2014-08-04,2014,WAS,BAL,3,7,7-3,BAL,9,0,36,41,77,144,139,283,10,15,25,3,3:10
1694,382215,2014-08-04,2014,OAK,TBA,3,2,3-2,OAK,10,0,50,39,89,139,200,339,22,7,29,2,3:57
1695,382216,2014-08-04,2014,CHA,TEX,5,3,5-3,CHA,7,0,29,29,58,104,124,228,13,8,21,1,2:28 (1:20 delay)
1696,382214,2014-08-04,2014,NYN,SFN,3,4,4-3,SFN,9,0,38,41,79,179,157,336,13,16,29,4,3:40
1697,382218,2014-08-05,2014,SEA,ATL,4,2,4-2,SEA,9,1,34,33,67,113,129,242,11,7,18,0,2:29
1698,382229,2014-08-05,2014,MIL,SFN,4,3,4-3,MIL,9,1,34,38,72,130,123,253,11,10,21,1,2:54
1699,382228,2014-08-05,2014,MIN,SDN,3,1,3-1,MIN,9,1,32,39,71,145,132,277,9,13,22,1,2:55
1700,382231,2014-08-05,2014,CHA,TEX,0,16,16-0,TEX,9,0,33,52,85,197,110,307,7,25,32,1,2:56
1701,382227,2014-08-05,2014,WAS,NYN,1,6,6-1,NYN,9,0,35,40,75,135,144,279,12,15,27,2,3:12
1702,382230,2014-08-05,2014,OAK,TBA,3,0,3-0,OAK,9,1,37,36,73,129,153,282,16,11,27,2,3:09
1703,382223,2014-08-05,2014,NYA,DET,3,4,4-3,DET,12,0,45,46,91,162,160,322,9,10,19,5,4:11
1704,382219,2014-08-05,2014,TOR,BAL,3,9,9-3,BAL,9,0,40,47,87,203,143,346,16,22,38,3,3:29
1705,382217,2014-08-05,2014,LAN,ANA,5,4,5-4,LAN,9,0,36,35,71,135,140,275,10,10,20,1,3:00
1706,382222,2014-08-05,2014,CLE,CIN,2,9,9-2,CIN,9,0,33,44,77,149,117,266,8,18,26,2,2:48
1707,382224,2014-08-05,2014,PHI,HOU,2,1,2-1,PHI,15,0,58,54,112,234,233,467,16,11,27,1,5:05
1708,382225,2014-08-05,2014,ARI,KCA,2,12,12-2,KCA,9,0,35,44,79,159,149,308,7,19,26,1,3:02
1709,382226,2014-08-05,2014,PIT,MIA,3,6,6-3,MIA,9,0,36,42,78,162,126,288,10,17,27,4,3:03
1710,382221,2014-08-05,2014,COL,CHN,5,6,6-5,CHN,12,0,53,50,103,204,169,373,20,18,38,4,4:21
1711,382220,2014-08-05,2014,SLN,BOS,3,2,3-2,SLN,9,1,36,34,70,141,144,285,14,7,21,1,3:04
1712,382233,2014-08-06,2014,TOR,BAL,5,1,5-1,TOR,9,1,38,29,67,119,137,256,14,2,16,1,2:41
1713,382242,2014-08-06,2014,WAS,NYN,7,1,7-1,WAS,9,1,34,34,68,132,133,265,11,8,19,1,2:31
1714,382245,2014-08-06,2014,OAK,TBA,3,7,7-3,TBA,9,0,33,45,78,158,142,300,6,19,25,1,3:10
1715,382237,2014-08-06,2014,NYA,DET,5,1,5-1,NYA,9,1,34,36,70,137,138,275,10,7,17,2,3:10
1716,382234,2014-08-06,2014,SLN,BOS,1,2,2-1,BOS,9,0,35,35,70,123,128,251,9,11,20,1,3:01 (1:03 delay)
1717,382238,2014-08-06,2014,PHI,HOU,10,3,10-3,PHI,9,1,38,37,75,133,142,275,17,10,27,1,2:45
1718,382240,2014-08-06,2014,ANA,LAN,1,2,2-1,LAN,9,0,31,37,68,145,110,255,5,11,16,2,3:06
1719,382239,2014-08-06,2014,ARI,KCA,3,4,4-3,KCA,9,0,41,35,76,120,164,284,14,8,22,1,3:02
1720,382232,2014-08-06,2014,SEA,ATL,7,3,7-3,SEA,9,1,38,38,76,146,140,286,15,12,27,3,2:53
1721,382243,2014-08-06,2014,MIN,SDN,4,5,5-4,SDN,10,0,48,42,90,154,180,334,20,13,33,3,3:45
1722,382244,2014-08-06,2014,MIL,SFN,4,7,7-4,SFN,9,0,41,46,87,186,153,339,15,21,36,3,3:53
1723,382236,2014-08-06,2014,CIN,CLE,8,3,8-3,CIN,9,1,34,35,69,132,120,252,10,9,19,2,2:44
1724,382246,2014-08-06,2014,CHA,TEX,1,3,3-1,TEX,9,0,33,33,66,147,135,282,10,9,19,3,2:57
1725,382241,2014-08-06,2014,PIT,MIA,7,3,7-3,PIT,9,1,36,34,70,128,145,273,13,7,20,1,2:43
1726,382235,2014-08-06,2014,COL,CHN,13,4,13-4,COL,9,1,41,36,77,142,127,269,21,10,31,1,2:51
1727,382247,2014-08-07,2014,TOR,BAL,1,2,2-1,BAL,9,0,34,34,68,139,148,287,8,7,15,0,2:59
1728,382252,2014-08-07,2014,NYA,DET,1,0,1-0,NYA,9,1,33,33,66,112,127,239,11,9,20,1,2:49
1729,382250,2014-08-07,2014,COL,CHN,2,6,6-2,CHN,9,0,35,35,70,126,117,243,7,10,17,1,2:29 (:39 delay)
1730,382253,2014-08-07,2014,PHI,HOU,6,5,6-5,PHI,9,1,32,34,66,122,128,250,10,10,20,2,2:47
1731,382251,2014-08-07,2014,CIN,CLE,4,0,4-0,CIN,9,1,33,33,66,129,112,241,9,6,15,1,2:35
1732,382254,2014-08-07,2014,ARI,KCA,2,6,6-2,KCA,9,0,34,38,72,149,109,258,7,13,20,0,2:34
1733,382257,2014-08-07,2014,OAK,MIN,3,0,3-0,OAK,9,1,36,31,67,122,144,266,12,5,17,2,2:42
1734,382259,2014-08-07,2014,MIL,SFN,3,1,3-1,MIL,9,1,34,37,71,158,122,280,12,11,23,3,3:14
1735,382256,2014-08-07,2014,PIT,MIA,7,2,7-2,PIT,9,1,37,31,68,138,148,286,15,6,21,3,3:03
1736,382249,2014-08-07,2014,SEA,CHA,13,3,13-3,SEA,9,1,45,37,82,141,163,304,23,9,32,4,3:08
1737,382258,2014-08-07,2014,WAS,NYN,5,3,5-3,WAS,13,0,51,50,101,186,196,382,17,12,29,5,4:34
1738,382255,2014-08-07,2014,ANA,LAN,0,7,7-0,LAN,9,0,31,46,77,178,136,314,5,21,26,2,3:24
1739,382248,2014-08-07,2014,SLN,BOS,5,2,5-2,SLN,9,1,33,37,70,154,132,286,10,10,20,2,3:08 (1:04 delay)
1740,382260,2014-08-08,2014,ANA,BOS,2,4,4-2,BOS,9,0,37,38,75,156,126,282,11,10,21,1,3:10
1741,382270,2014-08-08,2014,KCA,SFN,4,2,4-2,KCA,9,1,30,37,67,154,123,277,8,12,20,0,2:59
1742,382274,2014-08-08,2014,ATL,WAS,7,6,7-6,ATL,9,1,36,36,72,121,142,263,12,9,21,1,2:47 (1:11 delay)
1743,382265,2014-08-08,2014,MIL,LAN,9,3,9-3,MIL,9,1,35,38,73,148,113,261,9,13,22,4,3:05
1744,382263,2014-08-08,2014,ARI,COL,5,3,5-3,ARI,9,1,38,37,75,154,138,292,15,10,25,1,3:05
1745,382269,2014-08-08,2014,PIT,SDN,2,1,2-1,PIT,9,1,33,32,65,125,130,255,11,7,18,0,2:41
1746,382268,2014-08-08,2014,PHI,NYN,4,5,5-4,NYN,9,0,36,39,75,147,126,273,10,14,24,1,2:51
1747,382271,2014-08-08,2014,BAL,SLN,12,2,12-2,BAL,9,1,46,32,78,139,157,296,23,5,28,2,2:57
1748,382262,2014-08-08,2014,NYA,CLE,10,6,10-6,NYA,9,1,43,42,85,170,164,334,19,16,35,8,3:53
1749,382273,2014-08-08,2014,HOU,TEX,4,3,4-3,HOU,9,1,38,36,74,131,166,297,14,10,24,0,3:24
1750,382272,2014-08-08,2014,CHN,TBA,3,4,4-3,TBA,10,0,39,41,80,159,148,307,9,10,19,3,3:30
1751,382264,2014-08-08,2014,TOR,DET,4,5,5-4,DET,9,0,44,39,83,143,159,302,15,13,28,3,3:19
1752,382261,2014-08-08,2014,SEA,CHA,4,1,4-1,SEA,9,1,36,32,68,117,126,243,12,6,18,2,2:43
1753,382266,2014-08-08,2014,CIN,MIA,1,2,2-1,MIA,9,0,35,39,74,153,132,285,9,13,22,0,2:40
1754,382267,2014-08-08,2014,OAK,MIN,6,5,6-5,OAK,9,1,36,34,70,116,151,267,12,8,20,4,2:51
1755,382285,2014-08-09,2014,KCA,SFN,5,0,5-0,KCA,9,1,32,31,63,109,114,223,9,5,14,2,2:30
1756,382276,2014-08-09,2014,SEA,CHA,1,2,2-1,CHA,10,0,35,38,73,124,118,242,8,10,18,3,2:50 (:17 delay)
1757,382277,2014-08-09,2014,NYA,CLE,0,3,3-0,CLE,9,0,35,36,71,124,150,274,8,9,17,2,2:59
1758,382280,2014-08-09,2014,MIL,LAN,4,1,4-1,MIL,9,1,32,31,63,117,113,230,11,6,17,0,2:43
1759,382278,2014-08-09,2014,ARI,COL,14,4,14-4,ARI,9,1,40,36,76,130,164,294,16,9,25,1,3:11
1760,382283,2014-08-09,2014,PHI,NYN,1,2,2-1,NYN,11,0,42,43,85,177,166,343,9,13,22,1,3:41
1761,382286,2014-08-09,2014,BAL,SLN,10,3,10-3,BAL,9,1,40,40,80,149,149,298,18,14,32,2,2:58
1762,382281,2014-08-09,2014,CIN,MIA,3,4,4-3,MIA,9,0,38,43,81,174,152,326,12,17,29,1,3:27
1763,382289,2014-08-09,2014,ATL,WAS,1,4,4-1,WAS,11,0,45,46,91,164,175,339,15,15,30,2,3:38 (3:41 delay)
1764,382282,2014-08-09,2014,OAK,MIN,9,4,9-4,OAK,9,1,45,42,87,158,179,337,22,15,37,1,3:21
1765,382275,2014-08-09,2014,ANA,BOS,5,4,5-4,ANA,19,0,75,66,141,286,272,558,26,10,36,2,6:32
1766,382279,2014-08-09,2014,TOR,DET,3,2,3-2,TOR,10,0,36,36,72,125,145,270,11,8,19,1,2:50
1767,382287,2014-08-09,2014,CHN,TBA,0,4,4-0,TBA,9,0,32,36,68,135,157,292,6,9,15,0,3:06
1768,382284,2014-08-09,2014,PIT,SDN,1,2,2-1,SDN,9,0,36,34,70,131,144,275,9,9,18,2,2:53
1769,382288,2014-08-09,2014,HOU,TEX,8,3,8-3,HOU,9,1,41,38,79,151,174,325,19,11,30,2,3:32
1770,382296,2014-08-10,2014,CIN,MIA,7,2,7-2,CIN,9,1,35,36,71,130,144,274,10,8,18,1,2:45
1771,382290,2014-08-10,2014,ANA,BOS,1,3,3-1,BOS,9,0,36,36,72,160,132,292,10,9,19,1,3:03
1772,382303,2014-08-10,2014,HOU,TEX,2,6,6-2,TEX,9,0,36,38,74,131,156,287,10,11,21,0,3:08
1773,382295,2014-08-10,2014,MIL,LAN,1,5,5-1,LAN,9,0,32,44,76,147,111,258,8,18,26,1,3:05
1774,382291,2014-08-10,2014,SEA,CHA,4,2,4-2,SEA,9,1,34,35,69,136,125,261,13,12,25,3,2:50
1775,382300,2014-08-10,2014,KCA,SFN,7,4,7-4,KCA,9,1,38,40,78,163,142,305,15,13,28,3,3:21
1776,382304,2014-08-10,2014,ATL,WAS,3,1,3-1,ATL,9,1,37,35,72,134,172,306,14,9,23,2,3:07
1777,382298,2014-08-10,2014,PHI,NYN,7,6,7-6,PHI,9,0,40,42,82,136,170,306,14,17,31,1,3:14
1778,382301,2014-08-10,2014,BAL,SLN,3,8,8-3,SLN,9,0,38,45,83,191,147,338,11,20,31,2,3:39
1779,382294,2014-08-10,2014,TOR,DET,6,5,6-5,TOR,19,0,84,81,165,304,325,629,36,29,65,5,6:37
1780,382299,2014-08-10,2014,PIT,SDN,2,8,8-2,SDN,9,0,36,44,80,177,141,318,11,17,28,0,3:20
1781,382292,2014-08-10,2014,NYA,CLE,1,4,4-1,CLE,9,0,31,40,71,169,123,292,5,14,19,2,3:08
1782,382297,2014-08-10,2014,OAK,MIN,1,6,6-1,MIN,9,0,35,41,76,163,119,282,8,14,22,1,2:49
1783,382302,2014-08-10,2014,CHN,TBA,3,2,3-2,CHN,12,0,48,47,95,182,188,370,14,12,26,2,4:08
1784,382293,2014-08-10,2014,ARI,COL,3,5,5-3,COL,10,0,43,42,85,176,171,347,12,14,26,1,3:34
1785,382311,2014-08-11,2014,PHI,NYN,3,5,5-3,NYN,9,0,37,37,74,146,138,284,12,10,22,2,2:48
1786,382309,2014-08-11,2014,HOU,MIN,2,4,4-2,MIN,9,0,37,40,77,182,142,324,12,15,27,1,3:20
1787,382315,2014-08-11,2014,SEA,TOR,11,1,11-1,SEA,9,1,40,30,70,122,159,281,16,3,19,1,2:43
1788,382313,2014-08-11,2014,MIA,SLN,6,5,6-5,MIA,9,1,36,40,76,137,137,274,13,15,28,1,2:56
1789,382305,2014-08-11,2014,SDN,COL,4,3,4-3,SDN,9,1,35,35,70,144,154,298,13,8,21,3,3:10
1790,382307,2014-08-11,2014,ATL,LAN,2,6,6-2,LAN,9,0,34,40,74,158,125,283,7,15,22,2,3:11
1791,382314,2014-08-11,2014,TEX,TBA,0,7,7-0,TBA,9,0,35,43,78,175,147,322,9,17,26,2,3:17
1792,382310,2014-08-11,2014,BAL,NYA,11,3,11-3,BAL,9,1,41,37,78,173,156,329,16,10,26,2,3:41
1793,382306,2014-08-11,2014,PIT,DET,11,6,11-6,PIT,9,1,43,42,85,145,168,313,19,18,37,3,3:30
1794,382312,2014-08-11,2014,KCA,OAK,3,2,3-2,KCA,9,1,31,33,64,150,106,256,9,8,17,0,2:35
1795,382308,2014-08-11,2014,CHN,MIL,1,3,3-1,MIL,9,0,33,33,66,118,136,254,7,8,15,1,3:01
1796,382323,2014-08-12,2014,HOU,MIN,10,4,10-4,HOU,9,1,38,35,73,144,152,296,15,8,23,2,3:08
1797,382327,2014-08-12,2014,MIA,SLN,3,0,3-0,MIA,9,1,30,33,63,135,102,237,10,6,16,2,2:34
1798,382319,2014-08-12,2014,SDN,COL,4,1,4-1,SDN,9,1,33,34,67,125,119,244,9,8,17,1,2:41
1799,382321,2014-08-12,2014,ATL,LAN,2,4,4-2,LAN,9,0,35,38,73,133,139,272,8,12,20,2,2:56
1800,382320,2014-08-12,2014,PIT,DET,4,2,4-2,PIT,9,1,34,37,71,149,131,280,12,9,21,1,3:10
1801,382325,2014-08-12,2014,KCA,OAK,3,11,11-3,OAK,9,0,35,45,80,148,139,287,9,20,29,1,2:49
1802,382317,2014-08-12,2014,CIN,BOS,2,3,3-2,BOS,9,0,35,35,70,133,149,282,10,9,19,2,3:05
1803,382330,2014-08-12,2014,NYN,WAS,1,7,7-1,WAS,9,0,37,39,76,156,136,292,10,14,24,1,2:46 (:25 delay)
1804,382318,2014-08-12,2014,SFN,CHA,2,3,3-2,CHA,10,0,40,39,79,151,153,304,11,9,20,1,3:12
1805,382322,2014-08-12,2014,CHN,MIL,3,0,3-0,CHN,9,1,32,32,64,107,114,221,9,8,17,2,2:22
1806,382329,2014-08-12,2014,SEA,TOR,6,3,6-3,SEA,9,1,33,36,69,147,128,275,9,9,18,2,2:41
1807,382326,2014-08-12,2014,ANA,PHI,7,2,7-2,ANA,9,1,36,36,72,140,129,269,13,11,24,3,2:56
1808,382328,2014-08-12,2014,TEX,TBA,3,2,3-2,TEX,14,0,57,51,108,183,215,398,18,8,26,3,4:49
1809,382336,2014-08-13,2014,CHN,MIL,4,2,4-2,CHN,9,1,34,33,67,123,123,246,11,7,18,1,2:36
1810,382338,2014-08-13,2014,BAL,NYA,5,3,5-3,BAL,9,1,31,34,65,141,121,262,7,8,15,1,2:45
1811,382342,2014-08-13,2014,MIA,SLN,2,5,5-2,SLN,9,0,31,40,71,143,127,270,5,13,18,1,2:40
1812,382344,2014-08-13,2014,SEA,TOR,2,0,2-0,SEA,9,1,32,36,68,139,124,263,12,9,21,2,2:41
1813,382335,2014-08-13,2014,ATL,LAN,3,2,3-2,ATL,9,1,35,40,75,151,126,277,11,16,27,1,3:02
1814,382333,2014-08-13,2014,SFN,CHA,7,1,7-1,SFN,9,1,35,33,68,128,118,246,9,9,18,2,2:44
1815,382337,2014-08-13,2014,HOU,MIN,1,3,3-1,MIN,9,0,34,39,73,143,122,265,8,13,21,2,2:45
1816,382343,2014-08-13,2014,TEX,TBA,1,10,10-1,TBA,9,0,32,42,74,133,134,267,6,16,22,2,2:51
1817,382334,2014-08-13,2014,SDN,COL,5,3,5-3,SDN,9,1,36,38,74,147,127,274,13,13,26,1,3:01
1818,382340,2014-08-13,2014,ANA,PHI,4,3,4-3,ANA,9,1,35,39,74,141,123,264,12,13,25,0,2:51
1819,382332,2014-08-13,2014,CIN,BOS,4,5,5-4,BOS,9,0,38,37,75,138,134,272,11,10,21,0,3:01
1820,382339,2014-08-13,2014,KCA,OAK,3,0,3-0,KCA,9,1,31,29,60,97,111,208,9,3,12,0,2:06
1821,382341,2014-08-13,2014,DET,PIT,8,4,8-4,DET,9,1,37,37,74,143,133,276,16,12,28,2,3:06
1822,382331,2014-08-13,2014,CLE,ARI,3,2,3-2,CLE,9,0,35,32,67,126,140,266,11,7,18,3,2:50
1823,382345,2014-08-13,2014,NYN,WAS,2,3,3-2,WAS,9,0,37,36,73,128,121,249,10,10,20,1,2:47
1824,382316,2014-08-13,2014,CLE,ARI,0,1,1-0,ARI,12,0,46,48,94,157,215,372,13,13,26,4,4:16
1825,382316,2014-08-13,2014,CLE,ARI,0,1,1-0,ARI,12,0,46,48,94,157,215,372,13,13,26,4,4:16
1826,382354,2014-08-14,2014,TEX,TBA,3,6,6-3,TBA,9,0,33,39,72,167,135,302,6,12,18,2,3:02
1827,382347,2014-08-14,2014,COL,CIN,7,3,7-3,COL,9,1,37,33,70,124,130,254,13,7,20,1,2:53
1828,382351,2014-08-14,2014,KCA,OAK,7,3,7-3,KCA,9,1,36,40,76,151,132,283,13,13,26,5,3:13
1829,382355,2014-08-14,2014,NYN,WAS,1,4,4-1,WAS,9,0,31,39,70,144,133,277,5,12,17,1,2:53
1830,382353,2014-08-14,2014,SLN,SDN,4,3,4-3,SLN,9,1,33,38,71,143,122,265,11,13,24,1,2:44
1831,382350,2014-08-14,2014,CHN,MIL,2,6,6-2,MIL,9,0,34,39,73,150,156,306,6,13,19,1,3:06
1832,382346,2014-08-14,2014,MIA,ARI,5,4,5-4,MIA,10,0,43,41,84,168,175,343,20,12,32,1,3:31
1833,382349,2014-08-14,2014,ATL,LAN,4,6,6-4,LAN,9,0,40,41,81,138,189,327,15,18,33,3,3:39
1834,382352,2014-08-14,2014,DET,PIT,5,2,5-2,DET,9,1,35,33,68,138,141,279,13,7,20,1,2:55
1835,382348,2014-08-14,2014,BOS,HOU,9,4,9-4,BOS,9,1,40,37,77,140,157,297,18,12,30,2,3:19
1836,382364,2014-08-15,2014,TBA,NYA,5,0,5-0,TBA,9,1,34,34,68,135,125,260,9,8,17,2,2:42
1837,382362,2014-08-15,2014,MIN,KCA,5,6,6-5,KCA,9,0,37,40,77,126,143,269,10,14,24,4,3:05
1838,382356,2014-08-15,2014,TEX,ANA,4,5,5-4,ANA,9,0,37,40,77,167,141,308,12,14,26,4,3:18
1839,382357,2014-08-15,2014,MIA,ARI,2,3,3-2,ARI,9,0,36,35,71,130,145,275,13,8,21,2,2:55
1840,382365,2014-08-15,2014,ATL,OAK,7,2,7-2,ATL,9,1,37,32,69,137,132,269,12,7,19,1,2:37
1841,382369,2014-08-15,2014,DET,SEA,2,7,7-2,SEA,9,0,35,37,72,142,142,284,8,13,21,0,2:51
1842,382368,2014-08-15,2014,SLN,SDN,4,2,4-2,SLN,9,1,37,37,74,151,145,296,14,10,24,1,3:00
1843,382358,2014-08-15,2014,CLE,BAL,2,1,2-1,CLE,11,0,38,44,82,159,138,297,9,10,19,4,3:36
1844,382359,2014-08-15,2014,NYN,CHN,3,2,3-2,NYN,9,1,33,36,69,162,139,301,11,10,21,2,3:04
1845,382363,2014-08-15,2014,LAN,MIL,3,6,6-3,MIL,9,0,35,43,78,156,125,281,10,19,29,1,3:31
1846,382361,2014-08-15,2014,BOS,HOU,3,5,5-3,HOU,10,0,38,45,83,165,145,310,10,15,25,4,3:46
1847,382366,2014-08-15,2014,SFN,PHI,3,5,5-3,PHI,10,0,40,41,81,176,143,319,13,11,24,3,3:36
1848,382370,2014-08-15,2014,CHA,TOR,11,5,11-5,CHA,9,1,45,38,83,149,179,328,23,11,34,4,3:22
1849,382367,2014-08-15,2014,WAS,PIT,5,4,5-4,WAS,9,1,36,37,73,147,143,290,15,10,25,1,3:05
1850,382360,2014-08-15,2014,COL,CIN,2,3,3-2,CIN,9,0,35,39,74,143,119,262,11,13,24,1,3:02
1851,382373,2014-08-16,2014,CLE,BAL,6,0,6-0,CLE,9,1,35,30,65,105,150,255,11,4,15,2,2:39
1852,382372,2014-08-16,2014,MIA,ARI,2,1,2-1,MIA,9,1,30,32,62,119,118,237,6,7,13,0,2:25
1853,382374,2014-08-16,2014,NYN,CHN,7,3,7-3,NYN,9,1,35,36,71,125,128,253,11,9,20,3,2:39
1854,382384,2014-08-16,2014,DET,SEA,4,2,4-2,DET,9,1,39,33,72,122,147,269,15,8,23,1,2:55
1855,382377,2014-08-16,2014,MIN,KCA,4,1,4-1,MIN,9,1,37,35,72,125,137,262,13,9,22,2,2:37
1856,382382,2014-08-16,2014,WAS,PIT,4,3,4-3,WAS,9,0,34,36,70,145,134,279,13,11,24,1,2:49
1857,382379,2014-08-16,2014,TBA,NYA,2,3,3-2,NYA,9,0,36,33,69,146,138,284,9,8,17,1,2:59
1858,382385,2014-08-16,2014,CHA,TOR,3,6,6-3,TOR,9,0,35,40,75,150,127,277,10,14,24,4,2:54
1859,382380,2014-08-16,2014,ATL,OAK,4,3,4-3,ATL,9,1,34,36,70,163,133,296,11,10,21,2,3:11
1860,382381,2014-08-16,2014,SFN,PHI,6,5,6-5,SFN,9,1,39,43,82,164,133,297,14,19,33,6,3:34
1861,382376,2014-08-16,2014,BOS,HOU,10,7,10-7,BOS,9,1,41,44,85,174,161,335,18,18,36,4,3:50
1862,382378,2014-08-16,2014,LAN,MIL,2,3,3-2,MIL,9,0,34,32,66,97,113,210,8,5,13,0,2:28
1863,382371,2014-08-16,2014,TEX,ANA,4,5,5-4,ANA,9,0,37,38,75,135,153,288,10,11,21,2,3:03
1864,382383,2014-08-16,2014,SLN,SDN,5,9,9-5,SDN,9,0,39,44,83,182,155,337,12,21,33,2,3:28 (1:46 delay)
1865,382395,2014-08-17,2014,ATL,OAK,4,3,4-3,ATL,9,1,30,34,64,142,125,267,7,7,14,2,2:49
1866,382393,2014-08-17,2014,LAN,MIL,2,7,7-2,MIL,9,0,38,38,76,138,152,290,11,11,22,0,2:55
1867,382396,2014-08-17,2014,SFN,PHI,5,2,5-2,SFN,9,1,37,39,76,156,130,286,13,14,27,2,2:57
1868,382391,2014-08-17,2014,BOS,HOU,1,8,8-1,HOU,9,0,37,42,79,154,153,307,12,17,29,0,3:11
1869,382375,2014-08-17,2014,COL,CIN,10,5,10-5,COL,9,1,42,36,78,134,153,287,19,9,28,2,3:06
1870,382392,2014-08-17,2014,MIN,KCA,6,12,12-6,KCA,9,0,37,44,81,151,137,288,10,17,27,1,2:51 (1:28 delay)
1871,382375,2014-08-17,2014,COL,CIN,10,5,10-5,COL,9,1,42,36,78,134,153,287,19,9,28,2,3:06
1872,382399,2014-08-17,2014,DET,SEA,1,8,8-1,SEA,9,0,36,46,82,162,157,319,10,18,28,1,3:18
1873,382397,2014-08-17,2014,WAS,PIT,6,5,6-5,WAS,11,0,47,46,93,159,164,323,15,13,28,2,3:42
1874,382386,2014-08-17,2014,TEX,ANA,3,2,3-2,TEX,9,0,33,37,70,118,134,252,10,13,23,2,2:51
1875,382389,2014-08-17,2014,NYN,CHN,1,2,2-1,CHN,9,0,32,35,67,129,131,260,6,10,16,2,2:55
1876,382388,2014-08-17,2014,CLE,BAL,1,4,4-1,BAL,9,0,32,41,73,161,131,292,7,14,21,5,3:11
1877,382398,2014-08-17,2014,SLN,SDN,7,6,7-6,SLN,9,1,36,40,76,151,134,285,13,13,26,2,2:56
1878,382400,2014-08-17,2014,CHA,TOR,7,5,7-5,CHA,9,1,33,43,76,159,108,267,12,18,30,2,3:00
1879,382394,2014-08-17,2014,TBA,NYA,2,4,4-2,NYA,9,0,33,39,72,159,128,287,6,10,16,1,3:13
1880,382390,2014-08-17,2014,COL,CIN,10,9,10-9,COL,9,0,47,44,91,178,191,369,23,17,40,2,3:59 (:21 delay)
1881,382387,2014-08-17,2014,MIA,ARI,10,3,10-3,MIA,9,1,40,38,78,137,170,307,16,12,28,1,2:56
1882,382403,2014-08-18,2014,PIT,ATL,3,7,7-3,ATL,9,0,37,43,80,150,132,282,12,17,29,3,3:00
1883,382408,2014-08-18,2014,PHI,SEA,4,1,4-1,PHI,9,1,39,35,74,137,150,287,16,10,26,2,2:52
1884,382407,2014-08-18,2014,MIN,KCA,4,6,6-4,KCA,9,0,35,43,78,161,150,311,8,18,26,2,3:09
1885,382406,2014-08-18,2014,SLN,CIN,6,5,6-5,SLN,10,0,41,43,84,166,135,301,14,14,28,2,3:19
1886,382404,2014-08-18,2014,CHA,BAL,2,8,8-2,BAL,9,0,30,42,72,179,105,284,4,16,20,3,3:02
1887,382405,2014-08-18,2014,NYN,CHN,1,4,4-1,CHN,9,0,32,40,72,167,128,295,6,13,19,2,2:53
1888,382402,2014-08-18,2014,WAS,ARI,5,4,5-4,WAS,11,0,40,45,85,162,142,304,10,14,24,1,3:16
1889,382401,2014-08-18,2014,BOS,ANA,2,4,4-2,ANA,9,0,41,36,77,127,171,298,15,12,27,1,3:22
1890,382410,2014-08-19,2014,WAS,ARI,8,1,8-1,WAS,9,1,40,29,69,109,151,260,17,4,21,1,2:50
1891,382412,2014-08-19,2014,CHA,BAL,1,5,5-1,BAL,9,0,31,36,67,130,119,249,4,9,13,0,2:42
1892,382420,2014-08-19,2014,PHI,SEA,2,5,5-2,SEA,9,0,35,40,75,153,127,280,8,14,22,3,3:06
1893,382414,2014-08-19,2014,MIN,CLE,5,7,7-5,CLE,9,0,37,38,75,140,155,295,10,14,24,7,3:14
1894,382411,2014-08-19,2014,PIT,ATL,3,11,11-3,ATL,9,0,36,46,82,162,121,283,9,18,27,2,2:50
1895,382413,2014-08-19,2014,SLN,CIN,5,4,5-4,SLN,9,0,42,37,79,131,167,298,21,8,29,3,3:29
1896,382418,2014-08-19,2014,OAK,NYN,6,2,6-2,OAK,9,1,37,36,73,152,163,315,14,10,24,2,3:02
1897,382417,2014-08-19,2014,COL,KCA,4,7,7-4,KCA,9,0,41,42,83,158,149,307,16,16,32,3,3:12
1898,382419,2014-08-19,2014,LAN,SDN,8,6,8-6,LAN,9,1,36,40,76,148,147,295,11,16,27,3,3:23
1899,382423,2014-08-19,2014,MIL,TOR,6,1,6-1,MIL,9,1,37,30,67,129,120,249,12,3,15,1,2:39
1900,382422,2014-08-19,2014,MIA,TEX,4,3,4-3,MIA,10,0,48,45,93,173,190,363,22,17,39,4,3:59
1901,382415,2014-08-19,2014,TBA,DET,6,8,8-6,DET,11,0,50,53,103,215,204,419,18,22,40,3,4:42
1902,382416,2014-08-19,2014,NYA,HOU,4,7,7-4,HOU,9,0,37,44,81,170,149,319,10,18,28,3,3:38
1903,382409,2014-08-19,2014,BOS,ANA,3,4,4-3,ANA,9,0,40,37,77,138,169,307,14,12,26,1,3:24
1904,382421,2014-08-19,2014,CHN,SFN,2,1,2-1,CHN,9,1,30,37,67,147,132,279,6,11,17,0,2:50 (6:31 delay)
1905,382421,2014-08-19,2014,CHN,SFN,2,1,2-1,CHN,9,1,30,37,67,147,132,279,6,11,17,0,2:50 (6:31 delay)
1906,382430,2014-08-20,2014,TBA,DET,0,6,6-0,DET,9,0,30,38,68,147,104,251,3,10,13,1,2:37
1907,382427,2014-08-20,2014,CHA,BAL,3,4,4-3,BAL,9,0,34,34,68,133,107,240,7,8,15,1,2:37
1908,382425,2014-08-20,2014,WAS,ARI,3,2,3-2,WAS,9,0,36,36,72,143,140,283,14,11,25,2,3:04 (:12 delay)
1909,382432,2014-08-20,2014,COL,KCA,5,2,5-2,COL,9,1,32,31,63,116,111,227,7,8,15,0,2:37
1910,382437,2014-08-20,2014,MIA,TEX,4,5,5-4,TEX,9,0,38,35,73,143,140,283,13,12,25,0,2:55
1911,382426,2014-08-20,2014,PIT,ATL,3,2,3-2,PIT,9,0,32,34,66,118,130,248,7,10,17,1,2:45
1912,382438,2014-08-20,2014,MIL,TOR,5,9,9-5,TOR,9,0,41,43,84,166,152,318,16,18,34,4,3:23
1913,382433,2014-08-20,2014,OAK,NYN,5,8,8-5,NYN,9,0,40,42,82,169,165,334,12,16,28,6,3:20
1914,382428,2014-08-20,2014,SLN,CIN,7,3,7-3,SLN,9,1,41,39,80,141,150,291,18,13,31,4,3:12 (:58 delay)
1915,382434,2014-08-20,2014,LAN,SDN,1,4,4-1,SDN,9,0,35,39,74,155,147,302,10,14,24,0,3:13
1916,382436,2014-08-20,2014,CHN,SFN,3,8,8-3,SFN,9,0,35,43,78,163,134,297,11,17,28,1,3:11
1917,382431,2014-08-20,2014,NYA,HOU,2,5,5-2,HOU,9,0,39,38,77,143,161,304,13,11,24,3,3:29
1918,382424,2014-08-20,2014,BOS,ANA,3,8,8-3,ANA,9,0,40,41,81,149,169,318,13,14,27,1,3:42
1919,382435,2014-08-20,2014,PHI,SEA,4,3,4-3,PHI,9,1,38,40,78,157,140,297,14,14,28,0,3:00
1920,382429,2014-08-20,2014,MIN,CLE,0,5,5-0,CLE,9,0,36,38,74,148,130,278,9,13,22,3,3:02
1921,382445,2014-08-21,2014,LAN,SDN,2,1,2-1,LAN,9,1,28,32,60,119,97,216,6,6,12,0,2:23
1922,382443,2014-08-21,2014,TBA,DET,1,0,1-0,TBA,9,1,26,32,58,137,100,237,1,7,8,0,2:34
1923,382440,2014-08-21,2014,WAS,ARI,1,0,1-0,WAS,9,0,38,32,70,121,136,257,17,8,25,2,2:51
1924,382439,2014-08-21,2014,BOS,ANA,0,2,2-0,ANA,9,0,30,39,69,158,132,290,3,15,18,3,3:10
1925,382444,2014-08-21,2014,NYA,HOU,3,0,3-0,NYA,9,1,30,31,61,107,96,203,7,4,11,0,2:07
1926,382441,2014-08-21,2014,CIN,ATL,0,8,8-0,ATL,9,0,32,45,77,190,119,309,6,19,25,1,3:10
1927,382442,2014-08-21,2014,MIN,CLE,4,1,4-1,MIN,9,1,35,33,68,131,129,260,13,6,19,1,2:54
1928,382446,2014-08-21,2014,CHN,SFN,3,5,5-3,SFN,9,0,37,40,77,153,142,295,10,14,24,1,3:16
1929,382457,2014-08-22,2014,ARI,SDN,5,1,5-1,ARI,9,1,35,30,65,109,128,237,9,4,13,1,2:21
1930,382455,2014-08-22,2014,LAN,NYN,6,2,6-2,LAN,9,1,38,32,70,121,140,261,15,7,22,3,2:40
1931,382450,2014-08-22,2014,NYA,CHA,4,3,4-3,NYA,9,0,41,37,78,135,160,295,17,14,31,4,3:23
1932,382453,2014-08-22,2014,TEX,KCA,3,6,6-3,KCA,9,0,38,40,78,158,157,315,11,11,22,2,3:09
1933,382456,2014-08-22,2014,MIL,PIT,3,8,8-3,PIT,9,0,39,42,81,165,149,314,14,15,29,0,3:14
1934,382449,2014-08-22,2014,CHN,BAL,4,1,4-1,CHN,9,1,33,33,66,123,140,263,9,7,16,1,2:48
1935,382460,2014-08-22,2014,PHI,SLN,5,4,5-4,PHI,9,1,34,35,69,126,134,260,11,9,20,2,2:48
1936,382452,2014-08-22,2014,CLE,HOU,1,5,5-1,HOU,9,0,31,35,66,137,121,258,5,7,12,1,3:01
1937,382461,2014-08-22,2014,TOR,TBA,0,8,8-0,TBA,9,0,28,47,75,186,105,291,2,20,22,1,2:45
1938,382451,2014-08-22,2014,MIN,DET,20,6,20-6,MIN,9,1,55,44,99,172,214,386,29,17,46,7,3:59
1939,382459,2014-08-22,2014,WAS,SFN,3,10,10-3,SFN,9,0,36,43,79,172,159,331,10,16,26,2,3:24
1940,382458,2014-08-22,2014,BOS,SEA,3,5,5-3,SEA,9,0,36,40,76,180,168,348,11,15,26,3,3:41
1941,382447,2014-08-22,2014,OAK,ANA,5,3,5-3,OAK,9,1,35,36,71,128,147,275,12,11,23,1,2:53
1942,382448,2014-08-22,2014,CIN,ATL,1,3,3-1,ATL,12,0,44,52,96,196,184,380,9,18,27,2,4:22
1943,382454,2014-08-22,2014,COL,MIA,5,13,13-5,MIA,9,0,41,52,93,199,147,346,15,27,42,2,3:36
1944,382474,2014-08-23,2014,WAS,SFN,6,2,6-2,WAS,9,1,34,34,68,115,135,250,10,9,19,1,2:38 (1:12 delay)
1945,382472,2014-08-23,2014,ARI,SDN,5,2,5-2,ARI,9,1,37,32,69,114,134,248,14,6,20,1,2:31
1946,382476,2014-08-23,2014,TOR,TBA,5,4,5-4,TOR,10,0,37,42,79,142,161,303,10,14,24,4,3:19
1947,382467,2014-08-23,2014,CLE,HOU,3,2,3-2,CLE,9,0,38,32,70,139,166,305,13,6,19,3,3:18
1948,382468,2014-08-23,2014,TEX,KCA,3,6,6-3,KCA,9,0,33,36,69,130,132,262,9,12,21,2,2:37
1949,382462,2014-08-23,2014,OAK,ANA,2,1,2-1,OAK,9,1,32,34,66,130,134,264,11,7,18,1,3:00
1950,382463,2014-08-23,2014,CIN,ATL,1,0,1-0,CIN,9,1,31,32,63,146,129,275,7,6,13,1,2:47 (1:56 delay)
1951,380910,2014-08-23,2014,MIN,DET,12,4,12-4,MIN,9,1,45,39,84,145,184,329,22,12,34,2,3:12
1952,382464,2014-08-23,2014,CHN,BAL,7,2,7-2,CHN,9,1,37,34,71,139,156,295,13,9,22,1,3:09 (3:09 delay)
1953,382473,2014-08-23,2014,BOS,SEA,3,7,7-3,SEA,9,0,41,38,79,145,183,328,16,12,28,3,3:28
1954,382471,2014-08-23,2014,MIL,PIT,2,10,10-2,PIT,9,0,42,44,86,169,138,307,17,17,34,1,3:17
1955,380910,2014-08-23,2014,MIN,DET,12,4,12-4,MIN,9,1,45,39,84,145,184,329,22,12,34,2,3:12
1956,382475,2014-08-23,2014,PHI,SLN,5,6,6-5,SLN,12,0,49,57,106,221,198,419,13,23,36,4,4:53
1957,382466,2014-08-23,2014,MIN,DET,6,8,8-6,DET,9,0,40,43,83,148,146,294,14,18,32,3,3:23
1958,382470,2014-08-23,2014,LAN,NYN,7,4,7-4,LAN,9,1,34,39,73,142,117,259,10,14,24,2,2:51
1959,382469,2014-08-23,2014,COL,MIA,5,4,5-4,COL,13,0,50,58,108,219,180,399,18,19,37,3,4:28
1960,382465,2014-08-23,2014,NYA,CHA,5,3,5-3,NYA,9,1,33,38,71,147,105,252,11,11,22,1,2:54
1961,382479,2014-08-24,2014,CHN,BAL,2,1,2-1,CHN,9,1,31,31,62,129,116,245,7,4,11,2,2:37
1962,382486,2014-08-24,2014,MIL,PIT,4,3,4-3,MIL,9,1,35,33,68,138,103,241,14,6,20,1,2:40
1963,382484,2014-08-24,2014,COL,MIA,7,4,7-4,COL,9,1,40,39,79,125,142,267,19,13,32,4,3:07
1964,382485,2014-08-24,2014,LAN,NYN,3,11,11-3,NYN,9,0,36,42,78,134,152,286,11,14,25,1,3:02
1965,382477,2014-08-24,2014,OAK,ANA,4,9,9-4,ANA,9,0,37,42,79,148,141,289,10,17,27,2,3:05
1966,382480,2014-08-24,2014,NYA,CHA,7,4,7-4,NYA,10,0,42,39,81,146,166,312,16,10,26,2,3:17
1967,382478,2014-08-24,2014,CIN,ATL,5,3,5-3,CIN,9,1,36,40,76,165,148,313,13,15,28,3,3:13
1968,382488,2014-08-24,2014,BOS,SEA,6,8,8-6,SEA,9,0,48,40,88,152,198,350,22,17,39,6,4:07
1969,382490,2014-08-24,2014,PHI,SLN,7,1,7-1,PHI,9,1,34,36,70,122,122,244,10,9,19,1,2:33
1970,382483,2014-08-24,2014,TEX,KCA,3,1,3-1,TEX,9,1,38,34,72,121,136,257,17,7,24,0,2:46
1971,382491,2014-08-24,2014,TOR,TBA,1,2,2-1,TBA,10,0,39,42,81,171,138,309,9,13,22,1,3:28
1972,382482,2014-08-24,2014,CLE,HOU,3,1,3-1,CLE,9,1,35,39,74,177,122,299,11,14,25,2,3:14
1973,382481,2014-08-24,2014,MIN,DET,4,13,13-4,DET,9,0,43,53,96,196,202,398,16,28,44,3,4:10
1974,382487,2014-08-24,2014,ARI,SDN,4,7,7-4,SDN,9,0,41,40,81,152,154,306,14,14,28,3,3:10
1975,382489,2014-08-24,2014,WAS,SFN,14,6,14-6,WAS,9,1,46,41,87,139,185,324,24,14,38,3,3:46
1976,382493,2014-08-25,2014,SFN,COL,2,3,3-2,COL,9,0,35,34,69,122,127,249,12,7,19,0,2:47
1977,382497,2014-08-25,2014,PIT,SLN,2,3,3-2,SLN,9,0,34,37,71,134,121,255,11,12,23,2,2:55
1978,382495,2014-08-25,2014,SDN,MIL,1,10,10-1,MIL,9,0,36,49,85,175,133,308,12,23,35,2,3:10
1979,382496,2014-08-25,2014,HOU,OAK,2,8,8-2,OAK,9,0,35,42,77,164,129,293,9,15,24,1,3:18
1980,382500,2014-08-25,2014,PHI,WAS,3,2,3-2,PHI,9,1,31,36,67,137,134,271,10,9,19,0,2:46
1981,382492,2014-08-25,2014,TOR,BOS,3,4,4-3,BOS,10,0,37,40,77,168,127,295,8,11,19,1,3:07
1982,381492,2014-08-25,2014,KCA,NYA,1,8,8-1,NYA,9,0,33,41,74,141,121,262,7,16,23,3,3:02
1983,381492,2014-08-25,2014,KCA,NYA,1,8,8-1,NYA,9,0,33,41,74,141,121,262,7,16,23,3,3:02
1984,382499,2014-08-25,2014,SEA,TEX,0,2,2-0,TEX,9,0,30,37,67,153,109,262,5,11,16,0,2:50
1985,382494,2014-08-25,2014,ANA,MIA,1,7,7-1,MIA,9,0,36,43,79,167,130,297,9,17,26,2,2:57
1986,382498,2014-08-25,2014,BAL,TBA,9,1,9-1,BAL,9,1,40,32,72,112,163,275,16,6,22,1,2:56
1987,382505,2014-08-26,2014,SFN,COL,3,0,3-0,SFN,9,1,32,28,60,103,119,222,7,1,8,2,2:33
1988,382514,2014-08-26,2014,SEA,TEX,5,0,5-0,SEA,9,1,36,34,70,151,141,292,12,8,20,1,2:51
1989,382508,2014-08-26,2014,SDN,MIL,4,1,4-1,SDN,9,1,36,31,67,135,143,278,11,7,18,1,2:57
1990,382509,2014-08-26,2014,KCA,MIN,2,1,2-1,KCA,9,0,30,31,61,126,114,240,8,7,15,1,2:38
1991,382501,2014-08-26,2014,NYN,ATL,3,2,3-2,NYN,9,1,30,33,63,125,120,245,7,10,17,1,2:27
1992,382510,2014-08-26,2014,DET,NYA,5,2,5-2,DET,9,1,34,34,68,110,106,216,12,9,21,1,2:30 (1:08 delay)
1993,382515,2014-08-26,2014,PHI,WAS,4,3,4-3,PHI,9,1,31,35,66,106,107,213,8,9,17,1,2:24
1994,382512,2014-08-26,2014,PIT,SLN,5,2,5-2,PIT,9,1,37,36,73,156,129,285,13,9,22,1,2:56
1995,382507,2014-08-26,2014,ANA,MIA,8,2,8-2,ANA,9,1,42,37,79,150,135,285,19,10,29,2,3:01
1996,382503,2014-08-26,2014,CIN,CHN,0,3,3-0,CHN,9,0,32,37,69,129,138,267,5,10,15,1,2:42 (:50 delay)
1997,382511,2014-08-26,2014,HOU,OAK,4,2,4-2,HOU,9,1,32,37,69,150,104,254,7,9,16,0,2:36
1998,382513,2014-08-26,2014,BAL,TBA,4,2,4-2,BAL,9,1,37,38,75,157,162,319,13,13,26,2,3:37
1999,382504,2014-08-26,2014,CHA,CLE,6,8,8-6,CLE,10,0,40,46,86,188,149,337,14,19,33,8,3:48
2000,382506,2014-08-26,2014,ARI,LAN,5,9,9-5,LAN,9,0,41,42,83,155,142,297,14,18,32,3,3:22
2001,382502,2014-08-26,2014,TOR,BOS,7,11,11-7,BOS,11,0,53,53,106,226,213,439,22,18,40,6,4:33
2002,382517,2014-08-27,2014,TOR,BOS,5,2,5-2,TOR,9,1,33,33,66,126,123,249,9,7,16,3,2:38
2003,382516,2014-08-27,2014,NYN,ATL,2,3,3-2,ATL,9,0,36,34,70,130,144,274,10,9,19,1,2:48
2004,382530,2014-08-27,2014,PHI,WAS,8,4,8-4,PHI,9,1,42,36,78,148,144,292,20,10,30,2,3:04 (:38 delay)
2005,382524,2014-08-27,2014,KCA,MIN,6,1,6-1,KCA,9,1,33,32,65,121,109,230,10,5,15,2,2:27
2006,382527,2014-08-27,2014,PIT,SLN,3,1,3-1,PIT,9,1,36,35,71,114,132,246,12,9,21,1,2:43
2007,382528,2014-08-27,2014,BAL,TBA,1,3,3-1,TBA,9,0,31,36,67,135,107,242,3,9,12,0,2:44
2008,382529,2014-08-27,2014,SEA,TEX,4,12,12-4,TEX,9,0,34,40,74,128,112,240,8,13,21,1,2:24
2009,382519,2014-08-27,2014,CHA,CLE,3,2,3-2,CHA,9,1,35,35,70,135,131,266,12,9,21,4,3:07
2010,382525,2014-08-27,2014,DET,NYA,4,8,8-4,NYA,9,0,39,42,81,174,141,315,11,17,28,1,3:29
2011,382521,2014-08-27,2014,ARI,LAN,1,3,3-1,LAN,9,0,35,38,73,144,121,265,8,14,22,1,2:55
2012,382522,2014-08-27,2014,ANA,MIA,6,1,6-1,ANA,9,1,39,35,74,148,134,282,12,9,21,2,2:51
2013,382523,2014-08-27,2014,SDN,MIL,3,2,3-2,SDN,10,0,43,37,80,140,193,333,17,7,24,0,3:36
2014,382518,2014-08-27,2014,CIN,CHN,7,5,7-5,CIN,9,1,39,38,77,143,136,279,16,13,29,3,3:19
2015,382526,2014-08-27,2014,HOU,OAK,4,5,5-4,OAK,9,0,40,42,82,172,160,332,14,18,32,6,3:43
2016,382520,2014-08-27,2014,SFN,COL,4,2,4-2,SFN,9,0,39,33,72,102,152,254,13,9,22,1,2:54
2017,382534,2014-08-28,2014,SFN,COL,4,1,4-1,SFN,9,1,36,32,68,118,150,268,12,7,19,0,2:50
2018,382533,2014-08-28,2014,CHA,CLE,2,3,3-2,CLE,9,0,35,40,75,165,143,308,7,14,21,3,3:18
2019,382538,2014-08-28,2014,BAL,TBA,5,4,5-4,BAL,9,1,38,36,74,138,148,286,16,10,26,3,3:26
2020,382531,2014-08-28,2014,NYN,ATL,1,6,6-1,ATL,9,0,31,39,70,128,122,250,5,14,19,3,2:31
2021,382536,2014-08-28,2014,DET,NYA,3,2,3-2,DET,9,0,35,33,68,131,131,262,9,7,16,2,2:54
2022,382539,2014-08-28,2014,HOU,TEX,4,2,4-2,HOU,9,1,35,35,70,132,146,278,13,9,22,1,3:04
2023,382537,2014-08-28,2014,ANA,OAK,4,3,4-3,ANA,10,0,41,41,82,168,148,316,15,13,28,3,3:44
2024,382535,2014-08-28,2014,KCA,MIN,5,11,11-5,MIN,10,0,46,49,95,181,173,354,17,20,37,4,3:50
2025,382532,2014-08-28,2014,CIN,CHN,7,2,7-2,CIN,9,1,41,34,75,151,166,317,16,9,25,0,3:14
2026,382542,2014-08-29,2014,PIT,CIN,2,1,2-1,PIT,9,1,31,34,65,130,94,224,9,9,18,1,2:30
2027,382547,2014-08-29,2014,ATL,MIA,5,2,5-2,ATL,9,1,36,35,71,140,141,281,13,11,24,2,3:01
2028,382552,2014-08-29,2014,NYN,PHI,4,1,4-1,NYN,9,1,32,35,67,138,104,242,8,7,15,2,2:31
2029,382549,2014-08-29,2014,BAL,MIN,9,1,9-1,BAL,9,1,36,32,68,128,136,264,12,5,17,1,2:40
2030,382551,2014-08-29,2014,ANA,OAK,4,0,4-0,ANA,9,1,34,36,70,136,129,265,8,9,17,0,2:54
2031,382545,2014-08-29,2014,CHA,DET,1,7,7-1,DET,9,0,39,41,80,161,140,301,14,13,27,3,3:28
2032,382543,2014-08-29,2014,KCA,CLE,1,6,6-1,CLE,9,0,40,41,81,176,136,312,13,15,28,2,3:17 (:44 delay)
2033,382553,2014-08-29,2014,HOU,TEX,6,13,13-6,TEX,9,0,40,44,84,153,157,310,16,19,35,2,3:16
2034,382550,2014-08-29,2014,TOR,NYA,3,6,6-3,NYA,9,0,38,40,78,151,152,303,11,13,24,5,3:20
2035,382554,2014-08-29,2014,SEA,WAS,3,8,8-3,WAS,9,0,38,41,79,148,147,295,11,16,27,1,2:55
2036,382540,2014-08-29,2014,TBA,BOS,4,8,8-4,BOS,9,0,40,45,85,173,146,319,13,17,30,0,3:34
2037,382548,2014-08-29,2014,SFN,MIL,13,2,13-2,SFN,9,1,49,32,81,110,198,308,26,6,32,1,3:17
2038,382544,2014-08-29,2014,ARI,COL,5,2,5-2,ARI,9,1,34,32,66,126,145,271,12,6,18,4,2:54
2039,382546,2014-08-29,2014,SDN,LAN,3,2,3-2,SDN,12,0,49,49,98,198,182,380,15,14,29,2,4:12
2040,382541,2014-08-29,2014,SLN,CHN,2,7,7-2,CHN,9,0,38,37,75,128,141,269,10,11,21,1,2:52
2041,382557,2014-08-30,2014,PIT,CIN,3,2,3-2,PIT,9,1,29,32,61,126,108,234,7,6,13,1,2:34
2042,382566,2014-08-30,2014,ANA,OAK,2,0,2-0,ANA,9,1,29,31,60,149,102,251,4,6,10,1,2:46
2043,382565,2014-08-30,2014,TOR,NYA,2,0,2-0,TOR,9,1,32,32,64,131,119,250,8,5,13,1,2:32
2044,382563,2014-08-30,2014,SFN,MIL,3,1,3-1,SFN,9,1,36,34,70,134,133,267,13,9,22,2,2:57
2045,382560,2014-08-30,2014,CHA,DET,4,8,8-4,DET,9,0,37,43,80,151,158,309,11,19,30,4,3:23
2046,382567,2014-08-30,2014,NYN,PHI,2,7,7-2,PHI,9,0,35,41,76,143,140,283,9,16,25,3,2:58
2047,381134,2014-08-30,2014,SLN,CHN,1,5,5-1,CHN,9,0,34,35,69,134,117,251,9,9,18,1,2:40
2048,382555,2014-08-30,2014,TBA,BOS,7,0,7-0,TBA,9,1,38,32,70,122,137,259,14,6,20,1,2:48 (:12 delay)
2049,381134,2014-08-30,2014,SLN,CHN,1,5,5-1,CHN,9,0,34,35,69,134,117,251,9,9,18,1,2:40
2050,382559,2014-08-30,2014,ARI,COL,0,2,2-0,COL,9,0,36,30,66,115,142,257,9,3,12,2,2:37
2051,382564,2014-08-30,2014,BAL,MIN,3,2,3-2,BAL,9,1,37,40,77,153,139,292,13,13,26,1,3:12
2052,382562,2014-08-30,2014,ATL,MIA,0,4,4-0,MIA,9,0,34,42,76,158,127,285,10,13,23,3,2:54
2053,382558,2014-08-30,2014,KCA,CLE,2,3,3-2,CLE,11,0,51,42,93,173,214,387,20,10,30,5,4:23
2054,382556,2014-08-30,2014,SLN,CHN,13,2,13-2,SLN,9,1,42,37,79,142,146,288,20,10,30,2,3:16
2055,382561,2014-08-30,2014,SDN,LAN,2,1,2-1,SDN,10,0,35,41,76,155,132,287,10,11,21,1,3:20
2056,382569,2014-08-30,2014,SEA,WAS,1,3,3-1,WAS,9,0,35,36,71,141,116,257,8,11,19,2,2:54
2057,382568,2014-08-30,2014,HOU,TEX,2,0,2-0,HOU,9,1,33,30,63,115,122,237,9,4,13,1,2:25
2058,381500,2014-08-30,2014,CHA,DET,6,3,6-3,CHA,9,1,36,37,73,153,133,286,11,12,23,3,2:54
2059,381500,2014-08-30,2014,CHA,DET,6,3,6-3,CHA,9,1,36,37,73,153,133,286,11,12,23,3,2:54
2060,382580,2014-08-31,2014,TOR,NYA,4,3,4-3,TOR,9,1,32,38,70,136,119,255,9,12,21,1,2:28
2061,382574,2014-08-31,2014,ARI,COL,6,2,6-2,ARI,9,1,37,35,72,140,135,275,14,8,22,1,3:04
2062,382570,2014-08-31,2014,TBA,BOS,0,3,3-0,BOS,9,0,29,36,65,148,98,246,3,10,13,2,2:52
2063,382582,2014-08-31,2014,NYN,PHI,6,5,6-5,NYN,9,1,36,42,78,152,140,292,12,17,29,1,3:14
2064,382577,2014-08-31,2014,ATL,MIA,1,0,1-0,ATL,9,1,36,32,68,117,136,253,12,6,18,1,2:33
2065,382583,2014-08-31,2014,HOU,TEX,3,2,3-2,HOU,9,1,39,35,74,138,160,298,17,10,27,3,3:18
2066,382578,2014-08-31,2014,SFN,MIL,15,5,15-5,SFN,9,1,45,38,83,155,150,305,21,12,33,4,3:14
2067,382581,2014-08-31,2014,ANA,OAK,8,1,8-1,ANA,9,1,36,34,70,128,147,275,12,7,19,1,2:54
2068,382575,2014-08-31,2014,CHA,DET,6,2,6-2,CHA,9,1,41,33,74,126,127,253,13,7,20,2,3:04
2069,382571,2014-08-31,2014,SLN,CHN,9,6,9-6,SLN,9,1,41,42,83,142,160,302,19,16,35,4,3:26
2070,382572,2014-08-31,2014,PIT,CIN,2,3,3-2,CIN,9,0,35,37,72,142,127,269,10,10,20,1,3:01
2071,382579,2014-08-31,2014,BAL,MIN,12,8,12-8,BAL,9,1,47,43,90,174,150,324,26,18,44,6,3:33
2072,382576,2014-08-31,2014,SDN,LAN,1,7,7-1,LAN,9,0,31,44,75,186,104,290,5,20,25,2,3:04
2073,382573,2014-08-31,2014,KCA,CLE,3,4,4-3,CLE,10,0,38,44,82,174,129,303,10,13,23,1,3:24 (:58 delay)
2074,382573,2014-08-31,2014,KCA,CLE,3,4,4-3,CLE,10,0,38,44,82,174,129,303,10,13,23,1,3:24 (:58 delay)
2075,382584,2014-08-31,2014,SEA,WAS,5,3,5-3,SEA,9,1,35,36,71,138,119,257,13,8,21,3,2:57
2076,382588,2014-09-01,2014,CHN,MIL,4,2,4-2,CHN,9,1,33,33,66,123,115,238,13,8,21,2,2:47
2077,382592,2014-09-01,2014,SLN,PIT,5,4,5-4,SLN,9,1,36,42,78,167,121,288,14,16,30,3,3:08
2078,382593,2014-09-01,2014,OAK,SEA,6,1,6-1,OAK,9,1,39,31,70,126,140,266,16,5,21,2,2:30
2079,382585,2014-09-01,2014,SDN,ARI,3,1,3-1,SDN,9,1,40,35,75,145,152,297,18,8,26,1,3:03
2080,382589,2014-09-01,2014,BAL,MIN,4,6,6-4,MIN,9,0,34,36,70,122,109,231,6,9,15,1,2:36
2081,382591,2014-09-01,2014,ATL,PHI,0,7,7-0,PHI,9,0,33,41,74,152,147,299,6,17,23,2,3:10
2082,382596,2014-09-01,2014,LAN,WAS,4,6,6-4,WAS,9,0,36,38,74,161,124,285,9,12,21,3,3:12
2083,382586,2014-09-01,2014,TBA,BOS,4,3,4-3,TBA,10,0,39,37,76,161,162,323,13,9,22,4,3:32
2084,382587,2014-09-01,2014,CLE,DET,1,12,12-1,DET,9,0,37,50,87,177,133,310,11,26,37,2,3:31
2085,382590,2014-09-01,2014,MIA,NYN,9,6,9-6,MIA,9,1,41,39,80,155,176,331,19,13,32,4,3:32
2086,382595,2014-09-01,2014,KCA,TEX,4,3,4-3,KCA,9,1,35,34,69,122,118,240,12,9,21,2,2:31
2087,382594,2014-09-01,2014,COL,SFN,10,9,10-9,COL,9,0,46,43,89,156,160,316,19,19,38,4,3:44
2088,382605,2014-09-02,2014,ATL,PHI,0,4,4-0,PHI,9,0,32,38,70,139,126,265,7,11,18,1,2:57
2089,382609,2014-09-02,2014,KCA,TEX,2,1,2-1,KCA,9,1,32,36,68,137,130,267,9,12,21,2,3:00
2090,382603,2014-09-02,2014,CHN,MIL,7,1,7-1,CHN,9,1,38,37,75,144,144,288,13,13,26,0,3:12
2091,382610,2014-09-02,2014,TBA,TOR,2,8,8-2,TOR,9,0,34,42,76,179,134,313,7,16,23,2,3:07
2092,382601,2014-09-02,2014,BAL,CIN,5,4,5-4,BAL,9,1,32,38,70,148,113,261,11,11,22,2,3:07 (2:09 delay)
2093,382604,2014-09-02,2014,MIA,NYN,6,8,8-6,NYN,9,0,37,44,81,163,133,296,11,19,30,2,3:10
2094,382606,2014-09-02,2014,SLN,PIT,6,4,6-4,SLN,9,1,37,35,72,143,165,308,13,9,22,2,3:05
2095,382597,2014-09-02,2014,HOU,ANA,8,3,8-3,HOU,9,1,41,35,76,135,172,307,19,8,27,4,3:13
2096,382599,2014-09-02,2014,NYA,BOS,4,9,9-4,BOS,9,0,37,46,83,187,144,331,12,19,31,3,3:28
2097,382608,2014-09-02,2014,COL,SFN,7,12,12-7,SFN,9,0,39,46,85,153,155,308,13,19,32,4,3:37
2098,382600,2014-09-02,2014,MIN,CHA,3,6,6-3,CHA,10,0,37,45,82,196,143,339,11,18,29,4,3:35
2099,382602,2014-09-02,2014,CLE,DET,2,4,4-2,DET,9,0,40,43,83,175,162,337,14,18,32,6,3:52
2100,382607,2014-09-02,2014,OAK,SEA,5,6,6-5,SEA,9,0,35,35,70,121,124,245,12,10,22,2,2:42
2101,382598,2014-09-02,2014,SDN,ARI,2,1,2-1,SDN,9,0,34,33,67,138,107,245,12,7,19,0,2:28
2102,382611,2014-09-02,2014,LAN,WAS,4,1,4-1,LAN,9,1,36,33,69,123,133,256,13,5,18,2,2:40
2103,382622,2014-09-03,2014,OAK,SEA,1,2,2-1,SEA,9,0,31,34,65,118,110,228,5,8,13,0,2:20
2104,382613,2014-09-03,2014,SDN,ARI,1,6,6-1,ARI,9,0,32,39,71,137,113,250,7,11,18,2,2:43
2105,382614,2014-09-03,2014,NYA,BOS,5,1,5-1,NYA,9,1,36,33,69,132,147,279,15,7,22,1,3:12
2106,382616,2014-09-03,2014,BAL,CIN,6,0,6-0,BAL,9,1,33,33,66,117,142,259,10,5,15,1,2:36
2107,382623,2014-09-03,2014,COL,SFN,9,2,9-2,COL,9,1,41,35,76,108,143,251,17,10,27,1,2:53
2108,382617,2014-09-03,2014,CLE,DET,7,0,7-0,CLE,9,1,35,33,68,118,131,249,12,8,20,1,2:37
2109,382624,2014-09-03,2014,KCA,TEX,4,1,4-1,KCA,9,1,29,37,66,145,105,250,6,9,15,3,2:46
2110,382620,2014-09-03,2014,ATL,PHI,7,4,7-4,ATL,9,1,41,37,78,141,170,311,16,11,27,2,3:08
2111,382618,2014-09-03,2014,CHN,MIL,6,2,6-2,CHN,9,1,37,37,74,129,127,256,14,11,25,1,2:53
2112,382619,2014-09-03,2014,MIA,NYN,3,4,4-3,NYN,9,0,36,41,77,151,147,298,13,17,30,3,3:07
2113,382621,2014-09-03,2014,SLN,PIT,1,0,1-0,SLN,9,0,35,33,68,138,116,254,10,9,19,1,2:50
2114,382612,2014-09-03,2014,HOU,ANA,4,1,4-1,HOU,9,1,32,32,64,111,113,224,9,4,13,2,2:37
2115,382625,2014-09-03,2014,TBA,TOR,4,7,7-4,TOR,9,0,37,41,78,160,132,292,12,15,27,0,3:09 (:30 delay)
2116,382626,2014-09-03,2014,LAN,WAS,5,8,8-5,WAS,14,0,59,62,121,240,227,467,19,19,38,5,5:34
2117,382615,2014-09-03,2014,MIN,CHA,11,4,11-4,MIN,9,1,48,37,85,139,173,312,24,10,34,2,3:12 (:16 delay)
2118,382633,2014-09-04,2014,TBA,TOR,0,1,1-0,TOR,10,0,37,35,72,134,135,269,11,5,16,1,2:49
2119,382628,2014-09-04,2014,SDN,ARI,1,5,5-1,ARI,9,0,32,41,73,146,128,274,5,15,20,3,2:59
2120,382627,2014-09-04,2014,MIN,ANA,4,5,5-4,ANA,9,0,41,37,78,117,149,266,15,12,27,1,3:13
2121,382631,2014-09-04,2014,TEX,SEA,2,10,10-2,SEA,9,0,36,44,80,173,126,299,13,17,30,3,3:02
2122,382632,2014-09-04,2014,MIL,SLN,2,3,3-2,SLN,9,0,40,41,81,153,153,306,13,18,31,5,3:35
2123,382630,2014-09-04,2014,BAL,CIN,9,7,9-7,BAL,9,1,39,41,80,171,163,334,16,14,30,3,3:26
2124,381682,2014-09-04,2014,CLE,DET,4,11,11-4,DET,11,0,44,54,98,198,195,393,12,24,36,4,4:32
2125,382629,2014-09-04,2014,NYA,BOS,5,4,5-4,NYA,9,0,34,37,71,147,136,283,10,9,19,4,3:16
2126,382635,2014-09-05,2014,LAN,ARI,2,1,2-1,LAN,9,1,33,33,66,139,121,260,10,6,16,2,2:44
2127,382639,2014-09-05,2014,OAK,HOU,3,4,4-3,HOU,9,0,38,34,72,125,144,269,10,7,17,2,3:08
2128,382636,2014-09-05,2014,MIA,ATL,11,3,11-3,MIA,9,1,43,33,76,109,167,276,21,6,27,3,2:48
2129,382637,2014-09-05,2014,TBA,BAL,3,0,3-0,TBA,9,1,37,32,69,134,154,288,14,7,21,2,3:08
2130,382647,2014-09-05,2014,MIL,SLN,6,2,6-2,MIL,9,1,35,36,71,143,134,277,12,10,22,1,3:08
2131,382645,2014-09-05,2014,TEX,SEA,5,7,7-5,SEA,9,0,41,38,79,140,165,305,15,11,26,5,3:27
2132,382643,2014-09-05,2014,CHN,PIT,3,5,5-3,PIT,11,0,47,48,95,191,173,364,14,17,31,3,4:19 (1:52 delay)
2133,382643,2014-09-05,2014,CHN,PIT,3,5,5-3,PIT,11,0,47,48,95,191,173,364,14,17,31,3,4:19 (1:52 delay)
2134,382644,2014-09-05,2014,COL,SDN,3,0,3-0,COL,9,1,33,31,64,103,129,232,10,4,14,2,2:28
2135,382646,2014-09-05,2014,DET,SFN,2,8,8-2,SFN,9,0,33,44,77,154,112,266,8,19,27,0,2:48 (2:42 delay)
2136,382640,2014-09-05,2014,NYA,KCA,0,1,1-0,KCA,9,0,31,30,61,121,108,229,4,3,7,1,2:33
2137,382638,2014-09-05,2014,CLE,CHA,2,1,2-1,CLE,10,0,36,42,78,162,155,317,12,15,27,3,3:13
2138,382648,2014-09-05,2014,BOS,TOR,9,8,9-8,BOS,10,0,49,44,93,150,186,336,21,17,38,5,3:53
2139,382641,2014-09-05,2014,CIN,NYN,5,14,14-5,NYN,9,0,38,54,92,218,119,337,12,27,39,3,3:34
2140,382642,2014-09-05,2014,WAS,PHI,8,9,9-8,PHI,11,0,51,47,98,203,192,395,23,14,37,5,4:32
2141,382634,2014-09-05,2014,MIN,ANA,6,7,7-6,ANA,10,0,46,51,97,197,194,391,18,20,38,5,4:30
2142,382653,2014-09-06,2014,CLE,CHA,3,1,3-1,CLE,9,1,35,33,68,104,134,238,11,5,16,0,2:46
2143,382654,2014-09-06,2014,OAK,HOU,4,3,4-3,OAK,9,0,34,37,71,123,122,245,9,11,20,2,2:40
2144,382650,2014-09-06,2014,LAN,ARI,5,2,5-2,LAN,9,1,31,36,67,147,112,259,9,10,19,3,3:02
2145,382652,2014-09-06,2014,TBA,BAL,3,2,3-2,TBA,9,0,37,36,73,141,133,274,11,10,21,3,3:06
2146,382656,2014-09-06,2014,CIN,NYN,2,1,2-1,CIN,9,1,31,36,67,153,122,275,8,11,19,1,2:47
2147,382655,2014-09-06,2014,NYA,KCA,6,2,6-2,NYA,9,1,36,33,69,127,136,263,12,7,19,1,2:48
2148,382660,2014-09-06,2014,TEX,SEA,2,4,4-2,SEA,9,0,38,40,78,145,143,288,12,14,26,2,3:00 (3:13 delay)
2149,382662,2014-09-06,2014,MIL,SLN,3,5,5-3,SLN,9,0,38,34,72,140,146,286,12,7,19,2,3:02
2150,382651,2014-09-06,2014,MIA,ATL,3,4,4-3,ATL,10,0,39,44,83,156,157,313,10,15,25,4,3:28
2151,382657,2014-09-06,2014,WAS,PHI,1,3,3-1,PHI,9,0,34,34,68,123,123,246,9,7,16,0,2:33
2152,382658,2014-09-06,2014,CHN,PIT,0,5,5-0,PIT,9,0,35,42,77,177,151,328,9,16,25,1,3:20
2153,382649,2014-09-06,2014,MIN,ANA,5,8,8-5,ANA,9,0,38,42,80,153,150,303,15,16,31,3,3:20
2154,382661,2014-09-06,2014,DET,SFN,4,5,5-4,SFN,9,0,36,38,74,116,139,255,11,10,21,1,3:08
2155,382659,2014-09-06,2014,COL,SDN,7,6,7-6,COL,12,0,56,51,107,194,205,399,24,17,41,7,4:52
2156,382663,2014-09-06,2014,BOS,TOR,4,3,4-3,BOS,9,1,36,39,75,151,145,296,12,13,25,4,3:23 (1:12 delay)
2157,382668,2014-09-07,2014,CLE,CHA,2,0,2-0,CLE,9,1,32,31,63,106,117,223,11,4,15,3,2:36
2158,382675,2014-09-07,2014,TEX,SEA,1,0,1-0,TEX,9,1,30,34,64,125,128,253,8,9,17,2,2:42
2159,382666,2014-09-07,2014,MIA,ATL,4,0,4-0,MIA,9,1,32,33,65,117,118,235,10,6,16,2,2:44
2160,382674,2014-09-07,2014,COL,SDN,6,0,6-0,COL,9,1,38,34,72,134,152,286,18,8,26,1,3:04
2161,382665,2014-09-07,2014,LAN,ARI,7,2,7-2,LAN,9,1,38,35,73,132,145,277,13,9,22,2,3:11
2162,382677,2014-09-07,2014,MIL,SLN,1,9,9-1,SLN,9,0,32,40,72,171,100,271,8,15,23,1,3:01
2163,382678,2014-09-07,2014,BOS,TOR,1,3,3-1,TOR,9,0,34,36,70,144,134,278,7,12,19,2,2:44
2164,382667,2014-09-07,2014,TBA,BAL,5,7,7-5,BAL,11,0,52,50,102,211,193,404,20,19,39,6,4:36
2165,382671,2014-09-07,2014,CIN,NYN,3,4,4-3,NYN,9,0,40,41,81,167,153,320,15,14,29,1,3:34
2166,382670,2014-09-07,2014,NYA,KCA,0,2,2-0,KCA,9,0,34,36,70,160,139,299,8,12,20,2,3:16
2167,382669,2014-09-07,2014,OAK,HOU,3,4,4-3,HOU,9,0,39,40,79,149,148,297,13,16,29,4,3:15
2168,382676,2014-09-07,2014,DET,SFN,6,1,6-1,DET,9,1,36,38,74,161,148,309,15,12,27,4,3:43
2169,382664,2014-09-07,2014,MIN,ANA,4,14,14-4,ANA,9,0,37,52,89,180,157,337,10,24,34,3,3:20
2170,382673,2014-09-07,2014,CHN,PIT,4,10,10-4,PIT,9,0,39,46,85,167,164,331,14,20,34,3,3:17
2171,382672,2014-09-07,2014,WAS,PHI,3,2,3-2,WAS,9,1,35,32,67,145,155,300,12,7,19,2,3:20
2172,382681,2014-09-08,2014,TOR,CHN,8,0,8-0,TOR,9,1,36,29,65,93,132,225,13,3,16,1,2:20
2173,382679,2014-09-08,2014,WAS,ATL,2,1,2-1,WAS,9,1,33,34,67,147,111,258,11,8,19,3,2:39
2174,382687,2014-09-08,2014,PHI,PIT,4,6,6-4,PIT,9,0,35,41,76,145,133,278,7,14,21,3,3:08
2175,382682,2014-09-08,2014,NYN,COL,3,2,3-2,NYN,9,0,34,37,71,140,154,294,9,11,20,2,2:53
2176,382680,2014-09-08,2014,BOS,BAL,0,4,4-0,BAL,9,0,35,40,75,147,146,293,10,13,23,5,3:08
2177,382688,2014-09-08,2014,LAN,SDN,9,4,9-4,LAN,9,1,42,33,75,101,185,286,19,6,25,2,3:04
2178,382684,2014-09-08,2014,DET,KCA,9,5,9-5,DET,9,1,41,36,77,151,163,314,18,10,28,3,3:19
2179,382686,2014-09-08,2014,CHA,OAK,5,4,5-4,CHA,12,0,44,45,89,170,163,333,11,12,23,3,3:38
2180,382685,2014-09-08,2014,MIL,MIA,4,6,6-4,MIA,9,0,34,39,73,143,119,262,10,13,23,2,2:50
2181,382689,2014-09-08,2014,CIN,SLN,0,5,5-0,SLN,9,0,28,42,70,150,96,246,3,14,17,6,3:00
2182,382683,2014-09-08,2014,SEA,HOU,4,1,4-1,SEA,9,1,39,39,78,161,162,323,16,13,29,4,3:42
2183,381608,2014-09-08,2014,CLE,ANA,3,12,12-3,ANA,9,0,38,44,82,176,147,323,12,20,32,3,3:16
2184,381608,2014-09-08,2014,CLE,ANA,3,12,12-3,ANA,9,0,38,44,82,176,147,323,12,20,32,3,3:16
2185,382696,2014-09-09,2014,SEA,HOU,1,2,2-1,HOU,9,0,29,37,66,139,111,250,2,11,13,2,2:57
2186,382691,2014-09-09,2014,SFN,ARI,5,1,5-1,SFN,9,1,39,29,68,84,152,236,15,4,19,0,2:29
2187,382704,2014-09-09,2014,NYA,TBA,3,4,4-3,TBA,9,0,32,39,71,140,117,257,8,13,21,7,3:18
2188,382701,2014-09-09,2014,PHI,PIT,4,3,4-3,PHI,9,1,33,37,70,132,122,254,11,11,22,0,2:56
2189,382699,2014-09-09,2014,CLE,MIN,3,4,4-3,MIN,9,0,38,34,72,123,168,291,13,8,21,3,3:04
2190,382697,2014-09-09,2014,DET,KCA,4,2,4-2,DET,9,1,36,40,76,152,136,288,12,15,27,3,3:26
2191,382702,2014-09-09,2014,LAN,SDN,3,6,6-3,SDN,9,0,38,39,77,153,136,289,13,12,25,1,3:03
2192,382690,2014-09-09,2014,TEX,ANA,3,9,9-3,ANA,9,0,38,40,78,138,161,299,12,13,25,3,3:04
2193,382693,2014-09-09,2014,BOS,BAL,1,4,4-1,BAL,9,0,36,40,76,149,174,323,12,13,25,3,3:32
2194,382692,2014-09-09,2014,WAS,ATL,6,4,6-4,WAS,9,1,37,34,71,135,144,279,14,7,21,2,3:02
2195,382695,2014-09-09,2014,NYN,COL,2,0,2-0,NYN,9,1,33,33,66,125,125,250,9,6,15,2,2:41
2196,382700,2014-09-09,2014,CHA,OAK,2,11,11-2,OAK,9,0,35,49,84,178,133,311,10,19,29,0,3:19
2197,382694,2014-09-09,2014,TOR,CHN,9,2,9-2,TOR,9,1,40,40,80,128,162,290,18,14,32,2,3:04
2198,382698,2014-09-09,2014,MIL,MIA,3,6,6-3,MIA,9,0,43,42,85,183,146,329,16,17,33,3,3:50
2199,382703,2014-09-09,2014,CIN,SLN,9,5,9-5,CIN,9,1,44,42,86,192,156,348,20,16,36,5,3:33
2200,382711,2014-09-10,2014,SEA,HOU,2,5,5-2,HOU,9,0,32,39,71,149,125,274,8,12,20,2,3:01
2201,382710,2014-09-10,2014,NYN,COL,2,0,2-0,NYN,9,1,32,34,66,157,113,270,9,9,18,3,2:53
2202,382717,2014-09-10,2014,LAN,SDN,4,0,4-0,LAN,9,1,34,31,65,131,134,265,14,6,20,1,2:45
2203,382715,2014-09-10,2014,CHA,OAK,2,1,2-1,CHA,9,1,33,33,66,133,140,273,12,8,20,1,3:15
2204,382707,2014-09-10,2014,WAS,ATL,2,6,6-2,ATL,9,0,35,42,77,155,123,278,8,16,24,1,3:01
2205,382713,2014-09-10,2014,MIL,MIA,4,1,4-1,MIL,9,1,34,36,70,145,121,266,10,10,20,4,2:59
2206,382718,2014-09-10,2014,CIN,SLN,4,2,4-2,CIN,9,1,34,34,68,138,137,275,14,10,24,2,2:51
2207,382706,2014-09-10,2014,SFN,ARI,5,0,5-0,SFN,9,1,35,33,68,129,148,277,13,7,20,2,3:07
2208,382708,2014-09-10,2014,BOS,BAL,6,10,10-6,BAL,9,0,38,45,83,167,152,319,11,18,29,2,3:23
2209,382705,2014-09-10,2014,TEX,ANA,1,8,8-1,ANA,9,0,34,48,82,185,126,311,11,26,37,5,3:34
2210,382709,2014-09-10,2014,TOR,CHN,11,1,11-1,TOR,9,1,41,33,74,136,166,302,19,7,26,4,3:12
2211,382716,2014-09-10,2014,PHI,PIT,3,6,6-3,PIT,9,0,34,43,77,166,135,301,6,17,23,1,3:08
2212,382719,2014-09-10,2014,NYA,TBA,8,5,8-5,NYA,9,1,37,40,77,164,146,310,13,14,27,4,3:31
2213,382712,2014-09-10,2014,DET,KCA,0,3,3-0,KCA,9,0,29,38,67,148,129,277,3,12,15,2,3:18 (:42 delay)
2214,382727,2014-09-11,2014,CIN,SLN,1,0,1-0,CIN,9,1,27,31,58,127,101,228,4,6,10,0,2:12
2215,382728,2014-09-11,2014,NYA,TBA,5,4,5-4,NYA,9,0,35,37,72,125,136,261,8,13,21,4,3:05
2216,382714,2014-09-11,2014,CLE,MIN,2,0,2-0,CLE,9,1,33,31,64,127,136,263,9,6,15,1,2:33
2217,382724,2014-09-11,2014,CLE,MIN,8,2,8-2,CLE,9,1,38,34,72,118,140,258,14,8,22,1,2:40
2218,382714,2014-09-11,2014,CLE,MIN,2,0,2-0,CLE,9,1,33,31,64,127,136,263,9,6,15,1,2:33
2219,382720,2014-09-11,2014,TEX,ANA,3,7,7-3,ANA,9,0,36,39,75,158,140,298,10,12,22,5,3:24
2220,382729,2014-09-11,2014,NYN,WAS,2,6,6-2,WAS,9,0,35,43,78,159,121,280,11,17,28,5,3:10
2221,382723,2014-09-11,2014,MIL,MIA,4,2,4-2,MIL,9,1,35,36,71,131,130,261,12,8,20,2,3:19
2222,382721,2014-09-11,2014,SFN,ARI,6,2,6-2,SFN,9,1,40,36,76,150,152,302,18,10,28,4,3:28
2223,382725,2014-09-11,2014,CHA,OAK,1,0,1-0,CHA,9,1,28,32,60,125,113,238,5,6,11,0,2:18
2224,382726,2014-09-11,2014,PHI,PIT,1,4,4-1,PIT,9,0,35,38,73,160,125,285,9,13,22,1,3:09
2225,382722,2014-09-11,2014,KCA,BOS,3,6,6-3,BOS,9,0,37,42,79,174,130,304,10,16,26,4,3:28
2226,382743,2014-09-12,2014,TOR,TBA,0,1,1-0,TBA,9,0,32,32,64,129,141,270,5,4,9,0,2:55
2227,382735,2014-09-12,2014,SLN,COL,5,1,5-1,SLN,9,1,34,35,69,112,138,250,13,8,21,1,2:44
2228,382740,2014-09-12,2014,BAL,NYA,5,0,5-0,BAL,9,1,38,32,70,130,143,273,14,6,20,1,2:57
2229,382738,2014-09-12,2014,PHI,MIA,3,1,3-1,PHI,10,0,38,39,77,141,142,283,13,10,23,2,3:02
2230,382737,2014-09-12,2014,SFN,LAN,9,0,9-0,SFN,9,1,41,33,74,113,153,266,17,6,23,0,3:01
2231,382741,2014-09-12,2014,SEA,OAK,4,2,4-2,SEA,9,1,30,39,69,148,117,265,8,10,18,2,2:44
2232,382742,2014-09-12,2014,ARI,SDN,5,6,6-5,SDN,9,0,36,40,76,162,124,286,11,14,25,1,2:55
2233,382736,2014-09-12,2014,ANA,HOU,11,3,11-3,ANA,9,1,40,41,81,179,164,343,14,15,29,3,3:37
2234,382744,2014-09-12,2014,NYN,WAS,4,3,4-3,NYN,9,1,33,41,74,162,131,293,9,17,26,2,3:10
2235,382731,2014-09-12,2014,KCA,BOS,2,4,4-2,BOS,9,0,33,38,71,147,118,265,6,12,18,1,2:49
2236,382732,2014-09-12,2014,PIT,CHN,7,3,7-3,PIT,9,1,41,36,77,150,154,304,17,9,26,2,3:29
2237,382733,2014-09-12,2014,MIL,CIN,3,2,3-2,MIL,9,0,34,36,70,145,122,267,10,10,20,1,3:01
2238,382734,2014-09-12,2014,DET,CLE,7,2,7-2,DET,9,1,38,36,74,132,133,265,15,10,25,4,3:07
2239,382324,2014-09-12,2014,BAL,NYA,2,1,2-1,BAL,11,0,45,43,88,174,185,359,13,12,25,2,3:51
2240,382324,2014-09-12,2014,BAL,NYA,2,1,2-1,BAL,11,0,45,43,88,174,185,359,13,12,25,2,3:51
2241,382730,2014-09-12,2014,TEX,ATL,2,1,2-1,TEX,9,1,35,36,71,150,127,277,11,11,22,4,2:59
2242,382746,2014-09-13,2014,KCA,BOS,7,1,7-1,KCA,9,1,36,33,69,127,153,280,13,5,18,0,2:48
2243,382750,2014-09-13,2014,SLN,COL,5,4,5-4,SLN,9,1,36,36,72,134,158,292,12,10,22,3,3:24
2244,382758,2014-09-13,2014,TOR,TBA,6,3,6-3,TOR,9,1,36,35,71,126,139,265,13,9,22,1,2:40
2245,382754,2014-09-13,2014,CHA,MIN,5,1,5-1,CHA,9,1,35,32,67,139,121,260,12,6,18,3,2:38
2246,382753,2014-09-13,2014,PHI,MIA,2,1,2-1,PHI,9,1,28,35,63,120,102,222,4,10,14,1,2:33
2247,382756,2014-09-13,2014,SEA,OAK,2,3,3-2,OAK,10,0,34,43,77,167,115,282,7,15,22,3,3:20
2248,382751,2014-09-13,2014,ANA,HOU,5,2,5-2,ANA,9,1,37,35,72,133,163,296,16,8,24,2,3:19
2249,382739,2014-09-13,2014,CHA,MIN,7,6,7-6,CHA,9,0,41,37,78,158,175,333,16,12,28,3,3:34
2250,382749,2014-09-13,2014,DET,CLE,5,4,5-4,DET,9,1,34,36,70,147,130,277,11,11,22,2,3:14
2251,382759,2014-09-13,2014,NYN,WAS,3,10,10-3,WAS,9,0,35,48,83,203,114,317,8,20,28,3,3:32
2252,382755,2014-09-13,2014,BAL,NYA,2,3,3-2,NYA,9,0,37,36,73,154,158,312,11,9,20,2,3:28 (:35 delay)
2253,382757,2014-09-13,2014,ARI,SDN,10,4,10-4,ARI,9,1,40,37,77,137,159,296,15,11,26,1,3:13
2254,382739,2014-09-13,2014,CHA,MIN,7,6,7-6,CHA,9,0,41,37,78,158,175,333,16,12,28,3,3:34
2255,382747,2014-09-13,2014,PIT,CHN,4,6,6-4,CHN,9,0,38,42,80,176,149,325,11,16,27,3,3:27
2256,382745,2014-09-13,2014,TEX,ATL,3,2,3-2,TEX,9,1,28,35,63,115,105,220,4,10,14,2,2:25
2257,382752,2014-09-13,2014,SFN,LAN,0,17,17-0,LAN,9,0,31,59,90,196,114,310,5,31,36,2,3:15
2258,382748,2014-09-13,2014,MIL,CIN,1,5,5-1,CIN,9,0,32,38,70,156,118,274,7,12,19,0,2:56
2259,382762,2014-09-14,2014,PIT,CHN,7,3,7-3,PIT,9,1,39,33,72,122,136,258,16,9,25,1,2:53
2260,382771,2014-09-14,2014,SEA,OAK,0,4,4-0,OAK,9,0,38,36,74,131,168,299,13,9,22,2,2:58
2261,382774,2014-09-14,2014,NYN,WAS,0,3,3-0,WAS,9,0,38,35,73,143,136,279,11,9,20,1,2:53
2262,382767,2014-09-14,2014,SFN,LAN,2,4,4-2,LAN,9,0,34,35,69,107,123,230,8,10,18,1,2:53
2263,382770,2014-09-14,2014,BAL,NYA,3,2,3-2,BAL,9,0,34,35,69,152,123,275,9,8,17,1,3:04
2264,382765,2014-09-14,2014,SLN,COL,4,1,4-1,SLN,9,1,37,36,73,140,136,276,15,9,24,4,3:03
2265,382766,2014-09-14,2014,ANA,HOU,1,6,6-1,HOU,9,0,30,44,74,197,143,340,5,20,25,3,3:20
2266,382772,2014-09-14,2014,ARI,SDN,8,6,8-6,ARI,9,1,39,44,83,145,136,281,15,17,32,4,3:16
2267,382773,2014-09-14,2014,TOR,TBA,5,6,6-5,TBA,10,0,39,45,84,166,156,322,10,16,26,4,3:26
2268,382761,2014-09-14,2014,KCA,BOS,4,8,8-4,BOS,9,0,39,39,78,173,165,338,13,13,26,3,3:23
2269,382769,2014-09-14,2014,CHA,MIN,4,6,6-4,MIN,9,0,34,41,75,145,123,268,7,17,24,1,2:43
2270,382768,2014-09-14,2014,PHI,MIA,4,5,5-4,MIA,9,0,39,40,79,143,155,298,13,11,24,3,3:20
2271,382763,2014-09-14,2014,MIL,CIN,9,2,9-2,MIL,9,1,45,36,81,126,156,282,21,10,31,2,3:08
2272,382764,2014-09-14,2014,DET,CLE,6,4,6-4,DET,9,1,40,43,83,167,143,310,20,17,37,6,3:56
2273,382760,2014-09-14,2014,TEX,ATL,10,3,10-3,TEX,9,1,44,37,81,118,169,287,23,11,34,1,3:00
2274,382782,2014-09-15,2014,SDN,PHI,1,0,1-0,SDN,9,1,31,28,59,92,121,213,7,3,10,2,2:09
2275,382786,2014-09-15,2014,ATL,WAS,2,4,4-2,WAS,9,0,35,37,72,152,127,279,10,11,21,4,3:06
2276,382776,2014-09-15,2014,CHN,CIN,1,0,1-0,CHN,9,0,30,32,62,135,129,264,8,8,16,1,2:46
2277,382775,2014-09-15,2014,KCA,CHA,4,3,4-3,KCA,9,0,39,39,78,133,169,302,15,13,28,1,3:18
2278,382779,2014-09-15,2014,COL,LAN,3,11,11-3,LAN,9,0,39,47,86,178,128,306,14,21,35,4,3:39
2279,382781,2014-09-15,2014,TBA,NYA,1,0,1-0,TBA,9,0,37,34,71,147,145,292,10,8,18,2,3:28
2280,382784,2014-09-15,2014,ARI,SFN,6,2,6-2,ARI,9,1,35,38,73,148,128,276,13,11,24,2,2:59
2281,382778,2014-09-15,2014,MIN,DET,6,8,8-6,DET,9,0,37,42,79,139,147,286,13,19,32,6,3:15
2282,382777,2014-09-15,2014,HOU,CLE,3,1,3-1,HOU,9,1,32,35,67,120,129,249,9,7,16,4,2:45
2283,382783,2014-09-15,2014,ANA,SEA,8,1,8-1,ANA,9,1,39,32,71,119,148,267,15,6,21,2,2:54
2284,382780,2014-09-15,2014,NYN,MIA,5,6,6-5,MIA,9,0,40,39,79,142,160,302,13,12,25,4,3:10
2285,382785,2014-09-15,2014,BAL,TOR,5,2,5-2,BAL,9,1,35,40,75,163,135,298,13,13,26,3,3:12
2286,382798,2014-09-16,2014,ARI,SFN,1,2,2-1,SFN,9,0,33,35,68,117,112,229,7,9,16,2,2:34
2287,382801,2014-09-16,2014,ATL,WAS,0,3,3-0,WAS,9,0,31,36,67,135,108,243,5,10,15,0,2:36
2288,382789,2014-09-16,2014,CHN,CIN,7,0,7-0,CHN,9,1,36,28,64,110,149,259,12,2,14,1,2:36
2289,382795,2014-09-16,2014,TBA,NYA,6,1,6-1,TBA,9,1,37,36,73,146,136,282,12,10,22,6,3:32
2290,382787,2014-09-16,2014,PIT,BOS,4,0,4-0,PIT,9,1,34,35,69,157,140,297,10,9,19,3,3:07
2291,382793,2014-09-16,2014,NYN,MIA,9,1,9-1,NYN,9,1,38,38,76,131,133,264,14,14,28,3,2:47
2292,382800,2014-09-16,2014,BAL,TOR,8,2,8-2,BAL,9,1,37,36,73,140,145,285,12,9,21,3,3:02
2293,382790,2014-09-16,2014,HOU,CLE,2,4,4-2,CLE,9,0,39,37,76,167,150,317,12,10,22,1,3:18
2294,382788,2014-09-16,2014,KCA,CHA,5,7,7-5,CHA,9,0,42,41,83,146,197,343,16,16,32,9,4:16
2295,382794,2014-09-16,2014,SLN,MIL,2,3,3-2,MIL,12,0,42,49,91,185,166,351,9,16,25,1,3:55
2296,382799,2014-09-16,2014,OAK,TEX,3,6,6-3,TEX,9,0,35,40,75,141,130,271,7,14,21,2,2:53
2297,382797,2014-09-16,2014,ANA,SEA,2,13,13-2,SEA,9,0,34,47,81,163,119,282,9,22,31,4,3:18
2298,382796,2014-09-16,2014,SDN,PHI,5,4,5-4,SDN,9,1,37,38,75,174,137,311,15,11,26,2,3:11
2299,382792,2014-09-16,2014,COL,LAN,10,4,10-4,COL,9,1,36,41,77,137,139,276,14,17,31,3,3:04
2300,382791,2014-09-16,2014,MIN,DET,4,3,4-3,MIN,9,0,35,33,68,125,129,254,12,9,21,0,2:40
2301,382816,2014-09-17,2014,ATL,WAS,3,1,3-1,ATL,9,1,33,32,65,128,123,251,10,7,17,1,2:43
2302,382804,2014-09-17,2014,CHN,CIN,3,1,3-1,CHN,9,1,33,35,68,109,129,238,10,9,19,1,2:33
2303,382803,2014-09-17,2014,KCA,CHA,6,2,6-2,KCA,9,1,40,33,73,125,147,272,18,8,26,1,2:50
2304,382812,2014-09-17,2014,ANA,SEA,5,0,5-0,ANA,9,1,32,31,63,116,125,241,9,4,13,2,2:37
2305,382808,2014-09-17,2014,NYN,MIA,3,4,4-3,MIA,9,0,37,40,77,142,150,292,12,16,28,3,3:07
2306,382806,2014-09-17,2014,MIN,DET,8,4,8-4,MIN,9,1,40,39,79,130,156,286,16,14,30,5,3:19
2307,382811,2014-09-17,2014,SDN,PHI,2,5,5-2,PHI,9,0,36,37,73,129,151,280,12,11,23,1,2:50
2308,382814,2014-09-17,2014,OAK,TEX,1,6,6-1,TEX,9,0,38,39,77,159,154,313,12,14,26,6,3:37
2309,382802,2014-09-17,2014,PIT,BOS,9,1,9-1,PIT,9,1,39,36,75,153,138,291,16,11,27,0,3:04
2310,382813,2014-09-17,2014,ARI,SFN,2,4,4-2,SFN,9,0,39,38,77,155,155,310,12,13,25,1,3:35
2311,382807,2014-09-17,2014,COL,LAN,16,2,16-2,COL,9,1,48,36,84,128,160,288,23,9,32,1,3:01
2312,382805,2014-09-17,2014,HOU,CLE,0,2,2-0,CLE,9,0,30,35,65,108,98,206,3,7,10,1,2:20
2313,382815,2014-09-17,2014,BAL,TOR,6,1,6-1,BAL,9,1,35,35,70,167,131,298,11,11,22,3,3:13
2314,382810,2014-09-17,2014,TBA,NYA,2,3,3-2,NYA,9,0,33,35,68,134,129,263,7,8,15,1,2:57
2315,382809,2014-09-17,2014,SLN,MIL,2,0,2-0,SLN,9,1,28,34,62,102,115,217,5,9,14,0,2:32
2316,382826,2014-09-18,2014,MIA,WAS,2,6,6-2,WAS,9,0,33,38,71,127,125,252,6,11,17,1,2:46
2317,382818,2014-09-18,2014,PIT,BOS,3,2,3-2,PIT,9,1,33,35,68,128,131,259,10,9,19,2,2:53
2318,382823,2014-09-18,2014,ANA,SEA,1,3,3-1,SEA,9,0,37,34,71,126,134,260,10,9,19,2,3:08
2319,382821,2014-09-18,2014,SLN,MIL,3,2,3-2,SLN,13,0,51,53,104,185,187,372,18,14,32,3,4:26
2320,382824,2014-09-18,2014,OAK,TEX,2,7,7-2,TEX,9,0,34,41,75,146,130,276,9,17,26,5,3:05
2321,382825,2014-09-18,2014,NYA,TOR,3,2,3-2,NYA,9,0,34,33,67,138,127,265,9,7,16,1,2:39
2322,382819,2014-09-18,2014,HOU,CLE,1,2,2-1,CLE,13,0,48,51,99,184,179,363,12,14,26,7,4:32
2323,382822,2014-09-18,2014,SDN,PHI,7,3,7-3,SDN,9,1,39,38,77,137,143,280,19,11,30,1,3:02
2324,382817,2014-09-18,2014,COL,ARI,7,6,7-6,COL,9,0,41,36,77,111,141,252,16,11,27,3,2:47
2325,382820,2014-09-18,2014,CHN,LAN,4,8,8-4,LAN,9,0,39,42,81,167,178,345,13,16,29,2,3:53
2326,382841,2014-09-19,2014,MIA,WAS,2,3,3-2,WAS,9,0,34,37,71,152,129,281,8,11,19,1,2:47
2327,382838,2014-09-19,2014,SDN,SFN,5,0,5-0,SDN,9,1,34,32,66,138,131,269,10,5,15,2,2:49
2328,382836,2014-09-19,2014,OAK,PHI,3,1,3-1,OAK,9,1,36,33,69,142,129,271,13,8,21,2,2:56
2329,382834,2014-09-19,2014,PIT,MIL,4,2,4-2,PIT,9,1,37,33,70,111,150,261,13,8,21,1,2:57
2330,382835,2014-09-19,2014,ATL,NYN,0,5,5-0,NYN,9,0,34,38,72,144,139,283,7,13,20,1,3:03
2331,382828,2014-09-19,2014,BAL,BOS,3,5,5-3,BOS,10,0,40,41,81,165,162,327,11,9,20,4,3:42
2332,382839,2014-09-19,2014,ANA,TEX,3,12,12-3,TEX,9,0,38,44,82,152,160,312,13,17,30,1,3:16
2333,382829,2014-09-19,2014,TBA,CHA,3,4,4-3,CHA,9,0,36,41,77,177,134,311,11,16,27,5,3:29
2334,382833,2014-09-19,2014,CHN,LAN,5,14,14-5,LAN,9,0,41,45,86,182,157,339,15,19,34,2,3:31
2335,382830,2014-09-19,2014,SLN,CIN,2,1,2-1,SLN,9,1,33,34,67,112,122,234,9,8,17,3,2:35
2336,382840,2014-09-19,2014,NYA,TOR,5,3,5-3,NYA,9,1,33,37,70,149,119,268,10,10,20,4,2:44
2337,382837,2014-09-19,2014,HOU,SEA,5,10,10-5,SEA,9,0,41,45,86,182,145,327,16,20,36,4,3:34
2338,382832,2014-09-19,2014,KCA,DET,1,10,10-1,DET,9,0,32,46,78,169,136,305,7,20,27,3,3:16
2339,382827,2014-09-19,2014,COL,ARI,15,3,15-3,COL,9,1,44,38,82,123,137,260,21,11,32,0,2:51
2340,382831,2014-09-19,2014,MIN,CLE,5,4,5-4,MIN,10,0,41,42,83,127,161,288,15,11,26,8,3:27
2341,382844,2014-09-20,2014,TBA,CHA,3,1,3-1,TBA,9,1,32,35,67,143,118,261,12,9,21,3,3:05
2342,382843,2014-09-20,2014,BAL,BOS,7,2,7-2,BAL,9,1,37,35,72,133,164,297,14,8,22,0,2:51
2343,382850,2014-09-20,2014,ATL,NYN,2,4,4-2,NYN,9,0,36,41,77,160,120,280,10,14,24,2,2:52
2344,382853,2014-09-20,2014,SDN,SFN,3,2,3-2,SDN,9,1,35,34,69,130,121,251,12,7,19,4,2:53
2345,382842,2014-09-20,2014,COL,ARI,5,1,5-1,COL,9,1,36,35,71,125,132,257,11,10,21,1,2:43
2346,382856,2014-09-20,2014,MIA,WAS,2,3,3-2,WAS,9,0,33,37,70,134,128,262,7,14,21,2,2:59
2347,382851,2014-09-20,2014,OAK,PHI,0,3,3-0,PHI,9,0,31,38,69,161,121,282,6,10,16,3,2:59
2348,382852,2014-09-20,2014,HOU,SEA,10,1,10-1,HOU,9,1,37,35,72,136,137,273,15,9,24,1,2:34
2349,382854,2014-09-20,2014,ANA,TEX,8,5,8-5,ANA,9,1,37,35,72,138,134,272,14,9,23,3,2:57
2350,382849,2014-09-20,2014,PIT,MIL,0,1,1-0,MIL,9,0,37,37,74,134,135,269,14,11,25,3,3:32
2351,382847,2014-09-20,2014,KCA,DET,2,3,3-2,DET,9,0,39,35,74,128,153,281,13,8,21,1,3:29
2352,382855,2014-09-20,2014,NYA,TOR,3,6,6-3,TOR,9,0,41,41,82,144,159,303,13,16,29,4,3:18
2353,382848,2014-09-20,2014,CHN,LAN,8,7,8-7,CHN,9,1,41,40,81,139,172,311,18,16,34,5,3:44
2354,382846,2014-09-20,2014,MIN,CLE,3,7,7-3,CLE,9,0,37,40,77,162,152,314,11,14,25,5,3:14 (1:01 delay)
2355,382845,2014-09-20,2014,SLN,CIN,8,4,8-4,SLN,9,1,36,36,72,137,128,265,15,8,23,3,2:52
2356,382864,2014-09-21,2014,PIT,MIL,1,0,1-0,PIT,9,1,29,32,61,100,102,202,8,7,15,0,2:25
2357,382871,2014-09-21,2014,MIA,WAS,1,2,2-1,WAS,9,0,30,34,64,133,107,240,7,8,15,0,2:30
2358,382858,2014-09-21,2014,BAL,BOS,2,3,3-2,BOS,9,0,36,38,74,148,123,271,9,15,24,3,3:07
2359,382870,2014-09-21,2014,NYA,TOR,5,2,5-2,NYA,9,1,37,35,72,122,182,304,13,9,22,3,3:09
2360,382861,2014-09-21,2014,MIN,CLE,2,7,7-2,CLE,9,0,35,45,80,149,136,285,8,20,28,2,3:08
2361,382862,2014-09-21,2014,KCA,DET,5,2,5-2,KCA,9,1,38,36,74,120,148,268,16,9,25,4,3:09
2362,382865,2014-09-21,2014,ATL,NYN,2,10,10-2,NYN,9,0,34,45,79,158,139,297,7,18,25,1,3:06
2363,382868,2014-09-21,2014,SDN,SFN,8,2,8-2,SDN,9,1,38,34,72,130,172,302,14,8,22,5,3:24
2364,382867,2014-09-21,2014,HOU,SEA,8,3,8-3,HOU,9,1,43,33,76,128,161,289,21,8,29,4,3:29
2365,382857,2014-09-21,2014,COL,ARI,8,3,8-3,COL,9,1,39,34,73,113,138,251,17,9,26,3,2:47
2366,382869,2014-09-21,2014,ANA,TEX,1,2,2-1,TEX,9,0,34,38,72,159,127,286,10,14,24,3,3:17
2367,382859,2014-09-21,2014,TBA,CHA,5,10,10-5,CHA,9,0,41,45,86,179,157,336,15,18,33,3,3:26
2368,382866,2014-09-21,2014,OAK,PHI,8,6,8-6,OAK,10,0,48,43,91,153,200,353,21,14,35,3,3:48
2369,382860,2014-09-21,2014,SLN,CIN,2,7,7-2,CIN,9,0,38,38,76,151,128,279,11,11,22,2,3:01
2370,382863,2014-09-21,2014,CHN,LAN,5,8,8-5,LAN,9,0,40,44,84,164,184,348,13,17,30,1,3:45
2371,382875,2014-09-22,2014,DET,CHA,0,2,2-0,CHA,9,0,35,32,67,114,123,237,8,6,14,1,2:36
2372,382877,2014-09-22,2014,TEX,HOU,4,3,4-3,TEX,9,1,32,36,68,136,120,256,10,10,20,3,2:48
2373,382876,2014-09-22,2014,SDN,COL,1,0,1-0,SDN,9,1,32,37,69,142,119,261,8,11,19,2,2:46
2374,382879,2014-09-22,2014,ATL,PIT,0,1,1-0,PIT,9,0,35,33,68,139,142,281,8,6,14,0,2:50
2375,382880,2014-09-22,2014,TOR,SEA,14,4,14-4,TOR,9,1,45,37,82,127,153,280,22,10,32,1,2:48
2376,382872,2014-09-22,2014,OAK,ANA,8,4,8-4,OAK,9,1,41,35,76,134,184,318,16,10,26,3,3:17
2377,382881,2014-09-22,2014,LAN,SFN,2,5,5-2,SFN,13,0,46,55,101,204,145,349,8,17,25,2,4:16
2378,382874,2014-09-22,2014,NYA,BAL,5,0,5-0,NYA,9,1,34,30,64,132,132,264,11,3,14,5,3:00
2379,382878,2014-09-22,2014,CLE,KCA,0,2,2-0,KCA,9,0,36,36,72,124,141,265,10,9,19,2,3:03
2380,382882,2014-09-22,2014,CHN,SLN,0,8,8-0,SLN,9,0,32,42,74,166,135,301,7,15,22,0,3:00
2381,382873,2014-09-22,2014,MIN,ARI,2,6,6-2,ARI,9,0,37,40,77,153,163,316,11,15,26,3,3:14
2382,382895,2014-09-23,2014,LAN,SFN,4,2,4-2,LAN,9,1,30,32,62,129,120,249,7,7,14,1,2:49
2383,382894,2014-09-23,2014,TOR,SEA,10,2,10-2,TOR,9,1,41,34,75,116,148,264,16,8,24,1,2:36
2384,382890,2014-09-23,2014,CIN,MIL,3,1,3-1,CIN,9,1,30,32,62,121,128,249,7,7,14,0,2:36
2385,382893,2014-09-23,2014,ATL,PIT,2,3,3-2,PIT,9,0,30,36,66,150,126,276,8,11,19,1,2:48
2386,382885,2014-09-23,2014,NYA,BAL,4,5,5-4,BAL,9,0,38,43,81,146,153,299,11,17,28,4,3:22
2387,382889,2014-09-23,2014,CLE,KCA,1,7,7-1,KCA,9,0,36,42,78,145,143,288,9,18,27,4,2:57
2388,382896,2014-09-23,2014,CHN,SLN,4,3,4-3,CHN,10,0,42,39,81,146,164,310,15,10,25,3,3:11
2389,382887,2014-09-23,2014,SDN,COL,2,3,3-2,COL,9,0,39,35,74,135,161,296,15,10,25,1,3:20
2390,382892,2014-09-23,2014,MIA,PHI,2,0,2-0,MIA,9,1,31,36,67,121,117,238,8,9,17,1,2:20
2391,382886,2014-09-23,2014,DET,CHA,4,3,4-3,DET,9,0,39,36,75,121,150,271,15,9,24,2,3:19
2392,382883,2014-09-23,2014,OAK,ANA,0,2,2-0,ANA,9,0,35,30,65,115,147,262,11,6,17,2,3:02
2393,382897,2014-09-23,2014,BOS,TBA,2,6,6-2,TBA,9,0,34,36,70,125,146,271,10,13,23,3,3:14
2394,382891,2014-09-23,2014,WAS,NYN,4,2,4-2,WAS,9,1,34,36,70,149,119,268,9,9,18,4,2:57
2395,382884,2014-09-23,2014,MIN,ARI,6,3,6-3,MIN,9,1,37,38,75,144,139,283,17,11,28,2,3:05
2396,382888,2014-09-23,2014,TEX,HOU,2,1,2-1,TEX,9,1,38,34,72,138,142,280,15,8,23,2,2:55
2397,382909,2014-09-24,2014,TOR,SEA,1,0,1-0,TOR,9,1,28,29,57,103,99,202,5,4,9,1,1:59
2398,382899,2014-09-24,2014,MIN,ARI,2,1,2-1,MIN,9,1,32,34,66,116,152,268,9,6,15,0,2:31 (1:06 delay)
2399,382905,2014-09-24,2014,CIN,MIL,0,5,5-0,MIL,9,0,29,41,70,169,106,275,2,16,18,1,2:54
2400,382910,2014-09-24,2014,LAN,SFN,9,1,9-1,LAN,9,1,39,35,74,131,137,268,17,8,25,4,3:07
2401,382904,2014-09-24,2014,CLE,KCA,6,4,6-4,CLE,9,1,37,41,78,144,152,296,14,16,30,5,3:29
2402,382908,2014-09-24,2014,ATL,PIT,6,2,6-2,ATL,9,1,41,40,81,158,142,300,18,14,32,3,3:17
2403,382900,2014-09-24,2014,NYA,BAL,5,9,9-5,BAL,9,0,37,45,82,151,155,306,11,20,31,7,3:32
2404,382912,2014-09-24,2014,BOS,TBA,11,3,11-3,BOS,9,1,44,38,82,136,206,342,20,11,31,2,3:40
2405,382911,2014-09-24,2014,CHN,SLN,3,1,3-1,CHN,9,1,36,34,70,127,130,257,13,7,20,3,2:41
2406,382903,2014-09-24,2014,TEX,HOU,5,1,5-1,TEX,9,1,38,32,70,137,152,289,14,10,24,1,3:06
2407,382901,2014-09-24,2014,DET,CHA,6,1,6-1,DET,9,1,39,34,73,121,154,275,17,7,24,1,3:04
2408,382907,2014-09-24,2014,MIA,PHI,1,2,2-1,PHI,9,0,34,39,73,145,105,250,8,16,24,1,2:54
2409,382902,2014-09-24,2014,SDN,COL,4,3,4-3,SDN,9,1,35,36,71,143,144,287,12,10,22,4,3:10
2410,382898,2014-09-24,2014,OAK,ANA,4,5,5-4,ANA,9,0,38,36,74,129,165,294,12,10,22,3,3:27
2411,382916,2014-09-25,2014,DET,MIN,4,2,4-2,DET,9,1,33,36,69,155,115,270,10,9,19,0,2:55
2412,382919,2014-09-25,2014,MIA,PHI,6,4,6-4,MIA,9,1,37,35,72,131,137,268,17,10,27,2,3:01
2413,382917,2014-09-25,2014,WAS,NYN,3,0,3-0,WAS,9,1,36,31,67,133,149,282,12,5,17,0,3:00
2414,382915,2014-09-25,2014,CIN,MIL,5,3,5-3,CIN,9,1,37,35,72,128,149,277,11,9,20,2,3:11
2415,382923,2014-09-25,2014,BOS,TBA,11,1,11-1,BOS,9,1,41,36,77,119,157,276,17,10,27,2,3:16
2416,382914,2014-09-25,2014,CHA,KCA,3,6,6-3,KCA,9,0,39,40,79,126,160,286,11,15,26,1,3:06
2417,382920,2014-09-25,2014,ATL,PIT,1,10,10-1,PIT,9,0,36,46,82,186,136,322,9,24,33,3,3:27
2418,382918,2014-09-25,2014,TEX,OAK,2,1,2-1,TEX,9,0,31,38,69,135,125,260,6,13,19,2,2:47
2419,382922,2014-09-25,2014,TOR,SEA,5,7,7-5,SEA,9,0,37,40,77,152,143,295,10,15,25,6,3:02
2420,382921,2014-09-25,2014,SFN,SDN,9,8,9-8,SFN,9,1,39,41,80,169,147,316,14,14,28,6,3:32
2421,382913,2014-09-25,2014,NYA,BAL,6,5,6-5,NYA,9,0,38,33,71,119,163,282,9,6,15,2,3:10
2422,382906,2014-09-25,2014,WAS,NYN,4,7,7-4,NYN,9,0,38,45,83,167,151,318,13,20,33,2,3:31
2423,382906,2014-09-25,2014,WAS,NYN,4,7,7-4,NYN,9,0,38,45,83,167,151,318,13,20,33,2,3:31
2424,382938,2014-09-26,2014,CLE,TBA,1,0,1-0,CLE,9,1,28,33,61,116,115,231,5,7,12,1,2:33
2425,382924,2014-09-26,2014,SEA,ANA,4,3,4-3,SEA,9,1,34,34,68,120,129,249,11,7,18,2,2:48
2426,382926,2014-09-26,2014,TOR,BAL,4,2,4-2,TOR,9,1,36,34,70,132,123,255,13,7,20,1,2:36
2427,382935,2014-09-26,2014,CIN,PIT,1,3,3-1,PIT,9,0,36,36,72,147,116,263,11,11,22,1,2:49
2428,382936,2014-09-26,2014,SFN,SDN,1,4,4-1,SDN,9,0,35,38,73,140,122,262,7,13,20,1,2:55
2429,382933,2014-09-26,2014,BOS,NYA,2,3,3-2,NYA,9,0,32,37,69,150,123,273,6,10,16,1,3:01
2430,382928,2014-09-26,2014,LAN,COL,7,4,7-4,LAN,9,1,35,40,75,149,133,282,13,14,27,6,3:24
2431,382927,2014-09-26,2014,MIL,CHN,4,6,6-4,CHN,9,0,42,40,82,144,171,315,14,14,28,2,3:34
2432,382937,2014-09-26,2014,ARI,SLN,6,7,7-6,SLN,10,0,46,45,91,170,179,349,16,18,34,5,3:45
2433,381316,2014-09-26,2014,WAS,MIA,4,0,4-0,WAS,9,1,41,30,71,104,154,258,19,4,23,1,2:31
2434,381316,2014-09-26,2014,WAS,MIA,4,0,4-0,WAS,9,1,41,30,71,104,154,258,19,4,23,1,2:31
2435,382934,2014-09-26,2014,TEX,OAK,2,6,6-2,OAK,9,0,33,38,71,143,123,266,5,12,17,1,2:49
2436,382925,2014-09-26,2014,PHI,ATL,5,4,5-4,PHI,9,1,36,37,73,127,133,260,12,12,24,1,2:41
2437,382929,2014-09-26,2014,NYN,HOU,1,3,3-1,HOU,9,0,35,35,70,140,148,288,8,10,18,3,3:10
2438,382932,2014-09-26,2014,DET,MIN,4,11,11-4,MIN,9,0,39,46,85,155,130,285,12,22,34,5,3:23
2439,382930,2014-09-26,2014,CHA,KCA,1,3,3-1,KCA,9,0,34,34,68,124,128,252,7,9,16,1,2:41
2440,382931,2014-09-26,2014,WAS,MIA,7,15,15-7,MIA,9,0,42,48,90,178,155,333,16,26,42,4,3:34
2441,382941,2014-09-27,2014,TOR,BAL,4,2,4-2,TOR,9,1,33,33,66,129,100,229,8,8,16,1,2:25
2442,382944,2014-09-27,2014,NYN,HOU,2,1,2-1,NYN,9,0,31,35,66,135,121,256,6,9,15,3,2:59
2443,382949,2014-09-27,2014,TEX,OAK,5,4,5-4,TEX,9,1,31,38,69,145,115,260,9,15,24,6,3:06
2444,382951,2014-09-27,2014,SFN,SDN,3,1,3-1,SFN,9,1,34,37,71,136,126,262,11,9,20,1,2:35
2445,382946,2014-09-27,2014,WAS,MIA,5,1,5-1,WAS,9,1,38,35,73,137,140,277,16,6,22,1,2:57
2446,382948,2014-09-27,2014,BOS,NYA,10,4,10-4,BOS,9,1,41,40,81,123,141,264,20,14,34,3,3:04
2447,382952,2014-09-27,2014,ARI,SLN,5,2,5-2,ARI,9,1,38,37,75,150,151,301,14,10,24,2,2:58
2448,382947,2014-09-27,2014,DET,MIN,3,12,12-3,MIN,9,0,38,48,86,183,129,312,11,24,35,2,3:26
2449,382939,2014-09-27,2014,SEA,ANA,2,1,2-1,SEA,11,0,46,46,92,175,167,342,17,14,31,5,3:54
2450,382943,2014-09-27,2014,LAN,COL,6,5,6-5,LAN,12,0,49,49,98,178,185,363,17,14,31,5,4:06
2451,382953,2014-09-27,2014,CLE,TBA,0,2,2-0,TBA,9,0,32,35,67,124,118,242,6,8,14,3,2:55
2452,382940,2014-09-27,2014,PHI,ATL,2,4,4-2,ATL,9,0,37,35,72,154,140,294,12,9,21,2,3:05
2453,382945,2014-09-27,2014,CHA,KCA,5,4,5-4,CHA,9,1,32,37,69,145,154,299,10,12,22,5,3:19
2454,382942,2014-09-27,2014,MIL,CHN,2,1,2-1,MIL,9,1,35,34,69,135,136,271,14,7,21,1,3:10
2455,382950,2014-09-27,2014,CIN,PIT,10,6,10-6,CIN,10,0,44,42,86,154,173,327,17,12,29,1,3:41
2456,382956,2014-09-28,2014,TOR,BAL,0,1,1-0,BAL,9,0,32,34,66,122,113,235,6,8,14,1,2:26
2457,382962,2014-09-28,2014,DET,MIN,3,0,3-0,DET,9,1,30,33,63,139,95,234,7,6,13,2,2:41
2458,382967,2014-09-28,2014,ARI,SLN,0,1,1-0,SLN,9,0,30,29,59,98,124,222,5,3,8,2,2:20
2459,382954,2014-09-28,2014,SEA,ANA,4,1,4-1,SEA,9,1,35,33,68,126,130,256,11,6,17,4,2:50
2460,382957,2014-09-28,2014,MIL,CHN,2,5,5-2,CHN,9,0,34,39,73,141,137,278,9,10,19,1,3:09
2461,382966,2014-09-28,2014,SFN,SDN,9,3,9-3,SFN,9,1,39,35,74,134,145,279,16,9,25,4,3:03
2462,382958,2014-09-28,2014,LAN,COL,10,5,10-5,LAN,9,1,43,37,80,149,154,303,18,10,28,2,3:15
2463,382955,2014-09-28,2014,PHI,ATL,1,2,2-1,ATL,9,0,34,32,66,108,120,228,9,5,14,0,2:18
2464,382961,2014-09-28,2014,WAS,MIA,1,0,1-0,WAS,9,1,32,28,60,104,101,205,11,1,12,0,2:01
2465,382965,2014-09-28,2014,CIN,PIT,4,1,4-1,CIN,9,1,32,35,67,124,132,256,9,8,17,1,2:46
2466,382964,2014-09-28,2014,TEX,OAK,0,4,4-0,OAK,9,0,32,34,66,140,103,243,7,9,16,2,2:39
2467,382959,2014-09-28,2014,NYN,HOU,8,3,8-3,NYN,9,1,36,35,71,119,137,256,13,11,24,1,2:42
2468,382968,2014-09-28,2014,CLE,TBA,7,2,7-2,CLE,9,1,39,33,72,96,139,235,15,9,24,1,2:28
2469,382960,2014-09-28,2014,CHA,KCA,4,6,6-4,KCA,9,0,41,44,85,173,158,331,15,17,32,1,3:34
2470,382963,2014-09-28,2014,BOS,NYA,5,9,9-5,NYA,9,0,35,40,75,139,149,288,8,13,21,3,3:14
2471,413661,2015-04-05,2015,CHN,SLN,0,3,3-0,SLN,9,0,34,40,74,158,156,314,7,15,22,1,3:04
2472,413658,2015-04-06,2015,CIN,PIT,5,2,5-2,CIN,9,1,32,35,67,132,111,243,8,8,16,2,2:30 (:35 delay)
2473,413654,2015-04-06,2015,HOU,CLE,2,0,2-0,HOU,9,1,28,32,60,122,108,230,5,6,11,1,2:30
2474,413649,2015-04-06,2015,SEA,ANA,4,1,4-1,SEA,9,1,33,32,65,129,124,253,11,7,18,2,2:33
2475,413662,2015-04-06,2015,OAK,TEX,8,0,8-0,OAK,9,1,41,30,71,113,174,287,15,3,18,1,2:45
2476,413657,2015-04-06,2015,WAS,NYN,1,3,3-1,NYN,9,0,32,37,69,123,122,245,4,8,12,3,2:35
2477,413659,2015-04-06,2015,LAN,SDN,6,3,6-3,LAN,9,1,39,35,74,134,148,282,17,11,28,2,3:04
2478,413663,2015-04-06,2015,NYA,TOR,1,6,6-1,TOR,9,0,33,39,72,167,130,297,7,11,18,3,2:59
2479,413651,2015-04-06,2015,TBA,BAL,2,6,6-2,BAL,9,0,35,37,72,154,141,295,11,11,22,5,3:01
2480,413656,2015-04-06,2015,DET,MIN,4,0,4-0,DET,9,1,34,31,65,105,124,229,12,5,17,1,2:30
2481,413650,2015-04-06,2015,MIA,ATL,1,2,2-1,ATL,9,0,32,35,67,112,131,243,9,7,16,2,2:36 (:16 delay)
2482,413653,2015-04-06,2015,KCA,CHA,10,1,10-1,KCA,9,1,42,31,73,115,142,257,21,8,29,3,2:50
2483,413655,2015-04-06,2015,MIL,COL,0,10,10-0,COL,9,0,34,44,78,162,122,284,9,17,26,1,3:00
2484,413652,2015-04-06,2015,PHI,BOS,0,8,8-0,BOS,9,0,33,42,75,184,118,302,5,16,21,1,3:01
2485,413660,2015-04-06,2015,ARI,SFN,4,5,5-4,SFN,9,0,39,40,79,148,132,280,14,15,29,5,3:18
2486,413667,2015-04-07,2015,MIL,COL,2,5,5-2,COL,9,0,33,41,74,148,114,262,8,14,22,0,2:48
2487,413664,2015-04-07,2015,SEA,ANA,0,2,2-0,ANA,9,0,30,33,63,123,111,234,3,6,9,1,2:13
2488,413670,2015-04-07,2015,OAK,TEX,1,3,3-1,TEX,9,0,33,37,70,125,135,260,8,11,19,1,2:30
2489,413668,2015-04-07,2015,LAN,SDN,3,7,7-3,SDN,9,0,36,43,79,175,134,309,11,14,25,4,3:31 (:30 delay)
2490,413666,2015-04-07,2015,TBA,BAL,5,6,6-5,BAL,9,0,37,37,74,151,176,327,10,13,23,4,3:22
2491,413669,2015-04-07,2015,ARI,SFN,7,6,7-6,ARI,9,1,36,39,75,153,140,293,13,14,27,2,3:10
2492,413665,2015-04-07,2015,MIA,ATL,2,12,12-2,ATL,9,0,35,46,81,191,148,339,10,22,32,2,3:14
2493,413676,2015-04-08,2015,HOU,CLE,0,2,2-0,CLE,9,0,33,34,67,127,120,247,7,7,14,3,2:40
2494,413693,2015-04-08,2015,CHN,SLN,2,0,2-0,CHN,9,1,28,34,62,126,111,237,4,7,11,3,2:23
2495,413679,2015-04-08,2015,WAS,NYN,2,1,2-1,WAS,9,1,34,33,67,136,114,250,12,7,19,0,2:21 (:56 delay)
2496,413684,2015-04-08,2015,OAK,TEX,10,0,10-0,OAK,9,1,43,33,76,128,158,286,19,5,24,1,2:55
2497,413672,2015-04-08,2015,MIA,ATL,0,2,2-0,ATL,9,0,35,33,68,130,148,278,9,10,19,2,2:45
2498,413675,2015-04-08,2015,KCA,CHA,7,5,7-5,KCA,9,1,41,35,76,121,152,273,18,10,28,1,3:11
2499,413673,2015-04-08,2015,TBA,BAL,2,0,2-0,TBA,9,1,33,31,64,142,151,293,13,5,18,3,3:00
2500,413671,2015-04-08,2015,SEA,ANA,3,5,5-3,ANA,9,0,37,39,76,142,122,264,12,14,26,2,2:48
2501,413674,2015-04-08,2015,PHI,BOS,4,2,4-2,PHI,9,1,34,35,69,165,127,292,8,7,15,2,2:54
2502,413685,2015-04-08,2015,NYA,TOR,4,3,4-3,NYA,9,1,35,37,72,156,133,289,14,10,24,3,2:56
2503,413682,2015-04-08,2015,ARI,SFN,2,5,5-2,SFN,9,0,35,44,79,154,123,277,8,16,24,2,3:08
2504,413677,2015-04-08,2015,MIL,COL,4,5,5-4,COL,10,0,41,38,79,134,158,292,13,10,23,1,3:15
2505,413681,2015-04-08,2015,LAN,SDN,7,4,7-4,LAN,9,1,38,39,77,142,151,293,15,12,27,3,3:16
2506,413678,2015-04-08,2015,DET,MIN,11,0,11-0,DET,9,1,46,33,79,137,178,315,24,6,30,4,3:06
2507,413680,2015-04-08,2015,CIN,PIT,5,4,5-4,CIN,11,0,47,48,95,189,199,388,15,17,32,4,4:01 (2:34 delay)
2508,413687,2015-04-09,2015,KCA,CHA,4,1,4-1,KCA,9,1,35,32,67,105,114,219,10,6,16,1,2:37
2509,413691,2015-04-09,2015,CIN,PIT,3,2,3-2,CIN,9,0,33,35,68,113,131,244,9,9,18,1,2:32 (1:14 delay)
2510,413689,2015-04-09,2015,DET,MIN,7,1,7-1,DET,9,1,39,32,71,94,149,243,16,6,22,1,2:43 (3:36 delay)
2511,413695,2015-04-09,2015,NYA,TOR,3,6,6-3,TOR,9,0,37,35,72,142,152,294,12,9,21,2,2:52
2512,413694,2015-04-09,2015,OAK,TEX,1,10,10-1,TEX,9,0,34,43,77,143,131,274,9,16,25,1,2:32
2513,413688,2015-04-09,2015,HOU,CLE,1,5,5-1,CLE,9,0,35,40,75,161,163,324,8,14,22,1,3:08
2514,413690,2015-04-09,2015,WAS,NYN,3,6,6-3,NYN,9,0,37,40,77,151,145,296,10,14,24,2,2:54
2515,413686,2015-04-09,2015,PHI,BOS,2,6,6-2,BOS,9,0,35,45,80,203,137,340,8,17,25,0,3:08
2516,413692,2015-04-09,2015,SDN,SFN,0,1,1-0,SFN,12,0,46,45,91,170,165,335,13,12,25,4,4:05
2517,413706,2015-04-10,2015,SDN,SFN,1,0,1-0,SDN,9,1,30,30,60,108,115,223,11,8,19,1,2:31
2518,413699,2015-04-10,2015,TEX,HOU,1,5,5-1,HOU,9,0,34,37,71,125,119,244,8,12,20,1,2:45
2519,413707,2015-04-10,2015,CIN,SLN,5,4,5-4,CIN,9,1,31,39,70,161,98,259,9,14,23,2,2:26
2520,413697,2015-04-10,2015,COL,CHN,5,1,5-1,COL,9,1,37,37,74,140,150,290,15,11,26,2,3:01
2521,413710,2015-04-10,2015,PHI,WAS,4,1,4-1,PHI,9,1,34,33,67,131,122,253,13,7,20,2,2:30
2522,413700,2015-04-10,2015,ANA,KCA,2,4,4-2,KCA,9,0,35,41,76,158,150,308,9,14,23,3,3:16
2523,413702,2015-04-10,2015,CHA,MIN,0,6,6-0,MIN,9,0,30,46,76,190,112,302,5,23,28,2,3:01
2524,413701,2015-04-10,2015,ARI,LAN,4,3,4-3,ARI,10,0,38,39,77,161,148,309,10,12,22,0,3:01
2525,413704,2015-04-10,2015,MIL,PIT,2,6,6-2,PIT,9,0,38,41,79,154,136,290,12,15,27,2,3:13
2526,413705,2015-04-10,2015,OAK,SEA,12,0,12-0,OAK,9,1,44,31,75,124,164,288,22,5,27,2,2:44
2527,413703,2015-04-10,2015,ATL,NYN,5,3,5-3,ATL,9,1,39,35,74,161,154,315,13,10,23,3,3:01 (1:09 delay)
2528,413709,2015-04-10,2015,BAL,TOR,5,12,12-5,TOR,9,0,38,47,85,162,130,292,15,20,35,2,2:45
2529,413698,2015-04-10,2015,CLE,DET,4,8,8-4,DET,9,0,37,47,84,178,139,317,13,21,34,5,3:35
2530,413708,2015-04-10,2015,MIA,TBA,10,9,10-9,MIA,10,0,47,44,91,184,169,353,20,16,36,4,3:36
2531,413696,2015-04-10,2015,NYA,BOS,5,6,6-5,BOS,19,0,75,83,158,332,296,628,22,28,50,5,6:49 (:16 delay)
2532,413716,2015-04-11,2015,ARI,LAN,6,0,6-0,ARI,9,1,35,32,67,151,118,269,13,6,19,1,2:36
2533,413719,2015-04-11,2015,MIL,PIT,6,0,6-0,MIL,9,1,33,29,62,115,111,226,9,5,14,1,2:26
2534,413717,2015-04-11,2015,CHA,MIN,5,4,5-4,CHA,9,1,35,36,71,144,126,270,12,9,21,1,2:54
2535,413722,2015-04-11,2015,CIN,SLN,1,4,4-1,SLN,9,0,34,36,70,118,114,232,7,10,17,5,2:36
2536,413723,2015-04-11,2015,MIA,TBA,0,2,2-0,TBA,9,0,30,35,65,140,118,258,4,9,13,1,2:32
2537,413718,2015-04-11,2015,ATL,NYN,5,3,5-3,ATL,9,1,32,34,66,119,115,234,9,8,17,3,2:25
2538,413715,2015-04-11,2015,ANA,KCA,4,6,6-4,KCA,9,0,33,42,75,148,113,261,7,18,25,3,2:41
2539,413724,2015-04-11,2015,BAL,TOR,7,1,7-1,BAL,9,1,39,32,71,119,153,272,18,5,23,1,2:34
2540,413711,2015-04-11,2015,NYA,BOS,4,8,8-4,BOS,9,0,34,42,76,174,128,302,7,14,21,3,3:13
2541,413714,2015-04-11,2015,TEX,HOU,6,2,6-2,TEX,9,1,39,42,81,145,144,289,15,15,30,3,3:18
2542,413721,2015-04-11,2015,SDN,SFN,10,2,10-2,SDN,9,1,44,36,80,137,179,316,21,8,29,1,3:14
2543,413712,2015-04-11,2015,COL,CHN,5,9,9-5,CHN,9,0,40,44,84,164,146,310,14,19,33,3,3:19
2544,413725,2015-04-11,2015,PHI,WAS,3,2,3-2,PHI,10,0,43,40,83,180,155,335,16,12,28,2,3:25
2545,413720,2015-04-11,2015,OAK,SEA,4,5,5-4,SEA,11,0,47,46,93,174,162,336,17,13,30,5,3:39
2546,413713,2015-04-11,2015,CLE,DET,6,9,9-6,DET,9,0,40,45,85,189,168,357,13,21,34,7,4:16
2547,413733,2015-04-12,2015,ATL,NYN,3,4,4-3,NYN,9,0,34,40,74,131,102,233,7,16,23,4,2:37
2548,413736,2015-04-12,2015,SDN,SFN,6,4,6-4,SDN,9,1,36,37,73,136,151,287,13,11,24,3,3:01
2549,413732,2015-04-12,2015,CHA,MIN,6,2,6-2,CHA,9,1,37,36,73,155,131,286,12,9,21,3,2:56
2550,413730,2015-04-12,2015,ANA,KCA,2,9,9-2,KCA,9,0,33,44,77,151,129,280,8,17,25,2,2:56
2551,413727,2015-04-12,2015,COL,CHN,5,6,6-5,CHN,9,0,38,38,76,151,142,293,12,11,23,4,3:05
2552,413734,2015-04-12,2015,MIL,PIT,2,10,10-2,PIT,9,0,35,41,76,142,148,290,9,14,23,3,3:00
2553,413740,2015-04-12,2015,PHI,WAS,3,4,4-3,WAS,10,0,43,43,86,158,165,323,13,14,27,1,3:19
2554,413738,2015-04-12,2015,MIA,TBA,5,8,8-5,TBA,9,0,38,43,81,178,138,316,10,17,27,2,3:16
2555,413731,2015-04-12,2015,ARI,LAN,4,7,7-4,LAN,9,0,38,47,85,159,159,318,11,23,34,2,3:27
2556,413735,2015-04-12,2015,OAK,SEA,7,8,8-7,SEA,10,0,45,41,86,147,156,303,18,10,28,2,3:11
2557,413726,2015-04-12,2015,NYA,BOS,14,4,14-4,NYA,9,1,44,39,83,157,166,323,22,11,33,2,3:24
2558,413728,2015-04-12,2015,CLE,DET,5,8,8-5,DET,9,0,41,44,85,166,153,319,13,21,34,2,3:13
2559,413739,2015-04-12,2015,BAL,TOR,7,10,10-7,TOR,9,0,39,43,82,190,139,329,12,16,28,3,3:17
2560,413737,2015-04-12,2015,CIN,SLN,5,7,7-5,SLN,11,0,53,48,101,183,206,389,20,17,37,3,4:03
2561,413729,2015-04-12,2015,TEX,HOU,4,6,6-4,HOU,14,0,61,53,114,197,225,422,20,15,35,3,4:24
2562,413753,2015-04-13,2015,TOR,TBA,1,2,2-1,TBA,9,0,32,37,69,143,122,265,6,10,16,0,2:30
2563,413750,2015-04-13,2015,HOU,OAK,1,8,8-1,OAK,9,0,35,39,74,156,138,294,9,14,23,0,2:51
2564,413745,2015-04-13,2015,PIT,DET,5,4,5-4,PIT,9,1,33,34,67,125,117,242,9,9,18,2,2:31
2565,413742,2015-04-13,2015,SDN,ARI,4,8,8-4,ARI,9,0,35,44,79,173,145,318,10,16,26,1,3:02
2566,413744,2015-04-13,2015,SFN,COL,0,2,2-0,COL,9,0,39,38,77,122,149,271,13,15,28,2,2:58
2567,413752,2015-04-13,2015,LAN,SEA,6,5,6-5,LAN,10,0,42,36,78,142,155,297,14,7,21,4,3:04
2568,413747,2015-04-13,2015,ATL,MIA,3,2,3-2,ATL,9,1,35,36,71,153,142,295,14,10,24,1,3:02 (1:31 delay)
2569,413751,2015-04-13,2015,NYN,PHI,2,0,2-0,NYN,9,1,35,34,69,133,150,283,11,9,20,1,2:53
2570,413741,2015-04-13,2015,TEX,ANA,3,6,6-3,ANA,9,0,35,43,78,143,146,289,8,17,25,3,3:17
2571,413749,2015-04-13,2015,BAL,NYA,5,6,6-5,NYA,9,0,38,36,74,145,150,295,14,10,24,3,3:09
2572,413748,2015-04-13,2015,SLN,MIL,4,5,5-4,MIL,9,0,43,36,79,127,141,268,16,9,25,2,3:01
2573,413754,2015-04-13,2015,BOS,WAS,9,4,9-4,BOS,9,1,42,34,76,137,164,301,20,6,26,1,3:01
2574,413746,2015-04-13,2015,MIN,KCA,3,12,12-3,KCA,9,0,33,46,79,152,125,277,8,20,28,5,2:50
2575,413743,2015-04-13,2015,CHN,CIN,7,6,7-6,CHN,10,0,42,42,84,145,168,313,16,13,29,1,3:02
2576,413762,2015-04-14,2015,BAL,NYA,4,3,4-3,BAL,9,1,32,35,67,134,102,236,8,7,15,1,2:29
2577,413756,2015-04-14,2015,SDN,ARI,5,1,5-1,SDN,9,1,35,32,67,108,125,233,12,7,19,1,2:31
2578,413760,2015-04-14,2015,PIT,DET,0,2,2-0,DET,9,0,29,39,68,156,91,247,3,13,16,2,2:50
2579,413763,2015-04-14,2015,HOU,OAK,0,4,4-0,OAK,9,0,38,36,74,143,145,288,13,11,24,4,2:58
2580,413758,2015-04-14,2015,CHN,CIN,2,3,3-2,CIN,9,0,36,35,71,141,146,287,10,9,19,2,2:45
2581,413757,2015-04-14,2015,CLE,CHA,1,4,4-1,CHA,9,0,34,35,69,119,153,272,6,10,16,2,3:01
2582,413755,2015-04-14,2015,TEX,ANA,8,2,8-2,TEX,9,1,39,37,76,127,166,293,17,11,28,2,2:57
2583,413759,2015-04-14,2015,SFN,COL,1,4,4-1,COL,9,0,37,37,74,130,161,291,10,12,22,1,3:09
2584,413764,2015-04-14,2015,NYN,PHI,6,5,6-5,NYN,9,1,42,38,80,139,156,295,20,10,30,2,3:12
2585,413765,2015-04-14,2015,LAN,SEA,6,5,6-5,LAN,9,0,40,42,82,170,152,322,16,15,31,3,3:40
2586,413766,2015-04-14,2015,TOR,TBA,2,3,3-2,TBA,9,0,37,39,76,160,154,314,10,14,24,3,3:06
2587,413761,2015-04-14,2015,ATL,MIA,2,8,8-2,MIA,9,0,37,44,81,160,147,307,10,18,28,3,3:00
2588,413767,2015-04-14,2015,BOS,WAS,8,7,8-7,BOS,9,1,40,41,81,162,150,312,15,15,30,5,3:23
2589,413774,2015-04-15,2015,MIN,KCA,3,1,3-1,MIN,9,1,30,35,65,134,109,243,6,10,16,2,2:25
2590,413773,2015-04-15,2015,PIT,DET,0,1,1-0,DET,9,0,29,32,61,136,118,254,3,7,10,0,2:52
2591,413778,2015-04-15,2015,HOU,OAK,6,1,6-1,HOU,9,1,32,35,67,140,128,268,10,8,18,2,2:42
2592,413771,2015-04-15,2015,CHN,CIN,5,0,5-0,CHN,9,1,39,33,72,125,132,257,17,7,24,1,2:39
2593,413775,2015-04-15,2015,ATL,MIA,2,6,6-2,MIA,9,0,32,36,68,143,130,273,5,12,17,1,2:25
2594,413772,2015-04-15,2015,SFN,COL,2,4,4-2,COL,9,0,36,35,71,135,143,278,10,7,17,0,2:51
2595,413769,2015-04-15,2015,SDN,ARI,3,2,3-2,SDN,9,1,32,34,66,122,118,240,11,10,21,0,2:41
2596,413780,2015-04-15,2015,LAN,SEA,5,2,5-2,LAN,9,1,39,36,75,132,133,265,19,11,30,3,2:53
2597,413779,2015-04-15,2015,NYN,PHI,6,1,6-1,NYN,9,1,42,39,81,125,141,266,19,13,32,1,2:36
2598,413776,2015-04-15,2015,SLN,MIL,4,2,4-2,SLN,9,1,35,40,75,162,103,265,11,12,23,2,2:50
2599,413781,2015-04-15,2015,TOR,TBA,12,7,12-7,TOR,9,1,41,42,83,155,164,319,19,15,34,4,3:02
2600,413770,2015-04-15,2015,CLE,CHA,4,2,4-2,CLE,9,1,34,39,73,163,140,303,10,12,22,3,2:58
2601,413777,2015-04-15,2015,BAL,NYA,7,5,7-5,BAL,9,1,42,38,80,164,146,310,20,12,32,2,3:14
2602,413782,2015-04-15,2015,BOS,WAS,5,10,10-5,WAS,9,0,37,44,81,193,158,351,9,18,27,2,3:08
2603,413768,2015-04-15,2015,TEX,ANA,2,10,10-2,ANA,9,0,37,45,82,194,143,337,10,19,29,2,3:13
2604,413786,2015-04-16,2015,SLN,MIL,4,0,4-0,SLN,9,1,35,35,70,137,144,281,13,7,20,2,2:54
2605,413784,2015-04-16,2015,MIN,KCA,8,5,8-5,MIN,9,1,40,42,82,152,138,290,16,14,30,6,3:01
2606,413788,2015-04-16,2015,TOR,TBA,2,4,4-2,TBA,9,0,37,37,74,144,152,296,11,12,23,2,3:00
2607,413785,2015-04-16,2015,NYN,MIA,7,5,7-5,NYN,9,1,35,36,71,164,140,304,12,10,22,4,3:01
2608,413783,2015-04-16,2015,SFN,ARI,6,7,7-6,ARI,12,0,52,51,103,171,221,392,18,16,34,6,4:20
2609,413787,2015-04-16,2015,WAS,PHI,5,2,5-2,WAS,9,1,33,36,69,113,119,232,11,10,21,1,2:16
2610,413802,2015-04-17,2015,CHN,SDN,4,5,5-4,SDN,9,0,38,36,74,135,145,280,11,10,21,2,2:57
2611,413798,2015-04-17,2015,PIT,MIL,6,3,6-3,PIT,9,1,36,38,74,135,134,269,15,14,29,2,2:57
2612,413789,2015-04-17,2015,HOU,ANA,3,6,6-3,ANA,9,0,36,35,71,149,123,272,9,9,18,2,2:57
2613,413801,2015-04-17,2015,WAS,PHI,7,2,7-2,WAS,9,1,39,35,74,117,141,258,15,7,22,1,2:38
2614,413800,2015-04-17,2015,KCA,OAK,6,4,6-4,KCA,9,1,38,36,74,111,136,247,16,10,26,1,2:33
2615,413790,2015-04-17,2015,SFN,ARI,0,9,9-0,ARI,9,0,31,51,82,176,114,290,5,24,29,2,3:00
2616,413796,2015-04-17,2015,LAN,COL,7,3,7-3,LAN,9,1,38,35,73,148,154,302,16,8,24,1,3:18
2617,413799,2015-04-17,2015,TBA,NYA,4,5,5-4,NYA,9,0,37,37,74,184,165,349,11,11,22,3,3:12
2618,413791,2015-04-17,2015,TOR,ATL,7,8,8-7,ATL,9,0,41,45,86,164,161,325,15,17,32,2,3:09
2619,413795,2015-04-17,2015,MIN,CLE,3,2,3-2,MIN,11,0,42,45,87,175,149,324,14,14,28,3,3:38
2620,413803,2015-04-17,2015,SEA,TEX,1,3,3-1,TEX,9,0,34,36,70,139,147,286,10,11,21,3,3:00
2621,413793,2015-04-17,2015,DET,CHA,2,1,2-1,DET,9,0,35,32,67,118,113,231,10,6,16,0,2:35
2622,413794,2015-04-17,2015,SLN,CIN,6,1,6-1,SLN,9,1,33,37,70,134,120,254,10,9,19,0,2:21
2623,413797,2015-04-17,2015,NYN,MIA,4,1,4-1,NYN,9,1,34,33,67,117,134,251,10,7,17,2,2:38
2624,413792,2015-04-17,2015,BOS,BAL,3,2,3-2,BOS,9,0,35,34,69,165,137,302,13,7,20,4,3:13
2625,413810,2015-04-18,2015,MIN,CLE,2,4,4-2,CLE,9,0,34,36,70,108,145,253,9,9,18,2,2:33
2626,413813,2015-04-18,2015,PIT,MIL,6,2,6-2,PIT,9,1,36,32,68,117,139,256,12,6,18,0,2:30
2627,413804,2015-04-18,2015,HOU,ANA,4,0,4-0,HOU,9,1,33,33,66,147,135,282,10,6,16,1,2:38
2628,413815,2015-04-18,2015,KCA,OAK,0,5,5-0,OAK,9,0,34,37,71,134,122,256,9,11,20,2,2:34
2629,413811,2015-04-18,2015,LAN,COL,6,3,6-3,LAN,9,1,37,34,71,134,131,265,14,8,22,1,2:55
2630,413814,2015-04-18,2015,TBA,NYA,0,9,9-0,NYA,9,0,32,42,74,174,129,303,5,16,21,2,3:07
2631,413812,2015-04-18,2015,NYN,MIA,5,4,5-4,NYN,9,1,34,38,72,149,112,261,11,12,23,2,2:51
2632,413816,2015-04-18,2015,WAS,PHI,3,5,5-3,PHI,9,0,38,38,76,135,125,260,13,11,24,1,2:56 (:12 delay)
2633,413806,2015-04-18,2015,TOR,ATL,6,5,6-5,TOR,10,0,38,42,80,151,123,274,16,13,29,2,2:41
2634,413808,2015-04-18,2015,DET,CHA,3,12,12-3,CHA,9,0,36,48,84,174,144,318,9,22,31,2,3:01
2635,413807,2015-04-18,2015,BOS,BAL,1,4,4-1,BAL,9,0,35,41,76,145,163,308,10,15,25,1,3:24
2636,413818,2015-04-18,2015,SEA,TEX,3,1,3-1,SEA,9,1,36,33,69,141,149,290,15,6,21,1,3:00
2637,413817,2015-04-18,2015,CHN,SDN,7,6,7-6,CHN,11,0,51,44,95,177,219,396,21,11,32,3,3:49
2638,413805,2015-04-18,2015,SFN,ARI,4,1,4-1,SFN,9,1,39,34,73,127,145,272,14,8,22,2,2:38
2639,413809,2015-04-18,2015,SLN,CIN,5,2,5-2,SLN,9,1,37,38,75,132,125,257,15,12,27,3,2:42
2640,413824,2015-04-19,2015,SLN,CIN,2,1,2-1,SLN,9,1,27,37,64,114,86,200,4,10,14,0,2:02
2641,413819,2015-04-19,2015,HOU,ANA,4,3,4-3,HOU,9,1,38,34,72,151,161,312,14,8,22,3,3:20
2642,413822,2015-04-19,2015,BOS,BAL,3,8,8-3,BAL,9,0,37,44,81,153,150,303,10,19,29,1,3:14
2643,413823,2015-04-19,2015,DET,CHA,9,1,9-1,DET,9,1,37,33,70,131,144,275,14,10,24,1,2:45
2644,413829,2015-04-19,2015,TBA,NYA,3,5,5-3,NYA,9,0,38,42,80,178,153,331,12,17,29,6,3:33
2645,413830,2015-04-19,2015,KCA,OAK,4,2,4-2,KCA,9,1,34,37,71,151,124,275,11,13,24,2,3:08
2646,413821,2015-04-19,2015,TOR,ATL,2,5,5-2,ATL,9,0,35,37,72,155,142,297,10,13,23,3,2:41
2647,413832,2015-04-19,2015,CHN,SDN,2,5,5-2,SDN,9,0,38,38,76,152,144,296,10,12,22,1,2:51
2648,413820,2015-04-19,2015,SFN,ARI,1,5,5-1,ARI,9,0,33,38,71,124,112,236,9,11,20,2,2:45
2649,413828,2015-04-19,2015,PIT,MIL,5,2,5-2,PIT,9,1,35,33,68,133,130,263,12,6,18,0,2:39
2650,413831,2015-04-19,2015,WAS,PHI,4,1,4-1,WAS,9,1,38,36,74,117,148,265,15,9,24,1,2:40
2651,413827,2015-04-19,2015,NYN,MIA,7,6,7-6,NYN,9,1,35,39,74,128,129,257,13,12,25,3,2:49
2652,413826,2015-04-19,2015,LAN,COL,7,0,7-0,LAN,9,1,39,32,71,137,152,289,16,7,23,1,2:55
2653,413825,2015-04-19,2015,MIN,CLE,7,2,7-2,MIN,9,1,39,36,75,159,151,310,15,9,24,2,2:45
2654,413833,2015-04-19,2015,SEA,TEX,11,10,11-10,SEA,9,0,49,47,96,166,210,376,25,20,45,5,3:45
2655,413840,2015-04-20,2015,DET,NYA,2,1,2-1,DET,9,1,29,31,60,124,98,222,11,7,18,1,2:20
2656,413835,2015-04-20,2015,PIT,CHN,2,5,5-2,CHN,9,0,33,41,74,141,126,267,5,18,23,0,3:13 (:28 delay)
2657,413836,2015-04-20,2015,MIL,CIN,1,6,6-1,CIN,9,0,32,39,71,131,107,238,4,14,18,0,2:23
2658,413838,2015-04-20,2015,SEA,HOU,5,7,7-5,HOU,9,0,42,37,79,136,179,315,15,10,25,5,3:26
2659,413839,2015-04-20,2015,KCA,MIN,7,1,7-1,KCA,9,1,35,33,68,125,136,261,12,7,19,2,2:43
2660,413834,2015-04-20,2015,BOS,BAL,7,1,7-1,BOS,7,1,32,27,59,113,128,241,14,7,21,2,2:21 (1:42 delay)
2661,413841,2015-04-20,2015,ANA,OAK,3,6,6-3,OAK,9,0,37,38,75,139,143,282,10,12,22,2,2:57
2662,413837,2015-04-20,2015,CHA,CLE,4,3,4-3,CHA,9,0,38,36,74,131,153,284,14,9,23,2,2:53
2663,413842,2015-04-20,2015,COL,SDN,3,14,14-3,SDN,9,0,38,46,84,161,151,312,13,18,31,2,3:09
2664,413851,2015-04-21,2015,PHI,MIA,7,3,7-3,PHI,9,1,34,37,71,131,127,258,10,11,21,0,2:29
2665,413845,2015-04-21,2015,TBA,BOS,0,1,1-0,BOS,9,0,32,37,69,151,117,268,8,10,18,3,2:48
2666,413850,2015-04-21,2015,SFN,LAN,6,2,6-2,SFN,9,1,37,36,73,134,155,289,15,13,28,6,3:09
2667,413843,2015-04-21,2015,NYN,ATL,7,1,7-1,NYN,9,1,40,37,77,140,149,289,15,11,26,3,2:41
2668,413849,2015-04-21,2015,SEA,HOU,3,6,6-3,HOU,9,0,34,43,77,169,127,296,9,16,25,2,3:00
2669,413857,2015-04-21,2015,ARI,TEX,1,7,7-1,TEX,9,0,38,39,77,170,148,318,9,10,19,2,3:04
2670,413853,2015-04-21,2015,DET,NYA,2,5,5-2,NYA,9,0,36,43,79,177,136,313,13,17,30,5,3:24
2671,413854,2015-04-21,2015,ANA,OAK,14,1,14-1,ANA,9,1,44,36,80,146,176,322,20,9,29,2,3:15
2672,413852,2015-04-21,2015,KCA,MIN,6,5,6-5,KCA,9,1,39,37,76,145,141,286,15,11,26,4,2:55
2673,413855,2015-04-21,2015,COL,SDN,6,7,7-6,SDN,9,0,35,44,79,159,137,296,8,21,29,2,3:06
2674,413846,2015-04-21,2015,PIT,CHN,8,9,9-8,CHN,9,0,40,45,85,168,159,327,15,18,33,2,3:18
2675,413847,2015-04-21,2015,MIL,CIN,10,16,16-10,CIN,9,0,42,49,91,185,159,344,15,20,35,2,3:22
2676,413856,2015-04-21,2015,WAS,SLN,2,1,2-1,WAS,10,0,42,44,86,165,196,361,15,18,33,5,3:43
2677,413844,2015-04-21,2015,TOR,BAL,13,6,13-6,TOR,9,1,45,40,85,142,157,299,21,14,35,3,2:53
2678,413848,2015-04-21,2015,CHA,CLE,2,6,6-2,CLE,9,0,35,38,73,173,140,313,8,12,20,5,3:07
2679,413862,2015-04-22,2015,MIL,CIN,1,2,2-1,CIN,9,0,34,31,65,110,139,249,7,7,14,0,2:28
2680,413870,2015-04-22,2015,COL,SDN,5,4,5-4,COL,9,0,36,34,70,108,131,239,16,8,24,0,2:39
2681,413864,2015-04-22,2015,SEA,HOU,3,2,3-2,SEA,9,1,31,39,70,132,114,246,8,13,21,2,2:34
2682,413867,2015-04-22,2015,KCA,MIN,0,3,3-0,MIN,9,0,35,42,77,155,122,277,10,17,27,0,2:47
2683,413859,2015-04-22,2015,TOR,BAL,4,2,4-2,TOR,9,1,35,36,71,136,137,273,12,13,25,2,2:36
2684,413865,2015-04-22,2015,SFN,LAN,3,2,3-2,SFN,9,0,34,38,72,146,138,284,9,10,19,3,3:16
2685,413858,2015-04-22,2015,NYN,ATL,3,2,3-2,NYN,9,1,34,36,70,131,143,274,10,12,22,2,2:34 (:31 delay)
2686,413863,2015-04-22,2015,CHA,CLE,6,0,6-0,CHA,9,1,37,38,75,162,126,288,15,12,27,1,2:56
2687,413860,2015-04-22,2015,TBA,BOS,7,5,7-5,TBA,9,1,37,40,77,166,134,300,16,13,29,3,3:10
2688,413869,2015-04-22,2015,ANA,OAK,2,9,9-2,OAK,9,0,34,45,79,158,124,282,7,21,28,2,2:58
2689,413861,2015-04-22,2015,PIT,CHN,4,3,4-3,PIT,9,1,34,40,74,168,131,299,8,13,21,3,3:04
2690,413866,2015-04-22,2015,PHI,MIA,1,6,6-1,MIA,9,0,30,44,74,178,126,304,5,17,22,1,2:55
2691,413872,2015-04-22,2015,ARI,TEX,8,5,8-5,ARI,9,1,37,38,75,146,153,299,11,15,26,2,2:59
2692,413871,2015-04-22,2015,WAS,SLN,5,7,7-5,SLN,9,0,37,43,80,166,140,306,10,17,27,1,2:51
2693,413868,2015-04-22,2015,DET,NYA,4,13,13-4,NYA,9,0,37,49,86,212,155,367,11,23,34,2,3:35
2694,413877,2015-04-23,2015,MIL,CIN,4,2,4-2,MIL,9,1,34,30,64,123,121,244,12,5,17,1,2:28
2695,413884,2015-04-23,2015,WAS,SLN,1,4,4-1,SLN,9,0,35,36,71,118,122,240,9,11,20,1,2:31
2696,413882,2015-04-23,2015,ANA,OAK,2,0,2-0,ANA,9,1,29,37,66,145,108,253,4,10,14,1,2:20
2697,413881,2015-04-23,2015,DET,NYA,1,2,2-1,NYA,9,0,32,36,68,153,123,276,5,10,15,3,3:02
2698,413875,2015-04-23,2015,TBA,BOS,2,1,2-1,TBA,9,0,36,34,70,125,146,271,11,6,17,1,3:00
2699,413873,2015-04-23,2015,NYN,ATL,6,3,6-3,NYN,9,1,37,35,72,132,179,311,14,9,23,3,3:18
2700,413876,2015-04-23,2015,PIT,CHN,5,4,5-4,PIT,9,1,36,35,71,141,169,310,13,11,24,3,3:06
2701,413880,2015-04-23,2015,PHI,MIA,1,9,9-1,MIA,9,0,35,45,80,188,124,312,10,18,28,1,2:52
2702,413874,2015-04-23,2015,TOR,BAL,7,6,7-6,TOR,9,1,38,36,74,122,146,268,15,9,24,2,2:36
2703,413883,2015-04-23,2015,COL,SDN,2,1,2-1,COL,9,1,37,34,71,143,154,297,13,10,23,2,2:53
2704,413879,2015-04-23,2015,SFN,LAN,3,2,3-2,SFN,10,0,42,39,81,138,153,291,16,10,26,3,3:23
2705,413878,2015-04-23,2015,CHA,KCA,2,3,3-2,KCA,13,0,51,50,101,187,189,376,13,17,30,0,4:07
2706,413892,2015-04-24,2015,SEA,MIN,2,0,2-0,SEA,9,1,30,32,62,102,96,198,6,5,11,0,2:03
2707,413893,2015-04-24,2015,NYA,NYN,6,1,6-1,NYA,9,1,37,32,69,115,140,255,13,5,18,2,2:33
2708,413899,2015-04-24,2015,MIA,WAS,3,2,3-2,MIA,9,1,31,35,66,121,108,229,9,9,18,3,2:32
2709,413885,2015-04-24,2015,PHI,ATL,1,0,1-0,PHI,9,0,37,28,65,117,142,259,10,4,14,3,2:34
2710,413896,2015-04-24,2015,MIL,SLN,0,3,3-0,SLN,9,0,32,38,70,140,121,261,7,12,19,1,2:42
2711,413897,2015-04-24,2015,ANA,TEX,3,2,3-2,ANA,9,1,35,33,68,134,139,273,12,8,20,0,2:47
2712,413895,2015-04-24,2015,COL,SFN,6,4,6-4,COL,9,1,41,38,79,127,134,261,19,16,35,3,2:51
2713,413891,2015-04-24,2015,SDN,LAN,0,3,3-0,LAN,9,0,35,36,71,144,133,277,9,11,20,2,3:04
2714,413898,2015-04-24,2015,TBA,TOR,12,3,12-3,TBA,9,1,41,34,75,129,154,283,16,7,23,2,2:29
2715,413894,2015-04-24,2015,ARI,PIT,1,4,4-1,PIT,9,0,36,36,72,133,123,256,9,11,20,3,2:41
2716,413890,2015-04-24,2015,CHA,KCA,3,2,3-2,CHA,9,0,40,33,73,130,164,294,14,9,23,3,3:19
2717,413888,2015-04-24,2015,DET,CLE,1,13,13-1,CLE,9,0,39,43,82,140,150,290,12,18,30,1,2:52
2718,413886,2015-04-24,2015,BAL,BOS,5,7,7-5,BOS,9,0,39,41,80,146,161,307,15,14,29,4,3:29
2719,413890,2015-04-24,2015,CHA,KCA,3,2,3-2,CHA,9,0,40,33,73,130,164,294,14,9,23,3,3:19
2720,413889,2015-04-24,2015,OAK,HOU,4,5,5-4,HOU,11,0,42,49,91,187,161,348,11,20,31,3,3:36
2721,413887,2015-04-24,2015,CIN,CHN,3,7,7-3,CHN,11,0,44,45,89,194,200,394,13,13,26,2,3:48
2722,413900,2015-04-25,2015,PHI,ATL,2,5,5-2,ATL,9,0,34,38,72,134,106,240,8,13,21,2,2:27
2723,413913,2015-04-25,2015,TBA,TOR,4,2,4-2,TBA,9,1,35,33,68,132,135,267,12,7,19,2,2:31
2724,413908,2015-04-25,2015,NYA,NYN,2,8,8-2,NYN,9,0,33,41,74,152,110,262,7,13,20,2,2:45
2725,413914,2015-04-25,2015,MIA,WAS,8,0,8-0,MIA,9,1,37,34,71,120,145,265,16,8,24,1,2:35
2726,413911,2015-04-25,2015,MIL,SLN,3,5,5-3,SLN,9,0,37,38,75,145,124,269,13,13,26,4,3:01
2727,413909,2015-04-25,2015,ARI,PIT,1,2,2-1,PIT,9,0,36,34,70,143,127,270,12,7,19,0,2:52
2728,413903,2015-04-25,2015,DET,CLE,4,1,4-1,DET,9,1,39,35,74,148,154,302,18,10,28,1,2:58
2729,413904,2015-04-25,2015,OAK,HOU,3,9,9-3,HOU,9,0,37,44,81,142,152,294,10,17,27,2,2:55
2730,413901,2015-04-25,2015,BAL,BOS,5,4,5-4,BAL,10,0,41,39,80,145,131,276,13,11,24,1,2:57
2731,413912,2015-04-25,2015,ANA,TEX,4,1,4-1,ANA,9,1,34,38,72,146,151,297,13,12,25,4,3:10
2732,413906,2015-04-25,2015,SDN,LAN,8,11,11-8,LAN,9,0,38,45,83,196,164,360,11,19,30,3,3:36
2733,413907,2015-04-25,2015,SEA,MIN,5,8,8-5,MIN,9,0,37,46,83,192,146,338,10,17,27,8,3:26
2734,413910,2015-04-25,2015,COL,SFN,4,5,5-4,SFN,11,0,42,51,93,199,140,339,12,19,31,3,3:52
2735,413928,2015-04-26,2015,TBA,TOR,5,1,5-1,TBA,9,1,38,34,72,126,121,247,16,6,22,1,2:23
2736,413921,2015-04-26,2015,SDN,LAN,3,1,3-1,SDN,9,1,30,31,61,132,118,250,7,6,13,0,2:30
2737,413923,2015-04-26,2015,NYA,NYN,6,4,6-4,NYA,9,1,33,36,69,142,127,269,10,10,20,3,2:45
2738,413929,2015-04-26,2015,MIA,WAS,6,2,6-2,MIA,9,1,38,34,72,151,133,284,15,7,22,1,2:40
2739,413915,2015-04-26,2015,PHI,ATL,5,4,5-4,PHI,9,1,34,40,74,142,121,263,11,14,25,1,2:38
2740,413917,2015-04-26,2015,CIN,CHN,2,5,5-2,CHN,9,0,36,36,72,142,153,295,9,10,19,0,2:46
2741,413926,2015-04-26,2015,MIL,SLN,6,3,6-3,MIL,9,1,35,44,79,157,134,291,11,17,28,1,3:03
2742,413918,2015-04-26,2015,DET,CLE,8,6,8-6,DET,9,1,40,39,79,131,153,284,19,13,32,2,3:01
2743,413919,2015-04-26,2015,OAK,HOU,6,7,7-6,HOU,9,0,37,42,79,167,139,306,10,15,25,2,3:11
2744,413924,2015-04-26,2015,ARI,PIT,0,8,8-0,PIT,9,0,35,44,79,178,140,318,10,17,27,4,3:18
2745,413922,2015-04-26,2015,SEA,MIN,2,4,4-2,MIN,11,0,43,49,92,205,148,353,11,20,31,3,3:40
2746,413916,2015-04-26,2015,BAL,BOS,18,7,18-7,BAL,9,1,49,43,92,152,185,337,24,15,39,3,3:13
2747,413927,2015-04-26,2015,ANA,TEX,4,5,5-4,TEX,11,0,51,52,103,203,186,389,20,19,39,1,4:13
2748,413920,2015-04-26,2015,CHA,KCA,5,3,5-3,CHA,9,1,33,36,69,145,119,264,8,10,18,2,2:48
2749,413936,2015-04-27,2015,MIA,NYN,1,3,3-1,NYN,9,0,33,35,68,120,86,206,6,9,15,1,1:58
2750,413938,2015-04-27,2015,CHN,PIT,4,0,4-0,CHN,9,1,34,32,66,120,124,244,13,4,17,0,2:20
2751,413937,2015-04-27,2015,SLN,PHI,1,4,4-1,PHI,9,0,36,37,73,108,147,255,11,12,23,0,2:32
2752,413939,2015-04-27,2015,TEX,SEA,1,3,3-1,SEA,9,0,36,33,69,140,130,270,10,8,18,2,2:47 (:55 delay)
2753,413941,2015-04-27,2015,NYA,TBA,4,1,4-1,NYA,9,1,38,34,72,127,162,289,16,7,23,4,2:59
2754,413932,2015-04-27,2015,MIN,DET,4,5,5-4,DET,9,0,38,38,76,151,145,296,11,18,29,3,3:17
2755,413942,2015-04-27,2015,BOS,TOR,6,5,6-5,BOS,9,0,37,36,73,145,156,301,14,10,24,1,2:48 (:33 delay)
2756,413940,2015-04-27,2015,LAN,SFN,8,3,8-3,LAN,9,1,39,37,76,143,136,279,16,11,27,2,2:58
2757,413934,2015-04-27,2015,CLE,KCA,2,6,6-2,KCA,9,0,35,42,77,154,157,311,9,17,26,2,3:22
2758,413943,2015-04-27,2015,ATL,WAS,8,4,8-4,ATL,9,1,40,39,79,150,158,308,17,11,28,3,3:08
2759,413931,2015-04-27,2015,ARI,COL,4,5,5-4,COL,9,0,40,38,78,149,159,308,13,17,30,2,3:29
2760,413933,2015-04-27,2015,SDN,HOU,4,9,9-4,HOU,9,0,37,42,79,193,137,330,10,15,25,3,3:28
2761,413935,2015-04-27,2015,CIN,MIL,9,6,9-6,CIN,9,1,42,39,81,147,176,323,20,15,35,3,3:02
2762,413944,2015-04-28,2015,OAK,ANA,6,2,6-2,OAK,9,1,33,31,64,117,116,233,9,7,16,0,2:06
2763,413950,2015-04-28,2015,CIN,MIL,4,2,4-2,CIN,9,1,33,31,64,98,136,234,10,4,14,0,2:11
2764,413947,2015-04-28,2015,MIN,DET,3,2,3-2,MIN,9,1,34,32,66,128,132,260,11,5,16,1,2:40
2765,413954,2015-04-28,2015,TEX,SEA,1,2,2-1,SEA,9,0,35,34,69,141,119,260,8,9,17,4,2:43
2766,413955,2015-04-28,2015,LAN,SFN,1,2,2-1,SFN,9,0,33,38,71,129,120,249,6,12,18,2,2:50
2767,413951,2015-04-28,2015,MIA,NYN,4,3,4-3,MIA,9,1,34,40,74,138,125,263,10,12,22,3,2:46
2768,413953,2015-04-28,2015,CHN,PIT,6,2,6-2,CHN,9,1,42,32,74,117,159,276,20,5,25,1,2:51
2769,413956,2015-04-28,2015,NYA,TBA,4,2,4-2,NYA,9,1,34,39,73,167,124,291,11,12,23,2,2:58
2770,413949,2015-04-28,2015,CLE,KCA,5,11,11-5,KCA,9,0,39,45,84,155,151,306,14,23,37,3,3:13
2771,413946,2015-04-28,2015,ARI,COL,12,5,12-5,ARI,9,1,40,41,81,159,134,293,18,15,33,2,3:10
2772,413952,2015-04-28,2015,SLN,PHI,11,5,11-5,SLN,9,1,44,39,83,126,172,298,21,12,33,3,2:58
2773,413948,2015-04-28,2015,SDN,HOU,3,14,14-3,HOU,9,0,36,50,86,185,143,328,8,23,31,1,3:17
2774,413957,2015-04-28,2015,BOS,TOR,8,11,11-8,TOR,9,0,46,48,94,197,175,372,20,23,43,5,4:01
2775,413958,2015-04-28,2015,ATL,WAS,12,13,13-12,WAS,9,0,51,47,98,148,174,322,25,20,45,2,3:26
2776,413960,2015-04-29,2015,BAL,CHA,8,2,8-2,BAL,9,1,36,31,67,115,112,227,12,5,17,0,2:03
2777,413972,2015-04-29,2015,BOS,TOR,4,1,4-1,BOS,9,1,32,33,65,135,121,256,10,6,16,0,2:43
2778,413961,2015-04-29,2015,ARI,COL,9,1,9-1,ARI,9,1,40,31,71,110,136,246,18,5,23,1,2:34
2779,413967,2015-04-29,2015,SLN,PHI,5,2,5-2,SLN,9,1,35,38,73,138,110,248,11,13,24,0,2:38
2780,413964,2015-04-29,2015,CLE,KCA,7,5,7-5,CLE,9,1,37,37,74,138,136,274,13,10,23,2,2:41
2781,413970,2015-04-29,2015,LAN,SFN,7,3,7-3,LAN,9,1,33,37,70,154,119,273,11,9,20,0,2:54
2782,413966,2015-04-29,2015,MIA,NYN,7,3,7-3,MIA,9,1,36,36,72,142,127,269,13,11,24,4,2:54
2783,413959,2015-04-29,2015,OAK,ANA,3,6,6-3,ANA,9,0,36,37,73,153,131,284,9,12,21,4,3:01
2784,413963,2015-04-29,2015,SDN,HOU,2,7,7-2,HOU,9,0,31,40,71,159,127,286,3,12,15,1,2:34
2785,413965,2015-04-29,2015,CIN,MIL,3,8,8-3,MIL,9,0,34,44,78,184,129,313,9,16,25,1,2:58
2786,413973,2015-04-29,2015,ATL,WAS,4,13,13-4,WAS,9,0,33,47,80,192,120,312,9,20,29,0,2:47
2787,413969,2015-04-29,2015,TEX,SEA,2,5,5-2,SEA,9,0,32,43,75,169,143,312,6,16,22,4,3:05
2788,413968,2015-04-29,2015,CHN,PIT,1,8,8-1,PIT,9,0,33,46,79,175,154,329,9,21,30,0,3:04
2789,413962,2015-04-29,2015,MIN,DET,7,10,10-7,DET,9,0,40,42,82,158,163,321,15,17,32,6,3:33
2790,413971,2015-04-29,2015,NYA,TBA,2,3,3-2,TBA,13,0,48,51,99,196,194,390,11,13,24,3,3:58
2791,413976,2015-04-30,2015,ATL,CIN,1,5,5-1,CIN,9,0,31,40,71,146,122,268,7,14,21,0,2:22
2792,413977,2015-04-30,2015,KCA,DET,8,1,8-1,KCA,9,1,40,35,75,129,145,274,16,10,26,2,3:02
2793,413981,2015-04-30,2015,NYN,WAS,2,8,8-2,WAS,9,0,35,42,77,156,139,295,8,15,23,4,2:54
2794,413979,2015-04-30,2015,HOU,SEA,3,2,3-2,HOU,10,0,37,39,76,145,137,282,10,13,23,2,3:01
2795,413978,2015-04-30,2015,SLN,PHI,9,3,9-3,SLN,9,1,40,36,76,133,163,296,19,10,29,4,2:55
2796,413980,2015-04-30,2015,CLE,TOR,1,5,5-1,TOR,9,0,38,37,75,124,172,296,13,12,25,2,2:46
2797,413974,2015-04-30,2015,OAK,ANA,5,6,6-5,ANA,9,0,39,42,81,154,161,315,14,17,31,3,3:23
2798,413975,2015-04-30,2015,MIN,CHA,12,2,12-2,MIN,9,1,40,39,79,139,129,268,15,13,28,2,2:40
2799,413984,2015-05-01,2015,MIN,CHA,1,0,1-0,MIN,9,1,31,35,66,111,124,235,10,8,18,1,2:32
2800,413982,2015-05-01,2015,SFN,ANA,3,2,3-2,SFN,9,0,36,37,73,144,133,277,10,9,19,3,3:04
2801,413989,2015-05-01,2015,BOS,NYA,2,3,3-2,NYA,9,0,38,42,80,136,151,287,12,17,29,1,3:14
2802,413988,2015-05-01,2015,CHN,MIL,1,0,1-0,CHN,9,1,33,33,66,118,156,274,13,6,19,0,2:39
2803,413996,2015-05-01,2015,NYN,WAS,4,0,4-0,NYN,9,1,34,32,66,122,120,242,11,7,18,2,2:29
2804,413983,2015-05-01,2015,LAN,ARI,8,0,8-0,LAN,9,1,36,33,69,113,157,270,12,6,18,1,2:47
2805,413994,2015-05-01,2015,BAL,TBA,0,2,2-0,TBA,9,0,31,32,63,120,114,234,4,6,10,0,2:19
2806,413987,2015-05-01,2015,KCA,DET,4,1,4-1,KCA,9,1,35,36,71,151,110,261,12,9,21,1,2:47
2807,413992,2015-05-01,2015,SLN,PIT,2,1,2-1,SLN,10,0,40,37,77,148,166,314,14,9,23,4,3:31
2808,413993,2015-05-01,2015,HOU,SEA,4,3,4-3,HOU,9,1,32,35,67,138,130,268,12,8,20,2,2:50
2809,413985,2015-05-01,2015,ATL,CIN,4,3,4-3,ATL,9,1,35,37,72,141,134,275,12,11,23,1,2:36
2810,413990,2015-05-01,2015,TEX,OAK,5,7,7-5,OAK,9,0,39,38,77,173,140,313,12,12,24,3,3:11
2811,413995,2015-05-01,2015,CLE,TOR,9,4,9-4,CLE,9,1,41,37,78,144,135,279,18,12,30,1,2:37
2812,413991,2015-05-01,2015,MIA,PHI,4,3,4-3,MIA,9,0,40,34,74,148,148,296,19,8,27,0,2:57
2813,413986,2015-05-01,2015,SDN,COL,14,3,14-3,SDN,9,1,45,35,80,150,173,323,19,9,28,1,3:26
2814,413997,2015-05-02,2015,SFN,ANA,5,4,5-4,SFN,9,1,37,33,70,117,127,244,13,8,21,3,2:36
2815,414004,2015-05-02,2015,BOS,NYA,2,4,4-2,NYA,9,0,36,35,71,136,147,283,10,9,19,3,2:44
2816,414009,2015-05-02,2015,BAL,TBA,4,0,4-0,BAL,9,1,34,32,66,122,147,269,11,5,16,1,2:33
2817,414002,2015-05-02,2015,KCA,DET,1,2,2-1,DET,9,0,31,36,67,138,106,244,5,10,15,0,2:55
2818,413999,2015-05-02,2015,MIN,CHA,5,3,5-3,MIN,9,1,37,35,72,130,140,270,14,13,27,5,3:05
2819,414011,2015-05-02,2015,NYN,WAS,0,1,1-0,WAS,9,0,33,37,70,127,137,264,8,10,18,1,2:31
2820,414008,2015-05-02,2015,HOU,SEA,11,4,11-4,HOU,9,1,41,35,76,132,138,270,18,9,27,1,2:38
2821,414006,2015-05-02,2015,MIA,PHI,7,0,7-0,MIA,9,1,40,33,73,141,135,276,18,6,24,0,2:38
2822,414000,2015-05-02,2015,ATL,CIN,4,8,8-4,CIN,9,0,36,40,76,131,138,269,10,14,24,2,2:34
2823,414003,2015-05-02,2015,CHN,MIL,1,6,6-1,MIL,9,0,35,39,74,160,153,313,8,13,21,2,3:05
2824,414010,2015-05-02,2015,CLE,TOR,4,11,11-4,TOR,9,0,40,45,85,157,166,323,12,18,30,4,3:23
2825,413998,2015-05-02,2015,LAN,ARI,6,4,6-4,LAN,9,1,37,36,73,143,142,285,14,11,25,2,3:14
2826,414001,2015-05-02,2015,SDN,COL,4,2,4-2,SDN,9,1,37,34,71,137,150,287,14,8,22,0,2:57
2827,414007,2015-05-02,2015,SLN,PIT,2,1,2-1,SLN,11,0,38,52,90,179,131,310,10,21,31,2,3:27
2828,414005,2015-05-02,2015,TEX,OAK,8,7,8-7,TEX,10,0,45,44,89,169,157,326,19,15,34,7,3:45
2829,414012,2015-05-03,2015,SFN,ANA,5,0,5-0,SFN,9,1,36,32,68,124,119,243,13,5,18,0,2:16
2830,414017,2015-05-03,2015,KCA,DET,4,6,6-4,DET,9,0,34,36,70,117,132,249,7,12,19,1,2:38
2831,414026,2015-05-03,2015,NYN,WAS,0,1,1-0,WAS,9,0,34,40,74,146,130,276,7,15,22,4,2:55
2832,414023,2015-05-03,2015,HOU,SEA,7,6,7-6,HOU,9,1,34,36,70,143,121,264,13,13,26,2,2:50
2833,414018,2015-05-03,2015,CHN,MIL,3,5,5-3,MIL,9,0,38,37,75,133,142,275,10,13,23,3,3:01
2834,414025,2015-05-03,2015,CLE,TOR,10,7,10-7,CLE,9,1,41,42,83,152,163,315,21,15,36,5,3:06
2835,414015,2015-05-03,2015,ATL,CIN,5,0,5-0,ATL,9,1,33,34,67,146,108,254,10,8,18,1,2:31
2836,414024,2015-05-03,2015,BAL,TBA,4,2,4-2,BAL,9,1,35,36,71,129,131,260,11,10,21,5,2:44
2837,414021,2015-05-03,2015,MIA,PHI,2,6,6-2,PHI,9,0,34,42,76,158,111,269,8,13,21,1,2:45
2838,414016,2015-05-03,2015,SDN,COL,8,6,8-6,SDN,9,1,35,39,74,151,136,287,11,13,24,2,3:12
2839,414014,2015-05-03,2015,MIN,CHA,13,3,13-3,MIN,9,1,47,38,85,135,166,301,21,14,35,4,3:20
2840,414020,2015-05-03,2015,TEX,OAK,1,7,7-1,OAK,9,0,42,42,84,173,160,333,14,16,30,4,3:21
2841,414019,2015-05-03,2015,BOS,NYA,5,8,8-5,NYA,9,0,39,47,86,188,165,353,13,19,32,6,3:52
2842,414013,2015-05-03,2015,LAN,ARI,1,0,1-0,LAN,13,0,44,44,88,177,191,368,9,11,20,4,4:02
2843,414022,2015-05-03,2015,SLN,PIT,3,2,3-2,SLN,14,0,54,57,111,218,216,434,18,15,33,3,4:28
2844,414031,2015-05-04,2015,TOR,NYA,3,1,3-1,TOR,9,1,34,32,66,118,112,230,10,6,16,1,2:18
2845,414034,2015-05-04,2015,SFN,SDN,2,0,2-0,SFN,9,1,33,33,66,128,117,245,11,3,14,1,2:32
2846,414030,2015-05-04,2015,WAS,MIA,6,4,6-4,WAS,9,1,39,39,78,133,128,261,16,14,30,3,2:42
2847,414037,2015-05-04,2015,HOU,TEX,1,2,2-1,TEX,9,0,32,35,67,128,134,262,6,9,15,0,2:36
2848,414029,2015-05-04,2015,MIL,LAN,4,3,4-3,MIL,9,1,31,39,70,177,105,282,7,12,19,1,2:51
2849,414036,2015-05-04,2015,BOS,TBA,1,5,5-1,TBA,9,0,34,42,76,162,139,301,8,16,24,1,3:10
2850,414028,2015-05-04,2015,SLN,CHN,10,9,10-9,SLN,9,1,40,46,86,193,154,347,16,19,35,4,3:39
2851,414033,2015-05-04,2015,ATL,PHI,2,5,5-2,PHI,9,0,38,42,80,163,164,327,12,18,30,2,3:08
2852,414035,2015-05-04,2015,ANA,SEA,2,3,3-2,SEA,9,0,34,33,67,112,129,241,10,6,16,2,2:36
2853,414032,2015-05-04,2015,MIN,OAK,8,7,8-7,MIN,9,1,38,42,80,143,161,304,15,15,30,2,3:10
2854,414039,2015-05-05,2015,NYN,BAL,3,2,3-2,NYN,9,1,30,34,64,112,105,217,8,7,15,1,2:19
2855,414049,2015-05-05,2015,SFN,SDN,6,0,6-0,SFN,9,1,37,33,70,119,129,248,14,6,20,0,2:25
2856,414050,2015-05-05,2015,ANA,SEA,5,4,5-4,ANA,9,0,35,39,74,146,114,260,13,13,26,1,2:37
2857,414043,2015-05-05,2015,CHA,DET,5,2,5-2,CHA,9,1,32,36,68,127,115,242,11,8,19,1,2:37
2858,414051,2015-05-05,2015,BOS,TBA,2,0,2-0,BOS,9,1,32,34,66,127,120,247,8,8,16,0,2:26
2859,414042,2015-05-05,2015,KCA,CLE,5,3,5-3,KCA,9,1,32,33,65,129,134,263,8,6,14,1,2:26
2860,414044,2015-05-05,2015,MIL,LAN,2,8,8-2,LAN,9,0,33,42,75,184,119,303,6,15,21,3,3:12
2861,414046,2015-05-05,2015,TOR,NYA,3,6,6-3,NYA,9,0,37,39,76,156,128,284,11,13,24,2,2:54
2862,414052,2015-05-05,2015,HOU,TEX,1,7,7-1,TEX,9,0,31,37,68,156,117,273,4,13,17,0,2:41
2863,414048,2015-05-05,2015,ATL,PHI,9,0,9-0,ATL,9,1,40,31,71,99,150,249,18,4,22,1,2:23
2864,414047,2015-05-05,2015,MIN,OAK,1,2,2-1,OAK,9,0,33,37,70,145,117,262,6,11,17,4,2:43
2865,414045,2015-05-05,2015,WAS,MIA,1,2,2-1,MIA,9,0,36,39,75,157,147,304,9,11,20,2,3:07 (:28 delay)
2866,414040,2015-05-05,2015,SLN,CHN,7,4,7-4,SLN,9,1,39,42,81,180,127,307,17,14,31,3,3:13
2867,414041,2015-05-05,2015,PIT,CIN,1,7,7-1,CIN,9,0,37,40,77,139,148,287,11,15,26,1,2:50
2868,414065,2015-05-06,2015,ANA,SEA,4,3,4-3,ANA,9,0,33,37,70,132,111,243,9,11,20,1,2:35
2869,414038,2015-05-06,2015,COL,ARI,1,5,5-1,ARI,9,0,32,39,71,129,129,258,6,14,20,1,2:31
2870,414059,2015-05-06,2015,MIL,LAN,6,3,6-3,MIL,9,1,38,34,72,117,144,261,15,8,23,2,2:47
2871,414054,2015-05-06,2015,NYN,BAL,5,1,5-1,NYN,9,1,34,38,72,139,149,288,10,11,21,1,2:52
2872,414058,2015-05-06,2015,CHA,DET,7,6,7-6,CHA,9,1,42,45,87,177,179,356,17,20,37,4,3:41
2873,414038,2015-05-06,2015,COL,ARI,1,5,5-1,ARI,9,0,32,39,71,129,129,258,6,14,20,1,2:31
2874,414067,2015-05-06,2015,HOU,TEX,3,11,11-3,TEX,9,0,34,42,76,154,102,256,9,16,25,1,2:32
2875,414055,2015-05-06,2015,SLN,CHN,5,6,6-5,CHN,9,0,41,38,79,140,140,280,15,13,28,0,2:56
2876,414056,2015-05-06,2015,PIT,CIN,0,3,3-0,CIN,9,0,35,37,72,136,120,256,7,13,20,0,2:35
2877,414061,2015-05-06,2015,TOR,NYA,5,1,5-1,TOR,9,1,36,36,72,135,128,263,14,11,25,3,2:30
2878,414064,2015-05-06,2015,SFN,SDN,1,9,9-1,SDN,9,0,33,50,83,171,119,290,7,23,30,1,2:59
2879,414060,2015-05-06,2015,WAS,MIA,7,5,7-5,WAS,9,1,36,40,76,151,129,280,14,14,28,1,2:40
2880,414063,2015-05-06,2015,ATL,PHI,7,5,7-5,ATL,9,1,35,42,77,170,129,299,14,16,30,3,3:07
2881,414057,2015-05-06,2015,KCA,CLE,3,10,10-3,CLE,9,0,34,44,78,174,122,296,7,19,26,2,3:04
2882,414066,2015-05-06,2015,BOS,TBA,3,5,5-3,TBA,9,0,39,43,82,160,155,315,11,19,30,5,3:22
2883,414062,2015-05-06,2015,MIN,OAK,13,0,13-0,MIN,9,1,41,34,75,139,158,297,17,8,25,1,2:56
2884,414053,2015-05-06,2015,COL,ARI,7,13,13-7,ARI,9,0,41,50,91,196,147,343,15,27,42,5,3:29
2885,414073,2015-05-07,2015,ANA,HOU,2,3,3-2,HOU,9,0,33,38,71,155,119,274,9,12,21,4,2:57
2886,414069,2015-05-07,2015,SLN,CHN,5,1,5-1,SLN,9,1,34,35,69,132,143,275,12,8,20,4,2:53
2887,414068,2015-05-07,2015,NYA,BAL,4,3,4-3,NYA,9,1,36,36,72,152,139,291,14,10,24,2,2:51
2888,414072,2015-05-07,2015,CHA,DET,1,4,4-1,DET,9,0,33,39,72,166,116,282,7,14,21,2,2:53
2889,414075,2015-05-07,2015,SFN,MIA,2,7,7-2,MIA,9,0,34,41,75,135,113,248,9,17,26,1,2:31
2890,414076,2015-05-07,2015,MIN,OAK,6,5,6-5,MIN,9,1,35,37,72,149,142,291,11,10,21,2,2:57
2891,414078,2015-05-07,2015,TBA,TEX,4,5,5-4,TEX,9,0,34,40,74,174,135,309,8,12,20,2,2:47
2892,414077,2015-05-07,2015,ARI,SDN,11,0,11-0,ARI,9,1,42,32,74,138,154,292,18,5,23,0,2:52
2893,414070,2015-05-07,2015,PIT,CIN,7,2,7-2,PIT,9,1,40,36,76,122,158,280,18,12,30,2,2:56
2894,414071,2015-05-07,2015,KCA,CLE,7,4,7-4,KCA,9,1,42,37,79,149,155,304,17,10,27,4,3:13 (2:17 delay)
2895,414074,2015-05-07,2015,MIL,LAN,4,14,14-4,LAN,9,0,38,49,87,196,129,325,11,26,37,3,3:16
2896,414086,2015-05-08,2015,COL,LAN,1,2,2-1,LAN,6,1,20,23,43,90,62,152,8,10,18,0,1:41 (2:44 delay)
2897,414084,2015-05-08,2015,ANA,HOU,2,0,2-0,ANA,9,1,30,32,62,120,96,216,8,6,14,1,2:09
2898,414089,2015-05-08,2015,PHI,NYN,3,1,3-1,PHI,9,1,32,35,67,137,114,251,9,9,18,1,2:27
2899,414079,2015-05-08,2015,WAS,ATL,9,2,9-2,WAS,9,1,36,34,70,127,131,258,13,9,22,1,2:21
2900,414081,2015-05-08,2015,TOR,BOS,7,0,7-0,TOR,9,1,36,34,70,134,150,284,13,8,21,2,2:41
2901,414080,2015-05-08,2015,NYA,BAL,5,4,5-4,NYA,9,1,34,40,74,153,142,295,13,15,28,4,3:05
2902,414093,2015-05-08,2015,TBA,TEX,8,2,8-2,TBA,9,1,36,36,72,157,147,304,11,9,20,4,2:55
2903,414092,2015-05-08,2015,PIT,SLN,5,8,8-5,SLN,9,0,39,40,79,141,158,299,13,12,25,1,2:58
2904,414085,2015-05-08,2015,DET,KCA,6,5,6-5,DET,9,0,38,39,77,127,142,269,16,14,30,2,3:18
2905,414091,2015-05-08,2015,ARI,SDN,5,6,6-5,SDN,9,0,37,43,80,178,138,316,11,18,29,2,3:26
2906,414088,2015-05-08,2015,CLE,MIN,3,9,9-3,MIN,9,0,37,42,79,138,132,270,10,16,26,2,2:47
2907,414090,2015-05-08,2015,SEA,OAK,4,3,4-3,SEA,11,0,42,44,86,180,178,358,14,11,25,3,3:34
2908,414087,2015-05-08,2015,SFN,MIA,6,0,6-0,SFN,9,1,41,34,75,152,149,301,19,7,26,0,2:47
2909,414082,2015-05-08,2015,MIL,CHN,6,7,7-6,CHN,9,0,42,39,81,153,150,303,18,12,30,1,3:03
2910,414107,2015-05-09,2015,PIT,SLN,7,5,7-5,PIT,9,1,34,39,73,126,115,241,13,14,27,2,2:34
2911,414095,2015-05-09,2015,NYA,BAL,2,6,6-2,BAL,9,0,38,39,77,140,151,291,9,13,22,2,2:55
2912,414083,2015-05-09,2015,CHA,CIN,8,2,8-2,CHA,9,1,38,35,73,154,140,294,16,12,28,3,2:53
2913,414104,2015-05-09,2015,PHI,NYN,2,3,3-2,NYN,9,0,37,39,76,144,120,264,10,12,22,3,2:44
2914,414108,2015-05-09,2015,TBA,TEX,7,2,7-2,TBA,9,1,37,40,77,154,165,319,15,12,27,4,3:18
2915,414083,2015-05-09,2015,CHA,CIN,8,2,8-2,CHA,9,1,38,35,73,154,140,294,16,12,28,3,2:53
2916,414100,2015-05-09,2015,DET,KCA,2,6,6-2,KCA,9,0,37,43,80,149,112,261,10,18,28,1,2:40
2917,414096,2015-05-09,2015,TOR,BOS,7,1,7-1,TOR,9,1,42,37,79,152,169,321,17,9,26,1,3:12
2918,414094,2015-05-09,2015,WAS,ATL,8,6,8-6,WAS,9,0,40,38,78,139,147,286,18,11,29,3,3:12
2919,414099,2015-05-09,2015,ANA,HOU,5,6,6-5,HOU,9,0,39,37,76,142,144,286,14,11,25,1,2:42
2920,414097,2015-05-09,2015,MIL,CHN,12,4,12-4,MIL,9,1,40,36,76,150,164,314,16,9,25,1,3:03
2921,414098,2015-05-09,2015,CHA,CIN,4,10,10-4,CIN,9,0,35,48,83,175,131,306,8,23,31,4,3:33
2922,414103,2015-05-09,2015,CLE,MIN,4,7,7-4,MIN,9,0,41,43,84,157,146,303,15,19,34,3,3:02
2923,414102,2015-05-09,2015,SFN,MIA,2,6,6-2,MIA,9,0,39,41,80,181,160,341,13,13,26,1,3:24
2924,414105,2015-05-09,2015,SEA,OAK,7,2,7-2,SEA,9,1,43,41,84,162,178,340,19,12,31,4,3:36
2925,414106,2015-05-09,2015,ARI,SDN,4,6,6-4,SDN,12,0,48,54,102,198,204,402,15,19,34,3,4:17
2926,414114,2015-05-10,2015,ANA,HOU,3,1,3-1,ANA,9,1,31,33,64,132,110,242,8,6,14,1,2:40
2927,414120,2015-05-10,2015,SEA,OAK,4,3,4-3,SEA,9,1,34,34,68,129,136,265,9,7,16,1,2:36
2928,414121,2015-05-10,2015,ARI,SDN,2,1,2-1,ARI,9,1,29,37,66,136,120,256,6,12,18,4,2:47
2929,414123,2015-05-10,2015,TBA,TEX,1,2,2-1,TEX,9,0,34,38,72,146,149,295,8,12,20,2,3:06
2930,414109,2015-05-10,2015,WAS,ATL,5,4,5-4,WAS,9,1,33,41,74,147,119,266,13,15,28,1,2:51
2931,414117,2015-05-10,2015,SFN,MIA,3,2,3-2,SFN,9,0,38,35,73,136,155,291,14,9,23,1,3:02
2932,414115,2015-05-10,2015,DET,KCA,1,2,2-1,KCA,10,0,41,37,78,127,170,297,11,8,19,0,3:23 (1:43 delay)
2933,414119,2015-05-10,2015,PHI,NYN,4,7,7-4,NYN,9,0,38,41,79,133,130,263,11,15,26,3,2:57
2934,414111,2015-05-10,2015,TOR,BOS,3,6,6-3,BOS,9,0,36,37,73,138,136,274,12,11,23,1,2:38
2935,414122,2015-05-10,2015,PIT,SLN,4,3,4-3,PIT,9,1,35,36,71,129,131,260,12,11,23,2,2:38
2936,414118,2015-05-10,2015,CLE,MIN,8,2,8-2,CLE,9,1,40,31,71,148,134,282,17,4,21,0,2:37
2937,414116,2015-05-10,2015,COL,LAN,5,9,9-5,LAN,9,0,39,44,83,181,152,333,14,19,33,5,3:36
2938,414112,2015-05-10,2015,MIL,CHN,3,2,3-2,MIL,11,0,43,40,83,161,165,326,16,9,25,2,3:26
2939,414110,2015-05-10,2015,NYA,BAL,6,2,6-2,NYA,9,1,39,35,74,144,165,309,18,8,26,3,3:03
2940,414113,2015-05-10,2015,CHA,CIN,4,3,4-3,CHA,9,0,43,39,82,154,157,311,18,16,34,1,3:10
2941,414132,2015-05-11,2015,BAL,TOR,5,2,5-2,BAL,9,1,35,35,70,132,143,275,11,10,21,1,2:43
2942,414126,2015-05-11,2015,MIL,CHA,10,7,10-7,MIL,9,1,37,41,78,154,118,272,12,15,27,2,3:09
2943,414133,2015-05-11,2015,ARI,WAS,1,11,11-1,WAS,9,0,34,45,79,167,123,290,8,18,26,1,2:42
2944,414130,2015-05-11,2015,CHN,NYN,4,3,4-3,CHN,9,1,36,36,72,156,145,301,14,11,25,3,2:56
2945,414124,2015-05-11,2015,CIN,ATL,1,2,2-1,ATL,9,0,34,40,74,155,122,277,7,13,20,0,2:54 (1:40 delay)
2946,414129,2015-05-11,2015,TBA,NYA,5,11,11-5,NYA,9,0,35,42,77,137,142,279,10,16,26,0,2:48
2947,414131,2015-05-11,2015,PHI,PIT,3,4,4-3,PIT,9,0,37,38,75,143,120,263,12,12,24,2,2:55
2948,414128,2015-05-11,2015,LAN,MIA,5,3,5-3,LAN,9,0,35,37,72,141,155,296,12,13,25,2,3:02
2949,414127,2015-05-11,2015,TEX,KCA,8,2,8-2,TEX,9,1,42,34,76,132,171,303,17,9,26,1,2:53
2950,414125,2015-05-11,2015,OAK,BOS,4,5,5-4,BOS,11,0,48,47,95,192,179,371,16,17,33,4,3:57
2951,414136,2015-05-12,2015,MIL,CHA,2,4,4-2,CHA,9,0,31,40,71,139,123,262,4,13,17,2,2:45
2952,414141,2015-05-12,2015,TBA,NYA,4,2,4-2,TBA,9,1,32,35,67,132,112,244,10,10,20,1,2:33
2953,414135,2015-05-12,2015,OAK,BOS,9,2,9-2,OAK,9,1,40,30,70,123,167,290,16,4,20,1,2:32
2954,414140,2015-05-12,2015,DET,MIN,2,1,2-1,DET,10,0,38,37,75,136,137,273,12,8,20,1,2:56
2955,414143,2015-05-12,2015,PHI,PIT,2,7,7-2,PIT,9,0,35,38,73,167,115,282,9,12,21,0,2:49
2956,414148,2015-05-12,2015,ARI,WAS,14,6,14-6,ARI,9,1,43,39,82,128,157,285,20,15,35,3,2:59
2957,414137,2015-05-12,2015,ANA,COL,5,2,5-2,ANA,9,1,36,33,69,125,119,244,12,7,19,1,2:44
2958,414145,2015-05-12,2015,HOU,SFN,1,8,8-1,SFN,9,0,29,43,72,160,111,271,2,17,19,1,2:39
2959,414139,2015-05-12,2015,LAN,MIA,11,1,11-1,LAN,9,1,47,34,81,133,155,288,23,9,32,3,3:03
2960,414147,2015-05-12,2015,BAL,TOR,2,10,10-2,TOR,9,0,32,44,76,162,111,273,7,17,24,2,2:37
2961,414142,2015-05-12,2015,CHN,NYN,6,1,6-1,CHN,9,1,42,31,73,133,170,303,19,7,26,1,2:55
2962,414144,2015-05-12,2015,SEA,SDN,11,4,11-4,SEA,9,1,42,42,84,179,173,352,20,15,35,2,3:17
2963,414138,2015-05-12,2015,TEX,KCA,6,7,7-6,KCA,10,0,43,45,88,164,150,314,17,16,33,3,3:34
2964,414146,2015-05-12,2015,CLE,SLN,3,8,8-3,SLN,9,0,40,43,83,144,173,317,13,14,27,7,3:31
2965,414134,2015-05-12,2015,CIN,ATL,4,3,4-3,CIN,9,0,36,42,78,164,126,290,12,16,28,1,2:46
2966,414153,2015-05-13,2015,TEX,KCA,5,2,5-2,TEX,9,1,34,32,66,106,119,225,13,7,20,0,2:15
2967,414157,2015-05-13,2015,CHN,NYN,2,1,2-1,CHN,9,0,34,34,68,107,141,248,14,9,23,2,2:37
2968,414156,2015-05-13,2015,TBA,NYA,3,2,3-2,TBA,9,1,30,39,69,165,104,269,8,12,20,1,2:41
2969,414151,2015-05-13,2015,MIL,CHA,2,4,4-2,CHA,9,0,34,38,72,146,150,296,9,13,22,2,3:07
2970,414160,2015-05-13,2015,HOU,SFN,4,3,4-3,HOU,9,1,33,40,73,164,116,280,11,15,26,3,3:10
2971,414149,2015-05-13,2015,CIN,ATL,5,1,5-1,CIN,9,1,33,32,65,114,126,240,11,5,16,0,2:06
2972,414155,2015-05-13,2015,DET,MIN,2,6,6-2,MIN,9,0,39,39,78,141,161,302,12,15,27,5,3:07
2973,414158,2015-05-13,2015,PHI,PIT,3,2,3-2,PHI,9,1,33,35,68,142,121,263,10,10,20,0,2:37
2974,414154,2015-05-13,2015,LAN,MIA,4,5,5-4,MIA,9,0,34,41,75,164,125,289,9,15,24,5,3:24
2975,414152,2015-05-13,2015,ANA,COL,2,1,2-1,ANA,11,0,39,42,81,174,138,312,11,10,21,1,3:18
2976,414161,2015-05-13,2015,CLE,SLN,2,0,2-0,CLE,9,1,39,29,68,124,154,278,15,2,17,1,2:47
2977,414162,2015-05-13,2015,BAL,TOR,6,1,6-1,BAL,9,1,40,34,74,116,141,257,16,8,24,2,2:39
2978,414150,2015-05-13,2015,OAK,BOS,0,2,2-0,BOS,9,0,36,35,71,141,123,264,10,8,18,2,2:33
2979,414159,2015-05-13,2015,SEA,SDN,2,4,4-2,SDN,9,0,39,37,76,136,165,301,12,12,24,1,2:59
2980,414163,2015-05-13,2015,ARI,WAS,6,9,9-6,WAS,9,0,45,42,87,151,179,330,20,16,36,4,3:38
2981,414170,2015-05-14,2015,PHI,PIT,4,2,4-2,PHI,9,1,37,34,71,129,147,276,15,10,25,1,2:40
2982,414169,2015-05-14,2015,CHN,NYN,6,5,6-5,CHN,9,1,35,38,73,168,121,289,10,11,21,4,2:49
2983,414164,2015-05-14,2015,SEA,BOS,1,2,2-1,BOS,9,0,35,40,75,145,122,267,10,15,25,3,2:53
2984,414171,2015-05-14,2015,CIN,SFN,4,3,4-3,CIN,9,1,36,35,71,140,143,283,14,11,25,3,2:58
2985,414172,2015-05-14,2015,CLE,SLN,1,2,2-1,SLN,9,0,37,35,72,137,171,308,11,10,21,5,3:12
2986,414168,2015-05-14,2015,TBA,NYA,6,1,6-1,TBA,9,1,36,33,69,130,141,271,14,7,21,1,2:45
2987,414167,2015-05-14,2015,DET,MIN,13,1,13-1,DET,9,1,47,31,78,123,182,305,24,6,30,2,3:03
2988,414165,2015-05-14,2015,LAN,COL,4,5,5-4,COL,9,0,41,39,80,146,160,306,15,11,26,1,3:11 (1:25 delay)
2989,414173,2015-05-14,2015,HOU,TOR,6,4,6-4,HOU,9,1,37,34,71,118,160,278,15,10,25,2,2:48
2990,414174,2015-05-14,2015,SDN,WAS,8,3,8-3,SDN,9,1,37,40,77,155,129,284,15,12,27,2,2:44 (1:56 delay)
2991,414166,2015-05-14,2015,TEX,KCA,3,6,6-3,KCA,9,0,38,42,80,171,156,327,12,16,28,2,3:11
2992,414183,2015-05-15,2015,NYN,MIL,0,7,7-0,MIL,9,0,32,36,68,111,126,237,4,10,14,0,2:18
2993,414175,2015-05-15,2015,BAL,ANA,1,3,3-1,ANA,9,0,33,34,67,110,116,226,6,9,15,2,2:23
2994,414178,2015-05-15,2015,SEA,BOS,2,1,2-1,SEA,9,0,31,33,64,120,117,237,5,8,13,1,2:32
2995,414187,2015-05-15,2015,MIN,TBA,3,2,3-2,MIN,9,1,34,35,69,122,120,242,9,9,18,1,2:29
2996,414181,2015-05-15,2015,LAN,COL,6,4,6-4,LAN,9,1,40,40,80,159,156,315,18,12,30,4,3:34
2997,414177,2015-05-15,2015,MIA,ATL,3,5,5-3,ATL,9,0,41,39,80,136,152,288,14,13,27,3,3:10
2998,414186,2015-05-15,2015,CIN,SFN,2,10,10-2,SFN,9,0,37,43,80,154,129,283,10,17,27,0,2:53
2999,414188,2015-05-15,2015,HOU,TOR,8,4,8-4,HOU,9,1,36,37,73,135,136,271,12,11,23,1,2:29
3000,414176,2015-05-15,2015,PHI,ARI,4,3,4-3,PHI,9,1,34,38,72,126,146,272,11,11,22,5,3:05
3001,414180,2015-05-15,2015,TEX,CLE,3,8,8-3,CLE,9,0,40,42,82,165,159,324,13,17,30,4,3:17
3002,414179,2015-05-15,2015,OAK,CHA,6,7,7-6,CHA,9,0,46,39,85,147,183,330,20,13,33,6,3:34
3003,414182,2015-05-15,2015,SLN,DET,4,10,10-4,DET,9,0,41,46,87,192,154,346,16,20,36,2,3:26
3004,414189,2015-05-15,2015,SDN,WAS,0,10,10-0,WAS,9,0,34,44,78,177,128,305,8,21,29,0,2:43
3005,414184,2015-05-15,2015,KCA,NYA,12,1,12-1,KCA,9,1,46,34,80,125,171,296,20,7,27,5,3:12
3006,414185,2015-05-15,2015,CHN,PIT,11,10,11-10,CHN,12,0,61,58,119,233,263,496,29,24,53,5,5:01
3007,414190,2015-05-16,2015,BAL,ANA,1,6,6-1,ANA,9,0,30,39,69,127,106,233,3,13,16,0,2:28 (:57 delay)
3008,414204,2015-05-16,2015,SDN,WAS,1,4,4-1,WAS,9,0,35,38,73,142,146,288,9,14,23,1,2:53
3009,414203,2015-05-16,2015,HOU,TOR,6,5,6-5,HOU,9,1,36,38,74,162,155,317,12,11,23,2,3:08
3010,414198,2015-05-16,2015,NYN,MIL,14,1,14-1,NYN,9,1,42,33,75,144,162,306,19,8,27,1,2:56
3011,414196,2015-05-16,2015,LAN,COL,1,7,7-1,COL,9,0,33,39,72,152,121,273,6,11,17,1,2:54
3012,414200,2015-05-16,2015,CHN,PIT,4,1,4-1,CHN,9,1,36,38,74,137,149,286,13,12,25,2,3:05
3013,414194,2015-05-16,2015,OAK,CHA,3,4,4-3,CHA,9,0,36,40,76,155,149,304,10,16,26,4,3:06
3014,414202,2015-05-16,2015,MIN,TBA,6,4,6-4,MIN,9,1,38,36,74,129,141,270,17,9,26,3,3:03
3015,414201,2015-05-16,2015,CIN,SFN,2,11,11-2,SFN,9,0,40,43,83,148,138,286,13,17,30,1,2:53
3016,414191,2015-05-16,2015,PHI,ARI,7,5,7-5,PHI,9,1,42,37,79,137,158,295,18,10,28,3,3:14 (1:17 delay)
3017,414195,2015-05-16,2015,TEX,CLE,8,10,10-8,CLE,9,0,41,47,88,182,148,330,16,20,36,5,3:37
3018,414199,2015-05-16,2015,KCA,NYA,1,5,5-1,NYA,9,0,34,42,76,163,112,275,6,13,19,0,2:52
3019,414192,2015-05-16,2015,MIA,ATL,3,5,5-3,ATL,9,0,39,38,77,138,148,286,12,13,25,1,2:59
3020,414197,2015-05-16,2015,SLN,DET,3,4,4-3,DET,10,0,42,45,87,198,180,378,14,17,31,2,3:54 (1:20 delay)
3021,414193,2015-05-16,2015,SEA,BOS,2,4,4-2,BOS,9,0,34,40,74,150,135,285,7,13,20,2,2:48
3022,414205,2015-05-17,2015,BAL,ANA,3,0,3-0,BAL,9,1,31,32,63,108,116,224,8,6,14,2,2:20
3023,414207,2015-05-17,2015,MIA,ATL,0,6,6-0,ATL,9,0,29,39,68,130,94,224,3,12,15,1,2:15
3024,414206,2015-05-17,2015,PHI,ARI,6,0,6-0,PHI,9,1,38,37,75,120,137,257,15,12,27,1,2:52
3025,414208,2015-05-17,2015,SEA,BOS,5,0,5-0,SEA,9,1,34,33,67,120,139,259,11,7,18,1,2:31
3026,414211,2015-05-17,2015,LAN,COL,1,0,1-0,LAN,9,1,32,32,64,125,117,242,9,6,15,0,2:40
3027,414215,2015-05-17,2015,CHN,PIT,0,3,3-0,PIT,9,0,36,36,72,153,143,296,11,11,22,0,3:07
3028,414217,2015-05-17,2015,MIN,TBA,3,11,11-3,TBA,9,0,33,50,83,188,138,326,8,24,32,2,3:17
3029,414219,2015-05-17,2015,SDN,WAS,5,10,10-5,WAS,9,0,36,40,76,159,141,300,8,15,23,3,3:04
3030,414218,2015-05-17,2015,HOU,TOR,4,2,4-2,HOU,9,1,32,37,69,136,111,247,8,10,18,0,2:22
3031,414212,2015-05-17,2015,SLN,DET,2,1,2-1,SLN,9,1,36,35,71,135,119,254,15,9,24,2,2:57
3032,414210,2015-05-17,2015,TEX,CLE,5,1,5-1,TEX,9,1,32,38,70,153,114,267,9,13,22,0,2:49
3033,414214,2015-05-17,2015,KCA,NYA,6,0,6-0,KCA,9,1,35,36,71,143,138,281,11,9,20,2,3:03
3034,414213,2015-05-17,2015,NYN,MIL,5,1,5-1,NYN,9,1,37,34,71,143,134,277,14,7,21,2,2:49
3035,414209,2015-05-17,2015,OAK,CHA,3,7,7-3,CHA,9,0,36,42,78,168,134,302,11,13,24,2,2:56
3036,414216,2015-05-17,2015,CIN,SFN,8,9,9-8,SFN,9,0,43,48,91,177,147,324,16,21,37,3,3:25 (:24 delay)
3037,414222,2015-05-18,2015,CHA,CLE,2,1,2-1,CHA,10,0,36,36,72,130,125,255,9,6,15,0,2:34
3038,414223,2015-05-18,2015,DET,MIL,2,3,3-2,MIL,9,0,35,37,72,132,152,284,11,11,22,2,3:13
3039,414224,2015-05-18,2015,HOU,OAK,1,2,2-1,OAK,9,0,35,37,72,174,136,310,9,11,20,3,3:15
3040,414221,2015-05-18,2015,MIA,ARI,2,3,3-2,ARI,13,0,45,47,92,165,154,319,9,10,19,0,3:11
3041,414220,2015-05-18,2015,TOR,ANA,10,6,10-6,TOR,9,1,44,40,84,154,179,333,22,13,35,3,3:28
3042,414226,2015-05-18,2015,NYN,SLN,2,1,2-1,NYN,14,0,51,54,105,205,193,398,15,13,28,3,4:14
3043,414225,2015-05-18,2015,COL,PHI,3,4,4-3,PHI,9,0,38,38,76,139,146,285,11,13,24,1,3:14
3044,414230,2015-05-19,2015,KCA,CIN,3,0,3-0,KCA,9,1,33,31,64,115,111,226,10,5,15,0,2:12
3045,414240,2015-05-19,2015,ATL,TBA,3,5,5-3,TBA,9,0,36,37,73,123,146,269,9,10,19,1,2:43
3046,414233,2015-05-19,2015,DET,MIL,1,8,8-1,MIL,9,0,35,40,75,136,117,253,8,15,23,1,2:34
3047,414231,2015-05-19,2015,CHA,CLE,1,3,3-1,CLE,9,0,35,39,74,143,139,282,8,15,23,3,2:57
3048,414229,2015-05-19,2015,SDN,CHN,4,3,4-3,SDN,9,1,31,35,66,142,134,276,5,8,13,1,2:47
3049,414232,2015-05-19,2015,SFN,LAN,2,0,2-0,SFN,9,1,35,38,73,146,127,273,11,12,23,3,2:59
3050,414234,2015-05-19,2015,PIT,MIN,5,8,8-5,MIN,9,0,42,38,80,144,132,276,15,12,27,3,2:53
3051,414239,2015-05-19,2015,NYN,SLN,2,10,10-2,SLN,9,0,35,43,78,148,132,280,8,18,26,1,2:43
3052,414241,2015-05-19,2015,BOS,TEX,4,3,4-3,BOS,9,1,40,38,78,137,153,290,17,10,27,1,2:50
3053,414237,2015-05-19,2015,COL,PHI,6,5,6-5,COL,9,1,35,38,73,139,139,278,11,13,24,1,2:54 (:17 delay)
3054,414227,2015-05-19,2015,TOR,ANA,2,3,3-2,ANA,9,0,34,36,70,133,120,253,7,9,16,1,2:32
3055,414236,2015-05-19,2015,HOU,OAK,6,4,6-4,HOU,9,1,37,37,74,154,155,309,15,14,29,3,3:21
3056,414235,2015-05-19,2015,WAS,NYA,8,6,8-6,WAS,10,0,41,41,82,146,168,314,15,11,26,3,3:20
3057,414238,2015-05-19,2015,BAL,SEA,9,4,9-4,BAL,9,1,40,37,77,129,141,270,19,10,29,2,2:42
3058,414228,2015-05-19,2015,MIA,ARI,2,4,4-2,ARI,9,0,34,37,71,126,142,268,8,11,19,2,2:46
3059,414255,2015-05-20,2015,ATL,TBA,2,1,2-1,ATL,9,1,32,37,69,132,122,254,8,12,20,1,2:34
3060,414253,2015-05-20,2015,BAL,SEA,2,4,4-2,SEA,9,0,35,39,74,134,121,255,10,13,23,2,2:38
3061,414243,2015-05-20,2015,MIA,ARI,1,6,6-1,ARI,9,0,31,42,73,153,104,257,6,14,20,1,2:36
3062,414254,2015-05-20,2015,NYN,SLN,0,9,9-0,SLN,9,0,33,45,78,151,120,271,7,17,24,2,2:43
3063,414247,2015-05-20,2015,SFN,LAN,4,0,4-0,SFN,9,1,35,35,70,140,131,271,11,8,19,2,2:36
3064,414245,2015-05-20,2015,KCA,CIN,7,1,7-1,KCA,9,1,35,38,73,139,136,275,12,11,23,1,2:44
3065,414244,2015-05-20,2015,SDN,CHN,2,3,3-2,CHN,9,0,37,36,73,146,147,293,11,12,23,2,2:57
3066,414250,2015-05-20,2015,WAS,NYA,3,2,3-2,WAS,9,1,34,36,70,125,135,260,10,9,19,1,2:43
3067,414246,2015-05-20,2015,CHA,CLE,3,4,4-3,CLE,9,0,35,38,73,163,127,290,8,12,20,2,2:56 (:31 delay)
3068,414248,2015-05-20,2015,DET,MIL,5,2,5-2,DET,9,1,36,35,71,145,140,285,15,10,25,3,3:05
3069,414252,2015-05-20,2015,COL,PHI,2,4,4-2,PHI,9,0,32,41,73,168,121,289,8,14,22,1,2:50
3070,414251,2015-05-20,2015,HOU,OAK,6,1,6-1,HOU,9,1,37,38,75,153,149,302,13,10,23,2,3:02
3071,414256,2015-05-20,2015,BOS,TEX,1,2,2-1,TEX,9,0,40,35,75,135,162,297,14,10,24,3,3:13
3072,414249,2015-05-20,2015,PIT,MIN,3,4,4-3,MIN,13,0,51,52,103,184,189,373,16,16,32,2,3:56
3073,414242,2015-05-20,2015,TOR,ANA,3,4,4-3,ANA,9,0,34,39,73,139,116,255,8,13,21,1,2:36
3074,414259,2015-05-21,2015,SDN,CHN,0,3,3-0,CHN,9,0,30,36,66,139,108,247,5,9,14,0,2:08
3075,414267,2015-05-21,2015,NYN,SLN,5,0,5-0,NYN,9,1,35,29,64,121,138,259,16,2,18,2,2:26
3076,414257,2015-05-21,2015,TOR,ANA,8,4,8-4,TOR,9,1,38,33,71,107,126,233,14,7,21,1,2:22
3077,414263,2015-05-21,2015,ATL,MIL,10,1,10-1,ATL,9,1,40,30,70,114,146,260,15,4,19,3,2:49
3078,414264,2015-05-21,2015,TBA,OAK,3,0,3-0,TBA,9,1,33,34,67,152,140,292,8,8,16,2,2:58
3079,414262,2015-05-21,2015,SFN,LAN,4,0,4-0,SFN,9,1,34,37,71,150,110,260,12,12,24,4,2:54
3080,414268,2015-05-21,2015,BOS,TEX,1,3,3-1,TEX,9,0,33,35,68,131,148,279,8,10,18,2,2:49
3081,414258,2015-05-21,2015,MIA,ARI,6,7,7-6,ARI,9,0,41,42,83,134,137,271,15,14,29,3,3:02
3082,414260,2015-05-21,2015,CHA,CLE,2,5,5-2,CLE,9,0,36,43,79,168,148,316,10,18,28,2,3:04
3083,414265,2015-05-21,2015,COL,PHI,7,3,7-3,COL,9,1,42,37,79,173,127,300,19,12,31,2,3:15
3084,414266,2015-05-21,2015,BAL,SEA,5,4,5-4,BAL,9,1,36,44,80,196,157,353,11,18,29,3,3:30 (2:17 delay)
3085,414261,2015-05-21,2015,DET,HOU,6,5,6-5,DET,11,0,44,43,87,153,170,323,16,10,26,5,3:40
3086,414275,2015-05-22,2015,CHA,MIN,3,2,3-2,CHA,9,1,35,31,66,127,106,233,12,4,16,1,2:21
3087,414276,2015-05-22,2015,PIT,NYN,4,1,4-1,PIT,9,1,32,31,63,114,128,242,7,8,15,1,2:24
3088,414278,2015-05-22,2015,WAS,PHI,2,1,2-1,WAS,9,1,30,34,64,127,119,246,9,7,16,0,2:35
3089,414279,2015-05-22,2015,LAN,SDN,2,1,2-1,LAN,9,1,30,34,64,118,133,251,7,7,14,1,2:39
3090,414280,2015-05-22,2015,TOR,SEA,3,4,4-3,SEA,9,0,34,36,70,132,128,260,10,10,20,0,2:30
3091,414273,2015-05-22,2015,DET,HOU,6,2,6-2,DET,9,1,36,33,69,138,127,265,15,5,20,0,2:47
3092,414277,2015-05-22,2015,TBA,OAK,5,2,5-2,TBA,9,1,37,41,78,158,144,302,15,13,28,5,3:05
3093,414272,2015-05-22,2015,CLE,CIN,7,3,7-3,CLE,9,1,42,35,77,154,154,308,19,9,28,0,2:56
3094,414274,2015-05-22,2015,ATL,MIL,0,11,11-0,MIL,9,0,34,45,79,185,126,311,6,21,27,1,2:52
3095,414281,2015-05-22,2015,COL,SFN,8,11,11-8,SFN,9,0,43,45,88,160,149,309,17,18,35,3,3:33 (1:44 delay)
3096,414270,2015-05-22,2015,MIA,BAL,5,8,8-5,BAL,9,0,44,45,89,177,156,333,15,19,34,5,3:22
3097,414269,2015-05-22,2015,BOS,ANA,5,12,12-5,ANA,9,0,39,48,87,189,150,339,14,21,35,3,3:35
3098,414283,2015-05-22,2015,NYA,TEX,9,10,10-9,TEX,9,0,43,42,85,155,155,310,15,15,30,3,3:19
3099,414282,2015-05-22,2015,KCA,SLN,5,0,5-0,KCA,9,1,35,40,75,170,120,290,12,14,26,0,2:53
3100,414271,2015-05-22,2015,ARI,CHN,5,4,5-4,ARI,13,0,53,54,107,238,198,436,18,17,35,3,4:27
3101,413925,2015-05-23,2015,COL,SFN,5,3,5-3,COL,9,1,37,36,73,125,107,232,14,11,25,2,2:45 (:58 delay)
3102,414297,2015-05-23,2015,KCA,SLN,3,2,3-2,KCA,6,1,23,25,48,84,68,152,9,8,17,0,1:40 (1:10 delay)
3103,414294,2015-05-23,2015,LAN,SDN,2,0,2-0,LAN,9,1,30,27,57,99,134,233,6,1,7,0,2:11
3104,414287,2015-05-23,2015,CLE,CIN,2,1,2-1,CLE,9,1,31,34,65,120,131,251,9,9,18,0,2:33
3105,413925,2015-05-23,2015,COL,SFN,5,3,5-3,COL,9,1,37,36,73,125,107,232,14,11,25,2,2:45 (:58 delay)
3106,414290,2015-05-23,2015,CHA,MIN,3,4,4-3,MIN,9,0,35,35,70,124,108,232,8,10,18,1,2:12 (:30 delay)
3107,414293,2015-05-23,2015,WAS,PHI,1,8,8-1,PHI,9,0,33,40,73,146,116,262,6,12,18,1,2:33
3108,414291,2015-05-23,2015,PIT,NYN,8,2,8-2,PIT,9,1,36,34,70,131,129,260,12,8,20,0,2:41
3109,414295,2015-05-23,2015,TOR,SEA,2,3,3-2,SEA,9,0,33,36,69,121,141,262,8,10,18,1,2:25
3110,414288,2015-05-23,2015,DET,HOU,2,3,3-2,HOU,9,0,33,36,69,128,139,267,8,11,19,3,2:44
3111,414284,2015-05-23,2015,BOS,ANA,8,3,8-3,BOS,9,1,39,36,75,118,169,287,16,9,25,4,3:09
3112,414286,2015-05-23,2015,ARI,CHN,6,9,9-6,CHN,9,0,36,41,77,160,123,283,9,13,22,3,3:14
3113,414292,2015-05-23,2015,TBA,OAK,0,5,5-0,OAK,9,0,36,42,78,181,132,313,10,17,27,2,2:55
3114,414296,2015-05-23,2015,COL,SFN,8,10,10-8,SFN,9,0,41,42,83,135,150,285,15,15,30,3,3:04 (2:15 delay)
3115,414298,2015-05-23,2015,NYA,TEX,4,15,15-4,TEX,9,0,38,49,87,183,138,321,10,22,32,3,3:03
3116,414289,2015-05-23,2015,ATL,MIL,3,2,3-2,ATL,11,0,46,44,90,168,180,348,17,16,33,2,3:48
3117,414285,2015-05-23,2015,MIA,BAL,1,0,1-0,MIA,13,0,49,49,98,191,177,368,16,13,29,1,3:51
3118,414301,2015-05-24,2015,ARI,CHN,4,3,4-3,ARI,9,1,31,32,63,124,118,242,8,6,14,1,2:31
3119,414304,2015-05-24,2015,ATL,MIL,2,1,2-1,ATL,9,1,33,33,66,119,143,262,13,6,19,2,2:47
3120,414299,2015-05-24,2015,BOS,ANA,6,1,6-1,BOS,9,1,36,31,67,110,157,267,15,5,20,2,2:37
3121,414308,2015-05-24,2015,WAS,PHI,4,1,4-1,WAS,9,1,36,34,70,127,119,246,12,9,21,4,2:45
3122,414311,2015-05-24,2015,COL,SFN,11,2,11-2,COL,9,1,41,34,75,111,139,250,16,8,24,3,2:49 (2:10 delay)
3123,414310,2015-05-24,2015,TOR,SEA,8,2,8-2,TOR,9,1,40,34,74,134,153,287,16,10,26,4,2:50
3124,414305,2015-05-24,2015,CHA,MIN,1,8,8-1,MIN,9,0,31,39,70,148,114,262,5,11,16,1,2:37
3125,414312,2015-05-24,2015,KCA,SLN,1,6,6-1,SLN,9,0,34,39,73,176,116,292,8,13,21,0,2:40
3126,414300,2015-05-24,2015,MIA,BAL,5,2,5-2,MIA,9,1,37,37,74,142,153,295,15,11,26,3,3:00
3127,414306,2015-05-24,2015,PIT,NYN,9,1,9-1,PIT,9,1,42,36,78,143,150,293,20,9,29,1,2:46
3128,414309,2015-05-24,2015,LAN,SDN,3,11,11-3,SDN,9,0,33,48,81,158,114,272,8,23,31,1,2:47
3129,414302,2015-05-24,2015,CLE,CIN,5,2,5-2,CLE,9,1,42,35,77,130,184,314,15,7,22,2,3:07
3130,414313,2015-05-24,2015,NYA,TEX,2,5,5-2,TEX,9,0,35,40,75,153,158,311,8,14,22,4,3:25
3131,414307,2015-05-24,2015,TBA,OAK,2,7,7-2,OAK,9,0,37,41,78,150,147,297,11,15,26,1,2:53
3132,414303,2015-05-24,2015,DET,HOU,8,10,10-8,HOU,9,0,42,44,86,176,155,331,17,18,35,4,3:22
3133,414317,2015-05-25,2015,TOR,CHA,6,0,6-0,TOR,9,1,34,29,63,96,142,238,11,4,15,0,2:10
3134,414320,2015-05-25,2015,BAL,HOU,4,3,4-3,BAL,9,1,28,37,65,141,98,239,7,11,18,0,2:20
3135,414319,2015-05-25,2015,OAK,DET,4,0,4-0,OAK,9,1,35,33,68,112,120,232,10,5,15,2,2:40
3136,414322,2015-05-25,2015,PIT,MIA,4,2,4-2,PIT,9,1,33,34,67,109,125,234,12,9,21,0,2:20
3137,414328,2015-05-25,2015,CHN,WAS,1,2,2-1,WAS,9,0,32,35,67,132,122,254,7,8,15,2,2:39
3138,414316,2015-05-25,2015,MIN,BOS,7,2,7-2,MIN,9,1,40,34,74,125,151,276,18,8,26,2,2:52
3139,414326,2015-05-25,2015,MIL,SFN,4,8,8-4,SFN,9,0,36,43,79,152,149,301,9,18,27,4,3:15
3140,414323,2015-05-25,2015,NYN,PHI,6,3,6-3,NYN,9,1,34,37,71,148,132,280,12,9,21,4,3:07
3141,414325,2015-05-25,2015,TBA,SEA,1,4,4-1,SEA,9,0,39,38,77,148,140,288,12,13,25,0,2:51
3142,414318,2015-05-25,2015,CIN,COL,4,5,5-4,COL,9,0,40,41,81,151,129,280,14,15,29,2,2:59
3143,414321,2015-05-25,2015,NYA,KCA,14,1,14-1,NYA,9,1,45,37,82,129,192,321,22,12,34,3,3:12
3144,414315,2015-05-25,2015,LAN,ATL,6,3,6-3,LAN,9,1,40,36,76,129,164,293,17,12,29,3,2:49
3145,414324,2015-05-25,2015,ANA,SDN,4,3,4-3,ANA,9,0,39,36,75,146,150,296,17,11,28,3,3:11
3146,414314,2015-05-25,2015,SLN,ARI,3,2,3-2,SLN,10,0,41,43,84,150,152,302,17,14,31,3,3:24
3147,414327,2015-05-25,2015,CLE,TEX,8,10,10-8,TEX,9,0,42,40,82,153,183,336,16,13,29,7,3:32
3148,414330,2015-05-26,2015,LAN,ATL,8,0,8-0,LAN,9,1,33,34,67,135,119,254,15,6,21,1,2:38
3149,414331,2015-05-26,2015,MIN,BOS,2,1,2-1,MIN,9,1,32,34,66,139,109,248,9,9,18,2,2:36 (1:21 delay)
3150,414333,2015-05-26,2015,CIN,COL,2,1,2-1,CIN,9,0,35,32,67,133,115,248,10,8,18,0,2:39
3151,414343,2015-05-26,2015,CHN,WAS,3,2,3-2,CHN,9,0,36,32,68,113,145,258,12,9,21,1,2:33
3152,414334,2015-05-26,2015,OAK,DET,0,1,1-0,DET,9,0,37,33,70,130,137,267,9,10,19,2,2:58
3153,414336,2015-05-26,2015,NYA,KCA,5,1,5-1,NYA,9,1,35,32,67,128,143,271,10,4,14,1,2:31
3154,414329,2015-05-26,2015,SLN,ARI,6,4,6-4,SLN,9,1,34,41,75,140,137,277,11,15,26,2,2:51
3155,414335,2015-05-26,2015,BAL,HOU,1,4,4-1,HOU,9,0,33,39,72,139,124,263,8,14,22,2,2:50
3156,414337,2015-05-26,2015,PIT,MIA,5,1,5-1,PIT,9,1,34,38,72,148,134,282,12,11,23,2,2:38
3157,414342,2015-05-26,2015,CLE,TEX,3,4,4-3,TEX,9,0,39,39,78,142,161,303,11,12,23,3,3:06 (:56 delay)
3158,414341,2015-05-26,2015,MIL,SFN,3,6,6-3,SFN,9,0,37,39,76,164,146,310,10,13,23,2,3:07
3159,414339,2015-05-26,2015,ANA,SDN,0,4,4-0,SDN,10,0,37,43,80,153,162,315,8,14,22,3,3:24
3160,414332,2015-05-26,2015,TOR,CHA,10,9,10-9,TOR,9,0,38,45,83,175,150,325,14,17,31,3,3:12
3161,414338,2015-05-26,2015,NYN,PHI,5,4,5-4,NYN,10,0,42,40,82,156,176,332,16,13,29,4,3:17
3162,414340,2015-05-26,2015,TBA,SEA,6,7,7-6,SEA,10,0,46,44,90,180,175,355,17,15,32,4,3:52
3163,414355,2015-05-27,2015,TBA,SEA,0,3,3-0,SEA,9,0,29,32,61,123,101,224,6,5,11,0,2:13
3164,414346,2015-05-27,2015,MIN,BOS,6,4,6-4,MIN,9,1,31,35,66,131,101,232,10,8,18,3,2:29
3165,414350,2015-05-27,2015,BAL,HOU,5,4,5-4,BAL,9,1,34,39,73,109,131,240,11,12,23,1,2:26 (1:11 delay)
3166,414351,2015-05-27,2015,NYA,KCA,4,2,4-2,NYA,9,1,36,37,73,145,136,281,12,10,22,2,2:42
3167,414356,2015-05-27,2015,MIL,SFN,1,3,3-1,SFN,9,0,32,37,69,135,150,285,6,10,16,0,3:00
3168,414353,2015-05-27,2015,NYN,PHI,7,0,7-0,NYN,9,1,38,33,71,128,140,268,15,8,23,2,2:41
3169,414352,2015-05-27,2015,PIT,MIA,5,2,5-2,PIT,9,1,37,36,73,112,142,254,13,9,22,2,2:38
3170,414354,2015-05-27,2015,ANA,SDN,4,5,5-4,SDN,9,0,36,40,76,140,126,266,12,13,25,3,2:51
3171,414348,2015-05-27,2015,CIN,COL,4,6,6-4,COL,9,0,36,39,75,152,107,259,9,14,23,3,2:46
3172,414358,2015-05-27,2015,CHN,WAS,0,3,3-0,WAS,9,0,36,40,76,146,140,286,9,12,21,2,3:00
3173,414349,2015-05-27,2015,OAK,DET,2,3,3-2,DET,9,0,35,39,74,173,141,314,11,15,26,2,3:06
3174,414344,2015-05-27,2015,SLN,ARI,4,3,4-3,SLN,9,0,40,39,79,134,175,309,15,12,27,1,3:19
3175,414357,2015-05-27,2015,CLE,TEX,12,3,12-3,CLE,9,1,44,34,78,129,170,299,20,9,29,1,2:47
3176,414347,2015-05-27,2015,TOR,CHA,3,5,5-3,CHA,10,0,45,44,89,155,167,322,15,15,30,2,3:31
3177,414345,2015-05-27,2015,LAN,ATL,2,3,3-2,ATL,9,0,36,36,72,149,130,279,11,11,22,1,2:58
3178,413945,2015-05-28,2015,BAL,CHA,6,3,6-3,BAL,9,1,39,35,74,147,122,269,17,9,26,0,2:48
3179,413930,2015-05-28,2015,BAL,CHA,2,3,3-2,CHA,9,0,33,36,69,137,149,286,6,11,17,3,2:51
3180,414359,2015-05-28,2015,SFN,ATL,7,0,7-0,SFN,9,1,36,32,68,120,123,243,13,5,18,3,2:31
3181,413945,2015-05-28,2015,BAL,CHA,6,3,6-3,BAL,9,1,39,35,74,147,122,269,17,9,26,0,2:48
3182,414363,2015-05-28,2015,OAK,NYA,5,4,5-4,OAK,9,1,35,38,73,145,128,273,11,11,22,4,2:50
3183,414361,2015-05-28,2015,SEA,CLE,3,5,5-3,CLE,9,0,36,40,76,133,142,275,9,12,21,1,2:50
3184,414360,2015-05-28,2015,TEX,BOS,1,5,5-1,BOS,9,0,34,41,75,160,126,286,7,21,28,4,2:49
3185,413930,2015-05-28,2015,BAL,CHA,2,3,3-2,CHA,9,0,33,36,69,137,149,286,6,11,17,3,2:51
3186,414364,2015-05-28,2015,SDN,PIT,5,11,11-5,PIT,9,0,38,45,83,179,128,307,11,19,30,2,3:05
3187,414362,2015-05-28,2015,ANA,DET,12,2,12-2,ANA,9,1,39,37,76,157,147,304,18,11,29,2,3:07
3188,414377,2015-05-29,2015,BAL,TBA,2,1,2-1,BAL,9,0,33,35,68,125,135,260,8,8,16,2,2:43
3189,414366,2015-05-29,2015,SFN,ATL,4,2,4-2,SFN,9,1,36,34,70,119,128,247,12,8,20,1,2:36
3190,414371,2015-05-29,2015,ANA,DET,2,0,2-0,ANA,9,1,32,34,66,138,133,271,9,9,18,2,2:46
3191,414373,2015-05-29,2015,SLN,LAN,3,0,3-0,SLN,9,1,38,33,71,129,146,275,16,7,23,2,2:58
3192,414367,2015-05-29,2015,TEX,BOS,7,4,7-4,TEX,9,1,36,36,72,153,135,288,15,10,25,3,2:59
3193,414376,2015-05-29,2015,SDN,PIT,6,2,6-2,SDN,9,0,38,37,75,142,150,292,13,10,23,2,3:16
3194,414372,2015-05-29,2015,CHN,KCA,4,8,8-4,KCA,9,0,37,40,77,148,150,298,10,15,25,3,3:09
3195,414374,2015-05-29,2015,NYN,MIA,3,4,4-3,MIA,9,0,33,34,67,115,119,234,7,7,14,0,2:08
3196,414369,2015-05-29,2015,SEA,CLE,2,1,2-1,SEA,9,1,33,30,63,123,137,260,11,4,15,2,2:24
3197,414370,2015-05-29,2015,PHI,COL,1,4,4-1,COL,9,0,32,34,66,138,123,261,2,9,11,0,2:32
3198,414378,2015-05-29,2015,MIN,TOR,4,6,6-4,TOR,9,0,32,38,70,130,111,241,6,13,19,3,2:15 (1:01 delay)
3199,414368,2015-05-29,2015,HOU,CHA,3,6,6-3,CHA,11,0,44,50,94,195,162,357,13,17,30,5,4:08
3200,414379,2015-05-29,2015,CIN,WAS,5,2,5-2,CIN,9,1,37,42,79,148,127,275,14,17,31,4,3:02
3201,414375,2015-05-29,2015,OAK,NYA,6,2,6-2,OAK,9,1,38,34,72,119,149,268,13,8,21,2,2:49
3202,414365,2015-05-29,2015,MIL,ARI,5,7,7-5,ARI,9,0,41,43,84,180,151,331,14,17,31,3,3:23
3203,414392,2015-05-30,2015,BAL,TBA,0,3,3-0,TBA,9,0,30,35,65,127,102,229,4,10,14,0,2:09
3204,414391,2015-05-30,2015,SDN,PIT,2,5,5-2,PIT,9,0,32,42,74,161,110,271,5,16,21,2,2:50
3205,414386,2015-05-30,2015,ANA,DET,8,6,8-6,ANA,9,1,36,39,75,136,134,270,13,14,27,5,2:50
3206,414384,2015-05-30,2015,SEA,CLE,3,4,4-3,CLE,9,0,39,36,75,132,138,270,15,11,26,5,3:04
3207,414388,2015-05-30,2015,SLN,LAN,1,5,5-1,LAN,9,0,32,39,71,165,130,295,8,13,21,2,2:53 (2:20 delay)
3208,414385,2015-05-30,2015,PHI,COL,2,5,5-2,COL,9,0,37,38,75,159,144,303,10,11,21,4,3:23
3209,414390,2015-05-30,2015,OAK,NYA,3,5,5-3,NYA,9,0,38,38,76,144,158,302,12,11,23,3,3:06
3210,414389,2015-05-30,2015,NYN,MIA,5,9,9-5,MIA,9,0,43,42,85,157,159,316,16,15,31,4,3:07
3211,414383,2015-05-30,2015,HOU,CHA,3,0,3-0,HOU,9,1,34,31,65,113,138,251,12,4,16,1,2:29
3212,414393,2015-05-30,2015,MIN,TOR,3,2,3-2,MIN,9,1,33,38,71,141,127,268,12,14,26,1,2:41
3213,414380,2015-05-30,2015,MIL,ARI,3,7,7-3,ARI,9,0,36,42,78,135,144,279,9,14,23,1,2:58
3214,414382,2015-05-30,2015,TEX,BOS,8,0,8-0,TEX,9,1,41,36,77,146,145,291,16,10,26,2,2:49
3215,414381,2015-05-30,2015,SFN,ATL,0,8,8-0,ATL,9,0,38,42,80,150,146,296,12,16,28,2,2:51
3216,414394,2015-05-30,2015,CIN,WAS,8,5,8-5,CIN,9,1,37,40,77,151,152,303,16,14,30,2,3:08
3217,414404,2015-05-31,2015,NYN,MIA,4,3,4-3,NYN,9,1,33,36,69,114,138,252,9,9,18,2,2:47
3218,414398,2015-05-31,2015,HOU,CHA,0,6,6-0,CHA,9,0,33,39,72,137,118,255,11,11,22,1,2:37
3219,414400,2015-05-31,2015,PHI,COL,1,4,4-1,COL,9,0,35,36,71,116,147,263,8,11,19,2,2:56
3220,414409,2015-05-31,2015,CIN,WAS,8,2,8-2,CIN,9,1,38,33,71,124,141,265,16,8,24,3,2:45
3221,414407,2015-05-31,2015,BAL,TBA,5,9,9-5,TBA,9,0,42,45,87,157,158,315,15,20,35,4,3:24
3222,414397,2015-05-31,2015,TEX,BOS,4,3,4-3,TEX,9,0,40,40,80,173,146,319,12,14,26,4,3:16
3223,414405,2015-05-31,2015,OAK,NYA,3,0,3-0,OAK,9,1,31,34,65,128,108,236,9,9,18,2,2:21
3224,414402,2015-05-31,2015,CHN,KCA,2,1,2-1,CHN,11,0,41,42,83,192,167,359,14,9,23,6,3:39
3225,414403,2015-05-31,2015,SLN,LAN,3,1,3-1,SLN,9,1,32,34,66,147,135,282,13,7,20,1,2:33
3226,414401,2015-05-31,2015,ANA,DET,4,2,4-2,ANA,9,1,37,37,74,151,124,275,13,12,25,3,3:19
3227,414406,2015-05-31,2015,SDN,PIT,7,1,7-1,SDN,9,1,41,36,77,126,159,285,16,9,25,0,2:46
3228,414396,2015-05-31,2015,SFN,ATL,5,7,7-5,ATL,9,0,39,39,78,142,139,281,12,11,23,5,3:02
3229,414408,2015-05-31,2015,MIN,TOR,6,5,6-5,MIN,9,1,34,40,74,163,132,295,10,16,26,5,3:08
3230,414399,2015-05-31,2015,SEA,CLE,3,6,6-3,CLE,12,0,47,59,106,232,194,426,13,27,40,5,4:36
3231,414395,2015-05-31,2015,MIL,ARI,7,6,7-6,MIL,17,0,71,74,145,253,275,528,23,28,51,3,5:49
3232,414418,2015-06-01,2015,SFN,PIT,3,4,4-3,PIT,9,0,34,37,71,129,117,246,8,9,17,0,2:38
3233,414417,2015-06-01,2015,SDN,NYN,0,7,7-0,NYN,9,0,28,39,67,152,114,266,2,14,16,1,2:21
3234,414419,2015-06-01,2015,ANA,TBA,7,3,7-3,ANA,9,1,40,35,75,131,134,265,17,9,26,2,2:55
3235,414416,2015-06-01,2015,SEA,NYA,2,7,7-2,NYA,9,0,35,38,73,139,140,279,10,12,22,2,2:55
3236,414413,2015-06-01,2015,COL,LAN,4,11,11-4,LAN,9,0,36,49,85,175,123,298,10,24,34,2,3:08
3237,414410,2015-06-01,2015,ARI,ATL,1,8,8-1,ATL,9,0,33,44,77,183,123,306,7,19,26,0,2:45
3238,414414,2015-06-01,2015,SLN,MIL,0,1,1-0,MIL,9,0,37,33,70,109,145,254,11,6,17,2,3:05
3239,414412,2015-06-01,2015,MIA,CHN,1,5,5-1,CHN,9,0,34,39,73,149,156,305,7,13,20,1,2:45
3240,414411,2015-06-01,2015,HOU,BAL,5,2,5-2,HOU,9,1,35,34,69,127,129,256,14,9,23,3,2:45
3241,414101,2015-06-02,2015,COL,LAN,6,3,6-3,COL,9,1,38,35,73,143,139,282,14,9,23,1,3:01
3242,414420,2015-06-02,2015,WAS,TOR,2,0,2-0,WAS,9,1,35,33,68,117,123,240,11,7,18,0,2:17
3243,414422,2015-06-02,2015,HOU,BAL,6,4,6-4,HOU,9,1,37,34,71,133,138,271,13,9,22,1,2:42
3244,414424,2015-06-02,2015,MIA,CHN,5,2,5-2,MIA,9,1,34,36,70,135,121,256,10,11,21,1,2:33
3245,414429,2015-06-02,2015,BOS,MIN,1,0,1-0,BOS,9,1,31,32,63,110,113,223,9,6,15,0,2:21
3246,414426,2015-06-02,2015,KCA,CLE,1,2,2-1,CLE,9,0,34,36,70,175,134,309,7,9,16,3,3:16
3247,414101,2015-06-02,2015,COL,LAN,6,3,6-3,COL,9,1,38,35,73,143,139,282,14,9,23,1,3:01
3248,414432,2015-06-02,2015,DET,OAK,3,5,5-3,OAK,9,0,37,39,76,150,133,283,10,12,22,1,2:50
3249,414434,2015-06-02,2015,ANA,TBA,1,6,6-1,TBA,9,0,34,37,71,139,119,258,7,11,18,0,2:33
3250,414435,2015-06-02,2015,WAS,TOR,3,7,7-3,TOR,9,0,36,41,77,155,147,302,8,14,22,1,3:04
3251,414431,2015-06-02,2015,SDN,NYN,7,2,7-2,SDN,9,1,39,36,75,141,151,292,16,10,26,2,3:00
3252,414423,2015-06-02,2015,TEX,CHA,15,2,15-2,TEX,9,1,46,34,80,118,161,279,24,7,31,1,2:35
3253,414420,2015-06-02,2015,WAS,TOR,2,0,2-0,WAS,9,1,35,33,68,117,123,240,11,7,18,0,2:17
3254,414425,2015-06-02,2015,PHI,CIN,5,4,5-4,PHI,9,0,36,39,75,125,126,251,9,13,22,1,2:52
3255,414427,2015-06-02,2015,COL,LAN,8,9,9-8,LAN,9,0,42,42,84,157,143,300,18,16,34,4,3:24
3256,414430,2015-06-02,2015,SEA,NYA,3,5,5-3,NYA,11,0,49,48,97,189,180,369,18,18,36,3,3:55
3257,414433,2015-06-02,2015,SFN,PIT,4,7,7-4,PIT,9,0,42,44,86,161,157,318,15,19,34,2,3:14
3258,414421,2015-06-02,2015,ARI,ATL,7,6,7-6,ARI,9,1,43,38,81,154,164,318,21,12,33,4,3:18
3259,414428,2015-06-02,2015,SLN,MIL,1,0,1-0,SLN,9,1,26,33,59,136,99,235,6,8,14,1,2:27
3260,414415,2015-06-03,2015,BOS,MIN,6,3,6-3,BOS,9,1,38,34,72,139,125,264,15,8,23,1,2:33
3261,414444,2015-06-03,2015,BOS,MIN,0,2,2-0,MIN,9,0,29,31,60,115,117,232,2,5,7,0,2:15
3262,414437,2015-06-03,2015,HOU,BAL,3,1,3-1,HOU,9,1,27,31,58,107,118,225,4,4,8,1,2:14
3263,414445,2015-06-03,2015,SEA,NYA,1,3,3-1,NYA,9,0,33,33,66,118,122,240,7,6,13,1,2:21
3264,414443,2015-06-03,2015,SLN,MIL,7,4,7-4,SLN,9,1,36,41,77,116,125,241,12,15,27,1,2:40
3265,414447,2015-06-03,2015,DET,OAK,1,6,6-1,OAK,9,0,33,40,73,136,128,264,5,14,19,1,2:39
3266,414446,2015-06-03,2015,SDN,NYN,7,3,7-3,SDN,9,1,38,39,77,131,124,255,12,14,26,1,2:45
3267,414441,2015-06-03,2015,KCA,CLE,4,2,4-2,KCA,9,1,32,35,67,127,110,237,10,10,20,0,2:33
3268,414448,2015-06-03,2015,SFN,PIT,2,5,5-2,PIT,9,0,37,38,75,135,133,268,10,12,22,3,2:59
3269,414436,2015-06-03,2015,ARI,ATL,9,8,9-8,ARI,9,1,41,42,83,168,160,328,17,16,33,3,3:17
3270,414439,2015-06-03,2015,MIA,CHN,7,3,7-3,MIA,9,1,38,40,78,145,137,282,16,13,29,3,2:56
3271,414450,2015-06-03,2015,WAS,TOR,0,8,8-0,TOR,9,0,32,40,72,136,93,229,7,14,21,0,2:13
3272,414442,2015-06-03,2015,COL,LAN,7,6,7-6,COL,9,0,41,42,83,170,164,334,17,17,34,5,3:44 (2:26 delay)
3273,414415,2015-06-03,2015,BOS,MIN,6,3,6-3,BOS,9,1,38,34,72,139,125,264,15,8,23,1,2:33
3274,414438,2015-06-03,2015,TEX,CHA,2,9,9-2,CHA,9,0,36,45,81,189,163,352,10,19,29,2,3:06
3275,414449,2015-06-03,2015,ANA,TBA,5,6,6-5,TBA,10,0,43,41,84,150,157,307,18,12,30,3,3:20
3276,414440,2015-06-03,2015,PHI,CIN,5,4,5-4,PHI,11,0,43,51,94,173,171,344,11,17,28,3,3:31
3277,414460,2015-06-04,2015,SEA,TBA,1,2,2-1,TBA,9,0,38,32,70,117,131,248,12,8,20,2,2:42
3278,414454,2015-06-04,2015,PHI,CIN,4,6,6-4,CIN,9,0,34,38,72,141,131,272,9,13,22,2,2:41
3279,414455,2015-06-04,2015,KCA,CLE,2,6,6-2,CLE,8,0,31,37,68,145,120,265,9,13,22,2,2:38 (:44 delay)
3280,414459,2015-06-04,2015,LAN,SLN,1,7,7-1,SLN,9,0,36,43,79,149,141,290,9,18,27,1,2:56
3281,414458,2015-06-04,2015,DET,OAK,5,7,7-5,OAK,9,0,36,40,76,152,144,296,10,15,25,2,3:06
3282,414453,2015-06-04,2015,WAS,CHN,1,2,2-1,CHN,9,0,37,34,71,145,147,292,13,11,24,3,3:16 (1:51 delay)
3283,414457,2015-06-04,2015,ARI,NYN,2,6,6-2,NYN,9,0,36,43,79,193,145,338,10,15,25,2,3:22
3284,414451,2015-06-04,2015,HOU,BAL,2,3,3-2,BAL,9,0,36,35,71,168,140,308,9,10,19,2,2:59
3285,414452,2015-06-04,2015,TEX,CHA,2,1,2-1,TEX,11,0,47,44,91,177,185,362,21,8,29,3,3:55
3286,414456,2015-06-04,2015,BOS,MIN,4,8,8-4,MIN,9,0,39,45,84,169,150,319,13,17,30,4,3:12
3287,414469,2015-06-05,2015,BOS,OAK,4,2,4-2,BOS,9,1,34,35,69,122,120,242,12,10,22,2,2:31
3288,414462,2015-06-05,2015,CLE,BAL,2,5,5-2,BAL,9,0,37,36,73,115,142,257,11,12,23,4,2:48
3289,414463,2015-06-05,2015,WAS,CHN,7,5,7-5,WAS,9,1,38,35,73,144,139,283,16,9,25,2,2:58
3290,414472,2015-06-05,2015,PHI,SFN,4,5,5-4,SFN,9,0,35,39,74,152,142,294,10,14,24,2,2:58
3291,414466,2015-06-05,2015,COL,MIA,2,6,6-2,MIA,9,0,38,40,78,132,136,268,13,14,27,2,2:43 (1:55 delay)
3292,414473,2015-06-05,2015,LAN,SLN,1,2,2-1,SLN,9,0,34,34,68,101,132,233,8,8,16,2,2:22
3293,414475,2015-06-05,2015,KCA,TEX,0,4,4-0,TEX,9,0,30,38,68,140,116,256,5,10,15,1,2:40
3294,414464,2015-06-05,2015,CHA,DET,4,3,4-3,CHA,11,0,40,41,81,135,151,286,11,11,22,2,3:08
3295,414471,2015-06-05,2015,CIN,SDN,2,6,6-2,SDN,9,0,36,38,74,138,147,285,10,12,22,1,2:51 (1:09 delay)
3296,414461,2015-06-05,2015,NYA,ANA,8,7,8-7,NYA,9,1,40,46,86,188,154,342,16,18,34,3,3:27
3297,414474,2015-06-05,2015,SEA,TBA,0,1,1-0,TBA,9,0,36,34,70,133,146,279,10,10,20,1,2:55
3298,414468,2015-06-05,2015,ARI,NYN,7,2,7-2,ARI,9,1,36,35,71,151,122,273,14,9,23,2,2:49
3299,414467,2015-06-05,2015,MIN,MIL,5,10,10-5,MIL,9,0,38,41,79,142,143,285,12,15,27,3,2:48
3300,414465,2015-06-05,2015,TOR,HOU,6,2,6-2,TOR,9,1,35,31,66,114,127,241,13,6,19,3,2:35
3301,414470,2015-06-05,2015,ATL,PIT,8,10,10-8,PIT,9,0,45,44,89,177,161,338,19,18,37,2,3:28
3302,414488,2015-06-06,2015,LAN,SLN,2,0,2-0,LAN,9,1,28,30,58,117,99,216,7,4,11,1,2:22
3303,414477,2015-06-06,2015,CLE,BAL,2,1,2-1,CLE,9,1,36,32,68,132,158,290,15,8,23,2,2:44
3304,414478,2015-06-06,2015,WAS,CHN,2,4,4-2,CHN,9,0,34,35,69,159,123,282,8,9,17,2,2:52
3305,414476,2015-06-06,2015,NYA,ANA,8,2,8-2,NYA,9,1,42,35,77,139,166,305,17,9,26,3,3:05
3306,414490,2015-06-06,2015,KCA,TEX,2,4,4-2,TEX,9,0,37,41,78,170,135,305,9,18,27,2,2:50
3307,414481,2015-06-06,2015,COL,MIA,10,5,10-5,COL,9,1,42,42,84,139,143,282,19,15,34,2,2:59 (1:11 delay)
3308,414489,2015-06-06,2015,SEA,TBA,2,1,2-1,SEA,9,1,34,32,66,128,126,254,14,6,20,0,2:45
3309,414480,2015-06-06,2015,TOR,HOU,7,2,7-2,TOR,9,1,41,33,74,135,169,304,16,9,25,4,3:16
3310,414485,2015-06-06,2015,ATL,PIT,5,4,5-4,ATL,9,0,35,32,67,117,120,237,11,6,17,2,2:44
3311,414482,2015-06-06,2015,MIN,MIL,2,4,4-2,MIL,9,0,34,38,72,149,138,287,8,14,22,2,3:22
3312,414483,2015-06-06,2015,ARI,NYN,2,1,2-1,ARI,9,1,31,36,67,153,109,262,9,12,21,3,2:40
3313,414486,2015-06-06,2015,CIN,SDN,7,9,9-7,SDN,9,0,42,44,86,173,149,322,18,18,36,2,3:12
3314,414487,2015-06-06,2015,PHI,SFN,5,7,7-5,SFN,9,0,33,45,78,167,118,285,8,17,25,1,2:53 (:29 delay)
3315,414484,2015-06-06,2015,BOS,OAK,4,2,4-2,BOS,9,1,39,36,75,154,162,316,18,9,27,4,3:10
3316,414479,2015-06-06,2015,CHA,DET,1,7,7-1,DET,9,0,31,46,77,152,110,262,7,20,27,1,2:54
3317,414494,2015-06-07,2015,CHA,DET,4,6,6-4,DET,9,0,35,35,70,113,124,237,8,11,19,1,2:38
3318,414498,2015-06-07,2015,ARI,NYN,3,6,6-3,NYN,9,0,35,40,75,168,132,300,8,17,25,0,2:44
3319,414500,2015-06-07,2015,ATL,PIT,0,3,3-0,PIT,9,0,38,39,77,138,148,286,12,13,25,0,2:50
3320,414499,2015-06-07,2015,BOS,OAK,7,4,7-4,BOS,9,1,37,40,77,159,133,292,15,14,29,5,3:11
3321,414505,2015-06-07,2015,KCA,TEX,4,3,4-3,KCA,9,1,35,34,69,136,113,249,12,8,20,1,2:31
3322,414501,2015-06-07,2015,CIN,SDN,4,0,4-0,CIN,9,1,34,33,67,126,110,236,10,6,16,0,2:22
3323,414493,2015-06-07,2015,WAS,CHN,3,6,6-3,CHN,9,0,36,44,80,172,151,323,8,20,28,1,3:12
3324,414504,2015-06-07,2015,SEA,TBA,1,3,3-1,TBA,9,0,34,34,68,129,146,275,7,6,13,1,2:46
3325,414497,2015-06-07,2015,MIN,MIL,2,0,2-0,MIN,9,1,36,34,70,118,145,263,13,10,23,2,2:53
3326,414491,2015-06-07,2015,NYA,ANA,6,2,6-2,NYA,9,1,32,32,64,134,111,245,9,7,16,0,2:20
3327,414496,2015-06-07,2015,COL,MIA,2,3,3-2,MIA,10,0,39,36,75,122,164,286,11,8,19,0,3:05
3328,414502,2015-06-07,2015,PHI,SFN,6,4,6-4,PHI,9,1,34,42,76,149,117,266,12,16,28,3,3:07
3329,414495,2015-06-07,2015,TOR,HOU,7,6,7-6,TOR,9,0,40,42,82,163,152,315,15,15,30,1,3:06
3330,414503,2015-06-07,2015,LAN,SLN,2,4,4-2,SLN,9,0,35,37,72,136,168,304,9,11,20,5,3:25
3331,414492,2015-06-07,2015,CLE,BAL,3,7,7-3,BAL,9,0,40,44,84,167,163,330,13,15,28,6,3:33
3332,414507,2015-06-08,2015,CHA,HOU,3,1,3-1,CHA,9,1,28,34,62,135,106,241,5,7,12,0,2:13 (1:03 delay)
3333,414509,2015-06-08,2015,TOR,MIA,11,3,11-3,TOR,9,1,44,34,78,129,161,290,20,8,28,2,2:47
3334,414506,2015-06-08,2015,LAN,ARI,9,3,9-3,LAN,9,1,35,33,68,129,135,264,11,7,18,0,2:42
3335,414508,2015-06-08,2015,MIN,KCA,1,3,3-1,KCA,9,0,34,36,70,128,117,245,10,10,20,2,2:36
3336,414512,2015-06-08,2015,ATL,SDN,3,5,5-3,SDN,11,0,44,44,88,175,182,357,13,11,24,2,3:47
3337,414510,2015-06-08,2015,PIT,MIL,0,2,2-0,MIL,9,0,36,35,71,144,146,290,12,9,21,1,3:07 (2:13 delay)
3338,414513,2015-06-08,2015,COL,SLN,11,3,11-3,COL,9,1,43,35,78,118,146,264,17,9,26,0,2:39
3339,414511,2015-06-08,2015,CIN,PHI,6,4,6-4,CIN,9,1,36,39,75,152,144,296,13,14,27,0,2:55
3340,414521,2015-06-09,2015,PIT,MIL,1,4,4-1,MIL,9,0,33,34,67,111,117,228,6,7,13,0,2:25
3341,414519,2015-06-09,2015,MIN,KCA,0,2,2-0,KCA,9,0,31,38,69,156,118,274,5,13,18,4,2:50
3342,414522,2015-06-09,2015,CIN,PHI,11,2,11-2,CIN,9,1,41,38,79,141,156,297,15,13,28,1,2:50
3343,414525,2015-06-09,2015,NYN,SFN,0,5,5-0,SFN,9,0,29,40,69,143,110,253,3,16,19,1,2:32
3344,414523,2015-06-09,2015,ATL,SDN,6,5,6-5,ATL,9,1,38,44,82,163,136,299,13,17,30,3,3:15 (:50 delay)
3345,414528,2015-06-09,2015,NYA,WAS,6,1,6-1,NYA,9,1,39,33,72,128,148,276,16,7,23,2,2:51
3346,414516,2015-06-09,2015,BAL,BOS,1,0,1-0,BAL,9,1,32,36,68,159,133,292,9,10,19,2,3:08
3347,414520,2015-06-09,2015,TOR,MIA,4,3,4-3,TOR,9,0,31,38,69,145,113,258,6,12,18,0,2:16
3348,414517,2015-06-09,2015,DET,CHN,6,0,6-0,DET,9,1,37,36,73,135,152,287,15,10,25,2,2:53
3349,414526,2015-06-09,2015,COL,SLN,4,3,4-3,COL,9,1,35,36,71,149,137,286,13,10,23,3,2:56 (1:07 delay)
3350,414515,2015-06-09,2015,LAN,ARI,3,1,3-1,LAN,9,1,36,35,71,111,126,237,14,10,24,2,2:32
3351,414514,2015-06-09,2015,TBA,ANA,2,8,8-2,ANA,9,0,34,46,80,171,123,294,8,17,25,2,2:52
3352,414524,2015-06-09,2015,CLE,SEA,2,3,3-2,SEA,9,0,37,39,76,149,119,268,10,14,24,3,3:03
3353,414527,2015-06-09,2015,OAK,TEX,1,2,2-1,TEX,9,0,37,37,74,134,164,298,10,11,21,3,3:00
3354,414518,2015-06-09,2015,CHA,HOU,4,2,4-2,CHA,9,1,37,37,74,168,151,319,14,10,24,3,3:07
3355,414536,2015-06-10,2015,PIT,MIL,2,0,2-0,PIT,9,1,33,31,64,111,116,227,13,6,19,3,2:22
3356,414535,2015-06-10,2015,TOR,MIA,7,2,7-2,TOR,9,1,33,34,67,119,115,234,11,7,18,1,2:08
3357,414533,2015-06-10,2015,CHA,HOU,4,1,4-1,CHA,9,1,35,38,73,130,146,276,15,9,24,1,3:12
3358,414538,2015-06-10,2015,ATL,SDN,4,1,4-1,ATL,9,1,36,34,70,116,146,262,16,8,24,1,2:39
3359,414534,2015-06-10,2015,MIN,KCA,2,7,7-2,KCA,9,0,36,38,74,161,146,307,10,10,20,0,2:56
3360,414540,2015-06-10,2015,NYN,SFN,5,8,8-5,SFN,9,0,38,42,80,158,153,311,14,17,31,5,3:23
3361,414532,2015-06-10,2015,DET,CHN,3,12,12-3,CHN,9,0,35,47,82,186,137,323,11,22,33,2,3:18
3362,414529,2015-06-10,2015,TBA,ANA,4,2,4-2,TBA,9,1,35,35,70,140,114,254,12,10,22,1,2:39
3363,414537,2015-06-10,2015,CIN,PHI,5,2,5-2,CIN,9,1,36,37,73,151,136,287,12,12,24,2,2:48
3364,414530,2015-06-10,2015,LAN,ARI,7,6,7-6,LAN,9,0,40,41,81,149,156,305,14,14,28,3,3:35
3365,414543,2015-06-10,2015,NYA,WAS,4,5,5-4,WAS,11,0,45,47,92,160,168,328,13,14,27,3,3:36
3366,414539,2015-06-10,2015,CLE,SEA,3,9,9-3,SEA,9,0,40,44,84,169,139,308,14,17,31,1,3:04
3367,414542,2015-06-10,2015,OAK,TEX,5,4,5-4,OAK,9,0,38,40,78,142,150,292,13,15,28,2,3:05
3368,414531,2015-06-10,2015,BAL,BOS,5,2,5-2,BAL,9,1,34,32,66,132,115,247,12,8,20,2,2:36
3369,414541,2015-06-10,2015,COL,SLN,2,4,4-2,SLN,9,0,34,40,74,168,142,310,9,14,23,2,2:59
3370,414546,2015-06-11,2015,CHN,CIN,6,3,6-3,CHN,9,1,39,35,74,150,166,316,15,8,23,3,2:58
3371,414550,2015-06-11,2015,NYN,SFN,5,4,5-4,NYN,9,0,40,36,76,125,161,286,15,10,25,3,3:03
3372,414544,2015-06-11,2015,TBA,ANA,2,6,6-2,ANA,9,0,32,42,74,176,123,299,6,18,24,4,3:20
3373,414552,2015-06-11,2015,MIL,WAS,6,5,6-5,MIL,9,1,37,37,74,130,130,260,12,10,22,2,2:54
3374,414549,2015-06-11,2015,CLE,SEA,6,0,6-0,CLE,9,1,35,30,65,125,146,271,13,3,16,1,2:40
3375,414548,2015-06-11,2015,ATL,SDN,4,6,6-4,SDN,11,0,45,47,92,178,164,342,14,15,29,5,3:42 (:56 delay)
3376,414547,2015-06-11,2015,MIA,COL,6,0,6-0,MIA,9,1,40,34,74,123,133,256,16,7,23,1,2:41
3377,414551,2015-06-11,2015,OAK,TEX,7,0,7-0,OAK,9,1,40,29,69,114,134,248,18,3,21,2,2:35
3378,414545,2015-06-11,2015,BAL,BOS,6,5,6-5,BAL,9,1,35,37,72,158,118,276,12,10,22,2,2:39
3379,414559,2015-06-12,2015,SLN,KCA,4,0,4-0,SLN,9,1,36,32,68,114,140,254,13,5,18,2,2:38
3380,414561,2015-06-12,2015,TEX,MIN,6,2,6-2,TEX,9,1,32,34,66,155,124,279,10,8,18,4,2:39
3381,414553,2015-06-12,2015,SFN,ARI,0,1,1-0,ARI,9,0,31,39,70,144,124,268,5,15,20,2,2:52
3382,414555,2015-06-12,2015,TBA,CHA,7,5,7-5,TBA,9,1,40,37,77,149,148,297,17,10,27,3,3:07
3383,414562,2015-06-12,2015,BAL,NYA,11,3,11-3,BAL,9,1,42,40,82,168,142,310,18,13,31,3,3:18
3384,414558,2015-06-12,2015,MIA,COL,5,1,5-1,MIA,9,1,36,31,67,109,136,245,13,7,20,2,2:45
3385,414560,2015-06-12,2015,SDN,LAN,3,4,4-3,LAN,9,0,38,39,77,155,168,323,10,16,26,4,3:28
3386,414557,2015-06-12,2015,DET,CLE,4,0,4-0,DET,9,1,33,30,63,93,122,215,12,7,19,1,2:25
3387,414566,2015-06-12,2015,BOS,TOR,10,13,13-10,TOR,9,0,46,43,89,157,185,342,19,17,36,4,3:24
3388,414556,2015-06-12,2015,CHN,CIN,4,5,5-4,CIN,10,0,41,45,86,199,162,361,12,15,27,0,3:21
3389,414554,2015-06-12,2015,NYN,ATL,5,3,5-3,NYN,9,1,34,40,74,163,125,288,13,18,31,2,3:09
3390,414565,2015-06-12,2015,HOU,SEA,10,0,10-0,HOU,9,1,39,34,73,131,148,279,16,7,23,1,2:45
3391,414567,2015-06-12,2015,MIL,WAS,8,4,8-4,MIL,9,1,39,36,75,132,163,295,17,10,27,1,2:59
3392,414563,2015-06-12,2015,ANA,OAK,5,4,5-4,ANA,9,1,33,39,72,169,118,287,12,12,24,2,2:55
3393,414564,2015-06-12,2015,PIT,PHI,1,0,1-0,PIT,13,0,56,52,108,206,212,418,20,16,36,1,4:34 (1:26 delay)
3394,414579,2015-06-13,2015,PIT,PHI,4,3,4-3,PIT,9,1,35,37,72,153,135,288,12,10,22,0,3:05
3395,414576,2015-06-13,2015,TEX,MIN,11,7,11-7,TEX,9,1,40,38,78,137,130,267,21,12,33,2,2:44 (1:19 delay)
3396,414569,2015-06-13,2015,NYN,ATL,3,5,5-3,ATL,11,0,45,50,95,180,161,341,13,17,30,4,3:39
3397,414568,2015-06-13,2015,SFN,ARI,2,4,4-2,ARI,9,0,34,37,71,135,134,269,7,12,19,2,2:50
3398,414570,2015-06-13,2015,TBA,CHA,5,4,5-4,TBA,9,1,35,37,72,137,129,266,13,11,24,2,2:46
3399,414581,2015-06-13,2015,BOS,TOR,4,5,5-4,TOR,11,0,44,45,89,164,166,330,10,13,23,2,3:26
3400,414573,2015-06-13,2015,MIA,COL,4,1,4-1,MIA,9,1,32,34,66,129,127,256,9,7,16,1,2:43
3401,414575,2015-06-13,2015,SDN,LAN,2,1,2-1,SDN,9,1,31,31,62,124,100,224,9,7,16,0,2:30
3402,414571,2015-06-13,2015,CHN,CIN,4,3,4-3,CHN,9,0,33,37,70,140,106,246,13,11,24,1,2:39 (2:48 delay)
3403,414578,2015-06-13,2015,ANA,OAK,1,0,1-0,ANA,9,1,30,32,62,134,111,245,8,6,14,0,2:27
3404,414574,2015-06-13,2015,SLN,KCA,3,2,3-2,SLN,9,1,35,36,71,139,139,278,13,8,21,4,2:46 (:24 delay)
3405,414582,2015-06-13,2015,MIL,WAS,2,7,7-2,WAS,9,0,36,43,79,141,122,263,9,16,25,1,2:52
3406,414580,2015-06-13,2015,HOU,SEA,1,8,8-1,SEA,9,0,36,43,79,162,133,295,11,16,27,0,2:47
3407,414577,2015-06-13,2015,BAL,NYA,9,4,9-4,BAL,9,1,39,39,78,143,154,297,15,13,28,2,3:14
3408,414572,2015-06-13,2015,DET,CLE,4,5,5-4,CLE,9,0,41,40,81,157,152,309,15,15,30,6,3:34
3409,414591,2015-06-14,2015,TEX,MIN,3,4,4-3,MIN,9,0,36,40,76,145,129,274,11,16,27,0,2:49
3410,414583,2015-06-14,2015,SFN,ARI,0,4,4-0,ARI,9,0,33,40,73,161,111,272,11,15,26,1,2:51
3411,414594,2015-06-14,2015,PIT,PHI,1,0,1-0,PIT,11,0,46,38,84,126,162,288,15,7,22,0,3:04
3412,414593,2015-06-14,2015,ANA,OAK,1,8,8-1,OAK,9,0,36,44,80,163,130,293,7,15,22,4,3:16
3413,414584,2015-06-14,2015,NYN,ATL,10,8,10-8,NYN,9,1,40,43,83,144,146,290,18,18,36,3,2:59
3414,414587,2015-06-14,2015,DET,CLE,8,1,8-1,DET,9,1,35,36,71,139,128,267,12,10,22,2,2:46 (1:51 delay)
3415,414588,2015-06-14,2015,MIA,COL,1,4,4-1,COL,9,0,37,38,75,158,147,305,10,12,22,2,3:08
3416,414585,2015-06-14,2015,TBA,CHA,2,1,2-1,TBA,9,1,33,34,67,139,145,284,9,9,18,1,2:42
3417,414597,2015-06-14,2015,MIL,WAS,0,4,4-0,WAS,9,0,29,39,68,169,119,288,2,13,15,0,2:59
3418,414590,2015-06-14,2015,SDN,LAN,2,4,4-2,LAN,12,0,50,49,99,182,181,363,15,17,32,4,4:16
3419,414592,2015-06-14,2015,BAL,NYA,3,5,5-3,NYA,9,0,38,42,80,171,158,329,11,15,26,4,3:29
3420,414595,2015-06-14,2015,HOU,SEA,13,0,13-0,HOU,9,1,47,33,80,162,189,351,22,7,29,1,3:26
3421,414586,2015-06-14,2015,CHN,CIN,2,1,2-1,CHN,11,0,41,43,84,172,169,341,10,12,22,4,3:54
3422,414596,2015-06-14,2015,BOS,TOR,5,13,13-5,TOR,9,0,40,45,85,153,163,316,14,20,34,2,3:12
3423,414601,2015-06-15,2015,DET,CIN,6,0,6-0,DET,9,1,37,28,65,112,130,242,14,2,16,1,2:37
3424,414607,2015-06-15,2015,MIA,NYA,2,1,2-1,MIA,9,1,35,33,68,134,115,249,12,6,18,1,2:41
3425,414606,2015-06-15,2015,SLN,MIN,3,2,3-2,SLN,9,1,34,33,67,113,136,249,11,7,18,1,2:32 (:20 delay)
3426,414603,2015-06-15,2015,HOU,COL,6,3,6-3,HOU,9,1,36,34,70,132,142,274,12,7,19,1,2:48
3427,414598,2015-06-15,2015,ANA,ARI,3,7,7-3,ARI,9,0,33,41,74,139,143,282,8,16,24,2,2:58
3428,414610,2015-06-15,2015,SFN,SEA,1,5,5-1,SEA,9,0,34,40,74,159,121,280,7,13,20,1,2:52
3429,414609,2015-06-15,2015,BAL,PHI,4,0,4-0,BAL,9,1,31,30,61,124,116,240,8,5,13,0,2:09 (:27 delay)
3430,414604,2015-06-15,2015,MIL,KCA,5,8,8-5,KCA,9,0,41,42,83,169,152,321,16,17,33,1,3:19
3431,414599,2015-06-15,2015,BOS,ATL,2,4,4-2,ATL,9,0,36,36,72,127,138,265,12,11,23,3,2:54
3432,414608,2015-06-15,2015,SDN,OAK,1,9,9-1,OAK,9,0,37,47,84,184,141,325,9,21,30,1,3:18
3433,414611,2015-06-15,2015,NYN,TOR,4,3,4-3,NYN,11,0,41,43,84,193,146,339,8,10,18,2,3:26
3434,414605,2015-06-15,2015,TEX,LAN,4,1,4-1,TEX,9,1,32,34,66,142,109,251,9,11,20,1,2:44
3435,414600,2015-06-15,2015,PIT,CHA,11,0,11-0,PIT,9,1,43,28,71,120,168,288,21,3,24,1,2:51
3436,414612,2015-06-15,2015,TBA,WAS,6,1,6-1,TBA,9,1,43,40,83,162,163,325,20,14,34,1,3:12
3437,414621,2015-06-16,2015,SLN,MIN,3,2,3-2,SLN,9,1,32,35,67,124,124,248,10,9,19,3,2:31 (1:32 delay)
3438,414619,2015-06-16,2015,MIL,KCA,2,7,7-2,KCA,9,0,35,43,78,147,125,272,9,17,26,1,2:51
3439,414626,2015-06-16,2015,NYN,TOR,3,2,3-2,NYN,9,1,32,35,67,148,120,268,9,9,18,1,2:35
3440,414616,2015-06-16,2015,DET,CIN,2,5,5-2,CIN,9,0,35,36,71,122,145,267,11,11,22,3,2:57
3441,414623,2015-06-16,2015,SDN,OAK,5,6,6-5,OAK,9,0,35,39,74,151,131,282,10,14,24,2,2:57
3442,414614,2015-06-16,2015,BOS,ATL,9,4,9-4,BOS,9,1,38,39,77,150,124,274,19,12,31,2,2:38
3443,414618,2015-06-16,2015,HOU,COL,8,5,8-5,HOU,9,1,39,39,78,165,166,331,17,13,30,1,3:34
3444,414620,2015-06-16,2015,TEX,LAN,3,2,3-2,TEX,9,0,34,36,70,120,117,237,12,9,21,1,2:22
3445,414617,2015-06-16,2015,CHN,CLE,0,6,6-0,CLE,9,0,34,43,77,187,134,321,8,18,26,1,3:08
3446,414613,2015-06-16,2015,ANA,ARI,4,1,4-1,ANA,9,1,34,35,69,122,129,251,10,8,18,1,2:42
3447,414627,2015-06-16,2015,TBA,WAS,4,16,16-4,WAS,9,0,37,53,90,171,150,321,10,29,39,3,3:08
3448,414622,2015-06-16,2015,MIA,NYA,12,2,12-2,MIA,9,1,44,36,80,132,175,307,20,9,29,2,3:09
3449,414615,2015-06-16,2015,PIT,CHA,3,0,3-0,PIT,9,1,38,33,71,116,152,268,16,6,22,0,2:44
3450,414625,2015-06-16,2015,SFN,SEA,6,2,6-2,SFN,9,1,35,35,70,130,134,264,13,9,22,3,2:39
3451,414624,2015-06-16,2015,BAL,PHI,19,3,19-3,BAL,9,1,50,35,85,134,210,344,26,9,35,2,3:11
3452,414639,2015-06-17,2015,SEA,SFN,2,0,2-0,SEA,9,1,28,34,62,121,112,233,6,6,12,1,2:24
3453,414640,2015-06-17,2015,MIN,SLN,3,1,3-1,MIN,9,1,34,33,67,143,127,270,11,8,19,2,2:47
3454,414636,2015-06-17,2015,TOR,NYN,8,0,8-0,TOR,9,1,38,33,71,145,140,285,18,7,25,3,2:33
3455,414628,2015-06-17,2015,ARI,ANA,3,2,3-2,ARI,9,1,35,37,72,135,136,271,12,12,24,3,3:00
3456,414638,2015-06-17,2015,OAK,SDN,16,2,16-2,OAK,9,1,46,33,79,129,161,290,24,6,30,3,2:49
3457,414630,2015-06-17,2015,ATL,BOS,5,2,5-2,ATL,9,1,40,37,77,129,164,293,16,10,26,3,3:09
3458,414634,2015-06-17,2015,NYA,MIA,2,1,2-1,NYA,9,1,35,34,69,144,134,278,14,7,21,2,2:50
3459,414637,2015-06-17,2015,CHA,PIT,2,3,3-2,PIT,9,0,33,32,65,123,136,259,7,5,12,0,2:27
3460,414641,2015-06-17,2015,WAS,TBA,0,5,5-0,TBA,9,0,31,39,70,136,117,253,5,13,18,0,2:35 (:27 delay)
3461,414633,2015-06-17,2015,COL,HOU,4,8,8-4,HOU,9,0,34,43,77,169,108,277,9,17,26,3,3:13
3462,414642,2015-06-17,2015,LAN,TEX,3,5,5-3,TEX,9,0,40,35,75,151,154,305,14,10,24,3,3:18
3463,414629,2015-06-17,2015,PHI,BAL,4,6,6-4,BAL,9,0,36,36,72,128,124,252,10,9,19,3,2:34
3464,414635,2015-06-17,2015,KCA,MIL,10,2,10-2,KCA,9,1,40,33,73,134,150,284,17,7,24,1,3:05
3465,414631,2015-06-17,2015,CLE,CHN,0,17,17-0,CHN,9,0,31,49,80,202,126,328,6,24,30,3,3:06
3466,414632,2015-06-17,2015,CIN,DET,8,4,8-4,CIN,13,0,57,49,106,208,230,438,20,10,30,3,4:56 (1:14 delay)
3467,414644,2015-06-18,2015,PHI,BAL,2,1,2-1,PHI,9,1,29,36,65,131,107,238,7,8,15,0,2:32
3468,414651,2015-06-18,2015,TOR,NYN,7,1,7-1,TOR,9,1,37,35,72,140,130,270,13,8,21,2,2:34
3469,414655,2015-06-18,2015,MIN,SLN,2,1,2-1,MIN,9,0,35,32,67,113,139,252,12,6,18,3,2:38
3470,414646,2015-06-18,2015,CLE,CHN,4,3,4-3,CLE,9,1,34,37,71,153,143,296,12,10,22,6,3:01 (1:41 delay)
3471,414652,2015-06-18,2015,CHA,PIT,2,3,3-2,PIT,9,0,33,40,73,153,127,280,6,16,22,2,2:58
3472,414654,2015-06-18,2015,SEA,SFN,0,7,7-0,SFN,9,0,34,40,74,136,144,280,9,14,23,3,2:53
3473,414650,2015-06-18,2015,KCA,MIL,3,2,3-2,KCA,9,1,35,37,72,109,124,233,15,9,24,1,2:38
3474,414653,2015-06-18,2015,OAK,SDN,1,3,3-1,SDN,9,0,32,36,68,138,130,268,6,9,15,1,2:39
3475,414656,2015-06-18,2015,WAS,TBA,3,5,5-3,TBA,9,0,40,39,79,136,148,284,14,13,27,1,3:02 (:17 delay)
3476,414645,2015-06-18,2015,ATL,BOS,2,5,5-2,BOS,9,0,36,38,74,161,126,287,9,14,23,1,3:04 (:45 delay)
3477,414643,2015-06-18,2015,ARI,ANA,1,7,7-1,ANA,9,0,34,38,72,141,125,266,8,17,25,1,2:36
3478,414649,2015-06-18,2015,NYA,MIA,9,4,9-4,NYA,9,1,45,37,82,149,177,326,21,11,32,3,3:26
3479,414657,2015-06-18,2015,LAN,TEX,1,0,1-0,LAN,9,0,34,31,65,123,137,260,9,5,14,1,2:55
3480,414648,2015-06-18,2015,COL,HOU,4,8,8-4,HOU,9,0,40,41,81,166,165,331,13,15,28,1,3:30
3481,414661,2015-06-19,2015,MIN,CHN,7,2,7-2,MIN,9,1,36,30,66,105,123,228,14,4,18,1,2:18
3482,414667,2015-06-19,2015,WAS,PIT,4,1,4-1,WAS,9,1,37,32,69,117,112,229,15,7,22,2,2:36
3483,414666,2015-06-19,2015,ATL,NYN,2,1,2-1,ATL,9,1,32,34,66,109,119,228,9,7,16,3,2:29
3484,414664,2015-06-19,2015,CIN,MIA,5,0,5-0,CIN,9,1,35,34,69,125,131,256,12,8,20,2,2:27
3485,414672,2015-06-19,2015,CHA,TEX,1,2,2-1,TEX,9,0,38,33,71,139,128,267,11,7,18,0,2:26
3486,414663,2015-06-19,2015,SEA,HOU,5,2,5-2,SEA,9,1,36,33,69,117,135,252,12,6,18,2,2:33
3487,414669,2015-06-19,2015,LAN,SFN,5,9,9-5,SFN,9,0,37,43,80,180,124,304,12,18,30,4,3:24
3488,414671,2015-06-19,2015,CLE,TBA,1,4,4-1,TBA,9,0,35,36,71,141,140,281,10,12,22,2,3:01
3489,414662,2015-06-19,2015,NYA,DET,7,2,7-2,NYA,9,1,38,33,71,122,134,256,15,9,24,1,2:50
3490,414668,2015-06-19,2015,ARI,SDN,4,2,4-2,ARI,9,1,36,40,76,141,138,279,14,11,25,1,3:08
3491,414660,2015-06-19,2015,KCA,BOS,3,7,7-3,BOS,9,0,39,41,80,136,162,298,13,19,32,2,2:57
3492,414659,2015-06-19,2015,TOR,BAL,5,4,5-4,TOR,9,1,36,40,76,175,132,307,16,13,29,3,3:07
3493,414665,2015-06-19,2015,COL,MIL,5,9,9-5,MIL,9,0,38,44,82,158,142,300,12,21,33,1,3:16
3494,414658,2015-06-19,2015,OAK,ANA,7,12,12-7,ANA,9,0,40,46,86,189,149,338,14,18,32,6,3:38
3495,414670,2015-06-19,2015,PHI,SLN,4,12,12-4,SLN,9,0,42,52,94,226,166,392,15,26,41,0,3:34
3496,414682,2015-06-20,2015,WAS,PIT,6,0,6-0,WAS,9,1,32,28,60,106,127,233,9,1,10,1,2:21
3497,414687,2015-06-20,2015,CHA,TEX,3,2,3-2,CHA,9,1,36,32,68,134,123,257,13,7,20,0,2:47
3498,414675,2015-06-20,2015,KCA,BOS,7,4,7-4,KCA,9,1,37,40,77,150,127,277,16,13,29,3,3:09
3499,414679,2015-06-20,2015,CIN,MIA,0,5,5-0,MIA,9,0,32,37,69,138,112,250,7,11,18,2,2:33
3500,414674,2015-06-20,2015,TOR,BAL,3,5,5-3,BAL,9,0,40,38,78,141,165,306,15,13,28,1,2:56
3501,414680,2015-06-20,2015,COL,MIL,5,1,5-1,COL,9,1,33,33,66,117,115,232,9,8,17,1,2:27
3502,414681,2015-06-20,2015,ATL,NYN,6,4,6-4,ATL,9,1,36,37,73,140,150,290,15,12,27,2,3:11
3503,414685,2015-06-20,2015,PHI,SLN,1,10,10-1,SLN,9,0,35,46,81,176,137,313,10,21,31,0,3:02
3504,414676,2015-06-20,2015,MIN,CHN,1,4,4-1,CHN,10,0,37,44,81,157,156,313,12,16,28,3,3:17
3505,414673,2015-06-20,2015,OAK,ANA,4,1,4-1,OAK,9,1,38,35,73,137,138,275,14,9,23,4,2:59
3506,414686,2015-06-20,2015,CLE,TBA,1,4,4-1,TBA,9,0,36,36,72,143,145,288,10,14,24,2,3:07
3507,414683,2015-06-20,2015,ARI,SDN,1,8,8-1,SDN,9,0,32,40,72,163,111,274,6,14,20,2,2:40
3508,414678,2015-06-20,2015,SEA,HOU,6,3,6-3,SEA,9,1,36,36,72,131,133,264,12,9,21,5,2:43
3509,414684,2015-06-20,2015,LAN,SFN,2,6,6-2,SFN,9,0,35,38,73,144,127,271,9,12,21,2,2:56
3510,414677,2015-06-20,2015,NYA,DET,14,3,14-3,NYA,9,1,48,35,83,144,179,323,25,8,33,2,3:24
3511,414700,2015-06-21,2015,PHI,SLN,9,2,9-2,PHI,9,1,39,35,74,114,144,258,15,9,24,1,2:29
3512,414691,2015-06-21,2015,MIN,CHN,0,8,8-0,CHN,9,0,31,44,75,179,122,301,4,19,23,1,2:59
3513,414693,2015-06-21,2015,SEA,HOU,2,6,6-2,HOU,9,0,37,40,77,169,159,328,10,14,24,2,3:24
3514,414696,2015-06-21,2015,ATL,NYN,1,0,1-0,ATL,9,1,33,31,64,103,143,246,9,6,15,2,2:26
3515,414698,2015-06-21,2015,ARI,SDN,7,2,7-2,ARI,9,1,33,35,68,118,113,231,7,8,15,0,2:30
3516,414690,2015-06-21,2015,KCA,BOS,2,13,13-2,BOS,9,0,39,46,85,169,147,316,13,20,33,2,2:58
3517,414692,2015-06-21,2015,NYA,DET,4,12,12-4,DET,9,0,37,49,86,178,132,310,11,22,33,1,3:01
3518,414688,2015-06-21,2015,OAK,ANA,3,2,3-2,OAK,9,1,33,37,70,146,130,276,10,11,21,1,2:58
3519,414699,2015-06-21,2015,LAN,SFN,10,2,10-2,LAN,9,1,43,34,77,142,151,293,19,11,30,1,3:06
3520,414702,2015-06-21,2015,CHA,TEX,3,2,3-2,CHA,11,0,43,45,88,163,183,346,15,17,32,3,3:49
3521,414694,2015-06-21,2015,CIN,MIA,5,2,5-2,CIN,9,1,35,38,73,135,138,273,14,12,26,2,2:52
3522,414697,2015-06-21,2015,WAS,PIT,9,2,9-2,WAS,9,1,38,36,74,114,141,255,14,10,24,1,2:34
3523,414695,2015-06-21,2015,COL,MIL,10,4,10-4,COL,9,1,39,36,75,129,144,273,18,12,30,4,3:09
3524,414689,2015-06-21,2015,TOR,BAL,9,13,13-9,BAL,9,0,43,47,90,203,165,368,18,21,39,8,3:44
3525,414701,2015-06-21,2015,CLE,TBA,1,0,1-0,CLE,9,0,31,35,66,125,116,241,8,10,18,1,2:36
3526,414706,2015-06-22,2015,SEA,KCA,1,4,4-1,KCA,9,0,30,35,65,140,126,266,3,12,15,2,2:34
3527,414707,2015-06-22,2015,CHN,LAN,4,2,4-2,CHN,9,1,31,32,63,131,120,251,7,9,16,3,2:40 (:10 delay)
3528,414703,2015-06-22,2015,MIN,CHA,13,2,13-2,MIN,9,1,41,39,80,136,151,287,18,16,34,1,2:55
3529,414705,2015-06-22,2015,ANA,HOU,4,3,4-3,ANA,9,1,38,34,72,157,155,312,13,7,20,4,3:23
3530,414704,2015-06-22,2015,CLE,DET,5,8,8-5,DET,9,0,37,45,82,171,133,304,11,20,31,2,3:27 (:10 delay)
3531,414709,2015-06-22,2015,TBA,TOR,5,8,8-5,TOR,9,0,46,39,85,167,189,356,20,13,33,4,3:28
3532,414708,2015-06-22,2015,NYA,PHI,8,11,11-8,PHI,9,0,44,47,91,165,177,342,18,21,39,1,3:33
3533,414718,2015-06-23,2015,CHN,LAN,1,0,1-0,CHN,10,0,37,36,73,132,162,294,8,6,14,2,3:10
3534,414724,2015-06-23,2015,TBA,TOR,4,3,4-3,TBA,9,1,36,33,69,115,126,241,15,5,20,0,2:14
3535,414720,2015-06-23,2015,TEX,OAK,6,8,8-6,OAK,9,0,42,40,82,152,171,323,15,14,29,4,3:17
3536,414714,2015-06-23,2015,PIT,CIN,7,6,7-6,PIT,9,1,37,45,82,157,173,330,15,18,33,2,3:37
3537,414723,2015-06-23,2015,MIA,SLN,3,4,4-3,SLN,9,0,37,39,76,146,135,281,13,14,27,1,2:45
3538,414713,2015-06-23,2015,MIN,CHA,2,6,6-2,CHA,9,0,35,44,79,168,125,293,11,18,29,3,2:57
3539,414711,2015-06-23,2015,WAS,ATL,3,1,3-1,WAS,9,1,35,38,73,164,117,281,13,11,24,2,2:52 (2:12 delay)
3540,414716,2015-06-23,2015,ANA,HOU,3,13,13-3,HOU,9,0,38,49,87,170,128,298,13,22,35,1,2:59
3541,414710,2015-06-23,2015,COL,ARI,10,5,10-5,COL,9,1,36,39,75,130,123,253,14,13,27,1,2:51 (:38 delay)
3542,414717,2015-06-23,2015,SEA,KCA,7,0,7-0,SEA,9,1,39,33,72,105,150,255,15,6,21,0,2:23
3543,414719,2015-06-23,2015,MIL,NYN,3,2,3-2,MIL,9,1,38,34,72,149,136,285,16,7,23,3,2:53
3544,414722,2015-06-23,2015,SFN,SDN,2,3,3-2,SDN,11,0,44,41,85,174,198,372,13,10,23,4,4:03
3545,414712,2015-06-23,2015,BOS,BAL,4,6,6-4,BAL,9,0,40,38,78,166,170,336,13,14,27,2,3:08
3546,414721,2015-06-23,2015,NYA,PHI,6,11,11-6,PHI,9,0,43,45,88,173,166,339,16,18,34,4,3:45 (1:21 delay)
3547,414715,2015-06-23,2015,CLE,DET,3,7,7-3,DET,9,0,38,39,77,162,157,319,12,12,24,3,3:28
3548,414730,2015-06-24,2015,CLE,DET,8,2,8-2,CLE,9,1,43,31,74,121,184,305,22,6,28,4,3:06
3549,414731,2015-06-24,2015,ANA,HOU,2,1,2-1,ANA,13,0,54,46,100,177,216,393,16,11,27,5,4:31
3550,414734,2015-06-24,2015,MIL,NYN,4,1,4-1,MIL,9,1,35,30,65,116,106,222,13,4,17,0,2:13
3551,414728,2015-06-24,2015,MIN,CHA,6,1,6-1,MIN,9,1,35,34,69,102,121,223,12,7,19,1,2:19
3552,414737,2015-06-24,2015,SFN,SDN,6,0,6-0,SFN,9,1,34,34,68,122,131,253,11,7,18,0,2:36
3553,414738,2015-06-24,2015,MIA,SLN,1,6,6-1,SLN,9,0,34,34,68,115,112,227,7,9,16,2,2:31
3554,414727,2015-06-24,2015,BOS,BAL,5,1,5-1,BOS,9,1,32,34,66,128,127,255,9,9,18,1,2:38
3555,414733,2015-06-24,2015,CHN,LAN,2,5,5-2,LAN,9,0,37,34,71,141,150,291,13,8,21,4,3:12
3556,414732,2015-06-24,2015,SEA,KCA,2,8,8-2,KCA,9,0,36,39,75,132,144,276,9,15,24,2,2:47
3557,414736,2015-06-24,2015,NYA,PHI,10,2,10-2,NYA,9,1,47,37,84,141,179,320,22,9,31,1,3:10
3558,414729,2015-06-24,2015,PIT,CIN,2,5,5-2,CIN,9,0,36,41,77,162,141,303,9,16,25,2,3:09
3559,414735,2015-06-24,2015,TEX,OAK,2,8,8-2,OAK,9,0,36,46,82,170,121,291,11,19,30,1,2:46
3560,414726,2015-06-24,2015,WAS,ATL,2,1,2-1,WAS,11,0,43,42,85,147,160,307,14,12,26,2,3:10
3561,414725,2015-06-24,2015,COL,ARI,7,8,8-7,ARI,9,0,39,45,84,168,166,334,13,18,31,6,3:55 (:46 delay)
3562,414739,2015-06-24,2015,TBA,TOR,0,1,1-0,TOR,12,0,43,45,88,163,193,356,8,11,19,2,3:39
3563,414741,2015-06-25,2015,WAS,ATL,7,0,7-0,WAS,9,1,37,34,71,143,131,274,14,8,22,0,2:36
3564,414740,2015-06-25,2015,COL,ARI,6,4,6-4,COL,9,1,37,40,77,161,137,298,15,15,30,3,3:30
3565,414745,2015-06-25,2015,CHN,LAN,0,4,4-0,LAN,9,0,35,37,72,144,135,279,11,12,23,1,2:57
3566,414747,2015-06-25,2015,MIL,NYN,0,2,2-0,NYN,9,0,30,37,67,158,112,270,4,13,17,1,2:46
3567,414749,2015-06-25,2015,SFN,SDN,13,8,13-8,SFN,9,1,44,40,84,147,150,297,21,15,36,4,3:11
3568,414748,2015-06-25,2015,TEX,OAK,3,6,6-3,OAK,9,0,38,40,78,168,132,300,11,14,25,3,2:57
3569,414742,2015-06-25,2015,BOS,BAL,6,8,8-6,BAL,9,0,39,44,83,177,146,323,13,18,31,4,3:06
3570,414743,2015-06-25,2015,DET,CHA,7,8,8-7,CHA,10,0,49,46,95,174,190,364,22,16,38,2,3:53
3571,414746,2015-06-25,2015,HOU,NYA,4,0,4-0,HOU,9,1,34,33,67,116,127,243,12,7,19,1,2:29
3572,414750,2015-06-25,2015,MIA,SLN,1,5,5-1,SLN,9,0,35,40,75,153,130,283,8,15,23,3,2:47
3573,414744,2015-06-25,2015,PIT,CIN,4,5,5-4,CIN,13,0,55,58,113,219,193,412,18,22,40,1,4:41 (:56 delay)
3574,414756,2015-06-26,2015,NYN,CIN,2,1,2-1,NYN,9,1,31,31,62,98,135,233,6,5,11,0,2:24
3575,414757,2015-06-26,2015,BAL,CLE,4,3,4-3,BAL,9,1,35,39,74,144,127,271,13,13,26,1,2:47
3576,414751,2015-06-26,2015,SDN,ARI,4,2,4-2,SDN,9,1,32,32,64,130,137,267,8,8,16,0,2:42
3577,414754,2015-06-26,2015,DET,CHA,5,4,5-4,DET,9,1,36,37,73,137,122,259,14,10,24,1,2:47
3578,414765,2015-06-26,2015,PHI,WAS,2,5,5-2,WAS,9,0,33,39,72,135,107,242,7,12,19,0,2:38
3579,414752,2015-06-26,2015,PIT,ATL,3,2,3-2,PIT,10,0,42,38,80,124,144,268,18,10,28,1,3:10
3580,414760,2015-06-26,2015,MIA,LAN,1,7,7-1,LAN,9,0,32,43,75,147,144,291,7,19,26,0,2:38
3581,414758,2015-06-26,2015,SFN,COL,6,8,8-6,COL,9,0,40,44,84,142,163,305,14,20,34,4,3:30
3582,414755,2015-06-26,2015,SLN,CHN,3,2,3-2,SLN,10,0,39,44,83,165,146,311,12,16,28,3,3:25
3583,414763,2015-06-26,2015,ANA,SEA,1,3,3-1,SEA,9,0,36,36,72,115,121,236,11,13,24,3,2:43
3584,414759,2015-06-26,2015,OAK,KCA,2,5,5-2,KCA,9,0,33,40,73,147,142,289,6,15,21,2,2:51
3585,414762,2015-06-26,2015,HOU,NYA,2,3,3-2,NYA,9,0,35,38,73,140,150,290,8,12,20,4,3:08
3586,414764,2015-06-26,2015,TOR,TEX,12,2,12-2,TOR,9,1,41,35,76,130,147,277,19,9,28,0,2:26
3587,414753,2015-06-26,2015,TBA,BOS,3,4,4-3,BOS,10,0,41,42,83,154,142,296,15,15,30,4,3:23
3588,414761,2015-06-26,2015,MIL,MIN,10,4,10-4,MIL,9,1,40,35,75,133,157,290,15,8,23,1,2:49
3589,414776,2015-06-27,2015,MIL,MIN,2,5,5-2,MIN,9,0,35,35,70,132,128,260,8,11,19,1,2:47
3590,414768,2015-06-27,2015,TBA,BOS,4,1,4-1,TBA,9,1,33,30,63,124,134,258,11,3,14,1,2:21
3591,414767,2015-06-27,2015,PIT,ATL,8,4,8-4,PIT,9,1,39,38,77,136,132,268,15,13,28,2,3:02 (:46 delay)
3592,414770,2015-06-27,2015,SLN,CHN,8,1,8-1,SLN,9,1,41,35,76,144,160,304,20,12,32,1,3:03
3593,414774,2015-06-27,2015,OAK,KCA,2,3,3-2,KCA,9,0,34,37,71,129,142,271,8,10,18,1,2:49
3594,414777,2015-06-27,2015,HOU,NYA,6,9,9-6,NYA,9,0,41,46,87,167,166,333,14,18,32,2,3:39
3595,414775,2015-06-27,2015,MIA,LAN,3,2,3-2,MIA,9,1,31,32,63,104,122,226,8,6,14,1,2:26
3596,414779,2015-06-27,2015,TOR,TEX,0,4,4-0,TEX,9,0,30,38,68,141,108,249,5,11,16,3,2:24
3597,414778,2015-06-27,2015,ANA,SEA,4,2,4-2,ANA,9,1,32,36,68,115,132,247,10,10,20,1,2:38
3598,414771,2015-06-27,2015,NYN,CIN,2,1,2-1,NYN,13,0,57,52,109,197,232,429,20,15,35,3,4:33 (:53 delay)
3599,414766,2015-06-27,2015,SDN,ARI,7,2,7-2,SDN,9,1,39,33,72,141,129,270,16,8,24,1,2:57
3600,414773,2015-06-27,2015,SFN,COL,7,5,7-5,SFN,9,1,38,40,78,156,135,291,17,13,30,3,3:26
3601,414771,2015-06-27,2015,NYN,CIN,2,1,2-1,NYN,13,0,57,52,109,197,232,429,20,15,35,3,4:33 (:53 delay)
3602,414792,2015-06-28,2015,HOU,NYA,3,1,3-1,HOU,9,1,28,31,59,119,107,226,7,4,11,0,2:24
3603,414785,2015-06-28,2015,SLN,CHN,4,1,4-1,SLN,9,1,32,37,69,131,123,254,10,9,19,1,2:28 (2:29 delay)
3604,414784,2015-06-28,2015,DET,CHA,5,4,5-4,DET,9,0,35,35,70,149,127,276,10,9,19,2,3:01
3605,414772,2015-06-28,2015,BAL,CLE,8,0,8-0,BAL,9,1,37,34,71,140,155,295,12,8,20,2,2:46
3606,414772,2015-06-28,2015,BAL,CLE,8,0,8-0,BAL,9,1,37,34,71,140,155,295,12,8,20,2,2:46
3607,414787,2015-06-28,2015,BAL,CLE,4,0,4-0,BAL,9,1,31,33,64,127,116,243,9,6,15,2,2:21
3608,414790,2015-06-28,2015,MIA,LAN,0,2,2-0,LAN,9,0,32,41,73,159,117,276,6,16,22,2,2:54
3609,414793,2015-06-28,2015,ANA,SEA,3,2,3-2,ANA,10,0,40,36,76,134,158,292,15,7,22,3,3:14
3610,414788,2015-06-28,2015,SFN,COL,6,3,6-3,SFN,9,1,33,33,66,119,133,252,10,9,19,4,2:55
3611,414781,2015-06-28,2015,SDN,ARI,4,6,6-4,ARI,9,0,34,35,69,132,119,251,7,7,14,2,2:31
3612,414782,2015-06-28,2015,PIT,ATL,1,2,2-1,ATL,9,0,34,38,72,141,126,267,8,12,20,1,2:46
3613,414791,2015-06-28,2015,MIL,MIN,5,3,5-3,MIL,9,1,36,37,73,146,142,288,12,12,24,1,3:02
3614,414794,2015-06-28,2015,TOR,TEX,3,2,3-2,TOR,9,1,31,41,72,149,120,269,8,13,21,3,2:40
3615,414786,2015-06-28,2015,NYN,CIN,7,2,7-2,NYN,9,1,38,34,72,141,161,302,16,9,25,2,2:56
3616,414789,2015-06-28,2015,OAK,KCA,3,5,5-3,KCA,9,0,39,39,78,166,156,322,12,11,23,1,2:58
3617,414795,2015-06-28,2015,PHI,WAS,2,3,3-2,WAS,9,0,34,43,77,153,138,291,6,15,21,4,3:07
3618,414783,2015-06-28,2015,TBA,BOS,3,5,5-3,BOS,9,0,39,36,75,162,169,331,13,11,24,1,3:02
3619,414780,2015-06-28,2015,PHI,WAS,8,5,8-5,PHI,9,1,41,40,81,176,145,321,17,12,29,3,3:15
3620,414780,2015-06-28,2015,PHI,WAS,8,5,8-5,PHI,9,1,41,40,81,176,145,321,17,12,29,3,3:15
3621,414796,2015-06-29,2015,TOR,BOS,1,3,3-1,BOS,9,0,30,35,65,138,107,245,6,10,16,1,2:26
3622,414803,2015-06-29,2015,ANA,NYA,4,1,4-1,ANA,9,1,32,37,69,144,110,254,8,13,21,1,2:40
3623,414801,2015-06-29,2015,PHI,MIL,4,7,7-4,MIL,9,0,36,43,79,136,142,278,11,18,29,3,3:22
3624,414802,2015-06-29,2015,CIN,MIN,11,7,11-7,CIN,9,1,46,38,84,150,175,325,23,12,35,1,3:34
3625,414799,2015-06-29,2015,HOU,KCA,6,1,6-1,HOU,9,1,37,35,72,132,171,303,14,9,23,2,2:57
3626,414800,2015-06-29,2015,ARI,LAN,10,6,10-6,ARI,9,1,41,44,85,163,155,318,18,19,37,4,3:49
3627,414798,2015-06-29,2015,OAK,COL,7,1,7-1,OAK,9,1,36,37,73,153,130,283,13,11,24,1,2:40
3628,414797,2015-06-29,2015,TBA,CLE,1,7,7-1,CLE,9,0,29,43,72,162,113,275,3,19,22,1,2:45
3629,414804,2015-06-29,2015,BAL,TEX,1,8,8-1,TEX,9,0,37,42,79,153,165,318,12,16,28,1,3:11
3630,414807,2015-06-30,2015,NYN,CHN,0,1,1-0,CHN,9,0,31,35,66,138,128,266,4,10,14,0,2:22
3631,414817,2015-06-30,2015,MIA,SFN,5,3,5-3,MIA,9,1,37,35,72,135,112,247,13,8,21,2,2:44
3632,414818,2015-06-30,2015,BAL,TEX,6,8,8-6,TEX,9,0,36,39,75,149,135,284,8,16,24,1,2:44
3633,414808,2015-06-30,2015,TBA,CLE,2,6,6-2,CLE,9,0,32,37,69,161,129,290,5,10,15,4,2:42
3634,414819,2015-06-30,2015,ATL,WAS,1,6,6-1,WAS,9,0,36,42,78,163,139,302,9,16,25,1,2:53
3635,414805,2015-06-30,2015,TOR,BOS,3,4,4-3,BOS,9,0,35,39,74,161,140,301,8,12,20,3,3:04
3636,414813,2015-06-30,2015,CIN,MIN,5,8,8-5,MIN,9,0,40,44,84,168,146,314,13,20,33,2,3:19 (2:01 delay)
3637,414812,2015-06-30,2015,PHI,MIL,3,4,4-3,MIL,9,0,41,40,81,168,160,328,14,13,27,3,3:26 (1:19 delay)
3638,414810,2015-06-30,2015,HOU,KCA,4,0,4-0,HOU,9,1,31,34,65,122,111,233,8,8,16,1,2:14
3639,414814,2015-06-30,2015,ANA,NYA,2,1,2-1,ANA,9,1,35,30,65,117,125,242,12,4,16,1,2:37
3640,414816,2015-06-30,2015,SDN,SEA,0,5,5-0,SEA,9,0,32,35,67,139,113,252,6,8,14,0,2:23
3641,414809,2015-06-30,2015,OAK,COL,1,2,2-1,COL,9,0,35,33,68,145,134,279,11,7,18,1,2:56
3642,414815,2015-06-30,2015,DET,PIT,4,5,5-4,PIT,14,0,58,66,124,249,233,482,20,26,46,5,5:30
3643,414806,2015-06-30,2015,SLN,CHA,1,2,2-1,CHA,11,0,43,44,87,191,158,349,10,11,21,1,3:34
3644,414811,2015-06-30,2015,ARI,LAN,4,6,6-4,LAN,10,0,40,44,84,185,175,360,15,14,29,3,4:09
3645,414834,2015-07-01,2015,ATL,WAS,4,1,4-1,ATL,9,1,33,35,68,143,123,266,10,10,20,2,2:39 (2:09 delay)
3646,414826,2015-07-01,2015,ARI,LAN,3,4,4-3,LAN,9,0,37,39,76,164,127,291,13,14,27,1,2:58
3647,414833,2015-07-01,2015,BAL,TEX,4,2,4-2,BAL,9,1,33,32,65,101,119,220,10,5,15,2,2:18
3648,414828,2015-07-01,2015,CIN,MIN,2,1,2-1,CIN,9,1,33,33,66,123,122,245,9,6,15,2,2:40
3649,414820,2015-07-01,2015,TOR,BOS,11,2,11-2,TOR,9,1,40,33,73,139,137,276,18,6,24,0,2:19
3650,414832,2015-07-01,2015,MIA,SFN,6,5,6-5,MIA,9,0,31,39,70,157,116,273,13,14,27,2,2:45
3651,414823,2015-07-01,2015,TBA,CLE,1,8,8-1,CLE,9,0,30,39,69,142,131,273,4,12,16,2,2:44
3652,414824,2015-07-01,2015,OAK,COL,4,1,4-1,OAK,9,1,37,36,73,145,139,284,14,9,23,3,3:14
3653,414830,2015-07-01,2015,DET,PIT,3,9,9-3,PIT,9,0,40,47,87,176,131,307,12,22,34,2,3:21
3654,414831,2015-07-01,2015,SDN,SEA,0,7,7-0,SEA,9,0,31,41,72,168,127,295,5,14,19,3,3:01
3655,414829,2015-07-01,2015,ANA,NYA,1,3,3-1,NYA,9,0,36,40,76,140,157,297,11,14,25,5,3:22
3656,414825,2015-07-01,2015,HOU,KCA,6,5,6-5,HOU,9,1,38,35,73,128,147,275,14,9,23,4,3:21
3657,414827,2015-07-01,2015,PHI,MIL,5,9,9-5,MIL,9,0,40,44,84,147,128,275,13,18,31,2,2:58
3658,414821,2015-07-01,2015,SLN,CHA,1,7,7-1,CHA,9,0,35,41,76,153,138,291,8,16,24,4,3:16 (2:19 delay)
3659,414822,2015-07-01,2015,NYN,CHN,0,2,2-0,CHN,11,0,43,44,87,165,169,334,10,16,26,2,3:40
3660,414843,2015-07-02,2015,OAK,SEA,4,0,4-0,OAK,9,1,32,29,61,113,140,253,8,3,11,0,2:17
3661,414846,2015-07-02,2015,ATL,WAS,2,1,2-1,ATL,9,0,29,32,61,110,105,215,5,7,12,1,2:33
3662,414836,2015-07-02,2015,NYN,CHN,1,6,6-1,CHN,9,0,31,40,71,173,105,278,6,14,20,1,2:41
3663,414841,2015-07-02,2015,DET,PIT,4,8,8-4,PIT,9,0,40,46,86,183,151,334,14,21,35,5,3:32
3664,414840,2015-07-02,2015,KCA,MIN,0,2,2-0,MIN,9,0,34,36,70,147,125,272,8,11,19,2,2:54
3665,414844,2015-07-02,2015,MIA,SFN,5,4,5-4,MIA,9,1,36,38,74,139,121,260,13,11,24,2,2:45
3666,414838,2015-07-02,2015,ARI,COL,8,1,8-1,ARI,9,1,39,31,70,116,147,263,16,5,21,1,3:01
3667,414845,2015-07-02,2015,BAL,TEX,0,2,2-0,TEX,9,0,31,38,69,159,126,285,6,11,17,5,2:55
3668,414837,2015-07-02,2015,TBA,CLE,4,5,5-4,CLE,10,0,37,39,76,152,138,290,8,11,19,1,3:01
3669,414842,2015-07-02,2015,SLN,SDN,3,5,5-3,SDN,11,0,49,46,95,175,198,373,16,16,32,1,3:55
3670,414835,2015-07-02,2015,TOR,BOS,6,12,12-6,BOS,9,0,47,49,96,188,165,353,22,22,44,2,3:34
3671,414839,2015-07-02,2015,PHI,MIL,7,8,8-7,MIL,11,0,51,50,101,172,186,358,19,20,39,1,3:57
3672,414859,2015-07-03,2015,WAS,SFN,2,1,2-1,WAS,9,1,32,31,63,107,119,226,10,5,15,1,2:33
3673,414857,2015-07-03,2015,SLN,SDN,1,2,2-1,SDN,9,0,31,35,66,128,123,251,8,9,17,1,2:35
3674,414856,2015-07-03,2015,ATL,PHI,2,1,2-1,ATL,9,1,32,37,69,134,118,252,9,12,21,1,2:43
3675,414850,2015-07-03,2015,ARI,COL,4,3,4-3,ARI,10,0,44,36,80,141,158,299,19,7,26,1,3:36
3676,414852,2015-07-03,2015,CHN,MIA,1,2,2-1,MIA,9,0,36,36,72,151,132,283,9,9,18,2,2:50
3677,414855,2015-07-03,2015,LAN,NYN,1,2,2-1,NYN,9,0,33,36,69,141,152,293,5,8,13,0,3:00
3678,414847,2015-07-03,2015,TEX,ANA,2,8,8-2,ANA,9,0,35,45,80,179,114,293,8,19,27,2,3:03
3679,414853,2015-07-03,2015,CIN,MIL,1,12,12-1,MIL,9,0,34,47,81,185,152,337,9,22,31,1,3:34
3680,414861,2015-07-03,2015,DET,TOR,8,6,8-6,DET,9,1,36,38,74,154,136,290,16,11,27,3,3:01
3681,414849,2015-07-03,2015,PIT,CLE,2,5,5-2,CLE,9,0,32,42,74,177,125,302,6,16,22,3,3:11 (2:08 delay)
3682,414858,2015-07-03,2015,OAK,SEA,5,9,9-5,SEA,9,0,37,40,77,140,148,288,11,13,24,2,2:52
3683,414854,2015-07-03,2015,KCA,MIN,3,2,3-2,KCA,10,0,41,37,78,148,153,301,14,6,20,2,3:14
3684,414848,2015-07-03,2015,CHA,BAL,1,0,1-0,CHA,9,1,31,33,64,126,116,242,9,7,16,0,2:23
3685,414851,2015-07-03,2015,BOS,HOU,8,12,12-8,HOU,10,0,47,53,100,189,199,388,17,22,39,6,4:23
3686,414860,2015-07-03,2015,NYA,TBA,7,5,7-5,NYA,12,0,50,47,97,198,215,413,20,16,36,6,4:30
3687,414864,2015-07-04,2015,PIT,CLE,1,0,1-0,PIT,9,1,29,30,59,108,92,200,6,5,11,0,2:06
3688,414863,2015-07-04,2015,CHA,BAL,3,2,3-2,CHA,9,1,37,32,69,121,153,274,13,6,19,3,2:53
3689,414867,2015-07-04,2015,CHN,MIA,7,2,7-2,CHN,9,1,32,41,73,132,126,258,8,12,20,3,2:40
3690,414873,2015-07-04,2015,OAK,SEA,2,0,2-0,OAK,9,1,35,33,68,145,107,252,12,8,20,0,2:36
3691,414875,2015-07-04,2015,NYA,TBA,3,2,3-2,NYA,9,0,33,35,68,132,137,269,9,8,17,2,2:42
3692,414872,2015-07-04,2015,SLN,SDN,2,1,2-1,SLN,9,1,31,36,67,130,129,259,7,11,18,2,2:37
3693,414866,2015-07-04,2015,BOS,HOU,6,1,6-1,BOS,9,1,42,32,74,110,164,274,17,6,23,1,3:02
3694,414870,2015-07-04,2015,LAN,NYN,4,3,4-3,LAN,9,1,39,37,76,137,149,286,16,10,26,4,3:25
3695,414865,2015-07-04,2015,ARI,COL,7,3,7-3,ARI,9,1,39,36,75,125,155,280,14,11,25,2,3:18
3696,414874,2015-07-04,2015,WAS,SFN,9,3,9-3,WAS,9,1,40,35,75,141,144,285,17,10,27,2,3:10 (:19 delay)
3697,414871,2015-07-04,2015,ATL,PHI,9,5,9-5,ATL,9,1,40,39,79,130,167,297,15,14,29,2,3:04
3698,414869,2015-07-04,2015,KCA,MIN,3,5,5-3,MIN,9,0,38,39,77,139,141,280,13,14,27,4,3:25
3699,414868,2015-07-04,2015,CIN,MIL,3,7,7-3,MIL,9,0,40,47,87,166,136,302,12,25,37,5,3:46
3700,414876,2015-07-04,2015,DET,TOR,8,3,8-3,DET,9,1,39,37,76,141,164,305,19,11,30,2,3:10
3701,414862,2015-07-04,2015,TEX,ANA,0,13,13-0,ANA,9,0,34,52,86,213,138,351,6,27,33,1,3:21
3702,414884,2015-07-05,2015,KCA,MIN,3,2,3-2,KCA,9,0,31,34,65,109,101,210,9,10,19,2,2:20
3703,414882,2015-07-05,2015,CHN,MIA,2,0,2-0,CHN,9,1,31,31,62,111,110,221,7,6,13,1,2:18
3704,414887,2015-07-05,2015,SLN,SDN,3,1,3-1,SLN,9,1,30,33,63,134,135,269,8,6,14,0,2:26
3705,414889,2015-07-05,2015,WAS,SFN,3,1,3-1,WAS,9,1,34,33,67,125,123,248,10,6,16,3,3:02
3706,414883,2015-07-05,2015,CIN,MIL,1,6,6-1,MIL,9,0,33,40,73,127,120,247,7,16,23,1,2:41
3707,414879,2015-07-05,2015,PIT,CLE,5,3,5-3,PIT,9,1,35,32,67,121,139,260,11,7,18,4,2:51
3708,414888,2015-07-05,2015,OAK,SEA,1,2,2-1,SEA,9,0,34,33,67,143,133,276,10,7,17,3,2:47
3709,414890,2015-07-05,2015,NYA,TBA,1,8,8-1,TBA,9,0,35,41,76,144,149,293,9,15,24,1,2:59
3710,414878,2015-07-05,2015,CHA,BAL,1,9,9-1,BAL,9,0,33,45,78,164,143,307,8,15,23,2,3:13
3711,414880,2015-07-05,2015,ARI,COL,4,6,6-4,COL,9,0,39,39,78,143,149,292,13,15,28,4,3:32
3712,414886,2015-07-05,2015,ATL,PHI,0,4,4-0,PHI,10,0,37,44,81,165,149,314,9,15,24,3,3:13
3713,414881,2015-07-05,2015,BOS,HOU,5,4,5-4,BOS,9,1,38,41,79,174,177,351,16,14,30,3,4:01
3714,414877,2015-07-05,2015,TEX,ANA,6,12,12-6,ANA,9,0,40,46,86,164,154,318,13,20,33,1,3:03
3715,414891,2015-07-05,2015,DET,TOR,5,10,10-5,TOR,9,0,39,46,85,171,164,335,13,19,32,2,3:17
3716,414885,2015-07-05,2015,LAN,NYN,0,8,8-0,NYN,9,0,33,47,80,168,142,310,6,21,27,0,2:54
3717,414894,2015-07-06,2015,WAS,CIN,2,3,3-2,CIN,9,0,37,39,76,132,138,270,10,13,23,1,2:43 (:29 delay)
3718,414900,2015-07-06,2015,CHN,SLN,0,6,6-0,SLN,9,0,32,37,69,139,121,260,7,9,16,0,2:43 (1:16 delay)
3719,414899,2015-07-06,2015,PIT,SDN,2,1,2-1,PIT,9,0,33,33,66,129,143,272,8,10,18,1,2:53 (:28 delay)
3720,414892,2015-07-06,2015,MIL,ATL,3,5,5-3,ATL,9,0,35,44,79,173,140,313,10,18,28,1,3:30
3721,414896,2015-07-06,2015,CLE,HOU,4,9,9-4,HOU,9,0,38,44,82,170,150,320,13,19,32,2,3:15
3722,414893,2015-07-06,2015,MIN,BAL,4,2,4-2,MIN,10,0,37,39,76,141,137,278,10,11,21,1,2:49
3723,414895,2015-07-06,2015,SEA,DET,5,12,12-5,DET,9,0,38,44,82,142,153,295,12,20,32,4,3:17
3724,414898,2015-07-06,2015,LAN,PHI,10,7,10-7,LAN,9,1,42,45,87,186,181,367,18,19,37,4,4:13
3725,414902,2015-07-06,2015,CHA,TOR,4,2,4-2,CHA,9,1,31,32,63,108,104,212,9,7,16,0,1:54
3726,414897,2015-07-06,2015,SFN,NYN,0,3,3-0,NYN,9,0,32,38,70,134,93,227,5,12,17,4,2:20
3727,413683,2015-07-07,2015,CHN,SLN,7,4,7-4,CHN,9,1,45,35,80,133,168,301,20,11,31,4,3:10
3728,414907,2015-07-07,2015,WAS,CIN,0,5,5-0,CIN,9,0,31,38,69,133,122,255,3,11,14,1,2:30
3729,414909,2015-07-07,2015,CLE,HOU,2,0,2-0,CLE,9,1,33,34,67,145,129,274,10,8,18,2,3:03 (:11 delay)
3730,414911,2015-07-07,2015,SFN,NYN,3,0,3-0,SFN,9,1,35,33,68,151,117,268,11,8,19,1,2:47
3731,414903,2015-07-07,2015,COL,ANA,2,10,10-2,ANA,9,0,36,40,76,136,126,262,10,14,24,2,2:30
3732,414910,2015-07-07,2015,BOS,MIA,4,3,4-3,BOS,9,1,35,36,71,132,147,279,11,9,20,3,2:44
3733,414906,2015-07-07,2015,MIN,BAL,8,3,8-3,MIN,9,1,38,35,73,150,141,291,17,9,26,2,2:48
3734,414913,2015-07-07,2015,LAN,PHI,2,7,7-2,PHI,9,0,35,42,77,163,123,286,10,14,24,0,2:45
3735,414914,2015-07-07,2015,PIT,SDN,3,2,3-2,PIT,9,1,38,36,74,137,150,287,14,9,23,1,2:55 (1:42 delay)
3736,414905,2015-07-07,2015,MIL,ATL,3,4,4-3,ATL,9,0,37,37,74,133,148,281,12,12,24,3,2:55
3737,414916,2015-07-07,2015,KCA,TBA,7,1,7-1,KCA,9,1,40,35,75,147,143,290,16,9,25,3,3:10
3738,414901,2015-07-07,2015,KCA,TBA,9,5,9-5,KCA,9,0,43,40,83,140,145,285,21,12,33,3,3:10
3739,414901,2015-07-07,2015,KCA,TBA,9,5,9-5,KCA,9,0,43,40,83,140,145,285,21,12,33,3,3:10
3740,413683,2015-07-07,2015,CHN,SLN,7,4,7-4,CHN,9,1,45,35,80,133,168,301,20,11,31,4,3:10
3741,414912,2015-07-07,2015,NYA,OAK,3,4,4-3,OAK,10,0,40,37,77,147,156,303,11,9,20,3,3:16
3742,414908,2015-07-07,2015,SEA,DET,7,6,7-6,SEA,11,0,48,43,91,170,181,351,19,13,32,2,3:44
3743,414917,2015-07-07,2015,CHA,TOR,1,2,2-1,TOR,9,0,36,31,67,129,125,254,9,6,15,2,2:33
3744,414915,2015-07-07,2015,CHN,SLN,5,3,5-3,CHN,9,1,35,39,74,147,146,293,10,12,22,4,3:02
3745,414904,2015-07-07,2015,TEX,ARI,2,4,4-2,ARI,9,0,33,44,77,175,106,281,5,19,24,4,3:03
3746,414928,2015-07-08,2015,LAN,PHI,5,0,5-0,LAN,9,1,37,36,73,123,155,278,12,9,21,0,2:41
3747,414931,2015-07-08,2015,KCA,TBA,9,7,9-7,KCA,9,1,38,42,80,146,126,272,15,18,33,2,2:52
3748,414921,2015-07-08,2015,MIN,BAL,5,3,5-3,MIN,9,1,39,35,74,132,183,315,17,9,26,0,2:59
3749,414919,2015-07-08,2015,TEX,ARI,4,7,7-4,ARI,9,0,42,39,81,143,158,301,15,14,29,5,3:26
3750,414923,2015-07-08,2015,SEA,DET,4,5,5-4,DET,9,0,42,38,80,169,160,329,14,15,29,3,3:28
3751,414927,2015-07-08,2015,NYA,OAK,5,4,5-4,NYA,9,1,36,39,75,157,144,301,14,12,26,4,3:09
3752,414932,2015-07-08,2015,CHA,TOR,7,6,7-6,CHA,11,0,46,46,92,186,168,354,20,16,36,2,3:51
3753,414918,2015-07-08,2015,COL,ANA,2,3,3-2,ANA,9,0,42,38,80,161,148,309,18,14,32,2,3:27 (2:07 delay)
3754,414930,2015-07-08,2015,CHN,SLN,5,6,6-5,SLN,9,0,37,40,77,167,163,330,11,14,25,1,3:11
3755,414925,2015-07-08,2015,BOS,MIA,6,3,6-3,BOS,9,1,32,37,69,138,131,269,7,11,18,0,2:41
3756,414926,2015-07-08,2015,SFN,NYN,1,4,4-1,NYN,9,0,34,37,71,115,115,230,6,10,16,1,2:28
3757,414924,2015-07-08,2015,CLE,HOU,4,2,4-2,CLE,9,1,33,33,66,118,127,245,9,6,15,2,2:39
3758,414920,2015-07-08,2015,MIL,ATL,6,5,6-5,MIL,9,1,33,38,71,140,145,285,9,13,22,2,3:00
3759,414929,2015-07-08,2015,PIT,SDN,5,2,5-2,PIT,9,1,32,37,69,155,119,274,8,11,19,2,2:48
3760,414939,2015-07-09,2015,LAN,PHI,6,0,6-0,LAN,9,1,36,29,65,111,123,234,12,2,14,2,2:14
3761,414938,2015-07-09,2015,NYA,OAK,6,2,6-2,NYA,9,1,38,32,70,137,145,282,13,4,17,2,2:55
3762,414941,2015-07-09,2015,KCA,TBA,8,3,8-3,KCA,9,1,37,38,75,154,149,303,14,11,25,0,2:57
3763,414934,2015-07-09,2015,COL,ATL,5,3,5-3,COL,9,1,40,37,77,131,138,269,19,11,30,3,3:13 (2:06 delay)
3764,414933,2015-07-09,2015,SEA,ANA,7,2,7-2,SEA,9,1,42,38,80,147,145,292,21,12,33,4,3:14
3765,414942,2015-07-09,2015,CHA,TOR,2,0,2-0,CHA,9,1,31,30,61,108,133,241,7,5,12,0,2:15
3766,414937,2015-07-09,2015,CLE,HOU,3,1,3-1,CLE,9,1,34,32,66,123,134,257,12,7,19,3,2:49
3767,414936,2015-07-09,2015,MIN,DET,2,4,4-2,DET,9,0,37,33,70,126,130,256,9,9,18,2,3:01
3768,414935,2015-07-09,2015,MIA,CIN,2,0,2-0,MIA,9,1,32,32,64,128,120,248,11,7,18,0,2:31
3769,414940,2015-07-09,2015,PIT,SLN,1,4,4-1,SLN,9,0,33,37,70,135,142,277,8,11,19,3,2:52 (:36 delay)
3770,414952,2015-07-10,2015,CLE,OAK,5,1,5-1,CLE,9,1,39,33,72,115,157,272,14,7,21,2,2:57
3771,414956,2015-07-10,2015,KCA,TOR,3,0,3-0,KCA,9,1,36,35,71,147,131,278,12,10,22,1,2:55 (2:07 delay)
3772,414946,2015-07-10,2015,CHN,CHA,0,1,1-0,CHA,9,0,32,33,65,113,152,265,10,7,17,0,2:40
3773,414945,2015-07-10,2015,COL,ATL,5,3,5-3,COL,9,1,37,35,72,118,140,258,15,11,26,2,2:47
3774,414943,2015-07-10,2015,SEA,ANA,3,7,7-3,ANA,9,0,36,42,78,158,139,297,10,15,25,2,2:49
3775,414948,2015-07-10,2015,MIN,DET,8,6,8-6,MIN,9,0,37,41,78,149,150,299,13,15,28,2,3:22
3776,414947,2015-07-10,2015,MIA,CIN,0,1,1-0,CIN,9,0,32,35,67,120,119,239,5,9,14,0,2:21
3777,414957,2015-07-10,2015,BAL,WAS,3,2,3-2,BAL,9,0,36,35,71,149,147,296,12,11,23,2,3:12
3778,414953,2015-07-10,2015,SFN,PHI,15,2,15-2,SFN,9,1,49,39,88,135,201,336,26,14,40,2,3:23
3779,414950,2015-07-10,2015,LAN,MIL,3,2,3-2,LAN,9,1,33,34,67,122,110,232,9,8,17,0,2:35
3780,414949,2015-07-10,2015,TBA,HOU,3,1,3-1,TBA,9,1,29,31,60,119,108,227,6,6,12,2,2:19
3781,414955,2015-07-10,2015,PIT,SLN,5,2,5-2,PIT,9,1,35,35,70,148,148,296,13,9,22,0,3:01
3782,414954,2015-07-10,2015,TEX,SDN,4,3,4-3,TEX,9,1,33,39,72,165,145,310,9,13,22,3,3:05
3783,414944,2015-07-10,2015,NYN,ARI,4,2,4-2,NYN,9,1,36,35,71,137,169,306,14,8,22,2,3:02
3784,414951,2015-07-10,2015,BOS,NYA,1,5,5-1,NYA,9,0,35,41,76,156,126,282,8,12,20,3,3:03
3785,414964,2015-07-11,2015,TBA,HOU,3,0,3-0,TBA,9,1,33,35,68,143,118,261,10,8,18,2,2:41
3786,414971,2015-07-11,2015,KCA,TOR,2,6,6-2,TOR,9,0,33,43,76,167,110,277,6,16,22,2,2:42
3787,414967,2015-07-11,2015,CLE,OAK,4,5,5-4,OAK,9,0,37,37,74,145,145,290,11,12,23,6,3:08
3788,414966,2015-07-11,2015,BOS,NYA,5,3,5-3,BOS,9,1,36,34,70,144,139,283,13,10,23,4,3:10
3789,414969,2015-07-11,2015,TEX,SDN,5,6,6-5,SDN,9,0,38,40,78,135,163,298,13,13,26,3,3:11
3790,414960,2015-07-11,2015,COL,ATL,3,2,3-2,COL,9,0,40,38,78,148,146,294,18,12,30,5,3:26
3791,414959,2015-07-11,2015,NYN,ARI,4,2,4-2,NYN,9,1,30,34,64,130,109,239,6,10,16,2,2:25
3792,414972,2015-07-11,2015,BAL,WAS,4,7,7-4,WAS,9,0,39,38,77,125,159,284,14,14,28,2,3:05
3793,414968,2015-07-11,2015,SFN,PHI,8,5,8-5,SFN,9,1,41,38,79,150,146,296,18,12,30,5,3:17
3794,414961,2015-07-11,2015,CHN,CHA,1,5,5-1,CHA,9,0,35,36,71,141,144,285,8,10,18,2,2:45
3795,414958,2015-07-11,2015,SEA,ANA,5,0,5-0,SEA,9,1,39,33,72,119,137,256,16,6,22,2,2:42
3796,414965,2015-07-11,2015,LAN,MIL,1,7,7-1,MIL,9,0,29,42,71,157,100,257,5,19,24,1,2:56
3797,414963,2015-07-11,2015,MIN,DET,9,5,9-5,MIN,9,1,40,39,79,143,152,295,19,13,32,5,3:27
3798,414970,2015-07-11,2015,PIT,SLN,6,5,6-5,PIT,14,0,57,59,116,221,211,432,19,20,39,5,5:04
3799,414962,2015-07-11,2015,MIA,CIN,14,3,14-3,MIA,9,1,45,37,82,134,158,292,23,11,34,2,2:54
3800,414976,2015-07-12,2015,CHN,CHA,3,1,3-1,CHN,9,1,32,29,61,106,107,213,10,2,12,1,2:18
3801,414987,2015-07-12,2015,BAL,WAS,2,3,3-2,WAS,9,0,31,35,66,124,119,243,4,9,13,1,2:21
3802,414982,2015-07-12,2015,CLE,OAK,0,2,2-0,OAK,9,0,29,32,61,125,107,232,3,7,10,0,2:25
3803,414983,2015-07-12,2015,SFN,PHI,4,2,4-2,SFN,9,1,32,32,64,116,122,238,11,9,20,2,2:23
3804,414978,2015-07-12,2015,MIN,DET,7,1,7-1,MIN,9,1,35,33,68,123,136,259,12,8,20,2,2:44
3805,414975,2015-07-12,2015,COL,ATL,11,3,11-3,COL,9,1,42,41,83,148,149,297,20,16,36,1,3:08
3806,414973,2015-07-12,2015,SEA,ANA,3,10,10-3,ANA,9,0,36,44,80,167,137,304,10,16,26,2,2:56
3807,414986,2015-07-12,2015,KCA,TOR,11,10,11-10,KCA,9,1,39,42,81,175,133,308,16,16,32,3,3:23
3808,414974,2015-07-12,2015,NYN,ARI,5,3,5-3,NYN,9,1,39,34,73,121,159,280,16,7,23,2,2:44
3809,414985,2015-07-12,2015,PIT,SLN,6,5,6-5,PIT,10,0,44,44,88,160,164,324,17,16,33,3,3:42
3810,414979,2015-07-12,2015,TBA,HOU,4,3,4-3,TBA,9,1,30,38,68,154,114,268,8,11,19,1,2:41
3811,414977,2015-07-12,2015,MIA,CIN,8,1,8-1,MIA,9,1,36,37,73,139,116,255,11,9,20,0,2:27
3812,414980,2015-07-12,2015,LAN,MIL,4,3,4-3,LAN,9,1,34,34,68,109,163,272,10,8,18,3,2:42
3813,414981,2015-07-12,2015,BOS,NYA,6,8,8-6,NYA,9,0,43,38,81,145,183,328,14,12,26,5,3:36
3814,414984,2015-07-12,2015,TEX,SDN,1,2,2-1,SDN,9,0,35,39,74,145,154,299,10,12,22,3,3:13
3815,414988,2015-07-14,2015,NAS,AAS,3,6,6-3,AAS,9,0,36,39,75,158,130,288,8,11,19,1,3:02
3816,413905,2015-07-17,2015,CHA,KCA,2,4,4-2,KCA,9,0,36,35,71,134,137,271,12,11,23,0,2:44
3817,414996,2015-07-17,2015,PHI,MIA,6,3,6-3,PHI,9,1,33,36,69,130,99,229,9,12,21,3,2:26
3818,414997,2015-07-17,2015,OAK,MIN,0,5,5-0,MIN,9,0,34,38,72,149,125,274,6,11,17,1,2:42
3819,414994,2015-07-17,2015,CHA,KCA,2,0,2-0,CHA,9,1,34,34,68,132,135,267,12,8,20,3,3:08
3820,413905,2015-07-17,2015,CHA,KCA,2,4,4-2,KCA,9,0,36,35,71,134,137,271,12,11,23,0,2:44
3821,414998,2015-07-17,2015,SLN,NYN,3,2,3-2,SLN,9,1,33,35,68,161,125,286,9,8,17,2,3:01
3822,414995,2015-07-17,2015,WAS,LAN,5,3,5-3,WAS,9,1,37,37,74,126,140,266,14,9,23,2,2:51 (2:02 delay)
3823,414989,2015-07-17,2015,DET,BAL,7,3,7-3,DET,9,1,35,41,76,162,127,289,11,14,25,3,2:55
3824,414993,2015-07-17,2015,SDN,COL,4,2,4-2,SDN,9,1,32,37,69,158,151,309,9,14,23,0,3:13
3825,415001,2015-07-17,2015,ARI,SFN,5,6,6-5,SFN,12,0,52,57,109,234,204,438,17,21,38,7,5:11
3826,414990,2015-07-17,2015,ANA,BOS,1,0,1-0,ANA,9,0,30,34,64,121,124,245,4,8,12,1,2:24
3827,414992,2015-07-17,2015,CIN,CLE,6,1,6-1,CIN,9,1,39,36,75,145,150,295,15,8,23,1,2:58 (1:05 delay)
3828,415002,2015-07-17,2015,TOR,TBA,6,2,6-2,TOR,9,1,35,35,70,122,133,255,12,9,21,1,2:35
3829,414999,2015-07-17,2015,MIL,PIT,4,1,4-1,MIL,9,1,39,33,72,114,133,247,16,7,23,1,2:51
3830,415003,2015-07-17,2015,HOU,TEX,3,2,3-2,HOU,9,1,33,39,72,147,137,284,13,15,28,0,3:11
3831,414991,2015-07-17,2015,ATL,CHN,4,2,4-2,ATL,9,1,36,34,70,143,146,289,13,10,23,2,3:04
3832,415000,2015-07-17,2015,NYA,SEA,4,3,4-3,NYA,9,1,37,35,72,130,138,268,13,8,21,2,2:43
3833,414995,2015-07-17,2015,WAS,LAN,5,3,5-3,WAS,9,1,37,37,74,126,140,266,14,9,23,2,2:51 (2:02 delay)
3834,415004,2015-07-18,2015,DET,BAL,0,3,3-0,BAL,9,0,29,38,67,143,119,262,2,11,13,1,2:57
3835,415017,2015-07-18,2015,TOR,TBA,2,3,3-2,TBA,9,0,35,34,69,137,126,263,8,9,17,2,2:38
3836,415011,2015-07-18,2015,PHI,MIA,3,1,3-1,PHI,9,1,32,36,68,138,119,257,7,11,18,1,2:39
3837,415010,2015-07-18,2015,WAS,LAN,2,4,4-2,LAN,9,0,32,43,75,154,119,273,5,19,24,0,2:43
3838,415018,2015-07-18,2015,HOU,TEX,6,7,7-6,TEX,9,0,37,43,80,159,142,301,9,16,25,4,3:28
3839,415006,2015-07-18,2015,ATL,CHN,0,4,4-0,CHN,9,0,32,40,72,158,138,296,5,13,18,3,3:06
3840,415008,2015-07-18,2015,SDN,COL,5,4,5-4,SDN,9,1,32,35,67,153,110,263,9,10,19,2,2:39
3841,415016,2015-07-18,2015,ARI,SFN,4,8,8-4,SFN,9,0,38,45,83,183,142,325,12,20,32,5,3:38
3842,415013,2015-07-18,2015,SLN,NYN,12,2,12-2,SLN,9,1,45,40,85,130,164,294,21,15,36,2,3:01
3843,415009,2015-07-18,2015,CHA,KCA,6,7,7-6,KCA,13,0,57,61,118,235,220,455,19,26,45,3,4:56
3844,415005,2015-07-18,2015,ANA,BOS,3,0,3-0,ANA,9,1,33,30,63,113,136,249,9,3,12,0,2:37
3845,415007,2015-07-18,2015,CIN,CLE,4,9,9-4,CLE,9,0,36,43,79,140,137,277,10,16,26,2,3:04
3846,415012,2015-07-18,2015,OAK,MIN,3,2,3-2,OAK,10,0,38,35,73,145,153,298,14,8,22,2,3:00
3847,415015,2015-07-18,2015,NYA,SEA,3,4,4-3,SEA,9,0,35,36,71,165,134,299,7,10,17,3,3:12
3848,415014,2015-07-18,2015,MIL,PIT,8,5,8-5,MIL,9,1,42,39,81,141,161,302,20,12,32,1,3:24
3849,415033,2015-07-19,2015,HOU,TEX,10,0,10-0,HOU,9,1,44,30,74,118,173,291,20,3,23,1,2:56
3850,415025,2015-07-19,2015,WAS,LAN,0,5,5-0,LAN,9,0,31,45,76,187,130,317,6,19,25,2,3:14
3851,415030,2015-07-19,2015,NYA,SEA,2,1,2-1,NYA,9,1,32,36,68,135,125,260,9,10,19,1,2:45
3852,415029,2015-07-19,2015,MIL,PIT,6,1,6-1,MIL,9,1,35,35,70,140,112,252,13,10,23,3,2:56
3853,415024,2015-07-19,2015,CHA,KCA,1,4,4-1,KCA,9,0,32,37,69,133,125,258,7,14,21,2,2:45
3854,415026,2015-07-19,2015,PHI,MIA,8,7,8-7,PHI,9,0,36,42,78,170,126,296,13,16,29,1,3:15
3855,415019,2015-07-19,2015,DET,BAL,3,9,9-3,BAL,9,0,43,41,84,167,168,335,17,18,35,1,3:30
3856,415031,2015-07-19,2015,ARI,SFN,1,2,2-1,SFN,9,0,37,35,72,140,141,281,10,8,18,1,3:05
3857,415032,2015-07-19,2015,TOR,TBA,4,0,4-0,TOR,9,1,32,29,61,125,133,258,8,4,12,1,2:30
3858,415021,2015-07-19,2015,ATL,CHN,1,4,4-1,CHN,9,0,36,42,78,157,151,308,9,16,25,1,3:18
3859,415027,2015-07-19,2015,OAK,MIN,14,1,14-1,OAK,9,1,42,36,78,141,148,289,15,9,24,1,2:49
3860,415028,2015-07-19,2015,SLN,NYN,1,3,3-1,NYN,18,0,69,82,151,319,239,558,21,32,53,3,5:55
3861,415022,2015-07-19,2015,CIN,CLE,3,5,5-3,CLE,11,0,44,56,100,237,146,383,13,23,36,4,4:11 (:47 delay)
3862,415038,2015-07-20,2015,WAS,NYN,7,2,7-2,WAS,9,1,35,39,74,153,114,267,10,13,23,0,2:50
3863,415034,2015-07-20,2015,ANA,BOS,7,3,7-3,ANA,9,1,36,35,71,133,140,273,12,8,20,1,2:34
3864,415037,2015-07-20,2015,ARI,MIA,3,1,3-1,ARI,9,1,34,36,70,143,126,269,13,13,26,2,2:58
3865,415041,2015-07-20,2015,SDN,SFN,4,2,4-2,SDN,9,1,37,36,73,137,164,301,15,9,24,1,3:13
3866,415036,2015-07-20,2015,ATL,LAN,7,5,7-5,ATL,9,1,38,39,77,139,151,290,16,14,30,1,3:01
3867,415020,2015-07-20,2015,ANA,BOS,11,1,11-1,ANA,9,1,40,37,77,165,138,303,17,11,28,2,3:05
3868,415043,2015-07-20,2015,COL,TEX,8,7,8-7,COL,9,0,42,41,83,139,168,307,17,14,31,3,3:31
3869,415039,2015-07-20,2015,KCA,PIT,7,10,10-7,PIT,9,0,42,45,87,170,140,310,19,18,37,4,3:31
3870,415040,2015-07-20,2015,DET,SEA,5,4,5-4,DET,9,1,30,39,69,145,106,251,8,12,20,1,2:54
3871,415035,2015-07-20,2015,CIN,CHN,5,4,5-4,CIN,9,1,33,40,73,171,137,308,11,14,25,2,3:09
3872,415042,2015-07-20,2015,PHI,TBA,5,3,5-3,PHI,9,1,32,36,68,132,121,253,13,9,22,3,2:44
3873,415020,2015-07-20,2015,ANA,BOS,11,1,11-1,ANA,9,1,40,37,77,165,138,303,17,11,28,2,3:05
3874,415050,2015-07-21,2015,ANA,MIN,7,0,7-0,ANA,9,1,37,31,68,124,137,261,15,5,20,1,2:52
3875,415052,2015-07-21,2015,KCA,PIT,3,1,3-1,KCA,9,1,30,37,67,150,120,270,7,11,18,3,3:02
3876,415049,2015-07-21,2015,ARI,MIA,0,3,3-0,MIA,9,0,33,37,70,145,106,251,6,11,17,2,2:55
3877,415045,2015-07-21,2015,HOU,BOS,8,3,8-3,HOU,9,1,38,33,71,127,163,290,15,8,23,1,3:01
3878,415054,2015-07-21,2015,SDN,SFN,3,9,9-3,SFN,9,0,33,37,70,143,150,293,7,13,20,3,2:50
3879,415047,2015-07-21,2015,MIL,CLE,8,1,8-1,MIL,9,1,38,35,73,136,141,277,14,12,26,4,2:58
3880,415051,2015-07-21,2015,WAS,NYN,2,7,7-2,NYN,9,0,32,42,74,151,127,278,6,15,21,3,2:54
3881,415044,2015-07-21,2015,NYA,BAL,3,2,3-2,NYA,9,1,37,35,72,139,134,273,14,10,24,3,2:48 (:15 delay)
3882,415058,2015-07-21,2015,OAK,TOR,1,7,7-1,TOR,9,0,35,41,76,165,123,288,9,15,24,2,2:38
3883,415048,2015-07-21,2015,ATL,LAN,4,3,4-3,ATL,9,1,37,36,73,139,158,297,14,10,24,3,3:20
3884,415057,2015-07-21,2015,COL,TEX,0,9,9-0,TEX,9,0,34,47,81,154,137,291,10,20,30,2,3:06
3885,415055,2015-07-21,2015,CHA,SLN,5,8,8-5,SLN,9,0,39,44,83,164,165,329,12,18,30,1,3:06
3886,415046,2015-07-21,2015,CIN,CHN,4,5,5-4,CHN,13,0,54,58,112,246,209,455,16,19,35,2,4:51
3887,415056,2015-07-21,2015,PHI,TBA,0,1,1-0,TBA,9,0,33,35,68,133,137,270,8,8,16,2,2:52
3888,415053,2015-07-21,2015,DET,SEA,9,11,11-9,SEA,9,0,44,48,92,175,184,359,18,23,41,7,3:55
3889,413902,2015-07-22,2015,CIN,CHN,5,6,6-5,CHN,9,0,44,43,87,164,180,344,21,19,40,2,3:39
3890,415067,2015-07-22,2015,KCA,PIT,5,1,5-1,KCA,9,1,35,35,70,112,119,231,12,9,21,2,2:39
3891,415060,2015-07-22,2015,HOU,BOS,4,2,4-2,HOU,9,1,33,36,69,123,129,252,10,10,20,1,2:44
3892,415063,2015-07-22,2015,ATL,LAN,1,3,3-1,LAN,9,0,32,36,68,139,125,264,5,11,16,1,2:49
3893,415061,2015-07-22,2015,CIN,CHN,9,1,9-1,CIN,9,1,41,33,74,137,156,293,17,7,24,0,2:42
3894,415065,2015-07-22,2015,ANA,MIN,5,2,5-2,ANA,9,1,36,41,77,169,109,278,16,14,30,0,3:03
3895,415070,2015-07-22,2015,CHA,SLN,2,3,3-2,SLN,9,0,36,37,73,139,158,297,9,10,19,3,3:02
3896,415066,2015-07-22,2015,WAS,NYN,4,3,4-3,WAS,9,1,40,34,74,132,159,291,18,7,25,0,3:02
3897,415068,2015-07-22,2015,DET,SEA,9,4,9-4,DET,9,1,41,39,80,159,159,318,19,15,34,4,3:10
3898,415064,2015-07-22,2015,ARI,MIA,3,5,5-3,MIA,9,0,41,37,78,165,148,313,14,11,25,4,3:16
3899,415069,2015-07-22,2015,SDN,SFN,1,7,7-1,SFN,9,0,35,43,78,181,152,333,9,18,27,3,3:20
3900,415062,2015-07-22,2015,MIL,CLE,5,7,7-5,CLE,9,0,42,43,85,171,159,330,18,22,40,2,3:27
3901,415072,2015-07-22,2015,COL,TEX,8,10,10-8,TEX,9,0,42,45,87,185,152,337,16,20,36,4,3:45
3902,413902,2015-07-22,2015,CIN,CHN,5,6,6-5,CHN,9,0,44,43,87,164,180,344,21,19,40,2,3:39
3903,415071,2015-07-22,2015,PHI,TBA,5,4,5-4,PHI,10,0,45,46,91,167,163,330,15,19,34,2,3:43
3904,415059,2015-07-22,2015,NYA,BAL,4,3,4-3,NYA,9,1,33,33,66,129,123,252,9,7,16,0,2:33
3905,415073,2015-07-22,2015,OAK,TOR,4,3,4-3,OAK,10,0,43,44,87,164,185,349,16,17,33,3,3:49
3906,414589,2015-07-23,2015,SLN,KCA,4,3,4-3,SLN,9,1,34,38,72,149,143,292,11,13,24,1,2:56
3907,415077,2015-07-23,2015,NYN,LAN,0,3,3-0,LAN,9,0,29,34,63,112,104,216,3,10,13,1,2:27
3908,415080,2015-07-23,2015,ANA,MIN,0,3,3-0,MIN,9,0,32,33,65,114,105,219,5,9,14,0,2:16
3909,415082,2015-07-23,2015,OAK,TOR,2,5,5-2,TOR,9,0,33,36,69,130,106,236,7,9,16,3,2:34
3910,415074,2015-07-23,2015,NYA,BAL,9,3,9-3,NYA,9,1,39,32,71,118,146,264,16,5,21,3,2:40
3911,415076,2015-07-23,2015,CLE,CHA,1,8,8-1,CHA,9,0,32,38,70,135,120,255,5,12,17,1,2:28
3912,415078,2015-07-23,2015,SDN,MIA,0,4,4-0,MIA,9,0,33,37,70,142,135,277,8,11,19,1,2:46
3913,415079,2015-07-23,2015,ARI,MIL,8,3,8-3,ARI,9,1,41,33,74,143,154,297,18,8,26,0,3:12
3914,414589,2015-07-23,2015,SLN,KCA,4,3,4-3,SLN,9,1,34,38,72,149,143,292,11,13,24,1,2:56
3915,415083,2015-07-23,2015,PIT,WAS,7,3,7-3,PIT,9,1,38,37,75,156,154,310,14,11,25,1,2:52
3916,415075,2015-07-23,2015,HOU,BOS,5,4,5-4,HOU,9,0,37,40,77,156,159,315,15,13,28,3,3:31
3917,415081,2015-07-23,2015,DET,SEA,2,3,3-2,SEA,12,0,48,48,96,192,189,381,18,14,32,4,4:33
3918,415096,2015-07-24,2015,ANA,TEX,2,4,4-2,TEX,9,0,34,35,69,121,127,248,7,9,16,3,2:39
3919,415091,2015-07-24,2015,SDN,MIA,3,1,3-1,SDN,9,1,32,37,69,145,117,262,9,10,19,0,2:36
3920,415089,2015-07-24,2015,KCA,HOU,0,4,4-0,HOU,9,0,32,38,70,132,120,252,6,13,19,1,2:38
3921,415084,2015-07-24,2015,SLN,ATL,4,2,4-2,SLN,9,1,36,33,69,109,144,253,14,7,21,3,2:55
3922,415097,2015-07-24,2015,SEA,TOR,5,2,5-2,SEA,9,1,36,35,71,130,151,281,14,8,22,1,2:49
3923,415086,2015-07-24,2015,CLE,CHA,0,6,6-0,CHA,9,0,31,39,70,134,120,254,7,13,20,2,2:43
3924,415090,2015-07-24,2015,NYN,LAN,2,7,7-2,LAN,9,0,32,39,71,132,143,275,7,14,21,1,2:40
3925,415092,2015-07-24,2015,ARI,MIL,1,2,2-1,MIL,9,0,35,37,72,124,130,254,12,10,22,2,2:56
3926,415093,2015-07-24,2015,MIN,NYA,10,1,10-1,MIN,9,1,38,38,76,136,144,280,14,11,25,1,2:57
3927,415085,2015-07-24,2015,TBA,BAL,3,1,3-1,TBA,9,1,32,36,68,164,120,284,11,10,21,1,2:55
3928,415087,2015-07-24,2015,COL,CIN,6,5,6-5,COL,9,0,38,40,78,148,130,278,13,18,31,1,3:05
3929,415098,2015-07-24,2015,PIT,WAS,7,5,7-5,PIT,9,1,36,38,74,144,152,296,13,11,24,0,2:57
3930,415088,2015-07-24,2015,BOS,DET,2,1,2-1,BOS,11,0,39,39,78,175,146,321,10,8,18,0,3:42
3931,415094,2015-07-24,2015,SFN,OAK,9,3,9-3,SFN,9,1,43,34,77,143,174,317,19,8,27,5,3:25
3932,415095,2015-07-24,2015,CHN,PHI,3,5,5-3,PHI,10,0,43,41,84,140,163,303,14,13,27,1,3:13
3933,415099,2015-07-25,2015,SLN,ATL,1,0,1-0,SLN,9,1,28,31,59,102,109,211,5,9,14,2,2:13
3934,415100,2015-07-25,2015,TBA,BAL,1,5,5-1,BAL,9,0,32,34,66,108,127,235,5,7,12,2,2:21
3935,415109,2015-07-25,2015,SFN,OAK,2,1,2-1,SFN,9,1,29,37,66,131,133,264,7,10,17,0,2:41
3936,415110,2015-07-25,2015,CHN,PHI,0,5,5-0,PHI,9,0,29,42,71,142,129,271,2,15,17,0,2:38
3937,415107,2015-07-25,2015,ARI,MIL,2,0,2-0,ARI,9,1,31,37,68,131,132,263,9,9,18,0,2:55
3938,415106,2015-07-25,2015,SDN,MIA,3,1,3-1,SDN,9,1,34,35,69,137,130,267,10,9,19,3,2:51
3939,415103,2015-07-25,2015,BOS,DET,1,5,5-1,DET,9,0,33,38,71,137,128,265,9,12,21,2,2:57
3940,415104,2015-07-25,2015,KCA,HOU,2,1,2-1,KCA,10,0,37,34,71,142,131,273,10,6,16,2,3:03
3941,415108,2015-07-25,2015,MIN,NYA,5,8,8-5,NYA,9,0,39,37,76,125,135,260,12,11,23,3,2:54
3942,415102,2015-07-25,2015,COL,CIN,2,5,5-2,CIN,9,0,34,37,71,142,118,260,8,12,20,1,2:47
3943,415113,2015-07-25,2015,PIT,WAS,3,9,9-3,WAS,9,0,35,45,80,141,124,265,8,18,26,3,3:01
3944,415101,2015-07-25,2015,CLE,CHA,3,10,10-3,CHA,9,0,35,44,79,170,131,301,8,18,26,2,2:54
3945,415112,2015-07-25,2015,SEA,TOR,6,8,8-6,TOR,9,0,41,43,84,183,149,332,13,19,32,3,3:29
3946,415105,2015-07-25,2015,NYN,LAN,15,2,15-2,NYN,9,1,50,34,84,130,204,334,28,8,36,3,3:12
3947,415111,2015-07-25,2015,ANA,TEX,6,7,7-6,TEX,9,0,41,42,83,161,163,324,16,14,30,3,3:32
3948,415128,2015-07-26,2015,PIT,WAS,3,1,3-1,PIT,9,1,30,33,63,115,95,210,7,8,15,1,2:18
3949,415121,2015-07-26,2015,SDN,MIA,3,2,3-2,SDN,9,1,32,34,66,137,116,253,8,7,15,0,2:32
3950,415119,2015-07-26,2015,KCA,HOU,5,1,5-1,KCA,9,1,33,34,67,115,127,242,11,7,18,1,2:38
3951,415123,2015-07-26,2015,MIN,NYA,2,7,7-2,NYA,9,0,35,39,74,161,118,279,11,12,23,3,3:00
3952,415122,2015-07-26,2015,ARI,MIL,3,0,3-0,ARI,9,1,37,36,73,131,149,280,14,10,24,1,3:20
3953,415115,2015-07-26,2015,TBA,BAL,2,5,5-2,BAL,9,0,37,38,75,144,136,280,13,14,27,1,2:43
3954,415116,2015-07-26,2015,CLE,CHA,1,2,2-1,CHA,9,0,34,38,72,146,147,293,8,13,21,4,2:52
3955,415124,2015-07-26,2015,SFN,OAK,4,3,4-3,SFN,9,1,37,35,72,144,142,286,14,9,23,2,3:04
3956,415114,2015-07-26,2015,SLN,ATL,2,3,3-2,ATL,9,0,38,39,77,155,133,288,13,12,25,1,3:02
3957,415118,2015-07-26,2015,BOS,DET,11,1,11-1,BOS,9,1,46,33,79,128,164,292,23,6,29,1,3:14
3958,415120,2015-07-26,2015,NYN,LAN,3,2,3-2,NYN,10,0,40,38,78,160,156,316,15,8,23,3,3:27
3959,415125,2015-07-26,2015,CHN,PHI,5,11,11-5,PHI,9,0,34,46,80,191,124,315,9,20,29,2,3:01
3960,415127,2015-07-26,2015,SEA,TOR,6,5,6-5,SEA,10,0,41,41,82,165,159,324,15,14,29,1,3:05
3961,415117,2015-07-26,2015,COL,CIN,17,7,17-7,COL,9,1,46,45,91,170,181,351,21,19,40,2,3:30
3962,415126,2015-07-26,2015,ANA,TEX,13,7,13-7,ANA,9,1,45,43,88,158,187,345,19,16,35,5,3:33
3963,415136,2015-07-27,2015,SFN,MIL,4,2,4-2,SFN,9,1,33,33,66,121,120,241,9,10,19,1,2:37
3964,415132,2015-07-27,2015,SLN,CIN,4,1,4-1,SLN,9,1,35,36,71,136,128,264,12,10,22,0,2:38
3965,415134,2015-07-27,2015,TBA,DET,5,2,5-2,TBA,9,1,37,34,71,137,162,299,15,7,22,3,3:06
3966,415135,2015-07-27,2015,CLE,KCA,4,9,9-4,KCA,9,0,39,42,81,130,146,276,14,15,29,3,2:59
3967,415137,2015-07-27,2015,TEX,NYA,2,6,6-2,NYA,9,0,38,39,77,152,144,296,11,14,25,1,3:01
3968,415130,2015-07-27,2015,BAL,ATL,2,1,2-1,BAL,11,0,41,42,83,165,164,329,13,10,23,2,3:20
3969,415129,2015-07-27,2015,SEA,ARI,3,4,4-3,ARI,10,0,41,44,85,175,161,336,15,12,27,3,3:27
3970,415133,2015-07-27,2015,CHN,COL,9,8,9-8,CHN,9,0,39,42,81,190,134,324,14,16,30,3,3:35
3971,415131,2015-07-27,2015,BOS,CHA,8,10,10-8,CHA,9,0,44,46,90,175,174,349,16,22,38,4,3:54
3972,415148,2015-07-28,2015,LAN,OAK,0,2,2-0,OAK,9,0,30,33,63,117,110,227,4,7,11,0,2:22
3973,415151,2015-07-28,2015,NYN,SDN,4,0,4-0,NYN,9,1,31,30,61,119,115,234,8,4,12,1,2:20
3974,415142,2015-07-28,2015,SLN,CIN,0,4,4-0,CIN,9,0,32,34,66,116,105,221,5,9,14,1,2:22
3975,415149,2015-07-28,2015,TOR,PHI,2,3,3-2,PHI,9,0,34,32,66,124,119,243,8,8,16,1,2:29
3976,415145,2015-07-28,2015,CLE,KCA,1,2,2-1,KCA,9,0,36,32,68,112,136,248,12,7,19,1,2:40
3977,415146,2015-07-28,2015,SFN,MIL,2,5,5-2,MIL,9,0,34,36,70,128,124,252,9,9,18,2,2:38
3978,415152,2015-07-28,2015,MIA,WAS,4,1,4-1,MIA,9,1,36,38,74,149,110,259,18,14,32,1,2:42
3979,415144,2015-07-28,2015,TBA,DET,10,2,10-2,TBA,9,1,37,36,73,150,155,305,14,10,24,1,3:09
3980,415139,2015-07-28,2015,SEA,ARI,4,8,8-4,ARI,9,0,36,41,77,158,134,292,12,16,28,2,3:00
3981,415141,2015-07-28,2015,BOS,CHA,4,9,9-4,CHA,9,0,35,45,80,154,125,279,9,20,29,2,2:39
3982,415140,2015-07-28,2015,BAL,ATL,7,3,7-3,BAL,9,1,39,39,78,135,153,288,14,12,26,2,2:53
3983,415143,2015-07-28,2015,CHN,COL,2,7,7-2,COL,9,0,36,41,77,149,145,294,11,16,27,3,3:11
3984,415138,2015-07-28,2015,HOU,ANA,10,5,10-5,HOU,9,1,40,40,80,136,165,301,20,13,33,2,3:19
3985,415150,2015-07-28,2015,MIN,PIT,7,8,8-7,PIT,9,0,41,44,85,162,147,309,17,15,32,6,3:24
3986,415147,2015-07-28,2015,TEX,NYA,5,21,21-5,NYA,9,0,36,60,96,244,146,390,9,31,40,3,3:38
3987,415155,2015-07-29,2015,BAL,ATL,2,0,2-0,BAL,9,1,30,30,60,100,125,225,8,4,12,1,2:15 (:33 delay)
3988,415157,2015-07-29,2015,SLN,CIN,0,1,1-0,CIN,9,0,33,31,64,102,129,231,8,4,12,0,2:18
3989,415158,2015-07-29,2015,CHN,COL,3,2,3-2,CHN,9,1,32,32,64,132,130,262,11,7,18,0,2:37
3990,415159,2015-07-29,2015,TBA,DET,1,2,2-1,DET,9,0,31,33,64,135,126,261,5,6,11,0,2:39
3991,415153,2015-07-29,2015,HOU,ANA,6,3,6-3,HOU,9,1,36,36,72,133,128,261,14,9,23,1,2:50
3992,415164,2015-07-29,2015,TOR,PHI,8,2,8-2,TOR,9,1,40,35,75,112,146,258,17,8,25,1,2:37
3993,415160,2015-07-29,2015,CLE,KCA,12,1,12-1,CLE,9,1,47,33,80,112,166,278,23,6,29,1,2:55
3994,415154,2015-07-29,2015,SEA,ARI,2,8,8-2,ARI,9,0,36,42,78,143,138,281,9,17,26,1,2:59
3995,415162,2015-07-29,2015,TEX,NYA,5,2,5-2,TEX,9,1,38,34,72,143,154,297,15,9,24,1,3:09
3996,415161,2015-07-29,2015,SFN,MIL,5,0,5-0,SFN,9,1,34,33,67,135,151,286,11,7,18,2,3:02
3997,415167,2015-07-29,2015,MIA,WAS,2,7,7-2,WAS,9,0,35,38,73,142,148,290,9,11,20,0,2:39
3998,415163,2015-07-29,2015,LAN,OAK,10,7,10-7,LAN,9,1,39,43,82,160,152,312,16,17,33,5,3:24
3999,415166,2015-07-29,2015,NYN,SDN,3,7,7-3,SDN,9,0,34,44,78,165,153,318,10,18,28,1,3:12
4000,415165,2015-07-29,2015,MIN,PIT,4,10,10-4,PIT,9,0,40,45,85,165,170,335,14,19,33,5,3:29
4001,415156,2015-07-29,2015,BOS,CHA,2,9,9-2,CHA,9,0,35,48,83,200,163,363,10,21,31,2,3:42
4002,415172,2015-07-30,2015,OAK,CLE,1,3,3-1,CLE,9,0,30,31,61,122,103,225,3,8,11,1,2:15
4003,415168,2015-07-30,2015,HOU,ANA,3,0,3-0,HOU,9,0,35,33,68,129,137,266,9,6,15,2,3:02
4004,415180,2015-07-30,2015,MIA,WAS,0,1,1-0,WAS,9,0,31,34,65,138,128,266,6,7,13,0,2:38
4005,415175,2015-07-30,2015,TOR,KCA,5,2,5-2,TOR,9,1,36,33,69,129,136,265,14,6,20,1,2:33
4006,415171,2015-07-30,2015,MIL,CHN,2,5,5-2,CHN,9,0,35,39,74,150,127,277,10,12,22,2,3:07
4007,415169,2015-07-30,2015,PHI,ATL,4,1,4-1,PHI,9,1,35,40,75,157,127,284,13,14,27,1,2:59
4008,415178,2015-07-30,2015,NYN,SDN,7,8,8-7,SDN,9,0,39,41,80,146,144,290,11,15,26,2,2:46 (3:36 delay)
4009,415179,2015-07-30,2015,MIN,SEA,9,5,9-5,MIN,9,1,43,39,82,138,175,313,18,13,31,2,3:08
4010,415173,2015-07-30,2015,SLN,COL,9,8,9-8,SLN,9,0,43,45,88,167,171,338,21,21,42,3,3:50
4011,415170,2015-07-30,2015,BOS,CHA,8,2,8-2,BOS,9,1,39,36,75,143,128,271,18,9,27,1,2:40 (:51 delay)
4012,415176,2015-07-30,2015,TEX,NYA,7,6,7-6,TEX,9,0,41,42,83,164,155,319,18,16,34,4,3:31
4013,415174,2015-07-30,2015,BAL,DET,8,9,9-8,DET,9,0,42,43,85,171,161,332,15,19,34,6,3:36
4014,415177,2015-07-30,2015,CIN,PIT,15,5,15-5,CIN,9,1,52,41,93,154,216,370,27,15,42,3,3:37
4015,415193,2015-07-31,2015,TEX,SFN,6,3,6-3,TEX,9,1,33,36,69,133,112,245,10,10,20,1,2:33
4016,415183,2015-07-31,2015,PHI,ATL,9,3,9-3,PHI,9,1,41,37,78,121,148,269,18,10,28,2,2:39 (:33 delay)
4017,415187,2015-07-31,2015,BAL,DET,8,7,8-7,BAL,9,1,39,41,80,155,145,300,16,17,33,6,3:30
4018,415195,2015-07-31,2015,NYN,WAS,2,1,2-1,NYN,12,0,42,44,86,193,172,365,10,8,18,3,3:59
4019,415181,2015-07-31,2015,LAN,ANA,5,3,5-3,LAN,9,1,36,34,70,134,116,250,13,8,21,1,2:43
4020,415185,2015-07-31,2015,OAK,CLE,1,2,2-1,CLE,9,0,30,37,67,141,127,268,2,11,13,3,2:34
4021,415186,2015-07-31,2015,SLN,COL,7,0,7-0,SLN,9,1,42,35,77,133,160,293,19,7,26,1,3:05
4022,415184,2015-07-31,2015,MIL,CHN,1,4,4-1,CHN,9,0,36,39,75,158,151,309,10,12,22,2,3:18
4023,415192,2015-07-31,2015,MIN,SEA,1,6,6-1,SEA,9,0,30,41,71,132,101,233,2,14,16,1,2:23
4024,415190,2015-07-31,2015,CIN,PIT,4,5,5-4,PIT,9,0,41,38,79,149,164,313,16,13,29,1,3:14
4025,415188,2015-07-31,2015,TOR,KCA,7,6,7-6,TOR,11,0,47,41,88,136,178,314,18,11,29,3,3:23
4026,415182,2015-07-31,2015,HOU,ARI,4,6,6-4,ARI,10,0,38,45,83,167,152,319,9,16,25,4,3:41
4027,415194,2015-07-31,2015,BOS,TBA,7,5,7-5,BOS,9,1,37,45,82,180,145,325,11,17,28,1,3:13
4028,415191,2015-07-31,2015,MIA,SDN,3,8,8-3,SDN,11,0,40,47,87,205,148,353,7,18,25,1,3:41
4029,415189,2015-07-31,2015,CHA,NYA,6,13,13-6,NYA,9,0,43,53,96,219,192,411,16,27,43,2,3:56
4030,415200,2015-08-01,2015,OAK,CLE,5,1,5-1,OAK,9,1,32,33,65,120,121,241,10,5,15,3,2:24
4031,415207,2015-08-01,2015,MIN,SEA,3,2,3-2,MIN,9,0,35,35,70,126,139,265,11,8,19,1,2:45
4032,415202,2015-08-01,2015,BAL,DET,6,2,6-2,BAL,9,1,34,32,66,132,125,257,11,6,17,1,2:36
4033,415201,2015-08-01,2015,SLN,COL,2,6,6-2,COL,9,0,34,41,75,141,126,267,8,16,24,4,3:00
4034,415206,2015-08-01,2015,MIA,SDN,3,5,5-3,SDN,9,0,34,37,71,125,119,244,6,10,16,2,2:31
4035,415199,2015-08-01,2015,MIL,CHN,2,4,4-2,CHN,9,0,34,37,71,151,126,277,8,11,19,3,2:55
4036,415210,2015-08-01,2015,NYN,WAS,3,2,3-2,NYN,9,1,33,35,68,155,128,283,11,8,19,2,2:49
4037,415204,2015-08-01,2015,CHA,NYA,8,2,8-2,CHA,9,1,38,36,74,151,138,289,15,10,25,3,2:58
4038,415197,2015-08-01,2015,HOU,ARI,9,2,9-2,HOU,9,1,39,34,73,160,149,309,17,6,23,2,3:12
4039,415196,2015-08-01,2015,LAN,ANA,3,1,3-1,LAN,9,1,34,32,66,139,135,274,10,6,16,1,2:46
4040,415203,2015-08-01,2015,TOR,KCA,6,7,7-6,KCA,9,0,38,37,75,128,140,268,11,11,22,0,2:30
4041,415205,2015-08-01,2015,CIN,PIT,4,3,4-3,CIN,9,1,35,38,73,152,138,290,11,11,22,1,2:58
4042,415198,2015-08-01,2015,PHI,ATL,12,2,12-2,PHI,9,1,42,33,75,139,157,296,19,6,25,2,2:52
4043,415209,2015-08-01,2015,BOS,TBA,11,7,11-7,BOS,9,1,44,42,86,157,180,337,21,16,37,2,3:39
4044,415208,2015-08-01,2015,TEX,SFN,7,9,9-7,SFN,11,0,48,45,93,148,185,333,16,15,31,7,3:44
4045,415220,2015-08-02,2015,CIN,PIT,0,3,3-0,PIT,9,0,35,34,69,132,122,254,8,6,14,1,2:49
4046,415223,2015-08-02,2015,TEX,SFN,2,1,2-1,TEX,9,1,33,32,65,97,112,209,11,5,16,3,2:19
4047,415217,2015-08-02,2015,BAL,DET,1,6,6-1,DET,9,0,30,36,66,148,99,247,5,10,15,2,2:32
4048,415216,2015-08-02,2015,SLN,COL,3,2,3-2,SLN,9,0,34,36,70,143,155,298,12,9,21,1,3:16
4049,415225,2015-08-02,2015,NYN,WAS,5,2,5-2,NYN,9,1,34,34,68,125,127,252,10,8,18,0,2:42
4050,415212,2015-08-02,2015,HOU,ARI,4,1,4-1,HOU,9,1,37,36,73,124,144,268,13,10,23,0,2:54
4051,415218,2015-08-02,2015,TOR,KCA,5,2,5-2,TOR,9,1,38,33,71,131,157,288,15,7,22,3,3:02
4052,415213,2015-08-02,2015,PHI,ATL,2,6,6-2,ATL,9,0,37,41,78,140,128,268,11,15,26,1,2:48
4053,415221,2015-08-02,2015,MIA,SDN,5,2,5-2,MIA,9,0,35,37,72,167,137,304,11,10,21,2,3:05
4054,415214,2015-08-02,2015,MIL,CHN,3,4,4-3,CHN,9,0,36,38,74,161,155,316,8,13,21,1,3:12
4055,415211,2015-08-02,2015,LAN,ANA,5,3,5-3,LAN,10,0,40,39,79,141,158,299,13,9,22,1,3:19
4056,415215,2015-08-02,2015,OAK,CLE,2,1,2-1,OAK,10,0,39,38,77,142,158,300,11,11,22,3,3:14
4057,415224,2015-08-02,2015,BOS,TBA,3,4,4-3,TBA,9,0,36,40,76,167,158,325,10,13,23,2,3:10
4058,415219,2015-08-02,2015,CHA,NYA,3,12,12-3,NYA,9,0,35,45,80,179,134,313,11,17,28,2,3:09
4059,415222,2015-08-02,2015,MIN,SEA,1,4,4-1,SEA,11,0,39,44,83,169,124,293,6,14,20,3,3:12
4060,415231,2015-08-03,2015,TOR,MIN,5,1,5-1,TOR,9,1,36,32,68,129,143,272,12,5,17,0,2:37
4061,415229,2015-08-03,2015,ANA,CLE,5,4,5-4,ANA,9,1,37,37,74,146,124,270,13,10,23,4,3:02
4062,415227,2015-08-03,2015,OAK,BAL,2,9,9-2,BAL,9,0,34,42,76,176,120,296,8,16,24,2,2:47
4063,415226,2015-08-03,2015,WAS,ARI,4,6,6-4,ARI,9,0,37,36,73,139,122,261,11,11,22,1,2:42
4064,415234,2015-08-03,2015,COL,SEA,7,8,8-7,SEA,9,0,46,40,86,158,155,313,20,15,35,4,3:19
4065,415236,2015-08-03,2015,CHA,TBA,4,5,5-4,TBA,9,0,35,44,79,173,133,306,9,18,27,2,3:07
4066,415233,2015-08-03,2015,MIL,SDN,5,13,13-5,SDN,9,0,39,46,85,158,163,321,13,19,32,1,3:06
4067,415232,2015-08-03,2015,MIA,NYN,1,12,12-1,NYN,9,0,34,49,83,193,113,306,7,22,29,1,3:03
4068,415230,2015-08-03,2015,TEX,HOU,12,9,12-9,TEX,9,1,44,42,86,151,183,334,20,15,35,3,3:19
4069,415235,2015-08-03,2015,ATL,SFN,9,8,9-8,ATL,12,0,52,51,103,182,170,352,21,19,40,3,3:53
4070,415243,2015-08-04,2015,DET,KCA,1,5,5-1,KCA,9,0,34,39,73,132,124,256,9,12,21,0,2:41
4071,415245,2015-08-04,2015,TOR,MIN,3,1,3-1,TOR,9,1,34,32,66,128,142,270,11,5,16,2,2:36
4072,415250,2015-08-04,2015,CIN,SLN,3,2,3-2,CIN,9,1,32,36,68,130,129,259,9,10,19,1,2:24
4073,415238,2015-08-04,2015,OAK,BAL,5,0,5-0,OAK,9,1,35,35,70,139,134,273,14,9,23,1,2:51
4074,415247,2015-08-04,2015,MIL,SDN,4,1,4-1,MIL,9,1,38,35,73,148,139,287,17,7,24,4,3:09
4075,415242,2015-08-04,2015,TEX,HOU,4,3,4-3,TEX,9,1,37,37,74,156,142,298,13,11,24,3,3:19
4076,415239,2015-08-04,2015,NYA,BOS,13,3,13-3,NYA,9,1,43,35,78,143,184,327,18,9,27,6,3:26
4077,415237,2015-08-04,2015,WAS,ARI,5,4,5-4,WAS,9,1,36,36,72,154,168,322,14,8,22,2,3:13 (:30 delay)
4078,415246,2015-08-04,2015,MIA,NYN,1,5,5-1,NYN,9,0,36,41,77,181,134,315,10,14,24,2,3:08
4079,415251,2015-08-04,2015,CHA,TBA,3,11,11-3,TBA,9,0,35,45,80,176,134,310,8,19,27,2,2:53
4080,415240,2015-08-04,2015,PIT,CHN,0,5,5-0,CHN,9,0,31,47,78,188,126,314,7,22,29,2,3:15
4081,415249,2015-08-04,2015,ATL,SFN,3,8,8-3,SFN,9,0,37,42,79,154,161,315,10,17,27,4,3:15
4082,415244,2015-08-04,2015,PHI,LAN,6,2,6-2,PHI,9,1,37,42,79,181,141,322,14,16,30,2,3:31
4083,415241,2015-08-04,2015,ANA,CLE,0,2,2-0,CLE,12,0,39,46,85,174,136,310,4,14,18,1,3:32
4084,415248,2015-08-04,2015,COL,SEA,4,10,10-4,SEA,9,0,38,46,84,161,137,298,13,19,32,3,3:22
4085,415258,2015-08-05,2015,DET,KCA,2,1,2-1,DET,9,1,31,35,66,136,114,250,7,9,16,1,2:38
4086,415254,2015-08-05,2015,NYA,BOS,1,2,2-1,BOS,9,0,34,35,69,165,129,294,8,8,16,0,2:51
4087,415256,2015-08-05,2015,ANA,CLE,4,3,4-3,ANA,9,0,35,35,70,132,163,295,9,10,19,3,2:59
4088,415264,2015-08-05,2015,ATL,SFN,1,6,6-1,SFN,9,0,35,41,76,132,141,273,8,15,23,2,2:52
4089,415257,2015-08-05,2015,TEX,HOU,4,3,4-3,TEX,9,1,34,39,73,178,134,312,9,13,22,3,3:23
4090,415255,2015-08-05,2015,PIT,CHN,7,5,7-5,PIT,9,1,38,37,75,133,151,284,15,11,26,4,3:05
4091,415260,2015-08-05,2015,TOR,MIN,9,7,9-7,TOR,9,1,39,38,77,136,161,297,14,12,26,2,3:06
4092,415262,2015-08-05,2015,MIL,SDN,8,5,8-5,MIL,9,1,36,37,73,148,150,298,13,11,24,2,2:57
4093,415261,2015-08-05,2015,MIA,NYN,6,8,8-6,NYN,9,0,39,41,80,162,137,299,12,15,27,4,3:07
4094,415253,2015-08-05,2015,OAK,BAL,3,7,7-3,BAL,10,0,41,42,83,151,168,319,13,15,28,4,3:33
4095,415259,2015-08-05,2015,PHI,LAN,3,4,4-3,LAN,9,0,36,43,79,192,152,344,8,19,27,0,3:12
4096,415252,2015-08-05,2015,WAS,ARI,4,11,11-4,ARI,9,0,37,50,87,196,158,354,10,23,33,3,3:56
4097,415266,2015-08-05,2015,CHA,TBA,6,5,6-5,CHA,10,0,41,44,85,167,168,335,17,17,34,2,3:20
4098,415265,2015-08-05,2015,CIN,SLN,3,4,4-3,SLN,13,0,53,49,102,199,203,402,14,12,26,3,4:14
4099,415263,2015-08-05,2015,COL,SEA,7,5,7-5,COL,11,0,44,51,95,208,162,370,14,19,33,4,4:06
4100,415268,2015-08-06,2015,NYA,BOS,2,1,2-1,NYA,9,1,33,37,70,149,115,264,10,10,20,0,2:54
4101,415273,2015-08-06,2015,TOR,MIN,9,3,9-3,TOR,9,1,40,34,74,118,155,273,19,7,26,2,2:39
4102,415276,2015-08-06,2015,CIN,SLN,0,3,3-0,SLN,9,0,37,36,73,145,145,290,10,11,21,1,2:59
4103,415274,2015-08-06,2015,MIL,SDN,10,1,10-1,MIL,9,1,42,31,73,129,160,289,18,5,23,0,2:52
4104,415275,2015-08-06,2015,CHN,SFN,5,4,5-4,CHN,9,1,37,35,72,156,156,312,13,8,21,3,3:22
4105,415272,2015-08-06,2015,ATL,MIA,9,8,9-8,ATL,9,1,39,44,83,164,127,291,16,18,34,1,3:18
4106,415267,2015-08-06,2015,WAS,ARI,8,3,8-3,WAS,9,1,43,38,81,136,171,307,18,11,29,2,3:32
4107,415270,2015-08-06,2015,DET,KCA,8,6,8-6,DET,9,0,39,42,81,163,168,331,16,16,32,3,3:26
4108,415271,2015-08-06,2015,PHI,LAN,8,10,10-8,LAN,9,0,41,43,84,173,163,336,14,17,31,2,3:28
4109,415269,2015-08-06,2015,OAK,HOU,4,5,5-4,HOU,10,0,41,41,82,162,168,330,11,11,22,2,3:37
4110,415282,2015-08-07,2015,OAK,HOU,3,1,3-1,OAK,9,1,35,31,66,107,113,220,13,5,18,1,2:20
4111,415280,2015-08-07,2015,ARI,CIN,2,0,2-0,ARI,9,1,29,32,61,104,127,231,7,7,14,0,2:33
4112,415279,2015-08-07,2015,KCA,CHA,3,2,3-2,KCA,9,1,33,36,69,144,129,273,10,10,20,1,3:00
4113,415289,2015-08-07,2015,MIL,SLN,0,6,6-0,SLN,9,0,36,38,74,148,145,293,10,12,22,0,2:50
4114,415290,2015-08-07,2015,SEA,TEX,4,3,4-3,SEA,9,1,34,35,69,145,138,283,12,9,21,2,2:55
4115,415291,2015-08-07,2015,NYA,TOR,1,2,2-1,TOR,10,0,37,41,78,159,135,294,10,11,21,2,3:02
4116,415284,2015-08-07,2015,ATL,MIA,6,3,6-3,ATL,9,1,35,36,71,135,131,266,10,10,20,3,2:53
4117,415277,2015-08-07,2015,ANA,BAL,8,4,8-4,ANA,9,1,40,38,78,130,143,273,17,13,30,4,2:58
4118,415286,2015-08-07,2015,TBA,NYN,3,4,4-3,NYN,9,0,36,37,73,148,152,300,10,9,19,4,3:00
4119,415278,2015-08-07,2015,DET,BOS,2,7,7-2,BOS,9,0,39,43,82,171,157,328,14,17,31,3,3:30
4120,415281,2015-08-07,2015,WAS,COL,4,5,5-4,COL,9,0,39,37,76,151,171,322,13,10,23,1,3:17
4121,415285,2015-08-07,2015,CLE,MIN,9,10,10-9,MIN,9,0,43,44,87,155,159,314,17,18,35,4,3:24
4122,415283,2015-08-07,2015,PIT,LAN,5,4,5-4,PIT,10,0,44,41,85,170,161,331,20,12,32,2,3:42
4123,415287,2015-08-07,2015,SDN,PHI,3,4,4-3,PHI,12,0,51,47,98,192,189,381,16,11,27,2,4:13
4124,415288,2015-08-07,2015,CHN,SFN,7,3,7-3,CHN,9,1,38,35,73,137,153,290,14,11,25,3,3:13
4125,415296,2015-08-08,2015,WAS,COL,6,1,6-1,WAS,9,1,38,30,68,110,144,254,17,3,20,1,2:38
4126,415297,2015-08-08,2015,OAK,HOU,2,1,2-1,OAK,9,1,32,37,69,133,148,281,8,11,19,2,2:51
4127,415304,2015-08-08,2015,MIL,SLN,0,3,3-0,SLN,9,0,32,34,66,138,132,270,7,7,14,0,2:45
4128,415302,2015-08-08,2015,SDN,PHI,2,4,4-2,PHI,9,0,35,34,69,140,133,273,10,9,19,1,2:55
4129,415292,2015-08-08,2015,ANA,BAL,0,5,5-0,BAL,9,0,34,38,72,147,132,279,8,13,21,1,2:55
4130,415306,2015-08-08,2015,NYA,TOR,0,6,6-0,TOR,9,0,33,37,70,157,134,291,6,10,16,1,2:57
4131,415294,2015-08-08,2015,KCA,CHA,7,6,7-6,KCA,9,1,35,39,74,132,122,254,11,14,25,3,2:45
4132,415299,2015-08-08,2015,ATL,MIA,7,2,7-2,ATL,9,1,39,38,77,134,146,280,17,12,29,2,2:51
4133,415293,2015-08-08,2015,DET,BOS,7,6,7-6,DET,9,1,37,41,78,164,142,306,14,14,28,1,3:11
4134,415301,2015-08-08,2015,TBA,NYN,5,4,5-4,TBA,9,1,37,38,75,143,153,296,14,10,24,0,3:03
4135,415295,2015-08-08,2015,ARI,CIN,1,4,4-1,CIN,9,0,36,36,72,141,143,284,9,9,18,0,2:58
4136,415298,2015-08-08,2015,PIT,LAN,6,5,6-5,PIT,9,1,34,43,77,167,145,312,12,18,30,0,3:42
4137,415303,2015-08-08,2015,CHN,SFN,8,6,8-6,CHN,9,1,39,39,78,142,161,303,19,12,31,5,3:14
4138,415300,2015-08-08,2015,CLE,MIN,17,4,17-4,CLE,9,1,51,36,87,143,214,357,27,12,39,6,3:34
4139,415305,2015-08-08,2015,SEA,TEX,3,11,11-3,TEX,11,0,45,50,95,200,192,392,14,22,36,1,4:11
4140,415315,2015-08-09,2015,CLE,MIN,8,1,8-1,CLE,9,1,39,30,69,100,146,246,16,4,20,0,2:37
4141,415319,2015-08-09,2015,MIL,SLN,5,4,5-4,MIL,9,1,31,35,66,118,100,218,11,8,19,2,2:31
4142,415320,2015-08-09,2015,SEA,TEX,4,2,4-2,SEA,9,1,30,39,69,146,104,250,6,12,18,0,2:34
4143,415316,2015-08-09,2015,TBA,NYN,4,3,4-3,TBA,9,1,33,37,70,153,100,253,10,11,21,1,2:38
4144,415321,2015-08-09,2015,NYA,TOR,0,2,2-0,TOR,9,0,34,35,69,153,123,276,8,9,17,4,2:59
4145,415309,2015-08-09,2015,KCA,CHA,5,4,5-4,KCA,9,1,37,35,72,147,134,281,14,9,23,2,3:01
4146,415318,2015-08-09,2015,CHN,SFN,2,0,2-0,CHN,9,1,30,38,68,155,132,287,6,11,17,1,3:13
4147,415308,2015-08-09,2015,DET,BOS,2,7,7-2,BOS,9,0,36,42,78,174,139,313,10,16,26,4,3:22
4148,415317,2015-08-09,2015,SDN,PHI,3,5,5-3,PHI,9,0,37,40,77,142,149,291,9,14,23,2,2:56
4149,415311,2015-08-09,2015,WAS,COL,4,6,6-4,COL,9,0,42,40,82,132,157,289,13,14,27,3,3:24
4150,415312,2015-08-09,2015,OAK,HOU,5,4,5-4,OAK,9,0,40,36,76,161,148,309,18,10,28,5,3:35
4151,415310,2015-08-09,2015,ARI,CIN,4,3,4-3,ARI,10,0,43,39,82,150,155,305,19,10,29,3,3:21
4152,415313,2015-08-09,2015,PIT,LAN,13,6,13-6,PIT,9,1,48,42,90,141,175,316,24,19,43,1,3:39
4153,415307,2015-08-09,2015,ANA,BAL,5,4,5-4,ANA,11,0,50,42,92,164,223,387,21,11,32,2,4:03
4154,415314,2015-08-09,2015,ATL,MIA,1,4,4-1,MIA,9,0,33,42,75,172,122,294,6,15,21,2,3:15
4155,415326,2015-08-10,2015,KCA,DET,4,0,4-0,KCA,9,1,35,31,66,116,146,262,14,4,18,2,2:43
4156,415322,2015-08-10,2015,CHA,ANA,8,2,8-2,CHA,9,1,37,35,72,124,132,256,14,9,23,2,2:45
4157,415323,2015-08-10,2015,SEA,BAL,2,3,3-2,BAL,9,0,34,34,68,143,147,290,7,8,15,1,2:36
4158,415324,2015-08-10,2015,SDN,CIN,2,1,2-1,SDN,9,1,34,38,72,158,135,293,11,11,22,1,2:56
4159,415328,2015-08-10,2015,LAN,WAS,3,8,8-3,WAS,9,0,38,41,79,157,143,300,10,16,26,1,2:45
4160,415327,2015-08-10,2015,ARI,PHI,13,3,13-3,ARI,9,1,44,37,81,126,168,294,22,10,32,2,3:01
4161,415325,2015-08-10,2015,NYN,COL,4,2,4-2,NYN,9,1,34,32,66,116,122,238,9,6,15,1,2:28
4162,415330,2015-08-11,2015,TBA,ATL,2,0,2-0,TBA,9,1,30,31,61,90,92,182,8,6,14,2,2:02
4163,415336,2015-08-11,2015,SFN,HOU,3,1,3-1,SFN,9,1,35,31,66,105,141,246,12,5,17,2,2:36
4164,415339,2015-08-11,2015,TOR,OAK,4,2,4-2,TOR,9,1,33,34,67,109,142,251,7,8,15,2,2:35
4165,415341,2015-08-11,2015,SLN,PIT,4,3,4-3,SLN,9,1,39,35,74,125,129,254,14,10,24,0,2:40
4166,415329,2015-08-11,2015,CHA,ANA,3,0,3-0,CHA,9,1,30,34,64,142,134,276,7,7,14,2,2:38
4167,415340,2015-08-11,2015,ARI,PHI,13,1,13-1,ARI,9,1,44,35,79,116,143,259,20,9,29,1,2:43
4168,415334,2015-08-11,2015,NYN,COL,4,0,4-0,NYN,9,1,38,31,69,110,143,253,16,5,21,1,2:47
4169,415343,2015-08-11,2015,LAN,WAS,5,0,5-0,LAN,9,1,35,35,70,150,133,283,12,8,20,1,2:58
4170,415342,2015-08-11,2015,MIN,TEX,3,2,3-2,MIN,9,0,36,36,72,144,176,320,11,10,21,4,3:19
4171,415335,2015-08-11,2015,KCA,DET,6,1,6-1,KCA,9,1,35,37,72,139,152,291,11,11,22,2,3:01
4172,415333,2015-08-11,2015,SDN,CIN,11,6,11-6,SDN,9,1,41,38,79,139,153,292,16,13,29,2,2:44
4173,415337,2015-08-11,2015,CHN,MIL,6,3,6-3,CHN,9,1,41,35,76,132,186,318,17,8,25,4,3:10
4174,415331,2015-08-11,2015,SEA,BAL,6,5,6-5,SEA,10,0,46,40,86,149,191,340,18,10,28,5,3:29
4175,415332,2015-08-11,2015,MIA,BOS,5,4,5-4,MIA,10,0,49,38,87,148,191,339,22,10,32,4,3:30
4176,415338,2015-08-11,2015,CLE,NYA,5,4,5-4,CLE,16,0,66,57,123,212,259,471,22,11,33,1,5:04
4177,415358,2015-08-12,2015,LAN,WAS,3,0,3-0,LAN,9,1,30,30,60,109,121,230,7,3,10,1,2:20
4178,415349,2015-08-12,2015,NYN,COL,3,0,3-0,NYN,9,1,32,34,66,128,131,259,9,7,16,0,2:35
4179,415353,2015-08-12,2015,CLE,NYA,2,1,2-1,CLE,9,1,35,34,69,134,149,283,13,9,22,1,2:54
4180,415352,2015-08-12,2015,CHN,MIL,3,2,3-2,CHN,10,0,34,37,71,118,128,246,7,7,14,2,2:55
4181,415355,2015-08-12,2015,ARI,PHI,6,7,7-6,PHI,9,0,43,39,82,130,141,271,17,13,30,4,3:34
4182,415356,2015-08-12,2015,SLN,PIT,4,2,4-2,SLN,9,1,35,38,73,144,139,283,11,13,24,1,2:49
4183,415354,2015-08-12,2015,TOR,OAK,10,3,10-3,TOR,9,1,38,35,73,135,153,288,15,11,26,1,2:39
4184,415350,2015-08-12,2015,KCA,DET,4,7,7-4,DET,9,0,37,41,78,130,141,271,11,14,25,3,3:09
4185,415357,2015-08-12,2015,MIN,TEX,11,1,11-1,MIN,9,1,45,32,77,133,183,316,20,6,26,2,2:53
4186,415345,2015-08-12,2015,TBA,ATL,9,6,9-6,TBA,9,1,40,37,77,158,157,315,16,12,28,3,3:12
4187,415346,2015-08-12,2015,SEA,BAL,3,0,3-0,SEA,9,1,32,29,61,116,126,242,8,3,11,0,2:29
4188,415351,2015-08-12,2015,SFN,HOU,0,2,2-0,HOU,9,0,32,35,67,147,119,266,6,11,17,5,2:54
4189,415348,2015-08-12,2015,SDN,CIN,3,7,7-3,CIN,9,0,32,41,73,154,143,297,8,16,24,2,2:58
4190,415344,2015-08-12,2015,CHA,ANA,3,2,3-2,CHA,13,0,50,55,105,201,187,388,16,18,34,4,4:44
4191,415347,2015-08-12,2015,MIA,BOS,14,6,14-6,MIA,9,1,43,40,83,185,159,344,19,17,36,3,3:07
4192,415364,2015-08-13,2015,TOR,OAK,4,2,4-2,TOR,9,1,29,35,64,120,124,244,6,10,16,2,2:25
4193,415367,2015-08-13,2015,SFN,WAS,3,1,3-1,SFN,9,1,34,36,70,137,133,270,11,9,20,1,2:51
4194,415366,2015-08-13,2015,MIN,TEX,5,6,6-5,TEX,9,0,38,38,76,132,144,276,12,13,25,3,2:59
4195,415361,2015-08-13,2015,NYN,COL,12,3,12-3,NYN,9,1,39,32,71,120,166,286,15,8,23,2,2:55
4196,415362,2015-08-13,2015,CHN,MIL,9,2,9-2,CHN,9,1,39,38,77,141,171,312,16,11,27,3,3:09
4197,415365,2015-08-13,2015,SLN,PIT,5,10,10-5,PIT,9,0,39,43,82,163,147,310,14,18,32,2,3:06
4198,415360,2015-08-13,2015,LAN,CIN,3,10,10-3,CIN,9,0,40,43,83,171,159,330,14,18,32,3,3:32
4199,415359,2015-08-13,2015,KCA,ANA,6,7,7-6,ANA,9,0,43,42,85,183,164,347,16,14,30,2,3:45
4200,415363,2015-08-13,2015,CLE,NYA,6,8,8-6,NYA,9,0,42,43,85,173,170,343,16,16,32,5,3:35
4201,415377,2015-08-14,2015,MIL,PHI,3,1,3-1,MIL,9,1,28,38,66,125,107,232,4,12,16,0,2:30
4202,415372,2015-08-14,2015,MIN,CLE,1,6,6-1,CLE,9,0,28,40,68,134,98,232,2,15,17,1,2:26
4203,415374,2015-08-14,2015,SLN,MIA,3,1,3-1,SLN,9,1,32,34,66,108,114,222,8,9,17,1,2:24
4204,415371,2015-08-14,2015,LAN,CIN,5,3,5-3,LAN,9,1,36,33,69,110,144,254,15,8,23,1,2:39
4205,415373,2015-08-14,2015,HOU,DET,5,1,5-1,HOU,9,1,35,34,69,126,153,279,12,7,19,1,3:10
4206,415369,2015-08-14,2015,ATL,ARI,3,2,3-2,ATL,9,1,35,33,68,145,140,285,15,7,22,1,2:59
4207,415368,2015-08-14,2015,KCA,ANA,4,1,4-1,KCA,9,1,37,38,75,142,138,280,12,12,24,2,3:00
4208,415382,2015-08-14,2015,SFN,WAS,8,5,8-5,SFN,9,1,39,39,78,128,135,263,16,10,26,6,3:01
4209,415375,2015-08-14,2015,TOR,NYA,3,4,4-3,NYA,9,0,37,39,76,131,140,271,10,13,23,1,3:14
4210,415379,2015-08-14,2015,COL,SDN,5,9,9-5,SDN,9,0,41,40,81,139,158,297,14,16,30,3,3:10
4211,415378,2015-08-14,2015,NYN,PIT,2,3,3-2,PIT,10,0,40,41,81,149,148,297,11,14,25,2,3:20
4212,415370,2015-08-14,2015,CHA,CHN,5,6,6-5,CHN,9,0,41,38,79,150,174,324,15,12,27,2,3:20
4213,415381,2015-08-14,2015,TEX,TBA,5,3,5-3,TEX,9,1,34,37,71,130,130,260,12,14,26,2,2:55
4214,415380,2015-08-14,2015,BOS,SEA,15,1,15-1,BOS,9,1,47,36,83,160,181,341,23,9,32,2,3:30
4215,415376,2015-08-14,2015,BAL,OAK,8,6,8-6,BAL,13,0,55,58,113,216,201,417,19,22,41,3,4:27 (:10 delay)
4216,415387,2015-08-15,2015,MIN,CLE,4,1,4-1,MIN,9,1,31,35,66,135,109,244,7,9,16,1,2:27
4217,415389,2015-08-15,2015,SLN,MIA,6,2,6-2,SLN,9,1,35,36,71,123,130,253,14,10,24,1,2:35
4218,415392,2015-08-15,2015,MIL,PHI,4,2,4-2,MIL,9,1,35,38,73,132,116,248,12,11,23,2,2:58
4219,415386,2015-08-15,2015,LAN,CIN,8,3,8-3,LAN,9,1,38,35,73,133,149,282,17,9,26,1,2:48
4220,415390,2015-08-15,2015,TOR,NYA,1,4,4-1,NYA,9,0,35,40,75,166,112,278,8,13,21,1,2:57
4221,415383,2015-08-15,2015,KCA,ANA,9,4,9-4,KCA,9,1,43,36,79,131,153,284,19,12,31,2,2:55
4222,415391,2015-08-15,2015,BAL,OAK,4,3,4-3,BAL,9,0,31,34,65,128,117,245,8,10,18,0,2:25
4223,415394,2015-08-15,2015,COL,SDN,5,7,7-5,SDN,9,0,36,40,76,150,138,288,12,14,26,2,3:13
4224,415397,2015-08-15,2015,SFN,WAS,12,6,12-6,SFN,9,1,42,39,81,123,159,282,18,13,31,2,3:04
4225,415396,2015-08-15,2015,TEX,TBA,12,4,12-4,TEX,9,1,42,39,81,168,148,316,18,13,31,2,3:10
4226,415385,2015-08-15,2015,CHA,CHN,3,6,6-3,CHN,9,0,38,41,79,190,141,331,10,16,26,3,3:35
4227,415384,2015-08-15,2015,ATL,ARI,4,8,8-4,ARI,9,0,38,42,80,152,140,292,10,16,26,4,3:00
4228,415388,2015-08-15,2015,HOU,DET,2,4,4-2,DET,11,0,41,45,86,152,169,321,10,13,23,2,3:43
4229,415395,2015-08-15,2015,BOS,SEA,22,10,22-10,BOS,9,1,57,43,100,190,170,360,33,17,50,5,3:21
4230,415393,2015-08-15,2015,NYN,PIT,3,5,5-3,PIT,14,0,52,54,106,187,190,377,11,15,26,1,4:02
4231,415412,2015-08-16,2015,SFN,WAS,5,0,5-0,SFN,9,1,32,31,63,112,104,216,9,4,13,1,2:17
4232,415409,2015-08-16,2015,COL,SDN,5,0,5-0,COL,9,1,31,32,63,106,113,219,9,6,15,1,2:31
4233,415401,2015-08-16,2015,LAN,CIN,2,1,2-1,LAN,9,1,31,34,65,146,113,259,9,8,17,2,2:41
4234,415405,2015-08-16,2015,TOR,NYA,3,1,3-1,TOR,9,1,33,31,64,123,144,267,11,6,17,2,2:41
4235,415399,2015-08-16,2015,ATL,ARI,2,1,2-1,ATL,10,0,38,36,74,148,138,286,14,7,21,3,3:13
4236,415400,2015-08-16,2015,CHA,CHN,3,1,3-1,CHA,9,1,35,34,69,146,146,292,11,6,17,3,2:46
4237,415407,2015-08-16,2015,MIL,PHI,6,1,6-1,MIL,9,1,36,37,73,140,135,275,11,10,21,5,3:07
4238,415404,2015-08-16,2015,SLN,MIA,4,6,6-4,MIA,9,0,35,38,73,135,148,283,8,11,19,4,3:13
4239,415398,2015-08-16,2015,KCA,ANA,4,3,4-3,KCA,10,0,41,37,78,148,151,299,14,7,21,0,3:12
4240,415411,2015-08-16,2015,TEX,TBA,5,3,5-3,TEX,9,1,36,39,75,145,159,304,12,13,25,1,3:04
4241,415408,2015-08-16,2015,NYN,PIT,1,8,8-1,PIT,9,0,35,46,81,180,154,334,8,21,29,3,3:23 (:42 delay)
4242,415402,2015-08-16,2015,MIN,CLE,4,1,4-1,MIN,9,1,35,36,71,131,123,254,12,9,21,2,2:48
4243,415403,2015-08-16,2015,HOU,DET,6,5,6-5,HOU,9,0,37,40,77,161,145,306,13,12,25,4,3:25
4244,415410,2015-08-16,2015,BOS,SEA,8,10,10-8,SEA,12,0,54,58,112,197,225,422,22,22,44,5,4:24
4245,415406,2015-08-16,2015,BAL,OAK,18,2,18-2,BAL,9,1,51,37,88,152,169,321,29,10,39,3,3:09
4246,415415,2015-08-17,2015,ANA,CHA,2,1,2-1,ANA,9,1,29,36,65,142,104,246,7,10,17,0,2:32
4247,415414,2015-08-17,2015,SDN,ATL,5,3,5-3,SDN,9,1,33,35,68,149,132,281,13,9,22,2,2:58
4248,415421,2015-08-17,2015,SLN,SFN,2,1,2-1,SLN,9,1,35,34,69,119,148,267,13,8,21,2,2:40
4249,415417,2015-08-17,2015,MIL,MIA,2,6,6-2,MIA,9,0,38,40,78,138,138,276,11,13,24,1,2:51
4250,415413,2015-08-17,2015,PIT,ARI,1,4,4-1,ARI,9,0,37,34,71,134,161,295,10,10,20,3,3:27
4251,415420,2015-08-17,2015,TEX,SEA,4,3,4-3,TEX,9,0,40,36,76,126,135,261,17,12,29,1,2:51
4252,415416,2015-08-17,2015,BOS,CLE,2,8,8-2,CLE,9,0,35,40,75,159,146,305,9,13,22,1,3:12
4253,415422,2015-08-17,2015,HOU,TBA,2,9,9-2,TBA,9,0,38,46,84,180,156,336,10,19,29,2,3:23
4254,415418,2015-08-17,2015,NYA,MIN,8,7,8-7,NYA,10,0,43,46,89,186,179,365,16,18,34,5,4:13
4255,415419,2015-08-17,2015,BAL,OAK,4,2,4-2,BAL,9,1,36,33,69,122,124,246,9,7,16,2,2:35
4256,415425,2015-08-18,2015,ANA,CHA,5,3,5-3,ANA,9,1,32,32,64,128,119,247,7,8,15,1,2:29
4257,415433,2015-08-18,2015,TEX,SEA,2,3,3-2,SEA,9,0,32,36,68,153,124,277,6,9,15,1,2:44
4258,415424,2015-08-18,2015,SDN,ATL,9,0,9-0,SDN,9,1,40,36,76,151,158,309,19,11,30,2,3:14
4259,415435,2015-08-18,2015,HOU,TBA,3,2,3-2,HOU,10,0,38,40,78,137,161,298,14,11,25,1,3:14
4260,415434,2015-08-18,2015,SLN,SFN,0,2,2-0,SFN,9,0,31,40,71,157,146,303,4,15,19,3,3:09 (:31 delay)
4261,415432,2015-08-18,2015,BAL,NYN,3,5,5-3,NYN,9,0,37,40,77,168,136,304,10,12,22,3,2:59 (:46 delay)
4262,415431,2015-08-18,2015,NYA,MIN,8,4,8-4,NYA,9,1,39,35,74,135,166,301,15,10,25,5,3:16
4263,415436,2015-08-18,2015,PHI,TOR,5,8,8-5,TOR,9,0,37,45,82,166,145,311,14,16,30,2,3:10
4264,415427,2015-08-18,2015,CHN,DET,8,10,10-8,DET,9,0,41,48,89,174,147,321,16,23,39,5,3:36 (2:17 delay)
4265,415429,2015-08-18,2015,OAK,LAN,5,4,5-4,OAK,10,0,42,45,87,179,158,337,14,16,30,4,3:45
4266,415437,2015-08-18,2015,COL,WAS,6,15,15-6,WAS,9,0,42,52,94,203,150,353,15,26,41,3,3:45
4267,415430,2015-08-18,2015,MIL,MIA,6,9,9-6,MIA,9,0,43,45,88,179,173,352,16,18,34,4,3:38
4268,415428,2015-08-18,2015,CIN,KCA,1,3,3-1,KCA,13,0,49,51,100,219,220,439,12,17,29,1,4:39
4269,415423,2015-08-18,2015,PIT,ARI,9,8,9-8,PIT,15,0,63,64,127,222,243,465,22,21,43,3,5:11
4270,415426,2015-08-18,2015,BOS,CLE,9,1,9-1,BOS,9,1,42,32,74,121,156,277,19,6,25,3,2:56
4271,415440,2015-08-19,2015,ANA,CHA,1,0,1-0,ANA,9,1,34,33,67,128,128,256,10,8,18,1,2:56
4272,415446,2015-08-19,2015,NYA,MIN,4,3,4-3,NYA,9,1,32,34,66,159,112,271,10,7,17,1,2:34
4273,415444,2015-08-19,2015,OAK,LAN,5,2,5-2,OAK,9,1,33,31,64,130,118,248,12,4,16,3,2:34
4274,415451,2015-08-19,2015,PHI,TOR,7,4,7-4,PHI,9,1,37,34,71,116,124,240,13,7,20,0,2:24
4275,415449,2015-08-19,2015,SLN,SFN,4,3,4-3,SLN,9,1,35,36,71,125,127,252,11,11,22,4,2:54
4276,415439,2015-08-19,2015,SDN,ATL,3,2,3-2,SDN,9,1,34,36,70,137,135,272,11,12,23,1,2:43
4277,415452,2015-08-19,2015,COL,WAS,1,4,4-1,WAS,9,0,29,43,72,173,109,282,2,19,21,0,2:57
4278,415438,2015-08-19,2015,PIT,ARI,4,1,4-1,PIT,9,1,35,33,68,128,134,262,15,7,22,1,2:51
4279,415448,2015-08-19,2015,TEX,SEA,7,2,7-2,TEX,9,1,40,34,74,131,147,278,17,9,26,2,2:39
4280,415441,2015-08-19,2015,BOS,CLE,6,4,6-4,BOS,9,1,33,37,70,169,115,284,9,12,21,2,3:09
4281,415447,2015-08-19,2015,BAL,NYN,5,4,5-4,BAL,9,0,35,37,72,157,140,297,12,13,25,3,3:01
4282,415445,2015-08-19,2015,MIL,MIA,8,7,8-7,MIL,9,1,43,42,85,158,140,298,19,16,35,4,3:11
4283,415443,2015-08-19,2015,CIN,KCA,3,4,4-3,KCA,9,0,39,41,80,178,180,358,14,16,30,2,3:38 (1:37 delay)
4284,415442,2015-08-19,2015,CHN,DET,8,15,15-8,DET,9,0,42,52,94,179,175,354,15,25,40,5,3:48
4285,415450,2015-08-19,2015,HOU,TBA,3,2,3-2,HOU,13,0,48,48,96,181,177,358,13,11,24,3,4:04
4286,415461,2015-08-20,2015,HOU,TBA,0,1,1-0,TBA,9,0,28,36,64,142,98,240,2,10,12,0,2:32
4287,415462,2015-08-20,2015,DET,TEX,4,0,4-0,DET,9,1,35,31,66,116,144,260,13,3,16,0,2:47
4288,415463,2015-08-20,2015,COL,WAS,3,2,3-2,COL,9,1,36,34,70,132,129,261,14,8,22,2,2:47
4289,415460,2015-08-20,2015,PIT,SFN,4,0,4-0,PIT,9,1,34,37,71,127,127,254,11,11,22,1,2:51
4290,415457,2015-08-20,2015,BOS,KCA,4,1,4-1,BOS,9,1,35,34,69,142,146,288,12,7,19,2,2:49
4291,415456,2015-08-20,2015,NYA,CLE,2,3,3-2,CLE,9,0,35,36,71,157,143,300,8,11,19,0,3:07
4292,415458,2015-08-20,2015,BAL,MIN,2,15,15-2,MIN,9,0,37,48,85,183,120,303,12,22,34,1,2:51 (2:31 delay)
4293,415454,2015-08-20,2015,CHN,ATL,7,1,7-1,CHN,9,1,36,37,73,160,145,305,13,10,23,2,2:59
4294,415453,2015-08-20,2015,CIN,ARI,4,5,5-4,ARI,9,0,36,42,78,180,147,327,11,15,26,1,3:21
4295,415455,2015-08-20,2015,ANA,CHA,2,8,8-2,CHA,9,0,36,41,77,164,135,299,11,16,27,3,3:21
4296,415459,2015-08-20,2015,MIA,PHI,9,7,9-7,MIA,9,1,40,42,82,184,169,353,18,16,34,3,3:33
4297,415477,2015-08-21,2015,DET,TEX,0,2,2-0,TEX,9,0,33,32,65,142,122,264,9,7,16,3,3:08
4298,415468,2015-08-21,2015,BOS,KCA,7,2,7-2,BOS,9,1,38,31,69,120,131,251,14,5,19,0,2:31
4299,415469,2015-08-21,2015,HOU,LAN,3,0,3-0,HOU,9,1,30,30,60,134,118,252,7,3,10,0,2:31
4300,415473,2015-08-21,2015,MIA,PHI,1,7,7-1,PHI,9,0,34,41,75,149,115,264,9,15,24,0,2:36
4301,415465,2015-08-21,2015,CHN,ATL,5,3,5-3,CHN,9,1,36,39,75,144,121,265,12,10,22,4,2:53
4302,415476,2015-08-21,2015,OAK,TBA,1,2,2-1,TBA,9,0,37,36,73,123,156,279,9,11,20,2,2:52
4303,415471,2015-08-21,2015,BAL,MIN,3,4,4-3,MIN,9,0,32,42,74,175,128,303,6,15,21,2,3:06
4304,415464,2015-08-21,2015,CIN,ARI,3,6,6-3,ARI,9,0,37,42,79,150,124,274,10,16,26,1,3:02
4305,415478,2015-08-21,2015,ANA,TOR,2,9,9-2,TOR,9,0,34,45,79,176,124,300,7,16,23,3,3:07
4306,415474,2015-08-21,2015,PIT,SFN,4,6,6-4,SFN,9,0,38,42,80,151,148,299,13,17,30,2,3:12
4307,415466,2015-08-21,2015,SEA,CHA,4,11,11-4,CHA,9,0,33,46,79,187,132,319,6,21,27,2,3:06
4308,415475,2015-08-21,2015,SDN,SLN,9,3,9-3,SDN,9,1,40,39,79,176,140,316,16,12,28,3,3:07
4309,415467,2015-08-21,2015,NYA,CLE,3,7,7-3,CLE,9,0,38,42,80,170,151,321,10,15,25,4,3:39
4310,415470,2015-08-21,2015,WAS,MIL,3,10,10-3,MIL,9,0,36,44,80,173,157,330,10,17,27,3,3:24
4311,415472,2015-08-21,2015,COL,NYN,9,14,14-9,NYN,9,0,42,48,90,176,149,325,16,21,37,2,3:34
4312,415484,2015-08-22,2015,HOU,LAN,3,1,3-1,HOU,9,1,27,34,61,131,107,238,3,8,11,0,2:28
4313,415489,2015-08-22,2015,PIT,SFN,3,2,3-2,PIT,9,0,29,35,64,136,112,248,5,8,13,0,2:34
4314,415491,2015-08-22,2015,OAK,TBA,4,5,5-4,TBA,9,0,36,35,71,132,115,247,10,10,20,1,2:37
4315,415485,2015-08-22,2015,WAS,MIL,6,1,6-1,WAS,9,1,36,34,70,107,143,250,14,8,22,1,2:44
4316,415488,2015-08-22,2015,MIA,PHI,2,4,4-2,PHI,9,0,35,38,73,135,147,282,9,12,21,3,2:50
4317,415486,2015-08-22,2015,BAL,MIN,2,3,3-2,MIN,9,0,38,38,76,149,139,288,12,12,24,4,3:01
4318,415482,2015-08-22,2015,NYA,CLE,6,2,6-2,NYA,9,1,37,36,73,146,150,296,13,10,23,1,2:52
4319,415492,2015-08-22,2015,DET,TEX,3,5,5-3,TEX,9,0,38,36,74,143,143,286,12,10,22,2,2:55
4320,415490,2015-08-22,2015,SDN,SLN,8,0,8-0,SDN,9,1,40,37,77,151,142,293,15,10,25,6,3:11
4321,415493,2015-08-22,2015,ANA,TOR,3,15,15-3,TOR,9,0,34,49,83,197,127,324,7,24,31,2,3:16
4322,415480,2015-08-22,2015,CHN,ATL,9,7,9-7,CHN,9,1,37,39,76,132,132,264,13,11,24,4,2:42
4323,415483,2015-08-22,2015,BOS,KCA,3,6,6-3,KCA,9,0,41,41,82,169,181,350,14,15,29,3,3:29
4324,415481,2015-08-22,2015,SEA,CHA,3,6,6-3,CHA,10,0,42,45,87,172,166,338,13,16,29,2,3:23
4325,415487,2015-08-22,2015,COL,NYN,9,14,14-9,NYN,9,0,43,50,93,175,159,334,16,25,41,4,3:27
4326,415479,2015-08-22,2015,CIN,ARI,7,11,11-7,ARI,9,0,45,43,88,156,186,342,18,16,34,3,3:41
4327,415502,2015-08-23,2015,COL,NYN,1,5,5-1,NYN,9,0,32,39,71,141,113,254,7,13,20,0,2:42
4328,415503,2015-08-23,2015,MIA,PHI,0,2,2-0,PHI,9,0,30,37,67,162,109,271,5,12,17,1,2:40
4329,415494,2015-08-23,2015,CIN,ARI,0,4,4-0,ARI,9,0,32,38,70,143,124,267,8,11,19,1,2:53
4330,415507,2015-08-23,2015,DET,TEX,2,4,4-2,TEX,9,0,38,37,75,150,135,285,11,13,24,1,3:01
4331,415499,2015-08-23,2015,HOU,LAN,3,2,3-2,HOU,10,0,36,38,74,133,141,274,10,11,21,1,3:16
4332,415500,2015-08-23,2015,WAS,MIL,9,5,9-5,WAS,9,1,39,38,77,164,148,312,17,13,30,2,3:03
4333,415506,2015-08-23,2015,OAK,TBA,8,2,8-2,OAK,9,1,36,36,72,144,143,287,13,11,24,3,2:58
4334,415498,2015-08-23,2015,BOS,KCA,6,8,8-6,KCA,9,0,38,42,80,169,139,308,12,16,28,4,3:40
4335,415508,2015-08-23,2015,ANA,TOR,5,12,12-5,TOR,9,0,37,48,85,177,128,305,14,21,35,1,3:03
4336,415495,2015-08-23,2015,CHN,ATL,9,3,9-3,CHN,9,1,44,38,82,142,190,332,19,11,30,2,2:57
4337,415504,2015-08-23,2015,PIT,SFN,5,2,5-2,PIT,9,1,39,40,79,167,143,310,16,12,28,2,3:32
4338,415497,2015-08-23,2015,NYA,CLE,3,4,4-3,CLE,9,0,38,42,80,173,156,329,11,20,31,6,3:37
4339,415505,2015-08-23,2015,SDN,SLN,3,10,10-3,SLN,9,0,41,43,84,199,170,369,14,17,31,2,3:29
4340,415501,2015-08-23,2015,BAL,MIN,3,4,4-3,MIN,12,0,51,46,97,190,214,404,16,7,23,3,4:24
4341,415496,2015-08-23,2015,SEA,CHA,8,6,8-6,SEA,9,1,39,35,74,132,132,264,17,9,26,4,2:48
4342,414602,2015-08-24,2015,CHN,CLE,2,1,2-1,CHN,9,0,32,32,64,103,140,243,6,9,15,2,2:38
4343,414647,2015-08-24,2015,CIN,DET,12,5,12-5,CIN,9,1,41,42,83,179,169,348,18,17,35,3,3:23
4344,415512,2015-08-24,2015,NYA,HOU,1,0,1-0,NYA,9,0,32,35,67,126,126,252,10,8,18,1,2:47
4345,415511,2015-08-24,2015,ATL,COL,5,3,5-3,ATL,9,1,38,33,71,124,127,251,15,7,22,3,2:43
4346,415510,2015-08-24,2015,CHA,BOS,4,5,5-4,BOS,9,0,34,41,75,159,121,280,9,16,25,3,3:10
4347,415514,2015-08-24,2015,SEA,OAK,5,11,11-5,OAK,9,0,35,43,78,154,137,291,10,17,27,1,3:09
4348,414647,2015-08-24,2015,CIN,DET,12,5,12-5,CIN,9,1,41,42,83,179,169,348,18,17,35,3,3:23
4349,415513,2015-08-24,2015,PHI,NYN,7,16,16-7,NYN,9,0,43,50,93,181,177,358,16,23,39,2,3:33
4350,415509,2015-08-24,2015,KCA,BAL,8,3,8-3,KCA,9,1,39,30,69,99,119,218,15,5,20,1,2:18
4351,414602,2015-08-24,2015,CHN,CLE,2,1,2-1,CHN,9,0,32,32,64,103,140,243,6,9,15,2,2:38
4352,415516,2015-08-24,2015,ARI,SLN,3,5,5-3,SLN,9,0,41,41,82,151,161,312,17,13,30,2,3:19
4353,415515,2015-08-24,2015,MIA,PIT,2,5,5-2,PIT,9,0,35,45,80,179,132,311,10,19,29,3,3:21
4354,415528,2015-08-25,2015,MIA,PIT,5,2,5-2,MIA,9,1,33,36,69,123,128,251,11,11,22,2,2:48
4355,415524,2015-08-25,2015,CLE,MIL,11,6,11-6,CLE,9,1,41,34,75,127,156,283,17,7,24,2,2:54
4356,415519,2015-08-25,2015,CHA,BOS,5,4,5-4,CHA,9,1,37,34,71,149,125,274,16,8,24,2,3:00
4357,415517,2015-08-25,2015,DET,ANA,7,8,8-7,ANA,9,0,44,41,85,155,156,311,16,17,33,5,3:27
4358,415521,2015-08-25,2015,ATL,COL,1,5,5-1,COL,9,0,38,41,79,147,158,305,13,12,25,2,3:08
4359,415522,2015-08-25,2015,NYA,HOU,1,15,15-1,HOU,9,0,32,51,83,187,121,308,5,23,28,1,3:05
4360,415523,2015-08-25,2015,CIN,LAN,1,5,5-1,LAN,9,0,36,38,74,163,149,312,12,11,23,3,3:04
4361,415527,2015-08-25,2015,SEA,OAK,6,5,6-5,SEA,9,1,39,44,83,153,124,277,16,18,34,3,3:05
4362,415531,2015-08-25,2015,TEX,TOR,5,6,6-5,TOR,9,0,40,39,79,150,152,302,14,13,27,3,3:02
4363,415530,2015-08-25,2015,ARI,SLN,1,9,9-1,SLN,9,0,34,47,81,184,137,321,8,19,27,1,3:10
4364,415520,2015-08-25,2015,SFN,CHN,5,8,8-5,CHN,9,0,40,39,79,140,175,315,12,14,26,3,3:08
4365,415518,2015-08-25,2015,KCA,BAL,3,2,3-2,KCA,9,1,34,37,71,135,147,282,12,10,22,5,2:57
4366,415529,2015-08-25,2015,WAS,SDN,8,3,8-3,WAS,9,1,42,33,75,145,169,314,18,8,26,3,3:08
4367,415526,2015-08-25,2015,PHI,NYN,5,6,6-5,NYN,9,0,38,40,78,162,175,337,10,13,23,4,3:31
4368,415525,2015-08-25,2015,TBA,MIN,7,11,11-7,MIN,9,0,46,43,89,167,164,331,20,17,37,2,3:24
4369,415532,2015-08-26,2015,DET,ANA,5,0,5-0,DET,9,1,37,28,65,112,165,277,14,3,17,1,2:48
4370,415543,2015-08-26,2015,MIA,PIT,2,7,7-2,PIT,9,0,32,41,73,152,122,274,6,14,20,1,2:31
4371,415533,2015-08-26,2015,KCA,BAL,5,8,8-5,BAL,9,0,38,39,77,148,134,282,14,14,28,3,2:47
4372,415540,2015-08-26,2015,TBA,MIN,3,5,5-3,MIN,9,0,39,42,81,152,137,289,14,14,28,4,3:21
4373,415542,2015-08-26,2015,SEA,OAK,8,2,8-2,SEA,9,1,42,34,76,126,178,304,18,7,25,2,3:00
4374,415544,2015-08-26,2015,WAS,SDN,5,6,6-5,SDN,9,0,38,38,76,145,152,297,12,12,24,3,3:07
4375,415541,2015-08-26,2015,PHI,NYN,4,9,9-4,NYN,9,0,40,42,82,148,159,307,13,14,27,4,3:16
4376,415537,2015-08-26,2015,NYA,HOU,2,6,6-2,HOU,9,0,36,39,75,172,155,327,9,14,23,3,3:26
4377,415546,2015-08-26,2015,TEX,TOR,4,12,12-4,TOR,9,0,38,47,85,186,144,330,12,21,33,3,3:19
4378,415536,2015-08-26,2015,ATL,COL,3,6,6-3,COL,9,0,43,41,84,146,182,328,20,17,37,3,3:18
4379,415539,2015-08-26,2015,CLE,MIL,6,2,6-2,CLE,9,1,41,37,78,167,169,336,19,10,29,3,3:39
4380,415535,2015-08-26,2015,SFN,CHN,4,2,4-2,SFN,9,1,33,34,67,122,119,241,9,9,18,3,2:39
4381,415534,2015-08-26,2015,CHA,BOS,0,3,3-0,BOS,9,0,33,37,70,150,120,270,6,11,17,0,2:31
4382,415545,2015-08-26,2015,ARI,SLN,1,3,3-1,SLN,9,0,33,36,69,131,117,248,9,9,18,1,2:35
4383,415538,2015-08-26,2015,CIN,LAN,4,7,7-4,LAN,9,0,38,41,79,170,146,316,11,14,25,5,3:16
4384,415547,2015-08-27,2015,DET,ANA,0,2,2-0,ANA,9,0,28,34,62,128,119,247,3,10,13,1,2:39
4385,415553,2015-08-27,2015,MIA,PIT,1,2,2-1,PIT,9,0,32,36,68,135,118,253,6,13,19,1,2:46
4386,415548,2015-08-27,2015,KCA,BAL,5,3,5-3,KCA,9,1,36,38,74,147,123,270,13,10,23,0,2:46 (1:35 delay)
4387,415550,2015-08-27,2015,CIN,LAN,0,1,1-0,LAN,9,0,34,36,70,150,136,286,7,14,21,0,2:54
4388,415555,2015-08-27,2015,CHA,SEA,4,2,4-2,CHA,9,1,33,36,69,133,114,247,10,10,20,3,2:39
4389,415549,2015-08-27,2015,SFN,CHN,9,1,9-1,SFN,9,1,36,32,68,144,131,275,16,5,21,1,2:36
4390,415554,2015-08-27,2015,WAS,SDN,4,2,4-2,WAS,9,1,39,33,72,128,161,289,17,6,23,1,3:01
4391,415551,2015-08-27,2015,TBA,MIN,5,4,5-4,TBA,9,1,34,37,71,164,122,286,11,11,22,4,2:49
4392,415557,2015-08-27,2015,TEX,TOR,4,1,4-1,TEX,9,1,38,37,75,176,165,341,16,13,29,3,3:40
4393,415556,2015-08-27,2015,ARI,SLN,3,5,5-3,SLN,9,0,38,40,78,139,173,312,12,15,27,4,3:24
4394,415552,2015-08-27,2015,PHI,NYN,5,9,9-5,NYN,13,0,51,62,113,236,187,423,14,24,38,4,4:32
4395,415558,2015-08-28,2015,CLE,ANA,3,1,3-1,CLE,9,1,35,30,65,110,124,234,13,8,21,3,2:34
4396,415570,2015-08-28,2015,PHI,SDN,7,1,7-1,PHI,9,1,36,31,67,104,145,249,14,4,18,2,2:38
4397,415564,2015-08-28,2015,TOR,DET,5,3,5-3,TOR,9,1,36,34,70,114,132,246,14,7,21,1,2:25
4398,415567,2015-08-28,2015,WAS,MIA,3,4,4-3,MIA,9,0,35,35,70,112,145,257,10,8,18,3,2:49
4399,415566,2015-08-28,2015,TBA,KCA,2,3,3-2,KCA,9,0,36,37,73,152,130,282,10,11,21,2,3:01
4400,415563,2015-08-28,2015,PIT,COL,5,3,5-3,PIT,9,1,38,33,71,132,160,292,16,8,24,1,3:10
4401,415568,2015-08-28,2015,ATL,NYA,4,15,15-4,NYA,9,0,37,50,87,199,147,346,10,26,36,2,3:19
4402,415559,2015-08-28,2015,TEX,BAL,4,1,4-1,TEX,9,1,32,33,65,129,114,243,10,7,17,1,2:23
4403,415561,2015-08-28,2015,LAN,CHN,4,1,4-1,LAN,9,1,34,31,65,117,131,248,11,4,15,1,2:28
4404,415562,2015-08-28,2015,MIL,CIN,5,0,5-0,MIL,9,1,34,33,67,137,128,265,10,9,19,1,2:51
4405,415569,2015-08-28,2015,ARI,OAK,6,4,6-4,ARI,9,1,35,35,70,146,127,273,10,9,19,2,2:56
4406,415571,2015-08-28,2015,CHA,SEA,0,2,2-0,SEA,9,0,31,39,70,156,113,269,5,12,17,2,2:52
4407,415572,2015-08-28,2015,SFN,SLN,5,4,5-4,SFN,9,0,43,34,77,122,161,283,17,8,25,2,3:02
4408,415560,2015-08-28,2015,NYN,BOS,4,6,6-4,BOS,10,0,48,40,88,175,210,385,20,10,30,4,3:59
4409,415565,2015-08-28,2015,MIN,HOU,3,0,3-0,MIN,9,1,30,37,67,172,116,288,7,10,17,1,2:49
4410,415582,2015-08-29,2015,WAS,MIA,5,1,5-1,WAS,9,1,32,33,65,139,108,247,11,8,19,0,2:25
4411,415584,2015-08-29,2015,ARI,OAK,2,3,3-2,OAK,9,0,35,37,72,130,110,240,10,12,22,1,2:40
4412,415574,2015-08-29,2015,TEX,BAL,4,3,4-3,TEX,9,1,36,37,73,125,117,242,16,10,26,4,2:33
4413,415585,2015-08-29,2015,PHI,SDN,4,3,4-3,PHI,9,1,32,38,70,136,130,266,10,10,20,2,2:56
4414,415583,2015-08-29,2015,ATL,NYA,1,3,3-1,NYA,9,0,38,39,77,161,131,292,12,14,26,2,3:04
4415,415573,2015-08-29,2015,CLE,ANA,8,3,8-3,CLE,9,1,37,37,74,134,151,285,14,10,24,2,2:58 (:38 delay)
4416,415580,2015-08-29,2015,MIN,HOU,1,4,4-1,HOU,9,0,35,42,77,180,136,316,9,14,23,2,3:22
4417,415576,2015-08-29,2015,LAN,CHN,5,2,5-2,LAN,9,1,37,38,75,166,136,302,12,13,25,4,3:23
4418,415586,2015-08-29,2015,CHA,SEA,6,7,7-6,SEA,9,0,44,44,88,196,172,368,18,17,35,5,4:16
4419,415577,2015-08-29,2015,MIL,CIN,9,12,12-9,CIN,9,0,44,45,89,163,195,358,18,20,38,4,3:59
4420,415575,2015-08-29,2015,NYN,BOS,1,3,3-1,BOS,9,0,33,38,71,156,126,282,8,10,18,1,2:51
4421,415587,2015-08-29,2015,SFN,SLN,0,6,6-0,SLN,9,0,34,41,75,168,129,297,10,18,28,3,3:11
4422,415578,2015-08-29,2015,PIT,COL,4,3,4-3,PIT,9,1,35,37,72,140,154,294,13,10,23,2,3:09
4423,415581,2015-08-29,2015,TBA,KCA,3,6,6-3,KCA,9,0,36,44,80,189,119,308,10,15,25,4,3:20
4424,415579,2015-08-29,2015,TOR,DET,15,1,15-1,TOR,9,1,48,35,83,140,184,324,26,8,34,2,3:25
4425,415588,2015-08-30,2015,CLE,ANA,9,2,9-2,CLE,9,1,39,35,74,127,133,260,17,9,26,1,2:40
4426,415590,2015-08-30,2015,NYN,BOS,5,4,5-4,NYN,9,1,37,37,74,154,119,273,13,11,24,3,2:56
4427,415594,2015-08-30,2015,TOR,DET,9,2,9-2,TOR,9,1,39,36,75,127,157,284,15,10,25,2,2:38
4428,415592,2015-08-30,2015,MIL,CIN,4,1,4-1,MIL,9,1,33,34,67,129,123,252,12,9,21,2,2:38
4429,415591,2015-08-30,2015,LAN,CHN,0,2,2-0,CHN,9,0,29,41,70,139,116,255,1,15,16,1,2:42
4430,415589,2015-08-30,2015,TEX,BAL,6,0,6-0,TEX,9,1,38,31,69,116,152,268,15,4,19,2,2:41
4431,415593,2015-08-30,2015,PIT,COL,0,5,5-0,COL,9,0,33,38,71,129,130,259,5,12,17,2,2:55
4432,415597,2015-08-30,2015,WAS,MIA,7,4,7-4,WAS,9,1,38,37,75,117,154,271,17,11,28,2,3:05
4433,415596,2015-08-30,2015,TBA,KCA,3,2,3-2,TBA,9,1,34,35,69,137,139,276,11,9,20,0,2:57
4434,415595,2015-08-30,2015,MIN,HOU,7,5,7-5,MIN,9,1,37,38,75,150,152,302,13,14,27,2,3:03
4435,415602,2015-08-30,2015,SFN,SLN,5,7,7-5,SLN,9,0,37,41,78,149,138,287,12,16,28,5,3:08
4436,415600,2015-08-30,2015,PHI,SDN,4,9,9-4,SDN,9,0,35,46,81,179,141,320,12,19,31,2,3:13
4437,415598,2015-08-30,2015,ATL,NYA,6,20,20-6,NYA,9,0,45,57,102,202,175,377,18,31,49,5,3:46
4438,415599,2015-08-30,2015,ARI,OAK,4,7,7-4,OAK,11,0,48,54,102,190,189,379,14,24,38,2,4:03
4439,415601,2015-08-30,2015,CHA,SEA,6,5,6-5,CHA,11,0,54,47,101,200,193,393,22,16,38,4,4:01
4440,415613,2015-08-31,2015,SDN,TEX,7,0,7-0,SDN,9,1,39,33,72,126,138,264,15,6,21,1,2:39
4441,415609,2015-08-31,2015,NYN,PHI,3,1,3-1,NYN,9,1,29,33,62,125,104,229,6,8,14,0,2:23
4442,415606,2015-08-31,2015,TOR,CLE,2,4,4-2,CLE,9,0,38,35,73,130,144,274,13,9,22,1,2:56
4443,415610,2015-08-31,2015,HOU,SEA,8,3,8-3,HOU,9,1,37,35,72,146,140,286,14,9,23,0,2:48
4444,415608,2015-08-31,2015,BOS,NYA,4,3,4-3,BOS,9,1,35,44,79,170,142,312,12,18,30,2,3:44
4445,415604,2015-08-31,2015,COL,ARI,5,4,5-4,COL,9,0,43,37,80,129,164,293,18,11,29,3,3:30
4446,415612,2015-08-31,2015,BAL,TBA,3,6,6-3,TBA,9,0,41,37,78,129,178,307,13,11,24,1,3:03
4447,415614,2015-08-31,2015,SLN,WAS,8,5,8-5,SLN,9,1,38,41,79,159,148,307,18,15,33,1,3:07
4448,415611,2015-08-31,2015,LAN,SFN,5,4,5-4,LAN,14,0,57,59,116,231,221,452,21,19,40,4,5:29
4449,415603,2015-08-31,2015,OAK,ANA,11,5,11-5,OAK,9,1,39,40,79,160,168,328,15,15,30,6,3:34 (:10 delay)
4450,415605,2015-08-31,2015,CHN,CIN,6,13,13-6,CIN,9,0,37,47,84,189,147,336,12,20,32,4,3:22
4451,415607,2015-08-31,2015,ATL,MIA,0,4,4-0,MIA,9,0,32,37,69,144,148,292,8,11,19,2,2:54
4452,414027,2015-09-01,2015,COL,ARI,4,6,6-4,ARI,9,0,37,39,76,135,123,258,13,16,29,4,3:02
4453,414027,2015-09-01,2015,COL,ARI,4,6,6-4,ARI,9,0,37,39,76,135,123,258,13,16,29,4,3:02
4454,415621,2015-09-01,2015,ATL,MIA,1,7,7-1,MIA,9,0,37,41,78,157,121,278,12,14,26,2,2:47
4455,415622,2015-09-01,2015,BOS,NYA,1,3,3-1,NYA,9,0,35,33,68,121,135,256,9,6,15,2,2:41
4456,415626,2015-09-01,2015,LAN,SFN,2,1,2-1,LAN,9,1,34,33,67,129,122,251,10,6,16,2,2:47
4457,415624,2015-09-01,2015,MIL,PIT,7,4,7-4,MIL,9,1,35,34,69,126,164,290,14,8,22,2,2:55
4458,415617,2015-09-01,2015,MIN,CHA,8,6,8-6,MIN,9,1,41,39,80,136,152,288,16,13,29,4,3:06
4459,415618,2015-09-01,2015,CHN,CIN,5,4,5-4,CHN,9,1,36,34,70,141,163,304,12,8,20,3,3:03
4460,415627,2015-09-01,2015,BAL,TBA,2,11,11-2,TBA,9,0,33,47,80,178,129,307,7,21,28,2,3:01
4461,415619,2015-09-01,2015,TOR,CLE,5,3,5-3,TOR,10,0,36,41,77,147,133,280,9,12,21,1,3:06
4462,415625,2015-09-01,2015,HOU,SEA,5,7,7-5,SEA,9,0,40,41,81,187,149,336,14,16,30,2,3:25
4463,415616,2015-09-01,2015,COL,ARI,3,5,5-3,ARI,9,0,35,39,74,154,141,295,9,12,21,2,3:08
4464,415620,2015-09-01,2015,KCA,DET,5,6,6-5,DET,9,0,39,39,78,153,145,298,12,13,25,3,3:12
4465,415615,2015-09-01,2015,OAK,ANA,2,6,6-2,ANA,9,0,36,38,74,157,136,293,9,13,22,2,3:04
4466,415629,2015-09-01,2015,SLN,WAS,8,5,8-5,SLN,9,0,44,42,86,163,164,327,19,14,33,3,3:28
4467,415623,2015-09-01,2015,NYN,PHI,8,14,14-8,PHI,9,0,42,44,86,153,165,318,16,16,32,3,3:17
4468,415628,2015-09-01,2015,SDN,TEX,6,8,8-6,TEX,9,0,43,42,85,162,179,341,17,15,32,5,3:40
4469,415641,2015-09-02,2015,LAN,SFN,2,1,2-1,LAN,9,1,29,32,61,132,89,221,7,7,14,0,2:31
4470,415632,2015-09-02,2015,MIN,CHA,3,0,3-0,MIN,9,1,33,31,64,113,139,252,11,3,14,3,2:34
4471,415634,2015-09-02,2015,TOR,CLE,5,1,5-1,TOR,9,1,36,29,65,92,154,246,12,4,16,3,2:34
4472,415635,2015-09-02,2015,KCA,DET,12,1,12-1,KCA,9,1,41,33,74,125,136,261,20,7,27,2,2:47
4473,415640,2015-09-02,2015,HOU,SEA,3,8,8-3,SEA,9,0,36,46,82,196,143,339,11,21,32,5,3:40
4474,415636,2015-09-02,2015,ATL,MIA,3,7,7-3,MIA,9,0,37,40,77,143,148,291,12,15,27,0,3:05
4475,415644,2015-09-02,2015,SLN,WAS,3,4,4-3,WAS,9,0,43,37,80,143,160,303,16,10,26,3,3:34
4476,415630,2015-09-02,2015,OAK,ANA,4,9,9-4,ANA,9,0,37,42,79,149,120,269,10,14,24,2,2:53
4477,415639,2015-09-02,2015,MIL,PIT,9,4,9-4,MIL,9,1,41,35,76,134,166,300,18,9,27,3,3:07
4478,415633,2015-09-02,2015,CHN,CIN,4,7,7-4,CIN,9,0,37,41,78,144,165,309,11,13,24,3,3:10
4479,415631,2015-09-02,2015,COL,ARI,9,4,9-4,COL,9,1,42,38,80,129,148,277,19,13,32,5,3:38
4480,415642,2015-09-02,2015,BAL,TBA,7,6,7-6,BAL,11,0,40,47,87,164,151,315,13,18,31,4,3:36
4481,415643,2015-09-02,2015,SDN,TEX,3,4,4-3,TEX,10,0,39,45,84,189,143,332,10,15,25,0,3:33
4482,415637,2015-09-02,2015,BOS,NYA,8,13,13-8,NYA,9,0,45,44,89,168,179,347,18,20,38,6,3:33
4483,415638,2015-09-02,2015,NYN,PHI,9,4,9-4,NYN,9,1,40,37,77,134,137,271,19,11,30,1,2:53
4484,415650,2015-09-03,2015,COL,SFN,11,3,11-3,COL,9,1,42,32,74,103,145,248,19,7,26,2,2:48 (:21 delay)
4485,415649,2015-09-03,2015,MIL,PIT,5,3,5-3,MIL,9,1,36,39,75,152,123,275,15,12,27,2,3:12
4486,415648,2015-09-03,2015,SDN,LAN,10,7,10-7,SDN,9,1,38,40,78,144,138,282,16,13,29,4,3:22
4487,415646,2015-09-03,2015,MIN,CHA,4,6,6-4,CHA,9,0,39,41,80,164,151,315,11,16,27,4,3:26
4488,415645,2015-09-03,2015,WAS,ATL,15,1,15-1,WAS,9,1,50,33,83,136,190,326,27,8,35,3,3:02
4489,415647,2015-09-03,2015,KCA,DET,15,7,15-7,KCA,9,1,47,44,91,174,178,352,25,17,42,3,3:58
4490,415663,2015-09-04,2015,COL,SFN,2,1,2-1,COL,9,1,32,33,65,129,122,251,9,9,18,4,2:52
4491,415664,2015-09-04,2015,NYA,TBA,5,2,5-2,NYA,9,1,30,38,68,128,132,260,6,12,18,4,2:36
4492,415655,2015-09-04,2015,DET,CLE,1,8,8-1,CLE,9,0,32,41,73,162,104,266,5,17,22,1,2:40
4493,415654,2015-09-04,2015,KCA,CHA,1,12,12-1,CHA,9,0,33,44,77,151,121,272,8,19,27,1,2:40
4494,415658,2015-09-04,2015,HOU,MIN,8,0,8-0,HOU,9,1,37,33,70,127,131,258,14,8,22,1,2:35
4495,415660,2015-09-04,2015,BOS,PHI,7,5,7-5,BOS,9,1,36,40,76,169,121,290,12,16,28,4,3:22
4496,415665,2015-09-04,2015,ANA,TEX,5,2,5-2,ANA,9,1,36,39,75,134,138,272,13,17,30,2,2:58
4497,415652,2015-09-04,2015,WAS,ATL,5,2,5-2,WAS,10,0,41,42,83,141,176,317,17,14,31,3,3:23
4498,415653,2015-09-04,2015,TOR,BAL,2,10,10-2,BAL,9,0,41,44,85,128,159,287,15,16,31,3,2:56
4499,415656,2015-09-04,2015,SDN,LAN,4,8,8-4,LAN,9,0,33,46,79,196,142,338,6,19,25,2,3:33
4500,415662,2015-09-04,2015,OAK,SEA,8,11,11-8,SEA,9,0,43,41,84,177,150,327,19,16,35,5,3:38
4501,415661,2015-09-04,2015,SLN,PIT,3,9,9-3,PIT,9,0,37,46,83,171,166,337,10,20,30,3,3:21
4502,415651,2015-09-04,2015,CHN,ARI,14,5,14-5,CHN,9,1,44,42,86,180,181,361,20,14,34,2,3:40
4503,415659,2015-09-04,2015,MIA,NYN,6,5,6-5,MIA,11,0,48,51,99,185,175,360,18,21,39,2,3:49
4504,415657,2015-09-05,2015,CIN,MIL,3,7,7-3,MIL,9,0,37,40,77,151,155,306,12,14,26,1,3:11 (1:33 delay)
4505,415666,2015-09-05,2015,CHN,ARI,2,0,2-0,CHN,9,1,32,31,63,126,138,264,9,6,15,0,2:34
4506,415675,2015-09-05,2015,BOS,PHI,9,2,9-2,BOS,9,1,40,32,72,110,151,261,17,5,22,2,2:24
4507,415670,2015-09-05,2015,DET,CLE,6,0,6-0,DET,9,1,37,33,70,133,143,276,14,7,21,2,2:53
4508,415668,2015-09-05,2015,TOR,BAL,5,1,5-1,TOR,9,1,36,33,69,127,130,257,12,8,20,0,2:42
4509,415673,2015-09-05,2015,HOU,MIN,2,3,3-2,MIN,9,0,38,34,72,145,145,290,12,8,20,0,2:45
4510,415676,2015-09-05,2015,SLN,PIT,4,1,4-1,SLN,9,1,36,38,74,151,128,279,12,10,22,0,2:56
4511,415669,2015-09-05,2015,KCA,CHA,1,6,6-1,CHA,9,0,36,39,75,141,132,273,10,14,24,2,2:52
4512,415657,2015-09-05,2015,CIN,MIL,3,7,7-3,MIL,9,0,37,40,77,151,155,306,12,14,26,1,3:11 (1:33 delay)
4513,415671,2015-09-05,2015,SDN,LAN,0,2,2-0,LAN,9,0,34,41,75,157,120,277,8,15,23,0,3:04
4514,415674,2015-09-05,2015,MIA,NYN,0,7,7-0,NYN,9,0,33,40,73,153,100,253,9,15,24,1,2:30
4515,415678,2015-09-05,2015,COL,SFN,3,7,7-3,SFN,9,0,34,44,78,154,133,287,7,20,27,3,3:08
4516,415679,2015-09-05,2015,NYA,TBA,2,3,3-2,TBA,9,0,38,40,78,169,159,328,11,14,25,5,3:35
4517,415677,2015-09-05,2015,OAK,SEA,3,8,8-3,SEA,9,0,32,44,76,170,114,284,7,21,28,1,2:57
4518,415672,2015-09-05,2015,CIN,MIL,6,8,8-6,MIL,9,0,42,44,86,158,163,321,16,19,35,2,3:27
4519,415667,2015-09-05,2015,WAS,ATL,8,2,8-2,WAS,9,1,37,38,75,163,154,317,13,10,23,3,3:07
4520,415680,2015-09-05,2015,ANA,TEX,1,2,2-1,TEX,9,0,31,39,70,156,129,285,5,13,18,1,2:45
4521,415685,2015-09-06,2015,DET,CLE,0,4,4-0,CLE,9,0,30,37,67,135,119,254,5,11,16,0,2:50
4522,415690,2015-09-06,2015,BOS,PHI,6,2,6-2,BOS,9,1,36,38,74,138,153,291,13,12,25,0,2:57
4523,415695,2015-09-06,2015,ANA,TEX,7,0,7-0,ANA,9,1,37,33,70,140,128,268,17,8,25,2,2:46
4524,415694,2015-09-06,2015,NYA,TBA,6,4,6-4,NYA,9,1,37,40,77,141,131,272,13,13,26,3,3:07
4525,415691,2015-09-06,2015,SLN,PIT,1,7,7-1,PIT,9,0,34,40,74,128,128,256,7,16,23,2,2:44
4526,415692,2015-09-06,2015,OAK,SEA,2,3,3-2,SEA,9,0,38,34,72,135,126,261,11,10,21,3,3:00
4527,415687,2015-09-06,2015,CIN,MIL,6,3,6-3,CIN,9,1,41,36,77,128,149,277,18,10,28,1,3:02
4528,415688,2015-09-06,2015,HOU,MIN,8,5,8-5,HOU,9,1,38,37,75,135,148,283,15,10,25,4,2:55
4529,415682,2015-09-06,2015,WAS,ATL,8,4,8-4,WAS,9,1,41,38,79,137,164,301,15,11,26,3,3:06
4530,415684,2015-09-06,2015,KCA,CHA,5,7,7-5,CHA,9,0,35,42,77,179,132,311,8,16,24,1,3:01
4531,415689,2015-09-06,2015,MIA,NYN,4,3,4-3,MIA,9,0,39,35,74,158,149,307,14,13,27,3,3:20
4532,415686,2015-09-06,2015,SDN,LAN,1,5,5-1,LAN,9,0,36,42,78,182,142,324,10,16,26,2,3:32
4533,415681,2015-09-06,2015,CHN,ARI,6,4,6-4,CHN,9,1,36,36,72,136,137,273,12,11,23,4,3:01
4534,415683,2015-09-06,2015,TOR,BAL,10,4,10-4,TOR,9,1,41,37,78,146,158,304,18,12,30,3,3:22
4535,415693,2015-09-06,2015,COL,SFN,4,7,7-4,SFN,9,0,36,43,79,166,136,302,10,18,28,5,3:18
4536,415696,2015-09-07,2015,PHI,ATL,2,7,7-2,ATL,9,0,33,41,74,139,121,260,7,17,24,0,2:32
4537,415699,2015-09-07,2015,CHA,CLE,2,3,3-2,CLE,9,0,36,35,71,124,129,253,9,9,18,1,2:34
4538,415706,2015-09-07,2015,CIN,PIT,3,1,3-1,CIN,9,1,31,34,65,117,124,241,7,9,16,2,2:38
4539,415710,2015-09-07,2015,BOS,TOR,11,4,11-4,BOS,9,1,42,34,76,131,138,269,19,11,30,4,2:48
4540,415709,2015-09-07,2015,SEA,TEX,0,3,3-0,TEX,9,0,34,36,70,148,134,282,9,12,21,3,3:00
4541,415708,2015-09-07,2015,DET,TBA,5,4,5-4,DET,9,1,35,40,75,146,129,275,14,14,28,3,2:57
4542,415707,2015-09-07,2015,ARI,SFN,6,1,6-1,ARI,9,1,37,37,74,144,129,273,17,10,27,1,2:54
4543,415704,2015-09-07,2015,KCA,MIN,2,6,6-2,MIN,9,0,34,44,78,171,131,302,10,17,27,1,3:02
4544,415698,2015-09-07,2015,SLN,CHN,0,9,9-0,CHN,9,0,34,42,76,150,133,283,10,16,26,1,2:47
4545,415703,2015-09-07,2015,MIA,MIL,1,9,9-1,MIL,9,0,32,47,79,177,130,307,6,21,27,2,3:01
4546,415701,2015-09-07,2015,OAK,HOU,10,9,10-9,OAK,9,1,42,40,82,136,185,321,19,13,32,6,3:53
4547,415697,2015-09-07,2015,NYA,BAL,8,6,8-6,NYA,9,1,39,41,80,161,156,317,14,15,29,1,3:10
4548,415700,2015-09-07,2015,SDN,COL,4,6,6-4,COL,9,0,38,36,74,144,149,293,14,10,24,3,3:19
4549,415705,2015-09-07,2015,WAS,NYN,5,8,8-5,NYN,9,0,40,40,80,174,143,317,15,13,28,6,3:26
4550,415702,2015-09-07,2015,ANA,LAN,5,7,7-5,LAN,9,0,40,49,89,185,153,338,13,23,36,9,3:52
4551,415711,2015-09-08,2015,PHI,ATL,5,0,5-0,PHI,9,1,31,36,67,120,115,235,11,10,21,3,2:30
4552,415716,2015-09-08,2015,OAK,HOU,4,0,4-0,OAK,9,1,33,34,67,124,121,245,10,7,17,0,2:33
4553,415715,2015-09-08,2015,SDN,COL,2,1,2-1,SDN,9,0,36,32,68,119,139,258,11,6,17,0,2:40
4554,415714,2015-09-08,2015,CHA,CLE,7,4,7-4,CHA,9,1,37,38,75,144,130,274,15,10,25,3,2:54 (1:04 delay)
4555,415722,2015-09-08,2015,ARI,SFN,2,6,6-2,SFN,9,0,31,39,70,148,112,260,5,12,17,4,2:49
4556,415712,2015-09-08,2015,NYA,BAL,1,2,2-1,BAL,9,0,35,35,70,118,160,278,8,10,18,2,2:58
4557,415719,2015-09-08,2015,KCA,MIN,4,2,4-2,KCA,9,1,31,32,63,118,101,219,8,7,15,0,2:29
4558,415725,2015-09-08,2015,BOS,TOR,1,5,5-1,TOR,10,0,35,44,79,169,132,301,6,16,22,5,3:23
4559,415717,2015-09-08,2015,ANA,LAN,4,6,6-4,LAN,9,0,37,41,78,148,146,294,10,14,24,3,3:12
4560,415720,2015-09-08,2015,WAS,NYN,7,8,8-7,NYN,9,0,40,40,80,176,137,313,14,14,28,4,3:20
4561,415724,2015-09-08,2015,SEA,TEX,6,9,9-6,TEX,9,0,37,43,80,175,141,316,11,14,25,4,3:12
4562,415721,2015-09-08,2015,CIN,PIT,3,7,7-3,PIT,9,0,39,42,81,160,169,329,12,15,27,1,3:19
4563,415713,2015-09-08,2015,SLN,CHN,5,8,8-5,CHN,9,0,39,42,81,167,150,317,14,16,30,3,3:07
4564,415718,2015-09-08,2015,MIA,MIL,6,4,6-4,MIA,9,1,37,44,81,195,150,345,14,18,32,4,3:37
4565,415723,2015-09-08,2015,DET,TBA,8,7,8-7,DET,13,0,54,54,108,202,202,404,17,17,34,9,5:03
4566,415732,2015-09-09,2015,ANA,LAN,3,2,3-2,ANA,9,1,32,33,65,122,127,249,9,8,17,2,2:50
4567,415737,2015-09-09,2015,ARI,SFN,2,1,2-1,ARI,9,1,33,36,69,143,106,249,10,12,22,5,2:49
4568,415733,2015-09-09,2015,MIA,MIL,5,2,5-2,MIA,9,1,34,31,65,116,152,268,12,7,19,1,2:43
4569,415727,2015-09-09,2015,NYA,BAL,3,5,5-3,BAL,9,0,32,42,74,162,118,280,5,15,20,4,3:01
4570,415735,2015-09-09,2015,WAS,NYN,3,5,5-3,NYN,9,0,35,35,70,117,127,244,9,9,18,1,2:37
4571,415739,2015-09-09,2015,SEA,TEX,6,0,6-0,SEA,9,1,35,32,67,128,110,238,13,5,18,2,2:26
4572,415738,2015-09-09,2015,DET,TBA,0,8,8-0,TBA,9,0,34,41,75,156,139,295,9,17,26,3,3:04
4573,415726,2015-09-09,2015,PHI,ATL,1,8,8-1,ATL,9,0,34,49,83,154,129,283,7,26,33,2,2:52
4574,415729,2015-09-09,2015,CHA,CLE,4,6,6-4,CLE,9,0,36,40,76,145,151,296,8,14,22,3,2:58
4575,415728,2015-09-09,2015,SLN,CHN,4,3,4-3,SLN,9,1,32,39,71,147,130,277,8,12,20,2,2:47
4576,415736,2015-09-09,2015,CIN,PIT,4,5,5-4,PIT,9,0,37,36,73,126,171,297,10,10,20,2,3:04
4577,415730,2015-09-09,2015,SDN,COL,11,4,11-4,SDN,9,1,42,40,82,147,174,321,21,15,36,1,3:16
4578,415731,2015-09-09,2015,OAK,HOU,5,11,11-5,HOU,9,0,38,46,84,182,158,340,11,18,29,3,3:38
4579,415740,2015-09-09,2015,BOS,TOR,10,4,10-4,BOS,9,1,40,37,77,171,161,332,19,12,31,4,3:31
4580,415734,2015-09-09,2015,KCA,MIN,2,3,3-2,MIN,12,0,46,47,93,179,185,364,12,14,26,2,4:03
4581,415023,2015-09-10,2015,SDN,COL,3,4,4-3,COL,9,0,35,32,67,113,149,262,9,5,14,0,2:47
4582,415746,2015-09-10,2015,SEA,TEX,5,0,5-0,SEA,9,1,34,34,68,123,113,236,11,9,20,0,2:24
4583,415023,2015-09-10,2015,SDN,COL,3,4,4-3,COL,9,0,35,32,67,113,149,262,9,5,14,0,2:47
4584,415742,2015-09-10,2015,CLE,DET,7,5,7-5,CLE,9,1,40,39,79,136,119,255,15,15,30,4,3:11
4585,415744,2015-09-10,2015,ATL,NYN,2,7,7-2,NYN,9,0,36,42,78,174,131,305,10,18,28,2,3:05 (2:20 delay)
4586,415745,2015-09-10,2015,CIN,SLN,11,0,11-0,CIN,9,1,43,36,79,152,168,320,18,11,29,3,3:16
4587,415743,2015-09-10,2015,PIT,MIL,4,6,6-4,MIL,13,0,53,56,109,199,212,411,18,18,36,4,4:44
4588,415758,2015-09-11,2015,TEX,OAK,4,0,4-0,TEX,9,1,35,29,64,97,124,221,11,2,13,1,2:20
4589,415762,2015-09-11,2015,MIA,WAS,2,1,2-1,MIA,9,1,30,37,67,161,107,268,8,11,19,3,2:43
4590,415741,2015-09-11,2015,PHI,CHN,3,7,7-3,CHN,9,0,34,43,77,144,130,274,8,15,23,5,2:56
4591,415752,2015-09-11,2015,ANA,HOU,3,2,3-2,ANA,9,1,32,33,65,137,138,275,9,8,17,0,2:43
4592,415749,2015-09-11,2015,PHI,CHN,1,5,5-1,CHN,9,0,36,40,76,163,125,288,9,12,21,1,2:54
4593,415741,2015-09-11,2015,PHI,CHN,3,7,7-3,CHN,9,0,34,43,77,144,130,274,8,15,23,5,2:56
4594,415760,2015-09-11,2015,CIN,SLN,4,2,4-2,CIN,9,1,36,37,73,138,121,259,13,12,25,0,2:30 (1:07 delay)
4595,415759,2015-09-11,2015,SFN,SDN,9,1,9-1,SFN,9,1,44,32,76,118,179,297,21,5,26,3,3:02
4596,415755,2015-09-11,2015,PIT,MIL,6,3,6-3,PIT,9,1,38,35,73,142,148,290,14,10,24,2,3:12
4597,415757,2015-09-11,2015,ATL,NYN,1,5,5-1,NYN,9,0,38,41,79,156,140,296,11,17,28,3,3:10
4598,415750,2015-09-11,2015,SEA,COL,2,4,4-2,COL,9,0,38,39,77,141,144,285,12,13,25,4,3:11
4599,415748,2015-09-11,2015,TBA,BOS,8,4,8-4,TBA,9,1,37,42,79,196,139,335,13,16,29,4,3:26
4600,415756,2015-09-11,2015,CHA,MIN,2,6,6-2,MIN,9,0,34,43,77,186,134,320,9,19,28,1,2:58
4601,415761,2015-09-11,2015,NYA,TOR,5,11,11-5,TOR,9,0,38,45,83,172,168,340,10,19,29,3,3:39
4602,415753,2015-09-11,2015,BAL,KCA,14,8,14-8,BAL,9,1,45,43,88,164,207,371,20,15,35,8,3:59
4603,415754,2015-09-11,2015,ARI,LAN,12,4,12-4,ARI,9,1,43,38,81,157,171,328,18,11,29,1,3:23
4604,415760,2015-09-11,2015,CIN,SLN,4,2,4-2,CIN,9,1,36,37,73,138,121,259,13,12,25,0,2:30 (1:07 delay)
4605,415777,2015-09-12,2015,MIA,WAS,2,0,2-0,MIA,9,1,34,31,65,134,107,241,14,5,19,3,2:28
4606,415765,2015-09-12,2015,SEA,COL,7,2,7-2,SEA,9,1,37,34,71,122,144,266,12,7,19,4,2:37
4607,415770,2015-09-12,2015,PIT,MIL,10,2,10-2,PIT,9,1,42,35,77,126,153,279,19,9,28,2,2:55
4608,415772,2015-09-12,2015,ATL,NYN,4,6,6-4,NYN,9,0,32,40,72,140,131,271,6,16,22,3,2:57
4609,415764,2015-09-12,2015,PHI,CHN,7,5,7-5,PHI,9,0,36,39,75,142,148,290,10,12,22,4,3:12 (:50 delay)
4610,415763,2015-09-12,2015,TBA,BOS,4,10,10-4,BOS,9,0,36,44,80,164,151,315,10,17,27,0,2:56
4611,415774,2015-09-12,2015,SFN,SDN,8,0,8-0,SFN,9,1,39,28,67,111,157,268,16,1,17,1,2:35
4612,415769,2015-09-12,2015,ARI,LAN,5,9,9-5,LAN,9,0,42,47,89,188,163,351,17,20,37,3,3:52
4613,415768,2015-09-12,2015,BAL,KCA,6,14,14-6,KCA,9,0,45,45,90,183,183,366,20,20,40,5,3:40 (3:02 delay)
4614,415747,2015-09-12,2015,NYA,TOR,7,10,10-7,TOR,9,0,43,46,89,182,176,358,16,19,35,4,3:31 (:33 delay)
4615,415747,2015-09-12,2015,NYA,TOR,7,10,10-7,TOR,9,0,43,46,89,182,176,358,16,19,35,4,3:31 (:33 delay)
4616,415776,2015-09-12,2015,NYA,TOR,5,9,9-5,TOR,11,0,46,49,95,209,190,399,14,18,32,9,4:32
4617,415767,2015-09-12,2015,ANA,HOU,3,2,3-2,ANA,9,1,36,34,70,123,138,261,12,8,20,0,2:41
4618,415775,2015-09-12,2015,CIN,SLN,5,1,5-1,CIN,9,1,37,34,71,158,139,297,12,8,20,2,3:02
4619,415771,2015-09-12,2015,CHA,MIN,8,2,8-2,CHA,9,1,42,37,79,172,160,332,17,10,27,7,3:29
4620,415773,2015-09-12,2015,TEX,OAK,3,5,5-3,OAK,9,0,41,40,81,169,165,334,14,13,27,5,3:26
4621,415792,2015-09-13,2015,MIA,WAS,0,5,5-0,WAS,9,0,32,43,75,151,120,271,6,17,23,1,2:50
4622,415784,2015-09-13,2015,ARI,LAN,3,4,4-3,LAN,9,0,33,43,76,154,126,280,8,17,25,1,2:56
4623,415783,2015-09-13,2015,BAL,KCA,8,2,8-2,BAL,9,1,38,33,71,135,142,277,15,7,22,2,2:37
4624,415781,2015-09-13,2015,CLE,DET,7,2,7-2,CLE,9,1,37,39,76,163,144,307,16,13,29,4,3:20
4625,415782,2015-09-13,2015,ANA,HOU,3,5,5-3,HOU,9,0,33,43,76,169,132,301,6,17,23,3,3:14
4626,415779,2015-09-13,2015,PHI,CHN,7,4,7-4,PHI,9,1,38,40,78,170,143,313,17,11,28,0,3:04
4627,415780,2015-09-13,2015,SEA,COL,2,3,3-2,COL,9,0,33,39,72,162,140,302,9,12,21,2,3:13
4628,415790,2015-09-13,2015,CIN,SLN,2,9,9-2,SLN,9,0,36,47,83,194,143,337,11,19,30,2,3:18
4629,415751,2015-09-13,2015,CLE,DET,2,9,9-2,DET,9,0,37,45,82,182,178,360,11,20,31,3,3:52
4630,415785,2015-09-13,2015,PIT,MIL,7,6,7-6,PIT,11,0,46,47,93,169,173,342,14,17,31,1,3:47 (:21 delay)
4631,415751,2015-09-13,2015,CLE,DET,2,9,9-2,DET,9,0,37,45,82,182,178,360,11,20,31,3,3:52
4632,415778,2015-09-13,2015,TBA,BOS,0,2,2-0,BOS,13,0,47,51,98,191,187,378,10,16,26,4,4:05
4633,415787,2015-09-13,2015,ATL,NYN,7,10,10-7,NYN,10,0,48,48,96,184,150,334,17,20,37,5,3:38
4634,415791,2015-09-13,2015,NYA,TOR,5,0,5-0,NYA,9,1,33,30,63,128,121,249,9,4,13,2,2:40
4635,415789,2015-09-13,2015,SFN,SDN,10,3,10-3,SFN,9,1,41,34,75,120,169,289,17,7,24,4,3:00
4636,415786,2015-09-13,2015,CHA,MIN,0,7,7-0,MIN,9,0,32,44,76,186,128,314,6,18,24,1,2:57
4637,415788,2015-09-13,2015,TEX,OAK,12,4,12-4,TEX,9,1,45,41,86,192,168,360,20,13,33,7,3:52
4638,415796,2015-09-14,2015,LAN,COL,4,1,4-1,LAN,9,1,36,33,69,135,140,275,14,7,21,3,3:02
4639,415798,2015-09-14,2015,TEX,HOU,5,3,5-3,TEX,9,1,34,41,75,155,116,271,10,13,23,3,3:03
4640,415794,2015-09-14,2015,BAL,BOS,2,0,2-0,BAL,9,1,36,35,71,147,152,299,12,8,20,4,2:56
4641,415800,2015-09-14,2015,NYN,MIA,4,3,4-3,NYN,9,1,34,35,69,138,136,274,13,10,23,0,2:50
4642,415795,2015-09-14,2015,SFN,CIN,5,3,5-3,SFN,9,1,33,38,71,139,138,277,9,11,20,3,2:52
4643,415799,2015-09-14,2015,CLE,KCA,8,3,8-3,CLE,9,1,40,39,79,146,162,308,17,13,30,2,3:21
4644,415797,2015-09-14,2015,MIN,DET,7,1,7-1,MIN,9,1,39,38,77,138,154,292,17,11,28,2,2:56
4645,415793,2015-09-14,2015,SEA,ANA,10,1,10-1,SEA,9,1,42,31,73,125,168,293,17,6,23,2,2:59
4646,415801,2015-09-14,2015,TBA,NYA,1,4,4-1,NYA,9,0,35,34,69,130,159,289,8,10,18,4,3:08
4647,415803,2015-09-14,2015,ARI,SDN,3,10,10-3,SDN,9,0,39,43,82,180,141,321,12,17,29,2,3:29
4648,415804,2015-09-14,2015,PHI,WAS,7,8,8-7,WAS,11,0,47,49,96,193,173,366,13,19,32,3,3:54
4649,415802,2015-09-14,2015,CHA,OAK,8,7,8-7,CHA,14,0,67,56,123,222,273,495,29,13,42,3,5:09
4650,415228,2015-09-15,2015,PIT,CHN,5,4,5-4,PIT,9,1,35,35,70,139,138,277,12,8,20,3,2:51
4651,415819,2015-09-15,2015,PHI,WAS,0,4,4-0,WAS,9,0,29,38,67,144,115,259,2,12,14,1,2:35
4652,415812,2015-09-15,2015,CLE,KCA,0,2,2-0,KCA,9,0,36,31,67,110,135,245,9,5,14,1,2:34
4653,415807,2015-09-15,2015,PIT,CHN,1,2,2-1,CHN,9,0,32,38,70,139,111,250,7,11,18,1,2:44
4654,415818,2015-09-15,2015,ATL,TOR,3,2,3-2,ATL,9,0,34,37,71,156,122,278,12,10,22,4,2:45
4655,415805,2015-09-15,2015,SEA,ANA,3,4,4-3,ANA,9,0,36,35,71,120,140,260,10,9,19,0,2:40
4656,415813,2015-09-15,2015,NYN,MIA,3,9,9-3,MIA,9,0,40,40,80,147,162,309,14,18,32,3,3:16
4657,415228,2015-09-15,2015,PIT,CHN,5,4,5-4,PIT,9,1,35,35,70,139,138,277,12,8,20,3,2:51
4658,415817,2015-09-15,2015,MIL,SLN,1,3,3-1,SLN,10,0,37,41,78,179,147,326,10,12,22,1,3:14
4659,415816,2015-09-15,2015,ARI,SDN,6,4,6-4,ARI,9,1,37,39,76,158,157,315,14,13,27,6,3:31
4660,415814,2015-09-15,2015,TBA,NYA,6,3,6-3,TBA,9,1,38,38,76,160,154,314,16,9,25,4,3:14
4661,415811,2015-09-15,2015,TEX,HOU,6,5,6-5,TEX,9,0,41,41,82,159,164,323,18,15,33,8,3:46
4662,415810,2015-09-15,2015,MIN,DET,4,5,5-4,DET,9,0,40,38,78,151,153,304,15,13,28,5,3:29
4663,415806,2015-09-15,2015,BAL,BOS,6,5,6-5,BAL,13,0,48,53,101,218,173,391,12,18,30,7,4:20
4664,415815,2015-09-15,2015,CHA,OAK,6,17,17-6,OAK,9,0,41,55,96,230,146,376,17,28,45,3,3:31
4665,415808,2015-09-15,2015,SFN,CIN,8,9,9-8,CIN,10,0,46,45,91,175,196,371,17,16,33,5,4:02
4666,415809,2015-09-15,2015,LAN,COL,4,5,5-4,COL,16,0,63,60,123,207,246,453,20,13,33,5,5:23
4667,415824,2015-09-16,2015,LAN,COL,2,0,2-0,LAN,9,1,31,29,60,92,103,195,7,2,9,0,2:08
4668,415820,2015-09-16,2015,SEA,ANA,3,1,3-1,SEA,9,1,30,34,64,130,107,237,10,7,17,2,2:40
4669,415827,2015-09-16,2015,CLE,KCA,5,1,5-1,CLE,9,1,37,35,72,132,158,290,14,8,22,1,2:47
4670,415828,2015-09-16,2015,NYN,MIA,0,6,6-0,MIA,9,0,32,39,71,137,133,270,5,15,20,3,2:46
4671,415831,2015-09-16,2015,ARI,SDN,3,4,4-3,SDN,9,0,35,36,71,158,124,282,10,10,20,2,2:50
4672,415834,2015-09-16,2015,PHI,WAS,2,12,12-2,WAS,9,0,33,44,77,160,133,293,7,21,28,0,2:49
4673,415829,2015-09-16,2015,TBA,NYA,1,3,3-1,NYA,9,0,38,37,75,157,144,301,11,10,21,2,3:07
4674,415821,2015-09-16,2015,BAL,BOS,1,10,10-1,BOS,9,0,36,43,79,155,139,294,9,16,25,2,2:51
4675,415833,2015-09-16,2015,ATL,TOR,1,9,9-1,TOR,9,0,37,45,82,175,137,312,11,19,30,2,3:08
4676,415823,2015-09-16,2015,SFN,CIN,5,3,5-3,SFN,9,1,39,40,79,142,150,292,16,15,31,4,3:10
4677,415830,2015-09-16,2015,CHA,OAK,9,4,9-4,CHA,9,1,38,39,77,166,133,299,14,13,27,2,2:56
4678,415832,2015-09-16,2015,MIL,SLN,4,5,5-4,SLN,9,0,36,42,78,180,129,309,9,15,24,1,3:05
4679,415826,2015-09-16,2015,TEX,HOU,14,3,14-3,TEX,9,1,43,37,80,134,155,289,19,12,31,1,2:41
4680,415822,2015-09-16,2015,PIT,CHN,2,3,3-2,CHN,12,0,41,51,92,192,173,365,9,17,26,1,4:17
4681,415825,2015-09-16,2015,MIN,DET,4,7,7-4,DET,12,0,47,49,96,183,199,382,13,17,30,4,4:17 (:56 delay)
4682,415843,2015-09-17,2015,ATL,TOR,0,5,5-0,TOR,9,0,30,40,70,152,108,260,5,14,19,0,2:36
4683,415842,2015-09-17,2015,MIL,SLN,3,6,6-3,SLN,9,0,35,40,75,137,118,255,10,13,23,3,2:51
4684,415841,2015-09-17,2015,CHA,OAK,2,4,4-2,OAK,9,0,37,34,71,127,148,275,11,9,20,0,2:46
4685,415836,2015-09-17,2015,TBA,BAL,3,4,4-3,BAL,9,0,37,35,72,138,154,292,11,9,20,2,2:56
4686,415839,2015-09-17,2015,CLE,KCA,4,8,8-4,KCA,9,0,43,43,86,148,148,296,14,15,29,4,3:20
4687,415838,2015-09-17,2015,TEX,HOU,8,2,8-2,TEX,9,1,39,36,75,123,152,275,16,11,27,2,3:03
4688,415840,2015-09-17,2015,WAS,MIA,4,6,6-4,MIA,9,0,38,37,75,132,169,301,11,11,22,4,3:13
4689,415837,2015-09-17,2015,PIT,CHN,6,9,9-6,CHN,9,0,37,48,85,165,136,301,12,23,35,3,3:05
4690,415835,2015-09-17,2015,MIN,ANA,8,11,11-8,ANA,9,0,44,48,92,187,185,372,15,21,36,4,3:56
4691,415848,2015-09-18,2015,CLE,CHA,12,1,12-1,CLE,9,1,43,37,80,128,150,278,19,10,29,2,2:46
4692,415845,2015-09-18,2015,SFN,ARI,0,2,2-0,ARI,9,0,33,34,67,131,144,275,8,9,17,3,2:56
4693,415847,2015-09-18,2015,TOR,BOS,6,1,6-1,TOR,9,1,35,33,68,131,137,268,11,9,20,0,2:32
4694,415852,2015-09-18,2015,NYN,NYA,5,1,5-1,NYN,9,1,33,38,71,149,123,272,9,11,20,2,2:56
4695,415846,2015-09-18,2015,TBA,BAL,8,6,8-6,TBA,9,1,39,35,74,149,147,296,18,10,28,3,2:51
4696,415856,2015-09-18,2015,COL,SDN,7,4,7-4,COL,9,1,36,40,76,155,163,318,12,12,24,2,3:12
4697,415857,2015-09-18,2015,TEX,SEA,1,3,3-1,SEA,9,0,37,35,72,141,164,305,12,12,24,4,3:15
4698,415849,2015-09-18,2015,MIL,CIN,3,5,5-3,CIN,9,0,38,43,81,175,149,324,12,18,30,3,3:20
4699,415851,2015-09-18,2015,WAS,MIA,5,4,5-4,WAS,10,0,44,41,85,158,166,324,19,14,33,4,3:22
4700,415858,2015-09-18,2015,CHN,SLN,8,3,8-3,CHN,9,1,46,36,82,131,203,334,24,9,33,7,3:26
4701,415850,2015-09-18,2015,DET,KCA,5,4,5-4,DET,12,0,52,45,97,159,201,360,20,12,32,2,4:09 (:23 delay)
4702,415854,2015-09-18,2015,ATL,PHI,2,1,2-1,ATL,9,1,29,40,69,176,90,266,7,12,19,3,2:58
4703,415855,2015-09-18,2015,LAN,PIT,6,2,6-2,LAN,9,1,35,35,70,124,131,255,14,8,22,3,2:48
4704,415853,2015-09-18,2015,HOU,OAK,3,4,4-3,OAK,9,0,34,38,72,159,137,296,7,11,18,1,3:13
4705,415861,2015-09-19,2015,TBA,BAL,1,2,2-1,BAL,9,0,33,35,68,115,122,237,8,10,18,0,2:29
4706,415859,2015-09-19,2015,MIN,ANA,2,5,5-2,ANA,9,0,36,36,72,132,125,257,9,12,21,2,2:56
4707,415867,2015-09-19,2015,NYN,NYA,0,5,5-0,NYA,9,0,34,36,70,139,158,297,8,9,17,4,3:11
4708,415862,2015-09-19,2015,TOR,BOS,6,7,7-6,BOS,9,0,41,43,84,155,161,316,16,17,33,8,3:08
4709,415869,2015-09-19,2015,ATL,PHI,2,1,2-1,ATL,9,1,33,30,63,129,118,247,10,5,15,1,2:21
4710,415844,2015-09-19,2015,MIN,ANA,3,4,4-3,ANA,12,0,45,50,95,195,189,384,11,15,26,7,4:15
4711,415863,2015-09-19,2015,CLE,CHA,3,4,4-3,CHA,9,0,36,39,75,165,134,299,11,11,22,5,3:19
4712,415866,2015-09-19,2015,WAS,MIA,5,2,5-2,WAS,9,1,37,37,74,138,134,272,14,12,26,2,2:45
4713,415870,2015-09-19,2015,LAN,PIT,2,3,3-2,PIT,9,0,32,36,68,129,125,254,8,14,22,2,2:47
4714,415860,2015-09-19,2015,SFN,ARI,0,6,6-0,ARI,9,0,34,48,82,161,121,282,8,22,30,1,3:02
4715,415864,2015-09-19,2015,MIL,CIN,7,9,9-7,CIN,9,0,40,44,84,177,159,336,15,17,32,2,3:39
4716,415872,2015-09-19,2015,TEX,SEA,10,1,10-1,TEX,9,1,47,35,82,132,180,312,24,7,31,4,3:09
4717,415868,2015-09-19,2015,HOU,OAK,10,6,10-6,HOU,9,1,40,40,80,163,151,314,20,15,35,6,3:44
4718,415873,2015-09-19,2015,CHN,SLN,5,4,5-4,CHN,9,1,37,42,79,152,154,306,14,15,29,4,3:11
4719,415844,2015-09-19,2015,MIN,ANA,3,4,4-3,ANA,12,0,45,50,95,195,189,384,11,15,26,7,4:15
4720,415871,2015-09-19,2015,COL,SDN,10,2,10-2,COL,9,1,45,35,80,149,166,315,23,10,33,4,3:05
4721,415865,2015-09-19,2015,DET,KCA,6,5,6-5,DET,11,0,47,44,91,185,182,367,20,14,34,2,4:06
4722,415883,2015-09-20,2015,HOU,OAK,5,1,5-1,HOU,9,1,35,32,67,127,127,254,12,6,18,0,2:37
4723,415884,2015-09-20,2015,ATL,PHI,2,1,2-1,ATL,9,0,35,33,68,112,128,240,14,7,21,1,2:33
4724,415875,2015-09-20,2015,SFN,ARI,5,1,5-1,SFN,9,1,34,33,67,113,142,255,10,9,19,4,2:57
4725,415885,2015-09-20,2015,LAN,PIT,3,4,4-3,PIT,9,0,32,40,72,144,136,280,6,17,23,2,3:03
4726,415888,2015-09-20,2015,CHN,SLN,3,4,4-3,SLN,9,0,38,34,72,159,150,309,13,9,22,4,3:26
4727,415886,2015-09-20,2015,COL,SDN,4,10,10-4,SDN,9,0,36,43,79,147,161,308,9,16,25,1,3:06
4728,415887,2015-09-20,2015,TEX,SEA,2,9,9-2,SEA,9,0,36,45,81,176,148,324,9,23,32,3,3:16
4729,415881,2015-09-20,2015,WAS,MIA,13,3,13-3,WAS,9,1,41,36,77,137,145,282,18,9,27,2,2:57
4730,415879,2015-09-20,2015,MIL,CIN,8,4,8-4,MIL,9,1,45,37,82,141,155,296,21,10,31,2,3:08
4731,415878,2015-09-20,2015,CLE,CHA,6,3,6-3,CLE,9,1,38,37,75,152,166,318,15,12,27,2,3:15
4732,415877,2015-09-20,2015,TOR,BOS,3,4,4-3,BOS,9,0,36,40,76,143,143,286,9,12,21,2,2:51
4733,415876,2015-09-20,2015,TBA,BAL,7,6,7-6,TBA,9,0,43,41,84,138,171,309,19,13,32,3,3:18
4734,415874,2015-09-20,2015,MIN,ANA,8,1,8-1,MIN,9,1,42,35,77,137,164,301,19,8,27,2,3:02
4735,415880,2015-09-20,2015,DET,KCA,3,10,10-3,KCA,9,0,38,48,86,182,159,341,10,24,34,1,3:23
4736,415882,2015-09-20,2015,NYN,NYA,2,11,11-2,NYA,9,0,36,46,82,184,154,338,11,17,28,3,3:35
4737,414769,2015-09-21,2015,DET,CHA,0,2,2-0,CHA,9,0,28,32,60,122,88,210,1,9,10,0,2:12
4738,415894,2015-09-21,2015,SLN,CIN,2,1,2-1,SLN,9,1,34,34,68,122,113,235,10,10,20,2,2:34
4739,415889,2015-09-21,2015,HOU,ANA,6,3,6-3,HOU,9,1,35,37,72,151,150,301,14,11,25,4,3:02
4740,415891,2015-09-21,2015,NYN,ATL,4,0,4-0,NYN,9,1,37,34,71,125,163,288,18,7,25,2,2:51
4741,415895,2015-09-21,2015,CHN,MIL,9,5,9-5,CHN,9,1,43,37,80,151,151,302,21,9,30,2,3:08
4742,415897,2015-09-21,2015,COL,PIT,3,9,9-3,PIT,9,0,40,45,85,150,146,296,15,18,33,5,3:25
4743,415898,2015-09-21,2015,BOS,TBA,8,7,8-7,BOS,9,1,41,45,86,162,170,332,17,20,37,5,3:47
4744,414769,2015-09-21,2015,DET,CHA,0,2,2-0,CHA,9,0,28,32,60,122,88,210,1,9,10,0,2:12
4745,415893,2015-09-21,2015,DET,CHA,2,3,3-2,CHA,9,0,35,35,70,138,153,291,9,10,19,1,2:55
4746,415890,2015-09-21,2015,LAN,ARI,4,8,8-4,ARI,9,0,40,49,89,146,155,301,14,22,36,5,3:23
4747,415896,2015-09-21,2015,TOR,NYA,4,2,4-2,TOR,9,1,38,35,73,156,158,314,15,7,22,4,3:15
4748,415906,2015-09-22,2015,CHN,MIL,4,0,4-0,CHN,9,1,33,31,64,123,119,242,10,4,14,0,2:22
4749,415900,2015-09-22,2015,LAN,ARI,0,8,8-0,ARI,9,0,34,37,71,143,137,280,8,12,20,3,2:55
4750,415903,2015-09-22,2015,DET,CHA,2,1,2-1,DET,10,0,37,32,69,131,154,285,11,3,14,1,2:55
4751,415911,2015-09-22,2015,SDN,SFN,2,4,4-2,SFN,9,0,38,36,74,171,163,334,12,12,24,2,3:38
4752,415902,2015-09-22,2015,WAS,BAL,1,4,4-1,BAL,9,0,37,37,74,137,159,296,9,9,18,2,2:51
4753,415913,2015-09-22,2015,OAK,TEX,6,8,8-6,TEX,9,0,41,44,85,179,153,332,13,16,29,4,3:38
4754,415912,2015-09-22,2015,BOS,TBA,2,5,5-2,TBA,9,0,35,36,71,121,135,256,11,11,22,3,2:43
4755,415901,2015-09-22,2015,NYN,ATL,2,6,6-2,ATL,9,0,36,37,73,136,137,273,8,12,20,3,2:56
4756,415905,2015-09-22,2015,MIN,CLE,3,1,3-1,MIN,9,1,37,34,71,129,152,281,13,7,20,1,2:47
4757,415908,2015-09-22,2015,MIA,PHI,2,6,6-2,PHI,9,0,33,43,76,173,110,283,10,16,26,1,2:43
4758,415910,2015-09-22,2015,KCA,SEA,2,11,11-2,SEA,9,0,37,44,81,170,132,302,9,19,28,1,2:50
4759,415904,2015-09-22,2015,SLN,CIN,3,1,3-1,SLN,9,1,35,37,72,147,158,305,13,14,27,1,3:06
4760,415899,2015-09-22,2015,HOU,ANA,3,4,4-3,ANA,9,0,41,35,76,140,160,300,17,9,26,6,3:21
4761,415909,2015-09-22,2015,COL,PIT,3,6,6-3,PIT,9,0,34,45,79,169,129,298,9,19,28,3,3:22
4762,415907,2015-09-22,2015,TOR,NYA,4,6,6-4,NYA,10,0,42,46,88,182,158,340,15,18,33,4,3:39
4763,415921,2015-09-23,2015,CHN,MIL,1,4,4-1,MIL,9,0,31,37,68,129,132,261,5,10,15,4,2:38
4764,415928,2015-09-23,2015,OAK,TEX,3,10,10-3,TEX,9,0,36,40,76,157,141,298,9,15,24,1,2:52
4765,415923,2015-09-23,2015,MIA,PHI,4,3,4-3,MIA,11,0,46,40,86,146,172,318,16,9,25,2,3:20
4766,415925,2015-09-23,2015,KCA,SEA,4,3,4-3,KCA,10,0,48,40,88,176,182,358,21,10,31,5,3:44
4767,415924,2015-09-23,2015,COL,PIT,7,13,13-7,PIT,9,0,40,52,92,206,125,331,13,25,38,4,3:38
4768,415920,2015-09-23,2015,MIN,CLE,4,2,4-2,MIN,9,1,36,31,67,114,139,253,14,7,21,3,2:46
4769,415915,2015-09-23,2015,LAN,ARI,4,1,4-1,LAN,9,1,31,31,62,105,121,226,7,5,12,3,2:32
4770,415922,2015-09-23,2015,TOR,NYA,4,0,4-0,TOR,9,1,37,33,70,119,156,275,13,7,20,2,2:52
4771,415919,2015-09-23,2015,SLN,CIN,10,2,10-2,SLN,9,1,40,32,72,126,144,270,17,6,23,1,2:48
4772,415917,2015-09-23,2015,WAS,BAL,3,4,4-3,BAL,9,0,35,39,74,151,138,289,9,13,22,2,3:03
4773,415927,2015-09-23,2015,BOS,TBA,2,6,6-2,TBA,9,0,40,43,83,153,161,314,13,17,30,8,3:30
4774,415916,2015-09-23,2015,NYN,ATL,3,6,6-3,ATL,9,0,37,38,75,119,129,248,12,14,26,3,2:45
4775,415926,2015-09-23,2015,SDN,SFN,5,4,5-4,SDN,9,0,42,35,77,156,163,319,18,9,27,6,3:36
4776,415914,2015-09-23,2015,HOU,ANA,5,6,6-5,ANA,9,0,40,41,81,164,175,339,15,14,29,7,3:53
4777,415918,2015-09-23,2015,DET,CHA,7,4,7-4,DET,9,1,35,35,70,140,142,282,14,10,24,1,2:58
4778,415931,2015-09-24,2015,MIN,CLE,3,6,6-3,CLE,9,0,37,42,79,157,122,279,12,17,29,6,3:00
4779,415937,2015-09-24,2015,SDN,SFN,5,4,5-4,SDN,9,0,36,40,76,150,145,295,12,17,29,6,3:33
4780,415934,2015-09-24,2015,MIA,PHI,1,0,1-0,MIA,9,1,30,33,63,130,104,234,6,8,14,1,2:34
4781,415938,2015-09-24,2015,BOS,TBA,2,4,4-2,TBA,9,0,31,36,67,136,122,258,6,12,18,1,2:39
4782,415930,2015-09-24,2015,NYA,CHA,3,2,3-2,NYA,9,1,33,39,72,149,120,269,9,14,23,2,2:46
4783,415933,2015-09-24,2015,CIN,NYN,4,6,6-4,NYN,9,0,38,40,78,163,132,295,12,13,25,2,3:04
4784,415935,2015-09-24,2015,COL,PIT,4,5,5-4,PIT,9,0,39,40,79,147,139,286,13,15,28,1,2:58
4785,415929,2015-09-24,2015,LAN,ARI,6,3,6-3,LAN,9,1,40,36,76,156,152,308,16,9,25,4,3:21
4786,415892,2015-09-24,2015,WAS,BAL,4,5,5-4,BAL,9,0,39,39,78,163,152,315,16,14,30,2,3:05
4787,415892,2015-09-24,2015,WAS,BAL,4,5,5-4,BAL,9,0,39,39,78,163,152,315,16,14,30,2,3:05
4788,415936,2015-09-24,2015,KCA,SEA,10,4,10-4,KCA,9,1,44,38,82,138,182,320,22,12,34,5,3:23
4789,415939,2015-09-24,2015,OAK,TEX,1,8,8-1,TEX,9,0,34,46,80,193,131,324,10,20,30,1,3:20
4790,415932,2015-09-24,2015,SLN,MIL,7,3,7-3,SLN,9,1,37,38,75,157,142,299,16,12,28,2,3:03
4791,415949,2015-09-25,2015,WAS,PHI,2,8,8-2,PHI,9,0,35,39,74,149,127,276,8,12,20,0,2:30
4792,415950,2015-09-25,2015,CHN,PIT,2,3,3-2,PIT,9,0,36,34,70,139,141,280,10,7,17,1,3:01
4793,415947,2015-09-25,2015,DET,MIN,6,4,6-4,DET,9,1,37,34,71,128,164,292,15,6,21,3,3:16
4794,415942,2015-09-25,2015,BOS,BAL,7,0,7-0,BOS,9,1,35,30,65,116,148,264,12,3,15,3,2:42
4795,415953,2015-09-25,2015,TOR,TBA,5,3,5-3,TOR,9,1,40,33,73,109,171,280,16,6,22,2,2:44
4796,415943,2015-09-25,2015,NYA,CHA,2,5,5-2,CHA,9,0,37,39,76,149,134,283,14,14,28,4,3:10
4797,415944,2015-09-25,2015,KCA,CLE,0,6,6-0,CLE,9,0,29,41,70,169,113,282,3,14,17,1,2:43
4798,415952,2015-09-25,2015,OAK,SFN,5,4,5-4,OAK,9,1,35,38,73,146,125,271,11,13,24,2,2:49
4799,415946,2015-09-25,2015,SLN,MIL,3,4,4-3,MIL,9,0,37,35,72,125,143,268,11,10,21,4,3:19
4800,415940,2015-09-25,2015,SDN,ARI,3,6,6-3,ARI,9,0,36,36,72,125,151,276,9,9,18,2,2:57
4801,415951,2015-09-25,2015,ANA,SEA,8,4,8-4,ANA,9,1,39,40,79,149,130,279,16,14,30,4,3:09
4802,415945,2015-09-25,2015,COL,LAN,7,4,7-4,COL,9,1,37,39,76,171,135,306,12,14,26,2,3:12
4803,415948,2015-09-25,2015,CIN,NYN,5,12,12-5,NYN,9,0,39,43,82,158,147,305,12,16,28,4,3:15
4804,415954,2015-09-25,2015,HOU,TEX,2,6,6-2,TEX,9,0,40,42,82,159,158,317,13,16,29,6,3:49
4805,415941,2015-09-25,2015,MIA,ATL,12,11,12-11,MIA,9,1,41,45,86,179,137,316,22,20,42,5,3:19
4806,415955,2015-09-26,2015,SDN,ARI,3,0,3-0,SDN,9,1,34,31,65,107,138,245,10,5,15,2,2:56
4807,415966,2015-09-26,2015,ANA,SEA,3,2,3-2,ANA,9,0,34,35,69,138,125,263,11,10,21,3,2:53
4808,415965,2015-09-26,2015,CHN,PIT,0,4,4-0,PIT,9,0,34,40,74,160,126,286,7,12,19,3,2:58
4809,415958,2015-09-26,2015,NYA,CHA,2,1,2-1,NYA,9,1,34,32,66,120,157,277,13,6,19,1,2:44
4810,415960,2015-09-26,2015,COL,LAN,8,6,8-6,COL,9,0,39,36,75,130,126,256,18,12,30,3,2:59
4811,415961,2015-09-26,2015,SLN,MIL,5,1,5-1,SLN,9,1,35,33,68,110,145,255,13,7,20,0,2:35
4812,415959,2015-09-26,2015,KCA,CLE,5,9,9-5,CLE,9,0,36,40,76,172,114,286,10,14,24,4,3:03
4813,415956,2015-09-26,2015,MIA,ATL,6,2,6-2,MIA,9,1,38,37,75,133,146,279,18,11,29,4,2:55
4814,415962,2015-09-26,2015,DET,MIN,2,6,6-2,MIN,9,0,37,37,74,128,155,283,12,11,23,0,3:02
4815,415957,2015-09-26,2015,BOS,BAL,8,0,8-0,BOS,9,1,40,36,76,135,174,309,13,10,23,5,2:56
4816,415969,2015-09-26,2015,HOU,TEX,9,7,9-7,HOU,9,1,40,41,81,158,137,295,15,15,30,4,3:21
4817,415968,2015-09-26,2015,TOR,TBA,10,8,10-8,TOR,9,1,42,39,81,148,163,311,18,11,29,5,3:17
4818,415963,2015-09-26,2015,CIN,NYN,2,10,10-2,NYN,9,0,40,42,82,174,138,312,14,17,31,1,2:57
4819,415964,2015-09-26,2015,WAS,PHI,2,1,2-1,WAS,12,0,48,44,92,178,185,363,16,11,27,2,3:50
4820,415967,2015-09-26,2015,OAK,SFN,10,14,14-10,SFN,9,0,46,49,95,160,151,311,19,24,43,9,3:32
4821,415981,2015-09-27,2015,ANA,SEA,3,2,3-2,ANA,9,1,31,32,63,130,98,228,9,7,16,3,2:34
4822,415970,2015-09-27,2015,SDN,ARI,2,4,4-2,ARI,9,0,36,41,77,154,161,315,11,16,27,2,3:24
4823,415979,2015-09-27,2015,WAS,PHI,5,12,12-5,PHI,9,0,36,48,84,169,134,303,10,21,31,5,3:02
4824,415973,2015-09-27,2015,NYA,CHA,6,1,6-1,NYA,9,1,45,32,77,155,173,328,20,8,28,3,3:20
4825,415975,2015-09-27,2015,COL,LAN,12,5,12-5,COL,9,1,43,44,87,162,134,296,20,18,38,5,3:21
4826,415976,2015-09-27,2015,SLN,MIL,4,8,8-4,MIL,9,0,40,42,82,138,159,297,14,17,31,2,3:10
4827,415972,2015-09-27,2015,BOS,BAL,2,0,2-0,BOS,9,1,30,34,64,133,119,252,9,6,15,2,2:28
4828,415980,2015-09-27,2015,CHN,PIT,4,0,4-0,CHN,9,1,36,29,65,112,135,247,13,3,16,3,2:52
4829,415974,2015-09-27,2015,KCA,CLE,3,0,3-0,KCA,9,1,33,30,63,123,141,264,10,4,14,2,2:53
4830,415984,2015-09-27,2015,HOU,TEX,4,2,4-2,HOU,9,1,33,32,65,149,121,270,9,5,14,1,3:01
4831,415983,2015-09-27,2015,TOR,TBA,5,4,5-4,TOR,9,0,38,34,72,123,149,272,13,8,21,3,2:55
4832,415971,2015-09-27,2015,MIA,ATL,9,5,9-5,MIA,9,1,39,39,78,127,144,271,12,17,29,3,2:50
4833,415977,2015-09-27,2015,DET,MIN,1,7,7-1,MIN,9,0,36,41,77,160,134,294,10,15,25,1,2:57
4834,415978,2015-09-27,2015,CIN,NYN,1,8,8-1,NYN,9,0,35,44,79,164,138,302,8,14,22,1,2:49
4835,415982,2015-09-27,2015,OAK,SFN,4,5,5-4,SFN,9,0,37,41,78,135,147,282,12,13,25,6,3:11
4836,414387,2015-09-28,2015,CHN,KCA,1,0,1-0,CHN,11,0,34,38,72,154,134,288,5,7,12,1,2:49
4837,414922,2015-09-28,2015,WAS,CIN,5,1,5-1,WAS,9,1,37,32,69,119,139,258,14,6,20,0,2:37
4838,415992,2015-09-28,2015,BAL,TOR,3,4,4-3,TOR,9,0,32,37,69,139,103,242,5,12,17,3,2:36
4839,415987,2015-09-28,2015,SEA,HOU,2,3,3-2,HOU,9,0,31,37,68,154,131,285,6,12,18,3,2:55
4840,414922,2015-09-28,2015,WAS,CIN,5,1,5-1,WAS,9,1,37,32,69,119,139,258,14,6,20,0,2:37
4841,415991,2015-09-28,2015,PIT,SLN,0,3,3-0,SLN,9,0,43,32,75,105,190,295,17,7,24,1,3:34
4842,415990,2015-09-28,2015,ANA,OAK,5,4,5-4,ANA,9,0,35,38,73,152,138,290,13,12,25,6,3:23
4843,415988,2015-09-28,2015,SFN,LAN,3,2,3-2,SFN,12,0,45,46,91,147,163,310,15,11,26,6,3:59
4844,415989,2015-09-28,2015,CLE,MIN,2,4,4-2,MIN,9,0,33,38,71,142,124,266,6,12,18,2,2:59
4845,415985,2015-09-28,2015,NYA,BOS,1,5,5-1,BOS,9,0,38,38,76,128,146,274,11,13,24,4,2:56
4846,414387,2015-09-28,2015,CHN,KCA,1,0,1-0,CHN,11,0,34,38,72,154,134,288,5,7,12,1,2:49
4847,415986,2015-09-28,2015,TEX,DET,4,7,7-4,DET,9,0,40,46,86,181,167,348,14,20,34,2,3:37
4848,416007,2015-09-29,2015,ATL,WAS,2,1,2-1,ATL,9,1,29,34,63,125,119,244,7,10,17,2,2:30
4849,416000,2015-09-29,2015,TBA,MIA,4,2,4-2,TBA,9,1,34,35,69,124,122,246,9,10,19,1,2:27
4850,415993,2015-09-29,2015,NYA,BOS,4,10,10-4,BOS,9,0,36,41,77,156,130,286,9,14,23,0,2:57
4851,416003,2015-09-29,2015,PHI,NYN,4,3,4-3,PHI,9,1,34,42,76,156,111,267,12,14,26,2,2:46
4852,415994,2015-09-29,2015,CIN,CHN,1,4,4-1,CHN,9,0,31,44,75,169,121,290,4,17,21,2,2:48 (2:31 delay)
4853,416004,2015-09-29,2015,ANA,OAK,8,1,8-1,ANA,9,1,40,34,74,136,154,290,17,7,24,2,2:53
4854,415997,2015-09-29,2015,SEA,HOU,6,4,6-4,SEA,9,1,36,38,74,152,160,312,12,10,22,5,3:10
4855,415999,2015-09-29,2015,SFN,LAN,0,8,8-0,LAN,9,0,29,42,71,168,104,272,2,13,15,2,2:43
4856,415998,2015-09-29,2015,CHA,KCA,4,2,4-2,CHA,9,1,35,36,71,142,155,297,13,10,23,1,2:48
4857,416001,2015-09-29,2015,SDN,MIL,3,4,4-3,MIL,9,0,36,36,72,143,137,280,11,11,22,1,2:56
4858,415996,2015-09-29,2015,TEX,DET,7,6,7-6,TEX,9,1,39,38,77,150,165,315,14,12,26,4,3:13
4859,415995,2015-09-29,2015,ARI,COL,4,3,4-3,ARI,11,0,43,43,86,162,165,327,13,13,26,3,3:31
4860,416016,2015-09-30,2015,SDN,MIL,0,5,5-0,MIL,9,0,34,40,74,150,140,290,11,15,26,1,3:00
4861,416006,2015-09-30,2015,BAL,TOR,8,1,8-1,BAL,9,1,36,32,68,119,141,260,12,7,19,2,2:23
4862,416002,2015-09-30,2015,CLE,MIN,10,2,10-2,CLE,9,1,39,36,75,131,145,276,16,9,25,2,2:52
4863,416022,2015-09-30,2015,ATL,WAS,2,0,2-0,ATL,9,1,32,34,66,123,99,222,8,10,18,0,2:12
4864,416005,2015-09-30,2015,PIT,SLN,8,2,8-2,PIT,9,1,38,34,72,127,151,278,16,8,24,0,2:44
4865,416014,2015-09-30,2015,SFN,LAN,5,0,5-0,SFN,9,1,33,30,63,104,145,249,12,5,17,2,2:35
4866,416006,2015-09-30,2015,BAL,TOR,8,1,8-1,BAL,9,1,36,32,68,119,141,260,12,7,19,2,2:23
4867,416005,2015-09-30,2015,PIT,SLN,8,2,8-2,PIT,9,1,38,34,72,127,151,278,16,8,24,0,2:44
4868,416011,2015-09-30,2015,TEX,DET,6,2,6-2,TEX,9,1,34,36,70,139,141,280,12,13,25,4,3:13
4869,416017,2015-09-30,2015,CLE,MIN,1,7,7-1,MIN,9,0,36,39,75,153,148,301,10,13,23,2,3:05
4870,416015,2015-09-30,2015,TBA,MIA,6,4,6-4,TBA,9,1,37,38,75,155,134,289,15,13,28,4,2:53
4871,416002,2015-09-30,2015,CLE,MIN,10,2,10-2,CLE,9,1,39,36,75,131,145,276,16,9,25,2,2:52
4872,416012,2015-09-30,2015,SEA,HOU,6,7,7-6,HOU,9,0,41,41,82,152,132,284,15,16,31,7,3:29
4873,416010,2015-09-30,2015,ARI,COL,3,1,3-1,ARI,9,1,38,36,74,147,143,290,14,10,24,5,2:58
4874,416013,2015-09-30,2015,CHA,KCA,3,5,5-3,KCA,10,0,44,41,85,137,176,313,15,9,24,0,3:13
4875,416020,2015-09-30,2015,PIT,SLN,1,11,11-1,SLN,9,0,32,46,78,173,117,290,7,20,27,2,2:55
4876,416009,2015-09-30,2015,CIN,CHN,3,10,10-3,CHN,9,0,32,46,78,178,132,310,5,20,25,2,3:00
4877,416018,2015-09-30,2015,PHI,NYN,7,5,7-5,PHI,9,1,39,39,78,172,170,342,16,12,28,9,3:59
4878,416021,2015-09-30,2015,BAL,TOR,2,15,15-2,TOR,9,0,35,55,90,210,125,335,9,28,37,3,3:17
4879,416008,2015-09-30,2015,NYA,BOS,5,9,9-5,BOS,11,0,53,48,101,200,215,415,24,14,38,6,4:10
4880,416019,2015-09-30,2015,ANA,OAK,7,8,8-7,OAK,9,0,43,42,85,182,163,345,19,13,32,8,3:39
4881,416032,2015-10-01,2015,PHI,NYN,3,0,3-0,PHI,9,1,30,33,63,141,113,254,6,7,13,1,2:23
4882,416031,2015-10-01,2015,CLE,MIN,2,4,4-2,MIN,9,0,34,34,68,140,138,278,8,9,17,2,2:47
4883,416029,2015-10-01,2015,TBA,MIA,4,1,4-1,TBA,9,1,39,34,73,119,132,251,16,7,23,1,2:29
4884,416028,2015-10-01,2015,SFN,LAN,2,3,3-2,LAN,9,0,32,37,69,153,102,255,5,10,15,2,2:33
4885,416030,2015-10-01,2015,SDN,MIL,3,1,3-1,SDN,9,1,33,33,66,144,154,298,13,7,20,1,3:05
4886,416034,2015-10-01,2015,ATL,WAS,0,3,3-0,WAS,9,0,35,34,69,132,144,276,9,7,16,2,2:47
4887,416025,2015-10-01,2015,CIN,CHN,3,5,5-3,CHN,9,0,39,37,76,146,150,296,12,11,23,3,2:55
4888,416026,2015-10-01,2015,ARI,COL,8,6,8-6,ARI,9,1,37,40,77,136,139,275,15,14,29,2,3:10
4889,416024,2015-10-01,2015,NYA,BOS,4,1,4-1,NYA,9,1,34,36,70,163,142,305,13,12,25,0,3:10
4890,416023,2015-10-01,2015,TEX,ANA,5,3,5-3,TEX,9,1,37,35,72,140,148,288,16,9,25,5,3:14
4891,416027,2015-10-01,2015,CHA,KCA,4,6,6-4,KCA,9,0,37,42,79,145,159,304,12,17,29,3,3:21
4892,416033,2015-10-01,2015,BAL,TOR,6,4,6-4,BAL,9,1,42,38,80,157,164,321,18,14,32,5,3:12 (3:25 delay)
4893,416040,2015-10-02,2015,CHA,DET,2,1,2-1,CHA,9,1,30,33,63,117,94,211,8,7,15,1,2:13
4894,416035,2015-10-02,2015,TEX,ANA,1,2,2-1,ANA,9,0,34,33,67,128,125,253,6,7,13,1,2:49
4895,416036,2015-10-02,2015,CLE,BOS,8,2,8-2,CLE,9,1,41,34,75,135,165,300,19,9,28,2,3:00
4896,416047,2015-10-02,2015,ATL,SLN,4,0,4-0,ATL,9,1,40,35,75,152,150,302,15,9,24,2,2:58
4897,416048,2015-10-02,2015,TBA,TOR,4,8,8-4,TOR,9,0,35,44,79,173,138,311,10,18,28,5,3:07
4898,416041,2015-10-02,2015,ARI,HOU,5,21,21-5,HOU,9,0,41,57,98,214,168,382,15,28,43,1,3:52
4899,416038,2015-10-02,2015,PIT,CIN,6,4,6-4,PIT,12,0,47,51,98,203,212,415,13,14,27,3,4:23
4900,416045,2015-10-02,2015,SEA,OAK,2,4,4-2,OAK,9,0,35,37,72,133,127,260,10,11,21,0,2:45
4901,416046,2015-10-02,2015,LAN,SDN,6,2,6-2,LAN,9,1,34,33,67,120,132,252,11,7,18,1,2:32
4902,416042,2015-10-02,2015,MIN,KCA,1,3,3-1,KCA,9,0,33,40,73,161,127,288,8,13,21,3,2:55
4903,416037,2015-10-02,2015,MIL,CHN,1,6,6-1,CHN,9,0,33,41,74,170,117,287,5,16,21,3,3:01
4904,416039,2015-10-02,2015,SFN,COL,3,9,9-3,COL,9,0,38,38,76,132,158,290,11,11,22,3,3:00 (:11 delay)
4905,416049,2015-10-03,2015,NYN,WAS,1,3,3-1,WAS,9,0,35,34,69,138,155,293,9,8,17,2,2:44
4906,416049,2015-10-03,2015,NYN,WAS,1,3,3-1,WAS,9,0,35,34,69,138,155,293,9,8,17,2,2:44
4907,416059,2015-10-03,2015,BAL,NYA,4,3,4-3,BAL,9,1,32,36,68,146,114,260,10,11,21,0,2:31
4908,416044,2015-10-03,2015,BAL,NYA,9,2,9-2,BAL,9,1,45,37,82,158,167,325,22,10,32,3,3:15
4909,416044,2015-10-03,2015,BAL,NYA,9,2,9-2,BAL,9,1,45,37,82,158,167,325,22,10,32,3,3:15
4910,416043,2015-10-03,2015,PHI,MIA,2,5,5-2,MIA,9,0,35,39,74,140,112,252,9,15,24,0,2:35
4911,416061,2015-10-03,2015,LAN,SDN,2,1,2-1,LAN,9,1,27,34,61,120,96,216,6,7,13,0,2:10
4912,416064,2015-10-03,2015,NYN,WAS,0,2,2-0,WAS,9,0,28,34,62,130,109,239,0,6,6,0,2:14
4913,416050,2015-10-03,2015,TEX,ANA,10,11,11-10,ANA,9,0,43,47,90,199,169,368,16,22,38,10,4:06
4914,416051,2015-10-03,2015,CLE,BOS,2,0,2-0,CLE,9,1,34,31,65,120,131,251,10,6,16,2,2:41 (:30 delay)
4915,416052,2015-10-03,2015,MIL,CHN,0,1,1-0,CHN,9,0,29,40,69,150,118,268,3,13,16,0,2:49
4916,416057,2015-10-03,2015,MIN,KCA,1,5,5-1,KCA,9,0,36,40,76,157,128,285,10,13,23,3,3:01
4917,416043,2015-10-03,2015,PHI,MIA,2,5,5-2,MIA,9,0,35,39,74,140,112,252,9,15,24,0,2:35
4918,416054,2015-10-03,2015,SFN,COL,3,2,3-2,SFN,9,1,31,34,65,151,111,262,9,8,17,3,2:50
4919,416063,2015-10-03,2015,TBA,TOR,4,3,4-3,TBA,9,0,34,38,72,141,136,277,8,12,20,4,3:00
4920,416055,2015-10-03,2015,CHA,DET,4,3,4-3,CHA,9,0,39,38,77,132,177,309,13,12,25,2,3:15
4921,416056,2015-10-03,2015,ARI,HOU,2,6,6-2,HOU,9,0,35,43,78,175,113,288,9,16,25,3,3:26
4922,416058,2015-10-03,2015,PHI,MIA,6,7,7-6,MIA,9,0,41,43,84,171,170,341,15,16,31,3,3:19
4923,416053,2015-10-03,2015,PIT,CIN,1,3,3-1,CIN,9,0,34,35,69,139,137,276,7,10,17,3,3:01
4924,416060,2015-10-03,2015,SEA,OAK,5,7,7-5,OAK,13,0,51,58,109,228,188,416,13,22,35,3,4:31
4925,416077,2015-10-04,2015,ATL,SLN,6,0,6-0,ATL,9,1,32,35,67,128,112,240,9,8,17,1,2:14
4926,416062,2015-10-04,2015,ATL,SLN,2,0,2-0,ATL,9,1,32,30,62,107,130,237,11,5,16,1,2:19
4927,416075,2015-10-04,2015,SEA,OAK,3,2,3-2,SEA,9,1,34,34,68,144,124,268,11,9,20,1,2:45
4928,416067,2015-10-04,2015,MIL,CHN,1,3,3-1,CHN,9,0,31,37,68,159,110,269,5,12,17,0,2:44
4929,416065,2015-10-04,2015,TEX,ANA,9,2,9-2,TEX,9,1,39,33,72,108,160,268,15,6,21,4,2:53
4930,416070,2015-10-04,2015,CHA,DET,0,6,6-0,DET,9,0,32,42,74,169,123,292,5,15,20,0,2:45
4931,416076,2015-10-04,2015,LAN,SDN,6,3,6-3,LAN,9,1,39,36,75,142,153,295,16,9,25,4,3:02
4932,416069,2015-10-04,2015,SFN,COL,3,7,7-3,COL,9,0,40,39,79,132,136,268,16,11,27,6,3:05
4933,416078,2015-10-04,2015,TBA,TOR,12,3,12-3,TBA,9,1,38,40,78,164,165,329,14,15,29,3,3:09
4934,416072,2015-10-04,2015,MIN,KCA,1,6,6-1,KCA,9,0,40,44,84,166,174,340,13,17,30,2,3:11
4935,416062,2015-10-04,2015,ATL,SLN,2,0,2-0,ATL,9,1,32,30,62,107,130,237,11,5,16,1,2:19
4936,416066,2015-10-04,2015,CLE,BOS,3,1,3-1,CLE,9,1,33,37,70,160,118,278,11,10,21,3,2:46
4937,416068,2015-10-04,2015,PIT,CIN,4,0,4-0,PIT,9,1,37,34,71,137,151,288,14,9,23,0,3:03
4938,416079,2015-10-04,2015,NYN,WAS,1,0,1-0,NYN,9,1,30,31,61,144,134,278,8,4,12,1,2:34
4939,416071,2015-10-04,2015,ARI,HOU,5,3,5-3,ARI,9,1,39,39,78,158,144,302,14,14,28,4,3:19
4940,416074,2015-10-04,2015,BAL,NYA,9,4,9-4,BAL,9,1,41,42,83,152,187,339,19,15,34,7,3:39
4941,416073,2015-10-04,2015,PHI,MIA,7,2,7-2,PHI,9,1,38,36,74,135,124,259,16,9,25,2,2:29
4942,446877,2016-04-03,2016,PIT,SLN,4,1,4-1,PIT,9,1,36,38,74,141,144,285,15,11,26,0,3:02
4943,446873,2016-04-03,2016,KCA,NYN,4,3,4-3,KCA,9,1,33,39,72,177,114,291,11,13,24,2,3:13
4944,446911,2016-04-03,2016,TBA,TOR,3,5,5-3,TOR,9,0,36,38,74,158,118,276,8,10,18,2,2:51
4945,452866,2016-04-03,2016,ANA,CHN,6,4,6-4,ANA,9,1,36,33,69,128,124,252,11,8,19,1,2:33
4946,446878,2016-04-04,2016,TBA,TOR,3,5,5-3,TOR,9,0,39,36,75,140,140,280,12,9,21,3,2:58
4947,446874,2016-04-04,2016,CIN,PHI,6,2,6-2,CIN,9,1,33,34,67,134,133,267,10,7,17,4,2:56
4948,446871,2016-04-04,2016,SDN,LAN,0,15,15-0,LAN,9,0,33,49,82,180,139,319,6,23,29,2,3:10
4949,446876,2016-04-04,2016,TEX,SEA,3,2,3-2,TEX,9,1,34,34,68,133,120,253,8,8,16,0,2:38
4950,446889,2016-04-04,2016,ANA,CHN,0,9,9-0,CHN,9,0,30,44,74,188,109,297,4,19,23,0,3:08
4951,446868,2016-04-04,2016,OAK,CHA,3,4,4-3,CHA,9,0,36,36,72,159,133,292,10,10,20,3,2:56
4952,446872,2016-04-04,2016,BAL,MIN,3,2,3-2,BAL,9,0,41,35,76,128,150,278,15,8,23,2,2:48 (2:51 delay)
4953,446879,2016-04-04,2016,ATL,WAS,3,4,4-3,WAS,10,0,38,43,81,169,155,324,10,13,23,3,3:23
4954,446875,2016-04-04,2016,MIL,SFN,3,12,12-3,SFN,9,0,37,46,83,187,165,352,13,20,33,1,3:35
4955,446869,2016-04-04,2016,ARI,COL,5,10,10-5,COL,9,0,42,47,89,200,162,362,15,20,35,4,4:11
4956,446884,2016-04-05,2016,SDN,LAN,0,3,3-0,LAN,9,0,29,35,64,132,115,247,2,8,10,0,2:36
4957,446880,2016-04-05,2016,ANA,CHN,1,6,6-1,CHN,9,0,32,36,68,124,119,243,4,9,13,3,2:34
4958,446896,2016-04-05,2016,KCA,NYN,0,2,2-0,NYN,9,0,32,38,70,157,124,281,4,11,15,1,2:51
4959,446870,2016-04-05,2016,NYA,HOU,3,5,5-3,HOU,9,0,33,38,71,161,137,298,8,10,18,2,3:17
4960,446881,2016-04-05,2016,OAK,CHA,4,5,5-4,CHA,9,0,39,40,79,144,150,294,12,13,25,5,3:28
4961,446886,2016-04-05,2016,TEX,SEA,2,10,10-2,SEA,9,0,39,42,81,144,161,305,13,17,30,2,3:30
4962,446867,2016-04-05,2016,CLE,BOS,2,6,6-2,BOS,9,0,35,43,78,166,146,312,8,18,26,2,3:13
4963,446883,2016-04-05,2016,MIA,DET,7,8,8-7,DET,11,0,46,47,93,168,180,348,14,16,30,0,3:47
4964,446885,2016-04-05,2016,MIL,SFN,1,2,2-1,SFN,9,0,32,35,67,109,122,231,6,10,16,1,2:29
4965,446867,2016-04-05,2016,CLE,BOS,2,6,6-2,BOS,9,0,35,43,78,166,146,312,8,18,26,2,3:13
4966,446882,2016-04-05,2016,ARI,COL,11,6,11-6,ARI,9,1,44,36,80,129,168,297,20,10,30,2,3:14
4967,446910,2016-04-05,2016,PIT,SLN,6,5,6-5,PIT,11,0,44,45,89,167,174,341,14,13,27,1,3:27
4968,446870,2016-04-05,2016,NYA,HOU,3,5,5-3,HOU,9,0,33,38,71,161,137,298,8,10,18,2,3:17
4969,446887,2016-04-05,2016,TBA,TOR,3,2,3-2,TBA,9,1,31,40,71,174,112,286,8,13,21,4,3:07
4970,446897,2016-04-06,2016,CIN,PHI,3,2,3-2,CIN,9,0,33,33,66,123,123,246,8,7,15,0,2:23
4971,446901,2016-04-06,2016,TBA,TOR,5,3,5-3,TBA,9,1,35,35,70,153,126,279,12,9,21,3,2:47
4972,446890,2016-04-06,2016,OAK,CHA,2,1,2-1,OAK,9,1,34,35,69,139,121,260,10,10,20,0,2:54
4973,446902,2016-04-06,2016,ATL,WAS,1,3,3-1,WAS,9,0,34,36,70,132,126,258,11,11,22,1,2:53
4974,446899,2016-04-06,2016,TEX,SEA,5,9,9-5,SEA,9,0,35,43,78,170,131,301,9,20,29,3,2:56
4975,446891,2016-04-06,2016,ARI,COL,3,4,4-3,COL,9,0,38,32,70,112,130,242,10,8,18,3,2:39
4976,446898,2016-04-06,2016,MIL,SFN,4,3,4-3,MIL,9,1,38,35,73,143,150,293,16,11,27,4,3:19
4977,446894,2016-04-06,2016,SDN,LAN,0,7,7-0,LAN,9,0,32,40,72,171,121,292,5,14,19,0,2:57
4978,446900,2016-04-06,2016,PIT,SLN,5,1,5-1,PIT,9,1,39,33,72,145,160,305,18,6,24,4,3:08
4979,446888,2016-04-06,2016,CLE,BOS,7,6,7-6,CLE,9,1,38,40,78,158,159,317,15,13,28,5,3:29 (:12 delay)
4980,446895,2016-04-06,2016,BAL,MIN,4,2,4-2,BAL,9,1,38,38,76,175,151,326,16,11,27,1,3:11
4981,446892,2016-04-06,2016,MIA,DET,3,7,7-3,DET,9,0,40,43,83,190,160,350,15,17,32,3,3:22
4982,446893,2016-04-06,2016,NYA,HOU,16,6,16-6,NYA,9,1,49,40,89,143,234,377,24,14,38,3,3:45
4983,446908,2016-04-07,2016,BAL,MIN,4,2,4-2,BAL,9,1,31,34,65,133,124,257,8,9,17,1,2:32 (:21 delay)
4984,446906,2016-04-07,2016,NYA,HOU,8,5,8-5,NYA,9,1,37,36,73,153,137,290,13,9,22,1,3:00 (:12 delay)
4985,446907,2016-04-07,2016,SFN,LAN,12,6,12-6,SFN,9,1,43,39,82,126,137,263,20,13,33,4,3:07
4986,446904,2016-04-07,2016,ARI,CHN,6,14,14-6,CHN,9,0,36,52,88,195,124,319,10,25,35,3,3:29
4987,446917,2016-04-07,2016,WAS,MIA,4,6,6-4,MIA,9,0,42,43,85,175,174,349,15,17,32,2,3:32 (1:25 delay)
4988,446905,2016-04-07,2016,OAK,CHA,1,6,6-1,CHA,9,0,35,40,75,161,139,300,7,11,18,3,3:06
4989,448298,2016-04-07,2016,ANA,TEX,4,3,4-3,ANA,9,0,40,34,74,134,154,288,16,7,23,5,3:11
4990,446909,2016-04-07,2016,CIN,PHI,10,6,10-6,CIN,9,1,40,41,81,148,164,312,17,15,32,2,3:04
4991,446925,2016-04-08,2016,BAL,TBA,6,1,6-1,BAL,9,1,34,33,67,142,139,281,12,8,20,0,2:46
4992,446914,2016-04-08,2016,CHA,CLE,1,7,7-1,CLE,9,0,32,38,70,152,133,285,8,11,19,1,2:45 (:16 delay)
4993,446924,2016-04-08,2016,ATL,SLN,4,7,7-4,SLN,9,0,38,39,77,130,144,274,12,14,26,3,3:00
4994,446921,2016-04-08,2016,NYN,PHI,7,2,7-2,NYN,9,1,39,34,73,130,159,289,14,8,22,4,3:09
4995,446915,2016-04-08,2016,MIL,HOU,6,4,6-4,MIL,9,1,33,37,70,162,142,304,11,12,23,1,3:08
4996,446922,2016-04-08,2016,CIN,PIT,5,6,6-5,PIT,9,0,39,44,83,169,155,324,13,17,30,2,3:24
4997,446926,2016-04-08,2016,ANA,TEX,3,7,7-3,TEX,9,0,38,44,82,181,135,316,12,18,30,3,3:30
4998,446920,2016-04-08,2016,SEA,OAK,2,3,3-2,OAK,9,0,35,37,72,147,141,288,7,10,17,1,2:55
4999,446916,2016-04-08,2016,SFN,LAN,3,2,3-2,SFN,10,0,33,40,73,144,135,279,7,11,18,2,2:58
5000,446923,2016-04-08,2016,COL,SDN,6,13,13-6,SDN,9,0,41,51,92,194,173,367,15,25,40,3,3:48
5001,446919,2016-04-08,2016,DET,NYA,4,0,4-0,DET,9,1,36,32,68,133,148,281,13,7,20,1,2:44
5002,446913,2016-04-08,2016,ARI,CHN,3,2,3-2,ARI,9,0,34,35,69,134,132,266,11,10,21,1,2:48
5003,446918,2016-04-08,2016,KCA,MIN,4,3,4-3,KCA,9,1,37,40,77,178,145,323,13,14,27,2,3:14
5004,446912,2016-04-08,2016,TOR,BOS,7,8,8-7,BOS,9,0,42,41,83,158,165,323,15,14,29,3,3:24
5005,446927,2016-04-09,2016,TOR,BOS,4,8,8-4,BOS,9,0,36,43,79,165,143,308,8,15,23,0,2:48
5006,446933,2016-04-09,2016,KCA,MIN,7,0,7-0,KCA,9,1,40,35,75,150,170,320,15,9,24,3,3:04
5007,446928,2016-04-09,2016,ARI,CHN,2,4,4-2,CHN,9,0,32,42,74,146,124,270,5,17,22,1,2:46
5008,446931,2016-04-09,2016,SFN,LAN,2,3,3-2,LAN,10,0,37,46,83,166,136,302,8,16,24,2,3:22
5009,446939,2016-04-09,2016,ATL,SLN,2,12,12-2,SLN,9,0,35,53,88,212,137,349,7,24,31,1,3:30
5010,446936,2016-04-09,2016,NYN,PHI,0,1,1-0,PHI,9,0,34,33,67,128,140,268,7,8,15,1,2:44
5011,446941,2016-04-09,2016,ANA,TEX,1,4,4-1,TEX,9,0,32,37,69,133,141,274,8,11,19,1,2:53
5012,446937,2016-04-09,2016,CIN,PIT,5,1,5-1,CIN,9,1,34,37,71,138,150,288,12,13,25,2,3:00
5013,446935,2016-04-09,2016,SEA,OAK,1,6,6-1,OAK,9,0,34,38,72,145,148,293,9,12,21,0,2:54
5014,446929,2016-04-09,2016,CHA,CLE,7,3,7-3,CHA,9,1,38,35,73,130,143,273,14,9,23,2,2:43
5015,446934,2016-04-09,2016,DET,NYA,4,8,8-4,NYA,9,0,37,44,81,169,150,319,11,18,29,3,3:20
5016,446930,2016-04-09,2016,MIL,HOU,4,6,6-4,HOU,9,0,37,37,74,137,154,291,11,13,24,3,3:10
5017,446938,2016-04-09,2016,COL,SDN,3,16,16-3,SDN,9,0,39,50,89,182,140,322,11,25,36,1,3:24
5018,446942,2016-04-10,2016,TOR,BOS,3,0,3-0,TOR,9,1,32,34,66,122,138,260,11,9,20,1,2:27
5019,446947,2016-04-10,2016,WAS,MIA,4,2,4-2,WAS,9,1,38,33,71,125,144,269,18,9,27,2,2:52
5020,446945,2016-04-10,2016,MIL,HOU,3,2,3-2,MIL,9,1,36,33,69,147,137,284,14,8,22,2,3:08
5021,446955,2016-04-10,2016,BAL,TBA,5,3,5-3,BAL,9,1,32,39,71,160,126,286,11,12,23,1,2:53
5022,446951,2016-04-10,2016,NYN,PHI,2,5,5-2,PHI,9,0,32,38,70,152,131,283,5,13,18,1,2:57
5023,446946,2016-04-10,2016,SFN,LAN,9,6,9-6,SFN,9,1,39,41,80,136,152,288,16,14,30,3,3:07
5024,446943,2016-04-10,2016,ARI,CHN,3,7,7-3,CHN,9,0,35,44,79,178,122,300,8,19,27,2,3:21
5025,446952,2016-04-10,2016,CIN,PIT,2,1,2-1,CIN,9,0,33,42,75,184,116,300,12,16,28,0,3:04
5026,446948,2016-04-10,2016,KCA,MIN,4,3,4-3,KCA,10,0,38,44,82,161,155,316,9,16,25,1,3:23
5027,446950,2016-04-10,2016,SEA,OAK,1,2,2-1,OAK,10,0,41,38,79,154,137,291,11,8,19,0,3:03
5028,446953,2016-04-10,2016,COL,SDN,6,3,6-3,COL,9,1,36,35,71,134,120,254,14,9,23,1,2:38
5029,446956,2016-04-10,2016,ANA,TEX,3,1,3-1,ANA,9,1,34,35,69,118,124,242,13,9,22,1,2:43
5030,446954,2016-04-10,2016,ATL,SLN,7,12,12-7,SLN,9,0,47,49,96,193,187,380,22,23,45,5,3:55
5031,446966,2016-04-11,2016,PHI,SDN,3,4,4-3,SDN,9,0,33,34,67,130,137,267,9,8,17,3,2:51
5032,446967,2016-04-11,2016,SEA,TEX,3,7,7-3,TEX,9,0,36,42,78,154,138,292,10,17,27,1,3:00
5033,446964,2016-04-11,2016,SLN,MIL,10,1,10-1,SLN,9,1,44,36,80,141,170,311,21,10,31,1,3:00
5034,446957,2016-04-11,2016,WAS,ATL,6,4,6-4,WAS,9,1,40,36,76,137,150,287,17,12,29,3,3:05
5035,446960,2016-04-11,2016,CHN,CIN,5,3,5-3,CHN,9,1,36,35,71,144,149,293,11,9,20,3,3:03
5036,446962,2016-04-11,2016,OAK,ANA,1,4,4-1,ANA,9,0,37,38,75,128,148,276,13,13,26,4,3:05
5037,446963,2016-04-11,2016,NYN,MIA,3,10,10-3,MIA,9,0,38,47,85,205,160,365,11,20,31,3,3:45
5038,446961,2016-04-11,2016,HOU,KCA,8,2,8-2,HOU,9,1,40,38,78,132,160,292,17,12,29,1,2:59
5039,446959,2016-04-11,2016,MIN,CHA,1,4,4-1,CHA,9,0,34,43,77,162,133,295,9,15,24,2,3:05
5040,446965,2016-04-11,2016,DET,PIT,4,7,7-4,PIT,9,0,34,42,76,179,130,309,8,20,28,1,3:17
5041,446958,2016-04-11,2016,BOS,BAL,7,9,9-7,BAL,9,0,41,40,81,158,172,330,16,14,30,1,3:26
5042,446968,2016-04-12,2016,LAN,ARI,2,4,4-2,ARI,9,0,37,40,77,156,110,266,11,15,26,1,3:00
5043,446980,2016-04-12,2016,SEA,TEX,0,8,8-0,TEX,9,0,34,39,73,152,136,288,6,14,20,1,2:35
5044,446972,2016-04-12,2016,HOU,KCA,2,3,3-2,KCA,9,0,38,35,73,137,179,316,14,9,23,0,3:17
5045,446969,2016-04-12,2016,WAS,ATL,2,1,2-1,WAS,9,1,31,37,68,149,96,245,9,10,19,5,2:47
5046,446976,2016-04-12,2016,TOR,NYA,2,3,3-2,NYA,9,0,36,38,74,151,155,306,10,11,21,2,3:03
5047,446970,2016-04-12,2016,BOS,BAL,5,9,9-5,BAL,9,0,38,43,81,174,158,332,13,18,31,4,3:23
5048,446974,2016-04-12,2016,NYN,MIA,1,2,2-1,MIA,9,0,35,38,73,164,154,318,10,13,23,2,3:17
5049,446971,2016-04-12,2016,TBA,CLE,5,1,5-1,TBA,9,1,31,32,63,129,121,250,9,6,15,1,2:34
5050,446978,2016-04-12,2016,PHI,SDN,3,0,3-0,PHI,9,1,32,35,67,135,133,268,9,9,18,2,2:58
5051,446979,2016-04-12,2016,COL,SFN,2,7,7-2,SFN,9,0,35,39,74,131,128,259,9,14,23,0,2:44
5052,446973,2016-04-12,2016,OAK,ANA,4,5,5-4,ANA,9,0,35,38,73,145,120,265,8,13,21,1,2:41
5053,446977,2016-04-12,2016,DET,PIT,8,2,8-2,DET,9,1,44,34,78,148,187,335,22,9,31,1,3:16
5054,446982,2016-04-13,2016,WAS,ATL,3,0,3-0,WAS,9,1,30,34,64,119,102,221,6,9,15,1,2:12
5055,446986,2016-04-13,2016,TBA,CLE,1,4,4-1,CLE,9,0,32,34,66,137,112,249,6,6,12,0,2:32
5056,446990,2016-04-13,2016,NYN,MIA,2,1,2-1,NYN,9,1,31,37,68,150,134,284,10,11,21,3,2:53
5057,446981,2016-04-13,2016,LAN,ARI,3,1,3-1,LAN,9,1,35,33,68,128,140,268,11,9,20,3,3:12
5058,446994,2016-04-13,2016,COL,SFN,10,6,10-6,COL,9,1,45,36,81,126,159,285,23,10,33,2,3:07
5059,446993,2016-04-13,2016,PHI,SDN,2,1,2-1,PHI,9,1,31,36,67,147,108,255,10,8,18,0,2:36
5060,446988,2016-04-13,2016,HOU,KCA,2,4,4-2,KCA,9,0,37,38,75,146,135,281,10,11,21,2,3:03
5061,446984,2016-04-13,2016,MIN,CHA,0,3,3-0,CHA,9,0,36,35,71,130,151,281,10,9,19,4,2:51
5062,446995,2016-04-13,2016,SEA,TEX,4,2,4-2,SEA,10,0,42,37,79,157,164,321,12,8,20,1,3:20
5063,446992,2016-04-13,2016,TOR,NYA,7,2,7-2,TOR,9,1,37,36,73,142,144,286,14,11,25,0,2:43
5064,446975,2016-04-13,2016,SLN,MIL,4,6,6-4,MIL,9,0,34,39,73,145,138,283,8,12,20,1,2:49
5065,446985,2016-04-13,2016,CHN,CIN,9,2,9-2,CHN,9,1,43,35,78,121,188,309,19,11,30,2,3:03
5066,446989,2016-04-13,2016,OAK,ANA,1,5,5-1,ANA,9,0,34,43,77,157,128,285,6,17,23,4,3:03
5067,446987,2016-04-13,2016,PIT,DET,3,7,7-3,DET,9,0,34,41,75,170,142,312,9,15,24,2,3:12
5068,446983,2016-04-13,2016,BOS,BAL,4,2,4-2,BOS,9,1,34,39,73,167,143,310,12,14,26,2,3:13
5069,446997,2016-04-14,2016,WAS,ATL,6,2,6-2,WAS,9,1,31,33,64,114,126,240,7,7,14,1,2:29
5070,447000,2016-04-14,2016,CHN,CIN,8,1,8-1,CHN,9,1,39,36,75,131,173,304,16,10,26,1,3:07
5071,447005,2016-04-14,2016,PHI,SDN,3,0,3-0,PHI,9,1,32,30,62,113,142,255,8,3,11,0,2:27
5072,447003,2016-04-14,2016,HOU,KCA,2,6,6-2,KCA,9,0,31,40,71,135,124,259,7,14,21,2,2:41
5073,447002,2016-04-14,2016,PIT,DET,4,7,7-4,DET,9,0,43,38,81,138,178,316,17,14,31,1,3:20
5074,446996,2016-04-14,2016,LAN,ARI,5,2,5-2,LAN,9,1,34,33,67,141,118,259,13,7,20,2,2:36
5075,446991,2016-04-14,2016,SLN,MIL,7,0,7-0,SLN,9,1,38,29,67,104,151,255,15,2,17,0,2:29
5076,446998,2016-04-14,2016,TEX,BAL,6,3,6-3,TEX,9,1,35,37,72,155,124,279,12,12,24,2,2:47
5077,447004,2016-04-14,2016,TOR,NYA,4,2,4-2,TOR,9,1,35,33,68,118,121,239,11,6,17,1,2:22
5078,447006,2016-04-14,2016,COL,SFN,11,6,11-6,COL,9,1,40,40,80,158,168,326,18,11,29,3,3:26
5079,447001,2016-04-14,2016,TBA,CLE,0,6,6-0,CLE,9,0,34,46,80,192,154,346,8,20,28,1,3:20
5080,446999,2016-04-14,2016,MIN,CHA,1,3,3-1,CHA,9,0,34,37,71,138,142,280,7,10,17,3,3:00
5081,447011,2016-04-15,2016,SLN,CIN,14,3,14-3,SLN,9,1,44,35,79,111,151,262,18,8,26,0,2:31
5082,447019,2016-04-15,2016,NYA,SEA,1,7,7-1,SEA,9,0,40,41,81,152,165,317,13,16,29,3,3:18
5083,447012,2016-04-15,2016,CHN,COL,1,6,6-1,COL,9,0,34,41,75,144,144,288,8,16,24,2,2:59
5084,447010,2016-04-15,2016,TBA,CHA,0,1,1-0,CHA,9,0,30,33,63,117,106,223,2,7,9,0,2:23
5085,447013,2016-04-15,2016,HOU,DET,1,0,1-0,HOU,9,1,32,32,64,113,130,243,11,6,17,0,2:34
5086,447018,2016-04-15,2016,LAN,SFN,7,3,7-3,LAN,9,1,37,33,70,138,130,268,11,5,16,1,2:45
5087,447014,2016-04-15,2016,OAK,KCA,2,4,4-2,KCA,9,0,37,42,79,182,146,328,10,17,27,3,3:15
5088,447009,2016-04-15,2016,TEX,BAL,5,11,11-5,BAL,9,0,35,40,75,168,140,308,9,16,25,2,2:47
5089,447007,2016-04-15,2016,SDN,ARI,2,3,3-2,ARI,9,0,37,36,73,128,128,256,13,12,25,3,3:08
5090,447015,2016-04-15,2016,MIN,ANA,5,4,5-4,MIN,9,1,36,38,74,144,160,304,13,14,27,5,3:29
5091,447020,2016-04-15,2016,BOS,TOR,5,3,5-3,BOS,9,1,38,33,71,146,166,312,15,7,22,3,3:02
5092,447021,2016-04-15,2016,PHI,WAS,1,9,9-1,WAS,9,0,35,46,81,172,131,303,7,19,26,1,3:11
5093,447016,2016-04-15,2016,PIT,MIL,4,8,8-4,MIL,9,0,40,47,87,181,135,316,12,22,34,2,3:30
5094,447008,2016-04-15,2016,MIA,ATL,3,6,6-3,ATL,9,0,43,36,79,128,145,273,18,11,29,6,3:05
5095,447017,2016-04-15,2016,CLE,NYN,5,6,6-5,NYN,9,0,45,43,88,159,160,319,17,17,34,6,3:37
5096,447036,2016-04-16,2016,PHI,WAS,1,8,8-1,WAS,9,0,35,37,72,129,137,266,8,12,20,0,2:37
5097,447033,2016-04-16,2016,LAN,SFN,3,4,4-3,SFN,9,0,35,40,75,164,147,311,8,17,25,4,3:32
5098,447024,2016-04-16,2016,TEX,BAL,8,4,8-4,TEX,9,1,39,40,79,142,144,286,19,13,32,2,2:48
5099,447030,2016-04-16,2016,MIN,ANA,6,4,6-4,MIN,9,1,36,37,73,122,153,275,13,12,25,1,2:55
5100,447023,2016-04-16,2016,MIA,ATL,4,6,6-4,ATL,9,0,40,38,78,110,159,269,13,12,25,3,2:55
5101,447027,2016-04-16,2016,CHN,COL,6,2,6-2,CHN,9,1,36,32,68,119,139,258,13,8,21,2,2:39
5102,447026,2016-04-16,2016,SLN,CIN,8,9,9-8,CIN,9,0,44,44,88,138,167,305,16,19,35,2,3:12
5103,447029,2016-04-16,2016,OAK,KCA,5,3,5-3,OAK,9,1,39,38,77,165,141,306,15,11,26,2,3:02
5104,447032,2016-04-16,2016,CLE,NYN,7,5,7-5,CLE,9,1,37,38,75,155,125,280,14,12,26,2,2:54
5105,447028,2016-04-16,2016,HOU,DET,3,5,5-3,DET,9,0,34,43,77,163,134,297,10,16,26,1,3:17
5106,447035,2016-04-16,2016,BOS,TOR,4,2,4-2,BOS,9,1,33,32,65,135,118,253,11,7,18,0,2:43
5107,447031,2016-04-16,2016,PIT,MIL,5,0,5-0,PIT,9,1,37,33,70,138,150,288,15,8,23,0,2:52
5108,447025,2016-04-16,2016,TBA,CHA,7,2,7-2,TBA,9,1,38,34,72,124,141,265,16,8,24,5,2:52
5109,447034,2016-04-16,2016,NYA,SEA,2,3,3-2,SEA,9,0,43,38,81,157,175,332,16,11,27,1,3:21
5110,447022,2016-04-16,2016,SDN,ARI,5,3,5-3,SDN,14,0,59,58,117,233,238,471,21,17,38,2,5:25
5111,447048,2016-04-17,2016,LAN,SFN,3,1,3-1,LAN,9,1,30,33,63,129,104,233,9,9,18,2,2:42
5112,447040,2016-04-17,2016,TBA,CHA,3,2,3-2,TBA,9,1,30,34,64,137,121,258,8,7,15,2,2:36
5113,447037,2016-04-17,2016,SDN,ARI,3,7,7-3,ARI,9,0,35,37,72,117,131,248,9,12,21,1,2:37
5114,447042,2016-04-17,2016,CHN,COL,0,2,2-0,COL,9,0,32,32,64,129,124,253,5,7,12,1,2:38
5115,447047,2016-04-17,2016,CLE,NYN,0,6,6-0,NYN,9,0,32,39,71,145,115,260,5,11,16,1,2:32
5116,447041,2016-04-17,2016,SLN,CIN,4,3,4-3,SLN,9,1,36,34,70,122,139,261,11,10,21,2,2:44
5117,447043,2016-04-17,2016,HOU,DET,5,4,5-4,HOU,9,1,35,37,72,142,150,292,11,9,20,4,3:13
5118,447051,2016-04-17,2016,PHI,WAS,3,2,3-2,PHI,10,0,37,40,77,157,144,301,9,13,22,2,3:24
5119,447038,2016-04-17,2016,MIA,ATL,5,6,6-5,ATL,10,0,40,44,84,174,151,325,10,15,25,5,3:29
5120,447045,2016-04-17,2016,MIN,ANA,3,2,3-2,MIN,12,0,51,44,95,164,183,347,20,7,27,5,4:02
5121,447046,2016-04-17,2016,PIT,MIL,9,3,9-3,PIT,9,1,47,36,83,138,181,319,25,10,35,3,3:31
5122,447044,2016-04-17,2016,OAK,KCA,3,2,3-2,OAK,9,1,31,35,66,136,116,252,8,8,16,1,2:37
5123,447049,2016-04-17,2016,NYA,SEA,4,3,4-3,NYA,9,1,35,33,68,119,115,234,11,6,17,0,2:34
5124,447050,2016-04-17,2016,BOS,TOR,3,5,5-3,TOR,9,0,35,43,78,176,136,312,8,17,25,1,3:09
5125,447053,2016-04-18,2016,SLN,CHN,0,5,5-0,CHN,9,0,34,37,71,107,127,234,7,11,18,1,2:32
5126,447057,2016-04-18,2016,BOS,TOR,3,4,4-3,TOR,9,0,33,38,71,166,130,296,8,16,24,3,3:12
5127,447056,2016-04-18,2016,MIN,MIL,7,4,7-4,MIN,6,0,32,26,58,88,132,220,15,8,23,1,2:21 (2:06 delay)
5128,447058,2016-04-18,2016,MIA,WAS,6,1,6-1,MIA,9,1,37,38,75,148,120,268,13,13,26,1,2:43
5129,447055,2016-04-18,2016,CHA,ANA,0,7,7-0,ANA,9,0,33,41,74,171,130,301,6,15,21,1,2:58
5130,447052,2016-04-18,2016,SFN,ARI,7,9,9-7,ARI,11,0,51,50,101,182,223,405,20,20,40,3,4:35
5131,447054,2016-04-18,2016,CIN,COL,1,5,5-1,COL,9,0,32,36,68,141,112,253,6,10,16,2,2:41
5132,447067,2016-04-18,2016,PHI,NYN,2,5,5-2,NYN,9,0,36,39,75,146,132,278,10,13,23,0,2:51
5133,447070,2016-04-19,2016,CLE,SEA,3,2,3-2,CLE,9,1,36,36,72,140,133,273,15,9,24,3,2:56
5134,447061,2016-04-19,2016,CIN,COL,4,3,4-3,CIN,9,1,33,34,67,135,129,264,11,7,18,3,2:52
5135,447072,2016-04-19,2016,BAL,TOR,3,4,4-3,TOR,9,0,35,39,74,163,132,295,9,14,23,1,2:50
5136,447060,2016-04-19,2016,SLN,CHN,1,2,2-1,CHN,9,0,36,38,74,159,136,295,12,12,24,1,3:20
5137,447082,2016-04-19,2016,PHI,NYN,1,11,11-1,NYN,9,0,36,44,80,170,143,313,11,16,27,1,3:03
5138,447065,2016-04-19,2016,ATL,LAN,8,1,8-1,ATL,9,1,40,35,75,139,138,277,15,9,24,3,2:57
5139,447066,2016-04-19,2016,MIN,MIL,5,6,6-5,MIL,9,0,40,39,79,153,168,321,14,13,27,4,3:23
5140,447062,2016-04-19,2016,KCA,DET,8,6,8-6,KCA,9,1,37,45,82,184,141,325,14,17,31,2,3:08
5141,447073,2016-04-19,2016,MIA,WAS,0,7,7-0,WAS,9,0,33,39,72,134,120,254,7,13,20,2,2:38
5142,447069,2016-04-19,2016,SDN,PIT,5,4,5-4,SDN,9,1,42,41,83,169,196,365,19,15,34,4,4:01
5143,447064,2016-04-19,2016,CHA,ANA,5,0,5-0,CHA,9,1,35,32,67,128,141,269,12,6,18,2,2:46
5144,447063,2016-04-19,2016,TEX,HOU,7,5,7-5,TEX,9,1,37,38,75,182,136,318,15,11,26,2,3:22
5145,447059,2016-04-19,2016,SFN,ARI,0,3,3-0,ARI,9,0,37,40,77,148,148,296,11,16,27,2,3:08
5146,447071,2016-04-19,2016,BOS,TBA,0,3,3-0,TBA,10,0,32,43,75,179,126,305,3,13,16,2,3:25
5147,447068,2016-04-19,2016,NYA,OAK,2,3,3-2,OAK,11,0,43,44,87,162,169,331,11,12,23,1,3:30
5148,447088,2016-04-20,2016,MIA,WAS,1,3,3-1,WAS,9,0,31,34,65,122,116,238,7,9,16,1,2:33
5149,447074,2016-04-20,2016,SFN,ARI,1,2,2-1,ARI,9,0,35,34,69,118,139,257,8,9,17,2,2:54
5150,447079,2016-04-20,2016,CHA,ANA,2,1,2-1,CHA,9,1,32,31,63,141,142,283,10,5,15,3,2:59
5151,447075,2016-04-20,2016,SLN,CHN,5,3,5-3,SLN,9,1,35,36,71,140,123,263,13,9,22,2,2:40 (3:21 delay)
5152,447078,2016-04-20,2016,TEX,HOU,2,1,2-1,TEX,9,1,35,37,72,144,146,290,9,13,22,3,3:10
5153,447080,2016-04-20,2016,ATL,LAN,3,5,5-3,LAN,10,0,41,43,84,162,169,331,11,16,27,5,3:54 (:01 delay)
5154,447087,2016-04-20,2016,BAL,TOR,4,3,4-3,BAL,10,0,38,43,81,196,169,365,14,16,30,1,3:22
5155,447076,2016-04-20,2016,CIN,COL,6,5,6-5,CIN,9,0,34,37,71,144,129,273,9,12,21,3,2:55
5156,447085,2016-04-20,2016,CLE,SEA,1,2,2-1,SEA,9,0,33,34,67,140,141,281,6,6,12,1,2:48
5157,447086,2016-04-20,2016,BOS,TBA,7,3,7-3,BOS,9,1,38,36,74,138,145,283,16,9,25,2,3:02
5158,447077,2016-04-20,2016,KCA,DET,2,3,3-2,DET,9,0,38,39,77,142,153,295,13,13,26,2,3:08
5159,447083,2016-04-20,2016,NYA,OAK,2,5,5-2,OAK,9,0,35,39,74,149,142,291,9,15,24,1,2:57
5160,447084,2016-04-20,2016,SDN,PIT,8,2,8-2,SDN,9,1,38,40,78,155,155,310,17,13,30,2,2:59
5161,447096,2016-04-20,2016,PHI,NYN,5,4,5-4,PHI,11,0,45,49,94,191,173,364,15,17,32,2,4:03
5162,447081,2016-04-20,2016,MIL,MIN,10,5,10-5,MIL,9,1,41,40,81,136,187,323,19,15,34,3,3:22
5163,447091,2016-04-21,2016,KCA,DET,4,0,4-0,KCA,9,1,36,33,69,130,134,264,15,6,21,0,2:52
5164,447093,2016-04-21,2016,CHA,ANA,2,3,3-2,ANA,9,0,34,36,70,133,135,268,9,14,23,0,2:48
5165,447095,2016-04-21,2016,MIL,MIN,1,8,8-1,MIN,9,0,33,45,78,171,124,295,6,20,26,2,3:18
5166,447090,2016-04-21,2016,CIN,CHN,0,16,16-0,CHN,9,0,29,52,81,198,119,317,4,24,28,0,2:56
5167,447094,2016-04-21,2016,ATL,LAN,1,2,2-1,LAN,10,0,39,45,84,175,138,313,12,15,27,1,3:28
5168,447089,2016-04-21,2016,SFN,ARI,2,6,6-2,ARI,9,0,34,39,73,129,139,268,9,14,23,4,3:10
5169,447092,2016-04-21,2016,TEX,HOU,7,4,7-4,TEX,9,1,37,36,73,152,128,280,15,9,24,1,2:42
5170,447098,2016-04-21,2016,SDN,PIT,1,11,11-1,PIT,9,0,33,45,78,178,141,319,6,19,25,1,3:15
5171,447097,2016-04-21,2016,NYA,OAK,3,7,7-3,OAK,9,0,39,39,78,160,164,324,13,13,26,2,3:18
5172,447102,2016-04-21,2016,MIA,WAS,5,1,5-1,MIA,9,1,35,32,67,123,132,255,13,5,18,0,2:38
5173,447101,2016-04-21,2016,BAL,TOR,3,2,3-2,BAL,9,1,40,35,75,148,159,307,17,9,26,1,3:09
5174,447099,2016-04-21,2016,CLE,SEA,7,10,10-7,SEA,10,0,42,49,91,178,168,346,14,22,36,5,3:56
5175,447100,2016-04-21,2016,BOS,TBA,8,12,12-8,TBA,9,0,47,51,98,186,188,374,20,25,45,6,4:16
5176,447106,2016-04-22,2016,DET,CLE,1,2,2-1,CLE,9,0,32,35,67,159,112,271,5,8,13,1,2:46
5177,447115,2016-04-22,2016,SDN,SLN,4,1,4-1,SDN,9,1,34,35,69,137,115,252,12,9,21,0,2:35
5178,447107,2016-04-22,2016,COL,LAN,7,5,7-5,COL,9,1,35,38,73,145,143,288,12,12,24,3,3:27
5179,447103,2016-04-22,2016,KCA,BAL,4,2,4-2,KCA,9,1,32,33,65,141,121,262,9,6,15,0,2:31
5180,447111,2016-04-22,2016,TOR,OAK,5,8,8-5,OAK,9,0,38,44,82,159,148,307,13,19,32,3,3:21
5181,447104,2016-04-22,2016,HOU,BOS,2,6,6-2,BOS,9,0,39,40,79,159,167,326,13,17,30,2,3:28
5182,447112,2016-04-22,2016,MIL,PHI,2,5,5-2,PHI,9,0,36,37,73,145,134,279,9,12,21,0,2:48
5183,447117,2016-04-22,2016,CHA,TEX,5,0,5-0,CHA,9,1,35,31,66,119,141,260,11,7,18,1,2:41
5184,447116,2016-04-22,2016,NYA,TBA,6,3,6-3,NYA,9,1,35,40,75,134,134,268,13,12,25,3,3:02
5185,447105,2016-04-22,2016,CIN,CHN,1,8,8-1,CHN,9,0,32,40,72,172,123,295,7,14,21,1,3:03
5186,447113,2016-04-22,2016,ARI,PIT,7,8,8-7,PIT,9,0,43,39,82,150,148,298,17,15,32,3,3:12
5187,447108,2016-04-22,2016,SFN,MIA,8,1,8-1,SFN,9,1,44,34,78,136,172,308,23,8,31,2,3:09
5188,447114,2016-04-22,2016,ANA,SEA,2,5,5-2,SEA,10,0,35,41,76,166,124,290,7,14,21,2,3:23
5189,447110,2016-04-22,2016,ATL,NYN,3,6,6-3,NYN,9,0,40,39,79,152,167,319,13,13,26,2,3:21 (:56 delay)
5190,447109,2016-04-22,2016,WAS,MIN,8,4,8-4,WAS,9,1,39,38,77,130,136,266,16,10,26,2,2:51
5191,447124,2016-04-23,2016,WAS,MIN,2,0,2-0,WAS,9,1,32,33,65,148,117,265,9,6,15,1,2:39
5192,447131,2016-04-23,2016,NYA,TBA,3,2,3-2,NYA,9,0,38,32,70,119,161,280,10,7,17,2,2:55
5193,447122,2016-04-23,2016,COL,LAN,1,4,4-1,LAN,9,0,34,40,74,170,145,315,7,13,20,2,3:09
5194,447126,2016-04-23,2016,TOR,OAK,9,3,9-3,TOR,9,1,39,33,72,120,149,269,16,9,25,0,2:38
5195,447118,2016-04-23,2016,KCA,BAL,3,8,8-3,BAL,9,0,35,43,78,158,132,290,8,18,26,4,3:04
5196,447119,2016-04-23,2016,HOU,BOS,8,3,8-3,HOU,9,1,41,38,79,144,159,303,19,11,30,3,3:28
5197,447129,2016-04-23,2016,ANA,SEA,4,2,4-2,ANA,9,1,33,36,69,142,122,264,11,10,21,2,2:45
5198,447125,2016-04-23,2016,ATL,NYN,2,8,8-2,NYN,9,0,37,47,84,166,138,304,11,20,31,3,3:00
5199,447128,2016-04-23,2016,ARI,PIT,7,1,7-1,ARI,9,1,37,34,71,123,144,267,12,8,20,2,2:58
5200,447130,2016-04-23,2016,SDN,SLN,2,11,11-2,SLN,9,0,37,45,82,183,127,310,11,21,32,3,3:06
5201,447132,2016-04-23,2016,CHA,TEX,4,3,4-3,CHA,11,0,48,43,91,179,192,371,20,11,31,2,3:57
5202,447120,2016-04-23,2016,CIN,CHN,13,5,13-5,CIN,9,1,40,43,83,186,164,350,20,16,36,3,3:19
5203,447123,2016-04-23,2016,SFN,MIA,7,2,7-2,SFN,9,1,37,34,71,108,148,256,19,9,28,2,2:46
5204,447121,2016-04-23,2016,DET,CLE,1,10,10-1,CLE,9,0,29,43,72,162,118,280,2,17,19,3,2:41
5205,447127,2016-04-23,2016,MIL,PHI,6,10,10-6,PHI,9,0,40,47,87,200,187,387,14,20,34,2,4:00
5206,447141,2016-04-24,2016,TOR,OAK,6,3,6-3,TOR,9,1,39,33,72,130,142,272,17,8,25,4,2:44
5207,447142,2016-04-24,2016,MIL,PHI,8,5,8-5,MIL,9,1,36,36,72,130,141,271,12,11,23,1,2:49
5208,447133,2016-04-24,2016,KCA,BAL,6,1,6-1,KCA,9,1,37,33,70,115,147,262,14,6,20,2,2:42
5209,447136,2016-04-24,2016,DET,CLE,3,6,6-3,CLE,9,0,37,41,78,157,149,306,11,17,28,4,3:20
5210,447144,2016-04-24,2016,ANA,SEA,4,9,9-4,SEA,9,0,33,39,72,145,117,262,8,13,21,3,2:43
5211,447147,2016-04-24,2016,CHA,TEX,4,1,4-1,CHA,9,1,34,37,71,157,130,287,13,11,24,1,2:52
5212,447140,2016-04-24,2016,ATL,NYN,2,3,3-2,NYN,9,0,38,35,73,149,132,281,12,12,24,3,2:56
5213,447135,2016-04-24,2016,CIN,CHN,0,9,9-0,CHN,9,0,32,44,76,175,135,310,5,19,24,2,3:08
5214,447145,2016-04-24,2016,SDN,SLN,5,8,8-5,SLN,9,0,41,46,87,183,173,356,13,20,33,1,3:35
5215,447138,2016-04-24,2016,SFN,MIA,4,5,5-4,MIA,9,0,42,41,83,143,159,302,18,17,35,4,3:14
5216,447134,2016-04-24,2016,HOU,BOS,5,7,7-5,BOS,12,0,53,56,109,219,218,437,16,22,38,4,5:03
5217,447137,2016-04-24,2016,COL,LAN,10,12,12-10,LAN,9,0,47,48,95,171,171,342,21,21,42,6,4:02
5218,447146,2016-04-24,2016,NYA,TBA,1,8,8-1,TBA,9,0,34,42,76,178,120,298,8,15,23,0,2:50
5219,447143,2016-04-24,2016,ARI,PIT,10,12,12-10,PIT,13,0,62,64,126,249,261,510,25,29,54,2,5:25
5220,447139,2016-04-24,2016,WAS,MIN,6,5,6-5,WAS,16,0,65,62,127,243,273,516,21,15,36,5,5:56
5221,447153,2016-04-25,2016,SEA,HOU,3,2,3-2,SEA,9,1,33,37,70,156,134,290,11,12,23,0,2:40
5222,447157,2016-04-25,2016,DET,OAK,7,3,7-3,DET,9,1,37,38,75,132,136,268,13,11,24,3,2:39
5223,447155,2016-04-25,2016,LAN,MIA,2,3,3-2,MIA,9,0,36,37,73,146,136,282,9,11,20,3,2:51
5224,447154,2016-04-25,2016,ANA,KCA,6,1,6-1,ANA,9,1,35,36,71,151,137,288,15,9,24,1,2:59
5225,447148,2016-04-25,2016,TBA,BAL,2,0,2-0,TBA,9,1,34,32,66,122,134,256,11,5,16,4,2:37
5226,447156,2016-04-25,2016,TEX,NYA,1,3,3-1,NYA,9,0,30,38,68,140,117,257,5,12,17,2,2:46
5227,447149,2016-04-25,2016,ATL,BOS,0,1,1-0,BOS,9,0,33,36,69,139,134,273,7,9,16,1,2:55
5228,447159,2016-04-25,2016,SFN,SDN,5,4,5-4,SFN,9,1,39,40,79,165,177,342,16,13,29,5,3:47
5229,447152,2016-04-25,2016,MIN,CLE,4,3,4-3,MIN,9,0,33,40,73,172,143,315,10,16,26,4,3:24
5230,447151,2016-04-25,2016,NYN,CIN,5,3,5-3,NYN,9,1,37,37,74,150,141,291,13,10,23,2,3:11
5231,447160,2016-04-25,2016,ARI,SLN,12,7,12-7,ARI,9,1,46,38,84,126,176,302,24,12,36,4,3:26
5232,447158,2016-04-25,2016,COL,PIT,1,6,6-1,PIT,9,0,39,38,77,143,153,296,12,12,24,2,2:59 (:30 delay)
5233,447150,2016-04-25,2016,TOR,CHA,5,7,7-5,CHA,9,0,42,42,84,167,159,326,17,16,33,6,3:24
5234,447168,2016-04-26,2016,LAN,MIA,3,6,6-3,MIA,9,0,38,40,78,150,144,294,11,13,24,2,3:02
5235,447163,2016-04-26,2016,TOR,CHA,1,10,10-1,CHA,9,0,32,44,76,166,113,279,6,18,24,2,2:35
5236,447175,2016-04-26,2016,ARI,SLN,2,8,8-2,SLN,9,0,33,43,76,156,122,278,7,18,25,1,2:47
5237,447164,2016-04-26,2016,NYN,CIN,4,3,4-3,NYN,9,1,34,38,72,146,137,283,12,14,26,1,2:58
5238,447174,2016-04-26,2016,SFN,SDN,1,0,1-0,SFN,9,1,33,32,65,119,112,231,10,8,18,0,2:28
5239,447166,2016-04-26,2016,SEA,HOU,11,1,11-1,SEA,9,1,39,35,74,144,176,320,15,8,23,0,3:02
5240,447171,2016-04-26,2016,DET,OAK,1,5,5-1,OAK,9,0,32,35,67,124,150,274,6,10,16,1,2:38
5241,447161,2016-04-26,2016,TBA,BAL,3,1,3-1,TBA,9,1,35,33,68,139,141,280,13,10,23,2,2:44
5242,447167,2016-04-26,2016,ANA,KCA,9,4,9-4,ANA,9,1,42,37,79,129,155,284,19,13,32,0,3:02
5243,447162,2016-04-26,2016,ATL,BOS,4,11,11-4,BOS,9,0,39,43,82,153,130,283,11,18,29,1,2:52
5244,447172,2016-04-26,2016,WAS,PHI,3,4,4-3,PHI,9,0,39,39,78,163,140,303,14,14,28,2,3:25
5245,447169,2016-04-26,2016,CHN,MIL,4,3,4-3,CHN,9,1,38,33,71,149,167,316,13,7,20,2,3:09
5246,447170,2016-04-26,2016,TEX,NYA,10,1,10-1,TEX,9,1,39,32,71,113,135,248,18,7,25,0,2:19
5247,447173,2016-04-26,2016,COL,PIT,4,9,9-4,PIT,9,0,38,45,83,183,149,332,14,19,33,1,3:19
5248,447165,2016-04-26,2016,MIN,CLE,6,5,6-5,MIN,9,0,40,33,73,125,148,273,18,6,24,2,2:52
5249,447187,2016-04-27,2016,WAS,PHI,0,3,3-0,PHI,9,0,31,38,69,147,119,266,5,12,17,1,2:59
5250,447179,2016-04-27,2016,NYN,CIN,5,2,5-2,NYN,9,1,37,35,72,147,138,285,11,8,19,1,2:54
5251,447189,2016-04-27,2016,SFN,SDN,13,9,13-9,SFN,9,1,47,38,85,152,177,329,23,12,35,4,3:21
5252,447182,2016-04-27,2016,ANA,KCA,4,2,4-2,ANA,9,1,30,38,68,148,110,258,7,13,20,2,2:51
5253,447183,2016-04-27,2016,LAN,MIA,0,2,2-0,MIA,9,0,33,37,70,157,137,294,7,11,18,4,3:03
5254,447181,2016-04-27,2016,SEA,HOU,4,7,7-4,HOU,9,0,40,39,79,158,171,329,14,13,27,2,3:23
5255,447190,2016-04-27,2016,ARI,SLN,4,11,11-4,SLN,9,0,37,48,85,177,145,322,12,21,33,4,3:32
5256,447177,2016-04-27,2016,TBA,BAL,1,3,3-1,BAL,9,0,34,32,66,137,142,279,7,5,12,1,2:43
5257,447185,2016-04-27,2016,TEX,NYA,3,2,3-2,TEX,9,1,32,34,66,130,120,250,9,9,18,1,2:44
5258,447178,2016-04-27,2016,TOR,CHA,0,4,4-0,CHA,9,0,34,39,73,170,136,306,7,13,20,1,2:52
5259,447176,2016-04-27,2016,BOS,ATL,9,4,9-4,BOS,9,1,40,39,79,146,160,306,17,10,27,1,3:02
5260,447180,2016-04-27,2016,MIN,CLE,5,6,6-5,CLE,9,0,39,41,80,185,142,327,12,15,27,4,3:32 (:35 delay)
5261,447188,2016-04-27,2016,COL,PIT,8,9,9-8,PIT,12,0,56,54,110,250,205,455,22,19,41,3,4:58
5262,447186,2016-04-27,2016,DET,OAK,9,4,9-4,DET,9,1,41,37,78,147,177,324,18,10,28,3,3:23
5263,447193,2016-04-28,2016,LAN,MIA,3,5,5-3,MIA,9,0,38,38,76,135,146,281,13,11,24,2,2:51
5264,447198,2016-04-28,2016,ARI,SLN,3,0,3-0,ARI,9,1,32,33,65,123,131,254,10,6,16,0,2:25
5265,447191,2016-04-28,2016,BOS,ATL,3,5,5-3,ATL,9,0,39,42,81,142,146,288,13,18,31,4,3:22
5266,447196,2016-04-28,2016,WAS,PHI,0,3,3-0,PHI,9,0,33,35,68,142,126,268,7,10,17,2,2:59 (:36 delay)
5267,447195,2016-04-28,2016,DET,OAK,7,3,7-3,DET,9,1,39,41,80,162,156,318,16,15,31,3,3:04
5268,447194,2016-04-28,2016,CHN,MIL,7,2,7-2,CHN,9,1,45,39,84,181,199,380,21,13,34,2,3:45
5269,447192,2016-04-28,2016,BAL,CHA,10,2,10-2,BAL,9,1,42,40,82,162,165,327,19,13,32,2,3:10
5270,447202,2016-04-29,2016,PHI,CLE,4,3,4-3,PHI,11,0,40,41,81,179,143,322,14,10,24,2,3:20
5271,447199,2016-04-29,2016,CHN,ATL,6,1,6-1,CHN,9,1,35,34,69,125,135,260,15,9,24,2,2:38
5272,447201,2016-04-29,2016,PIT,CIN,4,1,4-1,PIT,9,1,32,34,66,137,128,265,11,7,18,1,2:41
5273,447212,2016-04-29,2016,TBA,TOR,1,6,6-1,TOR,9,0,37,37,74,152,140,292,11,11,22,2,2:43
5274,447210,2016-04-29,2016,LAN,SDN,1,5,5-1,SDN,9,0,37,37,74,141,140,281,11,11,22,2,3:01
5275,447204,2016-04-29,2016,MIN,DET,2,9,9-2,DET,9,0,36,45,81,151,157,308,9,22,31,3,3:09
5276,447209,2016-04-29,2016,BOS,NYA,4,2,4-2,BOS,9,1,33,33,66,123,120,243,8,10,18,1,2:50
5277,447206,2016-04-29,2016,SEA,KCA,1,0,1-0,SEA,9,1,31,34,65,137,137,274,8,9,17,2,2:49
5278,447213,2016-04-29,2016,SLN,WAS,4,5,5-4,WAS,9,0,37,35,72,125,133,258,12,9,21,0,2:46
5279,447207,2016-04-29,2016,TEX,ANA,4,2,4-2,TEX,9,1,32,35,67,101,132,233,11,11,22,2,2:35
5280,447205,2016-04-29,2016,OAK,HOU,7,4,7-4,OAK,9,0,35,36,71,157,134,291,13,12,25,4,3:13
5281,447208,2016-04-29,2016,MIL,MIA,3,6,6-3,MIA,9,0,38,38,76,152,162,314,10,15,25,2,3:02
5282,447203,2016-04-29,2016,ARI,COL,0,9,9-0,COL,9,0,33,43,76,173,163,336,9,16,25,2,3:21
5283,447200,2016-04-29,2016,BAL,CHA,6,3,6-3,BAL,9,1,34,34,68,131,116,247,11,9,20,0,2:30
5284,447211,2016-04-29,2016,NYN,SFN,13,1,13-1,NYN,9,1,42,41,83,177,169,346,18,15,33,1,3:17
5285,447218,2016-04-30,2016,ARI,COL,2,5,5-2,COL,9,0,33,41,74,144,143,287,8,18,26,1,3:16
5286,447221,2016-04-30,2016,SEA,KCA,6,0,6-0,SEA,9,1,39,32,71,114,155,269,17,6,23,1,2:28
5287,447219,2016-04-30,2016,MIN,DET,1,4,4-1,DET,9,0,34,36,70,150,138,288,8,9,17,2,2:51
5288,447225,2016-04-30,2016,LAN,SDN,2,5,5-2,SDN,9,0,35,41,76,167,143,310,10,14,24,2,3:06
5289,447227,2016-04-30,2016,TBA,TOR,4,3,4-3,TBA,9,0,36,36,72,153,138,291,13,9,22,3,2:52
5290,447217,2016-04-30,2016,PHI,CLE,4,3,4-3,PHI,9,1,33,37,70,140,126,266,10,10,20,3,3:03
5291,447226,2016-04-30,2016,NYN,SFN,6,5,6-5,NYN,9,1,35,39,74,176,136,312,13,13,26,3,3:09
5292,447228,2016-04-30,2016,SLN,WAS,1,6,6-1,WAS,9,0,37,39,76,132,141,273,10,13,23,2,3:02
5293,447224,2016-04-30,2016,BOS,NYA,8,0,8-0,BOS,9,1,44,33,77,129,204,333,20,6,26,2,3:30
5294,447216,2016-04-30,2016,PIT,CIN,5,1,5-1,PIT,9,1,41,37,78,146,164,310,18,9,27,3,3:17
5295,447223,2016-04-30,2016,MIL,MIA,5,7,7-5,MIA,9,0,35,51,86,197,147,344,9,24,33,3,3:24
5296,447220,2016-04-30,2016,OAK,HOU,2,0,2-0,OAK,9,1,32,32,64,122,125,247,8,8,16,1,2:27
5297,447222,2016-04-30,2016,TEX,ANA,7,2,7-2,TEX,9,1,38,35,73,142,133,275,13,9,22,1,2:55
5298,447215,2016-04-30,2016,BAL,CHA,7,8,8-7,CHA,9,0,43,41,84,169,154,323,19,14,33,5,3:42
5299,447241,2016-05-01,2016,NYN,SFN,1,6,6-1,SFN,9,0,40,36,76,146,156,302,14,11,25,4,3:19
5300,447242,2016-05-01,2016,TBA,TOR,1,5,5-1,TOR,9,0,33,33,66,143,118,261,6,9,15,2,2:34
5301,447240,2016-05-01,2016,LAN,SDN,1,0,1-0,LAN,9,1,28,29,57,101,118,219,6,3,9,1,2:07
5302,447232,2016-05-01,2016,PHI,CLE,2,1,2-1,PHI,9,1,27,33,60,151,110,261,6,8,14,0,2:40
5303,447243,2016-05-01,2016,SLN,WAS,1,6,6-1,WAS,9,0,33,38,71,136,136,272,6,11,17,2,2:47
5304,447239,2016-05-01,2016,BOS,NYA,8,7,8-7,BOS,9,1,40,38,78,133,138,271,17,12,29,2,3:17
5305,447229,2016-05-01,2016,CHN,ATL,3,4,4-3,ATL,10,0,40,38,78,129,164,293,10,10,20,3,3:04
5306,447234,2016-05-01,2016,MIN,DET,5,6,6-5,DET,9,0,40,39,79,155,168,323,14,14,28,3,3:33
5307,447231,2016-05-01,2016,PIT,CIN,5,6,6-5,CIN,11,0,46,46,92,173,177,350,16,15,31,3,3:42
5308,447238,2016-05-01,2016,MIL,MIA,14,5,14-5,MIL,9,1,44,43,87,152,167,319,22,18,40,3,3:21
5309,447233,2016-05-01,2016,ARI,COL,3,6,6-3,COL,9,0,40,39,79,153,143,296,13,12,25,5,3:23
5310,447237,2016-05-01,2016,TEX,ANA,6,9,9-6,ANA,9,0,41,45,86,174,156,330,16,20,36,2,3:33
5311,447230,2016-05-01,2016,BAL,CHA,1,7,7-1,CHA,9,0,40,46,86,161,176,337,14,21,35,4,3:07
5312,447235,2016-05-01,2016,OAK,HOU,1,2,2-1,HOU,9,0,36,36,72,163,122,285,9,10,19,3,2:50
5313,447236,2016-05-01,2016,SEA,KCA,1,4,4-1,KCA,9,0,38,39,77,162,167,329,12,13,25,1,3:14
5314,447251,2016-05-02,2016,OAK,SEA,3,4,4-3,SEA,9,0,34,38,72,133,121,254,8,13,21,4,2:45
5315,447253,2016-05-02,2016,KCA,WAS,0,2,2-0,WAS,9,0,34,36,70,137,140,277,8,11,19,2,3:09
5316,447246,2016-05-02,2016,SDN,COL,2,1,2-1,SDN,9,1,32,35,67,154,132,286,10,12,22,1,3:01
5317,447245,2016-05-02,2016,PIT,CHN,2,7,7-2,CHN,9,0,36,45,81,173,137,310,11,18,29,2,3:18
5318,447250,2016-05-02,2016,CIN,SFN,6,9,9-6,SFN,9,0,36,45,81,167,147,314,10,19,29,4,3:17
5319,447252,2016-05-02,2016,TOR,TEX,1,2,2-1,TEX,9,0,36,36,72,126,154,280,11,11,22,2,2:44
5320,447249,2016-05-02,2016,SLN,PHI,10,3,10-3,SLN,9,1,42,36,78,141,146,287,18,9,27,1,3:01
5321,447247,2016-05-02,2016,MIL,ANA,8,5,8-5,MIL,9,1,39,42,81,149,144,293,19,15,34,2,3:30
5322,447248,2016-05-02,2016,HOU,MIN,2,6,6-2,MIN,9,0,37,38,75,150,151,301,11,13,24,3,3:08
5323,447244,2016-05-02,2016,NYN,ATL,4,1,4-1,NYN,9,1,35,35,70,111,156,267,14,9,23,2,2:31
5324,447255,2016-05-03,2016,NYN,ATL,0,3,3-0,ATL,9,0,30,38,68,139,117,256,4,11,15,1,2:38
5325,447264,2016-05-03,2016,SLN,PHI,0,1,1-0,PHI,9,0,31,33,64,110,144,254,4,8,12,0,2:31
5326,447263,2016-05-03,2016,BAL,NYA,4,1,4-1,BAL,9,1,33,36,69,139,129,268,7,11,18,0,2:43
5327,447256,2016-05-03,2016,CHA,BOS,4,1,4-1,CHA,9,1,35,30,65,115,158,273,13,4,17,1,2:53
5328,447258,2016-05-03,2016,SDN,COL,6,3,6-3,SDN,9,1,34,33,67,146,123,269,11,8,19,1,2:46
5329,447260,2016-05-03,2016,MIL,ANA,5,4,5-4,MIL,9,1,35,35,70,116,139,255,12,12,24,0,2:41
5330,447262,2016-05-03,2016,HOU,MIN,6,4,6-4,HOU,9,1,33,35,68,151,147,298,9,9,18,2,3:01
5331,447254,2016-05-03,2016,MIA,ARI,7,4,7-4,MIA,9,1,38,38,76,132,156,288,14,12,26,2,3:11
5332,447257,2016-05-03,2016,PIT,CHN,1,7,7-1,CHN,9,0,33,43,76,142,135,277,6,17,23,0,2:31
5333,447265,2016-05-03,2016,CIN,SFN,1,3,3-1,SFN,9,0,32,40,72,174,132,306,6,16,22,1,3:05
5334,447259,2016-05-03,2016,CLE,DET,7,3,7-3,CLE,9,1,36,39,75,163,137,300,14,14,28,1,3:12
5335,447268,2016-05-03,2016,KCA,WAS,7,6,7-6,KCA,9,0,38,40,78,164,133,297,13,13,26,3,3:05
5336,447261,2016-05-03,2016,TBA,LAN,5,10,10-5,LAN,9,0,40,43,83,163,155,318,13,16,29,5,3:11
5337,447266,2016-05-03,2016,OAK,SEA,2,8,8-2,SEA,9,0,33,40,73,131,108,239,8,14,22,2,2:38
5338,447267,2016-05-03,2016,TOR,TEX,3,1,3-1,TOR,10,0,42,38,80,144,189,333,16,8,24,3,3:25
5339,447274,2016-05-04,2016,CLE,DET,4,0,4-0,CLE,9,1,30,32,62,111,115,226,9,7,16,0,2:19
5340,447271,2016-05-04,2016,CHA,BOS,2,5,5-2,BOS,9,0,31,39,70,154,121,275,6,15,21,1,2:46
5341,447279,2016-05-04,2016,SLN,PHI,5,4,5-4,SLN,9,0,39,34,73,119,138,257,16,7,23,2,3:03
5342,447282,2016-05-04,2016,TOR,TEX,4,3,4-3,TOR,9,0,35,37,72,130,135,265,10,11,21,0,2:32
5343,447280,2016-05-04,2016,CIN,SFN,7,4,7-4,CIN,9,1,35,38,73,151,122,273,11,12,23,1,2:42
5344,447269,2016-05-04,2016,MIA,ARI,4,3,4-3,MIA,9,1,34,38,72,162,129,291,11,13,24,1,2:48
5345,447283,2016-05-04,2016,KCA,WAS,2,13,13-2,WAS,9,0,34,47,81,168,129,297,7,18,25,1,2:53
5346,447276,2016-05-04,2016,TBA,LAN,8,5,8-5,TBA,9,1,36,41,77,187,140,327,12,15,27,4,3:21
5347,447281,2016-05-04,2016,OAK,SEA,8,9,9-8,SEA,9,0,40,47,87,160,147,307,12,20,32,3,3:10
5348,447277,2016-05-04,2016,HOU,MIN,16,4,16-4,HOU,9,1,46,38,84,150,171,321,21,11,32,3,3:23
5349,447272,2016-05-04,2016,PIT,CHN,2,6,6-2,CHN,9,0,39,43,82,158,157,315,13,18,31,2,3:25
5350,447270,2016-05-04,2016,NYN,ATL,8,0,8-0,NYN,9,1,38,31,69,127,156,283,14,4,18,2,2:28
5351,447275,2016-05-04,2016,MIL,ANA,3,7,7-3,ANA,9,0,39,42,81,164,166,330,13,18,31,2,3:28
5352,447273,2016-05-04,2016,SDN,COL,0,2,2-0,COL,9,0,30,36,66,134,112,246,4,12,16,1,2:36
5353,447278,2016-05-04,2016,BAL,NYA,0,7,7-0,NYA,9,0,35,42,77,161,144,305,11,16,27,2,3:16
5354,447292,2016-05-05,2016,HOU,SEA,3,6,6-3,SEA,9,0,36,41,77,167,136,303,12,16,28,2,3:13
5355,447290,2016-05-05,2016,BAL,NYA,1,0,1-0,BAL,10,0,35,33,68,134,119,253,9,5,14,2,2:50
5356,447287,2016-05-05,2016,CLE,DET,9,4,9-4,CLE,9,1,41,35,76,149,146,295,19,7,26,2,2:54
5357,447291,2016-05-05,2016,SLN,PHI,4,0,4-0,SLN,9,1,33,32,65,123,127,250,12,5,17,2,2:39
5358,447284,2016-05-05,2016,MIA,ARI,4,0,4-0,MIA,9,1,35,33,68,129,144,273,12,7,19,3,2:47
5359,447293,2016-05-05,2016,TOR,TEX,12,2,12-2,TOR,9,1,42,36,78,120,142,262,22,10,32,1,2:33
5360,447289,2016-05-05,2016,SDN,NYN,5,3,5-3,SDN,9,1,36,33,69,122,145,267,13,6,19,2,2:39
5361,447285,2016-05-05,2016,CHA,BOS,3,7,7-3,BOS,9,0,41,44,85,181,179,360,17,19,36,3,3:57
5362,447294,2016-05-05,2016,CHN,WAS,5,2,5-2,CHN,9,1,35,34,69,139,137,276,13,9,22,4,3:05
5363,447288,2016-05-05,2016,CIN,MIL,9,5,9-5,CIN,9,1,37,36,73,141,139,280,12,12,24,1,2:47
5364,447286,2016-05-05,2016,SFN,COL,7,17,17-7,COL,9,0,43,48,91,164,149,313,18,19,37,3,3:25
5365,447304,2016-05-06,2016,MIA,PHI,6,4,6-4,MIA,9,1,35,39,74,137,121,258,12,15,27,0,2:49
5366,447296,2016-05-06,2016,NYA,BOS,3,2,3-2,NYA,9,1,31,41,72,175,112,287,9,15,24,2,3:10
5367,447309,2016-05-06,2016,CHN,WAS,8,6,8-6,CHN,9,1,36,38,74,143,128,271,14,12,26,1,2:46
5368,447305,2016-05-06,2016,SLN,PIT,2,4,4-2,PIT,9,0,37,37,74,133,130,263,10,11,21,1,2:54
5369,447308,2016-05-06,2016,DET,TEX,1,5,5-1,TEX,9,0,31,38,69,120,132,252,4,11,15,0,2:31
5370,447297,2016-05-06,2016,SFN,COL,6,4,6-4,SFN,9,1,36,36,72,133,133,266,12,9,21,1,2:40
5371,447299,2016-05-06,2016,TOR,LAN,5,2,5-2,TOR,9,1,35,38,73,134,157,291,13,13,26,2,2:53
5372,447298,2016-05-06,2016,CLE,KCA,7,1,7-1,CLE,9,1,37,36,73,137,151,288,16,10,26,1,2:44
5373,447306,2016-05-06,2016,HOU,SEA,6,3,6-3,HOU,9,1,37,33,70,122,141,263,13,8,21,2,2:46
5374,447302,2016-05-06,2016,SDN,NYN,2,0,2-0,SDN,9,1,32,34,66,160,134,294,10,8,18,1,3:00
5375,447307,2016-05-06,2016,ANA,TBA,2,5,5-2,TBA,9,0,39,40,79,138,148,286,13,18,31,4,3:06
5376,447295,2016-05-06,2016,ATL,ARI,2,7,7-2,ARI,9,0,34,42,76,174,133,307,11,17,28,2,3:18
5377,447300,2016-05-06,2016,CIN,MIL,5,1,5-1,CIN,9,1,32,39,71,161,131,292,9,14,23,1,2:52
5378,447301,2016-05-06,2016,CHA,MIN,10,4,10-4,CHA,9,1,42,37,79,142,149,291,18,12,30,1,2:54
5379,447317,2016-05-07,2016,SDN,NYN,3,6,6-3,NYN,9,0,36,42,78,159,124,283,9,18,27,1,2:52
5380,447321,2016-05-07,2016,HOU,SEA,2,3,3-2,SEA,10,0,40,41,81,151,164,315,10,12,22,5,3:27
5381,447318,2016-05-07,2016,BAL,OAK,5,2,5-2,BAL,9,1,35,35,70,115,128,243,12,10,22,1,2:32
5382,447313,2016-05-07,2016,CLE,KCA,0,7,7-0,KCA,9,0,33,38,71,135,127,262,8,13,21,2,2:41
5383,447314,2016-05-07,2016,TOR,LAN,2,6,6-2,LAN,9,0,33,36,69,118,142,260,9,9,18,0,2:28
5384,447310,2016-05-07,2016,ATL,ARI,2,4,4-2,ARI,9,0,34,42,76,186,117,303,8,16,24,0,3:17
5385,447311,2016-05-07,2016,NYA,BOS,8,2,8-2,NYA,9,1,38,32,70,119,164,283,15,7,22,1,3:09
5386,447323,2016-05-07,2016,DET,TEX,5,10,10-5,TEX,9,0,44,38,82,143,167,310,19,12,31,5,3:14
5387,447322,2016-05-07,2016,ANA,TBA,2,4,4-2,TBA,9,0,34,38,72,163,123,286,9,10,19,1,3:06
5388,447315,2016-05-07,2016,CIN,MIL,7,13,13-7,MIL,10,0,42,49,91,171,156,327,13,18,31,2,3:38
5389,447320,2016-05-07,2016,SLN,PIT,6,4,6-4,SLN,9,0,37,41,78,162,149,311,13,13,26,1,3:23
5390,447316,2016-05-07,2016,CHA,MIN,7,2,7-2,CHA,9,1,42,35,77,148,173,321,21,8,29,3,2:58
5391,447312,2016-05-07,2016,SFN,COL,2,1,2-1,SFN,13,0,48,50,98,181,184,365,12,15,27,5,4:20
5392,447303,2016-05-07,2016,BAL,OAK,4,8,8-4,OAK,9,0,40,45,85,175,167,342,12,20,32,4,3:17
5393,447303,2016-05-07,2016,BAL,OAK,4,8,8-4,OAK,9,0,40,45,85,175,167,342,12,20,32,4,3:17
5394,447319,2016-05-07,2016,MIA,PHI,3,4,4-3,PHI,9,0,36,34,70,144,153,297,11,8,19,3,3:20
5395,447324,2016-05-07,2016,CHN,WAS,8,5,8-5,CHN,9,1,43,38,81,153,178,331,21,13,34,5,3:32
5396,447326,2016-05-08,2016,NYA,BOS,1,5,5-1,BOS,9,0,29,34,63,144,101,245,4,9,13,1,2:27
5397,447336,2016-05-08,2016,HOU,SEA,5,1,5-1,HOU,9,1,36,33,69,133,149,282,13,6,19,1,2:57
5398,447327,2016-05-08,2016,SFN,COL,0,2,2-0,COL,9,0,34,35,69,138,144,282,11,10,21,2,2:55
5399,447331,2016-05-08,2016,CHA,MIN,3,1,3-1,CHA,9,1,32,36,68,141,113,254,9,10,19,0,2:30
5400,447325,2016-05-08,2016,ATL,ARI,3,5,5-3,ARI,11,0,48,43,91,186,182,368,18,10,28,2,3:48
5401,447329,2016-05-08,2016,TOR,LAN,2,4,4-2,LAN,9,0,34,41,75,167,141,308,6,14,20,4,3:10
5402,447339,2016-05-08,2016,CHN,WAS,4,3,4-3,CHN,13,0,54,63,117,233,215,448,19,26,45,1,4:54
5403,447334,2016-05-08,2016,MIA,PHI,5,6,6-5,PHI,9,0,39,39,78,125,166,291,13,12,25,1,3:10
5404,447330,2016-05-08,2016,CIN,MIL,4,5,5-4,MIL,9,0,35,38,73,161,138,299,9,12,21,1,3:09 (1:55 delay)
5405,447332,2016-05-08,2016,SDN,NYN,3,4,4-3,NYN,9,0,36,42,78,177,155,332,10,16,26,2,3:30
5406,447338,2016-05-08,2016,DET,TEX,3,8,8-3,TEX,9,0,39,45,84,165,157,322,11,19,30,2,3:25
5407,447328,2016-05-08,2016,CLE,KCA,5,4,5-4,CLE,9,1,37,34,71,117,151,268,12,10,22,3,2:57
5408,447335,2016-05-08,2016,SLN,PIT,5,10,10-5,PIT,9,0,41,45,86,193,161,354,15,19,34,4,3:27
5409,447337,2016-05-08,2016,ANA,TBA,1,3,3-1,TBA,9,0,32,36,68,157,119,276,8,11,19,3,2:56
5410,447333,2016-05-08,2016,BAL,OAK,11,3,11-3,BAL,9,1,41,38,79,138,164,302,19,12,31,4,2:59
5411,447343,2016-05-09,2016,HOU,CLE,7,1,7-1,HOU,9,1,37,32,69,119,141,260,13,5,18,2,2:49
5412,447345,2016-05-09,2016,NYA,KCA,6,3,6-3,NYA,9,1,34,38,72,150,121,271,10,12,22,3,2:41
5413,447351,2016-05-09,2016,SEA,TBA,5,2,5-2,SEA,9,1,39,35,74,133,156,289,15,9,24,3,3:05
5414,447344,2016-05-09,2016,WAS,DET,5,4,5-4,WAS,9,0,36,37,73,132,119,251,12,13,25,5,2:57
5415,447352,2016-05-09,2016,SFN,TOR,1,3,3-1,TOR,9,0,36,40,76,171,133,304,9,13,22,0,2:52
5416,447340,2016-05-09,2016,COL,ARI,5,10,10-5,ARI,9,0,42,43,85,144,165,309,16,17,33,0,3:23
5417,447346,2016-05-09,2016,MIA,MIL,4,1,4-1,MIA,9,1,38,37,75,168,141,309,17,13,30,1,3:07
5418,447349,2016-05-09,2016,CIN,PIT,3,2,3-2,CIN,9,1,32,36,68,132,129,261,12,9,21,1,2:37
5419,447342,2016-05-09,2016,TEX,CHA,4,8,8-4,CHA,12,0,50,53,103,187,172,359,14,20,34,3,3:58
5420,447348,2016-05-09,2016,BOS,OAK,14,7,14-7,BOS,9,1,44,41,85,170,177,347,20,14,34,1,3:46
5421,447347,2016-05-09,2016,LAN,NYN,2,4,4-2,NYN,9,0,36,39,75,163,149,312,8,15,23,5,3:08
5422,447362,2016-05-10,2016,ATL,PHI,2,3,3-2,PHI,9,0,34,38,72,122,129,251,8,11,19,0,2:33
5423,447353,2016-05-10,2016,COL,ARI,1,5,5-1,ARI,9,0,33,42,75,144,117,261,5,18,23,2,3:08
5424,447365,2016-05-10,2016,ANA,SLN,1,8,8-1,SLN,9,0,36,45,81,180,131,311,8,18,26,2,2:57
5425,447367,2016-05-10,2016,SFN,TOR,0,4,4-0,TOR,9,0,34,35,69,129,122,251,10,9,19,1,2:29
5426,447355,2016-05-10,2016,TEX,CHA,13,11,13-11,TEX,9,1,43,46,89,186,152,338,21,20,41,5,3:22 (1:18 delay)
5427,447366,2016-05-10,2016,SEA,TBA,6,4,6-4,SEA,9,1,34,36,70,165,124,289,11,9,20,3,2:46
5428,447354,2016-05-10,2016,MIN,BAL,3,5,5-3,BAL,9,0,35,41,76,163,146,309,8,17,25,0,3:01
5429,447356,2016-05-10,2016,HOU,CLE,0,4,4-0,CLE,9,0,33,35,68,137,138,275,8,11,19,1,2:38
5430,447357,2016-05-10,2016,WAS,DET,4,5,5-4,DET,9,0,41,40,81,152,173,325,18,13,31,1,3:16
5431,447361,2016-05-10,2016,BOS,OAK,13,5,13-5,BOS,9,1,44,42,86,151,140,291,21,16,37,3,3:07
5432,447358,2016-05-10,2016,NYA,KCA,10,7,10-7,NYA,9,1,41,38,79,125,181,306,18,11,29,1,3:07
5433,447364,2016-05-10,2016,CHN,SDN,8,7,8-7,CHN,9,1,39,40,79,162,154,316,18,12,30,3,3:13
5434,447360,2016-05-10,2016,LAN,NYN,3,2,3-2,LAN,9,0,36,34,70,137,134,271,12,8,20,1,2:52
5435,447359,2016-05-10,2016,MIA,MIL,2,10,10-2,MIL,9,0,37,49,86,194,142,336,11,21,32,1,3:17
5436,447377,2016-05-11,2016,ATL,PHI,5,1,5-1,ATL,9,1,36,30,66,107,131,238,12,4,16,1,2:20
5437,447372,2016-05-11,2016,WAS,DET,3,2,3-2,WAS,9,1,33,33,66,119,129,248,13,6,19,1,2:38
5438,447374,2016-05-11,2016,MIA,MIL,3,2,3-2,MIA,9,1,29,36,65,134,110,244,6,11,17,1,2:29
5439,447375,2016-05-11,2016,LAN,NYN,3,4,4-3,NYN,9,0,34,40,74,166,107,273,8,14,22,2,3:04
5440,447378,2016-05-11,2016,CIN,PIT,4,5,5-4,PIT,9,0,35,38,73,149,114,263,9,12,21,2,3:04
5441,447379,2016-05-11,2016,CHN,SDN,0,1,1-0,SDN,9,0,36,30,66,121,164,285,9,3,12,1,2:45
5442,447380,2016-05-11,2016,ANA,SLN,2,5,5-2,SLN,9,0,34,36,70,139,131,270,7,11,18,2,3:00
5443,447370,2016-05-11,2016,TEX,CHA,6,5,6-5,TEX,9,1,38,41,79,175,139,314,16,14,30,2,3:07
5444,447373,2016-05-11,2016,NYA,KCA,3,7,7-3,KCA,9,0,38,43,81,176,138,314,11,18,29,2,3:18
5445,447376,2016-05-11,2016,BOS,OAK,13,3,13-3,BOS,9,1,46,39,85,144,168,312,23,12,35,3,3:17
5446,447369,2016-05-11,2016,MIN,BAL,2,9,9-2,BAL,9,0,36,43,79,166,131,297,10,18,28,1,2:54
5447,447368,2016-05-11,2016,COL,ARI,8,7,8-7,COL,9,1,42,39,81,146,168,314,17,13,30,5,3:19
5448,447350,2016-05-11,2016,CHN,SDN,4,7,7-4,SDN,9,0,43,44,87,172,171,343,18,18,36,2,3:15
5449,447381,2016-05-11,2016,SEA,TBA,6,5,6-5,SEA,11,0,44,50,94,202,191,393,15,17,32,5,4:01
5450,447350,2016-05-11,2016,CHN,SDN,4,7,7-4,SDN,9,0,43,44,87,172,171,343,18,18,36,2,3:15
5451,447371,2016-05-11,2016,HOU,CLE,5,3,5-3,HOU,16,0,68,61,129,222,267,489,24,15,39,5,5:09
5452,447382,2016-05-11,2016,SFN,TOR,5,4,5-4,SFN,13,0,58,57,115,224,206,430,22,20,42,4,4:28
5453,447384,2016-05-12,2016,BOS,HOU,11,1,11-1,BOS,9,1,41,35,76,133,146,279,17,8,25,1,2:56
5454,447386,2016-05-12,2016,LAN,NYN,5,0,5-0,LAN,9,1,32,30,62,109,113,222,8,4,12,0,2:13
5455,447390,2016-05-12,2016,ANA,SLN,10,12,12-10,SLN,9,0,45,51,96,203,164,367,19,24,43,7,3:56
5456,447387,2016-05-12,2016,ATL,PHI,4,7,7-4,PHI,10,0,37,43,80,168,123,291,10,15,25,4,3:14 (:10 delay)
5457,447389,2016-05-12,2016,ARI,SFN,2,4,4-2,SFN,9,0,40,37,77,135,153,288,14,11,25,2,3:13
5458,447385,2016-05-12,2016,NYA,KCA,7,3,7-3,NYA,9,1,36,37,73,140,136,276,12,11,23,1,2:45
5459,447388,2016-05-12,2016,MIL,SDN,0,3,3-0,SDN,9,0,33,35,68,115,143,258,10,9,19,0,2:51
5460,447383,2016-05-12,2016,BAL,DET,7,5,7-5,BAL,9,1,39,44,83,162,153,315,15,18,33,4,3:16
5461,447394,2016-05-13,2016,BAL,DET,1,0,1-0,BAL,9,1,29,33,62,125,112,237,7,8,15,0,2:39
5462,447403,2016-05-13,2016,ARI,SFN,1,3,3-1,SFN,9,0,33,34,67,142,128,270,8,12,20,2,3:00
5463,447393,2016-05-13,2016,PHI,CIN,3,2,3-2,PHI,9,1,32,31,63,119,119,238,12,6,18,0,2:37
5464,447405,2016-05-13,2016,TEX,TOR,0,5,5-0,TOR,9,0,30,40,70,172,120,292,4,13,17,2,2:38
5465,447396,2016-05-13,2016,SEA,ANA,6,7,7-6,ANA,9,0,45,43,88,148,177,325,20,17,37,2,3:41
5466,447397,2016-05-13,2016,WAS,MIA,5,3,5-3,WAS,9,1,37,38,75,151,156,307,15,11,26,4,3:19
5467,447391,2016-05-13,2016,KCA,ATL,5,1,5-1,KCA,9,1,36,35,71,111,143,254,13,7,20,1,2:45
5468,447392,2016-05-13,2016,NYA,CHA,1,7,7-1,CHA,9,0,33,44,77,176,99,275,6,17,23,1,2:45
5469,447402,2016-05-13,2016,MIL,SDN,1,0,1-0,MIL,9,1,34,31,65,125,149,274,14,5,19,0,2:56
5470,447400,2016-05-13,2016,TBA,OAK,3,6,6-3,OAK,9,0,40,40,80,173,168,341,13,15,28,0,3:07
5471,447398,2016-05-13,2016,CLE,MIN,7,6,7-6,CLE,9,1,36,41,77,162,139,301,12,14,26,4,3:07
5472,447395,2016-05-13,2016,BOS,HOU,6,7,7-6,HOU,9,0,40,43,83,189,165,354,16,17,33,5,3:49
5473,447401,2016-05-13,2016,CHN,PIT,9,4,9-4,CHN,9,1,38,40,78,152,153,305,15,15,30,3,2:55
5474,447399,2016-05-13,2016,COL,NYN,5,2,5-2,COL,9,1,36,35,71,139,130,269,14,8,22,1,2:48
5475,447404,2016-05-13,2016,LAN,SLN,8,4,8-4,LAN,9,1,41,39,80,140,147,287,14,13,27,4,3:01
5476,446932,2016-05-14,2016,WAS,MIA,6,4,6-4,WAS,9,1,41,40,81,158,156,314,17,14,31,2,3:22
5477,447418,2016-05-14,2016,ARI,SFN,3,5,5-3,SFN,9,0,38,41,79,140,130,270,10,16,26,3,3:05
5478,446932,2016-05-14,2016,WAS,MIA,6,4,6-4,WAS,9,1,41,40,81,158,156,314,17,14,31,2,3:22
5479,447419,2016-05-14,2016,LAN,SLN,5,3,5-3,LAN,9,1,33,35,68,123,133,256,10,6,16,2,2:45
5480,447416,2016-05-14,2016,CHN,PIT,8,2,8-2,CHN,9,1,41,32,73,122,156,278,17,6,23,1,2:42
5481,447407,2016-05-14,2016,NYA,CHA,2,1,2-1,NYA,9,1,30,33,63,128,114,242,7,6,13,1,2:24
5482,447411,2016-05-14,2016,SEA,ANA,7,9,9-7,ANA,9,0,39,43,82,154,159,313,12,18,30,4,3:29
5483,447413,2016-05-14,2016,CLE,MIN,3,6,6-3,MIN,9,0,35,42,77,159,156,315,10,16,26,2,3:08
5484,447415,2016-05-14,2016,TBA,OAK,6,0,6-0,TBA,9,1,38,29,67,106,154,260,15,3,18,2,2:36
5485,447406,2016-05-14,2016,KCA,ATL,0,5,5-0,ATL,9,0,33,38,71,144,118,262,8,16,24,3,2:43
5486,447408,2016-05-14,2016,PHI,CIN,4,3,4-3,PHI,9,1,34,36,70,142,107,249,13,10,23,0,2:45 (:38 delay)
5487,447409,2016-05-14,2016,BAL,DET,9,3,9-3,BAL,9,1,38,35,73,130,129,259,14,9,23,3,2:44
5488,447414,2016-05-14,2016,COL,NYN,7,4,7-4,COL,9,1,39,39,78,145,141,286,16,14,30,3,3:11
5489,447420,2016-05-14,2016,TEX,TOR,6,5,6-5,TEX,10,0,42,40,82,154,152,306,13,11,24,3,3:01
5490,447410,2016-05-14,2016,BOS,HOU,6,5,6-5,BOS,11,0,49,47,96,197,172,369,19,20,39,2,4:13
5491,447417,2016-05-14,2016,MIL,SDN,7,8,8-7,SDN,12,0,59,51,110,194,262,456,23,18,41,4,5:04
5492,447412,2016-05-14,2016,WAS,MIA,1,7,7-1,MIA,9,0,38,43,81,174,150,324,12,17,29,0,2:55
5493,447433,2016-05-15,2016,ARI,SFN,1,2,2-1,SFN,9,0,36,35,71,126,138,264,12,10,22,2,3:00
5494,447428,2016-05-15,2016,CLE,MIN,1,5,5-1,MIN,9,0,37,36,73,150,144,294,10,9,19,1,2:39
5495,447422,2016-05-15,2016,NYA,CHA,7,5,7-5,NYA,9,1,43,41,84,163,161,324,17,15,32,2,3:36
5496,447430,2016-05-15,2016,TBA,OAK,6,7,7-6,OAK,9,0,37,40,77,143,142,285,8,14,22,2,3:05
5497,447425,2016-05-15,2016,BOS,HOU,10,9,10-9,BOS,9,1,42,43,85,169,154,323,17,14,31,2,3:40
5498,447432,2016-05-15,2016,MIL,SDN,3,2,3-2,MIL,9,1,37,34,71,135,146,281,12,7,19,2,2:46
5499,447426,2016-05-15,2016,SEA,ANA,0,3,3-0,ANA,9,0,30,37,67,133,124,257,5,11,16,1,2:55
5500,447429,2016-05-15,2016,COL,NYN,4,3,4-3,COL,9,1,33,36,69,126,123,249,9,13,22,2,2:32
5501,447435,2016-05-15,2016,TEX,TOR,7,6,7-6,TEX,9,1,36,44,80,173,121,294,15,18,33,7,3:29
5502,447434,2016-05-15,2016,LAN,SLN,2,5,5-2,SLN,9,0,33,37,70,152,127,279,9,13,22,3,3:00
5503,447424,2016-05-15,2016,BAL,DET,5,6,6-5,DET,9,0,39,44,83,166,173,339,12,18,30,2,3:38
5504,447427,2016-05-15,2016,WAS,MIA,1,5,5-1,MIA,9,0,38,38,76,149,168,317,11,12,23,2,3:03
5505,447431,2016-05-15,2016,CHN,PIT,1,2,2-1,PIT,9,0,32,38,70,167,114,281,5,12,17,3,2:55
5506,447421,2016-05-15,2016,KCA,ATL,4,2,4-2,KCA,13,0,49,53,102,198,183,381,13,14,27,5,4:16
5507,447423,2016-05-15,2016,PHI,CIN,4,9,9-4,CIN,9,0,47,47,94,193,198,391,19,22,41,2,3:52
5508,447443,2016-05-16,2016,OAK,TEX,3,1,3-1,OAK,9,1,29,33,62,127,118,245,7,6,13,1,2:28
5509,447436,2016-05-16,2016,PIT,ATL,8,5,8-5,PIT,9,1,40,38,78,138,146,284,17,11,28,2,2:55
5510,447442,2016-05-16,2016,TOR,TBA,2,13,13-2,TBA,9,0,37,45,82,170,140,310,12,20,32,1,2:54
5511,447441,2016-05-16,2016,ARI,NYA,12,2,12-2,ARI,9,1,47,35,82,140,161,301,22,10,32,1,3:00
5512,447440,2016-05-16,2016,DET,MIN,10,8,10-8,DET,9,1,40,39,79,134,146,280,18,11,29,2,2:48
5513,447451,2016-05-16,2016,PHI,MIA,3,5,5-3,MIA,9,0,40,44,84,171,141,312,13,19,32,1,3:07
5514,447438,2016-05-16,2016,CLE,CIN,15,6,15-6,CLE,9,1,48,38,86,141,179,320,25,15,40,3,3:13
5515,447439,2016-05-16,2016,LAN,ANA,6,7,7-6,ANA,9,0,41,41,82,161,172,333,14,17,31,2,4:00
5516,447450,2016-05-17,2016,LAN,ANA,5,1,5-1,LAN,9,1,36,31,67,114,98,212,15,4,19,0,2:12
5517,447454,2016-05-17,2016,SDN,SFN,1,5,5-1,SFN,9,0,33,39,72,156,108,264,5,13,18,0,2:47
5518,447452,2016-05-17,2016,DET,MIN,7,2,7-2,DET,9,1,34,36,70,156,114,270,10,10,20,4,2:55
5519,447466,2016-05-17,2016,PHI,MIA,3,1,3-1,PHI,9,1,31,38,69,169,109,278,7,11,18,1,2:53
5520,447457,2016-05-17,2016,OAK,TEX,8,5,8-5,OAK,9,0,41,40,81,114,144,258,16,16,32,2,2:45
5521,447445,2016-05-17,2016,KCA,BOS,8,4,8-4,KCA,9,1,39,36,75,134,151,285,15,11,26,3,2:54
5522,447455,2016-05-17,2016,BAL,SEA,0,10,10-0,SEA,9,0,33,43,76,165,134,299,5,17,22,1,2:41
5523,447453,2016-05-17,2016,ARI,NYA,5,3,5-3,ARI,9,1,35,34,69,133,129,262,11,7,18,1,2:47
5524,447458,2016-05-17,2016,NYN,WAS,2,0,2-0,NYN,9,1,30,30,60,126,113,239,8,5,13,1,2:32
5525,447448,2016-05-17,2016,SLN,COL,1,3,3-1,COL,9,0,36,38,74,135,141,276,9,11,20,1,2:44
5526,447456,2016-05-17,2016,TOR,TBA,2,12,12-2,TBA,9,0,34,48,82,157,135,292,9,20,29,1,2:43
5527,447444,2016-05-17,2016,PIT,ATL,12,9,12-9,PIT,9,1,45,44,89,162,168,330,25,19,44,6,3:36
5528,447447,2016-05-17,2016,CLE,CIN,13,1,13-1,CLE,9,1,50,34,84,122,216,338,26,7,33,3,3:19
5529,447449,2016-05-17,2016,CHA,HOU,5,6,6-5,HOU,11,0,47,50,97,197,186,383,14,17,31,2,3:54
5530,447446,2016-05-17,2016,MIL,CHN,4,2,4-2,MIL,9,1,31,31,62,114,105,219,7,4,11,2,2:10
5531,447465,2016-05-18,2016,ANA,LAN,8,1,8-1,ANA,9,1,42,37,79,126,156,282,17,11,28,3,3:12
5532,447463,2016-05-18,2016,SLN,COL,2,0,2-0,SLN,9,1,34,34,68,140,125,265,11,8,19,2,2:54
5533,447464,2016-05-18,2016,CHA,HOU,3,5,5-3,HOU,9,0,37,41,78,133,151,284,12,18,30,3,2:57
5534,447468,2016-05-18,2016,ARI,NYA,2,4,4-2,NYA,9,0,31,41,72,160,147,307,4,16,20,2,3:12
5535,447469,2016-05-18,2016,SDN,SFN,1,2,2-1,SFN,9,0,33,34,67,144,117,261,6,6,12,0,2:33
5536,447459,2016-05-18,2016,PIT,ATL,1,3,3-1,ATL,9,0,33,38,71,122,105,227,8,13,21,1,2:38
5537,447480,2016-05-18,2016,PHI,MIA,4,2,4-2,PHI,9,1,36,31,67,118,135,253,14,7,21,0,2:29
5538,447460,2016-05-18,2016,KCA,BOS,3,2,3-2,KCA,9,1,29,36,65,150,101,251,6,10,16,1,2:23
5539,447437,2016-05-18,2016,KCA,BOS,2,5,5-2,BOS,9,0,33,42,75,145,131,276,8,18,26,3,3:06
5540,447471,2016-05-18,2016,TOR,TBA,3,6,6-3,TBA,9,0,35,38,73,147,139,286,9,11,20,1,2:48
5541,447437,2016-05-18,2016,KCA,BOS,2,5,5-2,BOS,9,0,33,42,75,145,131,276,8,18,26,3,3:06
5542,447472,2016-05-18,2016,OAK,TEX,8,1,8-1,OAK,9,1,38,33,71,133,128,261,16,6,22,2,2:31
5543,447467,2016-05-18,2016,DET,MIN,6,3,6-3,DET,9,1,37,37,74,141,151,292,15,10,25,1,2:57
5544,447470,2016-05-18,2016,BAL,SEA,5,2,5-2,BAL,9,1,36,38,74,161,141,302,12,11,23,2,2:59
5545,447461,2016-05-18,2016,MIL,CHN,1,2,2-1,CHN,13,0,50,55,105,208,249,457,14,24,38,4,5:00
5546,447473,2016-05-18,2016,NYN,WAS,1,7,7-1,WAS,9,0,34,46,80,217,131,348,7,21,28,4,3:42
5547,447462,2016-05-18,2016,CIN,CLE,7,8,8-7,CLE,12,0,49,51,100,224,205,429,14,15,29,4,4:21
5548,447481,2016-05-19,2016,OAK,NYA,1,4,4-1,NYA,9,0,31,40,71,144,104,248,6,15,21,1,2:39
5549,447485,2016-05-19,2016,NYN,WAS,1,9,9-1,WAS,9,0,36,43,79,163,155,318,9,16,25,1,3:12
5550,447482,2016-05-19,2016,SDN,SFN,1,3,3-1,SFN,9,0,31,38,69,148,125,273,4,11,15,1,2:56
5551,447478,2016-05-19,2016,CHA,HOU,2,1,2-1,CHA,9,1,30,31,61,107,123,230,6,4,10,0,2:11
5552,447483,2016-05-19,2016,BAL,SEA,2,7,7-2,SEA,9,0,34,37,71,135,166,301,8,13,21,1,3:01
5553,447474,2016-05-19,2016,PIT,ATL,8,2,8-2,PIT,9,1,40,35,75,125,166,291,15,9,24,2,2:56
5554,447475,2016-05-19,2016,MIL,CHN,5,3,5-3,MIL,9,1,36,38,74,164,141,305,13,12,25,2,2:58
5555,447479,2016-05-19,2016,ANA,LAN,7,4,7-4,ANA,9,1,37,37,74,135,147,282,15,10,25,3,3:06
5556,447476,2016-05-19,2016,CIN,CLE,2,7,7-2,CLE,9,0,33,42,75,165,109,274,6,15,21,2,2:48
5557,447484,2016-05-19,2016,MIN,TOR,2,3,3-2,TOR,11,0,37,44,81,184,138,322,5,12,17,1,3:07
5558,447477,2016-05-19,2016,SLN,COL,13,7,13-7,SLN,9,1,40,38,78,148,165,313,18,11,29,1,3:16
5559,447498,2016-05-20,2016,HOU,TEX,1,2,2-1,TEX,9,0,32,34,66,136,125,261,6,8,14,0,2:33
5560,447499,2016-05-20,2016,MIN,TOR,3,9,9-3,TOR,9,0,36,42,78,169,125,294,10,16,26,1,2:48
5561,447487,2016-05-20,2016,PHI,ATL,1,7,7-1,ATL,9,0,36,41,77,146,140,286,10,14,24,1,3:00
5562,447494,2016-05-20,2016,NYN,MIL,3,2,3-2,NYN,9,1,35,29,64,108,148,256,12,3,15,2,2:31
5563,447496,2016-05-20,2016,CIN,SEA,3,8,8-3,SEA,9,0,37,43,80,169,131,300,12,18,30,1,3:10 (:45 delay)
5564,447491,2016-05-20,2016,PIT,COL,2,1,2-1,PIT,9,1,32,37,69,137,101,238,8,14,22,0,2:33
5565,447492,2016-05-20,2016,CHA,KCA,1,4,4-1,KCA,9,0,36,38,74,135,145,280,10,12,22,2,2:59
5566,447500,2016-05-20,2016,MIA,WAS,1,4,4-1,WAS,9,0,36,38,74,134,140,274,12,13,25,3,2:53
5567,447497,2016-05-20,2016,DET,TBA,5,7,7-5,TBA,9,0,40,39,79,158,149,307,13,14,27,3,3:26
5568,447490,2016-05-20,2016,BOS,CLE,2,4,4-2,CLE,9,0,35,40,75,149,141,290,9,13,22,1,3:07
5569,447495,2016-05-20,2016,OAK,NYA,3,8,8-3,NYA,9,0,36,47,83,189,138,327,8,19,27,1,3:13
5570,447493,2016-05-20,2016,SDN,LAN,7,6,7-6,SDN,9,0,40,42,82,187,147,334,18,16,34,4,3:25
5571,447488,2016-05-20,2016,ANA,BAL,4,9,9-4,BAL,9,0,39,45,84,174,151,325,11,18,29,4,3:20
5572,447489,2016-05-20,2016,SFN,CHN,1,8,8-1,CHN,9,0,35,40,75,155,130,285,8,14,22,2,3:11
5573,447486,2016-05-20,2016,SLN,ARI,7,11,11-7,ARI,9,0,46,45,91,189,182,371,19,22,41,4,3:46
5574,447513,2016-05-21,2016,HOU,TEX,1,2,2-1,TEX,9,0,30,33,63,117,121,238,5,7,12,0,2:41
5575,447510,2016-05-21,2016,OAK,NYA,1,5,5-1,NYA,9,0,35,38,73,140,116,256,8,11,19,2,2:46
5576,447514,2016-05-21,2016,MIN,TOR,5,3,5-3,MIN,9,1,31,35,66,133,109,242,8,10,18,2,2:19
5577,447503,2016-05-21,2016,ANA,BAL,1,3,3-1,BAL,9,0,39,34,73,124,154,278,13,6,19,3,3:08
5578,447505,2016-05-21,2016,BOS,CLE,9,1,9-1,BOS,9,1,44,34,78,141,174,315,22,6,28,4,3:17
5579,447512,2016-05-21,2016,DET,TBA,5,4,5-4,DET,9,1,34,36,70,147,150,297,11,9,20,1,2:58
5580,447502,2016-05-21,2016,PHI,ATL,0,2,2-0,ATL,9,0,30,38,68,154,123,277,3,12,15,3,2:56
5581,447501,2016-05-21,2016,SLN,ARI,6,2,6-2,SLN,9,1,41,37,78,138,181,319,17,10,27,0,2:53
5582,447515,2016-05-21,2016,MIA,WAS,3,2,3-2,MIA,9,1,38,35,73,162,146,308,15,11,26,2,3:13
5583,447511,2016-05-21,2016,CIN,SEA,0,4,4-0,SEA,9,0,33,40,73,167,134,301,7,12,19,0,2:52
5584,447506,2016-05-21,2016,PIT,COL,1,5,5-1,COL,9,0,38,37,75,143,151,294,13,9,22,2,3:02 (:56 delay)
5585,447504,2016-05-21,2016,SFN,CHN,5,3,5-3,SFN,9,1,37,40,77,171,149,320,14,14,28,4,3:17
5586,447507,2016-05-21,2016,CHA,KCA,1,2,2-1,KCA,9,0,37,36,73,152,144,296,11,11,22,4,3:05
5587,447508,2016-05-21,2016,SDN,LAN,3,2,3-2,SDN,11,0,43,39,82,150,179,329,10,7,17,2,3:39
5588,447509,2016-05-21,2016,NYN,MIL,5,4,5-4,NYN,9,0,38,39,77,181,152,333,16,12,28,1,3:09
5589,447524,2016-05-22,2016,NYN,MIL,3,1,3-1,NYN,9,1,33,34,67,136,150,286,9,8,17,0,2:59
5590,447518,2016-05-22,2016,ANA,BAL,10,2,10-2,ANA,9,1,40,32,72,129,133,262,16,6,22,1,2:33
5591,447520,2016-05-22,2016,BOS,CLE,5,2,5-2,BOS,9,1,41,37,78,162,175,337,18,10,28,3,3:23
5592,447516,2016-05-22,2016,SLN,ARI,2,7,7-2,ARI,9,0,35,41,76,136,127,263,8,16,24,1,2:44
5593,447529,2016-05-22,2016,MIN,TOR,1,3,3-1,TOR,9,0,32,37,69,146,109,255,6,10,16,2,2:29
5594,447527,2016-05-22,2016,DET,TBA,9,4,9-4,DET,9,1,41,37,78,140,147,287,18,11,29,2,3:03
5595,447519,2016-05-22,2016,SFN,CHN,1,0,1-0,SFN,9,1,32,33,65,129,118,247,8,6,14,2,2:33
5596,447517,2016-05-22,2016,PHI,ATL,5,0,5-0,PHI,9,1,38,33,71,114,126,240,16,7,23,1,2:35
5597,447528,2016-05-22,2016,HOU,TEX,2,9,9-2,TEX,9,0,36,39,75,132,129,261,8,15,23,0,2:36
5598,447525,2016-05-22,2016,OAK,NYA,4,5,5-4,NYA,9,0,36,37,73,138,141,279,7,11,18,1,2:55
5599,447522,2016-05-22,2016,CHA,KCA,3,2,3-2,CHA,9,1,34,36,70,127,135,262,11,10,21,2,2:46
5600,447526,2016-05-22,2016,CIN,SEA,4,5,5-4,SEA,9,0,36,41,77,161,126,287,10,18,28,0,2:59
5601,447530,2016-05-22,2016,MIA,WAS,2,8,8-2,WAS,9,0,32,43,75,155,112,267,6,22,28,2,2:56
5602,447523,2016-05-22,2016,SDN,LAN,5,9,9-5,LAN,17,0,65,74,139,269,256,525,16,28,44,2,5:47
5603,446944,2016-05-23,2016,CHA,CLE,1,5,5-1,CLE,9,0,34,36,70,134,142,276,7,10,17,1,2:40
5604,447531,2016-05-23,2016,SLN,CHN,4,3,4-3,SLN,9,0,34,40,74,153,116,269,8,14,22,0,2:48
5605,447547,2016-05-23,2016,TEX,ANA,0,2,2-0,ANA,9,0,36,34,70,131,148,279,10,10,20,3,2:56
5606,447532,2016-05-23,2016,LAN,CIN,1,0,1-0,LAN,9,1,30,29,59,102,107,209,9,3,12,0,2:11
5607,447536,2016-05-23,2016,SEA,OAK,0,5,5-0,OAK,9,0,33,40,73,146,118,264,9,12,21,2,2:40
5608,447537,2016-05-23,2016,DET,PHI,5,4,5-4,DET,9,1,36,38,74,138,146,284,14,14,28,1,3:10
5609,447521,2016-05-23,2016,PIT,COL,6,3,6-3,PIT,9,1,34,35,69,141,108,249,11,8,19,2,3:10
5610,447538,2016-05-23,2016,SFN,SDN,1,0,1-0,SFN,9,0,36,30,66,114,141,255,12,3,15,0,2:37
5611,447521,2016-05-23,2016,PIT,COL,6,3,6-3,PIT,9,1,34,35,69,141,108,249,11,8,19,2,3:10
5612,447535,2016-05-23,2016,WAS,NYN,1,7,7-1,NYN,9,0,34,38,72,137,120,257,8,12,20,0,2:33 (1:07 delay)
5613,447539,2016-05-23,2016,MIA,TBA,7,6,7-6,MIA,9,1,39,42,81,149,147,296,17,17,34,3,3:11
5614,447533,2016-05-23,2016,CHA,CLE,7,6,7-6,CHA,9,1,43,37,80,151,160,311,19,11,30,3,3:10
5615,446944,2016-05-23,2016,CHA,CLE,1,5,5-1,CLE,9,0,34,36,70,134,142,276,7,10,17,1,2:40
5616,447534,2016-05-23,2016,MIN,KCA,4,10,10-4,KCA,9,0,40,45,85,187,154,341,16,19,35,4,3:29 (:41 delay)
5617,447551,2016-05-24,2016,DET,PHI,3,1,3-1,DET,9,1,30,33,63,126,112,238,8,7,15,0,2:38
5618,447544,2016-05-24,2016,CHA,CLE,2,6,6-2,CLE,9,0,33,41,74,167,118,285,7,15,22,1,2:51
5619,447543,2016-05-24,2016,LAN,CIN,8,2,8-2,LAN,9,1,42,31,73,129,178,307,18,4,22,3,3:08
5620,447553,2016-05-24,2016,MIA,TBA,3,4,4-3,TBA,9,0,39,39,78,152,155,307,11,16,27,2,3:21
5621,447562,2016-05-24,2016,TEX,ANA,4,1,4-1,TEX,9,1,32,35,67,137,129,266,10,10,20,0,2:47
5622,447545,2016-05-24,2016,BOS,COL,8,3,8-3,BOS,9,1,42,33,75,133,144,277,19,7,26,1,2:55
5623,447540,2016-05-24,2016,PIT,ARI,12,1,12-1,PIT,9,1,45,39,84,157,182,339,24,14,38,3,3:23
5624,447548,2016-05-24,2016,ATL,MIL,1,2,2-1,MIL,9,0,35,33,68,145,146,291,10,6,16,0,3:08
5625,447550,2016-05-24,2016,SEA,OAK,6,5,6-5,SEA,9,0,37,39,76,151,139,290,14,13,27,5,3:12
5626,447546,2016-05-24,2016,MIN,KCA,4,7,7-4,KCA,9,0,39,41,80,157,151,308,13,15,28,3,3:07
5627,447542,2016-05-24,2016,SLN,CHN,3,12,12-3,CHN,9,0,37,48,85,203,133,336,11,22,33,3,3:10
5628,447552,2016-05-24,2016,SFN,SDN,8,2,8-2,SFN,9,1,38,37,75,145,133,278,16,12,28,1,2:51
5629,447541,2016-05-24,2016,HOU,BAL,3,2,3-2,HOU,13,0,48,52,100,232,190,422,15,14,29,2,4:14
5630,447554,2016-05-24,2016,NYA,TOR,6,0,6-0,NYA,9,1,36,34,70,140,131,271,12,7,19,3,2:40
5631,447549,2016-05-24,2016,WAS,NYN,7,4,7-4,WAS,9,1,36,35,71,146,122,268,13,8,21,1,2:48
5632,447559,2016-05-25,2016,CHA,CLE,3,4,4-3,CLE,9,0,37,38,75,163,135,298,10,11,21,2,3:02
5633,447569,2016-05-25,2016,NYA,TOR,4,8,8-4,TOR,9,0,37,43,80,169,131,300,10,16,26,3,2:59
5634,447555,2016-05-25,2016,PIT,ARI,5,4,5-4,PIT,9,1,37,35,72,118,145,263,12,10,22,2,3:05
5635,447565,2016-05-25,2016,WAS,NYN,0,2,2-0,NYN,9,0,33,33,66,141,120,261,7,7,14,0,2:38
5636,447567,2016-05-25,2016,DET,PHI,5,8,8-5,PHI,9,0,39,41,80,141,140,281,11,15,26,3,3:11
5637,447556,2016-05-25,2016,HOU,BAL,4,3,4-3,HOU,9,1,33,42,75,168,117,285,8,17,25,1,2:58
5638,447561,2016-05-25,2016,MIN,KCA,7,5,7-5,MIN,9,1,37,38,75,136,146,282,15,13,28,2,2:48
5639,447558,2016-05-25,2016,LAN,CIN,3,1,3-1,LAN,9,1,29,32,61,127,116,243,5,6,11,0,2:21
5640,447560,2016-05-25,2016,BOS,COL,10,3,10-3,BOS,9,1,41,38,79,143,156,299,18,12,30,2,3:09
5641,447574,2016-05-25,2016,TEX,ANA,15,9,15-9,TEX,9,1,48,42,90,153,174,327,26,15,41,6,3:34
5642,447566,2016-05-25,2016,SEA,OAK,13,3,13-3,SEA,9,1,41,34,75,117,152,269,18,10,28,1,2:47
5643,447568,2016-05-25,2016,SFN,SDN,4,3,4-3,SFN,10,0,41,39,80,135,162,297,12,12,24,4,3:22
5644,447563,2016-05-25,2016,TBA,MIA,3,4,4-3,MIA,9,0,37,44,81,162,157,319,14,16,30,4,3:22
5645,447557,2016-05-25,2016,SLN,CHN,8,9,9-8,CHN,9,0,44,43,87,184,155,339,16,17,33,1,3:38
5646,447564,2016-05-25,2016,ATL,MIL,2,3,3-2,MIL,13,0,51,56,107,248,200,448,14,22,36,4,4:51
5647,447573,2016-05-26,2016,BOS,COL,2,8,8-2,COL,9,0,36,39,75,136,126,262,10,12,22,3,2:51
5648,447570,2016-05-26,2016,PIT,ARI,8,3,8-3,PIT,9,1,42,43,85,176,167,343,18,18,36,4,3:40
5649,447571,2016-05-26,2016,HOU,BAL,4,2,4-2,HOU,9,1,33,39,72,167,160,327,8,11,19,1,3:03
5650,447577,2016-05-26,2016,WAS,SLN,2,1,2-1,WAS,9,1,31,32,63,135,112,247,8,7,15,0,2:27
5651,447576,2016-05-26,2016,ATL,MIL,2,6,6-2,MIL,9,0,39,40,79,144,159,303,13,16,29,3,3:05 (1:17 delay)
5652,447578,2016-05-26,2016,NYA,TOR,1,3,3-1,TOR,9,0,33,36,69,124,123,247,7,8,15,0,2:34
5653,447575,2016-05-26,2016,TBA,MIA,1,9,9-1,MIA,9,0,36,42,78,177,140,317,9,16,25,1,2:51
5654,447588,2016-05-27,2016,TBA,NYA,1,4,4-1,NYA,9,0,33,34,67,120,125,245,5,7,12,1,2:36
5655,447580,2016-05-27,2016,TOR,BOS,7,5,7-5,TOR,9,1,41,35,76,136,145,281,17,9,26,2,2:53
5656,447593,2016-05-27,2016,WAS,SLN,2,6,6-2,SLN,9,0,36,34,70,119,124,243,10,8,18,0,2:32
5657,447587,2016-05-27,2016,SEA,MIN,2,7,7-2,MIN,9,0,32,40,72,151,126,277,5,14,19,0,2:36
5658,447584,2016-05-27,2016,ANA,HOU,7,2,7-2,ANA,9,1,37,35,72,129,122,251,13,9,22,2,2:38
5659,447590,2016-05-27,2016,TEX,PIT,1,9,9-1,PIT,9,0,38,45,83,172,145,317,11,18,29,1,3:04
5660,447589,2016-05-27,2016,CHN,PHI,6,2,6-2,CHN,9,1,35,38,73,146,149,295,12,12,24,2,3:04 (1:33 delay)
5661,447582,2016-05-27,2016,MIL,CIN,9,5,9-5,MIL,9,1,43,33,76,123,154,277,20,6,26,2,2:53
5662,447579,2016-05-27,2016,CLE,BAL,4,6,6-4,BAL,9,0,38,41,79,147,170,317,15,16,31,1,3:09
5663,447592,2016-05-27,2016,COL,SFN,5,2,5-2,COL,9,1,37,34,71,118,117,235,14,7,21,4,2:42 (:42 delay)
5664,447586,2016-05-27,2016,ATL,MIA,4,2,4-2,ATL,9,1,43,35,78,130,169,299,21,10,31,2,3:13
5665,447585,2016-05-27,2016,NYN,LAN,6,5,6-5,NYN,9,0,37,38,75,144,158,302,13,13,26,2,3:03
5666,447591,2016-05-27,2016,ARI,SDN,3,10,10-3,SDN,9,0,36,48,84,185,139,324,8,23,31,2,3:19
5667,447583,2016-05-27,2016,OAK,DET,1,4,4-1,DET,9,0,34,39,73,134,125,259,7,15,22,2,2:40
5668,447581,2016-05-27,2016,KCA,CHA,7,5,7-5,KCA,9,1,37,36,73,140,122,262,14,9,23,5,2:58
5669,447599,2016-05-28,2016,ANA,HOU,2,4,4-2,HOU,9,0,30,37,67,139,134,273,3,13,16,3,2:46
5670,447602,2016-05-28,2016,SEA,MIN,5,6,6-5,MIN,9,0,42,41,83,181,156,337,19,17,36,5,3:30
5671,447604,2016-05-28,2016,CHN,PHI,4,1,4-1,CHN,9,1,32,32,64,104,131,235,10,6,16,0,2:18
5672,447606,2016-05-28,2016,ARI,SDN,8,7,8-7,ARI,9,1,41,36,77,137,172,309,18,11,29,2,3:21
5673,447600,2016-05-28,2016,NYN,LAN,1,9,9-1,LAN,9,0,33,42,75,140,136,276,7,17,24,3,3:12
5674,447598,2016-05-28,2016,OAK,DET,12,3,12-3,OAK,9,1,41,35,76,129,147,276,18,10,28,2,2:57
5675,447605,2016-05-28,2016,TEX,PIT,5,2,5-2,TEX,9,1,34,36,70,144,150,294,10,8,18,1,3:08
5676,447603,2016-05-28,2016,TBA,NYA,9,5,9-5,TBA,9,1,40,41,81,160,139,299,16,16,32,4,3:15
5677,447601,2016-05-28,2016,ATL,MIA,7,2,7-2,ATL,9,1,35,40,75,155,168,323,10,12,22,3,3:15
5678,447607,2016-05-28,2016,COL,SFN,5,10,10-5,SFN,9,0,41,43,84,132,176,308,14,18,32,6,3:27
5679,447608,2016-05-28,2016,WAS,SLN,4,9,9-4,SLN,9,0,33,43,76,161,125,286,7,18,25,2,3:00
5680,447595,2016-05-28,2016,TOR,BOS,10,9,10-9,TOR,9,0,43,42,85,143,175,318,17,16,33,5,3:37
5681,447596,2016-05-28,2016,KCA,CHA,8,7,8-7,KCA,9,0,44,39,83,137,195,332,20,11,31,2,3:22
5682,447594,2016-05-28,2016,CLE,BAL,11,4,11-4,CLE,9,1,44,39,83,163,154,317,18,13,31,2,3:02 (:22 delay)
5683,447597,2016-05-28,2016,MIL,CIN,6,7,7-6,CIN,9,0,41,42,83,170,164,334,15,16,31,4,3:46
5684,447618,2016-05-29,2016,TBA,NYA,1,2,2-1,NYA,9,0,36,29,65,125,144,269,8,2,10,0,2:45
5685,447615,2016-05-29,2016,NYN,LAN,2,4,4-2,LAN,9,0,32,41,73,146,133,279,5,13,18,1,3:05
5686,447613,2016-05-29,2016,OAK,DET,4,2,4-2,OAK,9,1,36,34,70,128,141,269,13,8,21,2,2:48
5687,447619,2016-05-29,2016,CHN,PHI,7,2,7-2,CHN,9,1,38,35,73,123,151,274,16,10,26,3,2:50
5688,447617,2016-05-29,2016,SEA,MIN,4,5,5-4,MIN,9,0,35,36,71,155,142,297,10,10,20,1,2:51
5689,447612,2016-05-29,2016,MIL,CIN,5,4,5-4,MIL,9,1,35,36,71,132,139,271,13,13,26,2,3:10
5690,447609,2016-05-29,2016,CLE,BAL,4,6,6-4,BAL,9,0,39,39,78,162,157,319,14,12,26,1,3:14
5691,447623,2016-05-29,2016,WAS,SLN,10,2,10-2,WAS,9,1,38,39,77,159,142,301,15,12,27,3,3:12
5692,447621,2016-05-29,2016,ARI,SDN,6,3,6-3,ARI,9,1,38,34,72,124,142,266,14,7,21,1,2:39
5693,447610,2016-05-29,2016,TOR,BOS,3,5,5-3,BOS,11,0,47,49,96,210,183,393,14,18,32,5,4:07
5694,447611,2016-05-29,2016,KCA,CHA,5,4,5-4,KCA,9,1,37,36,73,154,158,312,16,11,27,1,3:04
5695,447620,2016-05-29,2016,TEX,PIT,6,2,6-2,TEX,9,1,35,37,72,141,128,269,11,9,20,0,2:47
5696,447616,2016-05-29,2016,ATL,MIA,3,7,7-3,MIA,9,0,35,41,76,181,131,312,8,15,23,3,3:18
5697,447622,2016-05-29,2016,COL,SFN,3,8,8-3,SFN,9,0,37,45,82,158,150,308,11,22,33,1,3:25
5698,447614,2016-05-29,2016,ANA,HOU,6,8,8-6,HOU,13,0,59,55,114,220,239,459,23,22,45,3,4:57
5699,447634,2016-05-30,2016,ATL,SFN,5,3,5-3,ATL,9,1,33,36,69,138,123,261,9,9,18,1,2:37
5700,447625,2016-05-30,2016,NYN,CHA,1,0,1-0,NYN,9,1,31,29,60,109,123,232,9,3,12,1,2:34
5701,447638,2016-05-30,2016,PHI,WAS,3,4,4-3,WAS,9,0,34,35,69,117,128,245,8,9,17,1,2:53
5702,447633,2016-05-30,2016,SEA,SDN,9,3,9-3,SEA,9,1,37,37,74,131,143,274,14,11,25,3,2:56
5703,447630,2016-05-30,2016,OAK,MIN,3,2,3-2,OAK,9,1,30,36,66,125,112,237,11,11,22,1,2:32
5704,447635,2016-05-30,2016,MIL,SLN,0,6,6-0,SLN,9,0,33,39,72,150,123,273,7,12,19,1,2:49
5705,447631,2016-05-30,2016,TOR,NYA,4,2,4-2,TOR,9,1,32,34,66,132,120,252,9,9,18,3,2:26
5706,447627,2016-05-30,2016,ANA,DET,5,1,5-1,ANA,9,1,32,32,64,114,139,253,8,6,14,1,2:46
5707,447629,2016-05-30,2016,CHN,LAN,2,0,2-0,CHN,9,1,34,29,63,118,128,246,12,2,14,1,2:40
5708,447632,2016-05-30,2016,MIA,PIT,0,10,10-0,PIT,9,0,28,40,68,161,105,266,3,16,19,1,2:37
5709,447637,2016-05-30,2016,CLE,TEX,2,9,9-2,TEX,9,0,37,40,77,132,129,261,14,12,26,2,2:36
5710,447624,2016-05-30,2016,BAL,BOS,2,7,7-2,BOS,9,0,35,42,77,155,122,277,9,16,25,2,2:54
5711,447628,2016-05-30,2016,ARI,HOU,3,8,8-3,HOU,9,0,33,44,77,179,107,286,6,19,25,1,2:54
5712,447626,2016-05-30,2016,COL,CIN,8,11,11-8,CIN,9,0,44,46,90,178,171,349,18,21,39,2,3:25
5713,447636,2016-05-30,2016,KCA,TBA,6,2,6-2,KCA,9,1,34,37,71,154,129,283,12,10,22,1,3:03
5714,447649,2016-05-31,2016,ATL,SFN,0,4,4-0,SFN,9,0,28,33,61,110,100,210,2,9,11,6,2:29
5715,447647,2016-05-31,2016,MIA,PIT,3,1,3-1,MIA,9,1,36,32,68,134,121,255,12,7,19,1,2:36
5716,447640,2016-05-31,2016,NYN,CHA,4,6,6-4,CHA,9,0,40,42,82,158,131,289,11,13,24,3,3:02
5717,447653,2016-05-31,2016,PHI,WAS,1,5,5-1,WAS,9,0,31,37,68,144,124,268,6,10,16,0,2:54
5718,447650,2016-05-31,2016,MIL,SLN,3,10,10-3,SLN,9,0,35,43,78,202,133,335,9,20,29,1,3:14
5719,447646,2016-05-31,2016,TOR,NYA,4,1,4-1,TOR,9,1,29,35,64,148,118,266,9,8,17,1,2:37
5720,447639,2016-05-31,2016,BAL,BOS,2,6,6-2,BOS,9,0,34,39,73,164,128,292,7,12,19,0,2:48
5721,447652,2016-05-31,2016,CLE,TEX,3,7,7-3,TEX,9,0,36,37,73,141,147,288,11,11,22,2,2:51
5722,447642,2016-05-31,2016,ANA,DET,11,9,11-9,ANA,9,0,40,37,77,165,142,307,22,11,33,3,3:19
5723,447645,2016-05-31,2016,OAK,MIN,7,4,7-4,OAK,9,1,40,41,81,142,173,315,16,15,31,5,3:14
5724,447644,2016-05-31,2016,CHN,LAN,0,5,5-0,LAN,9,0,29,40,69,168,124,292,3,13,16,2,2:57 (:27 delay)
5725,447641,2016-05-31,2016,COL,CIN,17,4,17-4,COL,9,1,46,36,82,131,173,304,24,12,36,2,3:07
5726,447648,2016-05-31,2016,SEA,SDN,16,4,16-4,SEA,9,1,48,33,81,120,202,322,25,7,32,3,3:09
5727,447643,2016-05-31,2016,ARI,HOU,5,8,8-5,HOU,9,0,40,42,82,154,163,317,14,19,33,2,3:11
5728,447651,2016-05-31,2016,KCA,TBA,10,5,10-5,KCA,9,1,44,45,89,188,147,335,23,18,41,2,3:27
5729,447665,2016-06-01,2016,MIL,SLN,3,1,3-1,MIL,9,1,33,30,63,120,109,229,9,4,13,0,2:20
5730,447666,2016-06-01,2016,KCA,TBA,6,3,6-3,KCA,9,1,38,38,76,127,142,269,13,12,25,0,2:45
5731,447659,2016-06-01,2016,CHN,LAN,2,1,2-1,CHN,9,1,30,31,61,113,132,245,7,4,11,0,2:29
5732,447658,2016-06-01,2016,ANA,DET,0,3,3-0,DET,9,0,32,40,72,148,135,283,5,14,19,2,2:55
5733,447661,2016-06-01,2016,TOR,NYA,7,0,7-0,TOR,9,1,37,36,73,131,157,288,15,9,24,2,2:57
5734,447660,2016-06-01,2016,OAK,MIN,5,1,5-1,OAK,9,1,35,37,72,128,138,266,14,11,25,0,2:33
5735,447668,2016-06-01,2016,PHI,WAS,2,7,7-2,WAS,9,0,36,40,76,130,131,261,9,14,23,1,2:45
5736,447662,2016-06-01,2016,MIA,PIT,3,2,3-2,MIA,9,1,36,35,71,156,153,309,12,10,22,2,2:52
5737,447657,2016-06-01,2016,COL,CIN,2,7,7-2,CIN,9,0,36,40,76,161,124,285,10,15,25,1,2:50
5738,447667,2016-06-01,2016,CLE,TEX,5,4,5-4,CLE,11,0,45,44,89,168,166,334,15,12,27,2,3:30
5739,447655,2016-06-01,2016,BAL,BOS,13,9,13-9,BAL,9,1,48,45,93,191,181,372,23,20,43,5,3:58
5740,447654,2016-06-01,2016,HOU,ARI,5,4,5-4,HOU,11,0,46,40,86,180,174,354,13,11,24,2,3:43
5741,447663,2016-06-01,2016,ATL,SFN,5,4,5-4,ATL,11,0,39,46,85,198,142,340,12,14,26,6,3:38
5742,447656,2016-06-01,2016,NYN,CHA,1,2,2-1,CHA,13,0,54,49,103,206,230,436,20,13,33,3,4:41
5743,447664,2016-06-01,2016,SDN,SEA,14,6,14-6,SDN,9,1,46,44,90,171,181,352,20,18,38,1,3:20
5744,446949,2016-06-02,2016,DET,NYA,4,5,5-4,NYA,9,0,39,36,75,106,161,267,15,9,24,3,2:56
5745,447673,2016-06-02,2016,CHN,LAN,7,2,7-2,CHN,9,1,36,30,66,120,136,256,13,6,19,1,2:25
5746,447669,2016-06-02,2016,HOU,ARI,0,3,3-0,ARI,9,0,32,35,67,130,134,264,5,10,15,1,2:36
5747,447672,2016-06-02,2016,CLE,KCA,5,4,5-4,CLE,9,0,40,38,78,132,142,274,14,14,28,2,2:54
5748,447670,2016-06-02,2016,BAL,BOS,12,7,12-7,BAL,9,1,38,40,78,148,132,280,14,14,28,3,2:57
5749,447676,2016-06-02,2016,ATL,SFN,0,6,6-0,SFN,9,0,35,40,75,146,134,280,7,14,21,2,2:49
5750,446949,2016-06-02,2016,DET,NYA,4,5,5-4,NYA,9,0,39,36,75,106,161,267,15,9,24,3,2:56
5751,447671,2016-06-02,2016,COL,CIN,4,11,11-4,CIN,9,0,35,44,79,142,132,274,9,18,27,1,2:44
5752,447674,2016-06-02,2016,PHI,MIL,1,4,4-1,MIL,9,0,33,40,73,159,138,297,6,16,22,3,3:14
5753,447675,2016-06-02,2016,MIA,PIT,4,3,4-3,MIA,12,0,48,47,95,193,182,375,13,13,26,1,3:54
5754,447677,2016-06-02,2016,SDN,SEA,13,16,16-13,SEA,9,0,51,46,97,194,172,366,24,19,43,4,3:50
5755,447678,2016-06-02,2016,MIN,TBA,6,4,6-4,MIN,9,1,41,37,78,109,144,253,20,11,31,1,2:44
5756,447682,2016-06-03,2016,SDN,COL,4,0,4-0,SDN,9,1,32,32,64,135,105,240,7,5,12,0,2:26
5757,447680,2016-06-03,2016,LAN,ATL,4,2,4-2,LAN,9,1,32,35,67,130,126,256,8,10,18,2,2:42
5758,447683,2016-06-03,2016,CLE,KCA,6,1,6-1,CLE,9,1,34,33,67,126,126,252,12,9,21,1,2:25
5759,447679,2016-06-03,2016,CHN,ARI,6,0,6-0,CHN,9,1,38,33,71,137,166,303,18,8,26,2,3:00
5760,447687,2016-06-03,2016,BAL,NYA,6,5,6-5,BAL,9,1,35,36,71,146,136,282,12,12,24,3,3:00
5761,447691,2016-06-03,2016,MIN,TBA,2,4,4-2,TBA,9,0,39,34,73,132,174,306,14,7,21,2,3:03
5762,447686,2016-06-03,2016,MIA,NYN,2,6,6-2,NYN,9,0,35,37,72,154,133,287,8,12,20,1,2:55
5763,447685,2016-06-03,2016,PHI,MIL,6,3,6-3,PHI,9,1,33,36,69,163,108,271,11,10,21,1,3:03
5764,447693,2016-06-03,2016,CIN,WAS,7,2,7-2,CIN,9,1,35,34,69,153,135,288,12,10,22,1,2:55
5765,447681,2016-06-03,2016,DET,CHA,10,3,10-3,DET,9,1,42,37,79,148,167,315,21,11,32,1,3:22
5766,447690,2016-06-03,2016,TEX,SEA,7,3,7-3,TEX,9,1,39,35,74,121,153,274,19,10,29,1,2:52
5767,447689,2016-06-03,2016,SLN,SFN,1,5,5-1,SFN,9,0,36,40,76,149,145,294,10,13,23,5,3:11
5768,447684,2016-06-03,2016,PIT,ANA,2,9,9-2,ANA,9,0,35,49,84,184,145,329,9,26,35,2,3:17
5769,447688,2016-06-03,2016,HOU,OAK,12,2,12-2,HOU,9,1,45,38,83,156,161,317,21,12,33,2,2:59
5770,447692,2016-06-03,2016,BOS,TOR,2,5,5-2,TOR,9,0,39,38,77,159,152,311,12,13,25,3,3:10
5771,447696,2016-06-04,2016,DET,CHA,7,4,7-4,DET,9,1,39,38,77,139,147,286,14,13,27,3,3:09
5772,447694,2016-06-04,2016,CHN,ARI,5,3,5-3,CHN,9,1,35,34,69,130,144,274,11,7,18,3,2:46
5773,447704,2016-06-04,2016,SLN,SFN,7,4,7-4,SLN,9,1,35,35,70,134,124,258,12,9,21,1,2:39
5774,447698,2016-06-04,2016,CLE,KCA,7,1,7-1,CLE,9,1,37,35,72,125,140,265,14,8,22,1,2:48 (:32 delay)
5775,447708,2016-06-04,2016,CIN,WAS,6,3,6-3,CIN,9,1,33,31,64,126,150,276,10,6,16,2,2:38 (1:25 delay)
5776,447706,2016-06-04,2016,MIN,TBA,4,7,7-4,TBA,9,0,39,39,78,146,165,311,13,16,29,1,3:10 (1:10 delay)
5777,447695,2016-06-04,2016,LAN,ATL,4,0,4-0,LAN,9,1,37,33,70,145,152,297,14,8,22,3,3:27
5778,447697,2016-06-04,2016,SDN,COL,4,3,4-3,SDN,9,1,35,41,76,162,132,294,13,15,28,2,3:00
5779,447702,2016-06-04,2016,BAL,NYA,6,8,8-6,NYA,9,0,38,42,80,154,152,306,11,16,27,4,3:25
5780,447699,2016-06-04,2016,PIT,ANA,8,7,8-7,PIT,9,1,42,37,79,117,160,277,19,12,31,2,3:00
5781,447705,2016-06-04,2016,TEX,SEA,10,4,10-4,TEX,9,1,44,40,84,148,166,314,21,13,34,1,3:09
5782,447701,2016-06-04,2016,MIA,NYN,4,6,6-4,NYN,9,0,40,47,87,183,149,332,13,24,37,3,3:39
5783,447703,2016-06-04,2016,HOU,OAK,6,5,6-5,HOU,12,0,48,52,100,193,180,373,17,17,34,3,4:07
5784,447700,2016-06-04,2016,PHI,MIL,3,6,6-3,MIL,9,0,36,43,79,182,131,313,9,16,25,0,3:25
5785,447707,2016-06-04,2016,BOS,TOR,6,4,6-4,BOS,9,1,37,35,72,176,144,320,16,10,26,1,3:08
5786,447722,2016-06-05,2016,BOS,TOR,4,5,5-4,TOR,9,0,36,34,70,144,139,283,9,8,17,2,2:44
5787,447713,2016-06-05,2016,CLE,KCA,7,0,7-0,CLE,9,1,34,31,65,121,128,249,11,5,16,2,2:21 (3:10 delay)
5788,447720,2016-06-05,2016,TEX,SEA,3,2,3-2,TEX,9,1,31,32,63,118,109,227,6,5,11,2,2:30
5789,447716,2016-06-05,2016,MIA,NYN,1,0,1-0,MIA,9,1,28,31,59,125,113,238,5,4,9,0,2:17
5790,447711,2016-06-05,2016,DET,CHA,5,2,5-2,DET,9,1,39,33,72,128,156,284,17,6,23,1,3:09 (:07 delay)
5791,447719,2016-06-05,2016,SLN,SFN,6,3,6-3,SLN,9,1,36,37,73,140,122,262,13,10,23,5,3:05
5792,447709,2016-06-05,2016,CHN,ARI,2,3,3-2,ARI,9,0,35,40,75,178,121,299,8,16,24,2,3:00
5793,447715,2016-06-05,2016,PHI,MIL,8,1,8-1,PHI,9,1,38,40,78,153,141,294,16,14,30,1,3:05
5794,447723,2016-06-05,2016,CIN,WAS,9,10,10-9,WAS,9,0,43,43,86,166,166,332,18,16,34,3,3:27
5795,447721,2016-06-05,2016,MIN,TBA,5,7,7-5,TBA,9,0,43,40,83,172,164,336,17,15,32,2,3:19
5796,447710,2016-06-05,2016,LAN,ATL,12,6,12-6,LAN,9,1,44,39,83,149,188,337,20,14,34,2,3:17
5797,447718,2016-06-05,2016,HOU,OAK,5,2,5-2,HOU,9,1,41,39,80,135,150,285,16,12,28,3,3:05
5798,447714,2016-06-05,2016,PIT,ANA,4,5,5-4,ANA,9,0,42,37,79,134,168,302,19,10,29,2,3:08
5799,447712,2016-06-05,2016,SDN,COL,3,10,10-3,COL,9,0,33,41,74,162,118,280,7,14,21,2,2:56
5800,447717,2016-06-05,2016,BAL,NYA,3,1,3-1,BAL,9,1,37,38,75,143,169,312,14,12,26,2,3:26 (1:37 delay)
5801,447729,2016-06-06,2016,BAL,KCA,4,1,4-1,BAL,9,1,33,33,66,125,111,236,10,7,17,1,2:37
5802,447726,2016-06-06,2016,SEA,CLE,1,3,3-1,CLE,9,0,33,34,67,140,125,265,6,6,12,1,2:30
5803,447727,2016-06-06,2016,LAN,COL,1,6,6-1,COL,9,0,31,37,68,141,113,254,7,14,21,1,2:26
5804,447724,2016-06-06,2016,SDN,ATL,7,2,7-2,SDN,9,1,37,38,75,141,140,281,12,11,23,2,2:57
5805,447730,2016-06-06,2016,NYA,ANA,5,2,5-2,NYA,9,1,31,34,65,113,98,211,9,8,17,1,2:35
5806,447725,2016-06-06,2016,PHI,CHN,4,6,6-4,CHN,9,0,34,43,77,164,118,282,9,15,24,1,3:05
5807,447733,2016-06-06,2016,DET,TOR,11,0,11-0,DET,9,1,43,33,76,134,166,300,19,7,26,1,2:57
5808,447728,2016-06-06,2016,TEX,HOU,6,5,6-5,TEX,9,0,41,40,81,149,132,281,14,12,26,1,3:08
5809,447732,2016-06-06,2016,ARI,TBA,4,6,6-4,TBA,9,0,40,43,83,185,174,359,13,18,31,3,3:30
5810,447741,2016-06-07,2016,NYA,ANA,6,3,6-3,NYA,9,1,35,34,69,118,124,242,12,7,19,3,2:35
5811,447743,2016-06-07,2016,PIT,NYN,3,1,3-1,PIT,9,1,37,35,72,126,155,281,15,8,23,0,2:40
5812,447737,2016-06-07,2016,SEA,CLE,7,1,7-1,SEA,9,1,37,33,70,124,154,278,16,8,24,2,2:38
5813,447739,2016-06-07,2016,TEX,HOU,4,3,4-3,TEX,9,1,34,37,71,161,133,294,11,13,24,1,2:48
5814,447745,2016-06-07,2016,CIN,SLN,7,6,7-6,CIN,9,0,38,38,76,141,146,287,15,12,27,3,2:55
5815,447731,2016-06-07,2016,PIT,NYN,3,1,3-1,PIT,9,1,35,31,66,138,145,283,11,6,17,2,2:48
5816,447734,2016-06-07,2016,SDN,ATL,4,3,4-3,SDN,9,0,38,34,72,121,143,264,14,9,23,1,2:48
5817,447731,2016-06-07,2016,PIT,NYN,3,1,3-1,PIT,9,1,35,31,66,138,145,283,11,6,17,2,2:48
5818,447735,2016-06-07,2016,SFN,BOS,3,5,5-3,BOS,10,0,37,42,79,142,139,281,8,14,22,4,3:04
5819,447738,2016-06-07,2016,LAN,COL,4,3,4-3,LAN,9,0,32,40,72,186,127,313,10,13,23,4,3:17
5820,447742,2016-06-07,2016,MIN,MIA,6,4,6-4,MIN,11,0,41,44,85,183,159,342,10,11,21,3,3:18
5821,447748,2016-06-07,2016,CHA,WAS,5,10,10-5,WAS,9,0,42,45,87,197,196,393,16,19,35,3,3:55
5822,447736,2016-06-07,2016,PHI,CHN,3,2,3-2,PHI,9,1,34,34,68,135,126,261,11,8,19,3,2:45
5823,447744,2016-06-07,2016,MIL,OAK,5,4,5-4,MIL,9,1,32,35,67,142,113,255,8,8,16,0,2:28
5824,447746,2016-06-07,2016,ARI,TBA,5,0,5-0,ARI,9,1,32,31,63,104,106,210,10,5,15,1,2:15
5825,447747,2016-06-07,2016,DET,TOR,3,2,3-2,DET,10,0,37,43,80,185,125,310,10,15,25,3,3:07
5826,447740,2016-06-07,2016,BAL,KCA,9,1,9-1,BAL,9,1,38,41,79,158,118,276,14,14,28,2,2:44
5827,447750,2016-06-08,2016,SFN,BOS,2,1,2-1,SFN,9,1,29,35,64,145,107,252,5,7,12,2,2:45
5828,447752,2016-06-08,2016,SEA,CLE,5,0,5-0,SEA,9,1,34,31,65,130,134,264,12,4,16,1,2:41
5829,447759,2016-06-08,2016,MIL,OAK,4,0,4-0,MIL,9,1,34,30,64,119,131,250,12,3,15,4,2:44
5830,447749,2016-06-08,2016,SDN,ATL,2,4,4-2,ATL,9,0,33,44,77,161,124,285,7,18,25,1,3:01
5831,447755,2016-06-08,2016,BAL,KCA,4,0,4-0,BAL,9,1,32,36,68,138,137,275,8,10,18,2,2:47
5832,447751,2016-06-08,2016,PHI,CHN,1,8,8-1,CHN,9,0,30,40,70,153,125,278,4,15,19,2,2:44 (:19 delay)
5833,447754,2016-06-08,2016,TEX,HOU,1,3,3-1,HOU,9,0,37,37,74,135,143,278,12,12,24,1,2:49
5834,447762,2016-06-08,2016,DET,TOR,2,7,7-2,TOR,9,0,37,37,74,146,157,303,13,12,25,3,2:56
5835,447761,2016-06-08,2016,ARI,TBA,3,6,6-3,TBA,9,0,40,41,81,149,146,295,16,15,31,1,3:00
5836,447756,2016-06-08,2016,NYA,ANA,12,6,12-6,NYA,9,1,45,42,87,153,151,304,19,15,34,4,3:20
5837,447757,2016-06-08,2016,MIN,MIA,7,5,7-5,MIN,9,1,39,41,80,142,141,283,15,15,30,5,3:05
5838,447760,2016-06-08,2016,CIN,SLN,7,12,12-7,SLN,9,0,42,51,93,197,141,338,16,23,39,3,3:21
5839,447763,2016-06-08,2016,CHA,WAS,4,11,11-4,WAS,9,0,38,48,86,212,147,359,12,22,34,3,3:38
5840,447753,2016-06-08,2016,LAN,COL,0,1,1-0,COL,9,0,35,33,68,132,139,271,7,7,14,2,3:04
5841,447758,2016-06-08,2016,PIT,NYN,5,6,6-5,NYN,10,0,46,45,91,171,172,343,16,19,35,1,3:51
5842,447197,2016-06-09,2016,COL,PIT,11,5,11-5,COL,9,1,43,37,80,146,152,298,19,10,29,1,2:53
5843,447771,2016-06-09,2016,CHA,WAS,3,1,3-1,CHA,9,1,31,31,62,112,126,238,7,5,12,1,2:21
5844,447767,2016-06-09,2016,NYA,ANA,6,3,6-3,NYA,9,1,40,36,76,113,146,259,18,10,28,2,2:58
5845,447766,2016-06-09,2016,TEX,HOU,5,3,5-3,TEX,9,1,35,39,74,147,143,290,11,13,24,1,2:51
5846,447197,2016-06-09,2016,COL,PIT,11,5,11-5,COL,9,1,43,37,80,146,152,298,19,10,29,1,2:53
5847,447764,2016-06-09,2016,TOR,BAL,5,6,6-5,BAL,9,0,39,41,80,158,147,305,13,15,28,4,3:12
5848,447768,2016-06-09,2016,MIN,MIA,3,10,10-3,MIA,9,0,35,45,80,159,143,302,11,19,30,4,3:04
5849,447765,2016-06-09,2016,SEA,CLE,3,5,5-3,CLE,9,0,39,42,81,181,158,339,14,15,29,4,3:39
5850,447770,2016-06-09,2016,CIN,SLN,2,3,3-2,SLN,9,0,32,38,70,153,118,271,6,10,16,0,2:56
5851,447769,2016-06-09,2016,MIL,NYN,2,5,5-2,NYN,9,0,33,42,75,154,117,271,10,17,27,2,3:04
5852,447782,2016-06-10,2016,CIN,OAK,2,1,2-1,CIN,9,1,29,37,66,139,95,234,6,15,21,1,2:36
5853,447779,2016-06-10,2016,SFN,LAN,2,3,3-2,LAN,9,0,34,34,68,129,126,255,7,7,14,0,2:35
5854,447774,2016-06-10,2016,ATL,CHN,5,1,5-1,ATL,9,1,40,30,70,130,125,255,16,4,20,3,2:51
5855,447776,2016-06-10,2016,NYA,DET,4,0,4-0,NYA,9,1,33,34,67,131,130,261,12,8,20,1,2:48
5856,447778,2016-06-10,2016,CHA,KCA,7,5,7-5,CHA,9,1,35,39,74,148,128,276,14,13,27,3,3:00
5857,447783,2016-06-10,2016,WAS,PHI,9,6,9-6,WAS,9,1,38,36,74,144,134,278,16,9,25,0,2:53
5858,447775,2016-06-10,2016,ANA,CLE,2,6,6-2,CLE,9,0,31,37,68,144,114,258,4,11,15,1,2:34
5859,447786,2016-06-10,2016,SEA,TEX,7,5,7-5,SEA,9,1,36,36,72,134,151,285,11,11,22,1,2:54
5860,447772,2016-06-10,2016,TOR,BAL,4,3,4-3,TOR,10,0,39,39,78,157,158,315,13,9,22,1,2:54
5861,447773,2016-06-10,2016,MIN,BOS,1,8,8-1,BOS,9,0,36,45,81,172,132,304,10,17,27,2,3:00
5862,447777,2016-06-10,2016,TBA,HOU,4,3,4-3,TBA,9,1,35,41,76,159,142,301,13,18,31,1,3:19
5863,447780,2016-06-10,2016,ARI,MIA,6,8,8-6,MIA,9,0,43,40,83,136,147,283,18,13,31,4,3:10
5864,447784,2016-06-10,2016,COL,SDN,5,7,7-5,SDN,9,0,38,39,77,157,167,324,12,12,24,3,3:23
5865,447781,2016-06-10,2016,MIL,NYN,1,2,2-1,NYN,11,0,40,46,86,150,182,332,9,17,26,3,3:56
5866,447785,2016-06-10,2016,PIT,SLN,3,9,9-3,SLN,12,0,48,52,100,206,185,391,13,19,32,1,4:16
5867,447795,2016-06-11,2016,ARI,MIA,5,3,5-3,ARI,9,1,31,40,71,142,116,258,7,13,20,0,2:33
5868,447800,2016-06-11,2016,PIT,SLN,1,5,5-1,SLN,9,0,33,40,73,144,130,274,9,13,22,1,2:44
5869,447790,2016-06-11,2016,ANA,CLE,4,3,4-3,ANA,9,0,37,36,73,137,123,260,13,9,22,1,2:59
5870,447792,2016-06-11,2016,TBA,HOU,3,4,4-3,HOU,9,0,35,37,72,155,123,278,11,10,21,2,2:52
5871,447791,2016-06-11,2016,NYA,DET,1,6,6-1,DET,9,0,35,38,73,139,138,277,9,12,21,4,3:17 (:05 delay)
5872,447799,2016-06-11,2016,COL,SDN,5,3,5-3,COL,9,1,34,33,67,116,132,248,12,11,23,4,2:37
5873,447793,2016-06-11,2016,CHA,KCA,1,4,4-1,KCA,9,0,34,36,70,129,125,254,8,10,18,1,2:37
5874,447797,2016-06-11,2016,CIN,OAK,2,1,2-1,CIN,9,1,35,36,71,135,136,271,11,10,21,1,2:43
5875,447796,2016-06-11,2016,MIL,NYN,7,4,7-4,MIL,9,1,36,35,71,124,151,275,15,9,24,1,2:54
5876,447789,2016-06-11,2016,ATL,CHN,2,8,8-2,CHN,9,0,37,41,78,154,129,283,8,15,23,0,2:45
5877,447801,2016-06-11,2016,SEA,TEX,1,2,2-1,TEX,11,0,41,45,86,175,123,298,9,16,25,3,3:13
5878,447798,2016-06-11,2016,WAS,PHI,8,0,8-0,WAS,9,1,39,35,74,131,153,284,16,10,26,2,2:56
5879,447787,2016-06-11,2016,TOR,BAL,11,6,11-6,TOR,9,1,43,39,82,134,163,297,22,14,36,2,3:05
5880,447794,2016-06-11,2016,SFN,LAN,5,4,5-4,SFN,10,0,40,44,84,184,163,347,14,17,31,7,4:00
5881,447788,2016-06-11,2016,MIN,BOS,4,15,15-4,BOS,9,0,40,47,87,181,172,353,15,20,35,6,3:45
5882,447815,2016-06-12,2016,PIT,SLN,3,8,8-3,SLN,9,0,32,41,73,141,121,262,6,17,23,1,2:42
5883,447810,2016-06-12,2016,ARI,MIA,6,0,6-0,ARI,9,1,39,29,68,131,144,275,14,5,19,1,2:41
5884,447809,2016-06-12,2016,SFN,LAN,2,1,2-1,SFN,9,1,32,33,65,131,124,255,9,7,16,6,3:01
5885,447811,2016-06-12,2016,MIL,NYN,5,3,5-3,MIL,9,1,35,37,72,156,134,290,10,9,19,2,2:51
5886,447813,2016-06-12,2016,WAS,PHI,5,4,5-4,WAS,9,0,38,33,71,128,154,282,13,7,20,1,2:56
5887,447808,2016-06-12,2016,CHA,KCA,1,3,3-1,KCA,9,0,31,38,69,149,114,263,6,16,22,3,2:43
5888,447806,2016-06-12,2016,NYA,DET,1,4,4-1,DET,9,0,36,38,74,156,136,292,9,11,20,0,2:56
5889,447812,2016-06-12,2016,CIN,OAK,1,6,6-1,OAK,9,0,34,41,75,154,128,282,10,17,27,1,2:50
5890,447816,2016-06-12,2016,SEA,TEX,4,6,6-4,TEX,9,0,39,40,79,171,140,311,14,13,27,2,3:05
5891,447803,2016-06-12,2016,MIN,BOS,7,4,7-4,MIN,10,0,42,40,82,156,161,317,12,13,25,2,3:28
5892,447805,2016-06-12,2016,ANA,CLE,3,8,8-3,CLE,9,0,39,42,81,150,175,325,13,14,27,4,3:28
5893,447804,2016-06-12,2016,ATL,CHN,2,13,13-2,CHN,9,0,36,50,86,194,146,340,8,25,33,3,3:42
5894,447802,2016-06-12,2016,TOR,BAL,10,9,10-9,TOR,9,1,43,44,87,189,167,356,20,18,38,3,3:11
5895,447814,2016-06-12,2016,COL,SDN,2,1,2-1,COL,9,1,33,36,69,137,121,258,9,10,19,2,2:49
5896,447807,2016-06-12,2016,TBA,HOU,5,0,5-0,TBA,9,1,37,32,69,139,144,283,12,5,17,1,2:45
5897,447817,2016-06-13,2016,WAS,CHN,4,1,4-1,WAS,9,1,40,29,69,123,143,266,17,2,19,2,2:44
5898,447819,2016-06-13,2016,KCA,CLE,2,1,2-1,KCA,9,1,34,35,69,121,139,260,12,10,22,0,2:42
5899,447824,2016-06-13,2016,ANA,MIN,4,9,9-4,MIN,9,0,35,43,78,161,145,306,9,14,23,0,2:50
5900,447825,2016-06-13,2016,TOR,PHI,0,7,7-0,PHI,9,0,36,39,75,156,149,305,11,13,24,2,2:55
5901,447826,2016-06-13,2016,OAK,TEX,14,5,14-5,OAK,9,1,44,38,82,143,169,312,22,11,33,3,3:06
5902,447822,2016-06-13,2016,SDN,MIA,4,13,13-4,MIA,9,0,36,52,88,185,139,324,9,26,35,1,3:15
5903,447823,2016-06-13,2016,SFN,MIL,11,5,11-5,SFN,9,1,42,43,85,164,172,336,21,17,38,4,3:38
5904,447818,2016-06-13,2016,ATL,CIN,8,9,9-8,CIN,9,0,41,44,85,187,151,338,15,19,34,0,3:22
5905,447820,2016-06-13,2016,CHA,DET,10,9,10-9,CHA,12,0,56,59,115,226,220,446,23,26,49,4,4:34
5906,447821,2016-06-13,2016,ARI,LAN,3,2,3-2,ARI,9,1,30,39,69,160,129,289,8,12,20,5,3:21
5907,447832,2016-06-14,2016,SLN,HOU,2,5,5-2,HOU,9,0,33,34,67,105,102,207,6,9,15,3,2:18
5908,447827,2016-06-14,2016,BOS,BAL,2,3,3-2,BAL,9,0,36,32,68,117,152,269,10,5,15,1,2:47
5909,447839,2016-06-14,2016,NYN,PIT,0,4,4-0,PIT,9,0,31,37,68,144,107,251,5,10,15,0,2:28
5910,447836,2016-06-14,2016,ANA,MIN,5,4,5-4,ANA,9,1,35,39,74,143,119,262,15,12,27,2,2:55
5911,447830,2016-06-14,2016,KCA,CLE,3,2,3-2,KCA,9,1,33,38,71,166,119,285,9,15,24,2,2:55
5912,447829,2016-06-14,2016,ATL,CIN,1,3,3-1,CIN,9,0,37,35,72,147,139,286,12,6,18,1,2:58
5913,447835,2016-06-14,2016,SFN,MIL,3,2,3-2,SFN,9,1,40,30,70,131,174,305,17,6,23,1,3:21
5914,447834,2016-06-14,2016,SDN,MIA,2,5,5-2,MIA,9,0,36,38,74,155,146,301,9,11,20,0,3:00
5915,447833,2016-06-14,2016,ARI,LAN,4,7,7-4,LAN,9,0,35,40,75,168,126,294,10,13,23,4,3:10
5916,447841,2016-06-14,2016,OAK,TEX,6,10,10-6,TEX,9,0,38,44,82,175,128,303,12,18,30,2,3:08
5917,447840,2016-06-14,2016,TBA,SEA,8,7,8-7,TBA,9,1,38,42,80,170,141,311,14,17,31,4,3:12
5918,447838,2016-06-14,2016,TOR,PHI,11,3,11-3,TOR,9,1,45,34,79,126,174,300,19,8,27,1,2:43
5919,447828,2016-06-14,2016,WAS,CHN,3,4,4-3,CHN,9,0,37,38,75,148,135,283,10,13,23,3,3:03
5920,447837,2016-06-14,2016,COL,NYA,13,10,13-10,COL,9,1,43,46,89,176,158,334,21,20,41,5,3:43
5921,447831,2016-06-14,2016,CHA,DET,8,11,11-8,DET,9,0,38,49,87,206,140,346,12,26,38,1,3:47
5922,447846,2016-06-15,2016,CHA,DET,5,3,5-3,CHA,9,1,38,36,74,145,116,261,16,11,27,2,2:49
5923,447848,2016-06-15,2016,ARI,LAN,2,3,3-2,LAN,9,0,33,35,68,146,138,284,6,10,16,2,2:51
5924,447845,2016-06-15,2016,KCA,CLE,9,4,9-4,KCA,9,1,40,35,75,138,135,273,14,8,22,4,2:47
5925,447842,2016-06-15,2016,BOS,BAL,6,4,6-4,BOS,9,1,39,38,77,131,154,285,17,11,28,2,2:58
5926,447856,2016-06-15,2016,PHI,TOR,2,7,7-2,TOR,9,0,35,40,75,164,135,299,8,15,23,2,2:51
5927,447850,2016-06-15,2016,SFN,MIL,10,1,10-1,SFN,9,1,46,36,82,131,151,282,21,10,31,1,2:56
5928,447849,2016-06-15,2016,SDN,MIA,6,3,6-3,SDN,9,1,38,38,76,143,128,271,15,13,28,1,2:58
5929,447855,2016-06-15,2016,OAK,TEX,5,7,7-5,TEX,9,0,37,38,75,136,172,308,10,13,23,2,3:08
5930,447843,2016-06-15,2016,WAS,CHN,5,4,5-4,WAS,12,0,47,46,93,185,182,367,14,15,29,5,4:17
5931,447851,2016-06-15,2016,ANA,MIN,10,2,10-2,ANA,9,1,43,35,78,153,176,329,19,8,27,2,3:13
5932,447854,2016-06-15,2016,TBA,SEA,3,2,3-2,TBA,13,0,58,51,109,209,236,445,23,15,38,4,4:38
5933,447844,2016-06-15,2016,ATL,CIN,9,8,9-8,ATL,13,0,63,56,119,241,257,498,27,20,47,4,5:18
5934,447852,2016-06-15,2016,COL,NYA,6,3,6-3,COL,9,1,39,34,73,128,140,268,17,7,24,2,2:55
5935,447847,2016-06-15,2016,SLN,HOU,1,4,4-1,HOU,9,0,36,36,72,133,133,266,12,14,26,2,2:56
5936,447853,2016-06-15,2016,NYN,PIT,11,2,11-2,NYN,9,1,45,33,78,136,152,288,21,5,26,2,3:06
5937,447857,2016-06-16,2016,BOS,BAL,1,5,5-1,BAL,9,0,32,40,72,150,119,269,5,14,19,1,2:53
5938,447862,2016-06-16,2016,NYN,PIT,6,4,6-4,NYN,9,1,37,35,72,115,153,268,14,10,24,4,2:55
5939,447864,2016-06-16,2016,OAK,TEX,1,5,5-1,TEX,9,0,30,40,70,162,109,271,3,14,17,2,2:35 (:01 delay)
5940,447861,2016-06-16,2016,MIN,NYA,1,4,4-1,NYA,9,0,38,33,71,135,161,296,11,9,20,1,3:00
5941,447858,2016-06-16,2016,ATL,CIN,7,2,7-2,ATL,9,1,37,38,75,156,140,296,13,12,25,3,2:56
5942,447860,2016-06-16,2016,LAN,MIL,6,8,8-6,MIL,9,0,38,39,77,165,138,303,12,13,25,1,3:18
5943,447859,2016-06-16,2016,KCA,DET,4,10,10-4,DET,9,0,38,43,81,159,133,292,13,16,29,0,3:15
5944,447865,2016-06-16,2016,PHI,TOR,2,13,13-2,TOR,9,0,34,48,82,188,106,294,7,20,27,1,3:04
5945,447863,2016-06-16,2016,TBA,SEA,4,6,6-4,SEA,9,0,42,43,85,177,175,352,15,19,34,1,3:30
5946,447866,2016-06-16,2016,SDN,WAS,5,8,8-5,WAS,9,0,40,42,82,177,157,334,14,15,29,2,3:18
5947,447879,2016-06-17,2016,SLN,TEX,0,1,1-0,TEX,9,0,32,34,66,119,109,228,6,8,14,2,2:23
5948,447869,2016-06-17,2016,CLE,CHA,3,2,3-2,CLE,9,0,32,37,69,148,115,263,9,12,21,1,2:47
5949,447871,2016-06-17,2016,MIA,COL,5,1,5-1,MIA,9,1,36,34,70,158,143,301,13,9,22,2,2:57
5950,447878,2016-06-17,2016,BOS,SEA,4,8,8-4,SEA,9,0,38,39,77,130,121,251,12,13,25,1,2:49
5951,447873,2016-06-17,2016,OAK,ANA,3,2,3-2,OAK,9,0,37,35,72,118,146,264,12,7,19,2,2:51
5952,447877,2016-06-17,2016,TBA,SFN,1,5,5-1,SFN,9,0,30,38,68,165,115,280,4,11,15,0,2:45
5953,447872,2016-06-17,2016,KCA,DET,10,3,10-3,KCA,9,1,43,36,79,151,164,315,20,10,30,3,3:17
5954,447881,2016-06-17,2016,SDN,WAS,5,7,7-5,WAS,9,0,41,38,79,138,163,301,14,13,27,1,3:12
5955,447874,2016-06-17,2016,LAN,MIL,3,2,3-2,LAN,10,0,39,44,83,182,140,322,14,15,29,1,3:37
5956,447875,2016-06-17,2016,MIN,NYA,2,8,8-2,NYA,9,0,35,44,79,175,137,312,9,20,29,1,3:03 (:35 delay)
5957,447867,2016-06-17,2016,PHI,ARI,2,10,10-2,ARI,9,0,35,44,79,167,136,303,8,17,25,1,3:04
5958,447868,2016-06-17,2016,NYN,ATL,1,5,5-1,ATL,9,0,35,43,78,142,157,299,10,16,26,4,3:13
5959,447870,2016-06-17,2016,HOU,CIN,2,4,4-2,CIN,11,0,49,45,94,158,206,364,16,15,31,2,3:57
5960,447876,2016-06-17,2016,CHN,PIT,6,0,6-0,CHN,9,1,44,34,78,155,185,340,23,8,31,3,3:18
5961,447880,2016-06-17,2016,BAL,TOR,3,13,13-3,TOR,9,0,36,43,79,171,139,310,9,18,27,1,2:53
5962,447882,2016-06-18,2016,PHI,ARI,1,4,4-1,ARI,9,0,31,40,71,146,102,248,5,13,18,1,2:37
5963,447895,2016-06-18,2016,BAL,TOR,4,2,4-2,BAL,9,1,34,38,72,141,134,275,12,13,25,0,2:33
5964,447893,2016-06-18,2016,BOS,SEA,6,2,6-2,BOS,9,1,35,34,69,130,142,272,13,9,22,1,2:53
5965,447892,2016-06-18,2016,TBA,SFN,4,6,6-4,SFN,9,0,38,39,77,157,138,295,13,14,27,5,3:13
5966,447890,2016-06-18,2016,MIN,NYA,6,7,7-6,NYA,9,0,36,39,75,147,158,305,9,15,24,4,3:10
5967,447883,2016-06-18,2016,NYN,ATL,3,4,4-3,ATL,9,0,37,36,73,157,135,292,10,12,22,3,3:02
5968,447888,2016-06-18,2016,OAK,ANA,1,7,7-1,ANA,9,0,34,42,76,158,132,290,8,15,23,4,3:05
5969,447894,2016-06-18,2016,SLN,TEX,3,4,4-3,TEX,9,0,36,39,75,159,141,300,12,13,25,2,3:05
5970,447896,2016-06-18,2016,SDN,WAS,7,3,7-3,SDN,9,1,35,38,73,125,163,288,13,12,25,3,3:12
5971,447889,2016-06-18,2016,LAN,MIL,10,6,10-6,LAN,9,1,40,39,79,160,167,327,18,15,33,2,3:28
5972,447891,2016-06-18,2016,CHN,PIT,4,3,4-3,CHN,9,1,37,37,74,138,137,275,16,12,28,4,3:00
5973,447886,2016-06-18,2016,MIA,COL,9,6,9-6,MIA,9,1,44,39,83,178,155,333,22,13,35,2,3:23
5974,447884,2016-06-18,2016,CLE,CHA,13,2,13-2,CLE,9,1,47,35,82,145,185,330,24,8,32,3,3:00
5975,447887,2016-06-18,2016,KCA,DET,16,5,16-5,KCA,9,1,47,37,84,122,171,293,26,12,38,4,3:16
5976,447885,2016-06-18,2016,HOU,CIN,5,4,5-4,HOU,11,0,46,41,87,152,152,304,18,9,27,0,3:05
5977,447904,2016-06-19,2016,LAN,MIL,2,1,2-1,LAN,9,0,35,33,68,125,116,241,11,9,20,1,2:44
5978,447903,2016-06-19,2016,OAK,ANA,0,2,2-0,ANA,9,0,29,34,63,143,95,238,4,9,13,0,2:19
5979,447898,2016-06-19,2016,NYN,ATL,0,6,6-0,ATL,9,0,28,41,69,164,120,284,1,14,15,0,2:51
5980,447900,2016-06-19,2016,HOU,CIN,6,0,6-0,HOU,9,1,34,33,67,134,132,266,13,7,20,1,2:48
5981,447905,2016-06-19,2016,MIN,NYA,7,4,7-4,MIN,9,1,36,35,71,131,153,284,13,7,20,3,3:00
5982,447897,2016-06-19,2016,PHI,ARI,1,5,5-1,ARI,9,0,33,42,75,155,122,277,6,15,21,3,2:59
5983,447908,2016-06-19,2016,BOS,SEA,2,1,2-1,BOS,9,1,37,33,70,123,158,281,18,8,26,1,3:05
5984,447901,2016-06-19,2016,MIA,COL,3,0,3-0,MIA,9,1,32,34,66,134,143,277,9,9,18,1,2:51
5985,447911,2016-06-19,2016,SDN,WAS,6,3,6-3,SDN,9,1,37,33,70,132,147,279,16,8,24,1,2:59
5986,447909,2016-06-19,2016,SLN,TEX,4,5,5-4,TEX,9,0,38,38,76,135,139,274,15,12,27,2,2:58
5987,447910,2016-06-19,2016,BAL,TOR,11,6,11-6,BAL,9,1,42,36,78,162,143,305,21,8,29,5,3:31
5988,447899,2016-06-19,2016,CLE,CHA,3,2,3-2,CLE,10,0,42,39,81,144,147,291,18,11,29,2,3:12
5989,447906,2016-06-19,2016,CHN,PIT,10,5,10-5,CHN,9,1,39,42,81,174,151,325,16,14,30,4,3:23
5990,447902,2016-06-19,2016,KCA,DET,2,1,2-1,KCA,13,0,44,44,88,177,150,327,12,7,19,1,3:32
5991,447907,2016-06-19,2016,TBA,SFN,1,5,5-1,SFN,9,0,37,38,75,165,147,312,9,12,21,2,3:30
5992,447039,2016-06-20,2016,TEX,BAL,4,3,4-3,TEX,9,1,34,42,76,151,149,300,11,18,29,2,3:04
5993,447912,2016-06-20,2016,PHI,ARI,1,3,3-1,ARI,9,0,33,32,65,111,124,235,7,7,14,1,2:40
5994,447916,2016-06-20,2016,PIT,SFN,1,0,1-0,PIT,9,1,29,32,61,107,110,217,7,6,13,1,2:24
5995,447919,2016-06-20,2016,CLE,TBA,7,4,7-4,CLE,9,1,35,33,68,128,115,243,11,6,17,1,2:26
5996,447920,2016-06-20,2016,LAN,WAS,4,1,4-1,LAN,9,1,32,34,66,134,140,274,10,7,17,0,2:50
5997,447918,2016-06-20,2016,CHN,SLN,2,3,3-2,SLN,9,0,38,39,77,157,137,294,13,14,27,2,3:00
5998,447914,2016-06-20,2016,MIA,COL,3,5,5-3,COL,9,0,36,40,76,154,152,306,11,16,27,3,3:17
5999,447039,2016-06-20,2016,TEX,BAL,4,3,4-3,TEX,9,1,34,42,76,151,149,300,11,18,29,2,3:04
6000,447913,2016-06-20,2016,BOS,CHA,1,3,3-1,CHA,10,0,40,40,80,143,161,304,10,11,21,3,3:33
6001,447915,2016-06-20,2016,HOU,ANA,10,7,10-7,HOU,9,1,43,38,81,147,160,307,22,11,33,2,3:13
6002,447917,2016-06-20,2016,DET,SEA,8,7,8-7,DET,12,0,51,54,105,198,196,394,19,22,41,1,4:29
6003,447935,2016-06-21,2016,LAN,WAS,3,2,3-2,LAN,9,1,30,39,69,147,115,262,8,15,23,1,2:44
6004,447933,2016-06-21,2016,CHN,SLN,3,4,4-3,SLN,9,0,37,35,72,132,136,268,13,9,22,2,2:55
6005,447921,2016-06-21,2016,TOR,ARI,2,4,4-2,ARI,9,0,36,33,69,130,130,260,12,6,18,1,2:42
6006,447926,2016-06-21,2016,NYN,KCA,2,1,2-1,NYN,9,1,33,35,68,138,135,273,9,8,17,2,2:56
6007,447923,2016-06-21,2016,BOS,CHA,1,3,3-1,CHA,9,0,36,33,69,135,149,284,9,8,17,2,2:54
6008,447927,2016-06-21,2016,HOU,ANA,3,2,3-2,HOU,9,0,31,34,65,140,125,265,12,7,19,2,2:54
6009,447922,2016-06-21,2016,MIA,ATL,2,3,3-2,ATL,10,0,41,37,78,140,170,310,13,9,22,4,3:16
6010,447925,2016-06-21,2016,NYA,COL,4,8,8-4,COL,9,0,38,45,83,171,145,316,12,18,30,3,3:31
6011,447930,2016-06-21,2016,BAL,SDN,7,10,10-7,SDN,9,0,43,49,92,187,162,349,15,22,37,3,3:44 (:38 delay)
6012,447928,2016-06-21,2016,OAK,MIL,5,3,5-3,OAK,9,1,41,36,77,130,190,320,18,11,29,4,3:32
6013,447929,2016-06-21,2016,MIN,PHI,14,10,14-10,MIN,9,1,45,43,88,155,185,340,21,15,36,2,3:24
6014,447931,2016-06-21,2016,PIT,SFN,4,15,15-4,SFN,9,0,41,52,93,202,165,367,13,27,40,3,3:49
6015,447924,2016-06-21,2016,TEX,CIN,2,8,8-2,CIN,9,0,32,38,70,125,124,249,8,12,20,0,2:29
6016,447932,2016-06-21,2016,DET,SEA,4,2,4-2,DET,9,1,37,36,73,130,116,246,16,10,26,1,2:47
6017,447934,2016-06-21,2016,CLE,TBA,6,0,6-0,CLE,9,1,36,32,68,115,129,244,13,5,18,1,2:36
6018,447937,2016-06-22,2016,MIA,ATL,3,0,3-0,MIA,9,1,32,34,66,130,120,250,9,8,17,1,2:27
6019,447939,2016-06-22,2016,TEX,CIN,6,4,6-4,TEX,9,1,31,39,70,152,125,277,8,12,20,0,2:38
6020,447943,2016-06-22,2016,OAK,MIL,2,4,4-2,MIL,9,0,35,40,75,150,130,280,8,14,22,3,2:53
6021,447942,2016-06-22,2016,HOU,ANA,3,2,3-2,HOU,9,1,32,39,71,143,119,262,12,13,25,2,3:09
6022,447941,2016-06-22,2016,NYN,KCA,4,3,4-3,NYN,9,1,33,35,68,145,161,306,10,9,19,1,3:06
6023,447948,2016-06-22,2016,CHN,SLN,2,7,7-2,SLN,9,0,31,43,74,177,132,309,6,14,20,4,3:02
6024,447949,2016-06-22,2016,CLE,TBA,6,1,6-1,CLE,9,1,35,30,65,113,144,257,11,4,15,1,2:30
6025,447940,2016-06-22,2016,NYA,COL,9,8,9-8,NYA,9,0,42,38,80,159,148,307,19,11,30,4,3:25
6026,447936,2016-06-22,2016,TOR,ARI,5,2,5-2,TOR,9,1,31,38,69,151,133,284,9,12,21,1,2:54
6027,447950,2016-06-22,2016,LAN,WAS,4,3,4-3,LAN,9,0,35,39,74,174,131,305,10,14,24,4,3:35
6028,447946,2016-06-22,2016,PIT,SFN,6,7,7-6,SFN,9,0,38,44,82,158,159,317,12,17,29,1,3:28
6029,447944,2016-06-22,2016,MIN,PHI,6,5,6-5,MIN,9,1,39,37,76,129,141,270,15,12,27,1,2:48 (1:10 delay)
6030,447938,2016-06-22,2016,BOS,CHA,6,8,8-6,CHA,9,0,45,42,87,164,182,346,22,14,36,4,3:38
6031,447947,2016-06-22,2016,DET,SEA,5,1,5-1,DET,9,1,38,33,71,121,139,260,16,6,22,2,2:39
6032,447945,2016-06-22,2016,BAL,SDN,7,2,7-2,BAL,9,1,36,37,73,156,120,276,13,10,23,1,2:43
6033,447955,2016-06-23,2016,ANA,OAK,4,5,5-4,OAK,9,0,37,39,76,152,134,286,12,13,25,1,3:03
6034,447952,2016-06-23,2016,MIA,CHN,4,2,4-2,MIA,9,1,34,37,71,140,128,268,11,11,22,1,2:43
6035,447954,2016-06-23,2016,ATL,NYN,4,3,4-3,ATL,9,1,34,39,73,138,126,264,13,12,25,2,2:54
6036,447956,2016-06-23,2016,MIN,PHI,3,7,7-3,PHI,9,0,36,44,80,157,151,308,9,22,31,2,3:07
6037,447958,2016-06-23,2016,PIT,SFN,3,5,5-3,SFN,9,0,35,36,71,144,166,310,8,11,19,0,3:04
6038,447951,2016-06-23,2016,COL,ARI,6,7,7-6,ARI,9,0,44,43,87,175,168,343,16,18,34,2,3:42
6039,447959,2016-06-23,2016,DET,SEA,5,4,5-4,DET,10,0,45,39,84,149,188,337,18,10,28,2,3:24
6040,447957,2016-06-23,2016,CIN,SDN,4,7,7-4,SDN,9,0,39,39,78,181,170,351,12,13,25,1,3:26
6041,447953,2016-06-23,2016,BOS,CHA,8,7,8-7,BOS,10,0,48,47,95,154,201,355,23,20,43,4,4:25
6042,447967,2016-06-24,2016,ATL,NYN,6,8,8-6,NYN,9,0,37,39,76,130,129,259,12,16,28,3,2:55
6043,447966,2016-06-24,2016,NYA,MIN,5,3,5-3,NYA,9,1,37,35,72,130,149,279,11,9,20,1,2:59
6044,447963,2016-06-24,2016,DET,CLE,5,7,7-5,CLE,9,0,39,38,77,144,153,297,14,13,27,2,3:01
6045,447971,2016-06-24,2016,SEA,SLN,4,3,4-3,SEA,9,0,34,36,70,146,133,279,10,10,20,1,2:52
6046,447972,2016-06-24,2016,BAL,TBA,6,3,6-3,BAL,9,1,33,35,68,160,135,295,9,12,21,2,3:07
6047,447974,2016-06-24,2016,MIL,WAS,5,3,5-3,MIL,9,1,32,41,73,183,145,328,8,14,22,0,3:06
6048,447965,2016-06-24,2016,PIT,LAN,8,6,8-6,PIT,9,1,38,40,78,147,149,296,16,15,31,4,3:17
6049,447973,2016-06-24,2016,CHA,TOR,3,2,3-2,CHA,9,1,37,40,77,168,140,308,13,13,26,1,3:22
6050,447970,2016-06-24,2016,CIN,SDN,4,13,13-4,SDN,9,0,38,45,83,178,147,325,11,19,30,1,3:12
6051,447962,2016-06-24,2016,MIA,CHN,4,5,5-4,CHN,9,0,36,41,77,155,175,330,8,15,23,3,3:24
6052,447968,2016-06-24,2016,ANA,OAK,4,7,7-4,OAK,9,0,40,40,80,155,140,295,13,15,28,3,3:17
6053,447961,2016-06-24,2016,TEX,BOS,7,8,8-7,BOS,9,0,43,40,83,170,173,343,18,16,34,2,3:48
6054,447969,2016-06-24,2016,SFN,PHI,5,4,5-4,SFN,9,1,36,42,78,159,134,293,10,17,27,5,3:21
6055,447964,2016-06-24,2016,KCA,HOU,4,13,13-4,HOU,9,0,38,50,88,172,129,301,13,21,34,2,2:56
6056,447960,2016-06-24,2016,COL,ARI,9,10,10-9,ARI,9,0,52,49,101,170,211,381,24,24,48,8,4:30
6057,446940,2016-06-25,2016,BAL,TBA,5,0,5-0,BAL,9,1,39,33,72,135,139,274,17,6,23,3,2:46
6058,447985,2016-06-25,2016,CIN,SDN,0,3,3-0,SDN,9,0,31,38,69,147,130,277,5,12,17,1,2:44
6059,447978,2016-06-25,2016,DET,CLE,0,6,6-0,CLE,9,0,32,36,68,142,117,259,5,10,15,0,2:43
6060,446940,2016-06-25,2016,BAL,TBA,5,0,5-0,BAL,9,1,39,33,72,135,139,274,17,6,23,3,2:46
6061,447977,2016-06-25,2016,MIA,CHN,9,6,9-6,MIA,9,1,37,43,80,163,153,316,13,18,31,3,3:09
6062,447981,2016-06-25,2016,NYA,MIN,2,1,2-1,NYA,9,1,36,31,67,126,147,273,12,4,16,1,2:44
6063,447986,2016-06-25,2016,SEA,SLN,5,4,5-4,SEA,9,1,38,39,77,149,139,288,15,11,26,2,2:53
6064,447982,2016-06-25,2016,ATL,NYN,0,1,1-0,NYN,11,0,40,40,80,152,131,283,12,10,22,2,3:19
6065,447988,2016-06-25,2016,CHA,TOR,8,10,10-8,TOR,9,0,40,45,85,158,138,296,13,18,31,4,3:14
6066,447983,2016-06-25,2016,ANA,OAK,3,7,7-3,OAK,9,0,42,42,84,150,173,323,15,18,33,4,3:24
6067,447980,2016-06-25,2016,PIT,LAN,6,1,6-1,PIT,9,1,32,34,66,123,148,271,9,8,17,1,2:47
6068,447975,2016-06-25,2016,COL,ARI,11,6,11-6,COL,9,1,42,43,85,178,147,325,20,20,40,1,3:35
6069,447984,2016-06-25,2016,SFN,PHI,2,3,3-2,PHI,9,0,35,32,67,138,124,262,8,7,15,1,2:47
6070,447987,2016-06-25,2016,BAL,TBA,8,6,8-6,BAL,9,1,36,43,79,157,150,307,15,20,35,2,3:15
6071,447979,2016-06-25,2016,KCA,HOU,5,13,13-5,HOU,9,0,44,48,92,179,176,355,20,22,42,3,3:40
6072,447976,2016-06-25,2016,TEX,BOS,10,3,10-3,TEX,9,1,42,36,78,170,175,345,17,11,28,4,3:30
6073,447989,2016-06-25,2016,MIL,WAS,6,5,6-5,MIL,9,1,36,41,77,131,141,272,13,15,28,1,3:05
6074,447995,2016-06-26,2016,PIT,LAN,4,3,4-3,PIT,9,1,33,34,67,116,124,240,12,8,20,0,2:40
6075,448003,2016-06-26,2016,CHA,TOR,5,2,5-2,CHA,9,1,36,31,67,109,145,254,12,7,19,0,2:27
6076,447997,2016-06-26,2016,ATL,NYN,5,2,5-2,ATL,9,1,36,34,70,124,114,238,12,7,19,2,2:39
6077,447994,2016-06-26,2016,KCA,HOU,6,1,6-1,KCA,9,1,36,31,67,123,127,250,13,5,18,2,2:33
6078,448004,2016-06-26,2016,MIL,WAS,2,3,3-2,WAS,9,0,38,37,75,149,137,286,12,10,22,2,3:14
6079,447999,2016-06-26,2016,SFN,PHI,8,7,8-7,SFN,9,0,44,41,85,134,146,280,20,15,35,3,3:16
6080,448002,2016-06-26,2016,BAL,TBA,12,5,12-5,BAL,9,1,42,40,82,147,160,307,20,15,35,0,3:03
6081,447998,2016-06-26,2016,ANA,OAK,7,6,7-6,ANA,9,0,42,40,82,160,173,333,16,14,30,1,3:33
6082,447993,2016-06-26,2016,DET,CLE,3,9,9-3,CLE,9,0,34,40,74,153,112,265,7,15,22,1,2:48
6083,447996,2016-06-26,2016,NYA,MIN,1,7,7-1,MIN,9,0,29,37,66,145,110,255,2,12,14,1,2:24
6084,448000,2016-06-26,2016,CIN,SDN,3,0,3-0,CIN,9,1,36,30,66,130,112,242,13,6,19,0,2:38
6085,447990,2016-06-26,2016,COL,ARI,9,7,9-7,COL,9,0,43,44,87,140,152,292,20,18,38,4,3:35
6086,447992,2016-06-26,2016,MIA,CHN,6,1,6-1,MIA,9,1,39,34,73,131,156,287,14,8,22,3,3:07
6087,448001,2016-06-26,2016,SEA,SLN,6,11,11-6,SLN,9,0,42,48,90,172,173,345,16,20,36,2,3:25
6088,447991,2016-06-26,2016,TEX,BOS,6,2,6-2,TEX,9,1,36,37,73,140,144,284,19,11,30,2,3:04
6089,448013,2016-06-27,2016,KCA,SLN,6,2,6-2,KCA,9,1,37,31,68,111,139,250,13,6,19,0,2:32
6090,448011,2016-06-27,2016,SFN,OAK,3,8,8-3,OAK,9,0,35,41,76,146,122,268,10,18,28,2,2:43
6091,448009,2016-06-27,2016,PIT,LAN,4,5,5-4,LAN,9,0,37,41,78,161,161,322,11,15,26,3,3:32
6092,448015,2016-06-27,2016,COL,TOR,9,5,9-5,COL,9,1,39,34,73,132,147,279,15,7,22,2,2:48
6093,448014,2016-06-27,2016,NYA,TEX,6,9,9-6,TEX,9,0,46,44,90,170,170,340,20,16,36,2,3:43 (3:56 delay)
6094,448007,2016-06-27,2016,ATL,CLE,3,8,8-3,CLE,9,0,38,40,78,142,156,298,12,15,27,3,3:15
6095,448012,2016-06-27,2016,ARI,PHI,0,8,8-0,PHI,9,0,34,45,79,161,146,307,9,18,27,2,3:18
6096,448006,2016-06-27,2016,CIN,CHN,8,11,11-8,CHN,9,0,41,46,87,165,156,321,14,20,34,4,3:22
6097,448008,2016-06-27,2016,ANA,HOU,2,4,4-2,HOU,9,0,36,42,78,165,123,288,12,17,29,3,3:38
6098,448010,2016-06-27,2016,WAS,NYN,11,4,11-4,WAS,9,1,44,40,84,140,169,309,22,15,37,0,3:33
6099,448005,2016-06-27,2016,TBA,BOS,13,7,13-7,TBA,9,1,44,42,86,165,184,349,21,16,37,2,3:29
6100,448019,2016-06-28,2016,ATL,CLE,3,5,5-3,CLE,9,0,31,41,72,146,104,250,6,15,21,1,2:40
6101,448024,2016-06-28,2016,WAS,NYN,5,0,5-0,WAS,9,1,36,34,70,135,130,265,15,8,23,3,2:47 (2:20 delay)
6102,448023,2016-06-28,2016,CHA,MIN,0,4,4-0,MIN,9,0,35,36,71,138,137,275,7,10,17,0,2:51
6103,448026,2016-06-28,2016,ARI,PHI,3,4,4-3,PHI,9,0,38,41,79,165,159,324,15,16,31,1,3:34
6104,448029,2016-06-28,2016,NYA,TEX,1,7,7-1,TEX,9,0,35,39,74,126,117,243,9,13,22,1,2:37
6105,448027,2016-06-28,2016,SEA,PIT,5,2,5-2,SEA,9,1,36,33,69,135,154,289,14,8,22,2,2:53
6106,448016,2016-06-28,2016,SDN,BAL,7,11,11-7,BAL,9,0,41,46,87,158,176,334,15,20,35,2,3:08
6107,448022,2016-06-28,2016,DET,MIA,7,5,7-5,DET,9,1,36,44,80,151,150,301,12,18,30,3,3:00
6108,448028,2016-06-28,2016,KCA,SLN,4,8,8-4,SLN,9,0,40,42,82,150,144,294,13,15,28,1,2:50
6109,448021,2016-06-28,2016,MIL,LAN,5,6,6-5,LAN,9,0,38,44,82,157,148,305,12,19,31,2,3:25
6110,448017,2016-06-28,2016,TBA,BOS,2,8,8-2,BOS,9,0,36,43,79,164,145,309,9,18,27,1,3:11
6111,448020,2016-06-28,2016,ANA,HOU,1,7,7-1,HOU,9,0,36,43,79,180,125,305,9,17,26,1,3:07
6112,448030,2016-06-28,2016,COL,TOR,9,14,14-9,TOR,9,0,44,54,98,198,181,379,16,27,43,3,3:51 (2:41 delay)
6113,448025,2016-06-28,2016,SFN,OAK,11,13,13-11,OAK,9,0,50,48,98,185,167,352,25,20,45,6,3:53
6114,448018,2016-06-28,2016,CIN,CHN,2,7,7-2,CHN,15,0,54,61,115,244,209,453,11,17,28,5,4:43
6115,448034,2016-06-29,2016,ATL,CLE,0,3,3-0,CLE,9,0,35,36,71,128,139,267,9,10,19,1,2:51
6116,448044,2016-06-29,2016,NYA,TEX,9,7,9-7,NYA,9,0,42,39,81,159,149,308,17,12,29,3,3:19
6117,448043,2016-06-29,2016,OAK,SFN,7,1,7-1,OAK,9,1,33,36,69,131,127,258,9,11,20,2,2:44
6118,448031,2016-06-29,2016,SDN,BAL,6,12,12-6,BAL,9,0,39,45,84,158,146,304,13,19,32,3,3:07
6119,448045,2016-06-29,2016,COL,TOR,3,5,5-3,TOR,9,0,38,44,82,175,135,310,13,18,31,1,3:17
6120,448037,2016-06-29,2016,MIL,LAN,7,0,7-0,MIL,9,1,36,30,66,121,145,266,16,4,20,0,2:30
6121,448038,2016-06-29,2016,DET,MIA,10,3,10-3,DET,9,1,42,42,84,160,185,345,18,15,33,1,3:13
6122,448040,2016-06-29,2016,WAS,NYN,4,2,4-2,WAS,9,1,33,34,67,140,139,279,11,7,18,3,3:01
6123,448042,2016-06-29,2016,SEA,PIT,1,8,8-1,PIT,9,0,32,45,77,166,123,289,6,15,21,0,2:47
6124,448039,2016-06-29,2016,CHA,MIN,9,6,9-6,CHA,9,1,38,43,81,161,143,304,14,17,31,4,3:03
6125,448041,2016-06-29,2016,ARI,PHI,8,9,9-8,PHI,10,0,47,50,97,178,171,349,18,20,38,5,3:53
6126,448032,2016-06-29,2016,TBA,BOS,4,0,4-0,TBA,9,1,34,34,68,138,123,261,10,7,17,1,2:49
6127,448035,2016-06-29,2016,ANA,HOU,4,10,10-4,HOU,9,0,43,46,89,160,154,314,16,19,35,2,3:18
6128,448033,2016-06-29,2016,CIN,CHN,2,9,9-2,CHN,9,0,38,44,82,176,161,337,14,19,33,3,3:14
6129,448036,2016-06-29,2016,SLN,KCA,2,3,3-2,KCA,12,0,50,58,108,215,195,410,14,21,35,3,4:28
6130,448049,2016-06-30,2016,TOR,CLE,1,4,4-1,CLE,9,0,32,36,68,118,140,258,6,11,17,1,2:33
6131,448046,2016-06-30,2016,SEA,BAL,5,3,5-3,SEA,9,1,38,35,73,143,159,302,16,9,25,4,3:06
6132,448047,2016-06-30,2016,NYN,CHN,4,3,4-3,NYN,9,1,34,41,75,179,141,320,9,16,25,4,3:22
6133,448051,2016-06-30,2016,SLN,KCA,2,4,4-2,KCA,9,0,36,35,71,138,165,303,10,8,18,0,2:50
6134,448052,2016-06-30,2016,MIL,LAN,1,8,8-1,LAN,9,0,35,44,79,185,140,325,8,19,27,2,3:19
6135,448048,2016-06-30,2016,WAS,CIN,13,4,13-4,WAS,9,1,43,39,82,149,172,321,21,15,36,1,3:07
6136,448056,2016-06-30,2016,NYA,TEX,2,1,2-1,NYA,9,0,36,34,70,144,154,298,11,7,18,1,3:12
6137,448050,2016-06-30,2016,TBA,DET,7,10,10-7,DET,9,0,41,40,81,176,154,330,16,16,32,3,3:25
6138,448053,2016-06-30,2016,ATL,MIA,8,5,8-5,ATL,9,1,41,45,86,204,149,353,18,18,36,3,3:33 (1:08 delay)
6139,448054,2016-06-30,2016,CHA,MIN,6,5,6-5,CHA,9,1,37,35,72,150,144,294,16,10,26,3,3:03
6140,448055,2016-06-30,2016,OAK,SFN,6,12,12-6,SFN,9,0,38,49,87,209,159,368,11,25,36,4,3:43
6141,448059,2016-07-01,2016,HOU,CHA,5,0,5-0,HOU,9,1,33,34,67,131,114,245,10,8,18,0,2:58
6142,448067,2016-07-01,2016,SLN,MIL,7,1,7-1,SLN,9,1,40,35,75,106,137,243,16,8,24,1,2:47
6143,448070,2016-07-01,2016,ARI,SFN,4,6,6-4,SFN,9,0,36,38,74,128,145,273,10,12,22,0,2:52
6144,448071,2016-07-01,2016,MIN,TEX,2,3,3-2,TEX,10,0,37,42,79,177,135,312,10,12,22,1,3:04
6145,448064,2016-07-01,2016,PHI,KCA,4,3,4-3,PHI,9,1,37,36,73,146,149,295,15,10,25,0,3:06
6146,448058,2016-07-01,2016,NYN,CHN,10,2,10-2,NYN,9,1,40,36,76,152,158,310,16,9,25,2,2:56 (1:59 delay)
6147,448057,2016-07-01,2016,SEA,BAL,5,2,5-2,SEA,9,1,36,34,70,118,146,264,12,6,18,0,2:35
6148,448069,2016-07-01,2016,OAK,PIT,3,7,7-3,PIT,9,0,35,37,72,141,142,283,7,11,18,0,2:45
6149,448065,2016-07-01,2016,BOS,ANA,5,4,5-4,BOS,9,1,39,42,81,182,148,330,20,18,38,2,3:36 (1:35 delay)
6150,448068,2016-07-01,2016,SDN,NYA,7,6,7-6,SDN,9,1,36,38,74,146,149,295,13,11,24,4,3:12
6151,448066,2016-07-01,2016,ATL,MIA,5,7,7-5,MIA,12,0,51,55,106,186,171,357,16,22,38,2,4:05
6152,448060,2016-07-01,2016,WAS,CIN,3,2,3-2,WAS,14,0,55,51,106,190,209,399,16,13,29,1,4:30 (:35 delay)
6153,448061,2016-07-01,2016,TOR,CLE,1,2,2-1,CLE,19,0,75,76,151,305,301,606,21,20,41,4,6:13
6154,448062,2016-07-01,2016,LAN,COL,5,0,5-0,LAN,9,1,34,33,67,145,112,257,13,7,20,2,2:53
6155,448063,2016-07-01,2016,TBA,DET,2,10,10-2,DET,9,0,32,45,77,191,123,314,5,18,23,2,3:06
6156,448085,2016-07-02,2016,ARI,SFN,6,5,6-5,ARI,9,1,35,36,71,143,115,258,11,10,21,3,2:55
6157,448083,2016-07-02,2016,SDN,NYA,2,1,2-1,SDN,9,0,32,33,65,122,124,246,10,7,17,1,2:43
6158,448081,2016-07-02,2016,ATL,MIA,9,1,9-1,ATL,9,1,35,37,72,139,116,255,11,10,21,1,2:28
6159,448074,2016-07-02,2016,HOU,CHA,6,7,7-6,CHA,9,0,36,42,78,188,131,319,8,18,26,3,3:09
6160,448077,2016-07-02,2016,LAN,COL,6,1,6-1,LAN,9,1,38,34,72,159,167,326,14,7,21,1,3:11
6161,448079,2016-07-02,2016,PHI,KCA,2,6,6-2,KCA,9,0,36,37,73,160,114,274,9,12,21,1,2:47
6162,448078,2016-07-02,2016,TBA,DET,2,3,3-2,DET,9,0,32,36,68,160,124,284,7,10,17,2,2:53
6163,448084,2016-07-02,2016,OAK,PIT,2,4,4-2,PIT,10,0,42,42,84,150,170,320,13,16,29,0,3:19
6164,448073,2016-07-02,2016,NYN,CHN,4,3,4-3,NYN,9,1,33,37,70,148,140,288,10,10,20,4,3:06
6165,448076,2016-07-02,2016,TOR,CLE,9,6,9-6,TOR,9,1,42,39,81,180,166,346,18,12,30,3,3:19
6166,448086,2016-07-02,2016,MIN,TEX,17,5,17-5,MIN,9,1,46,37,83,140,185,325,20,10,30,3,3:06
6167,448072,2016-07-02,2016,SEA,BAL,12,6,12-6,SEA,9,1,46,40,86,151,182,333,23,14,37,3,3:15
6168,448080,2016-07-02,2016,BOS,ANA,2,21,21-2,ANA,9,0,39,55,94,169,167,336,12,26,38,2,3:38
6169,448075,2016-07-02,2016,WAS,CIN,4,9,9-4,CIN,10,0,40,49,89,170,155,325,9,20,29,5,3:35
6170,448082,2016-07-02,2016,SLN,MIL,3,0,3-0,SLN,9,1,34,33,67,124,119,243,11,10,21,0,2:40 (1:32 delay)
6171,448096,2016-07-03,2016,ATL,MIA,2,5,5-2,MIA,9,0,37,42,79,150,134,284,10,16,26,2,2:59
6172,448098,2016-07-03,2016,SDN,NYA,3,6,6-3,NYA,9,0,35,42,77,142,143,285,9,16,25,2,3:12
6173,448090,2016-07-03,2016,WAS,CIN,12,1,12-1,WAS,9,1,44,34,78,153,163,316,21,7,28,3,3:08
6174,448089,2016-07-03,2016,HOU,CHA,1,4,4-1,CHA,9,0,33,41,74,162,126,288,6,14,20,2,2:58
6175,448094,2016-07-03,2016,PHI,KCA,7,2,7-2,PHI,9,1,35,36,71,139,122,261,12,10,22,1,2:42
6176,448095,2016-07-03,2016,BOS,ANA,10,5,10-5,BOS,9,1,43,38,81,151,183,334,21,15,36,3,3:52
6177,448087,2016-07-03,2016,SEA,BAL,9,4,9-4,SEA,9,1,38,40,78,127,152,279,13,13,26,4,2:53
6178,448092,2016-07-03,2016,LAN,COL,4,1,4-1,LAN,9,1,33,32,65,128,136,264,12,6,18,1,2:52
6179,448100,2016-07-03,2016,ARI,SFN,4,5,5-4,SFN,11,0,45,48,93,185,179,364,12,16,28,1,3:47
6180,448101,2016-07-03,2016,MIN,TEX,5,4,5-4,MIN,9,1,38,37,75,165,144,309,15,11,26,2,3:04
6181,448093,2016-07-03,2016,TBA,DET,1,5,5-1,DET,9,0,36,41,77,177,119,296,10,16,26,4,3:11
6182,448091,2016-07-03,2016,TOR,CLE,17,1,17-1,TOR,9,1,53,32,85,125,209,334,30,5,35,2,3:10
6183,448099,2016-07-03,2016,OAK,PIT,3,6,6-3,PIT,9,0,37,42,79,167,159,326,12,18,30,3,3:35
6184,448088,2016-07-03,2016,NYN,CHN,14,3,14-3,NYN,9,1,52,38,90,123,205,328,28,12,40,2,3:17
6185,448097,2016-07-03,2016,SLN,MIL,9,8,9-8,SLN,9,1,43,47,90,199,154,353,19,21,40,4,3:48 (2:15 delay)
6186,448107,2016-07-04,2016,TOR,KCA,6,2,6-2,TOR,9,1,34,32,66,105,128,233,12,5,17,1,2:10
6187,448102,2016-07-04,2016,PHI,ATL,8,2,8-2,PHI,9,1,37,37,74,125,117,242,13,9,22,1,2:27
6188,448108,2016-07-04,2016,TBA,ANA,4,2,4-2,TBA,9,1,32,40,72,154,141,295,9,12,21,2,3:12
6189,448103,2016-07-04,2016,LAN,BAL,7,5,7-5,LAN,9,1,38,37,75,140,157,297,15,10,25,2,3:12
6190,448110,2016-07-04,2016,WAS,MIL,0,1,1-0,MIL,9,0,32,36,68,157,136,293,6,8,14,1,3:01
6191,448115,2016-07-04,2016,HOU,SEA,2,1,2-1,HOU,9,1,34,31,65,116,115,231,13,6,19,2,2:26
6192,448109,2016-07-04,2016,NYN,MIA,8,6,8-6,NYN,9,1,40,43,83,162,171,333,19,19,38,2,3:38
6193,448116,2016-07-04,2016,BOS,TEX,12,5,12-5,BOS,9,1,48,41,89,163,190,353,25,16,41,2,3:40
6194,448105,2016-07-04,2016,SFN,COL,3,1,3-1,SFN,9,1,30,35,65,139,120,259,6,8,14,4,2:56
6195,448112,2016-07-04,2016,MIN,OAK,1,3,3-1,OAK,9,0,36,37,73,162,134,296,9,10,19,2,2:50
6196,448113,2016-07-04,2016,SLN,PIT,2,4,4-2,PIT,9,0,39,38,77,148,143,291,13,13,26,2,2:54 (1:26 delay)
6197,448106,2016-07-04,2016,CLE,DET,5,3,5-3,CLE,9,1,36,36,72,147,128,275,13,12,25,3,3:20 (2:21 delay)
6198,448111,2016-07-04,2016,CHA,NYA,8,2,8-2,CHA,9,1,42,40,82,150,147,297,16,10,26,2,3:06
6199,448114,2016-07-04,2016,ARI,SDN,4,8,8-4,SDN,9,0,39,40,79,177,143,320,11,15,26,3,3:25
6200,448104,2016-07-04,2016,CHN,CIN,10,4,10-4,CHN,9,1,46,37,83,146,178,324,21,10,31,2,3:01
6201,448117,2016-07-05,2016,PHI,ATL,5,1,5-1,PHI,9,1,34,29,63,92,126,218,11,6,17,1,2:08
6202,448130,2016-07-05,2016,HOU,SEA,5,2,5-2,HOU,9,1,33,35,68,148,117,265,9,8,17,0,2:34
6203,448118,2016-07-05,2016,LAN,BAL,1,4,4-1,BAL,9,0,34,39,73,164,130,294,8,14,22,1,3:17
6204,448126,2016-07-05,2016,CHA,NYA,0,9,9-0,NYA,9,0,33,50,83,179,117,296,7,23,30,2,3:07
6205,448120,2016-07-05,2016,SFN,COL,3,7,7-3,COL,9,0,39,45,84,180,159,339,11,18,29,5,3:34
6206,448122,2016-07-05,2016,TOR,KCA,8,3,8-3,TOR,9,1,37,35,72,140,148,288,15,10,25,1,2:32
6207,448128,2016-07-05,2016,SLN,PIT,2,5,5-2,PIT,9,0,37,38,75,131,158,289,10,11,21,0,3:07
6208,448121,2016-07-05,2016,CLE,DET,12,1,12-1,CLE,9,1,43,34,77,136,167,303,20,9,29,1,3:05
6209,448124,2016-07-05,2016,NYN,MIA,2,5,5-2,MIA,9,0,34,37,71,138,124,262,7,11,18,0,2:33
6210,448129,2016-07-05,2016,ARI,SDN,7,5,7-5,ARI,9,1,35,39,74,142,134,276,11,15,26,0,2:52
6211,448131,2016-07-05,2016,BOS,TEX,2,7,7-2,TEX,9,0,43,39,82,132,172,304,18,13,31,2,3:21
6212,448125,2016-07-05,2016,WAS,MIL,2,5,5-2,MIL,9,0,37,39,76,141,131,272,14,15,29,2,2:52
6213,448123,2016-07-05,2016,TBA,ANA,5,13,13-5,ANA,9,0,40,48,88,169,154,323,16,20,36,3,3:19
6214,448127,2016-07-05,2016,MIN,OAK,11,4,11-4,MIN,9,1,40,38,78,165,147,312,16,11,27,3,3:08 (2:42 delay)
6215,448119,2016-07-05,2016,CHN,CIN,5,9,9-5,CIN,9,0,40,43,83,167,152,319,13,17,30,0,3:08
6216,448141,2016-07-06,2016,CHA,NYA,5,0,5-0,CHA,9,1,31,35,66,132,129,261,10,9,19,1,2:54
6217,448132,2016-07-06,2016,PHI,ATL,4,3,4-3,PHI,9,1,35,38,73,129,132,261,14,9,23,3,2:54
6218,448136,2016-07-06,2016,CLE,DET,2,12,12-2,DET,9,0,36,41,77,165,138,303,11,14,25,2,3:13
6219,448142,2016-07-06,2016,MIN,OAK,4,0,4-0,MIN,9,1,40,28,68,100,165,265,16,2,18,2,2:44
6220,448137,2016-07-06,2016,TOR,KCA,4,2,4-2,TOR,9,1,33,31,64,99,138,237,9,5,14,0,2:16
6221,448144,2016-07-06,2016,ARI,SDN,6,13,13-6,SDN,9,0,43,44,87,144,167,311,17,17,34,2,3:10
6222,448138,2016-07-06,2016,TBA,ANA,2,7,7-2,ANA,9,0,37,40,77,158,158,316,11,14,25,1,3:18
6223,448143,2016-07-06,2016,SLN,PIT,5,7,7-5,PIT,9,0,39,42,81,168,151,319,13,15,28,1,3:21
6224,448145,2016-07-06,2016,HOU,SEA,9,8,9-8,HOU,9,1,41,42,83,177,176,353,17,17,34,3,3:32
6225,448135,2016-07-06,2016,SFN,COL,5,1,5-1,SFN,9,1,34,31,65,118,120,238,12,6,18,1,2:31
6226,448139,2016-07-06,2016,NYN,MIA,4,2,4-2,NYN,9,1,32,34,66,147,118,265,8,9,17,1,2:40
6227,448140,2016-07-06,2016,WAS,MIL,7,4,7-4,WAS,9,1,36,35,71,129,134,263,14,9,23,2,2:47
6228,448134,2016-07-06,2016,CHN,CIN,3,5,5-3,CIN,9,0,35,37,72,182,138,320,10,11,21,0,2:56
6229,448146,2016-07-06,2016,BOS,TEX,11,6,11-6,BOS,9,1,41,42,83,167,151,318,15,15,30,3,3:19
6230,448133,2016-07-06,2016,LAN,BAL,4,6,6-4,BAL,14,0,62,61,123,277,249,526,26,22,48,2,5:26
6231,447214,2016-07-07,2016,CHN,ATL,3,4,4-3,ATL,11,0,44,44,88,189,178,367,14,10,24,6,3:54 (1:35 delay)
6232,448155,2016-07-07,2016,KCA,SEA,4,3,4-3,KCA,9,0,32,37,69,153,91,244,11,11,22,1,2:37
6233,448151,2016-07-07,2016,HOU,OAK,1,3,3-1,OAK,9,0,32,36,68,131,133,264,5,10,15,1,2:32
6234,448154,2016-07-07,2016,LAN,SDN,0,6,6-0,SDN,9,0,34,40,74,149,135,284,7,14,21,1,2:45
6235,448152,2016-07-07,2016,COL,PHI,11,2,11-2,COL,9,1,39,37,76,137,145,282,15,11,26,2,2:53
6236,448156,2016-07-07,2016,NYN,WAS,9,7,9-7,NYN,9,1,47,40,87,152,181,333,25,14,39,6,3:39
6237,448149,2016-07-07,2016,TEX,MIN,1,10,10-1,MIN,9,0,36,52,88,215,157,372,10,25,35,1,3:37
6238,448153,2016-07-07,2016,SLN,PIT,5,1,5-1,SLN,9,1,31,34,65,139,115,254,8,7,15,2,2:42 (:31 delay)
6239,447214,2016-07-07,2016,CHN,ATL,3,4,4-3,ATL,11,0,44,44,88,189,178,367,14,10,24,6,3:54 (1:35 delay)
6240,448148,2016-07-07,2016,TBA,ANA,1,5,5-1,ANA,9,0,36,38,74,145,149,294,9,12,21,2,3:01
6241,448147,2016-07-07,2016,TOR,DET,5,4,5-4,TOR,9,1,43,36,79,133,156,289,18,11,29,3,3:18
6242,448150,2016-07-07,2016,CLE,NYA,4,5,5-4,NYA,9,0,35,41,76,143,144,287,8,15,23,2,3:00
6243,448160,2016-07-08,2016,MIA,CIN,3,1,3-1,MIA,9,1,31,32,63,119,118,237,9,7,16,0,2:16
6244,448171,2016-07-08,2016,NYN,WAS,1,3,3-1,WAS,9,0,33,35,68,157,132,289,7,9,16,4,3:17 (:37 delay)
6245,448161,2016-07-08,2016,TOR,DET,6,0,6-0,TOR,9,1,38,35,73,146,158,304,17,8,25,2,3:07
6246,448170,2016-07-08,2016,BOS,TBA,6,5,6-5,BOS,9,1,36,40,76,158,151,309,13,13,26,2,3:20
6247,448163,2016-07-08,2016,TEX,MIN,6,5,6-5,TEX,9,1,36,38,74,164,144,308,13,13,26,2,3:14
6248,448165,2016-07-08,2016,HOU,OAK,10,9,10-9,HOU,9,0,41,40,81,160,164,324,16,16,32,3,3:29
6249,448158,2016-07-08,2016,CHA,ATL,8,11,11-8,ATL,9,0,43,45,88,160,169,329,16,21,37,2,3:17
6250,448168,2016-07-08,2016,KCA,SEA,2,3,3-2,SEA,9,0,34,34,68,123,125,248,9,8,17,2,2:41
6251,448162,2016-07-08,2016,BAL,ANA,5,9,9-5,ANA,9,0,42,44,86,150,155,305,14,17,31,2,3:27
6252,448157,2016-07-08,2016,SFN,ARI,6,2,6-2,SFN,9,1,40,37,77,158,157,315,15,11,26,3,3:27
6253,448159,2016-07-08,2016,PIT,CHN,8,4,8-4,PIT,9,1,41,40,81,164,139,303,16,14,30,4,3:23
6254,448167,2016-07-08,2016,LAN,SDN,10,6,10-6,LAN,9,1,43,43,86,177,162,339,22,17,39,3,3:45
6255,448164,2016-07-08,2016,CLE,NYA,10,2,10-2,CLE,9,1,36,33,69,112,160,272,12,7,19,1,2:36
6256,448169,2016-07-08,2016,MIL,SLN,4,3,4-3,MIL,9,0,37,41,78,145,134,279,10,14,24,3,3:05
6257,448166,2016-07-08,2016,COL,PHI,3,5,5-3,PHI,9,0,41,39,80,143,173,316,16,11,27,4,3:36
6258,448182,2016-07-09,2016,LAN,SDN,4,3,4-3,LAN,9,1,34,33,67,130,110,240,11,6,17,2,2:45
6259,448185,2016-07-09,2016,BOS,TBA,4,1,4-1,BOS,9,1,36,33,69,125,139,264,13,7,20,0,2:43
6260,448180,2016-07-09,2016,HOU,OAK,2,3,3-2,OAK,9,0,32,40,72,165,113,278,6,15,21,3,2:52
6261,448173,2016-07-09,2016,CHA,ATL,5,4,5-4,CHA,9,1,34,37,71,145,124,269,12,13,25,2,2:48
6262,448176,2016-07-09,2016,TOR,DET,2,3,3-2,DET,9,0,35,36,71,147,143,290,8,10,18,0,2:47
6263,448183,2016-07-09,2016,KCA,SEA,5,3,5-3,KCA,9,1,37,36,73,147,125,272,14,11,25,2,2:53
6264,448175,2016-07-09,2016,MIA,CIN,4,2,4-2,MIA,9,1,33,36,69,155,139,294,10,10,20,2,2:48
6265,448181,2016-07-09,2016,COL,PHI,8,3,8-3,COL,9,1,36,39,75,138,129,267,13,13,26,1,2:45
6266,448172,2016-07-09,2016,SFN,ARI,4,2,4-2,SFN,9,1,34,38,72,141,131,272,12,10,22,5,3:03
6267,448177,2016-07-09,2016,BAL,ANA,3,2,3-2,BAL,9,1,34,36,70,151,133,284,12,13,25,3,3:14
6268,448184,2016-07-09,2016,MIL,SLN,1,8,8-1,SLN,9,0,36,43,79,186,152,338,11,17,28,2,3:26 (:09 delay)
6269,448178,2016-07-09,2016,TEX,MIN,6,8,8-6,MIN,9,0,40,44,84,189,157,346,15,18,33,1,3:20 (1:10 delay)
6270,448174,2016-07-09,2016,PIT,CHN,12,6,12-6,PIT,9,1,39,44,83,177,174,351,17,18,35,2,3:31
6271,448179,2016-07-09,2016,CLE,NYA,6,7,7-6,NYA,11,0,49,51,100,218,177,395,17,20,37,4,4:18
6272,448186,2016-07-09,2016,NYN,WAS,1,6,6-1,WAS,9,0,35,40,75,148,148,296,8,14,22,1,3:13
6273,448197,2016-07-10,2016,LAN,SDN,3,1,3-1,LAN,9,1,35,31,66,139,130,269,12,4,16,1,2:49
6274,448196,2016-07-10,2016,COL,PHI,3,10,10-3,PHI,9,0,38,44,82,176,151,327,12,18,30,1,3:11
6275,448201,2016-07-10,2016,NYN,WAS,2,3,3-2,WAS,9,0,35,35,70,121,146,267,9,10,19,2,2:41
6276,448189,2016-07-10,2016,PIT,CHN,5,6,6-5,CHN,9,0,37,42,79,141,152,293,10,17,27,3,2:58
6277,448191,2016-07-10,2016,TOR,DET,6,1,6-1,TOR,9,1,41,36,77,119,170,289,19,9,28,3,2:49
6278,448195,2016-07-10,2016,HOU,OAK,2,1,2-1,HOU,10,0,40,35,75,132,158,290,10,6,16,0,3:05
6279,448199,2016-07-10,2016,MIL,SLN,1,5,5-1,SLN,9,0,32,43,75,171,127,298,6,16,22,1,3:00
6280,448192,2016-07-10,2016,BAL,ANA,4,2,4-2,BAL,9,1,39,37,76,145,157,302,17,11,28,2,3:13
6281,448198,2016-07-10,2016,KCA,SEA,5,8,8-5,SEA,9,0,38,44,82,181,134,315,13,18,31,3,3:03
6282,448194,2016-07-10,2016,CLE,NYA,7,11,11-7,NYA,9,0,43,47,90,182,155,337,16,17,33,5,3:35
6283,448193,2016-07-10,2016,TEX,MIN,5,15,15-5,MIN,9,0,39,47,86,183,150,333,15,21,36,2,3:13
6284,448187,2016-07-10,2016,SFN,ARI,4,0,4-0,SFN,9,1,37,28,65,117,155,272,14,2,16,0,2:54
6285,448188,2016-07-10,2016,CHA,ATL,0,2,2-0,ATL,9,0,31,35,66,114,120,234,6,9,15,2,2:22
6286,448200,2016-07-10,2016,BOS,TBA,4,0,4-0,BOS,9,1,33,32,65,121,134,255,9,7,16,1,2:31
6287,448190,2016-07-10,2016,MIA,CIN,7,3,7-3,MIA,9,1,40,36,76,134,174,308,16,10,26,2,3:04
6288,448202,2016-07-12,2016,AAS,NAS,4,2,4-2,AAS,9,1,35,39,74,148,131,279,11,12,23,4,3:05
6289,448214,2016-07-15,2016,WAS,PIT,5,1,5-1,WAS,9,1,35,32,67,125,131,256,12,6,18,2,2:43
6290,448215,2016-07-15,2016,SDN,SFN,4,1,4-1,SDN,9,1,32,31,63,124,130,254,9,6,15,0,2:39
6291,448204,2016-07-15,2016,NYA,BOS,3,5,5-3,BOS,9,0,33,39,72,167,112,279,6,12,18,3,3:05
6292,448213,2016-07-15,2016,PHI,NYN,3,5,5-3,NYN,9,0,35,38,73,148,124,272,7,11,18,5,3:10
6293,448212,2016-07-15,2016,CIN,MIL,5,4,5-4,CIN,9,1,35,39,74,158,132,290,12,12,24,2,3:14
6294,448205,2016-07-15,2016,ANA,CHA,7,0,7-0,ANA,9,1,34,33,67,120,133,253,11,7,18,3,2:39
6295,448206,2016-07-15,2016,MIN,CLE,2,5,5-2,CLE,9,0,32,37,69,157,136,293,6,11,17,2,2:54
6296,448208,2016-07-15,2016,SEA,HOU,3,7,7-3,HOU,9,0,37,36,73,134,162,296,11,13,24,1,2:54
6297,448211,2016-07-15,2016,SLN,MIA,6,7,7-6,MIA,9,0,39,44,83,164,148,312,12,19,31,3,3:24
6298,448207,2016-07-15,2016,ATL,COL,2,11,11-2,COL,9,0,37,44,81,195,138,333,13,16,29,5,3:28
6299,448217,2016-07-15,2016,OAK,TOR,8,7,8-7,OAK,9,1,37,41,78,168,141,309,15,15,30,4,3:09
6300,448210,2016-07-15,2016,ARI,LAN,7,13,13-7,LAN,9,0,39,51,90,189,166,355,12,24,36,3,3:51
6301,448216,2016-07-15,2016,CHN,TEX,6,0,6-0,CHN,9,1,37,34,71,136,140,276,12,8,20,2,2:44
6302,448209,2016-07-15,2016,DET,KCA,4,2,4-2,DET,9,1,35,35,70,135,153,288,11,8,19,2,2:57
6303,448203,2016-07-15,2016,TBA,BAL,3,4,4-3,BAL,9,0,41,35,76,126,170,296,17,8,25,1,3:00
6304,448220,2016-07-16,2016,ANA,CHA,1,0,1-0,ANA,9,1,27,33,60,115,91,206,4,6,10,0,2:20
6305,448218,2016-07-16,2016,TBA,BAL,1,2,2-1,BAL,9,0,33,35,68,114,117,231,7,10,17,3,2:33
6306,448223,2016-07-16,2016,SEA,HOU,1,0,1-0,SEA,9,1,30,32,62,124,127,251,9,5,14,2,2:46
6307,448219,2016-07-16,2016,NYA,BOS,2,5,5-2,BOS,9,0,33,41,74,140,120,260,7,14,21,1,2:56
6308,448228,2016-07-16,2016,PHI,NYN,4,2,4-2,PHI,9,1,37,36,73,132,143,275,13,9,22,3,3:11
6309,448229,2016-07-16,2016,WAS,PIT,6,0,6-0,WAS,9,1,36,33,69,120,136,256,14,8,22,1,2:36 (1:11 delay)
6310,448231,2016-07-16,2016,CHN,TEX,3,1,3-1,CHN,9,1,35,30,65,128,148,276,10,5,15,3,2:47
6311,448225,2016-07-16,2016,ARI,LAN,2,1,2-1,ARI,12,0,43,52,95,199,176,375,15,19,34,2,4:31
6312,448232,2016-07-16,2016,OAK,TOR,5,4,5-4,OAK,9,1,34,37,71,150,128,278,12,11,23,2,2:41
6313,448222,2016-07-16,2016,ATL,COL,3,4,4-3,COL,9,0,37,37,74,152,152,304,11,11,22,4,3:02
6314,448227,2016-07-16,2016,CIN,MIL,1,9,9-1,MIL,9,0,39,43,82,173,127,300,13,17,30,1,3:03
6315,448224,2016-07-16,2016,DET,KCA,4,8,8-4,KCA,9,0,34,44,78,174,135,309,9,19,28,4,3:16
6316,448221,2016-07-16,2016,MIN,CLE,5,4,5-4,MIN,11,0,50,45,95,168,202,370,18,13,31,4,3:50 (2:05 delay)
6317,448226,2016-07-16,2016,SLN,MIA,5,0,5-0,SLN,9,1,36,31,67,120,150,270,12,5,17,0,2:39
6318,448230,2016-07-16,2016,SDN,SFN,7,6,7-6,SDN,10,0,43,44,87,182,179,361,19,15,34,2,4:05
6319,448246,2016-07-17,2016,CHN,TEX,1,4,4-1,TEX,9,0,31,35,66,127,107,234,4,8,12,0,2:17
6320,448243,2016-07-17,2016,PHI,NYN,0,5,5-0,NYN,9,0,28,37,65,148,105,253,2,10,12,0,2:21
6321,448242,2016-07-17,2016,CIN,MIL,1,0,1-0,CIN,9,0,30,33,63,127,128,255,6,6,12,1,2:34
6322,448233,2016-07-17,2016,TBA,BAL,5,2,5-2,TBA,9,1,33,36,69,144,117,261,10,9,19,2,2:32
6323,448234,2016-07-17,2016,NYA,BOS,3,1,3-1,NYA,9,1,38,32,70,129,135,264,14,6,20,3,2:57
6324,448235,2016-07-17,2016,ANA,CHA,8,1,8-1,ANA,9,1,37,33,70,128,134,262,15,8,23,1,2:40
6325,448237,2016-07-17,2016,ATL,COL,1,0,1-0,ATL,9,0,38,33,71,132,154,286,14,9,23,3,3:22
6326,448236,2016-07-17,2016,MIN,CLE,1,6,6-1,CLE,9,0,35,40,75,153,123,276,8,16,24,1,2:46
6327,448245,2016-07-17,2016,SDN,SFN,5,3,5-3,SDN,9,1,37,37,74,136,160,296,13,9,22,4,3:25
6328,448247,2016-07-17,2016,OAK,TOR,3,5,5-3,TOR,9,0,36,41,77,157,137,294,10,15,25,3,3:12
6329,448238,2016-07-17,2016,SEA,HOU,1,8,8-1,HOU,9,0,38,44,82,142,142,284,16,17,33,1,2:55
6330,448240,2016-07-17,2016,ARI,LAN,6,5,6-5,ARI,9,1,35,42,77,152,133,285,13,16,29,2,3:14
6331,448241,2016-07-17,2016,SLN,MIA,3,6,6-3,MIA,9,0,34,44,78,166,142,308,7,19,26,2,3:03
6332,448239,2016-07-17,2016,DET,KCA,4,2,4-2,DET,9,0,35,34,69,109,125,234,12,7,19,0,2:22
6333,448244,2016-07-17,2016,WAS,PIT,1,2,2-1,PIT,18,0,62,68,130,266,275,541,13,18,31,1,5:48
6334,448254,2016-07-18,2016,DET,MIN,1,0,1-0,DET,9,1,28,31,59,140,119,259,6,6,12,0,2:26
6335,448250,2016-07-18,2016,SEA,CHA,4,3,4-3,SEA,9,0,34,37,71,130,122,252,10,12,22,0,2:21
6336,448249,2016-07-18,2016,NYA,BAL,2,1,2-1,NYA,9,1,32,36,68,147,127,274,9,11,20,2,2:57
6337,448251,2016-07-18,2016,KCA,CLE,7,3,7-3,KCA,9,1,37,36,73,141,128,269,17,11,28,2,2:51
6338,448255,2016-07-18,2016,CHN,NYN,5,1,5-1,CHN,9,1,35,35,70,124,150,274,12,10,22,3,2:56
6339,448252,2016-07-18,2016,OAK,HOU,7,4,7-4,OAK,9,1,40,38,78,147,151,298,17,11,28,1,3:06
6340,448253,2016-07-18,2016,PHI,MIA,2,3,3-2,MIA,11,0,39,41,80,142,159,301,7,10,17,1,3:05
6341,448257,2016-07-18,2016,COL,TBA,7,4,7-4,COL,9,1,37,37,74,145,146,291,16,11,27,1,3:12 (:32 delay)
6342,448256,2016-07-18,2016,SLN,SDN,10,2,10-2,SLN,9,1,41,35,76,129,164,293,18,8,26,1,2:55
6343,448248,2016-07-18,2016,CIN,ATL,8,2,8-2,CIN,9,1,38,37,75,150,150,300,15,11,26,2,3:11
6344,448258,2016-07-18,2016,ANA,TEX,9,5,9-5,ANA,9,1,37,38,75,148,134,282,14,12,26,2,3:03
6345,448262,2016-07-19,2016,KCA,CLE,3,7,7-3,CLE,9,0,36,40,76,138,129,267,9,14,23,3,2:46
6346,448260,2016-07-19,2016,NYA,BAL,7,1,7-1,NYA,9,1,36,32,68,122,160,282,15,6,21,2,2:51
6347,448272,2016-07-19,2016,ANA,TEX,8,6,8-6,ANA,9,1,36,42,78,148,126,274,15,15,30,1,3:01
6348,448273,2016-07-19,2016,ARI,TOR,1,5,5-1,TOR,9,0,34,38,72,162,122,284,9,11,20,0,2:58
6349,448263,2016-07-19,2016,OAK,HOU,4,3,4-3,OAK,10,0,43,42,85,159,200,359,17,12,29,5,3:41
6350,448270,2016-07-19,2016,BOS,SFN,4,0,4-0,BOS,9,1,30,32,62,145,122,267,5,8,13,3,2:42
6351,448266,2016-07-19,2016,PIT,MIL,3,2,3-2,PIT,9,0,34,35,69,119,146,265,9,9,18,0,2:49
6352,448271,2016-07-19,2016,COL,TBA,1,10,10-1,TBA,9,0,33,42,75,143,144,287,7,17,24,1,2:54 (2:01 delay)
6353,448267,2016-07-19,2016,DET,MIN,2,6,6-2,MIN,9,0,36,38,74,153,125,278,8,12,20,3,2:55
6354,448264,2016-07-19,2016,WAS,LAN,4,8,8-4,LAN,9,0,36,43,79,164,128,292,9,17,26,2,3:14
6355,448261,2016-07-19,2016,SEA,CHA,1,6,6-1,CHA,9,0,36,38,74,160,150,310,10,15,25,3,3:00
6356,448265,2016-07-19,2016,PHI,MIA,1,2,2-1,MIA,10,0,39,40,79,164,171,335,10,12,22,2,3:26
6357,448259,2016-07-19,2016,CIN,ATL,4,5,5-4,ATL,11,0,46,43,89,154,180,334,17,13,30,4,3:38
6358,448268,2016-07-19,2016,CHN,NYN,1,2,2-1,NYN,9,0,38,36,74,115,152,267,13,9,22,1,3:04
6359,448284,2016-07-20,2016,SLN,SDN,3,2,3-2,SLN,9,1,34,36,70,133,128,261,10,9,19,2,3:03
6360,448282,2016-07-20,2016,DET,MIN,1,4,4-1,MIN,9,0,36,35,71,142,149,291,10,7,17,2,3:05
6361,448277,2016-07-20,2016,KCA,CLE,4,11,11-4,CLE,9,0,36,46,82,206,134,340,9,19,28,3,3:16
6362,448280,2016-07-20,2016,PHI,MIA,4,1,4-1,PHI,9,1,36,31,67,112,129,241,12,5,17,1,2:37
6363,448275,2016-07-20,2016,NYA,BAL,5,0,5-0,NYA,9,1,33,34,67,151,97,248,10,7,17,1,2:40
6364,448274,2016-07-20,2016,CIN,ATL,6,3,6-3,CIN,9,1,38,35,73,126,129,255,16,9,25,0,2:33
6365,448283,2016-07-20,2016,CHN,NYN,6,2,6-2,CHN,9,1,38,35,73,124,140,264,14,11,25,3,2:49
6366,448288,2016-07-20,2016,ARI,TOR,4,10,10-4,TOR,9,0,36,44,80,145,118,263,11,16,27,3,2:52
6367,448279,2016-07-20,2016,WAS,LAN,8,1,8-1,WAS,9,1,35,32,67,130,149,279,11,6,17,2,2:57
6368,448287,2016-07-20,2016,ANA,TEX,7,4,7-4,ANA,9,1,37,41,78,158,110,268,15,14,29,1,2:52
6369,448278,2016-07-20,2016,OAK,HOU,0,7,7-0,HOU,9,0,33,47,80,189,127,316,6,19,25,0,3:06
6370,448285,2016-07-20,2016,BOS,SFN,11,7,11-7,BOS,9,1,43,45,88,181,158,339,19,19,38,6,3:46
6371,448281,2016-07-20,2016,PIT,MIL,5,9,9-5,MIL,9,0,39,45,84,188,161,349,13,21,34,2,3:43
6372,448269,2016-07-20,2016,SLN,SDN,4,2,4-2,SLN,9,1,33,32,65,117,128,245,12,6,18,0,2:32
6373,448269,2016-07-20,2016,SLN,SDN,4,2,4-2,SLN,9,1,33,32,65,117,128,245,12,6,18,0,2:32
6374,448286,2016-07-20,2016,COL,TBA,3,11,11-3,TBA,9,0,39,48,87,174,152,326,11,22,33,1,3:27
6375,448276,2016-07-20,2016,SEA,CHA,6,5,6-5,SEA,11,0,43,47,90,158,154,312,15,14,29,2,3:12
6376,448291,2016-07-21,2016,CHA,DET,1,2,2-1,DET,7,1,26,29,55,117,95,212,10,9,19,1,2:08 (2:05 delay)
6377,448297,2016-07-21,2016,OAK,TBA,3,7,7-3,TBA,9,0,35,36,71,148,132,280,8,10,18,2,2:46
6378,448290,2016-07-21,2016,NYA,BAL,1,4,4-1,BAL,9,0,32,38,70,147,130,277,7,10,17,1,2:52
6379,448293,2016-07-21,2016,PHI,MIA,3,9,9-3,MIA,9,0,32,44,76,168,126,294,4,17,21,0,2:57
6380,448295,2016-07-21,2016,BOS,MIN,13,2,13-2,BOS,9,1,41,33,74,125,155,280,19,6,25,3,2:45
6381,448289,2016-07-21,2016,COL,ATL,7,3,7-3,COL,9,1,38,37,75,140,154,294,15,11,26,4,3:04
6382,448292,2016-07-21,2016,WAS,LAN,3,6,6-3,LAN,9,0,42,36,78,142,190,332,15,9,24,4,3:35
6383,448296,2016-07-21,2016,SLN,SDN,6,5,6-5,SLN,9,0,38,38,76,168,144,312,15,12,27,2,3:18
6384,448294,2016-07-21,2016,PIT,MIL,5,3,5-3,PIT,9,1,36,33,69,136,125,261,14,5,19,1,2:47
6385,448311,2016-07-22,2016,TOR,SEA,1,2,2-1,SEA,9,0,32,39,71,134,134,268,6,12,18,1,2:41
6386,448304,2016-07-22,2016,HOU,ANA,2,1,2-1,HOU,9,1,33,34,67,132,125,257,10,9,19,2,3:02
6387,448306,2016-07-22,2016,BOS,MIN,1,2,2-1,MIN,9,0,32,36,68,146,120,266,6,12,18,2,3:00
6388,448309,2016-07-22,2016,WAS,SDN,3,5,5-3,SDN,9,0,37,37,74,143,135,278,9,11,20,2,2:58
6389,448301,2016-07-22,2016,MIL,CHN,2,5,5-2,CHN,9,0,35,39,74,136,145,281,8,13,21,2,3:07
6390,448299,2016-07-22,2016,CIN,ARI,6,2,6-2,CIN,9,1,40,36,76,136,179,315,20,11,31,1,3:15
6391,448308,2016-07-22,2016,PIT,PHI,0,4,4-0,PHI,9,0,29,42,71,144,100,244,4,16,20,2,2:38
6392,448303,2016-07-22,2016,CHA,DET,5,7,7-5,DET,9,0,39,47,86,203,152,355,12,22,34,4,3:35
6393,448313,2016-07-22,2016,KCA,TEX,3,1,3-1,KCA,9,1,33,34,67,133,121,254,10,8,18,1,2:44
6394,448302,2016-07-22,2016,BAL,CLE,5,1,5-1,BAL,9,1,36,36,72,153,125,278,14,10,24,3,2:52
6395,448300,2016-07-22,2016,COL,ATL,4,3,4-3,COL,9,1,33,37,70,153,141,294,11,12,23,3,3:18
6396,448310,2016-07-22,2016,NYA,SFN,3,2,3-2,NYA,9,1,36,39,75,153,141,294,12,12,24,1,3:17
6397,448312,2016-07-22,2016,OAK,TBA,1,0,1-0,OAK,13,0,46,47,93,174,168,342,12,9,21,3,3:31
6398,448305,2016-07-22,2016,SLN,LAN,4,3,4-3,SLN,16,0,59,64,123,220,224,444,15,17,32,2,5:10
6399,448307,2016-07-22,2016,MIA,NYN,3,5,5-3,NYN,9,0,35,41,76,157,142,299,9,15,24,2,3:07
6400,448327,2016-07-23,2016,OAK,TBA,4,3,4-3,OAK,9,0,35,35,70,102,130,232,10,10,20,0,2:22
6401,448316,2016-07-23,2016,MIL,CHN,6,1,6-1,MIL,9,1,34,34,68,135,151,286,12,8,20,3,2:56
6402,448315,2016-07-23,2016,COL,ATL,8,4,8-4,COL,9,1,37,38,75,139,138,277,13,12,25,3,3:02 (:47 delay)
6403,448318,2016-07-23,2016,CHA,DET,4,3,4-3,CHA,9,0,37,38,75,147,148,295,11,12,23,2,3:15 (2:10 delay)
6404,448318,2016-07-23,2016,CHA,DET,4,3,4-3,CHA,9,0,37,38,75,147,148,295,11,12,23,2,3:15 (2:10 delay)
6405,448320,2016-07-23,2016,SLN,LAN,2,7,7-2,LAN,9,0,32,39,71,141,127,268,6,14,20,1,2:56
6406,448317,2016-07-23,2016,BAL,CLE,5,2,5-2,BAL,9,1,33,34,67,152,129,281,10,10,20,2,2:52 (:14 delay)
6407,448324,2016-07-23,2016,WAS,SDN,3,2,3-2,WAS,9,0,36,34,70,133,137,270,12,8,20,0,3:01
6408,448321,2016-07-23,2016,BOS,MIN,9,11,11-9,MIN,9,0,48,48,96,193,196,389,23,23,46,7,4:11
6409,448323,2016-07-23,2016,PIT,PHI,7,4,7-4,PIT,9,1,35,45,80,177,128,305,11,17,28,3,3:35
6410,448322,2016-07-23,2016,MIA,NYN,7,2,7-2,MIA,9,1,42,40,82,145,164,309,19,13,32,2,3:09
6411,448328,2016-07-23,2016,KCA,TEX,4,7,7-4,TEX,9,0,41,40,81,153,166,319,14,14,28,2,3:14
6412,448326,2016-07-23,2016,TOR,SEA,5,14,14-5,SEA,9,0,38,47,85,185,137,322,11,24,35,2,3:18
6413,448325,2016-07-23,2016,NYA,SFN,1,2,2-1,SFN,12,0,48,46,94,176,215,391,14,12,26,4,4:25
6414,448314,2016-07-23,2016,CIN,ARI,6,1,6-1,CIN,9,1,35,34,69,144,150,294,11,7,18,1,3:00
6415,448319,2016-07-23,2016,HOU,ANA,7,2,7-2,HOU,9,1,38,34,72,144,150,294,16,8,24,0,2:53
6416,448332,2016-07-24,2016,BAL,CLE,5,3,5-3,BAL,9,0,36,36,72,135,135,270,10,10,20,0,2:46
6417,448340,2016-07-24,2016,NYA,SFN,5,2,5-2,NYA,9,1,31,39,70,164,115,279,9,13,22,3,3:06
6418,448337,2016-07-24,2016,MIA,NYN,0,3,3-0,NYN,9,0,35,37,72,146,131,277,8,9,17,2,2:50
6419,448339,2016-07-24,2016,WAS,SDN,6,10,10-6,SDN,9,0,37,44,81,176,143,319,12,18,30,3,3:32
6420,448329,2016-07-24,2016,CIN,ARI,8,9,9-8,ARI,9,0,44,42,86,152,165,317,18,16,34,1,3:32
6421,448335,2016-07-24,2016,SLN,LAN,6,9,9-6,LAN,9,0,37,46,83,199,177,376,10,21,31,3,3:49
6422,448341,2016-07-24,2016,TOR,SEA,2,0,2-0,TOR,9,1,29,32,61,148,114,262,6,7,13,0,2:21
6423,448331,2016-07-24,2016,MIL,CHN,5,6,6-5,CHN,9,0,44,39,83,159,194,353,17,18,35,4,4:08
6424,448342,2016-07-24,2016,OAK,TBA,3,2,3-2,OAK,9,1,36,32,68,112,114,226,12,6,18,2,2:21
6425,448343,2016-07-24,2016,KCA,TEX,1,2,2-1,TEX,9,0,35,38,73,140,145,285,9,14,23,0,3:03
6426,448338,2016-07-24,2016,PIT,PHI,5,4,5-4,PIT,9,1,34,37,71,141,140,281,13,11,24,1,3:08 (1:32 delay)
6427,448330,2016-07-24,2016,COL,ATL,7,2,7-2,COL,9,1,39,39,78,157,148,305,16,14,30,1,2:56
6428,448333,2016-07-24,2016,CHA,DET,5,4,5-4,CHA,9,0,39,37,76,167,138,305,15,10,25,2,3:00
6429,448336,2016-07-24,2016,BOS,MIN,8,7,8-7,BOS,9,1,35,39,74,149,146,295,11,11,22,3,3:15
6430,448334,2016-07-24,2016,HOU,ANA,13,3,13-3,HOU,9,1,42,37,79,122,160,282,19,11,30,1,3:00
6431,448353,2016-07-25,2016,TOR,SDN,4,2,4-2,TOR,9,1,35,34,69,132,126,258,13,8,21,1,2:41
6432,448347,2016-07-25,2016,BAL,COL,3,2,3-2,BAL,10,0,39,36,75,152,145,297,10,9,19,3,3:14
6433,448352,2016-07-25,2016,MIA,PHI,0,4,4-0,PHI,9,0,30,42,72,186,106,292,3,16,19,1,3:03
6434,448348,2016-07-25,2016,BOS,DET,2,4,4-2,DET,9,0,40,36,76,140,175,315,13,10,23,1,3:27
6435,448350,2016-07-25,2016,HOU,NYA,1,2,2-1,NYA,9,0,35,33,68,117,136,253,8,7,15,1,2:41
6436,448351,2016-07-25,2016,TEX,OAK,7,6,7-6,TEX,9,0,40,39,79,123,149,272,14,14,28,1,2:58
6437,448345,2016-07-25,2016,CHA,CHN,5,4,5-4,CHA,9,0,36,42,78,162,146,308,11,16,27,4,3:23
6438,448349,2016-07-25,2016,KCA,ANA,2,6,6-2,ANA,9,0,35,41,76,162,144,306,9,15,24,2,3:05
6439,448344,2016-07-25,2016,MIL,ARI,7,2,7-2,MIL,9,1,38,39,77,155,152,307,16,12,28,1,3:09
6440,448346,2016-07-25,2016,SFN,CIN,5,7,7-5,CIN,9,0,36,39,75,147,149,296,10,12,22,3,3:05
6441,448367,2016-07-26,2016,NYN,SLN,2,3,3-2,SLN,9,0,40,36,76,159,164,323,13,11,24,1,3:18
6442,448354,2016-07-26,2016,NYN,SLN,3,1,3-1,NYN,9,1,34,30,64,117,130,247,10,4,14,0,2:33
6443,448356,2016-07-26,2016,MIN,ATL,0,2,2-0,ATL,9,0,34,33,67,97,142,239,8,7,15,1,2:23
6444,448359,2016-07-26,2016,BAL,COL,3,6,6-3,COL,9,0,35,35,70,129,143,272,9,9,18,1,2:44
6445,448364,2016-07-26,2016,MIA,PHI,5,0,5-0,MIA,9,1,37,31,68,123,132,255,14,5,19,1,2:41
6446,448354,2016-07-26,2016,NYN,SLN,3,1,3-1,NYN,9,1,34,30,64,117,130,247,10,4,14,0,2:33
6447,448368,2016-07-26,2016,LAN,TBA,3,2,3-2,LAN,9,1,31,38,69,161,97,258,5,13,18,3,2:55
6448,448357,2016-07-26,2016,CHA,CHN,3,0,3-0,CHA,9,1,34,35,69,136,150,286,11,8,19,2,2:55
6449,448365,2016-07-26,2016,TOR,SDN,7,6,7-6,TOR,12,0,47,49,96,168,219,387,16,13,29,3,3:58
6450,448363,2016-07-26,2016,TEX,OAK,3,6,6-3,OAK,9,0,35,38,73,147,148,295,9,13,22,3,3:01 (1:02 delay)
6451,448369,2016-07-26,2016,CLE,WAS,7,6,7-6,CLE,9,0,39,39,78,168,144,312,16,13,29,5,3:17
6452,448362,2016-07-26,2016,HOU,NYA,3,6,6-3,NYA,9,0,38,43,81,148,155,303,11,18,29,3,3:03
6453,448355,2016-07-26,2016,MIL,ARI,9,4,9-4,MIL,9,1,38,40,78,146,156,302,18,12,30,4,3:35
6454,448361,2016-07-26,2016,KCA,ANA,0,13,13-0,ANA,9,0,30,54,84,190,115,305,4,27,31,3,3:04
6455,448360,2016-07-26,2016,BOS,DET,8,9,9-8,DET,9,0,40,45,85,152,165,317,14,20,34,3,3:33
6456,448366,2016-07-26,2016,PIT,SEA,4,7,7-4,SEA,9,0,40,41,81,146,157,303,16,15,31,2,3:08
6457,448358,2016-07-26,2016,SFN,CIN,9,7,9-7,SFN,9,1,43,40,83,158,167,325,21,13,34,2,3:20
6458,448377,2016-07-27,2016,HOU,NYA,4,1,4-1,HOU,9,1,33,34,67,128,129,257,11,7,18,0,2:38
6459,448372,2016-07-27,2016,CHN,CHA,8,1,8-1,CHN,9,1,37,33,70,125,152,277,13,7,20,3,2:51
6460,448376,2016-07-27,2016,KCA,ANA,7,5,7-5,KCA,9,1,36,43,79,157,99,256,12,17,29,2,3:15
6461,448375,2016-07-27,2016,BOS,DET,3,4,4-3,DET,9,0,32,41,73,151,123,274,7,16,23,2,2:55
6462,448370,2016-07-27,2016,MIL,ARI,1,8,8-1,ARI,9,0,33,42,75,154,127,281,8,13,21,1,2:56
6463,448379,2016-07-27,2016,MIA,PHI,11,1,11-1,MIA,9,1,44,38,82,132,161,293,23,13,36,3,2:57
6464,448373,2016-07-27,2016,SFN,CIN,1,2,2-1,CIN,9,0,32,33,65,118,108,226,5,6,11,2,2:23
6465,448374,2016-07-27,2016,BAL,COL,1,3,3-1,COL,9,0,34,35,69,148,115,263,9,8,17,2,2:48
6466,448378,2016-07-27,2016,TEX,OAK,4,6,6-4,OAK,9,0,38,36,74,147,126,273,13,9,22,2,2:44
6467,448381,2016-07-27,2016,PIT,SEA,10,1,10-1,PIT,9,1,41,31,72,93,171,264,18,4,22,1,2:41
6468,448384,2016-07-27,2016,CLE,WAS,1,4,4-1,WAS,9,0,36,36,72,149,139,288,9,10,19,4,3:11
6469,448380,2016-07-27,2016,TOR,SDN,4,8,8-4,SDN,9,0,35,39,74,168,132,300,9,14,23,2,2:42
6470,448382,2016-07-27,2016,NYN,SLN,4,5,5-4,SLN,9,0,38,38,76,130,146,276,13,13,26,1,3:07
6471,448383,2016-07-27,2016,LAN,TBA,1,3,3-1,TBA,9,0,35,37,72,170,136,306,9,12,21,2,3:07
6472,448371,2016-07-27,2016,MIN,ATL,7,9,9-7,ATL,9,0,42,44,86,181,158,339,14,20,34,5,3:19
6473,447341,2016-07-28,2016,MIN,BAL,6,2,6-2,MIN,9,1,39,36,75,150,172,322,18,12,30,1,3:00
6474,448389,2016-07-28,2016,TEX,KCA,3,2,3-2,TEX,9,1,28,34,62,138,113,251,5,8,13,0,2:26 (:35 delay)
6475,448391,2016-07-28,2016,MIA,SLN,4,5,5-4,SLN,9,0,33,40,73,151,112,263,8,13,21,0,2:28
6476,448387,2016-07-28,2016,CHN,CHA,3,1,3-1,CHN,9,1,35,33,68,136,147,283,13,7,20,3,2:51
6477,448388,2016-07-28,2016,NYN,COL,1,2,2-1,COL,9,0,37,39,76,149,129,278,12,12,24,3,3:13
6478,448385,2016-07-28,2016,MIL,ARI,6,4,6-4,MIL,9,1,35,37,72,136,148,284,12,10,22,2,2:50
6479,447341,2016-07-28,2016,MIN,BAL,6,2,6-2,MIN,9,1,39,36,75,150,172,322,18,12,30,1,3:00
6480,448390,2016-07-28,2016,ATL,PHI,5,7,7-5,PHI,9,0,46,40,86,148,171,319,21,13,34,2,3:25
6481,448392,2016-07-28,2016,SFN,WAS,2,4,4-2,WAS,9,0,38,44,82,178,169,347,11,20,31,2,3:28
6482,448386,2016-07-28,2016,ANA,BOS,2,1,2-1,ANA,9,0,34,33,67,151,122,273,11,11,22,1,3:05
6483,448404,2016-07-29,2016,MIL,PIT,3,1,3-1,MIL,9,1,35,32,67,106,136,242,12,5,17,1,2:45
6484,448395,2016-07-29,2016,ANA,BOS,2,6,6-2,BOS,9,0,31,39,70,152,107,259,5,14,19,1,2:30
6485,448403,2016-07-29,2016,ATL,PHI,2,1,2-1,ATL,9,1,33,38,71,132,117,249,11,12,23,0,2:43
6486,448394,2016-07-29,2016,TOR,BAL,6,5,6-5,TOR,9,1,35,37,72,139,145,284,11,10,21,0,2:45
6487,448402,2016-07-29,2016,CLE,OAK,5,3,5-3,CLE,9,1,36,39,75,161,132,293,12,10,22,3,2:59
6488,448400,2016-07-29,2016,TEX,KCA,8,3,8-3,TEX,9,1,37,35,72,151,131,282,15,10,25,3,2:50
6489,448401,2016-07-29,2016,TBA,NYA,5,1,5-1,TBA,9,1,38,38,76,148,143,291,14,11,25,4,2:58
6490,448398,2016-07-29,2016,NYN,COL,1,6,6-1,COL,9,0,35,41,76,158,138,296,10,16,26,1,3:07
6491,448407,2016-07-29,2016,SFN,WAS,1,4,4-1,WAS,9,0,36,37,73,136,155,291,12,11,23,4,3:15
6492,448393,2016-07-29,2016,LAN,ARI,9,7,9-7,LAN,9,1,39,37,76,152,139,291,16,11,27,7,3:24
6493,448399,2016-07-29,2016,DET,HOU,14,6,14-6,DET,9,1,41,38,79,166,150,316,17,10,27,3,3:05
6494,448405,2016-07-29,2016,CHN,SEA,12,1,12-1,CHN,9,1,43,39,82,146,167,313,20,12,32,1,3:08 (1:14 delay)
6495,448406,2016-07-29,2016,MIA,SLN,6,11,11-6,SLN,9,0,35,47,82,179,147,326,9,23,32,2,3:03
6496,448396,2016-07-29,2016,MIN,CHA,2,1,2-1,MIN,12,0,47,41,88,154,188,342,15,8,23,2,3:42
6497,448397,2016-07-29,2016,SDN,CIN,0,6,6-0,CIN,9,0,33,44,77,160,141,301,10,18,28,0,2:57
6498,448417,2016-07-30,2016,CLE,OAK,6,3,6-3,CLE,9,1,37,36,73,132,122,254,14,10,24,1,2:39 (:27 delay)
6499,448420,2016-07-30,2016,CHN,SEA,1,4,4-1,SEA,9,0,32,37,69,136,130,266,5,10,15,2,2:37
6500,448408,2016-07-30,2016,LAN,ARI,2,4,4-2,ARI,9,0,36,37,73,139,166,305,11,11,22,4,3:24
6501,448421,2016-07-30,2016,MIA,SLN,11,0,11-0,MIA,9,1,41,36,77,156,153,309,17,9,26,2,3:02
6502,448409,2016-07-30,2016,TOR,BAL,9,1,9-1,TOR,9,1,40,34,74,137,176,313,18,8,26,3,2:52
6503,448411,2016-07-30,2016,MIN,CHA,5,6,6-5,CHA,10,0,43,45,88,147,166,313,14,15,29,2,3:23
6504,448418,2016-07-30,2016,ATL,PHI,5,9,9-5,PHI,9,0,41,47,88,183,151,334,15,20,35,3,3:40
6505,448415,2016-07-30,2016,TEX,KCA,2,1,2-1,TEX,9,0,33,32,65,133,132,265,9,8,17,0,2:41
6506,448414,2016-07-30,2016,DET,HOU,3,2,3-2,DET,9,0,36,33,69,116,144,260,10,6,16,1,2:49
6507,448412,2016-07-30,2016,SDN,CIN,2,1,2-1,SDN,10,0,35,34,69,127,138,265,8,6,14,0,2:44
6508,448413,2016-07-30,2016,NYN,COL,2,7,7-2,COL,9,0,33,39,72,156,128,284,8,13,21,0,3:09 (:38 delay)
6509,448419,2016-07-30,2016,MIL,PIT,5,3,5-3,MIL,9,1,36,36,72,162,149,311,13,11,24,3,3:19
6510,448422,2016-07-30,2016,SFN,WAS,5,3,5-3,SFN,9,1,40,36,76,151,159,310,17,10,27,4,3:29
6511,448416,2016-07-30,2016,TBA,NYA,6,3,6-3,TBA,9,1,32,33,65,143,139,282,9,7,16,1,2:47
6512,448410,2016-07-30,2016,ANA,BOS,5,2,5-2,ANA,9,1,34,40,74,189,112,301,12,13,25,3,3:06
6513,448426,2016-07-31,2016,MIN,CHA,6,4,6-4,MIN,9,1,34,40,74,148,128,276,12,12,24,2,2:39
6514,448428,2016-07-31,2016,NYN,COL,6,4,6-4,NYN,9,1,35,38,73,167,140,307,11,15,26,0,3:06 (:38 delay)
6515,448437,2016-07-31,2016,SFN,WAS,3,1,3-1,SFN,9,1,38,36,74,169,126,295,14,9,23,1,3:12
6516,448430,2016-07-31,2016,TEX,KCA,5,3,5-3,TEX,9,1,32,33,65,118,121,239,12,7,19,3,2:22
6517,448431,2016-07-31,2016,TBA,NYA,5,3,5-3,TBA,9,1,35,37,72,160,127,287,12,13,25,1,3:01
6518,448433,2016-07-31,2016,ATL,PHI,2,1,2-1,ATL,9,1,32,33,65,131,114,245,10,9,19,2,2:43 (:24 delay)
6519,448424,2016-07-31,2016,TOR,BAL,2,6,6-2,BAL,12,0,46,48,94,175,198,373,13,13,26,2,3:47
6520,448436,2016-07-31,2016,MIA,SLN,5,4,5-4,MIA,9,0,36,36,72,131,133,264,14,9,23,0,2:42
6521,448434,2016-07-31,2016,MIL,PIT,4,2,4-2,MIL,9,1,36,33,69,135,160,295,14,7,21,0,3:04
6522,448429,2016-07-31,2016,DET,HOU,11,0,11-0,DET,9,1,38,38,76,152,140,292,15,12,27,0,2:59
6523,448425,2016-07-31,2016,ANA,BOS,3,5,5-3,BOS,9,0,38,40,78,180,141,321,14,12,26,3,3:32
6524,448427,2016-07-31,2016,SDN,CIN,2,3,3-2,CIN,9,0,36,38,74,142,155,297,10,11,21,3,3:09
6525,448423,2016-07-31,2016,LAN,ARI,14,3,14-3,LAN,9,1,46,33,79,135,187,322,21,7,28,4,3:43
6526,448435,2016-07-31,2016,CHN,SEA,7,6,7-6,CHN,12,0,53,51,104,196,223,419,17,16,33,3,4:18
6527,448432,2016-07-31,2016,CLE,OAK,8,0,8-0,CLE,9,1,38,35,73,133,131,264,15,9,24,2,2:43 (:36 delay)
6528,448443,2016-08-01,2016,NYN,NYA,5,6,6-5,NYA,10,0,46,43,89,173,178,351,18,14,32,3,3:47
6529,448439,2016-08-01,2016,TBA,KCA,0,3,3-0,KCA,9,0,29,36,65,138,121,259,2,10,12,1,2:37
6530,448440,2016-08-01,2016,CHN,MIA,5,0,5-0,CHN,9,1,41,33,74,123,163,286,19,11,30,0,2:47
6531,448438,2016-08-01,2016,SEA,BOS,1,2,2-1,BOS,9,0,36,31,67,117,152,269,10,5,15,2,2:42
6532,448441,2016-08-01,2016,SDN,MIL,7,3,7-3,SDN,9,1,41,39,80,179,165,344,19,14,33,2,3:46
6533,448442,2016-08-01,2016,CLE,MIN,5,12,12-5,MIN,9,0,36,49,85,179,149,328,9,23,32,3,3:12
6534,448445,2016-08-01,2016,ARI,WAS,1,14,14-1,WAS,9,0,34,51,85,194,135,329,7,24,31,2,3:23
6535,448444,2016-08-01,2016,HOU,TOR,2,1,2-1,HOU,14,0,49,51,100,238,193,431,11,9,20,2,4:05
6536,448458,2016-08-02,2016,BAL,TEX,5,1,5-1,BAL,9,1,32,32,64,134,124,258,11,6,17,2,2:43
6537,448454,2016-08-02,2016,ANA,OAK,5,4,5-4,ANA,9,1,35,38,73,139,123,262,11,13,24,1,2:45
6538,448451,2016-08-02,2016,SDN,MIL,2,3,3-2,MIL,9,0,34,39,73,139,124,263,8,17,25,2,3:00
6539,448453,2016-08-02,2016,NYN,NYA,7,1,7-1,NYN,9,1,35,35,70,133,123,256,10,9,19,1,2:39
6540,448459,2016-08-02,2016,HOU,TOR,1,2,2-1,TOR,9,0,34,35,69,134,139,273,7,10,17,1,2:40
6541,448450,2016-08-02,2016,CHN,MIA,3,2,3-2,CHN,9,1,35,37,72,141,134,275,13,11,24,2,2:48
6542,448446,2016-08-02,2016,SEA,BOS,5,4,5-4,SEA,9,1,32,36,68,136,114,250,8,9,17,2,2:30
6543,448447,2016-08-02,2016,DET,CHA,11,5,11-5,DET,9,1,44,39,83,128,167,295,21,15,36,0,3:07
6544,448455,2016-08-02,2016,ATL,PIT,3,5,5-3,PIT,9,0,40,35,75,158,169,327,13,9,22,3,3:20
6545,448457,2016-08-02,2016,CIN,SLN,7,5,7-5,CIN,9,0,42,40,82,130,185,315,18,14,32,3,3:22
6546,448456,2016-08-02,2016,PHI,SFN,13,8,13-8,PHI,9,1,42,43,85,163,155,318,18,15,33,2,3:16
6547,448452,2016-08-02,2016,CLE,MIN,6,10,10-6,MIN,9,0,42,43,85,182,151,333,16,19,35,5,3:33
6548,448460,2016-08-02,2016,ARI,WAS,4,10,10-4,WAS,9,0,41,45,86,162,144,306,14,18,32,1,3:18
6549,448449,2016-08-02,2016,COL,LAN,7,3,7-3,COL,9,1,41,35,76,163,173,336,21,9,30,3,3:28 (:38 delay)
6550,448448,2016-08-02,2016,TBA,KCA,2,3,3-2,KCA,9,0,40,35,75,130,169,299,14,9,23,2,3:04
6551,448461,2016-08-03,2016,SEA,BOS,3,1,3-1,SEA,9,1,29,35,64,120,112,232,6,8,14,1,2:16
6552,448473,2016-08-03,2016,BAL,TEX,3,2,3-2,BAL,9,1,31,33,64,135,109,244,8,9,17,0,2:26
6553,448474,2016-08-03,2016,HOU,TOR,1,3,3-1,TOR,9,0,34,37,71,150,114,264,5,9,14,0,2:31
6554,448462,2016-08-03,2016,DET,CHA,2,1,2-1,DET,9,1,30,35,65,133,108,241,7,10,17,1,2:35
6555,448464,2016-08-03,2016,COL,LAN,12,2,12-2,COL,9,1,43,33,76,109,135,244,20,9,29,1,2:31
6556,448472,2016-08-03,2016,CIN,SLN,4,5,5-4,SLN,9,0,37,38,75,145,150,295,12,13,25,0,2:59
6557,448475,2016-08-03,2016,ARI,WAS,3,8,8-3,WAS,9,0,33,46,79,163,119,282,6,21,27,2,2:59
6558,448465,2016-08-03,2016,CHN,MIA,5,4,5-4,CHN,9,0,40,39,79,148,178,326,15,13,28,1,3:19
6559,448469,2016-08-03,2016,ANA,OAK,8,6,8-6,ANA,9,0,40,42,82,169,133,302,16,19,35,4,3:15
6560,448467,2016-08-03,2016,CLE,MIN,5,13,13-5,MIN,9,0,34,47,81,188,134,322,10,22,32,3,3:23
6561,448466,2016-08-03,2016,SDN,MIL,12,3,12-3,SDN,9,1,44,36,80,126,169,295,20,9,29,0,3:02
6562,448463,2016-08-03,2016,TBA,KCA,12,0,12-0,TBA,9,1,47,32,79,154,175,329,22,5,27,1,2:59
6563,448470,2016-08-03,2016,ATL,PIT,8,4,8-4,ATL,9,1,40,37,77,153,161,314,18,10,28,1,3:25
6564,448468,2016-08-03,2016,NYA,NYN,9,5,9-5,NYA,9,1,38,40,78,162,143,305,14,15,29,3,3:02
6565,448471,2016-08-03,2016,PHI,SFN,5,4,5-4,PHI,12,0,48,47,95,172,171,343,15,12,27,4,4:03
6566,448481,2016-08-04,2016,NYA,NYN,1,4,4-1,NYN,9,0,35,36,71,130,123,253,9,8,17,1,2:46
6567,448486,2016-08-04,2016,BAL,TEX,3,5,5-3,TEX,9,0,34,38,72,148,112,260,10,11,21,1,2:26
6568,448477,2016-08-04,2016,DET,CHA,3,6,6-3,CHA,9,0,35,41,76,152,106,258,10,15,25,2,2:50
6569,448485,2016-08-04,2016,CIN,SLN,7,0,7-0,CIN,9,1,35,32,67,122,126,248,13,5,18,2,2:33
6570,448487,2016-08-04,2016,HOU,TOR,1,4,4-1,TOR,9,0,32,34,66,140,133,273,7,8,15,0,2:41
6571,448479,2016-08-04,2016,COL,LAN,2,4,4-2,LAN,9,0,34,40,74,151,153,304,7,15,22,1,3:08
6572,448483,2016-08-04,2016,ATL,PIT,5,2,5-2,ATL,9,1,34,35,69,148,134,282,10,10,20,2,2:55 (1:16 delay)
6573,448478,2016-08-04,2016,TBA,KCA,3,2,3-2,TBA,9,1,34,38,72,130,145,275,10,12,22,1,2:42
6574,448480,2016-08-04,2016,CLE,MIN,9,2,9-2,CLE,9,1,40,36,76,153,180,333,15,12,27,3,3:16
6575,448484,2016-08-04,2016,PHI,SFN,2,3,3-2,SFN,10,0,40,40,80,161,163,324,11,11,22,1,3:30
6576,448476,2016-08-04,2016,SEA,BOS,2,3,3-2,BOS,11,0,46,46,92,177,189,366,16,17,33,2,3:47
6577,448482,2016-08-04,2016,ANA,OAK,6,8,8-6,OAK,10,0,45,43,88,167,191,358,18,13,31,3,3:54
6578,448500,2016-08-05,2016,WAS,SFN,5,1,5-1,WAS,9,1,31,31,62,130,116,246,8,5,13,0,2:26
6579,448488,2016-08-05,2016,SLN,ATL,1,0,1-0,SLN,9,1,32,30,62,107,115,222,9,4,13,1,2:28
6580,448501,2016-08-05,2016,HOU,TEX,5,0,5-0,HOU,9,1,35,32,67,111,99,210,12,5,17,0,2:14
6581,448499,2016-08-05,2016,SDN,PHI,4,5,5-4,PHI,9,0,36,35,71,122,143,265,12,7,19,1,2:55
6582,448498,2016-08-05,2016,DET,NYN,4,3,4-3,DET,9,1,33,33,66,140,131,271,10,6,16,0,2:55
6583,448497,2016-08-05,2016,TBA,MIN,2,6,6-2,MIN,9,0,35,41,76,157,140,297,8,13,21,3,2:57
6584,448492,2016-08-05,2016,PIT,CIN,3,2,3-2,PIT,9,0,33,37,70,154,141,295,11,10,21,0,3:04
6585,448494,2016-08-05,2016,SEA,ANA,6,4,6-4,SEA,9,1,41,32,73,113,152,265,18,6,24,2,2:52
6586,448491,2016-08-05,2016,OAK,CHN,2,7,7-2,CHN,9,0,33,39,72,176,139,315,7,13,20,0,2:56
6587,448490,2016-08-05,2016,LAN,BOS,0,9,9-0,BOS,9,0,31,41,72,152,119,271,4,16,20,2,2:49
6588,448489,2016-08-05,2016,CHA,BAL,5,7,7-5,BAL,9,0,41,42,83,153,160,313,14,16,30,2,3:19
6589,448502,2016-08-05,2016,KCA,TOR,3,4,4-3,TOR,9,0,37,41,78,148,132,280,10,15,25,0,2:40
6590,448495,2016-08-05,2016,COL,MIA,3,5,5-3,MIA,9,0,41,40,81,162,163,325,17,14,31,4,3:24
6591,448496,2016-08-05,2016,ARI,MIL,3,2,3-2,ARI,11,0,43,44,87,169,180,349,12,15,27,2,3:54
6592,448493,2016-08-05,2016,NYA,CLE,13,7,13-7,NYA,9,1,47,41,88,168,178,346,26,16,42,5,3:39
6593,448517,2016-08-06,2016,KCA,TOR,4,2,4-2,KCA,9,1,36,35,71,134,122,256,12,7,19,1,2:36
6594,448507,2016-08-06,2016,PIT,CIN,5,3,5-3,PIT,9,1,35,32,67,110,142,252,13,8,21,1,2:38
6595,448506,2016-08-06,2016,OAK,CHN,0,4,4-0,CHN,9,0,32,40,72,167,120,287,6,12,18,0,2:56
6596,448504,2016-08-06,2016,CHA,BAL,4,2,4-2,CHA,9,1,33,37,70,148,144,292,13,9,22,2,2:56
6597,448516,2016-08-06,2016,HOU,TEX,2,3,3-2,TEX,9,0,39,40,79,147,157,304,14,16,30,2,3:07
6598,448509,2016-08-06,2016,SEA,ANA,8,6,8-6,SEA,9,1,40,37,77,135,148,283,16,13,29,3,3:01
6599,448505,2016-08-06,2016,LAN,BOS,3,0,3-0,LAN,9,1,35,34,69,135,147,282,12,7,19,2,2:54
6600,448514,2016-08-06,2016,SDN,PHI,9,7,9-7,SDN,9,1,41,40,81,166,143,309,19,11,30,3,3:17
6601,448508,2016-08-06,2016,NYA,CLE,2,5,5-2,CLE,9,0,31,41,72,170,117,287,7,17,24,4,2:59
6602,448513,2016-08-06,2016,DET,NYN,6,5,6-5,DET,9,1,37,42,79,163,161,324,15,17,32,1,3:19
6603,448512,2016-08-06,2016,TBA,MIN,7,3,7-3,TBA,9,1,38,37,75,160,163,323,13,11,24,4,3:09
6604,448515,2016-08-06,2016,WAS,SFN,1,7,7-1,SFN,9,0,38,43,81,164,151,315,13,19,32,5,3:29
6605,448503,2016-08-06,2016,SLN,ATL,5,13,13-5,ATL,9,0,40,46,86,164,162,326,14,19,33,3,3:21
6606,448510,2016-08-06,2016,COL,MIA,12,6,12-6,COL,9,1,44,43,87,171,169,340,21,16,37,3,3:25
6607,448511,2016-08-06,2016,ARI,MIL,6,15,15-6,MIL,9,0,41,56,97,196,142,338,12,31,43,3,4:00
6608,448524,2016-08-07,2016,SEA,ANA,3,1,3-1,SEA,9,1,33,35,68,125,110,235,10,7,17,1,2:31
6609,448530,2016-08-07,2016,WAS,SFN,1,0,1-0,WAS,9,1,29,36,65,132,113,245,5,9,14,0,2:43
6610,448523,2016-08-07,2016,NYA,CLE,3,2,3-2,NYA,9,1,31,38,69,160,108,268,8,11,19,2,2:55
6611,448528,2016-08-07,2016,DET,NYN,1,3,3-1,NYN,9,0,38,33,71,115,147,262,15,6,21,3,2:50
6612,448521,2016-08-07,2016,OAK,CHN,1,3,3-1,CHN,9,0,31,38,69,178,119,297,4,15,19,4,2:53
6613,448532,2016-08-07,2016,KCA,TOR,7,1,7-1,KCA,9,1,36,36,72,130,145,275,13,10,23,2,2:39
6614,448525,2016-08-07,2016,COL,MIA,7,10,10-7,MIA,9,0,38,46,84,177,133,310,13,21,34,2,3:29
6615,448529,2016-08-07,2016,SDN,PHI,5,6,6-5,PHI,9,0,33,42,75,160,139,299,7,16,23,1,3:13
6616,448519,2016-08-07,2016,CHA,BAL,2,10,10-2,BAL,9,0,32,48,80,192,118,310,5,23,28,2,2:53
6617,448522,2016-08-07,2016,PIT,CIN,3,7,7-3,CIN,9,0,36,37,73,156,152,308,11,12,23,2,3:17
6618,448520,2016-08-07,2016,LAN,BOS,8,5,8-5,LAN,9,1,39,38,77,147,155,302,16,13,29,4,3:23
6619,448526,2016-08-07,2016,ARI,MIL,9,3,9-3,ARI,9,1,41,37,78,184,143,327,17,12,29,2,3:31
6620,448527,2016-08-07,2016,TBA,MIN,3,6,6-3,MIN,9,0,37,43,80,161,162,323,12,15,27,2,3:29
6621,448518,2016-08-07,2016,SLN,ATL,3,6,6-3,ATL,9,0,39,39,78,154,161,315,13,14,27,1,2:57
6622,448531,2016-08-07,2016,HOU,TEX,3,5,5-3,TEX,11,0,46,51,97,184,160,344,13,18,31,3,3:57
6623,448534,2016-08-08,2016,OAK,BAL,3,2,3-2,OAK,9,1,34,34,68,132,135,267,10,7,17,0,2:29
6624,448537,2016-08-08,2016,MIN,HOU,3,1,3-1,MIN,9,1,34,32,66,130,116,246,12,6,18,0,2:18
6625,448536,2016-08-08,2016,SEA,DET,3,0,3-0,SEA,9,1,30,32,62,123,122,245,8,6,14,1,2:30
6626,448540,2016-08-08,2016,COL,TEX,3,4,4-3,TEX,9,0,35,36,71,136,148,284,10,12,22,1,3:04
6627,448538,2016-08-08,2016,LAN,PHI,9,4,9-4,LAN,9,1,36,38,74,152,127,279,13,10,23,0,2:50
6628,448535,2016-08-08,2016,SLN,CIN,5,4,5-4,SLN,9,0,41,39,80,141,171,312,16,13,29,2,3:10
6629,448539,2016-08-08,2016,TOR,TBA,7,5,7-5,TOR,9,1,43,39,82,147,170,317,19,14,33,3,3:13
6630,448533,2016-08-08,2016,MIL,ATL,3,4,4-3,ATL,12,0,45,45,90,162,175,337,11,13,24,1,3:31
6631,448553,2016-08-08,2016,MIA,SFN,7,8,8-7,SFN,14,0,55,68,123,283,197,480,16,32,48,5,5:34
6632,448549,2016-08-09,2016,CHN,ANA,5,1,5-1,CHN,9,1,33,30,63,114,124,238,10,4,14,0,2:22
6633,448543,2016-08-09,2016,OAK,BAL,2,1,2-1,OAK,9,1,34,31,65,128,133,261,11,5,16,2,2:25
6634,448546,2016-08-09,2016,WAS,CLE,1,3,3-1,CLE,9,0,37,33,70,142,143,285,9,6,15,3,2:55
6635,448541,2016-08-09,2016,NYN,ARI,3,5,5-3,ARI,9,0,34,38,72,184,132,316,8,11,19,2,3:04
6636,448569,2016-08-09,2016,MIA,SFN,2,0,2-0,MIA,9,1,33,34,67,140,147,287,10,7,17,1,2:58
6637,448548,2016-08-09,2016,MIN,HOU,5,7,7-5,HOU,9,0,39,38,77,135,168,303,13,14,27,2,3:04
6638,448554,2016-08-09,2016,TOR,TBA,2,9,9-2,TBA,9,0,35,48,83,183,110,293,9,22,31,0,2:56
6639,448552,2016-08-09,2016,PIT,SDN,6,4,6-4,PIT,9,1,41,36,77,138,170,308,19,13,32,0,3:14 (:36 delay)
6640,448555,2016-08-09,2016,COL,TEX,5,7,7-5,TEX,9,0,41,39,80,159,175,334,15,12,27,3,3:14
6641,448545,2016-08-09,2016,SLN,CIN,4,7,7-4,CIN,9,0,38,42,80,148,138,286,16,17,33,1,2:57
6642,448551,2016-08-09,2016,LAN,PHI,9,3,9-3,LAN,9,1,39,37,76,163,152,315,16,11,27,3,3:17
6643,448542,2016-08-09,2016,MIL,ATL,1,2,2-1,ATL,9,0,32,33,65,137,117,254,8,10,18,3,2:53
6644,448550,2016-08-09,2016,BOS,NYA,5,3,5-3,BOS,9,1,32,39,71,152,150,302,10,12,22,4,3:13
6645,448544,2016-08-09,2016,KCA,CHA,5,7,7-5,CHA,10,0,40,44,84,154,153,307,11,15,26,1,3:05
6646,448547,2016-08-09,2016,SEA,DET,6,5,6-5,SEA,15,0,61,62,123,213,267,480,20,20,40,1,4:51
6647,448560,2016-08-10,2016,SLN,CIN,3,2,3-2,SLN,9,1,35,33,68,90,153,243,12,7,19,2,2:42
6648,448570,2016-08-10,2016,TOR,TBA,7,0,7-0,TOR,9,1,40,33,73,140,173,313,15,7,22,2,3:01
6649,448557,2016-08-10,2016,MIL,ATL,4,3,4-3,MIL,9,1,35,36,71,140,121,261,13,11,24,2,2:50
6650,448567,2016-08-10,2016,LAN,PHI,2,6,6-2,PHI,9,0,38,38,76,162,155,317,12,13,25,3,3:17
6651,448558,2016-08-10,2016,OAK,BAL,1,0,1-0,OAK,9,1,31,33,64,121,126,247,7,7,14,1,2:24
6652,448568,2016-08-10,2016,PIT,SDN,0,4,4-0,SDN,9,0,30,35,65,128,132,260,5,8,13,1,2:57
6653,448580,2016-08-10,2016,MIA,SFN,0,1,1-0,SFN,9,0,34,37,71,153,125,278,8,11,19,2,3:04
6654,448563,2016-08-10,2016,SEA,DET,3,1,3-1,SEA,9,1,36,33,69,146,144,290,13,8,21,1,3:06
6655,448562,2016-08-10,2016,TEX,COL,5,4,5-4,TEX,9,1,41,37,78,168,171,339,17,10,27,4,3:27
6656,448561,2016-08-10,2016,WAS,CLE,7,4,7-4,WAS,9,1,36,37,73,155,124,279,12,11,23,4,2:52
6657,448556,2016-08-10,2016,NYN,ARI,2,3,3-2,ARI,12,0,42,47,89,192,173,365,7,13,20,4,4:03 (:30 delay)
6658,448566,2016-08-10,2016,BOS,NYA,4,9,9-4,NYA,9,0,42,44,86,180,175,355,18,19,37,9,4:15
6659,448565,2016-08-10,2016,CHN,ANA,3,1,3-1,CHN,9,1,33,35,68,135,133,268,8,8,16,2,2:50
6660,448559,2016-08-10,2016,KCA,CHA,3,2,3-2,KCA,14,0,57,56,113,220,204,424,18,17,35,3,4:34
6661,448574,2016-08-11,2016,KCA,CHA,2,1,2-1,KCA,9,1,30,33,63,98,121,219,6,7,13,0,2:25
6662,448572,2016-08-11,2016,MIL,ATL,11,3,11-3,MIL,9,1,39,40,79,127,172,299,19,15,34,1,3:19
6663,448579,2016-08-11,2016,PIT,SDN,4,0,4-0,PIT,9,1,32,33,65,123,119,242,10,7,17,1,2:37
6664,448573,2016-08-11,2016,OAK,BAL,6,9,9-6,BAL,9,0,40,41,81,158,179,337,14,16,30,1,3:10
6665,448578,2016-08-11,2016,BOS,NYA,2,4,4-2,NYA,9,0,38,35,73,134,138,272,13,10,23,0,3:02
6666,448577,2016-08-11,2016,CLE,ANA,14,4,14-4,CLE,9,1,42,36,78,138,184,322,18,10,28,2,3:10 (1:10 delay)
6667,448571,2016-08-11,2016,NYN,ARI,0,9,9-0,ARI,9,0,31,45,76,176,103,279,6,18,24,1,2:52
6668,448564,2016-08-11,2016,MIN,HOU,2,10,10-2,HOU,9,0,37,46,83,174,138,312,9,19,28,1,2:46
6669,448564,2016-08-11,2016,MIN,HOU,2,10,10-2,HOU,9,0,37,46,83,174,138,312,9,19,28,1,2:46
6670,448581,2016-08-11,2016,CHN,SLN,4,3,4-3,CHN,11,0,48,46,94,172,203,375,17,15,32,2,3:55
6671,448576,2016-08-11,2016,MIN,HOU,7,15,15-7,HOU,9,0,40,54,94,164,150,314,15,26,41,4,3:02
6672,448575,2016-08-11,2016,TEX,COL,9,12,12-9,COL,9,0,47,47,94,190,212,402,21,21,42,2,4:03
6673,448590,2016-08-12,2016,MIN,KCA,3,7,7-3,KCA,9,0,33,40,73,150,137,287,6,13,19,2,2:48 (:50 delay)
6674,448582,2016-08-12,2016,BOS,ARI,9,4,9-4,BOS,9,1,37,40,77,136,132,268,12,14,26,1,2:53
6675,448596,2016-08-12,2016,NYA,TBA,6,3,6-3,NYA,9,1,34,34,68,139,129,268,10,8,18,0,2:51 (:30 delay)
6676,448589,2016-08-12,2016,TOR,HOU,3,5,5-3,HOU,9,0,33,44,77,154,130,284,8,18,26,2,2:49
6677,448584,2016-08-12,2016,SFN,BAL,2,5,5-2,BAL,9,0,33,39,72,150,148,298,7,13,20,4,3:01
6678,448592,2016-08-12,2016,LAN,PIT,1,5,5-1,PIT,9,0,38,34,72,123,146,269,12,7,19,2,2:57
6679,448591,2016-08-12,2016,CLE,ANA,13,3,13-3,CLE,9,1,43,35,78,123,154,277,20,8,28,0,3:13
6680,448595,2016-08-12,2016,CHN,SLN,13,2,13-2,CHN,9,1,44,38,82,151,161,312,20,9,29,1,2:59
6681,448583,2016-08-12,2016,WAS,ATL,5,8,8-5,ATL,9,0,38,41,79,163,147,310,12,16,28,4,3:15
6682,448594,2016-08-12,2016,OAK,SEA,6,3,6-3,OAK,9,1,34,32,66,124,123,247,12,8,20,1,2:19
6683,448585,2016-08-12,2016,MIA,CHA,2,4,4-2,CHA,9,0,35,42,77,163,167,330,8,19,27,3,3:22
6684,448587,2016-08-12,2016,PHI,COL,10,6,10-6,PHI,9,1,42,39,81,159,172,331,17,11,28,1,3:25
6685,448586,2016-08-12,2016,MIL,CIN,4,7,7-4,CIN,9,0,35,45,80,183,165,348,8,18,26,1,3:23
6686,448588,2016-08-12,2016,TEX,DET,8,5,8-5,TEX,9,1,39,38,77,136,141,277,15,10,25,2,3:00 (2:42 delay)
6687,448593,2016-08-12,2016,NYN,SDN,6,8,8-6,SDN,9,0,39,35,74,153,153,306,12,9,21,2,3:07
6688,448606,2016-08-13,2016,CLE,ANA,5,1,5-1,CLE,9,1,35,33,68,133,136,269,14,7,21,1,3:04 (2:11 delay)
6689,448599,2016-08-13,2016,SFN,BAL,6,2,6-2,SFN,9,1,39,37,76,137,160,297,16,10,26,2,2:59
6690,448602,2016-08-13,2016,PHI,COL,6,3,6-3,PHI,9,1,36,41,77,150,138,288,13,16,29,2,3:20
6691,448609,2016-08-13,2016,OAK,SEA,3,4,4-3,SEA,9,0,37,37,74,135,136,271,11,11,22,2,2:58
6692,448605,2016-08-13,2016,MIN,KCA,5,3,5-3,MIN,9,1,38,36,74,131,129,260,14,9,23,1,2:35
6693,448597,2016-08-13,2016,BOS,ARI,6,3,6-3,BOS,9,1,35,37,72,160,140,300,10,12,22,5,3:12
6694,448598,2016-08-13,2016,WAS,ATL,7,6,7-6,WAS,9,1,37,40,77,145,135,280,12,14,26,2,3:07
6695,448603,2016-08-13,2016,TEX,DET,0,2,2-0,DET,9,0,32,42,74,147,130,277,6,20,26,0,2:54
6696,448604,2016-08-13,2016,TOR,HOU,4,2,4-2,TOR,9,1,31,35,66,128,132,260,9,10,19,1,2:35
6697,448611,2016-08-13,2016,NYA,TBA,8,4,8-4,NYA,9,1,36,33,69,104,134,238,12,6,18,1,2:40
6698,448608,2016-08-13,2016,NYN,SDN,3,2,3-2,NYN,11,0,42,36,78,148,160,308,10,6,16,1,3:22
6699,448601,2016-08-13,2016,MIL,CIN,5,11,11-5,CIN,9,0,41,45,86,162,178,340,16,17,33,2,3:29
6700,448610,2016-08-13,2016,CHN,SLN,4,8,8-4,SLN,9,0,36,40,76,148,167,315,12,13,25,2,2:50
6701,448600,2016-08-13,2016,MIA,CHA,7,8,8-7,CHA,9,0,40,45,85,172,148,320,16,18,34,3,3:23
6702,448607,2016-08-13,2016,LAN,PIT,8,4,8-4,LAN,9,1,43,49,92,201,151,352,18,22,40,5,3:54
6703,448613,2016-08-14,2016,WAS,ATL,9,1,9-1,WAS,9,1,37,32,69,116,145,261,12,8,20,1,2:46
6704,448615,2016-08-14,2016,MIA,CHA,5,4,5-4,MIA,9,1,34,38,72,136,122,258,12,12,24,1,2:49
6705,448621,2016-08-14,2016,CLE,ANA,5,4,5-4,CLE,9,1,36,33,69,133,128,261,15,8,23,1,2:47 (1:38 delay)
6706,448623,2016-08-14,2016,NYN,SDN,5,1,5-1,NYN,9,1,34,32,66,137,142,279,12,6,18,2,2:47
6707,448624,2016-08-14,2016,OAK,SEA,4,8,8-4,SEA,9,0,37,42,79,132,134,266,10,16,26,1,2:51
6708,448616,2016-08-14,2016,MIL,CIN,7,3,7-3,MIL,9,1,38,35,73,149,164,313,14,9,23,1,2:52
6709,448626,2016-08-14,2016,NYA,TBA,3,12,12-3,TBA,9,0,35,44,79,154,124,278,10,17,27,2,2:54
6710,448618,2016-08-14,2016,TEX,DET,0,7,7-0,DET,9,0,30,41,71,133,112,245,4,14,18,1,2:26
6711,448619,2016-08-14,2016,TOR,HOU,9,2,9-2,TOR,9,1,40,36,76,118,168,286,16,8,24,4,2:59
6712,448612,2016-08-14,2016,BOS,ARI,16,2,16-2,BOS,9,1,48,33,81,107,161,268,23,7,30,2,2:49
6713,448625,2016-08-14,2016,CHN,SLN,4,6,6-4,SLN,9,0,37,39,76,163,132,295,10,13,23,4,3:02
6714,448617,2016-08-14,2016,PHI,COL,7,6,7-6,PHI,9,1,43,43,86,176,153,329,17,17,34,3,3:33
6715,448614,2016-08-14,2016,SFN,BAL,7,8,8-7,BAL,9,0,46,44,90,159,167,326,19,17,36,3,3:14
6716,448622,2016-08-14,2016,LAN,PIT,3,11,11-3,PIT,9,0,36,48,84,198,162,360,9,21,30,3,3:39
6717,448620,2016-08-14,2016,MIN,KCA,4,11,11-4,KCA,9,0,34,47,81,169,142,311,8,19,27,3,3:07
6718,446903,2016-08-15,2016,CLE,BOS,2,3,3-2,BOS,9,0,34,37,71,139,137,276,9,11,20,3,2:57
6719,446903,2016-08-15,2016,CLE,BOS,2,3,3-2,BOS,9,0,34,37,71,139,137,276,9,11,20,3,2:57
6720,448631,2016-08-15,2016,TBA,SDN,8,2,8-2,TBA,9,1,39,33,72,132,155,287,17,7,24,1,2:50
6721,448627,2016-08-15,2016,DET,KCA,1,3,3-1,KCA,9,0,34,40,74,137,127,264,7,15,22,2,2:58
6722,448632,2016-08-15,2016,ANA,SEA,2,3,3-2,SEA,9,0,36,38,74,160,131,291,9,12,21,3,3:01
6723,448634,2016-08-15,2016,COL,WAS,4,5,5-4,WAS,9,0,37,42,79,162,161,323,12,17,29,3,3:26
6724,448643,2016-08-15,2016,TEX,OAK,5,2,5-2,TEX,9,1,38,32,70,122,157,279,17,7,24,1,2:42
6725,448630,2016-08-15,2016,SFN,PIT,5,8,8-5,PIT,9,0,43,42,85,161,154,315,17,17,34,3,3:27
6726,448633,2016-08-15,2016,NYA,TOR,1,0,1-0,NYA,9,1,39,30,69,147,149,296,15,4,19,0,2:55
6727,448629,2016-08-15,2016,ARI,NYN,10,6,10-6,ARI,9,1,43,42,85,179,150,329,19,17,36,1,3:29
6728,448628,2016-08-15,2016,CIN,MIA,3,6,6-3,MIA,9,0,39,41,80,166,173,339,12,14,26,6,3:41
6729,447184,2016-08-16,2016,CHN,MIL,4,0,4-0,CHN,9,1,35,35,70,159,150,309,11,10,21,2,3:12
6730,448637,2016-08-16,2016,DET,KCA,1,6,6-1,KCA,9,0,31,35,66,130,114,244,5,7,12,3,2:43
6731,448649,2016-08-16,2016,COL,WAS,6,2,6-2,COL,9,1,35,38,73,144,130,274,14,12,26,2,2:54 (2:05 delay)
6732,448639,2016-08-16,2016,CIN,MIA,6,3,6-3,CIN,9,1,35,36,71,137,127,264,13,11,24,1,2:34
6733,448646,2016-08-16,2016,ANA,SEA,7,6,7-6,ANA,9,1,35,41,76,155,135,290,12,15,27,2,3:03
6734,448645,2016-08-16,2016,TBA,SDN,15,1,15-1,TBA,9,1,44,38,82,160,158,318,20,11,31,0,3:18
6735,448647,2016-08-16,2016,HOU,SLN,5,8,8-5,SLN,9,0,41,37,78,160,161,321,14,10,24,2,3:06
6736,448635,2016-08-16,2016,BAL,BOS,3,5,5-3,BOS,9,0,36,38,74,148,145,293,10,13,23,3,3:05
6737,447184,2016-08-16,2016,CHN,MIL,4,0,4-0,CHN,9,1,35,35,70,159,150,309,11,10,21,2,3:12
6738,448641,2016-08-16,2016,ATL,MIN,2,4,4-2,MIN,9,0,37,42,79,188,147,335,10,18,28,5,3:28
6739,448636,2016-08-16,2016,CLE,CHA,3,1,3-1,CLE,9,1,37,35,72,141,153,294,14,9,23,2,3:08
6740,448644,2016-08-16,2016,SFN,PIT,3,4,4-3,PIT,9,0,37,38,75,156,121,277,10,13,23,1,3:12
6741,448638,2016-08-16,2016,PHI,LAN,5,15,15-5,LAN,9,0,36,47,83,208,143,351,9,19,28,2,3:30
6742,448642,2016-08-16,2016,ARI,NYN,5,7,7-5,NYN,9,0,41,39,80,145,173,318,12,15,27,3,3:24
6743,448640,2016-08-16,2016,CHN,MIL,4,1,4-1,CHN,9,1,36,35,71,152,154,306,15,10,25,3,3:21
6744,448658,2016-08-16,2016,TEX,OAK,5,4,5-4,TEX,10,0,41,48,89,185,169,354,14,19,33,2,3:40
6745,448648,2016-08-16,2016,NYA,TOR,6,12,12-6,TOR,9,0,35,45,80,188,136,324,8,19,27,3,3:09 (:42 delay)
6746,448650,2016-08-17,2016,BAL,BOS,1,8,8-1,BOS,7,1,23,33,56,118,84,202,4,16,20,1,2:12 (1:17 delay)
6747,448660,2016-08-17,2016,TBA,SDN,2,0,2-0,TBA,9,1,31,34,65,126,114,240,7,7,14,3,2:32
6748,448655,2016-08-17,2016,CHN,MIL,6,1,6-1,CHN,9,1,37,33,70,152,137,289,14,6,20,1,2:50
6749,448663,2016-08-17,2016,NYA,TOR,4,7,7-4,TOR,9,0,36,41,77,149,121,270,10,13,23,2,2:47
6750,448652,2016-08-17,2016,DET,KCA,1,4,4-1,KCA,9,0,37,36,73,149,131,280,10,11,21,3,2:47
6751,448674,2016-08-17,2016,TEX,OAK,6,2,6-2,TEX,9,1,37,35,72,119,143,262,15,9,24,3,2:54
6752,448654,2016-08-17,2016,CIN,MIA,3,2,3-2,CIN,9,1,36,37,73,162,146,308,15,9,24,2,3:07
6753,448657,2016-08-17,2016,ARI,NYN,13,5,13-5,ARI,9,1,42,40,82,132,155,287,20,13,33,5,2:53
6754,448662,2016-08-17,2016,HOU,SLN,2,8,8-2,SLN,9,0,37,42,79,201,128,329,10,16,26,3,2:59
6755,448653,2016-08-17,2016,PHI,LAN,2,7,7-2,LAN,9,0,39,43,82,161,164,325,14,16,30,2,3:23
6756,448651,2016-08-17,2016,CLE,CHA,7,10,10-7,CHA,9,0,44,39,83,146,187,333,18,14,32,3,3:30
6757,448659,2016-08-17,2016,SFN,PIT,5,6,6-5,PIT,9,0,41,38,79,159,168,327,15,12,27,1,3:21
6758,448661,2016-08-17,2016,ANA,SEA,3,4,4-3,SEA,9,0,42,41,83,153,183,336,19,14,33,3,3:37
6759,448664,2016-08-17,2016,COL,WAS,12,10,12-10,COL,9,1,41,44,85,210,163,373,17,17,34,3,3:52
6760,448656,2016-08-17,2016,ATL,MIN,3,10,10-3,MIN,9,0,36,49,85,213,115,328,12,25,37,3,3:24
6761,448675,2016-08-18,2016,ANA,SEA,6,4,6-4,ANA,9,1,35,36,71,135,125,260,13,10,23,2,2:58
6762,448672,2016-08-18,2016,KCA,MIN,8,1,8-1,KCA,9,1,34,32,66,110,124,234,11,6,17,1,2:15
6763,448667,2016-08-18,2016,CLE,CHA,5,4,5-4,CLE,9,0,36,36,72,148,144,292,14,10,24,2,3:00
6764,448669,2016-08-18,2016,PHI,LAN,5,4,5-4,PHI,9,1,38,36,74,134,150,284,14,10,24,2,2:54
6765,448670,2016-08-18,2016,CIN,MIA,5,4,5-4,CIN,9,1,34,36,70,143,124,267,12,9,21,1,2:40
6766,448673,2016-08-18,2016,SFN,NYN,10,7,10-7,SFN,9,1,42,42,84,165,155,320,22,17,39,6,3:30
6767,448665,2016-08-18,2016,SDN,ARI,9,8,9-8,SDN,9,1,42,45,87,168,163,331,20,19,39,2,3:49
6768,448676,2016-08-18,2016,ATL,WAS,2,8,8-2,WAS,9,0,37,43,80,179,143,322,9,14,23,1,3:32 (1:16 delay)
6769,448668,2016-08-18,2016,BAL,HOU,13,5,13-5,BAL,9,1,42,35,77,131,149,280,19,8,27,2,2:40
6770,448666,2016-08-18,2016,DET,BOS,4,3,4-3,DET,9,1,36,39,75,163,129,292,13,13,26,2,3:23
6771,448671,2016-08-18,2016,CHN,MIL,9,6,9-6,CHN,9,1,40,42,82,161,158,319,16,16,32,2,3:21
6772,448690,2016-08-19,2016,CLE,TOR,3,2,3-2,CLE,9,0,34,33,67,121,141,262,10,7,17,0,2:27
6773,448689,2016-08-19,2016,TBA,TEX,2,6,6-2,TEX,9,0,35,42,77,160,134,294,8,15,23,3,2:56
6774,448680,2016-08-19,2016,BAL,HOU,8,15,15-8,HOU,9,0,39,49,88,169,142,311,12,24,36,4,3:03
6775,448682,2016-08-19,2016,PIT,MIA,5,6,6-5,MIA,9,0,39,47,86,150,161,311,17,25,42,3,3:36
6776,448688,2016-08-19,2016,PHI,SLN,3,4,4-3,SLN,11,0,46,45,91,167,186,353,17,13,30,3,3:54
6777,448687,2016-08-19,2016,CHA,OAK,0,9,9-0,OAK,9,0,28,43,71,155,98,253,2,16,18,1,2:23
6778,448678,2016-08-19,2016,DET,BOS,2,10,10-2,BOS,9,0,33,45,78,158,132,290,6,18,24,1,2:46
6779,448683,2016-08-19,2016,SEA,MIL,7,6,7-6,SEA,9,1,43,40,83,166,152,318,18,15,33,3,3:21
6780,448681,2016-08-19,2016,CIN,LAN,9,2,9-2,CIN,9,1,38,43,81,165,173,338,17,17,34,2,3:39
6781,448685,2016-08-19,2016,SFN,NYN,8,1,8-1,SFN,9,1,39,35,74,136,126,262,17,11,28,4,2:54
6782,448691,2016-08-19,2016,ATL,WAS,6,7,7-6,WAS,9,0,37,44,81,177,165,342,12,17,29,2,3:36
6783,448684,2016-08-19,2016,KCA,MIN,5,4,5-4,KCA,11,0,49,45,94,182,192,374,21,12,33,4,3:44 (3:15 delay)
6784,448686,2016-08-19,2016,ANA,NYA,0,7,7-0,NYA,9,0,34,42,76,132,123,255,7,16,23,4,2:55
6785,448677,2016-08-19,2016,SDN,ARI,7,4,7-4,SDN,10,0,41,49,90,205,139,344,16,23,39,4,3:58
6786,448679,2016-08-19,2016,COL,CHN,7,6,7-6,COL,11,0,44,47,91,183,182,365,14,16,30,2,3:47 (2:10 delay)
6787,448701,2016-08-20,2016,ANA,NYA,1,5,5-1,NYA,9,0,33,37,70,155,123,278,7,9,16,2,2:51
6788,448692,2016-08-20,2016,SDN,ARI,1,2,2-1,ARI,9,0,34,34,68,123,148,271,6,8,14,2,2:52
6789,448699,2016-08-20,2016,KCA,MIN,10,0,10-0,KCA,9,1,42,31,73,124,135,259,19,5,24,1,2:31
6790,448693,2016-08-20,2016,DET,BOS,2,3,3-2,BOS,9,0,34,36,70,139,106,245,8,10,18,2,2:36 (2:31 delay)
6791,448703,2016-08-20,2016,PHI,SLN,4,2,4-2,PHI,9,1,34,34,68,134,138,272,11,10,21,0,2:56
6792,448702,2016-08-20,2016,CHA,OAK,6,2,6-2,CHA,9,1,35,36,71,146,131,277,11,9,20,1,2:33
6793,448698,2016-08-20,2016,SEA,MIL,8,2,8-2,SEA,9,1,37,35,72,123,141,264,15,9,24,2,2:53
6794,448704,2016-08-20,2016,TBA,TEX,8,2,8-2,TBA,9,1,37,37,74,158,132,290,14,11,25,3,2:56
6795,448696,2016-08-20,2016,CIN,LAN,11,1,11-1,CIN,9,1,44,33,77,126,154,280,22,6,28,1,2:53 (1:19 delay)
6796,448705,2016-08-20,2016,CLE,TOR,5,6,6-5,TOR,9,0,34,41,75,154,142,296,7,15,22,1,3:00
6797,448706,2016-08-20,2016,ATL,WAS,9,11,11-9,WAS,9,0,45,45,90,160,154,314,17,20,37,4,3:26
6798,448695,2016-08-20,2016,BAL,HOU,2,12,12-2,HOU,9,0,37,50,87,204,139,343,9,25,34,2,3:21
6799,448697,2016-08-20,2016,PIT,MIA,1,3,3-1,MIA,9,0,32,33,65,109,141,250,6,6,12,0,2:30
6800,448694,2016-08-20,2016,COL,CHN,2,9,9-2,CHN,9,0,34,44,78,176,129,305,8,18,26,2,3:05
6801,448700,2016-08-20,2016,SFN,NYN,5,9,9-5,NYN,9,0,39,42,81,167,151,318,15,17,32,2,3:21
6802,448714,2016-08-21,2016,KCA,MIN,2,1,2-1,KCA,9,1,29,36,65,125,129,254,5,10,15,1,2:25
6803,448716,2016-08-21,2016,ANA,NYA,2,0,2-0,ANA,9,1,32,35,67,141,132,273,10,9,19,1,2:39
6804,448711,2016-08-21,2016,CIN,LAN,0,4,4-0,LAN,9,0,34,37,71,138,145,283,10,12,22,0,2:55
6805,448719,2016-08-21,2016,TBA,TEX,8,4,8-4,TBA,9,1,37,35,72,160,139,299,12,9,21,3,3:01
6806,448709,2016-08-21,2016,COL,CHN,11,4,11-4,COL,9,1,42,33,75,122,180,302,17,8,25,1,3:00
6807,448713,2016-08-21,2016,SEA,MIL,6,7,7-6,MIL,9,0,39,38,77,160,154,314,12,12,24,3,3:13
6808,448707,2016-08-21,2016,SDN,ARI,9,1,9-1,SDN,9,1,37,32,69,128,136,264,14,5,19,1,2:30
6809,448715,2016-08-21,2016,SFN,NYN,0,2,2-0,NYN,9,0,29,32,61,123,111,234,5,6,11,0,2:25
6810,448720,2016-08-21,2016,CLE,TOR,3,2,3-2,CLE,9,1,32,40,72,166,113,279,10,14,24,2,2:53
6811,448717,2016-08-21,2016,CHA,OAK,4,2,4-2,CHA,9,1,35,37,72,136,120,256,12,11,23,3,2:42
6812,448708,2016-08-21,2016,DET,BOS,10,5,10-5,DET,9,1,38,36,74,153,148,301,17,10,27,0,3:09
6813,448721,2016-08-21,2016,ATL,WAS,7,6,7-6,ATL,10,0,43,43,86,170,174,344,16,12,28,3,3:36 (1:04 delay)
6814,448710,2016-08-21,2016,BAL,HOU,3,5,5-3,HOU,9,0,33,38,71,127,112,239,7,12,19,0,2:32 (4:35 delay)
6815,448712,2016-08-21,2016,PIT,MIA,2,3,3-2,MIA,9,0,35,38,73,132,146,278,7,9,16,1,2:55
6816,448718,2016-08-21,2016,PHI,SLN,0,9,9-0,SLN,9,0,35,43,78,181,126,307,11,15,26,1,3:07
6817,448725,2016-08-22,2016,OAK,CLE,0,1,1-0,CLE,9,0,31,34,65,143,112,255,4,8,12,0,2:29
6818,448727,2016-08-22,2016,PIT,HOU,1,3,3-1,HOU,9,0,32,32,64,111,119,230,6,6,12,0,2:17
6819,448729,2016-08-22,2016,SEA,NYA,7,5,7-5,SEA,9,1,34,37,71,146,132,278,13,12,25,5,2:56
6820,448730,2016-08-22,2016,BAL,WAS,4,3,4-3,BAL,9,1,31,37,68,143,121,264,8,11,19,1,2:31
6821,448724,2016-08-22,2016,SDN,CHN,1,5,5-1,CHN,9,0,34,41,75,167,155,322,8,18,26,1,3:19
6822,448722,2016-08-22,2016,ARI,ATL,9,8,9-8,ARI,9,0,39,43,82,153,158,311,17,18,35,2,3:18
6823,448723,2016-08-22,2016,TBA,BOS,2,6,6-2,BOS,9,0,33,43,76,185,137,322,7,18,25,1,3:13
6824,448728,2016-08-22,2016,CIN,LAN,9,18,18-9,LAN,9,0,50,52,102,189,190,379,22,25,47,6,4:02
6825,448726,2016-08-22,2016,MIL,COL,4,2,4-2,MIL,9,1,34,36,70,137,154,291,12,9,21,0,2:54
6826,448744,2016-08-23,2016,CIN,TEX,3,0,3-0,CIN,9,1,31,36,67,146,113,259,9,9,18,0,2:39
6827,448733,2016-08-23,2016,SDN,CHN,3,5,5-3,CHN,9,0,33,42,75,145,134,279,10,14,24,2,2:55
6828,448738,2016-08-23,2016,MIA,KCA,0,1,1-0,KCA,9,0,35,35,70,136,147,283,9,9,18,1,2:50
6829,448734,2016-08-23,2016,OAK,CLE,9,1,9-1,OAK,9,1,40,31,71,150,141,291,16,6,22,1,2:43
6830,448739,2016-08-23,2016,TOR,ANA,7,2,7-2,TOR,9,1,38,35,73,124,157,281,17,10,27,2,2:38
6831,448741,2016-08-23,2016,SEA,NYA,1,5,5-1,NYA,9,0,31,41,72,162,123,285,5,12,17,1,2:45
6832,448736,2016-08-23,2016,MIN,DET,3,8,8-3,DET,9,0,32,41,73,156,112,268,6,18,24,2,2:45
6833,448745,2016-08-23,2016,BAL,WAS,8,1,8-1,BAL,9,1,41,35,76,144,158,302,17,12,29,3,3:12
6834,448737,2016-08-23,2016,PIT,HOU,7,1,7-1,PIT,9,1,37,33,70,98,153,251,14,7,21,0,2:32
6835,448740,2016-08-23,2016,SLN,NYN,4,7,7-4,NYN,9,0,42,41,83,144,171,315,16,16,32,3,3:12
6836,448731,2016-08-23,2016,ARI,ATL,4,7,7-4,ATL,9,0,38,45,83,169,153,322,11,18,29,1,3:23
6837,448732,2016-08-23,2016,TBA,BOS,1,2,2-1,BOS,9,0,34,34,68,172,131,303,10,9,19,2,3:09
6838,448742,2016-08-23,2016,CHA,PHI,9,1,9-1,CHA,9,1,37,34,71,144,134,278,15,7,22,1,2:38
6839,448743,2016-08-23,2016,LAN,SFN,9,5,9-5,LAN,9,1,41,38,79,152,158,310,17,14,31,5,3:36
6840,448735,2016-08-23,2016,MIL,COL,6,4,6-4,MIL,9,1,37,43,80,172,156,328,14,16,30,2,3:29
6841,448759,2016-08-24,2016,LAN,SFN,1,0,1-0,LAN,9,1,29,35,64,133,119,252,6,8,14,2,2:47
6842,448758,2016-08-24,2016,CHA,PHI,3,5,5-3,PHI,9,0,35,39,74,148,120,268,9,12,21,1,2:44
6843,448756,2016-08-24,2016,SLN,NYN,8,1,8-1,SLN,9,1,42,33,75,109,166,275,22,7,29,2,2:55
6844,448754,2016-08-24,2016,MIA,KCA,3,0,3-0,MIA,9,1,32,38,70,150,114,264,8,11,19,1,2:35
6845,448751,2016-08-24,2016,MIL,COL,7,1,7-1,MIL,9,1,38,38,76,142,144,286,14,10,24,2,3:01
6846,448749,2016-08-24,2016,SDN,CHN,3,6,6-3,CHN,9,0,37,37,74,138,150,288,9,10,19,2,2:55
6847,448760,2016-08-24,2016,CIN,TEX,5,6,6-5,TEX,9,0,38,34,72,116,132,248,12,8,20,0,2:44
6848,448752,2016-08-24,2016,MIN,DET,4,9,9-4,DET,9,0,38,42,80,151,153,304,11,17,28,1,3:04
6849,448753,2016-08-24,2016,PIT,HOU,4,5,5-4,HOU,9,0,40,37,77,130,159,289,13,11,24,1,2:56
6850,448746,2016-08-24,2016,ARI,ATL,10,9,10-9,ARI,11,0,53,56,109,233,206,439,23,25,48,4,4:46
6851,448755,2016-08-24,2016,TOR,ANA,2,8,8-2,ANA,9,0,38,47,85,184,163,347,11,24,35,1,3:21
6852,448748,2016-08-24,2016,TBA,BOS,4,3,4-3,TBA,11,0,47,42,89,158,190,348,14,11,25,5,3:41
6853,448747,2016-08-24,2016,WAS,BAL,8,10,10-8,BAL,9,0,43,48,91,175,173,348,18,20,38,4,3:28
6854,448750,2016-08-24,2016,OAK,CLE,5,1,5-1,OAK,9,1,37,37,74,138,133,271,14,12,26,3,2:37
6855,448757,2016-08-24,2016,SEA,NYA,0,5,5-0,NYA,9,0,35,42,77,161,147,308,10,17,27,2,3:18
6856,448762,2016-08-25,2016,WAS,BAL,4,0,4-0,WAS,9,1,34,30,64,110,134,244,10,3,13,1,2:43
6857,448763,2016-08-25,2016,TBA,BOS,2,1,2-1,TBA,9,1,32,33,65,122,122,244,9,10,19,2,2:32
6858,448767,2016-08-25,2016,TOR,ANA,3,6,6-3,ANA,9,0,38,37,75,143,145,288,10,14,24,4,3:06
6859,448765,2016-08-25,2016,MIN,DET,5,8,8-5,DET,9,0,37,45,82,149,138,287,10,19,29,2,2:49
6860,448764,2016-08-25,2016,TEX,CLE,9,0,9-0,TEX,9,1,37,30,67,117,136,253,12,3,15,1,2:34
6861,448761,2016-08-25,2016,ARI,ATL,1,3,3-1,ATL,9,0,32,39,71,161,124,285,5,14,19,0,2:55
6862,448770,2016-08-25,2016,LAN,SFN,0,4,4-0,SFN,9,0,31,38,69,170,134,304,4,11,15,1,3:02
6863,448769,2016-08-25,2016,MIL,PIT,2,3,3-2,PIT,10,0,38,40,78,156,143,299,9,11,20,1,3:20
6864,448766,2016-08-25,2016,MIA,KCA,2,5,5-2,KCA,9,0,40,38,78,149,162,311,11,12,23,2,3:13
6865,448771,2016-08-25,2016,CHA,SEA,7,6,7-6,CHA,9,0,40,38,78,146,162,308,16,11,27,3,3:06
6866,448768,2016-08-25,2016,SLN,NYN,6,10,10-6,NYN,9,0,41,45,86,166,157,323,15,21,36,2,3:28
6867,448785,2016-08-26,2016,CHA,SEA,1,3,3-1,SEA,9,0,33,32,65,120,121,241,10,6,16,1,2:22
6868,448779,2016-08-26,2016,DET,ANA,4,2,4-2,DET,9,1,34,33,67,135,113,248,12,7,19,2,2:50
6869,448781,2016-08-26,2016,SLN,OAK,3,1,3-1,SLN,9,1,32,34,66,134,121,255,9,8,17,1,2:26
6870,448772,2016-08-26,2016,SFN,ATL,7,0,7-0,SFN,9,1,36,36,72,129,131,260,11,10,21,0,2:51
6871,448783,2016-08-26,2016,MIL,PIT,3,5,5-3,PIT,9,0,41,40,81,155,156,311,16,12,28,3,3:26
6872,448776,2016-08-26,2016,TEX,CLE,1,12,12-1,CLE,9,0,35,46,81,163,160,323,9,21,30,2,3:17
6873,448778,2016-08-26,2016,BOS,KCA,3,6,6-3,KCA,9,0,42,38,80,145,178,323,17,13,30,3,3:14
6874,448784,2016-08-26,2016,MIA,SDN,7,6,7-6,MIA,9,0,45,40,85,176,194,370,19,14,33,4,3:52
6875,448777,2016-08-26,2016,WAS,COL,8,5,8-5,WAS,9,1,38,35,73,143,138,281,15,9,24,3,3:04
6876,448773,2016-08-26,2016,NYA,BAL,14,4,14-4,NYA,9,1,44,35,79,142,158,300,20,8,28,1,2:51
6877,448782,2016-08-26,2016,NYN,PHI,9,4,9-4,NYN,9,1,36,37,73,142,144,286,14,11,25,2,2:56
6878,448774,2016-08-26,2016,LAN,CHN,4,6,6-4,CHN,10,0,44,43,87,168,166,334,15,13,28,0,3:38
6879,448780,2016-08-26,2016,TOR,MIN,15,8,15-8,TOR,9,1,45,42,87,173,181,354,20,15,35,3,3:11
6880,448775,2016-08-26,2016,ARI,CIN,4,3,4-3,ARI,11,0,45,49,94,170,179,349,13,20,33,0,3:47
6881,448786,2016-08-26,2016,HOU,TBA,5,4,5-4,HOU,9,0,32,35,67,124,145,269,9,9,18,1,2:39
6882,448787,2016-08-27,2016,SFN,ATL,1,3,3-1,ATL,9,0,33,35,68,130,118,248,6,13,19,2,2:34
6883,448790,2016-08-27,2016,ARI,CIN,0,13,13-0,CIN,9,0,30,47,77,157,108,265,5,19,24,1,2:32
6884,448789,2016-08-27,2016,LAN,CHN,3,2,3-2,LAN,9,1,30,36,66,146,117,263,6,12,18,2,3:08
6885,448796,2016-08-27,2016,SLN,OAK,2,3,3-2,OAK,9,0,33,38,71,151,129,280,6,10,16,3,2:52
6886,448791,2016-08-27,2016,TEX,CLE,7,0,7-0,TEX,9,1,37,36,73,146,143,289,12,9,21,0,2:57
6887,448800,2016-08-27,2016,CHA,SEA,9,3,9-3,CHA,9,1,41,35,76,130,155,285,18,10,28,2,2:51
6888,448801,2016-08-27,2016,HOU,TBA,6,2,6-2,HOU,9,1,39,35,74,134,167,301,19,10,29,1,2:58
6889,448795,2016-08-27,2016,TOR,MIN,8,7,8-7,TOR,9,1,37,39,76,161,148,309,15,13,28,2,3:06
6890,448793,2016-08-27,2016,BOS,KCA,8,3,8-3,BOS,9,1,37,37,74,159,141,300,15,10,25,0,3:03
6891,448797,2016-08-27,2016,NYN,PHI,12,1,12-1,NYN,9,1,43,31,74,134,175,309,20,5,25,1,3:07
6892,448799,2016-08-27,2016,MIA,SDN,0,1,1-0,SDN,9,0,35,36,71,181,121,302,10,10,20,2,3:11
6893,448798,2016-08-27,2016,MIL,PIT,6,9,9-6,PIT,9,0,39,43,82,170,155,325,15,18,33,1,3:21
6894,448794,2016-08-27,2016,DET,ANA,2,3,3-2,ANA,9,0,36,39,75,169,158,327,11,13,24,1,3:17
6895,448788,2016-08-27,2016,NYA,BAL,13,5,13-5,NYA,9,1,51,41,92,161,197,358,27,15,42,5,3:29
6896,448792,2016-08-27,2016,WAS,COL,4,9,9-4,COL,11,0,47,54,101,214,200,414,15,25,40,6,4:49
6897,448814,2016-08-28,2016,MIA,SDN,1,3,3-1,SDN,9,0,30,36,66,131,99,230,9,11,20,0,2:36
6898,448815,2016-08-28,2016,CHA,SEA,4,1,4-1,CHA,9,1,33,34,67,143,115,258,9,8,17,3,2:30
6899,448806,2016-08-28,2016,TEX,CLE,2,1,2-1,TEX,9,1,32,35,67,135,125,260,9,10,19,1,2:43
6900,448813,2016-08-28,2016,MIL,PIT,1,3,3-1,PIT,9,0,32,39,71,151,108,259,6,12,18,1,2:39
6901,448804,2016-08-28,2016,LAN,CHN,1,0,1-0,LAN,9,1,32,35,67,135,150,285,9,8,17,2,3:08
6902,448807,2016-08-28,2016,WAS,COL,3,5,5-3,COL,9,0,34,39,73,151,129,280,7,12,19,2,2:52
6903,448803,2016-08-28,2016,NYA,BAL,0,5,5-0,BAL,9,0,34,39,73,150,149,299,8,13,21,2,3:07
6904,448812,2016-08-28,2016,NYN,PHI,1,5,5-1,PHI,9,0,36,36,72,145,163,308,8,12,20,3,3:08
6905,448811,2016-08-28,2016,SLN,OAK,4,7,7-4,OAK,9,0,34,38,72,126,134,260,8,13,21,1,2:43
6906,448816,2016-08-28,2016,HOU,TBA,4,10,10-4,TBA,9,0,39,44,83,175,156,331,11,17,28,2,3:14
6907,448808,2016-08-28,2016,BOS,KCA,4,10,10-4,KCA,9,0,37,43,80,162,168,330,13,15,28,3,3:25
6908,448810,2016-08-28,2016,TOR,MIN,9,6,9-6,TOR,9,1,39,41,80,149,153,302,17,14,31,3,3:00
6909,448805,2016-08-28,2016,ARI,CIN,11,2,11-2,ARI,9,1,43,30,73,121,176,297,19,5,24,0,2:57
6910,448809,2016-08-28,2016,DET,ANA,0,5,5-0,ANA,9,0,34,37,71,135,148,283,8,13,21,2,3:09
6911,448802,2016-08-28,2016,SFN,ATL,13,4,13-4,SFN,9,1,46,35,81,138,177,315,23,9,32,2,3:13
6912,448818,2016-08-29,2016,ANA,CIN,9,2,9-2,ANA,9,1,39,35,74,123,130,253,16,9,25,1,2:51
6913,448823,2016-08-29,2016,HOU,OAK,6,0,6-0,HOU,9,1,36,35,71,140,155,295,12,10,22,3,2:45
6914,448829,2016-08-29,2016,PHI,WAS,0,4,4-0,WAS,9,0,31,38,69,150,127,277,6,11,17,0,2:58
6915,448827,2016-08-29,2016,BOS,TBA,9,4,9-4,BOS,9,1,41,35,76,140,169,309,18,10,28,1,3:11
6916,448821,2016-08-29,2016,CLE,MIN,1,0,1-0,CLE,10,0,38,41,79,168,134,302,12,12,24,4,3:19
6917,448825,2016-08-29,2016,TEX,SEA,6,3,6-3,TEX,9,1,35,37,72,155,148,303,11,10,21,2,3:18
6918,448828,2016-08-29,2016,BAL,TOR,1,5,5-1,TOR,9,0,32,37,69,152,134,286,6,11,17,1,2:35
6919,448819,2016-08-29,2016,COL,LAN,8,1,8-1,COL,9,1,39,39,78,152,173,325,15,13,28,1,3:36
6920,448820,2016-08-29,2016,NYN,MIA,2,1,2-1,NYN,10,0,39,41,80,182,173,355,12,12,24,1,3:30
6921,448817,2016-08-29,2016,DET,CHA,4,3,4-3,DET,9,1,36,39,75,164,130,294,13,13,26,4,3:20
6922,448822,2016-08-29,2016,KCA,NYA,8,5,8-5,KCA,9,1,36,41,77,148,155,303,13,13,26,5,3:17
6923,448826,2016-08-29,2016,MIL,SLN,5,6,6-5,SLN,9,0,40,44,84,171,171,342,14,17,31,3,3:24
6924,448824,2016-08-29,2016,CHN,PIT,8,7,8-7,CHN,13,0,59,56,115,205,260,465,26,19,45,1,5:03
6925,448843,2016-08-30,2016,BAL,TOR,5,3,5-3,BAL,9,1,35,34,69,139,129,268,11,9,20,2,2:34
6926,448844,2016-08-30,2016,PHI,WAS,2,3,3-2,WAS,9,0,30,36,66,139,114,253,5,10,15,0,2:42
6927,448842,2016-08-30,2016,BOS,TBA,3,4,4-3,TBA,9,0,35,37,72,141,158,299,10,11,21,1,3:11
6928,448839,2016-08-30,2016,ATL,SDN,7,3,7-3,ATL,9,1,40,34,74,124,149,273,19,7,26,1,2:55
6929,448835,2016-08-30,2016,CLE,MIN,5,4,5-4,CLE,9,1,38,39,77,148,145,293,18,13,31,6,3:10
6930,448834,2016-08-30,2016,NYN,MIA,7,4,7-4,NYN,9,1,41,38,79,145,142,287,19,12,31,2,3:04
6931,448830,2016-08-30,2016,SFN,ARI,3,4,4-3,ARI,9,0,39,38,77,148,155,303,13,13,26,2,3:18
6932,448832,2016-08-30,2016,ANA,CIN,4,2,4-2,ANA,9,1,33,38,71,138,118,256,11,12,23,3,2:56
6933,448838,2016-08-30,2016,CHN,PIT,3,0,3-0,CHN,9,1,32,30,62,136,137,273,9,5,14,0,2:36
6934,448837,2016-08-30,2016,HOU,OAK,3,1,3-1,HOU,9,1,29,33,62,139,114,253,6,6,12,0,2:28
6935,448841,2016-08-30,2016,MIL,SLN,1,2,2-1,SLN,10,0,38,37,75,139,157,296,9,9,18,1,3:08
6936,448831,2016-08-30,2016,DET,CHA,8,4,8-4,DET,9,1,40,38,78,159,163,322,16,12,28,2,3:13
6937,448840,2016-08-30,2016,TEX,SEA,8,7,8-7,TEX,9,0,41,43,84,152,157,309,18,16,34,3,3:23
6938,448836,2016-08-30,2016,KCA,NYA,4,5,5-4,NYA,10,0,41,48,89,180,168,348,13,18,31,6,4:07 (:59 delay)
6939,448850,2016-08-31,2016,CLE,MIN,8,4,8-4,CLE,9,1,39,37,76,136,133,269,17,11,28,2,2:45
6940,448859,2016-08-31,2016,PHI,WAS,1,2,2-1,WAS,9,0,30,34,64,151,135,286,4,7,11,3,2:50
6941,448849,2016-08-31,2016,NYN,MIA,5,2,5-2,NYN,9,1,36,35,71,126,140,266,14,7,21,1,2:46
6942,448857,2016-08-31,2016,BOS,TBA,8,6,8-6,BOS,9,1,38,41,79,157,144,301,15,17,32,2,3:10
6943,448847,2016-08-31,2016,ANA,CIN,3,0,3-0,ANA,9,1,31,30,61,94,102,196,8,4,12,0,2:10
6944,448856,2016-08-31,2016,MIL,SLN,3,1,3-1,MIL,9,1,30,34,64,133,116,249,6,6,12,1,2:33
6945,448846,2016-08-31,2016,DET,CHA,3,2,3-2,DET,9,0,36,32,68,139,118,257,13,5,18,0,2:46
6946,448852,2016-08-31,2016,HOU,OAK,4,3,4-3,HOU,9,1,33,38,71,152,134,286,10,10,20,0,2:43
6947,448845,2016-08-31,2016,SFN,ARI,4,2,4-2,SFN,9,1,37,38,75,158,141,299,13,12,25,4,3:33
6948,448848,2016-08-31,2016,COL,LAN,7,0,7-0,COL,9,1,38,34,72,134,138,272,16,8,24,1,2:55
6949,448858,2016-08-31,2016,BAL,TOR,3,5,5-3,TOR,9,0,39,35,74,145,164,309,12,12,24,1,3:12
6950,448854,2016-08-31,2016,ATL,SDN,8,1,8-1,ATL,9,1,41,35,76,153,176,329,21,8,29,2,3:22
6951,448855,2016-08-31,2016,TEX,SEA,14,1,14-1,TEX,9,1,42,37,79,141,165,306,19,11,30,1,3:01
6952,448833,2016-08-31,2016,COL,LAN,8,10,10-8,LAN,9,0,40,45,85,176,159,335,16,18,34,1,3:36
6953,448833,2016-08-31,2016,COL,LAN,8,10,10-8,LAN,9,0,40,45,85,176,159,335,16,18,34,1,3:36
6954,448853,2016-08-31,2016,CHN,PIT,6,5,6-5,CHN,9,1,38,44,82,205,143,348,14,17,31,3,3:48
6955,448851,2016-08-31,2016,KCA,NYA,4,5,5-4,NYA,13,0,49,55,104,216,182,398,11,17,28,5,4:19
6956,448862,2016-09-01,2016,ATL,SDN,9,6,9-6,ATL,9,1,40,35,75,135,135,270,16,8,24,2,2:48
6957,448861,2016-09-01,2016,NYN,MIA,4,6,6-4,MIA,9,0,39,42,81,166,162,328,14,15,29,2,3:25
6958,448863,2016-09-01,2016,CHN,SFN,5,4,5-4,CHN,9,1,37,33,70,111,166,277,14,7,21,3,2:54
6959,448860,2016-09-01,2016,MIN,CHA,8,5,8-5,MIN,9,1,34,45,79,176,139,315,11,19,30,1,3:13
6960,448875,2016-09-02,2016,CHN,SFN,2,1,2-1,CHN,9,1,33,32,65,102,145,247,11,5,16,2,2:37
6961,448876,2016-09-02,2016,CIN,SLN,3,2,3-2,CIN,9,0,42,34,76,122,173,295,18,8,26,1,2:57
6962,448872,2016-09-02,2016,PIT,MIL,0,1,1-0,MIL,9,0,35,35,70,134,145,279,11,9,20,1,3:01
6963,448873,2016-09-02,2016,BAL,NYA,8,0,8-0,BAL,9,1,37,32,69,129,162,291,13,6,19,2,2:52
6964,448871,2016-09-02,2016,CLE,MIA,6,2,6-2,CLE,9,1,39,36,75,137,150,287,15,9,24,1,2:49
6965,448865,2016-09-02,2016,PHI,ATL,4,8,8-4,ATL,9,0,38,44,82,179,148,327,11,18,29,1,3:28
6966,448877,2016-09-02,2016,TBA,TOR,8,3,8-3,TBA,9,1,38,37,75,156,149,305,12,10,22,2,2:52
6967,448874,2016-09-02,2016,LAN,SDN,2,4,4-2,SDN,9,0,40,39,79,164,167,331,14,14,28,4,3:32
6968,448864,2016-09-02,2016,COL,ARI,14,7,14-7,COL,9,1,44,40,84,142,152,294,21,15,36,2,3:11
6969,448869,2016-09-02,2016,TEX,HOU,10,8,10-8,TEX,9,1,41,41,82,167,151,318,19,13,32,7,3:15
6970,448868,2016-09-02,2016,KCA,DET,6,7,7-6,DET,9,0,41,41,82,146,159,305,13,15,28,3,3:28
6971,448870,2016-09-02,2016,SEA,ANA,11,8,11-8,SEA,9,1,45,39,84,164,185,349,21,14,35,3,3:25
6972,448866,2016-09-02,2016,OAK,BOS,2,16,16-2,BOS,9,0,35,51,86,211,134,345,9,23,32,3,3:27
6973,448867,2016-09-02,2016,MIN,CHA,4,11,11-4,CHA,9,0,34,50,84,199,104,303,10,25,35,2,2:59
6974,448878,2016-09-02,2016,NYN,WAS,1,4,4-1,WAS,9,0,35,36,71,151,153,304,8,9,17,3,3:07
6975,448889,2016-09-03,2016,LAN,SDN,5,1,5-1,LAN,9,1,33,34,67,141,109,250,12,7,19,0,2:35
6976,448886,2016-09-03,2016,CLE,MIA,8,3,8-3,CLE,9,1,42,32,74,108,153,261,18,7,25,2,2:38
6977,448888,2016-09-03,2016,BAL,NYA,2,0,2-0,BAL,9,1,35,32,67,154,149,303,13,7,20,0,3:02
6978,448885,2016-09-03,2016,SEA,ANA,3,10,10-3,ANA,9,0,37,44,81,164,133,297,11,18,29,1,2:54
6979,448890,2016-09-03,2016,CHN,SFN,2,3,3-2,SFN,9,0,38,34,72,140,151,291,11,6,17,3,3:13
6980,448883,2016-09-03,2016,KCA,DET,5,2,5-2,KCA,9,1,37,41,78,164,139,303,14,16,30,3,3:14
6981,448891,2016-09-03,2016,CIN,SLN,9,1,9-1,CIN,9,1,44,36,80,132,149,281,23,13,36,3,3:10
6982,448879,2016-09-03,2016,COL,ARI,4,9,9-4,ARI,9,0,37,42,79,149,150,299,12,16,28,3,3:11
6983,448892,2016-09-03,2016,TBA,TOR,7,5,7-5,TBA,9,1,38,39,77,173,148,321,16,12,28,4,3:06
6984,448884,2016-09-03,2016,TEX,HOU,12,4,12-4,TEX,9,1,42,39,81,162,151,313,20,15,35,4,3:27
6985,448893,2016-09-03,2016,NYN,WAS,3,1,3-1,NYN,9,1,34,37,71,135,144,279,12,10,22,5,3:13
6986,448882,2016-09-03,2016,MIN,CHA,11,3,11-3,MIN,9,1,42,35,77,144,179,323,18,8,26,2,3:12
6987,448880,2016-09-03,2016,PHI,ATL,4,6,6-4,ATL,10,0,39,44,83,152,176,328,8,15,23,0,3:27
6988,448887,2016-09-03,2016,PIT,MIL,4,7,7-4,MIL,9,0,40,44,84,146,162,308,16,18,34,5,3:45
6989,448881,2016-09-03,2016,OAK,BOS,2,11,11-2,BOS,9,0,31,49,80,201,121,322,5,21,26,1,3:00
6990,448896,2016-09-04,2016,OAK,BOS,1,0,1-0,OAK,9,0,31,36,67,152,116,268,6,9,15,1,2:39
6991,448904,2016-09-04,2016,LAN,SDN,7,4,7-4,LAN,9,1,38,34,72,137,160,297,15,9,24,2,3:09
6992,448899,2016-09-04,2016,TEX,HOU,6,7,7-6,HOU,9,0,41,44,85,153,147,300,15,17,32,1,3:22
6993,448898,2016-09-04,2016,KCA,DET,5,6,6-5,DET,9,0,37,39,76,145,159,304,12,14,26,3,3:19
6994,448907,2016-09-04,2016,TBA,TOR,3,5,5-3,TOR,9,0,37,40,77,172,176,348,10,14,24,3,3:18
6995,448901,2016-09-04,2016,CLE,MIA,6,5,6-5,CLE,9,0,42,40,82,156,178,334,17,13,30,4,3:43
6996,448905,2016-09-04,2016,CHN,SFN,3,2,3-2,CHN,13,0,51,48,99,181,186,367,16,9,25,5,4:23
6997,448895,2016-09-04,2016,PHI,ATL,0,2,2-0,ATL,9,0,36,41,77,141,151,292,9,17,26,0,3:14
6998,448902,2016-09-04,2016,PIT,MIL,0,10,10-0,MIL,9,0,32,42,74,161,131,292,7,16,23,0,3:10
6999,448908,2016-09-04,2016,NYN,WAS,5,1,5-1,NYN,9,1,33,37,70,141,143,284,10,10,20,2,2:59
7000,448894,2016-09-04,2016,COL,ARI,5,8,8-5,ARI,9,0,39,39,78,139,163,302,13,15,28,2,3:20
7001,448900,2016-09-04,2016,SEA,ANA,2,4,4-2,ANA,9,0,35,35,70,115,146,261,10,12,22,1,3:00
7002,448897,2016-09-04,2016,MIN,CHA,11,13,13-11,CHA,12,0,61,58,119,219,249,468,25,20,45,5,4:46
7003,448906,2016-09-04,2016,CIN,SLN,2,5,5-2,SLN,9,0,39,37,76,153,146,299,16,9,25,1,2:56
7004,448903,2016-09-04,2016,BAL,NYA,2,5,5-2,NYA,9,0,38,38,76,163,159,322,11,14,25,4,3:17
7005,448920,2016-09-05,2016,COL,SFN,6,0,6-0,COL,9,1,35,29,64,103,140,243,12,2,14,1,2:24
7006,448919,2016-09-05,2016,MIA,PHI,2,6,6-2,PHI,9,0,33,37,70,145,131,276,7,12,19,1,2:54
7007,448912,2016-09-05,2016,SDN,BOS,2,1,2-1,SDN,9,1,31,34,65,141,134,275,8,9,17,1,3:01
7008,448923,2016-09-05,2016,NYA,TOR,5,3,5-3,NYA,9,1,33,38,71,151,120,271,10,13,23,3,2:49
7009,448913,2016-09-05,2016,MIL,CHN,2,7,7-2,CHN,9,0,33,41,74,139,138,277,8,14,22,3,2:51
7010,448911,2016-09-05,2016,TBA,BAL,3,7,7-3,BAL,9,0,31,38,69,144,114,258,4,11,15,0,2:35
7011,448909,2016-09-05,2016,LAN,ARI,10,2,10-2,LAN,9,1,38,34,72,142,165,307,14,7,21,2,3:12
7012,448918,2016-09-05,2016,CIN,NYN,0,5,5-0,NYN,9,0,34,36,70,153,146,299,9,12,21,2,3:05
7013,448910,2016-09-05,2016,WAS,ATL,6,4,6-4,WAS,9,1,35,42,77,142,139,281,13,14,27,0,2:59
7014,448917,2016-09-05,2016,OAK,ANA,7,10,10-7,ANA,9,0,45,46,91,165,183,348,18,20,38,2,3:44
7015,448921,2016-09-05,2016,PIT,SLN,6,12,12-6,SLN,9,0,39,49,88,180,145,325,13,21,34,0,3:25
7016,448916,2016-09-05,2016,MIN,KCA,5,11,11-5,KCA,9,0,42,46,88,180,147,327,16,21,37,5,3:24
7017,448915,2016-09-05,2016,CLE,HOU,2,6,6-2,HOU,9,0,36,44,80,192,151,343,10,19,29,6,3:44
7018,448922,2016-09-05,2016,SEA,TEX,14,6,14-6,SEA,9,1,48,38,86,143,209,352,25,12,37,4,3:32
7019,448914,2016-09-05,2016,CHA,DET,3,5,5-3,DET,11,0,45,45,90,175,180,355,12,13,25,1,3:56
7020,448929,2016-09-06,2016,CHA,DET,2,0,2-0,CHA,9,1,32,36,68,134,137,271,11,10,21,2,2:54
7021,448935,2016-09-06,2016,COL,SFN,2,3,3-2,SFN,9,0,33,35,68,137,132,269,7,10,17,4,3:02
7022,448934,2016-09-06,2016,MIA,PHI,3,4,4-3,PHI,9,0,37,42,79,151,148,299,11,16,27,2,3:00
7023,448928,2016-09-06,2016,MIL,CHN,12,5,12-5,MIL,9,1,42,37,79,127,137,264,20,10,30,2,2:49
7024,448930,2016-09-06,2016,CLE,HOU,3,4,4-3,HOU,9,0,36,38,74,152,156,308,9,11,20,2,3:03
7025,448933,2016-09-06,2016,CIN,NYN,3,5,5-3,NYN,9,0,36,39,75,162,140,302,9,14,23,2,3:08
7026,448931,2016-09-06,2016,MIN,KCA,3,10,10-3,KCA,9,0,35,42,77,167,129,296,9,16,25,6,3:07
7027,448926,2016-09-06,2016,TBA,BAL,2,11,11-2,BAL,9,0,37,49,86,189,142,331,10,21,31,0,3:08
7028,448932,2016-09-06,2016,OAK,ANA,3,2,3-2,OAK,9,1,31,31,62,113,113,226,8,6,14,1,2:14
7029,448924,2016-09-06,2016,LAN,ARI,5,2,5-2,LAN,9,1,35,32,67,115,139,254,13,5,18,2,2:49
7030,448927,2016-09-06,2016,SDN,BOS,1,5,5-1,BOS,9,0,36,40,76,162,119,281,9,16,25,2,3:04
7031,448938,2016-09-06,2016,NYA,TOR,7,6,7-6,NYA,9,1,35,44,79,198,113,311,11,19,30,7,3:21
7032,448925,2016-09-06,2016,WAS,ATL,9,7,9-7,WAS,9,1,41,36,77,151,176,327,17,11,28,6,3:38
7033,448936,2016-09-06,2016,PIT,SLN,7,9,9-7,SLN,9,0,42,44,86,161,184,345,14,17,31,2,3:36
7034,448937,2016-09-06,2016,SEA,TEX,7,10,10-7,TEX,9,0,44,52,96,213,152,365,16,24,40,5,3:44
7035,448943,2016-09-07,2016,MIL,CHN,2,1,2-1,MIL,9,1,31,31,62,124,143,267,11,5,16,2,2:54
7036,448953,2016-09-07,2016,NYA,TOR,2,0,2-0,NYA,9,1,35,33,68,143,133,276,12,8,20,1,2:48
7037,448947,2016-09-07,2016,OAK,ANA,4,1,4-1,OAK,9,1,42,30,72,141,166,307,17,4,21,2,3:11
7038,448945,2016-09-07,2016,CLE,HOU,6,5,6-5,CLE,9,1,40,39,79,135,147,282,18,13,31,4,3:06
7039,448950,2016-09-07,2016,COL,SFN,6,5,6-5,COL,9,0,36,40,76,135,154,289,13,15,28,5,3:16
7040,448946,2016-09-07,2016,MIN,KCA,6,5,6-5,MIN,9,1,38,38,76,158,141,299,13,14,27,2,3:08
7041,448949,2016-09-07,2016,MIA,PHI,6,0,6-0,MIA,9,1,36,34,70,168,109,277,14,9,23,2,2:52
7042,448952,2016-09-07,2016,SEA,TEX,8,3,8-3,SEA,9,1,36,36,72,134,148,282,13,11,24,1,2:30
7043,448940,2016-09-07,2016,WAS,ATL,5,4,5-4,WAS,11,0,50,49,99,209,189,398,22,18,40,8,4:39 (:57 delay)
7044,448944,2016-09-07,2016,CHA,DET,7,4,7-4,CHA,9,1,40,36,76,144,150,294,16,13,29,3,3:18 (:45 delay)
7045,448939,2016-09-07,2016,LAN,ARI,3,1,3-1,LAN,9,1,32,39,71,149,123,272,8,13,21,6,3:05
7046,448942,2016-09-07,2016,SDN,BOS,2,7,7-2,BOS,9,0,35,40,75,151,128,279,8,13,21,2,3:01
7047,448951,2016-09-07,2016,PIT,SLN,4,3,4-3,PIT,9,1,35,37,72,161,139,300,12,12,24,1,3:01
7048,448941,2016-09-07,2016,TBA,BAL,7,6,7-6,TBA,9,1,41,41,82,163,182,345,17,14,31,3,3:25
7049,448948,2016-09-07,2016,CIN,NYN,3,6,6-3,NYN,9,0,42,43,85,153,165,318,18,16,34,3,3:29
7050,448956,2016-09-08,2016,CLE,HOU,10,7,10-7,CLE,9,1,38,38,76,142,168,310,16,12,28,4,3:14 (:55 delay)
7051,448954,2016-09-08,2016,PIT,CIN,4,1,4-1,PIT,9,1,41,32,73,94,148,242,20,6,26,0,2:28
7052,448959,2016-09-08,2016,NYA,TBA,5,4,5-4,NYA,9,0,35,40,75,151,127,278,11,14,25,4,3:21
7053,448958,2016-09-08,2016,WAS,PHI,1,4,4-1,PHI,9,0,35,35,70,133,123,256,7,8,15,1,2:48
7054,448960,2016-09-08,2016,SEA,TEX,6,3,6-3,SEA,9,1,37,37,74,163,158,321,16,11,27,3,3:22
7055,448957,2016-09-08,2016,SLN,MIL,5,12,12-5,MIL,9,0,39,46,85,167,140,307,14,22,36,2,3:15
7056,448955,2016-09-08,2016,SDN,COL,14,1,14-1,SDN,9,1,45,37,82,153,198,351,19,11,30,2,3:26
7057,448966,2016-09-09,2016,SDN,COL,1,4,4-1,COL,9,0,33,36,69,143,132,275,8,11,19,2,2:38
7058,448963,2016-09-09,2016,HOU,CHN,0,2,2-0,CHN,9,0,31,36,67,134,123,257,7,9,16,1,2:34
7059,448969,2016-09-09,2016,SLN,MIL,4,3,4-3,SLN,9,1,32,36,68,130,117,247,10,13,23,1,2:34
7060,448961,2016-09-09,2016,DET,BAL,4,3,4-3,DET,9,1,34,33,67,135,147,282,14,7,21,0,2:54
7061,448964,2016-09-09,2016,PIT,CIN,3,4,4-3,CIN,9,0,38,38,76,130,132,262,18,14,32,1,3:01
7062,448965,2016-09-09,2016,MIN,CLE,4,5,5-4,CLE,9,0,36,44,80,152,148,300,10,15,25,2,3:07
7063,448967,2016-09-09,2016,CHA,KCA,7,2,7-2,CHA,9,1,38,39,77,163,138,301,15,10,25,3,3:11
7064,448970,2016-09-09,2016,ATL,NYN,4,6,6-4,NYN,9,0,42,39,81,156,158,314,18,13,31,2,3:17
7065,448973,2016-09-09,2016,OAK,SEA,2,3,3-2,SEA,9,0,34,36,70,158,135,293,8,9,17,1,2:59
7066,448974,2016-09-09,2016,NYA,TBA,7,5,7-5,NYA,9,1,42,42,84,143,203,346,20,16,36,6,3:30 (1:34 delay)
7067,448975,2016-09-09,2016,ANA,TEX,1,2,2-1,TEX,9,0,34,38,72,137,124,261,7,12,19,3,3:22
7068,448968,2016-09-09,2016,MIA,LAN,4,1,4-1,MIA,9,1,35,37,72,143,145,288,11,10,21,4,3:08
7069,448971,2016-09-09,2016,WAS,PHI,5,4,5-4,WAS,9,0,37,38,75,170,140,310,12,13,25,4,3:31
7070,448962,2016-09-09,2016,TOR,BOS,3,13,13-3,BOS,9,0,38,49,87,196,157,353,11,23,34,4,3:23
7071,448972,2016-09-09,2016,ARI,SFN,6,7,7-6,SFN,12,0,51,55,106,242,229,471,17,22,39,7,5:23
7072,448984,2016-09-10,2016,SLN,MIL,5,1,5-1,SLN,9,1,33,34,67,118,127,245,12,11,23,2,2:39
7073,448977,2016-09-10,2016,TOR,BOS,3,2,3-2,TOR,9,1,34,35,69,138,136,274,9,7,16,1,3:03
7074,448986,2016-09-10,2016,WAS,PHI,3,0,3-0,WAS,9,1,33,34,67,150,122,272,10,8,18,4,3:05
7075,448976,2016-09-10,2016,DET,BAL,3,11,11-3,BAL,9,0,39,46,85,189,150,339,12,19,31,1,3:05 (:11 delay)
7076,448989,2016-09-10,2016,NYA,TBA,5,1,5-1,NYA,9,1,32,34,66,119,114,233,7,8,15,2,2:34 (:28 delay)
7077,448978,2016-09-10,2016,HOU,CHN,2,1,2-1,HOU,9,1,32,33,65,159,118,277,9,8,17,0,2:54
7078,448981,2016-09-10,2016,SDN,COL,6,3,6-3,SDN,9,1,35,34,69,139,123,262,11,6,17,1,2:37
7079,448983,2016-09-10,2016,MIA,LAN,0,5,5-0,LAN,9,0,30,36,66,145,131,276,2,11,13,2,2:52
7080,448985,2016-09-10,2016,ATL,NYN,4,3,4-3,ATL,10,0,38,40,78,160,139,299,10,13,23,3,3:24
7081,448988,2016-09-10,2016,OAK,SEA,3,14,14-3,SEA,9,0,38,46,84,185,138,323,11,23,34,2,3:03
7082,448980,2016-09-10,2016,MIN,CLE,2,1,2-1,MIN,12,0,47,47,94,154,176,330,13,13,26,5,3:38
7083,448990,2016-09-10,2016,ANA,TEX,5,8,8-5,TEX,9,0,40,43,83,164,150,314,13,16,29,4,3:40
7084,448982,2016-09-10,2016,CHA,KCA,5,6,6-5,KCA,9,0,41,38,79,152,158,310,16,12,28,3,3:33
7085,448987,2016-09-10,2016,ARI,SFN,3,11,11-3,SFN,9,0,33,49,82,177,130,307,8,25,33,1,3:09
7086,448979,2016-09-10,2016,PIT,CIN,7,8,8-7,CIN,9,0,44,44,88,173,164,337,18,19,37,1,3:36
7087,449001,2016-09-11,2016,WAS,PHI,3,2,3-2,WAS,9,1,30,34,64,129,125,254,7,9,16,4,2:49
7088,448996,2016-09-11,2016,SDN,COL,2,3,3-2,COL,10,0,39,37,76,119,148,267,9,8,17,2,3:03
7089,449003,2016-09-11,2016,OAK,SEA,2,3,3-2,SEA,9,0,34,39,73,159,131,290,11,14,25,2,2:52
7090,448994,2016-09-11,2016,PIT,CIN,0,8,8-0,CIN,9,0,37,42,79,146,129,275,12,19,31,1,2:56
7091,448993,2016-09-11,2016,HOU,CHN,5,9,9-5,CHN,9,0,36,41,77,162,129,291,11,14,25,3,3:07
7092,449002,2016-09-11,2016,ARI,SFN,3,5,5-3,SFN,9,0,38,39,77,160,136,296,12,14,26,4,3:19
7093,449000,2016-09-11,2016,ATL,NYN,3,10,10-3,NYN,9,0,36,42,78,151,120,271,13,16,29,3,2:56
7094,448998,2016-09-11,2016,MIA,LAN,3,0,3-0,MIA,9,1,33,30,63,110,127,237,12,4,16,1,2:26
7095,448999,2016-09-11,2016,SLN,MIL,1,2,2-1,MIL,9,0,34,32,66,146,114,260,6,5,11,1,2:33
7096,449004,2016-09-11,2016,NYA,TBA,2,4,4-2,TBA,9,0,35,37,72,138,141,279,8,10,18,2,2:58
7097,448997,2016-09-11,2016,CHA,KCA,0,2,2-0,KCA,9,0,32,38,70,132,155,287,7,12,19,0,2:59
7098,449005,2016-09-11,2016,ANA,TEX,3,2,3-2,ANA,9,1,32,33,65,124,116,240,10,7,17,2,2:31
7099,448991,2016-09-11,2016,DET,BAL,1,3,3-1,BAL,9,0,35,37,72,164,152,316,9,13,22,0,3:23
7100,448992,2016-09-11,2016,TOR,BOS,8,11,11-8,BOS,9,0,42,44,86,169,168,337,15,18,33,9,3:46
7101,448995,2016-09-11,2016,MIN,CLE,1,7,7-1,CLE,9,0,37,45,82,194,138,332,9,19,28,4,3:13
7102,449017,2016-09-12,2016,SFN,SDN,0,4,4-0,SDN,9,0,35,36,71,132,129,261,8,11,19,2,2:54
7103,449007,2016-09-12,2016,SLN,CHN,1,4,4-1,CHN,9,0,30,36,66,130,112,242,4,11,15,2,2:17
7104,449006,2016-09-12,2016,BOS,BAL,12,2,12-2,BOS,9,1,42,30,72,108,148,256,19,3,22,2,2:40
7105,449010,2016-09-12,2016,NYA,LAN,2,8,8-2,LAN,9,0,36,41,77,161,159,320,9,14,23,3,3:13
7106,449014,2016-09-12,2016,WAS,NYN,8,1,8-1,WAS,9,1,40,37,77,137,154,291,18,10,28,4,3:08
7107,449016,2016-09-12,2016,PHI,PIT,6,2,6-2,PHI,9,1,39,35,74,151,166,317,17,8,25,1,3:18
7108,449009,2016-09-12,2016,ARI,COL,12,9,12-9,ARI,9,1,43,43,86,172,159,331,19,16,35,3,3:42
7109,449019,2016-09-12,2016,TOR,TBA,3,2,3-2,TOR,9,1,31,34,65,117,110,227,7,6,13,1,2:13
7110,449013,2016-09-12,2016,DET,MIN,4,2,4-2,DET,9,1,34,38,72,158,149,307,10,12,22,3,3:04
7111,449018,2016-09-12,2016,ANA,SEA,1,8,8-1,SEA,9,0,35,42,77,165,140,305,9,14,23,2,3:08
7112,449012,2016-09-12,2016,CIN,MIL,3,0,3-0,CIN,9,1,31,35,66,139,130,269,8,9,17,1,2:32
7113,449008,2016-09-12,2016,CHA,CLE,11,4,11-4,CHA,9,1,44,37,81,142,178,320,19,10,29,6,3:30
7114,449015,2016-09-12,2016,KCA,OAK,3,16,16-3,OAK,9,0,35,52,87,210,136,346,9,27,36,4,3:23
7115,449020,2016-09-12,2016,HOU,TEX,3,4,4-3,TEX,12,0,46,45,91,170,185,355,12,13,25,1,3:48
7116,449011,2016-09-12,2016,ATL,MIA,12,7,12-7,ATL,9,1,46,46,92,162,169,331,23,21,44,6,3:35
7117,449035,2016-09-13,2016,HOU,TEX,2,3,3-2,TEX,9,0,30,36,66,127,112,239,5,9,14,0,2:23
7118,449027,2016-09-13,2016,CIN,MIL,6,4,6-4,CIN,9,1,35,34,69,124,130,254,11,7,18,0,2:35
7119,449022,2016-09-13,2016,SLN,CHN,4,2,4-2,SLN,9,1,34,39,73,162,121,283,11,12,23,2,2:51
7120,449023,2016-09-13,2016,CHA,CLE,8,1,8-1,CHA,9,1,37,34,71,124,124,248,13,8,21,2,2:37
7121,449031,2016-09-13,2016,PHI,PIT,3,5,5-3,PIT,9,0,36,39,75,155,138,293,10,16,26,3,3:12
7122,449033,2016-09-13,2016,ANA,SEA,0,8,8-0,SEA,9,0,30,40,70,154,113,267,3,13,16,1,2:37
7123,449025,2016-09-13,2016,NYA,LAN,3,0,3-0,NYA,9,1,34,33,67,131,143,274,13,6,19,4,3:02
7124,449021,2016-09-13,2016,BOS,BAL,3,6,6-3,BAL,9,0,39,41,80,174,134,308,13,15,28,7,3:29
7125,449030,2016-09-13,2016,KCA,OAK,4,5,5-4,OAK,9,0,39,34,73,128,150,278,12,8,20,3,2:56
7126,449029,2016-09-13,2016,WAS,NYN,3,4,4-3,NYN,10,0,39,44,83,150,155,305,9,15,24,2,3:22
7127,449026,2016-09-13,2016,ATL,MIA,5,7,7-5,MIA,9,0,40,41,81,138,160,298,14,15,29,5,3:24
7128,449028,2016-09-13,2016,DET,MIN,1,8,8-1,MIN,9,0,35,43,78,157,125,282,9,18,27,1,2:48
7129,449024,2016-09-13,2016,ARI,COL,11,4,11-4,ARI,9,1,48,37,85,151,186,337,26,10,36,3,3:28
7130,449034,2016-09-13,2016,TOR,TBA,2,6,6-2,TBA,9,0,36,39,75,152,159,311,11,15,26,6,3:10
7131,449032,2016-09-13,2016,SFN,SDN,4,6,6-4,SDN,9,0,41,42,83,160,136,296,17,17,34,2,3:27
7132,449048,2016-09-14,2016,ANA,SEA,1,2,2-1,SEA,9,0,34,34,68,121,120,241,8,7,15,3,3:01
7133,449044,2016-09-14,2016,WAS,NYN,1,0,1-0,WAS,9,1,29,33,62,123,108,231,9,8,17,1,2:30
7134,449038,2016-09-14,2016,CHA,CLE,1,6,6-1,CLE,9,0,33,39,72,145,122,267,6,13,19,2,2:48
7135,449047,2016-09-14,2016,SFN,SDN,1,3,3-1,SDN,9,0,31,39,70,140,122,262,6,12,18,4,2:51
7136,449043,2016-09-14,2016,DET,MIN,9,6,9-6,DET,9,1,39,35,74,124,156,280,14,8,22,2,2:54
7137,449036,2016-09-14,2016,BOS,BAL,0,1,1-0,BAL,9,0,32,31,63,126,135,261,5,5,10,0,2:35
7138,449049,2016-09-14,2016,TOR,TBA,1,8,8-1,TBA,9,0,34,43,77,174,133,307,6,16,22,5,2:58
7139,449040,2016-09-14,2016,NYA,LAN,0,2,2-0,LAN,9,0,33,34,67,151,132,283,5,6,11,1,2:57 (1:00 delay)
7140,449046,2016-09-14,2016,PHI,PIT,6,2,6-2,PHI,9,1,39,37,76,146,120,266,15,15,30,4,2:57
7141,449042,2016-09-14,2016,CIN,MIL,0,7,7-0,MIL,9,0,34,39,73,176,120,296,9,12,21,0,3:01
7142,449045,2016-09-14,2016,KCA,OAK,0,8,8-0,OAK,9,0,33,48,81,200,119,319,7,21,28,2,2:56
7143,449041,2016-09-14,2016,ATL,MIA,5,7,7-5,MIA,9,0,36,37,73,140,139,279,12,11,23,4,3:04
7144,449037,2016-09-14,2016,SLN,CHN,0,7,7-0,CHN,9,0,29,40,69,157,121,278,4,14,18,0,2:37
7145,449050,2016-09-14,2016,HOU,TEX,8,4,8-4,HOU,9,1,37,38,75,157,148,305,16,10,26,4,3:08
7146,449039,2016-09-14,2016,ARI,COL,11,6,11-6,ARI,9,1,47,42,89,176,190,366,22,17,39,7,3:49
7147,449058,2016-09-15,2016,SFN,SLN,6,2,6-2,SFN,9,1,39,33,72,105,134,239,17,6,23,2,2:33
7148,449052,2016-09-15,2016,ARI,LAN,7,3,7-3,ARI,9,1,33,37,70,119,143,262,9,11,20,2,2:39
7149,449054,2016-09-15,2016,DET,MIN,1,5,5-1,MIN,9,0,37,38,75,148,151,299,12,14,26,3,3:04
7150,449056,2016-09-15,2016,KCA,OAK,5,14,14-5,OAK,9,0,37,49,86,202,127,329,10,21,31,2,3:19
7151,449059,2016-09-15,2016,BAL,TBA,6,7,7-6,TBA,9,0,41,41,82,163,160,323,14,15,29,4,3:27
7152,449057,2016-09-15,2016,PHI,PIT,2,15,15-2,PIT,9,0,32,43,75,178,118,296,5,16,21,2,2:54
7153,449053,2016-09-15,2016,CHN,MIL,4,5,5-4,MIL,9,0,40,36,76,136,161,297,15,9,24,2,3:10
7154,449051,2016-09-15,2016,CHA,CLE,2,1,2-1,CHA,9,0,35,37,72,150,167,317,12,10,22,3,3:12
7155,449060,2016-09-15,2016,ANA,TOR,2,7,7-2,TOR,9,0,37,40,77,178,133,311,9,16,25,3,3:15
7156,449055,2016-09-15,2016,BOS,NYA,7,5,7-5,BOS,9,0,41,44,85,171,149,320,15,18,33,3,3:52
7157,449067,2016-09-16,2016,NYN,MIN,3,0,3-0,NYN,9,1,35,33,68,124,137,261,12,7,19,1,2:41
7158,449073,2016-09-16,2016,BAL,TBA,5,4,5-4,BAL,9,1,38,35,73,124,151,275,14,10,24,2,2:44
7159,449068,2016-09-16,2016,BOS,NYA,7,4,7-4,BOS,9,1,35,39,74,151,122,273,16,14,30,5,3:13
7160,449061,2016-09-16,2016,KCA,CHA,4,7,7-4,CHA,9,0,35,41,76,173,119,292,8,15,23,1,3:00
7161,449075,2016-09-16,2016,ATL,WAS,2,7,7-2,WAS,9,0,38,40,78,158,135,293,11,17,28,3,3:14
7162,449064,2016-09-16,2016,ARI,LAN,2,3,3-2,LAN,9,0,40,35,75,144,174,318,13,10,23,3,3:32
7163,449074,2016-09-16,2016,ANA,TOR,0,5,5-0,TOR,9,0,40,41,81,160,141,301,13,17,30,4,3:15
7164,449072,2016-09-16,2016,SFN,SLN,8,2,8-2,SFN,9,1,37,38,75,154,131,285,13,12,25,2,2:57
7165,449071,2016-09-16,2016,COL,SDN,8,7,8-7,COL,9,0,43,39,82,146,174,320,17,14,31,4,3:31 (:38 delay)
7166,449062,2016-09-16,2016,CLE,DET,11,4,11-4,CLE,9,1,42,37,79,134,180,314,20,10,30,1,3:31
7167,449070,2016-09-16,2016,CIN,PIT,7,9,9-7,PIT,10,0,41,48,89,192,163,355,11,20,31,3,3:55 (:31 delay)
7168,449069,2016-09-16,2016,TEX,OAK,7,6,7-6,TEX,9,0,42,39,81,147,138,285,16,13,29,1,3:02
7169,449065,2016-09-16,2016,PHI,MIA,4,3,4-3,PHI,13,0,53,57,110,216,207,423,19,19,38,4,4:43
7170,449063,2016-09-16,2016,SEA,HOU,0,6,6-0,HOU,9,0,32,42,74,164,132,296,6,14,20,2,2:58
7171,449066,2016-09-16,2016,CHN,MIL,5,4,5-4,CHN,10,0,39,40,79,139,143,282,16,12,28,2,3:13
7172,447363,2016-09-17,2016,CIN,PIT,4,10,10-4,PIT,9,0,39,48,87,196,144,340,13,22,35,1,3:20 (1:02 delay)
7173,449078,2016-09-17,2016,SEA,HOU,1,2,2-1,HOU,9,0,34,33,67,118,142,260,8,7,15,0,2:33
7174,449086,2016-09-17,2016,COL,SDN,8,0,8-0,COL,9,1,38,31,69,113,153,266,15,4,19,2,2:53
7175,449079,2016-09-17,2016,ARI,LAN,2,6,6-2,LAN,9,0,34,41,75,149,135,284,7,16,23,4,3:12
7176,447363,2016-09-17,2016,CIN,PIT,4,10,10-4,PIT,9,0,39,48,87,196,144,340,13,22,35,1,3:20 (1:02 delay)
7177,449082,2016-09-17,2016,NYN,MIN,3,2,3-2,NYN,12,0,49,50,99,213,191,404,16,14,30,3,4:15
7178,449080,2016-09-17,2016,PHI,MIA,8,0,8-0,PHI,9,1,40,30,70,106,144,250,17,5,22,1,2:42
7179,449089,2016-09-17,2016,ANA,TOR,6,1,6-1,ANA,9,1,34,40,74,162,117,279,10,14,24,3,3:08
7180,449076,2016-09-17,2016,KCA,CHA,3,2,3-2,KCA,9,1,31,37,68,141,105,246,8,9,17,1,2:36
7181,449088,2016-09-17,2016,BAL,TBA,2,5,5-2,TBA,9,0,33,38,71,157,114,271,8,10,18,3,3:00
7182,449087,2016-09-17,2016,SFN,SLN,2,3,3-2,SLN,9,0,36,36,72,148,122,270,10,12,22,4,2:53
7183,449083,2016-09-17,2016,BOS,NYA,6,5,6-5,BOS,9,1,37,37,74,165,138,303,14,11,25,5,3:36
7184,449081,2016-09-17,2016,CHN,MIL,3,11,11-3,MIL,9,0,36,41,77,159,146,305,11,15,26,0,3:02
7185,449084,2016-09-17,2016,TEX,OAK,2,11,11-2,OAK,9,0,33,44,77,159,119,278,7,17,24,2,2:52
7186,449077,2016-09-17,2016,CLE,DET,1,0,1-0,CLE,10,0,41,36,77,158,174,332,15,9,24,3,3:53 (:10 delay)
7187,449090,2016-09-17,2016,ATL,WAS,7,3,7-3,ATL,9,1,38,38,76,173,155,328,17,11,28,1,3:26
7188,449085,2016-09-17,2016,CIN,PIT,3,7,7-3,PIT,9,0,34,47,81,197,144,341,9,20,29,3,3:29
7189,449102,2016-09-18,2016,SFN,SLN,0,3,3-0,SLN,9,0,34,33,67,117,114,231,7,10,17,4,2:49
7190,449105,2016-09-18,2016,ATL,WAS,6,2,6-2,ATL,7,0,35,27,62,98,141,239,18,8,26,4,2:36 (2:57 delay)
7191,449096,2016-09-18,2016,CHN,MIL,1,3,3-1,MIL,9,0,39,35,74,130,134,264,12,8,20,1,2:37
7192,449091,2016-09-18,2016,KCA,CHA,10,3,10-3,KCA,9,1,40,38,78,137,129,266,17,13,30,1,3:04
7193,449100,2016-09-18,2016,CIN,PIT,7,4,7-4,CIN,9,1,40,38,78,155,131,286,16,11,27,0,2:52
7194,449099,2016-09-18,2016,TEX,OAK,2,5,5-2,OAK,9,0,38,40,78,142,152,294,13,14,27,4,3:11
7195,449103,2016-09-18,2016,BAL,TBA,2,1,2-1,BAL,9,1,34,35,69,150,143,293,9,10,19,1,3:01
7196,449104,2016-09-18,2016,ANA,TOR,4,0,4-0,ANA,9,1,39,34,73,145,146,291,14,9,23,3,3:25
7197,449101,2016-09-18,2016,COL,SDN,6,3,6-3,COL,9,1,40,35,75,147,159,306,16,9,25,3,3:20
7198,449092,2016-09-18,2016,CLE,DET,5,9,9-5,DET,9,0,35,44,79,159,147,306,8,19,27,3,3:38
7199,449095,2016-09-18,2016,PHI,MIA,4,5,5-4,MIA,9,0,38,38,76,144,162,306,13,11,24,3,3:16
7200,449097,2016-09-18,2016,NYN,MIN,3,2,3-2,NYN,9,1,32,37,69,153,113,266,10,10,20,4,2:58
7201,449098,2016-09-18,2016,BOS,NYA,5,4,5-4,BOS,9,1,37,40,77,138,156,294,13,13,26,4,3:31
7202,449093,2016-09-18,2016,SEA,HOU,7,3,7-3,SEA,9,1,38,33,71,127,138,265,16,7,23,4,2:33
7203,449094,2016-09-18,2016,ARI,LAN,10,9,10-9,ARI,12,0,59,53,112,209,206,415,26,17,43,7,4:29
7204,447572,2016-09-19,2016,KCA,CHA,8,3,8-3,KCA,9,1,39,36,75,106,152,258,15,10,25,1,2:35
7205,449110,2016-09-19,2016,OAK,HOU,2,4,4-2,HOU,9,0,32,35,67,129,124,253,6,10,16,4,2:41
7206,449113,2016-09-19,2016,COL,SLN,3,5,5-3,SLN,9,0,40,38,78,115,171,286,13,12,25,2,3:01
7207,449112,2016-09-19,2016,LAN,SFN,2,1,2-1,LAN,9,0,32,30,62,117,136,253,8,4,12,4,2:58
7208,449106,2016-09-19,2016,SDN,ARI,3,2,3-2,SDN,9,1,34,34,68,126,142,268,11,9,20,2,2:46
7209,449111,2016-09-19,2016,TEX,ANA,3,2,3-2,TEX,9,0,38,34,72,104,155,259,17,6,23,2,3:00 (:38 delay)
7210,449108,2016-09-19,2016,BAL,BOS,2,5,5-2,BOS,9,0,32,37,69,152,89,241,5,12,17,3,2:33
7211,449115,2016-09-19,2016,MIA,WAS,4,3,4-3,MIA,9,1,34,34,68,124,153,277,10,9,19,2,2:50
7212,447572,2016-09-19,2016,KCA,CHA,8,3,8-3,KCA,9,1,39,36,75,106,152,258,15,10,25,1,2:35
7213,449109,2016-09-19,2016,CHN,CIN,5,2,5-2,CHN,9,1,34,35,69,140,120,260,10,8,18,1,2:42
7214,449114,2016-09-19,2016,SEA,TOR,2,3,3-2,TOR,9,0,35,39,74,160,143,303,8,13,21,4,3:03
7215,449107,2016-09-19,2016,NYN,ATL,3,7,7-3,ATL,9,0,37,44,81,189,142,331,10,17,27,2,3:11
7216,449130,2016-09-20,2016,MIA,WAS,1,0,1-0,MIA,9,1,30,31,61,127,98,225,6,4,10,0,2:11
7217,449118,2016-09-20,2016,BAL,BOS,2,5,5-2,BOS,9,0,35,39,74,141,134,275,8,12,20,5,3:14
7218,449120,2016-09-20,2016,CHN,CIN,6,1,6-1,CHN,9,1,40,36,76,128,172,300,18,10,28,1,2:58
7219,449119,2016-09-20,2016,PHI,CHA,7,6,7-6,PHI,9,1,38,38,76,164,137,301,15,15,30,2,3:20
7220,449128,2016-09-20,2016,COL,SLN,5,10,10-5,SLN,9,0,39,46,85,167,144,311,14,20,34,3,3:21
7221,449117,2016-09-20,2016,NYN,ATL,4,5,5-4,ATL,9,0,39,40,79,159,153,312,12,15,27,5,3:28
7222,449121,2016-09-20,2016,MIN,DET,1,8,8-1,DET,9,0,31,41,72,159,118,277,5,14,19,1,2:46
7223,449116,2016-09-20,2016,SDN,ARI,5,2,5-2,SDN,9,1,34,33,67,129,150,279,13,6,19,1,2:57 (1:10 delay)
7224,449123,2016-09-20,2016,CLE,KCA,2,1,2-1,CLE,9,0,36,32,68,120,137,257,9,6,15,4,2:45
7225,449122,2016-09-20,2016,OAK,HOU,1,2,2-1,HOU,10,0,37,39,76,135,151,286,8,11,19,1,3:01
7226,449125,2016-09-20,2016,TBA,NYA,3,5,5-3,NYA,9,0,34,41,75,145,148,293,6,15,21,2,2:49
7227,449126,2016-09-20,2016,MIL,PIT,3,6,6-3,PIT,9,0,36,39,75,158,149,307,10,15,25,3,3:08
7228,449127,2016-09-20,2016,LAN,SFN,0,2,2-0,SFN,9,0,37,38,75,163,145,308,11,14,25,3,3:36
7229,449129,2016-09-20,2016,SEA,TOR,2,10,10-2,TOR,9,0,37,44,81,179,164,343,10,19,29,2,3:33
7230,449124,2016-09-20,2016,TEX,ANA,5,4,5-4,TEX,9,1,38,42,80,164,144,308,17,18,35,4,3:22
7231,449135,2016-09-21,2016,CHN,CIN,9,2,9-2,CHN,9,1,45,34,79,113,182,295,22,8,30,4,3:12
7232,449140,2016-09-21,2016,TBA,NYA,5,11,11-5,NYA,9,0,36,47,83,168,147,315,10,20,30,3,3:06
7233,449142,2016-09-21,2016,LAN,SFN,9,3,9-3,LAN,9,1,37,36,73,153,140,293,15,9,24,1,3:03
7234,449139,2016-09-21,2016,TEX,ANA,4,5,5-4,ANA,9,0,37,38,75,128,130,258,11,12,23,2,2:46
7235,449134,2016-09-21,2016,PHI,CHA,8,3,8-3,PHI,9,1,40,35,75,121,145,266,17,10,27,1,2:43
7236,449131,2016-09-21,2016,SDN,ARI,2,3,3-2,ARI,9,0,36,31,67,116,160,276,11,6,17,2,2:50
7237,449133,2016-09-21,2016,BAL,BOS,1,5,5-1,BOS,9,0,34,37,71,155,113,268,6,10,16,4,2:55
7238,449138,2016-09-21,2016,CLE,KCA,4,3,4-3,CLE,9,1,38,35,73,149,164,313,18,10,28,4,3:20
7239,449143,2016-09-21,2016,COL,SLN,11,1,11-1,COL,9,1,38,38,76,148,132,280,15,11,26,1,2:43
7240,449141,2016-09-21,2016,MIL,PIT,1,4,4-1,PIT,9,0,34,38,72,128,142,270,8,11,19,0,2:51
7241,449137,2016-09-21,2016,OAK,HOU,5,6,6-5,HOU,9,0,38,39,77,144,162,306,11,12,23,5,3:13
7242,449132,2016-09-21,2016,NYN,ATL,3,4,4-3,ATL,9,0,39,38,77,136,147,283,15,11,26,5,3:17
7243,449145,2016-09-21,2016,MIA,WAS,3,8,8-3,WAS,9,0,33,39,72,179,135,314,6,12,18,2,3:10
7244,449144,2016-09-21,2016,SEA,TOR,2,1,2-1,SEA,12,0,48,45,93,203,208,411,13,12,25,6,4:23
7245,449147,2016-09-22,2016,BAL,BOS,3,5,5-3,BOS,9,0,36,42,78,185,126,311,9,16,25,2,3:19
7246,449136,2016-09-22,2016,MIN,DET,2,9,9-2,DET,9,0,34,41,75,165,148,313,8,17,25,3,3:09
7247,449155,2016-09-22,2016,SDN,SFN,1,2,2-1,SFN,9,0,33,36,69,124,139,263,6,9,15,2,2:55
7248,449152,2016-09-22,2016,TBA,NYA,2,0,2-0,TBA,9,1,30,38,68,147,118,265,9,11,20,1,2:37
7249,449154,2016-09-22,2016,MIL,PIT,3,1,3-1,MIL,9,1,30,33,63,132,124,256,7,8,15,2,2:39
7250,449150,2016-09-22,2016,CLE,KCA,5,2,5-2,CLE,9,1,33,34,67,138,135,273,11,8,19,1,2:40
7251,449151,2016-09-22,2016,HOU,ANA,0,2,2-0,ANA,9,0,32,34,66,135,130,265,9,8,17,1,2:41
7252,449136,2016-09-22,2016,MIN,DET,2,9,9-2,DET,9,0,34,41,75,165,148,313,8,17,25,3,3:09
7253,449149,2016-09-22,2016,MIN,DET,2,4,4-2,DET,9,0,35,36,71,149,167,316,9,10,19,0,3:10
7254,449148,2016-09-22,2016,LAN,COL,7,4,7-4,LAN,9,1,39,34,73,116,152,268,17,8,25,2,2:56
7255,449146,2016-09-22,2016,MIA,ATL,3,6,6-3,ATL,9,0,37,37,74,152,142,294,11,11,22,1,2:46
7256,449153,2016-09-22,2016,NYN,PHI,9,8,9-8,NYN,11,0,47,50,97,214,195,409,16,19,35,7,4:23
7257,449169,2016-09-23,2016,OAK,TEX,0,3,3-0,TEX,9,0,34,32,66,97,144,241,10,5,15,0,2:19
7258,449160,2016-09-23,2016,MIL,CIN,5,4,5-4,MIL,9,1,35,36,71,127,130,257,12,9,21,3,2:48
7259,449158,2016-09-23,2016,TBA,BOS,1,2,2-1,BOS,9,0,34,40,74,151,142,293,9,15,24,3,2:52
7260,449168,2016-09-23,2016,CHN,SLN,5,0,5-0,CHN,9,1,39,30,69,127,167,294,15,7,22,4,2:53
7261,449159,2016-09-23,2016,CLE,CHA,10,4,10-4,CLE,9,1,42,34,76,125,166,291,17,9,26,4,3:02
7262,449162,2016-09-23,2016,DET,KCA,8,3,8-3,DET,9,1,41,38,79,143,167,310,16,12,28,2,3:10
7263,449157,2016-09-23,2016,MIA,ATL,2,3,3-2,ATL,9,0,33,39,72,169,147,316,7,16,23,1,3:08
7264,449163,2016-09-23,2016,HOU,ANA,6,10,10-6,ANA,9,0,38,45,83,179,137,316,13,20,33,4,3:24
7265,449167,2016-09-23,2016,MIN,SEA,1,10,10-1,SEA,9,0,32,47,79,209,122,331,6,20,26,3,3:04 (:36 delay)
7266,449165,2016-09-23,2016,NYN,PHI,10,5,10-5,NYN,9,1,39,42,81,169,150,319,14,15,29,6,3:40
7267,449166,2016-09-23,2016,SDN,SFN,7,2,7-2,SDN,9,1,34,36,70,137,123,260,12,9,21,3,2:54
7268,449170,2016-09-23,2016,PIT,WAS,6,5,6-5,PIT,11,0,51,50,101,198,205,403,20,16,36,6,4:36
7269,449164,2016-09-23,2016,TOR,NYA,9,0,9-0,TOR,9,1,42,33,75,137,158,295,21,6,27,1,3:06
7270,449161,2016-09-23,2016,LAN,COL,5,2,5-2,LAN,9,1,38,36,74,151,179,330,16,10,26,1,3:39 (:37 delay)
7271,449156,2016-09-23,2016,BAL,ARI,3,2,3-2,BAL,12,0,50,45,95,184,186,370,17,11,28,2,4:00
7272,449172,2016-09-24,2016,MIA,ATL,6,4,6-4,MIA,9,1,39,37,76,141,160,301,17,11,28,2,3:21
7273,449174,2016-09-24,2016,CLE,CHA,1,8,8-1,CHA,9,0,37,43,80,179,148,327,12,16,28,3,3:28
7274,449182,2016-09-24,2016,MIN,SEA,3,2,3-2,MIN,9,1,28,33,61,110,87,197,4,5,9,0,2:06
7275,449181,2016-09-24,2016,SDN,SFN,6,9,9-6,SFN,10,0,39,48,87,173,150,323,9,16,25,4,3:43
7276,449177,2016-09-24,2016,DET,KCA,4,7,7-4,KCA,9,0,45,41,86,157,183,340,19,13,32,4,3:50
7277,449171,2016-09-24,2016,BAL,ARI,6,1,6-1,BAL,9,1,38,34,72,118,149,267,16,7,23,2,2:36
7278,449184,2016-09-24,2016,OAK,TEX,0,5,5-0,TEX,9,0,35,37,72,124,145,269,8,10,18,2,2:58
7279,449179,2016-09-24,2016,TOR,NYA,3,0,3-0,TOR,9,1,33,30,63,139,117,256,11,6,17,0,2:34
7280,449173,2016-09-24,2016,TBA,BOS,4,6,6-4,BOS,9,0,38,35,73,135,158,293,12,10,22,5,3:10
7281,449175,2016-09-24,2016,MIL,CIN,1,6,6-1,CIN,9,0,34,42,76,154,137,291,8,19,27,1,3:01
7282,449185,2016-09-24,2016,PIT,WAS,1,6,6-1,WAS,9,0,39,43,82,161,156,317,12,16,28,3,3:28
7283,449178,2016-09-24,2016,HOU,ANA,4,10,10-4,ANA,9,0,39,43,82,174,153,327,13,17,30,5,3:32
7284,449176,2016-09-24,2016,LAN,COL,14,1,14-1,LAN,9,1,47,32,79,120,196,316,23,6,29,2,3:04
7285,449183,2016-09-24,2016,CHN,SLN,4,10,10-4,SLN,9,0,37,45,82,177,155,332,11,19,30,3,3:19
7286,449180,2016-09-24,2016,NYN,PHI,8,10,10-8,PHI,9,0,44,47,91,187,185,372,17,23,40,2,3:47
7287,449199,2016-09-25,2016,OAK,TEX,7,1,7-1,OAK,9,1,38,31,69,106,127,233,16,5,21,2,2:31
7288,449193,2016-09-25,2016,HOU,ANA,4,1,4-1,HOU,9,1,30,34,64,134,122,256,11,9,20,0,2:23
7289,449189,2016-09-25,2016,CLE,CHA,0,3,3-0,CHA,9,0,32,36,68,153,120,273,5,8,13,2,2:46
7290,449190,2016-09-25,2016,MIL,CIN,2,4,4-2,CIN,9,0,33,35,68,120,136,256,7,11,18,0,2:41
7291,449186,2016-09-25,2016,BAL,ARI,2,1,2-1,BAL,9,1,31,35,66,154,132,286,8,8,16,0,2:43
7292,449198,2016-09-25,2016,CHN,SLN,3,1,3-1,CHN,9,1,36,35,71,146,142,288,15,8,23,3,3:09
7293,449197,2016-09-25,2016,MIN,SEA,3,4,4-3,SEA,9,0,38,37,75,148,142,290,13,9,22,3,3:03
7294,449196,2016-09-25,2016,SDN,SFN,4,3,4-3,SDN,9,1,34,37,71,128,155,283,13,10,23,4,3:05
7295,449191,2016-09-25,2016,LAN,COL,4,3,4-3,LAN,10,0,44,38,82,157,153,310,15,11,26,4,3:33
7296,449192,2016-09-25,2016,DET,KCA,9,12,12-9,KCA,9,0,48,46,94,173,184,357,22,20,42,3,3:51
7297,449200,2016-09-25,2016,PIT,WAS,7,10,10-7,WAS,9,0,38,46,84,186,168,354,12,21,33,6,4:01
7298,449188,2016-09-25,2016,TBA,BOS,2,3,3-2,BOS,10,0,40,41,81,210,184,394,11,14,25,4,4:01
7299,449194,2016-09-25,2016,TOR,NYA,4,3,4-3,TOR,9,0,39,37,76,146,167,313,16,10,26,2,3:19
7300,449195,2016-09-25,2016,NYN,PHI,17,0,17-0,NYN,9,1,50,32,82,133,201,334,27,5,32,3,3:32
7301,449208,2016-09-26,2016,ANA,OAK,2,1,2-1,ANA,9,1,32,32,64,142,113,255,10,6,16,0,2:35
7302,449205,2016-09-26,2016,TEX,MIL,3,8,8-3,MIL,9,0,36,38,74,118,144,262,9,13,22,1,2:51
7303,449210,2016-09-26,2016,CHA,TBA,7,1,7-1,CHA,9,1,37,38,75,150,151,301,13,14,27,2,3:04
7304,449207,2016-09-26,2016,TOR,NYA,5,7,7-5,NYA,9,0,42,40,82,134,159,293,16,14,30,7,3:22
7305,449204,2016-09-26,2016,DET,CLE,4,7,7-4,CLE,9,0,38,42,80,158,148,306,13,14,27,2,3:25
7306,449203,2016-09-26,2016,SLN,CIN,2,15,15-2,CIN,9,0,32,51,83,172,106,278,6,25,31,2,2:48
7307,449201,2016-09-26,2016,WAS,ARI,4,14,14-4,ARI,9,0,38,44,82,168,161,329,14,16,30,2,3:21 (:20 delay)
7308,449202,2016-09-26,2016,PIT,CHN,2,12,12-2,CHN,9,0,38,52,90,233,159,392,11,25,36,2,3:34
7309,449206,2016-09-26,2016,MIA,NYN,7,3,7-3,MIA,9,1,40,40,80,172,154,326,17,13,30,4,3:28
7310,449209,2016-09-26,2016,HOU,SEA,3,4,4-3,SEA,11,0,42,51,93,189,178,367,12,20,32,0,3:52
7311,449211,2016-09-27,2016,WAS,ARI,4,2,4-2,WAS,9,1,30,35,65,128,112,240,6,8,14,1,2:40
7312,449212,2016-09-27,2016,TOR,BAL,5,1,5-1,TOR,9,1,34,37,71,136,132,268,12,11,23,0,2:39
7313,449213,2016-09-27,2016,NYA,BOS,6,4,6-4,NYA,9,1,35,39,74,146,100,246,15,13,28,4,3:09
7314,449222,2016-09-27,2016,ANA,OAK,8,1,8-1,ANA,9,1,35,33,68,130,120,250,13,9,22,1,2:34
7315,449224,2016-09-27,2016,HOU,SEA,8,4,8-4,HOU,9,1,37,37,74,143,116,259,14,12,26,3,2:55
7316,449216,2016-09-27,2016,DET,CLE,12,0,12-0,DET,9,1,41,31,72,122,161,283,23,5,28,2,3:01
7317,449218,2016-09-27,2016,SDN,LAN,7,1,7-1,SDN,9,1,33,38,71,156,131,287,10,11,21,2,3:02
7318,449219,2016-09-27,2016,TEX,MIL,6,4,6-4,TEX,9,1,36,40,76,158,136,294,13,15,28,2,3:10
7319,449225,2016-09-27,2016,CHA,TBA,13,6,13-6,CHA,9,1,44,40,84,139,168,307,19,12,31,1,2:57
7320,449217,2016-09-27,2016,SFN,COL,12,3,12-3,SFN,9,1,45,36,81,128,160,288,23,9,32,3,3:05
7321,449223,2016-09-27,2016,ATL,PHI,7,6,7-6,ATL,9,1,37,45,82,165,141,306,14,20,34,3,3:02 (2:24 delay)
7322,449215,2016-09-27,2016,SLN,CIN,12,5,12-5,SLN,9,1,41,41,82,149,184,333,18,14,32,2,3:17
7323,449214,2016-09-27,2016,PIT,CHN,4,6,6-4,CHN,9,0,42,44,86,190,185,375,17,16,33,4,3:49
7324,449220,2016-09-27,2016,KCA,MIN,4,3,4-3,KCA,11,0,40,46,86,198,162,360,14,15,29,6,3:45
7325,449221,2016-09-27,2016,MIA,NYN,1,12,12-1,NYN,9,0,33,51,84,184,132,316,7,27,34,5,3:20
7326,449226,2016-09-28,2016,WAS,ARI,0,3,3-0,ARI,6,1,19,26,45,112,74,186,6,12,18,1,1:55 (1:42 delay)
7327,449240,2016-09-28,2016,CHA,TBA,1,0,1-0,CHA,9,1,31,29,60,103,121,224,8,3,11,2,2:10 (1:37 delay)
7328,449232,2016-09-28,2016,SFN,COL,0,2,2-0,COL,9,0,30,36,66,141,124,265,7,11,18,3,2:55
7329,449234,2016-09-28,2016,TEX,MIL,8,5,8-5,TEX,9,1,38,35,73,129,143,272,13,11,24,1,2:59
7330,449227,2016-09-28,2016,TOR,BAL,2,3,3-2,BAL,9,0,37,38,75,151,147,298,12,12,24,4,3:04
7331,449230,2016-09-28,2016,SLN,CIN,1,2,2-1,CIN,9,0,36,39,75,166,121,287,11,10,21,2,2:48
7332,449238,2016-09-28,2016,ATL,PHI,12,2,12-2,ATL,9,1,41,34,75,137,135,272,18,8,26,1,2:45
7333,449233,2016-09-28,2016,SDN,LAN,6,5,6-5,SDN,9,1,33,36,69,121,141,262,12,10,22,2,2:45
7334,449229,2016-09-28,2016,PIT,CHN,8,4,8-4,PIT,9,1,39,37,76,149,152,301,16,9,25,3,3:05
7335,449237,2016-09-28,2016,ANA,OAK,8,6,8-6,ANA,9,1,41,38,79,157,158,315,15,11,26,2,3:18
7336,449235,2016-09-28,2016,KCA,MIN,5,2,5-2,KCA,9,1,35,37,72,164,133,297,12,11,23,4,2:58
7337,449231,2016-09-28,2016,DET,CLE,6,3,6-3,DET,5,0,24,26,50,114,96,210,10,12,22,1,2:02 (1:57 delay)
7338,449228,2016-09-28,2016,NYA,BOS,5,3,5-3,NYA,9,0,34,39,73,144,162,306,9,16,25,3,3:28
7339,449239,2016-09-28,2016,HOU,SEA,4,12,12-4,SEA,9,0,39,48,87,179,140,319,13,24,37,3,3:12
7340,449236,2016-09-28,2016,MIA,NYN,2,5,5-2,NYN,9,0,37,42,79,156,143,299,11,15,26,2,2:57
7341,449244,2016-09-29,2016,PIT,CHN,1,1,1-1,CHN,6,1,19,20,39,57,71,128,4,4,8,1,1:15 (1:23 delay)
7342,449242,2016-09-29,2016,TOR,BAL,0,4,4-0,BAL,9,0,32,38,70,121,143,264,6,11,17,3,2:35
7343,449250,2016-09-29,2016,SEA,OAK,3,2,3-2,SEA,9,1,37,35,72,127,152,279,14,9,23,4,2:54
7344,449243,2016-09-29,2016,NYA,BOS,5,1,5-1,NYA,9,1,39,31,70,124,163,287,15,6,21,4,3:17
7345,449241,2016-09-29,2016,WAS,ARI,5,3,5-3,WAS,9,1,35,36,71,156,117,273,11,9,20,3,2:55
7346,449247,2016-09-29,2016,SFN,COL,7,2,7-2,SFN,9,1,41,37,78,143,143,286,17,12,29,5,3:15
7347,449251,2016-09-29,2016,ATL,PHI,5,2,5-2,ATL,9,1,37,36,73,146,158,304,15,10,25,5,3:18
7348,449252,2016-09-29,2016,CHA,TBA,3,5,5-3,TBA,9,0,35,41,76,171,140,311,10,16,26,2,3:15 (:35 delay)
7349,449249,2016-09-29,2016,KCA,MIN,6,7,7-6,MIN,9,0,40,42,82,162,137,299,16,16,32,4,3:16
7350,449245,2016-09-29,2016,SLN,CIN,4,3,4-3,SLN,9,0,39,40,79,171,140,311,13,15,28,1,3:16
7351,449248,2016-09-29,2016,SDN,LAN,4,9,9-4,LAN,9,0,42,44,86,159,163,322,16,17,33,2,3:38
7352,449263,2016-09-30,2016,SEA,OAK,5,1,5-1,SEA,9,1,32,33,65,144,122,266,8,7,15,1,2:35
7353,449266,2016-09-30,2016,TEX,TBA,3,1,3-1,TEX,9,1,34,35,69,142,131,273,11,6,17,3,3:00
7354,449260,2016-09-30,2016,COL,MIL,4,1,4-1,COL,9,1,31,38,69,139,111,250,10,14,24,1,2:30
7355,449254,2016-09-30,2016,CIN,CHN,3,7,7-3,CHN,9,0,33,37,70,143,133,276,6,12,18,2,2:39
7356,449265,2016-09-30,2016,ARI,SDN,5,3,5-3,ARI,9,1,31,39,70,148,119,267,8,12,20,2,2:51
7357,449255,2016-09-30,2016,KCA,CLE,2,7,7-2,CLE,9,0,31,40,71,159,110,269,5,15,20,2,2:36
7358,449261,2016-09-30,2016,CHA,MIN,7,3,7-3,CHA,9,1,38,36,74,139,167,306,14,11,25,3,2:56
7359,449257,2016-09-30,2016,ANA,HOU,7,1,7-1,ANA,9,1,34,35,69,135,139,274,10,10,20,1,2:40
7360,449264,2016-09-30,2016,SLN,PIT,7,0,7-0,SLN,9,1,36,33,69,123,143,266,13,6,19,1,2:42 (:47 delay)
7361,449256,2016-09-30,2016,ATL,DET,2,6,6-2,DET,9,0,36,42,78,153,155,308,9,15,24,3,3:21
7362,449253,2016-09-30,2016,NYA,BAL,1,8,8-1,BAL,9,0,36,46,82,182,155,337,9,18,27,1,3:26
7363,449262,2016-09-30,2016,PHI,NYN,1,5,5-1,NYN,9,0,36,37,73,161,129,290,10,10,20,2,2:53
7364,449259,2016-09-30,2016,WAS,MIA,4,7,7-4,MIA,9,0,36,44,80,141,153,294,10,17,27,3,3:08 (1:43 delay)
7365,449258,2016-09-30,2016,SFN,LAN,9,3,9-3,SFN,9,1,43,35,78,128,170,298,19,10,29,3,3:15
7366,449267,2016-09-30,2016,BOS,TOR,5,3,5-3,BOS,9,1,37,43,80,160,165,325,12,16,28,2,3:25
7367,449273,2016-10-01,2016,SFN,LAN,3,0,3-0,SFN,9,1,34,30,64,110,107,217,10,4,14,0,2:15
7368,449281,2016-10-01,2016,TEX,TBA,1,4,4-1,TBA,9,0,33,35,68,124,135,259,5,7,12,1,2:39
7369,449276,2016-10-01,2016,CHA,MIN,0,6,6-0,MIN,9,0,33,36,69,138,141,279,7,8,15,1,2:32
7370,449279,2016-10-01,2016,SLN,PIT,4,3,4-3,SLN,9,1,35,36,71,153,131,284,13,9,22,2,3:12
7371,449280,2016-10-01,2016,ARI,SDN,9,5,9-5,ARI,9,1,35,39,74,137,127,264,14,12,26,3,2:46
7372,449272,2016-10-01,2016,ANA,HOU,0,3,3-0,HOU,9,0,34,41,75,161,123,284,7,15,22,2,2:55
7373,449268,2016-10-01,2016,NYA,BAL,7,3,7-3,NYA,9,1,38,38,76,140,160,300,16,13,29,4,2:54
7374,449274,2016-10-01,2016,WAS,MIA,2,1,2-1,WAS,9,1,32,35,67,164,119,283,11,10,21,3,3:03
7375,449282,2016-10-01,2016,BOS,TOR,3,4,4-3,TOR,9,0,37,37,74,171,149,320,11,11,22,3,3:29
7376,449271,2016-10-01,2016,ATL,DET,5,3,5-3,ATL,9,1,35,36,71,135,122,257,11,10,21,3,2:51
7377,449277,2016-10-01,2016,PHI,NYN,3,5,5-3,NYN,9,0,35,39,74,149,133,282,9,15,24,2,3:01
7378,449269,2016-10-01,2016,CIN,CHN,7,4,7-4,CIN,9,1,39,36,75,147,180,327,16,11,27,0,3:08
7379,449270,2016-10-01,2016,KCA,CLE,3,6,6-3,CLE,9,0,38,43,81,177,150,327,11,17,28,2,3:22
7380,449275,2016-10-01,2016,COL,MIL,3,4,4-3,MIL,10,0,42,41,83,156,160,316,14,12,26,1,3:26
7381,449278,2016-10-01,2016,SEA,OAK,8,9,9-8,OAK,10,0,50,47,97,162,201,363,20,19,39,5,4:01
7382,449286,2016-10-02,2016,ATL,DET,1,0,1-0,ATL,9,1,30,32,62,132,119,251,8,6,14,0,2:47
7383,449285,2016-10-02,2016,KCA,CLE,2,3,3-2,CLE,9,0,32,35,67,129,110,239,7,8,15,2,2:26
7384,449295,2016-10-02,2016,ARI,SDN,3,2,3-2,ARI,9,0,36,34,70,120,116,236,12,7,19,1,2:37
7385,449292,2016-10-02,2016,PHI,NYN,5,2,5-2,PHI,9,1,36,35,71,144,106,250,12,10,22,3,2:39
7386,449283,2016-10-02,2016,NYA,BAL,2,5,5-2,BAL,9,0,37,33,70,127,126,253,11,8,19,2,2:32
7387,449293,2016-10-02,2016,SEA,OAK,2,3,3-2,OAK,9,0,33,35,68,132,137,269,7,11,18,0,2:34
7388,449287,2016-10-02,2016,ANA,HOU,8,1,8-1,ANA,9,1,39,34,73,120,151,271,15,8,23,2,2:42
7389,449297,2016-10-02,2016,BOS,TOR,1,2,2-1,TOR,9,0,34,38,72,150,139,289,8,13,21,3,3:14
7390,449294,2016-10-02,2016,SLN,PIT,10,4,10-4,SLN,9,1,42,39,81,138,158,296,16,13,29,2,3:12
7391,449291,2016-10-02,2016,CHA,MIN,3,6,6-3,MIN,9,0,38,41,79,163,155,318,11,14,25,2,3:01
7392,449288,2016-10-02,2016,SFN,LAN,7,1,7-1,SFN,9,1,43,32,75,120,165,285,21,6,27,2,3:04
7393,449289,2016-10-02,2016,WAS,MIA,10,7,10-7,WAS,9,1,41,42,83,164,152,316,19,19,38,4,3:36
7394,449290,2016-10-02,2016,COL,MIL,4,6,6-4,MIL,10,0,46,44,90,160,162,322,17,15,32,2,3:23
7395,449284,2016-10-02,2016,CIN,CHN,4,7,7-4,CHN,9,0,36,44,80,200,156,356,10,18,28,2,3:18
7396,449296,2016-10-02,2016,TEX,TBA,4,6,6-4,TBA,10,0,46,46,92,186,202,388,17,16,33,2,4:00
7397,490106,2017-04-02,2017,TBA,NYA,7,3,7-3,TBA,9,1,40,39,79,143,141,284,16,11,27,3,3:21
7398,490110,2017-04-02,2017,ARI,SFN,6,5,6-5,ARI,9,0,38,41,79,168,124,292,13,16,29,3,3:23
7399,490099,2017-04-02,2017,SLN,CHN,4,3,4-3,SLN,9,0,44,36,80,143,194,337,20,10,30,2,3:33
7400,490111,2017-04-03,2017,HOU,SEA,3,0,3-0,HOU,9,1,30,34,64,122,104,226,7,8,15,1,2:29
7401,490105,2017-04-03,2017,WAS,MIA,4,2,4-2,WAS,9,1,34,33,67,110,145,255,12,6,18,1,2:47
7402,490103,2017-04-03,2017,MIN,KCA,7,1,7-1,MIN,9,1,39,30,69,117,149,266,16,5,21,2,2:47
7403,490108,2017-04-03,2017,BOS,PIT,5,3,5-3,BOS,9,1,35,38,73,144,133,277,12,11,23,2,3:03
7404,490109,2017-04-03,2017,LAN,SDN,14,3,14-3,LAN,9,1,44,33,77,115,146,261,23,5,28,2,2:52
7405,490104,2017-04-03,2017,OAK,ANA,4,2,4-2,OAK,9,1,37,36,73,154,138,292,15,12,27,2,2:56
7406,490107,2017-04-03,2017,CIN,PHI,3,4,4-3,PHI,9,0,37,40,77,170,117,287,12,16,28,2,3:04
7407,490098,2017-04-03,2017,NYN,ATL,6,0,6-0,NYN,9,1,39,33,72,133,155,288,15,7,22,3,3:13
7408,490101,2017-04-03,2017,MIL,COL,5,7,7-5,COL,9,0,38,37,75,146,155,301,14,13,27,2,3:26
7409,490100,2017-04-03,2017,TEX,CLE,5,8,8-5,CLE,9,0,37,40,77,151,155,306,11,14,25,3,3:21
7410,490112,2017-04-03,2017,BAL,TOR,3,2,3-2,BAL,11,0,41,48,89,179,152,331,11,17,28,4,3:41
7411,490119,2017-04-04,2017,HOU,SEA,2,1,2-1,HOU,9,1,29,38,67,129,110,239,8,10,18,1,2:41
7412,490136,2017-04-04,2017,SLN,CHN,1,2,2-1,CHN,9,0,34,38,72,128,130,258,8,11,19,0,2:57
7413,490117,2017-04-04,2017,LAN,SDN,0,4,4-0,SDN,9,0,30,37,67,148,110,258,7,13,20,0,2:44
7414,490115,2017-04-04,2017,OAK,ANA,6,7,7-6,ANA,9,0,37,37,74,136,174,310,12,12,24,1,3:17
7415,490116,2017-04-04,2017,TBA,NYA,0,5,5-0,NYA,9,0,35,39,74,159,153,312,8,12,20,1,3:07
7416,490102,2017-04-04,2017,CHA,DET,3,6,6-3,DET,9,0,37,39,76,158,153,311,11,13,24,4,3:30
7417,490114,2017-04-04,2017,MIL,COL,5,6,6-5,COL,9,0,36,43,79,166,152,318,11,21,32,3,3:34
7418,490118,2017-04-04,2017,ARI,SFN,4,8,8-4,SFN,9,0,38,48,86,183,154,337,11,19,30,2,3:26
7419,490102,2017-04-04,2017,CHA,DET,3,6,6-3,DET,9,0,37,39,76,158,153,311,11,13,24,4,3:30
7420,490113,2017-04-04,2017,TEX,CLE,3,4,4-3,CLE,9,0,34,37,71,148,121,269,9,13,22,4,3:14
7421,490129,2017-04-05,2017,CIN,PHI,2,0,2-0,CIN,9,1,29,32,61,133,99,232,6,5,11,1,2:25 (:50 delay)
7422,490131,2017-04-05,2017,LAN,SDN,3,1,3-1,LAN,9,1,34,32,66,116,142,258,10,7,17,2,2:43
7423,490128,2017-04-05,2017,TBA,NYA,4,1,4-1,TBA,9,1,33,35,68,148,134,282,10,10,20,4,3:17
7424,490127,2017-04-05,2017,WAS,MIA,6,4,6-4,WAS,9,1,36,39,75,154,149,303,15,14,29,3,3:06
7425,490125,2017-04-05,2017,MIN,KCA,9,1,9-1,MIN,9,1,40,33,73,142,173,315,17,8,25,4,3:06
7426,490122,2017-04-05,2017,TEX,CLE,6,9,9-6,CLE,9,0,37,40,77,153,154,307,12,14,26,4,3:25
7427,490132,2017-04-05,2017,ARI,SFN,8,6,8-6,ARI,9,1,40,39,79,150,152,302,16,12,28,4,3:15
7428,490130,2017-04-05,2017,BOS,PIT,3,0,3-0,BOS,12,0,45,42,87,184,169,353,14,6,20,1,3:53
7429,490120,2017-04-05,2017,NYN,ATL,1,3,3-1,ATL,12,0,43,50,93,203,161,364,9,17,26,2,3:51
7430,490126,2017-04-05,2017,OAK,ANA,0,5,5-0,ANA,9,0,34,40,74,147,145,292,7,16,23,3,3:15
7431,490134,2017-04-05,2017,BAL,TOR,3,1,3-1,BAL,9,1,29,34,63,138,97,235,5,8,13,0,2:23
7432,490133,2017-04-05,2017,HOU,SEA,5,3,5-3,HOU,13,0,55,53,108,206,216,422,16,14,30,5,4:25
7433,490123,2017-04-05,2017,MIL,COL,6,1,6-1,MIL,9,1,31,37,68,173,132,305,11,12,23,1,3:03
7434,490121,2017-04-06,2017,SLN,CHN,4,6,6-4,CHN,9,0,38,42,80,167,152,319,10,14,24,3,3:18
7435,490142,2017-04-06,2017,CIN,PHI,7,4,7-4,CIN,9,1,38,36,74,162,133,295,15,12,27,1,3:05
7436,490144,2017-04-06,2017,LAN,SDN,10,2,10-2,LAN,9,1,44,35,79,132,175,307,20,8,28,2,3:14
7437,490141,2017-04-06,2017,WAS,MIA,3,4,4-3,MIA,10,0,42,44,86,163,150,313,17,19,36,1,3:26 (2:23 delay)
7438,490146,2017-04-06,2017,HOU,SEA,2,4,4-2,SEA,9,0,36,38,74,143,139,282,11,12,23,1,2:57
7439,490139,2017-04-06,2017,MIN,KCA,5,3,5-3,MIN,9,1,40,39,79,145,154,299,17,14,31,4,3:14
7440,490135,2017-04-06,2017,NYN,ATL,6,2,6-2,NYN,9,1,34,32,66,113,115,228,11,6,17,1,2:28
7441,490147,2017-04-06,2017,TBA,TOR,2,5,5-2,TOR,9,0,34,37,71,138,122,260,11,10,21,3,2:56
7442,490140,2017-04-06,2017,OAK,ANA,5,1,5-1,OAK,9,1,33,35,68,141,124,265,9,8,17,2,2:44
7443,490121,2017-04-06,2017,SLN,CHN,4,6,6-4,CHN,9,0,38,42,80,167,152,319,10,14,24,3,3:18
7444,490137,2017-04-06,2017,MIL,COL,1,2,2-1,COL,9,0,36,34,70,133,162,295,11,7,18,1,3:07
7445,490145,2017-04-06,2017,ARI,SFN,9,3,9-3,ARI,9,1,39,36,75,158,141,299,16,9,25,3,3:00
7446,490138,2017-04-06,2017,CHA,DET,11,2,11-2,CHA,9,1,42,36,78,166,177,343,17,10,27,2,3:31
7447,490151,2017-04-07,2017,SLN,CIN,0,2,2-0,CIN,9,0,31,35,66,116,120,236,5,10,15,0,2:17
7448,490156,2017-04-07,2017,CHA,MIN,1,3,3-1,MIN,9,0,36,36,72,126,138,264,9,9,18,1,2:59
7449,490159,2017-04-07,2017,SDN,SFN,7,6,7-6,SDN,9,1,40,35,75,136,143,279,15,10,25,3,2:58
7450,490153,2017-04-07,2017,HOU,KCA,1,5,5-1,KCA,9,0,33,42,75,171,135,306,9,16,25,3,3:12
7451,490158,2017-04-07,2017,TEX,OAK,10,5,10-5,TEX,9,1,40,36,76,159,136,295,15,10,25,1,2:56
7452,490157,2017-04-07,2017,BAL,NYA,6,5,6-5,BAL,9,1,33,39,72,176,132,308,8,14,22,4,3:20
7453,490155,2017-04-07,2017,NYN,MIA,2,7,7-2,MIA,9,0,37,43,80,175,133,308,11,17,28,2,3:06
7454,490150,2017-04-07,2017,MIL,CHN,2,1,2-1,MIL,11,0,42,43,85,182,171,353,11,13,24,3,3:58
7455,490149,2017-04-07,2017,DET,BOS,6,5,6-5,DET,9,1,36,41,77,175,145,320,17,14,31,5,3:35
7456,490148,2017-04-07,2017,PIT,ATL,5,4,5-4,PIT,9,1,42,38,80,139,178,317,16,12,28,2,3:18
7457,490152,2017-04-07,2017,ARI,CLE,7,3,7-3,ARI,9,1,39,38,77,156,156,312,16,10,26,3,3:19
7458,490162,2017-04-07,2017,PHI,WAS,6,7,7-6,WAS,9,0,39,41,80,178,149,327,13,17,30,2,3:34
7459,490160,2017-04-07,2017,ANA,SEA,5,1,5-1,ANA,9,1,36,35,71,139,123,262,14,7,21,2,2:56
7460,490154,2017-04-07,2017,COL,LAN,2,1,2-1,COL,9,1,31,34,65,140,127,267,7,8,15,1,3:00
7461,490161,2017-04-07,2017,TBA,TOR,10,8,10-8,TBA,9,1,43,44,87,193,165,358,20,16,36,6,3:53
7462,490164,2017-04-08,2017,DET,BOS,4,1,4-1,DET,9,1,31,35,66,143,133,276,10,10,20,1,3:05
7463,490171,2017-04-08,2017,CHA,MIN,6,2,6-2,CHA,9,1,34,37,71,125,143,268,12,11,23,2,2:56
7464,490168,2017-04-08,2017,HOU,KCA,3,7,7-3,KCA,9,0,35,36,71,131,113,244,12,9,21,1,2:42
7465,490173,2017-04-08,2017,TEX,OAK,1,6,6-1,OAK,9,0,30,40,70,160,119,279,3,12,15,1,2:59
7466,490172,2017-04-08,2017,BAL,NYA,5,4,5-4,BAL,9,1,38,40,78,165,129,294,16,15,31,3,3:35
7467,490165,2017-04-08,2017,MIL,CHN,6,11,11-6,CHN,9,0,37,49,86,199,148,347,10,24,34,2,3:28
7468,490163,2017-04-08,2017,PIT,ATL,6,4,6-4,PIT,9,1,37,43,80,140,131,271,15,21,36,1,3:00
7469,490175,2017-04-08,2017,ANA,SEA,5,4,5-4,ANA,9,1,36,35,71,139,134,273,14,9,23,1,3:05
7470,490177,2017-04-08,2017,PHI,WAS,17,3,17-3,PHI,9,1,45,36,81,144,196,340,20,12,32,1,3:15
7471,490170,2017-04-08,2017,NYN,MIA,1,8,8-1,MIA,9,0,34,48,82,194,156,350,6,21,27,2,3:25
7472,490166,2017-04-08,2017,SLN,CIN,10,4,10-4,SLN,9,1,46,34,80,132,176,308,23,8,31,1,2:47
7473,490174,2017-04-08,2017,SDN,SFN,2,1,2-1,SDN,9,1,34,33,67,124,114,238,9,6,15,1,2:24
7474,490176,2017-04-08,2017,TBA,TOR,3,2,3-2,TBA,11,0,49,40,89,158,168,326,19,9,28,2,3:55
7475,490167,2017-04-08,2017,ARI,CLE,11,2,11-2,ARI,9,1,41,33,74,144,167,311,19,7,26,3,3:15
7476,490169,2017-04-08,2017,COL,LAN,4,2,4-2,COL,9,1,33,35,68,161,124,285,9,10,19,1,2:59
7477,490188,2017-04-09,2017,TEX,OAK,8,1,8-1,TEX,9,1,40,39,79,152,148,300,14,13,27,2,3:16
7478,490186,2017-04-09,2017,CHA,MIN,1,4,4-1,MIN,9,0,38,35,73,131,150,281,11,9,20,4,3:07
7479,490183,2017-04-09,2017,HOU,KCA,5,4,5-4,HOU,12,0,51,45,96,166,193,359,23,10,33,2,3:49
7480,490178,2017-04-09,2017,PIT,ATL,6,5,6-5,PIT,10,0,38,45,83,153,126,279,15,15,30,0,3:14
7481,490192,2017-04-09,2017,PHI,WAS,4,3,4-3,PHI,9,0,37,37,74,150,139,289,12,10,22,1,3:24
7482,490180,2017-04-09,2017,MIL,CHN,4,7,7-4,CHN,9,0,33,42,75,162,128,290,6,16,22,2,3:00
7483,490190,2017-04-09,2017,ANA,SEA,10,9,10-9,ANA,9,0,41,39,80,148,153,301,18,11,29,3,3:27
7484,490184,2017-04-09,2017,COL,LAN,6,10,10-6,LAN,9,0,39,46,85,190,148,338,11,20,31,1,3:49
7485,490181,2017-04-09,2017,SLN,CIN,0,8,8-0,CIN,9,0,32,43,75,154,134,288,7,17,24,2,2:44
7486,490182,2017-04-09,2017,ARI,CLE,3,2,3-2,ARI,9,1,33,38,71,152,119,271,9,10,19,2,3:02
7487,490189,2017-04-09,2017,SDN,SFN,3,5,5-3,SFN,9,0,39,39,78,145,143,288,13,12,25,0,2:57
7488,490179,2017-04-09,2017,DET,BOS,5,7,7-5,BOS,9,0,42,40,82,134,151,285,16,18,34,3,3:27
7489,490185,2017-04-09,2017,NYN,MIA,5,2,5-2,NYN,9,1,34,31,65,131,117,248,9,5,14,0,2:44
7490,490191,2017-04-09,2017,TBA,TOR,7,2,7-2,TBA,9,1,37,31,68,144,162,306,14,5,19,1,2:57
7491,490187,2017-04-09,2017,BAL,NYA,3,7,7-3,NYA,9,0,36,46,82,202,137,339,10,20,30,3,3:22
7492,490198,2017-04-10,2017,PHI,NYN,3,4,4-3,NYN,9,0,38,35,73,121,155,276,14,10,24,3,2:59
7493,490200,2017-04-10,2017,COL,SDN,3,5,5-3,SDN,9,0,35,36,71,142,143,285,11,12,23,2,2:53
7494,490199,2017-04-10,2017,KCA,OAK,0,2,2-0,OAK,9,0,33,34,67,132,138,270,7,8,15,0,2:50
7495,490197,2017-04-10,2017,CHN,LAN,3,2,3-2,CHN,9,0,39,37,76,158,151,309,14,10,24,4,3:37 (1:56 delay)
7496,490193,2017-04-10,2017,SFN,ARI,4,1,4-1,SFN,9,1,36,32,68,108,139,247,11,5,16,1,2:38
7497,490202,2017-04-10,2017,NYA,TBA,8,1,8-1,NYA,9,1,37,29,66,106,117,223,11,2,13,2,2:37
7498,490196,2017-04-10,2017,SEA,HOU,6,0,6-0,SEA,9,1,38,35,73,131,157,288,16,9,25,1,2:56
7499,490195,2017-04-10,2017,PIT,CIN,1,7,7-1,CIN,9,0,36,42,78,167,149,316,9,14,23,2,3:05
7500,490194,2017-04-10,2017,DET,BOS,2,1,2-1,DET,9,1,30,34,64,150,109,259,6,7,13,1,2:44 (:36 delay)
7501,490201,2017-04-10,2017,WAS,SLN,14,6,14-6,WAS,9,1,49,39,88,157,190,347,26,10,36,3,3:47
7502,490210,2017-04-11,2017,DET,MIN,2,1,2-1,DET,9,1,31,35,66,148,111,259,7,9,16,2,2:39
7503,490206,2017-04-11,2017,CLE,CHA,2,1,2-1,CLE,10,0,39,35,74,141,178,319,14,6,20,3,3:37
7504,490208,2017-04-11,2017,SEA,HOU,5,7,7-5,HOU,9,0,40,42,82,158,171,329,15,17,32,3,3:29
7505,490213,2017-04-11,2017,WAS,SLN,8,3,8-3,WAS,9,1,41,35,76,126,153,279,16,9,25,0,2:55
7506,490205,2017-04-11,2017,BOS,BAL,8,1,8-1,BOS,9,1,40,34,74,130,162,292,18,7,25,2,3:15
7507,490209,2017-04-11,2017,TOR,MIL,3,4,4-3,MIL,9,0,37,40,77,176,158,334,10,12,22,1,3:31
7508,490212,2017-04-11,2017,COL,SDN,3,2,3-2,COL,9,1,31,34,65,127,111,238,6,7,13,0,2:24
7509,490211,2017-04-11,2017,PHI,NYN,4,14,14-4,NYN,9,0,37,52,89,206,149,355,10,26,36,3,3:38
7510,490214,2017-04-11,2017,ANA,TEX,6,5,6-5,ANA,10,0,45,42,87,155,152,307,18,13,31,1,3:33
7511,490207,2017-04-11,2017,PIT,CIN,2,6,6-2,CIN,9,0,40,39,79,140,157,297,12,12,24,1,3:04 (1:09 delay)
7512,490204,2017-04-11,2017,MIA,ATL,8,4,8-4,MIA,9,1,35,38,73,157,130,287,13,11,24,0,2:54
7513,490203,2017-04-11,2017,SFN,ARI,3,4,4-3,ARI,9,0,43,41,84,160,163,323,17,14,31,2,3:18
7514,490216,2017-04-12,2017,MIA,ATL,4,5,5-4,ATL,9,0,37,35,72,119,136,255,9,11,20,0,2:51 (:27 delay)
7515,490226,2017-04-12,2017,COL,SDN,0,6,6-0,SDN,9,0,35,38,73,120,146,266,9,14,23,3,2:49
7516,490221,2017-04-12,2017,CHN,LAN,0,2,2-0,LAN,9,0,32,38,70,171,139,310,8,11,19,2,3:20
7517,490218,2017-04-12,2017,CLE,CHA,1,2,2-1,CHA,9,0,35,34,69,138,155,293,7,7,14,1,2:58
7518,490227,2017-04-12,2017,WAS,SLN,1,6,6-1,SLN,9,0,34,41,75,156,141,297,8,13,21,4,3:14
7519,490219,2017-04-12,2017,PIT,CIN,2,9,9-2,CIN,9,0,35,44,79,159,130,289,9,18,27,2,2:54
7520,490225,2017-04-12,2017,KCA,OAK,3,8,8-3,OAK,9,0,37,43,80,160,152,312,10,18,28,3,3:07
7521,490215,2017-04-12,2017,SFN,ARI,6,2,6-2,SFN,9,1,40,38,78,148,159,307,15,11,26,3,3:21
7522,490222,2017-04-12,2017,TOR,MIL,0,2,2-0,MIL,9,0,31,34,65,100,111,211,8,8,16,0,2:14
7523,490229,2017-04-12,2017,ANA,TEX,3,8,8-3,TEX,9,0,35,42,77,154,116,270,7,17,24,3,2:59
7524,490220,2017-04-12,2017,SEA,HOU,5,10,10-5,HOU,9,0,38,46,84,148,147,295,10,24,34,1,3:12
7525,490224,2017-04-12,2017,PHI,NYN,4,5,5-4,NYN,9,0,34,37,71,157,136,293,8,12,20,2,3:13
7526,490223,2017-04-12,2017,DET,MIN,5,3,5-3,DET,9,1,33,34,67,156,104,260,9,9,18,0,2:48
7527,490217,2017-04-12,2017,BOS,BAL,5,12,12-5,BAL,9,0,43,43,86,175,190,365,16,19,35,4,3:46
7528,490228,2017-04-12,2017,NYA,TBA,8,4,8-4,NYA,9,1,39,38,77,159,154,313,13,12,25,5,3:33
7529,490238,2017-04-13,2017,NYA,TBA,3,2,3-2,NYA,9,1,34,35,69,146,133,279,13,9,22,2,2:59
7530,490239,2017-04-13,2017,ANA,TEX,3,8,8-3,TEX,9,0,36,41,77,162,136,298,10,14,24,0,3:14
7531,490143,2017-04-13,2017,BOS,PIT,4,3,4-3,BOS,9,1,34,37,71,160,133,293,12,12,24,3,3:15
7532,490230,2017-04-13,2017,TOR,BAL,1,2,2-1,BAL,9,0,35,33,68,120,141,261,9,7,16,1,2:45
7533,490143,2017-04-13,2017,BOS,PIT,4,3,4-3,BOS,9,1,34,37,71,160,133,293,12,12,24,3,3:15
7534,490233,2017-04-13,2017,CHN,LAN,4,0,4-0,CHN,9,1,34,36,70,136,134,270,14,10,24,2,3:01
7535,490237,2017-04-13,2017,KCA,OAK,3,1,3-1,KCA,9,1,36,33,69,130,133,263,11,7,18,1,2:39
7536,490234,2017-04-13,2017,CIN,MIL,1,5,5-1,MIL,9,0,32,36,68,119,121,240,5,12,17,0,2:25
7537,490235,2017-04-13,2017,DET,MIN,5,11,11-5,MIN,9,0,38,45,83,176,167,343,12,19,31,2,3:31
7538,490231,2017-04-13,2017,CLE,CHA,4,10,10-4,CHA,9,0,42,46,88,156,172,328,16,19,35,4,3:32
7539,490232,2017-04-13,2017,SFN,COL,1,3,3-1,COL,9,0,33,36,69,146,112,258,8,9,17,3,2:50
7540,490236,2017-04-13,2017,MIA,NYN,8,9,9-8,NYN,16,0,69,66,135,253,256,509,23,19,42,2,5:38
7541,490246,2017-04-14,2017,KCA,ANA,7,1,7-1,KCA,9,1,34,34,68,138,124,262,11,8,19,0,2:37
7542,490251,2017-04-14,2017,ATL,SDN,5,2,5-2,ATL,9,1,35,36,71,143,122,265,13,12,25,1,2:57
7543,490242,2017-04-14,2017,MIN,CHA,1,2,2-1,CHA,9,0,35,34,69,126,138,264,10,10,20,3,3:06 (:36 delay)
7544,490254,2017-04-14,2017,SEA,TEX,2,1,2-1,SEA,9,1,34,34,68,113,150,263,13,8,21,4,3:05
7545,490243,2017-04-14,2017,SFN,COL,8,2,8-2,SFN,9,1,38,33,71,109,170,279,13,7,20,1,2:49
7546,490250,2017-04-14,2017,CHN,PIT,2,4,4-2,PIT,9,0,40,36,76,140,174,314,12,13,25,1,3:15
7547,490245,2017-04-14,2017,OAK,HOU,2,7,7-2,HOU,9,0,36,44,80,156,136,292,9,16,25,2,3:07
7548,490252,2017-04-14,2017,NYA,SLN,4,3,4-3,NYA,9,1,36,37,73,153,131,284,13,10,23,1,2:54
7549,490244,2017-04-14,2017,CLE,DET,6,7,7-6,DET,9,0,45,40,85,169,183,352,16,14,30,3,4:00
7550,490240,2017-04-14,2017,LAN,ARI,7,1,7-1,LAN,9,1,40,32,72,115,160,275,17,6,23,2,3:06
7551,490253,2017-04-14,2017,BOS,TBA,5,10,10-5,TBA,9,0,44,44,88,174,156,330,18,17,35,3,3:37
7552,490248,2017-04-14,2017,MIA,NYN,3,2,3-2,MIA,9,0,38,40,78,154,144,298,14,14,28,2,3:26
7553,490249,2017-04-14,2017,WAS,PHI,3,2,3-2,WAS,10,0,40,37,77,145,159,304,15,9,24,0,3:18
7554,490247,2017-04-14,2017,CIN,MIL,4,10,10-4,MIL,9,0,37,45,82,185,145,330,10,19,29,1,3:21
7555,490241,2017-04-14,2017,TOR,BAL,4,6,6-4,BAL,9,0,38,39,77,160,157,317,11,13,24,2,3:18
7556,490257,2017-04-15,2017,MIN,CHA,6,0,6-0,MIN,9,1,40,29,69,107,135,242,17,2,19,1,2:26
7557,490256,2017-04-15,2017,TOR,BAL,2,1,2-1,TOR,9,0,31,36,67,131,115,246,8,10,18,2,2:39
7558,490263,2017-04-15,2017,MIA,NYN,5,4,5-4,MIA,9,1,32,34,66,129,125,254,8,7,15,2,2:30
7559,490255,2017-04-15,2017,LAN,ARI,8,4,8-4,LAN,9,1,42,35,77,141,135,276,18,6,24,4,3:03
7560,490269,2017-04-15,2017,SEA,TEX,5,0,5-0,SEA,9,1,34,29,63,127,119,246,12,3,15,1,2:24
7561,490258,2017-04-15,2017,SFN,COL,0,5,5-0,COL,9,0,30,41,71,143,105,248,3,14,17,1,2:26
7562,490262,2017-04-15,2017,CIN,MIL,7,5,7-5,CIN,9,1,40,39,79,154,147,301,18,13,31,1,3:10
7563,490260,2017-04-15,2017,OAK,HOU,6,10,10-6,HOU,9,0,41,44,85,189,176,365,14,18,32,5,3:55
7564,490264,2017-04-15,2017,WAS,PHI,2,4,4-2,PHI,9,0,32,33,65,139,124,263,5,7,12,0,2:39
7565,490268,2017-04-15,2017,BOS,TBA,2,1,2-1,BOS,9,1,32,33,65,143,116,259,9,8,17,1,2:54
7566,490261,2017-04-15,2017,KCA,ANA,3,2,3-2,KCA,9,1,31,38,69,142,144,286,8,13,21,2,3:16
7567,490266,2017-04-15,2017,ATL,SDN,4,2,4-2,ATL,9,1,33,36,69,116,117,233,11,10,21,1,2:20
7568,490267,2017-04-15,2017,NYA,SLN,3,2,3-2,NYA,9,1,39,35,74,133,160,293,13,8,21,2,3:05
7569,490265,2017-04-15,2017,CHN,PIT,7,8,8-7,PIT,9,0,41,38,79,163,154,317,13,12,25,2,3:25
7570,490259,2017-04-15,2017,CLE,DET,13,6,13-6,CLE,9,1,46,40,86,143,167,310,23,13,36,2,3:36
7571,490273,2017-04-16,2017,SFN,COL,3,4,4-3,COL,9,0,33,35,68,130,112,242,7,8,15,3,2:46
7572,490274,2017-04-16,2017,CLE,DET,1,4,4-1,DET,9,0,34,36,70,142,149,291,10,13,23,2,3:15
7573,490277,2017-04-16,2017,CIN,MIL,2,4,4-2,MIL,9,0,34,38,72,166,131,297,9,10,19,1,2:56
7574,490281,2017-04-16,2017,ATL,SDN,9,2,9-2,ATL,9,1,36,32,68,122,136,258,15,6,21,2,2:46
7575,490272,2017-04-16,2017,MIN,CHA,1,3,3-1,CHA,10,0,40,42,82,139,162,301,11,12,23,0,3:15
7576,490282,2017-04-16,2017,NYA,SLN,9,3,9-3,NYA,9,1,39,38,77,137,170,307,20,11,31,2,3:17
7577,490279,2017-04-16,2017,WAS,PHI,6,4,6-4,WAS,9,0,39,39,78,150,146,296,14,12,26,2,3:11
7578,490278,2017-04-16,2017,MIA,NYN,4,2,4-2,MIA,9,0,36,37,73,163,125,288,13,10,23,1,2:58
7579,490280,2017-04-16,2017,CHN,PIT,1,6,6-1,PIT,9,0,36,38,74,158,131,289,10,14,24,1,3:02
7580,490276,2017-04-16,2017,KCA,ANA,1,0,1-0,KCA,9,0,34,30,64,119,131,250,9,4,13,1,2:37
7581,490283,2017-04-16,2017,BOS,TBA,7,5,7-5,BOS,9,1,40,36,76,164,156,320,21,10,31,3,3:46
7582,490284,2017-04-16,2017,SEA,TEX,8,7,8-7,SEA,9,0,40,42,82,146,164,310,18,16,34,6,3:39
7583,490271,2017-04-16,2017,TOR,BAL,4,11,11-4,BAL,9,0,39,46,85,160,181,341,14,17,31,4,3:30
7584,490270,2017-04-16,2017,LAN,ARI,1,3,3-1,ARI,9,0,34,37,71,150,141,291,8,13,21,4,3:22
7585,490291,2017-04-17,2017,SLN,PIT,2,1,2-1,SLN,9,1,28,35,63,128,78,206,5,8,13,0,2:14
7586,490289,2017-04-17,2017,SEA,MIA,6,1,6-1,SEA,9,1,35,32,67,124,141,265,12,5,17,0,2:31
7587,490290,2017-04-17,2017,CHN,MIL,3,6,6-3,MIL,9,0,37,37,74,139,154,293,12,11,23,0,3:00
7588,490285,2017-04-17,2017,LAN,ARI,2,4,4-2,ARI,9,0,36,40,76,158,135,293,9,16,25,1,3:07
7589,490293,2017-04-17,2017,BOS,TBA,4,3,4-3,BOS,9,1,35,39,74,154,137,291,12,14,26,2,3:07
7590,490288,2017-04-17,2017,HOU,ANA,3,0,3-0,HOU,9,1,32,36,68,140,113,253,11,8,19,0,2:36
7591,490292,2017-04-17,2017,ATL,SDN,5,4,5-4,ATL,9,0,38,39,77,133,114,247,14,13,27,3,2:48
7592,490294,2017-04-17,2017,OAK,TEX,0,7,7-0,TEX,9,0,30,41,71,160,121,281,5,15,20,2,2:46 (:10 delay)
7593,490286,2017-04-17,2017,NYA,CHA,7,4,7-4,NYA,9,1,34,37,71,132,137,269,10,14,24,3,2:49
7594,490287,2017-04-17,2017,MIN,CLE,1,3,3-1,CLE,9,0,40,40,80,127,155,282,13,14,27,2,2:58
7595,490306,2017-04-18,2017,SLN,PIT,2,1,2-1,SLN,9,1,30,37,67,145,99,244,6,11,17,1,2:31
7596,490303,2017-04-18,2017,SEA,MIA,0,5,5-0,MIA,9,0,31,37,68,126,124,250,4,10,14,0,2:33
7597,490309,2017-04-18,2017,ATL,WAS,1,3,3-1,WAS,9,0,36,36,72,138,161,299,10,11,21,2,3:09
7598,490301,2017-04-18,2017,TBA,DET,5,1,5-1,TBA,9,1,38,32,70,143,145,288,15,5,20,3,3:19
7599,490308,2017-04-18,2017,OAK,TEX,4,2,4-2,OAK,9,1,33,31,64,111,142,253,10,3,13,3,2:48
7600,490304,2017-04-18,2017,CHN,MIL,9,7,9-7,CHN,9,1,40,38,78,154,138,292,18,11,29,2,3:00
7601,490307,2017-04-18,2017,KCA,SFN,1,2,2-1,SFN,11,0,45,45,90,163,158,321,15,14,29,4,3:37
7602,490298,2017-04-18,2017,NYA,CHA,1,4,4-1,CHA,9,0,32,31,63,119,107,226,7,3,10,1,2:16
7603,490295,2017-04-18,2017,SDN,ARI,2,11,11-2,ARI,9,0,34,48,82,196,131,327,9,18,27,4,3:20
7604,490302,2017-04-18,2017,HOU,ANA,2,5,5-2,ANA,9,0,36,38,74,153,147,300,12,12,24,1,3:05
7605,490300,2017-04-18,2017,LAN,COL,3,4,4-3,COL,9,0,42,36,78,141,166,307,16,10,26,2,3:17
7606,490299,2017-04-18,2017,MIN,CLE,4,11,11-4,CLE,9,0,39,43,82,160,148,308,12,16,28,3,3:15
7607,490297,2017-04-18,2017,TOR,BOS,7,8,8-7,BOS,9,0,45,43,88,167,177,344,18,18,36,4,3:48
7608,490296,2017-04-18,2017,CIN,BAL,9,3,9-3,CIN,9,1,43,36,79,133,184,317,19,9,28,1,3:05
7609,490305,2017-04-18,2017,NYN,PHI,2,6,6-2,PHI,10,0,39,48,87,209,159,368,9,16,25,4,3:58
7610,490321,2017-04-19,2017,SLN,PIT,2,1,2-1,SLN,9,1,32,35,67,138,125,263,10,8,18,1,2:40
7611,490311,2017-04-19,2017,CIN,BAL,0,2,2-0,BAL,9,0,33,35,68,119,120,239,6,10,16,1,2:28
7612,490312,2017-04-19,2017,TOR,BOS,3,0,3-0,TOR,9,1,33,34,67,137,122,259,7,8,15,1,2:45
7613,490320,2017-04-19,2017,NYN,PHI,5,4,5-4,NYN,9,1,34,37,71,132,114,246,11,12,23,2,2:37
7614,490316,2017-04-19,2017,TBA,DET,8,7,8-7,TBA,9,0,42,40,82,167,153,320,18,17,35,2,3:44
7615,490310,2017-04-19,2017,SDN,ARI,1,0,1-0,SDN,9,1,29,31,60,121,96,217,6,5,11,0,2:13
7616,490315,2017-04-19,2017,LAN,COL,4,2,4-2,LAN,9,1,34,35,69,129,124,253,9,8,17,3,2:55
7617,490317,2017-04-19,2017,HOU,ANA,5,1,5-1,HOU,9,1,33,33,66,118,127,245,12,9,21,2,2:47
7618,490323,2017-04-19,2017,OAK,TEX,9,1,9-1,OAK,9,1,38,34,72,121,145,266,17,7,24,1,2:47
7619,490324,2017-04-19,2017,ATL,WAS,4,14,14-4,WAS,9,0,35,52,87,203,130,333,10,28,38,2,3:32
7620,490319,2017-04-19,2017,CHN,MIL,7,4,7-4,CHN,9,0,40,39,79,164,191,355,13,13,26,2,3:30 (:55 delay)
7621,490313,2017-04-19,2017,NYA,CHA,9,1,9-1,NYA,9,1,36,34,70,123,134,257,14,8,22,2,2:40
7622,490318,2017-04-19,2017,SEA,MIA,10,5,10-5,SEA,9,1,45,41,86,138,185,323,23,18,41,4,3:32
7623,490322,2017-04-19,2017,KCA,SFN,2,0,2-0,KCA,9,1,33,31,64,122,126,248,11,5,16,0,2:28
7624,490326,2017-04-20,2017,CIN,BAL,1,2,2-1,BAL,10,0,32,35,67,143,130,273,3,7,10,0,2:37
7625,490329,2017-04-20,2017,TBA,DET,8,1,8-1,TBA,9,1,39,34,73,132,156,288,15,7,22,1,3:02
7626,490335,2017-04-20,2017,ATL,WAS,2,3,3-2,WAS,9,0,37,34,71,106,132,238,10,7,17,3,2:41
7627,490325,2017-04-20,2017,SDN,ARI,4,1,4-1,SDN,9,1,29,36,65,134,108,242,5,9,14,1,2:24
7628,490330,2017-04-20,2017,TEX,KCA,1,0,1-0,TEX,13,0,45,46,91,187,173,360,10,9,19,2,3:47
7629,490331,2017-04-20,2017,HOU,ANA,2,1,2-1,HOU,9,1,29,35,64,139,110,249,5,10,15,1,2:37
7630,490332,2017-04-20,2017,NYN,PHI,4,6,6-4,PHI,9,0,37,41,78,159,141,300,12,13,25,1,3:14
7631,490333,2017-04-20,2017,OAK,SEA,9,6,9-6,OAK,9,1,38,38,76,154,159,313,15,12,27,3,3:09
7632,490327,2017-04-20,2017,TOR,BOS,1,4,4-1,BOS,10,0,36,40,76,176,132,308,6,11,17,1,3:07
7633,490328,2017-04-20,2017,MIN,CLE,2,6,6-2,CLE,9,0,36,44,80,186,156,342,9,19,28,7,3:36
7634,490334,2017-04-20,2017,MIL,SLN,7,5,7-5,MIL,9,1,36,41,77,169,135,304,13,15,28,3,3:08
7635,490342,2017-04-21,2017,TEX,KCA,6,2,6-2,TEX,9,1,34,34,68,120,141,261,10,9,19,1,2:45
7636,490347,2017-04-21,2017,OAK,SEA,3,1,3-1,OAK,9,1,33,35,68,146,120,266,13,10,23,2,2:51
7637,490337,2017-04-21,2017,BAL,BOS,2,0,2-0,BAL,9,1,33,33,66,142,136,278,9,8,17,4,3:20
7638,490341,2017-04-21,2017,TBA,HOU,3,6,6-3,HOU,9,0,35,39,74,154,132,286,9,14,23,1,3:16
7639,490346,2017-04-21,2017,COL,SFN,6,5,6-5,COL,9,1,38,41,79,130,149,279,14,15,29,3,2:59
7640,490336,2017-04-21,2017,PHI,ATL,4,3,4-3,PHI,9,1,35,34,69,119,114,233,12,7,19,0,2:38 (:24 delay)
7641,490340,2017-04-21,2017,MIN,DET,6,3,6-3,MIN,9,1,34,36,70,130,150,280,11,9,20,3,2:59
7642,490348,2017-04-21,2017,MIL,SLN,3,6,6-3,SLN,9,0,38,38,76,127,167,294,11,15,26,0,2:56
7643,490343,2017-04-21,2017,ARI,LAN,13,5,13-5,ARI,9,1,46,37,83,143,168,311,24,11,35,5,3:28
7644,490344,2017-04-21,2017,SDN,MIA,5,3,5-3,SDN,9,1,36,34,70,125,125,250,14,7,21,1,2:28
7645,490338,2017-04-21,2017,CIN,CHN,5,6,6-5,CHN,11,0,47,48,95,179,204,383,17,16,33,1,3:57
7646,490345,2017-04-21,2017,PIT,NYA,6,3,6-3,PIT,9,1,36,41,77,179,139,318,12,12,24,3,3:19
7647,490350,2017-04-21,2017,NYN,WAS,3,4,4-3,WAS,11,0,44,44,88,180,172,352,13,13,26,2,3:43
7648,490339,2017-04-21,2017,CHA,CLE,0,3,3-0,CLE,9,0,29,34,63,161,110,271,5,10,15,2,2:45
7649,490349,2017-04-21,2017,ANA,TOR,7,8,8-7,TOR,13,0,59,59,118,248,244,492,19,20,39,4,5:36
7650,490356,2017-04-22,2017,TBA,HOU,6,3,6-3,TBA,9,1,38,34,72,127,141,268,14,9,23,4,3:05
7651,490363,2017-04-22,2017,MIL,SLN,1,4,4-1,SLN,9,0,34,42,76,148,147,295,10,15,25,0,3:16
7652,490361,2017-04-22,2017,COL,SFN,12,3,12-3,COL,9,1,42,35,77,130,152,282,18,9,27,3,3:01
7653,490364,2017-04-22,2017,ANA,TOR,5,4,5-4,ANA,9,1,35,35,70,122,109,231,13,12,25,3,2:35
7654,490360,2017-04-22,2017,PIT,NYA,5,11,11-5,NYA,9,0,40,45,85,165,143,308,13,17,30,5,3:17
7655,490357,2017-04-22,2017,TEX,KCA,2,1,2-1,TEX,9,0,33,33,66,121,126,247,11,7,18,1,2:38
7656,490352,2017-04-22,2017,BAL,BOS,4,2,4-2,BAL,9,1,35,37,72,143,109,252,12,10,22,2,2:47 (:28 delay)
7657,490359,2017-04-22,2017,SDN,MIA,3,6,6-3,MIA,11,0,44,42,86,157,157,314,13,10,23,2,3:13
7658,490355,2017-04-22,2017,MIN,DET,4,5,5-4,DET,9,0,39,47,86,189,150,339,13,19,32,5,4:00
7659,490353,2017-04-22,2017,CIN,CHN,8,12,12-8,CHN,9,0,41,45,86,192,157,349,14,19,33,1,3:24
7660,490351,2017-04-22,2017,PHI,ATL,4,3,4-3,PHI,10,0,40,40,80,172,155,327,14,11,25,1,3:32
7661,490362,2017-04-22,2017,OAK,SEA,4,3,4-3,OAK,9,1,34,38,72,145,137,282,11,13,24,3,3:07
7662,490358,2017-04-22,2017,ARI,LAN,11,5,11-5,ARI,9,1,41,40,81,170,140,310,17,16,33,3,3:20
7663,490354,2017-04-22,2017,CHA,CLE,0,7,7-0,CLE,9,0,30,42,72,168,123,291,4,14,18,3,3:09
7664,490365,2017-04-22,2017,NYN,WAS,1,3,3-1,WAS,9,0,32,41,73,155,129,284,5,16,21,3,3:01
7665,490376,2017-04-23,2017,COL,SFN,8,0,8-0,COL,9,1,35,35,70,115,132,247,12,9,21,1,2:46
7666,490375,2017-04-23,2017,PIT,NYA,2,1,2-1,PIT,9,1,33,36,69,135,127,262,12,9,21,0,2:39
7667,490368,2017-04-23,2017,CIN,CHN,7,5,7-5,CIN,9,1,35,35,70,119,128,247,9,9,18,2,2:26
7668,490370,2017-04-23,2017,MIN,DET,4,13,13-4,DET,9,0,36,45,81,180,140,320,9,19,28,4,3:17
7669,490373,2017-04-23,2017,ARI,LAN,2,6,6-2,LAN,9,0,34,39,73,143,123,266,8,14,22,1,2:54
7670,490367,2017-04-23,2017,BAL,BOS,2,6,6-2,BOS,9,0,39,41,80,156,161,317,12,18,30,5,3:34
7671,490374,2017-04-23,2017,SDN,MIA,3,7,7-3,MIA,9,0,34,41,75,149,118,267,9,14,23,2,2:42
7672,490372,2017-04-23,2017,TEX,KCA,5,2,5-2,TEX,9,1,36,32,68,127,145,272,14,6,20,2,3:00
7673,490380,2017-04-23,2017,NYN,WAS,3,6,6-3,WAS,9,0,33,35,68,130,129,259,7,9,16,1,2:43
7674,490366,2017-04-23,2017,PHI,ATL,5,2,5-2,PHI,9,1,33,36,69,131,123,254,10,9,19,2,2:38
7675,490377,2017-04-23,2017,OAK,SEA,1,11,11-1,SEA,9,0,33,44,77,181,142,323,6,18,24,2,3:11
7676,490379,2017-04-23,2017,ANA,TOR,2,6,6-2,TOR,9,0,33,37,70,173,99,272,9,13,22,1,2:51
7677,490369,2017-04-23,2017,CHA,CLE,6,2,6-2,CHA,9,1,41,37,78,163,164,327,16,12,28,1,3:12
7678,490378,2017-04-23,2017,MIL,SLN,4,6,6-4,SLN,9,0,39,40,79,156,156,312,11,17,28,2,3:15
7679,490371,2017-04-23,2017,TBA,HOU,4,6,6-4,HOU,10,0,42,43,85,162,163,325,11,17,28,1,3:39
7680,490388,2017-04-24,2017,ANA,TOR,2,1,2-1,ANA,9,1,33,35,68,149,124,273,11,12,23,2,3:02
7681,490384,2017-04-24,2017,SFN,LAN,2,1,2-1,SFN,9,1,33,31,64,111,151,262,11,6,17,2,2:57
7682,490389,2017-04-24,2017,COL,WAS,8,4,8-4,COL,9,1,38,36,74,135,131,266,14,10,24,3,3:00
7683,490385,2017-04-24,2017,TEX,MIN,2,3,3-2,MIN,9,0,35,37,72,148,131,279,10,12,22,2,3:01
7684,490386,2017-04-24,2017,ARI,SDN,7,6,7-6,ARI,9,1,37,39,76,156,135,291,13,11,24,1,3:05
7685,490387,2017-04-24,2017,BAL,TBA,6,3,6-3,BAL,9,1,36,40,76,172,124,296,13,14,27,4,3:16 (:19 delay)
7686,490381,2017-04-24,2017,PIT,CHN,3,14,14-3,CHN,9,0,39,52,91,190,144,334,13,28,41,2,3:22
7687,490382,2017-04-24,2017,MIL,CIN,11,7,11-7,MIL,9,1,40,44,84,192,144,336,15,15,30,2,3:24
7688,490383,2017-04-24,2017,CHA,KCA,12,1,12-1,CHA,9,1,41,31,72,120,179,299,18,3,21,1,2:47
7689,490391,2017-04-25,2017,PIT,CHN,0,1,1-0,CHN,9,0,34,31,65,115,148,263,8,4,12,0,2:44
7690,490399,2017-04-25,2017,ANA,OAK,2,1,2-1,ANA,11,0,38,39,77,156,137,293,7,8,15,0,3:12
7691,490395,2017-04-25,2017,SFN,LAN,1,2,2-1,LAN,9,0,36,37,73,128,124,252,9,12,21,2,2:59
7692,490402,2017-04-25,2017,BAL,TBA,0,2,2-0,TBA,9,0,32,38,70,147,138,285,5,13,18,2,2:52
7693,490400,2017-04-25,2017,ARI,SDN,9,3,9-3,ARI,9,1,42,39,81,150,159,309,19,12,31,2,3:02
7694,490394,2017-04-25,2017,CHA,KCA,10,5,10-5,CHA,9,1,42,38,80,167,159,326,19,12,31,2,3:21
7695,490401,2017-04-25,2017,DET,SEA,19,9,19-9,DET,9,1,55,48,103,167,201,368,32,24,56,3,3:43
7696,490403,2017-04-25,2017,SLN,TOR,5,6,6-5,TOR,11,0,45,48,93,184,187,371,14,14,28,1,3:46
7697,490392,2017-04-25,2017,MIL,CIN,9,1,9-1,MIL,9,1,41,38,79,141,153,294,18,11,29,2,2:59
7698,490397,2017-04-25,2017,TEX,MIN,1,8,8-1,MIN,9,0,31,44,75,176,129,305,7,21,28,2,3:04
7699,490404,2017-04-25,2017,COL,WAS,12,15,15-12,WAS,9,0,45,47,92,178,151,329,18,20,38,2,3:26 (1:06 delay)
7700,490393,2017-04-25,2017,CLE,HOU,2,4,4-2,HOU,9,0,34,38,72,143,117,260,9,13,22,1,2:46
7701,490413,2017-04-26,2017,BOS,NYA,1,3,3-1,NYA,9,0,34,40,74,166,146,312,8,12,20,2,3:16
7702,490410,2017-04-26,2017,SFN,LAN,4,3,4-3,SFN,10,0,37,41,78,148,147,295,9,11,20,3,3:11
7703,490415,2017-04-26,2017,ARI,SDN,5,8,8-5,SDN,9,0,42,41,83,157,157,314,17,15,32,2,3:14
7704,490414,2017-04-26,2017,ANA,OAK,8,5,8-5,ANA,9,1,42,40,82,162,149,311,17,14,31,2,3:30
7705,490405,2017-04-26,2017,NYN,ATL,2,8,8-2,ATL,9,0,36,47,83,177,138,315,9,20,29,4,3:19
7706,490411,2017-04-26,2017,PHI,MIA,7,4,7-4,PHI,9,1,35,36,71,134,135,269,12,10,22,1,2:41
7707,490416,2017-04-26,2017,DET,SEA,0,8,8-0,SEA,9,0,33,46,79,197,133,330,6,18,24,1,3:18
7708,490412,2017-04-26,2017,TEX,MIN,14,3,14-3,TEX,9,1,46,37,83,134,192,326,25,13,38,4,3:37
7709,490407,2017-04-26,2017,MIL,CIN,9,4,9-4,MIL,9,1,41,38,79,143,142,285,19,11,30,4,2:53
7710,490409,2017-04-26,2017,CHA,KCA,5,2,5-2,CHA,9,1,33,40,73,145,131,276,9,12,21,2,2:58
7711,490417,2017-04-26,2017,BAL,TBA,5,4,5-4,BAL,11,0,46,47,93,180,183,363,18,15,33,4,4:08
7712,490408,2017-04-26,2017,CLE,HOU,7,6,7-6,CLE,9,1,37,40,77,176,144,320,15,12,27,2,3:12
7713,490419,2017-04-26,2017,COL,WAS,4,11,11-4,WAS,9,0,38,45,83,156,169,325,13,19,32,2,3:23
7714,490406,2017-04-26,2017,PIT,CHN,6,5,6-5,PIT,9,1,36,45,81,188,137,325,14,19,33,4,3:22
7715,490426,2017-04-27,2017,ARI,SDN,6,2,6-2,ARI,9,1,34,31,65,116,124,240,11,5,16,1,2:21
7716,490422,2017-04-27,2017,SFN,LAN,1,5,5-1,LAN,10,0,38,42,80,160,152,312,12,13,25,5,3:28
7717,490418,2017-04-27,2017,SLN,TOR,6,4,6-4,SLN,9,1,41,36,77,141,149,290,18,10,28,1,2:56
7718,490429,2017-04-27,2017,COL,WAS,5,16,16-5,WAS,9,0,39,53,92,196,153,349,13,28,41,2,3:25
7719,490424,2017-04-27,2017,BOS,NYA,0,3,3-0,NYA,9,0,29,34,63,120,97,217,3,10,13,1,2:21
7720,490421,2017-04-27,2017,CLE,HOU,4,3,4-3,CLE,9,1,34,40,74,142,134,276,12,15,27,2,2:50 (:15 delay)
7721,490428,2017-04-27,2017,SLN,TOR,8,4,8-4,SLN,11,0,48,46,94,170,152,322,24,14,38,1,3:32
7722,490423,2017-04-27,2017,PHI,MIA,3,2,3-2,PHI,9,1,33,37,70,139,137,276,12,10,22,3,3:15
7723,490418,2017-04-27,2017,SLN,TOR,6,4,6-4,SLN,9,1,41,36,77,141,149,290,18,10,28,1,2:56
7724,490425,2017-04-27,2017,ANA,OAK,2,1,2-1,ANA,9,1,29,34,63,134,106,240,7,6,13,1,2:30
7725,490427,2017-04-27,2017,DET,SEA,1,2,2-1,SEA,9,0,35,35,70,158,125,283,7,9,16,2,3:22 (:45 delay)
7726,490420,2017-04-27,2017,NYN,ATL,5,7,7-5,ATL,9,0,36,42,78,157,122,279,11,16,27,2,2:56
7727,490439,2017-04-28,2017,HOU,OAK,9,4,9-4,HOU,9,1,41,37,78,134,140,274,16,9,25,1,2:58
7728,490436,2017-04-28,2017,TEX,ANA,3,6,6-3,ANA,9,0,33,40,73,150,134,284,7,14,21,0,3:12
7729,490430,2017-04-28,2017,MIL,ATL,8,10,10-8,ATL,9,0,40,42,82,155,156,311,15,16,31,1,3:18
7730,490435,2017-04-28,2017,ARI,COL,1,3,3-1,COL,9,0,35,36,71,128,140,268,9,9,18,2,2:53
7731,490437,2017-04-28,2017,KCA,MIN,4,6,6-4,MIN,9,0,37,37,74,164,141,305,11,9,20,7,3:20
7732,490443,2017-04-28,2017,CLE,SEA,1,3,3-1,SEA,9,0,34,31,65,121,143,264,6,6,12,2,2:36
7733,490433,2017-04-28,2017,DET,CHA,3,7,7-3,CHA,9,0,37,42,79,145,148,293,11,16,27,2,3:25
7734,490432,2017-04-28,2017,BOS,CHN,5,4,5-4,BOS,9,1,36,41,77,157,148,305,16,14,30,3,3:28
7735,490434,2017-04-28,2017,SLN,CIN,7,5,7-5,SLN,9,1,38,40,78,160,136,296,15,14,29,3,3:08
7736,490438,2017-04-28,2017,WAS,NYN,5,7,7-5,NYN,9,0,39,43,82,153,160,313,14,18,32,2,3:24
7737,490440,2017-04-28,2017,LAN,PHI,5,3,5-3,LAN,9,1,37,35,72,142,136,278,13,8,21,2,3:02
7738,490441,2017-04-28,2017,MIA,PIT,2,12,12-2,PIT,9,0,40,51,91,212,152,364,13,27,40,2,3:31
7739,490431,2017-04-28,2017,NYA,BAL,14,11,14-11,NYA,10,0,48,50,98,152,185,337,21,20,41,4,3:41
7740,490442,2017-04-28,2017,SFN,SDN,4,3,4-3,SFN,9,1,35,33,68,120,104,224,10,8,18,0,2:26
7741,490444,2017-04-28,2017,TOR,TBA,4,7,7-4,TBA,9,0,41,40,81,146,152,298,14,14,28,4,3:16
7742,490447,2017-04-29,2017,BOS,CHN,4,7,7-4,CHN,9,0,36,41,77,157,135,292,11,13,24,3,3:00
7743,490459,2017-04-29,2017,TOR,TBA,4,1,4-1,TOR,9,1,31,38,69,156,115,271,9,11,20,1,3:02
7744,490458,2017-04-29,2017,CLE,SEA,4,3,4-3,CLE,9,1,33,34,67,153,128,281,9,7,16,2,2:42
7745,490454,2017-04-29,2017,HOU,OAK,1,2,2-1,OAK,9,0,34,37,71,137,114,251,9,11,20,3,2:49
7746,490448,2017-04-29,2017,DET,CHA,4,6,6-4,CHA,10,0,40,44,84,184,148,332,11,15,26,2,3:36
7747,490450,2017-04-29,2017,ARI,COL,6,7,7-6,COL,9,0,39,42,81,168,154,322,12,17,29,4,3:38
7748,490445,2017-04-29,2017,MIL,ATL,3,11,11-3,ATL,9,0,36,44,80,154,132,286,12,21,33,0,3:06
7749,490453,2017-04-29,2017,WAS,NYN,3,5,5-3,NYN,9,0,38,34,72,127,160,287,13,8,21,2,3:17
7750,490446,2017-04-29,2017,NYA,BAL,12,4,12-4,NYA,9,1,40,41,81,167,165,332,16,13,29,3,3:12
7751,490457,2017-04-29,2017,SFN,SDN,4,12,12-4,SDN,9,0,39,45,84,193,162,355,12,18,30,2,3:32
7752,490456,2017-04-29,2017,MIA,PIT,0,4,4-0,PIT,9,0,29,37,66,143,95,238,3,11,14,1,2:31
7753,490455,2017-04-29,2017,LAN,PHI,6,5,6-5,LAN,9,0,39,43,82,163,157,320,13,17,30,1,3:27
7754,490451,2017-04-29,2017,TEX,ANA,6,3,6-3,TEX,9,1,36,38,74,169,125,294,13,10,23,0,3:03
7755,490470,2017-04-30,2017,LAN,PHI,5,3,5-3,LAN,9,1,36,37,73,147,140,287,15,11,26,2,3:06
7756,490467,2017-04-30,2017,KCA,MIN,5,7,7-5,MIN,9,0,39,44,83,170,130,300,12,17,29,4,3:11
7757,490462,2017-04-30,2017,BOS,CHN,6,2,6-2,BOS,9,1,34,36,70,153,152,305,11,9,20,3,3:28
7758,490466,2017-04-30,2017,TEX,ANA,2,5,5-2,ANA,9,0,35,42,77,137,160,297,9,17,26,4,3:23
7759,490460,2017-04-30,2017,MIL,ATL,4,3,4-3,MIL,9,1,31,34,65,126,115,241,5,9,14,1,2:35
7760,490463,2017-04-30,2017,DET,CHA,7,3,7-3,DET,9,1,39,37,76,163,133,296,18,11,29,2,3:24
7761,490471,2017-04-30,2017,MIA,PIT,10,3,10-3,MIA,9,1,43,38,81,170,161,331,21,14,35,3,3:36
7762,490472,2017-04-30,2017,SFN,SDN,2,5,5-2,SDN,12,0,45,50,95,173,154,327,10,12,22,2,3:23
7763,490469,2017-04-30,2017,HOU,OAK,7,2,7-2,HOU,9,1,36,38,74,137,134,271,12,11,23,2,2:58
7764,490468,2017-04-30,2017,WAS,NYN,23,5,23-5,WAS,9,1,54,38,92,153,202,355,32,11,43,2,3:37
7765,490464,2017-04-30,2017,SLN,CIN,4,5,5-4,CIN,9,0,38,45,83,175,151,326,13,19,32,2,3:20
7766,490465,2017-04-30,2017,ARI,COL,2,0,2-0,ARI,13,0,51,48,99,199,183,382,16,9,25,2,4:02
7767,490473,2017-04-30,2017,CLE,SEA,12,4,12-4,CLE,9,1,41,35,76,138,151,289,18,12,30,3,2:58
7768,490474,2017-04-30,2017,TOR,TBA,3,1,3-1,TOR,9,1,34,34,68,146,131,277,11,9,20,5,3:02
7769,490461,2017-04-30,2017,NYA,BAL,4,7,7-4,BAL,11,0,53,51,104,209,228,437,21,19,40,2,4:37
7770,490481,2017-05-01,2017,CIN,PIT,4,3,4-3,CIN,10,0,37,36,73,142,163,305,9,8,17,1,3:13
7771,490483,2017-05-01,2017,MIA,TBA,2,4,4-2,TBA,9,0,33,40,73,175,128,303,6,13,19,3,3:14
7772,490485,2017-05-01,2017,NYA,TOR,1,7,7-1,TOR,9,0,36,40,76,160,144,304,8,15,23,1,2:58
7773,490479,2017-05-01,2017,ATL,NYN,5,7,7-5,NYN,9,0,37,39,76,132,131,263,12,16,28,3,3:00
7774,490477,2017-05-01,2017,DET,CLE,7,1,7-1,DET,9,1,41,37,78,151,170,321,17,11,28,1,3:14
7775,490475,2017-05-01,2017,BOS,BAL,2,5,5-2,BAL,9,0,35,36,71,160,140,300,11,7,18,2,3:10
7776,490478,2017-05-01,2017,SLN,MIL,5,7,7-5,MIL,10,0,43,41,84,137,163,300,18,15,33,1,3:09
7777,490480,2017-05-01,2017,CHN,PHI,2,10,10-2,PHI,9,0,35,42,77,157,149,306,8,17,25,1,3:06 (1:25 delay)
7778,490482,2017-05-01,2017,LAN,SFN,3,4,4-3,SFN,9,0,34,34,68,139,129,268,7,9,16,1,2:52
7779,490484,2017-05-01,2017,HOU,TEX,6,2,6-2,HOU,9,1,38,34,72,153,125,278,13,9,22,4,2:59
7780,490476,2017-05-01,2017,KCA,CHA,6,1,6-1,KCA,9,1,36,36,72,141,125,266,14,9,23,1,2:36
7781,490489,2017-05-02,2017,DET,CLE,5,2,5-2,DET,9,1,34,38,72,166,119,285,11,11,22,2,3:14
7782,490492,2017-05-02,2017,SLN,MIL,2,1,2-1,SLN,9,1,34,34,68,129,158,287,10,6,16,2,2:47
7783,490498,2017-05-02,2017,MIA,TBA,1,3,3-1,TBA,9,0,37,45,82,179,138,317,11,19,30,1,3:22
7784,490496,2017-05-02,2017,CIN,PIT,3,12,12-3,PIT,9,0,37,45,82,177,137,314,10,19,29,1,3:00
7785,490500,2017-05-02,2017,NYA,TOR,11,5,11-5,NYA,9,1,43,40,83,147,176,323,20,13,33,3,3:31
7786,490493,2017-05-02,2017,ATL,NYN,9,7,9-7,ATL,9,1,40,40,80,141,140,281,19,14,33,3,2:55
7787,490490,2017-05-02,2017,SDN,COL,6,2,6-2,SDN,9,1,34,34,68,145,142,287,10,7,17,3,2:56
7788,490487,2017-05-02,2017,BOS,BAL,5,2,5-2,BOS,9,1,34,32,66,127,126,253,12,5,17,1,2:33
7789,490488,2017-05-02,2017,KCA,CHA,0,6,6-0,CHA,9,0,32,40,72,165,116,281,6,15,21,1,2:43
7790,490494,2017-05-02,2017,MIN,OAK,9,1,9-1,MIN,9,1,38,36,74,144,140,284,15,9,24,0,2:48
7791,490499,2017-05-02,2017,HOU,TEX,8,7,8-7,HOU,9,1,38,39,77,151,142,293,14,12,26,5,3:13
7792,490486,2017-05-02,2017,WAS,ARI,3,6,6-3,ARI,9,0,40,41,81,185,191,376,14,17,31,1,3:48
7793,490491,2017-05-02,2017,SEA,ANA,4,6,6-4,ANA,11,0,47,52,99,212,199,411,14,21,35,5,4:40
7794,490497,2017-05-02,2017,LAN,SFN,13,5,13-5,LAN,9,1,43,40,83,173,158,331,21,13,34,1,3:23
7795,490495,2017-05-02,2017,CHN,PHI,8,3,8-3,CHN,9,1,39,36,75,156,168,324,17,10,27,0,3:24
7796,490513,2017-05-03,2017,LAN,SFN,1,4,4-1,SFN,11,0,38,50,88,188,140,328,7,20,27,1,3:50
7797,490501,2017-05-03,2017,WAS,ARI,2,1,2-1,WAS,9,1,30,38,68,159,129,288,7,12,19,0,2:52
7798,490514,2017-05-03,2017,HOU,TEX,10,1,10-1,HOU,9,1,40,34,74,150,143,293,16,10,26,1,3:01
7799,490503,2017-05-03,2017,KCA,CHA,6,1,6-1,KCA,9,1,34,32,66,137,126,263,11,3,14,2,2:43
7800,490504,2017-05-03,2017,DET,CLE,2,3,3-2,CLE,9,0,35,37,72,131,142,273,9,11,20,1,3:03
7801,490502,2017-05-03,2017,BOS,BAL,4,2,4-2,BOS,9,1,36,39,75,168,139,307,12,11,23,3,3:24
7802,490512,2017-05-03,2017,CIN,PIT,7,2,7-2,CIN,9,1,37,39,76,154,140,294,14,13,27,0,2:48
7803,490506,2017-05-03,2017,SEA,ANA,8,7,8-7,SEA,9,1,38,40,78,144,140,284,16,13,29,5,3:19
7804,490511,2017-05-03,2017,CHN,PHI,5,4,5-4,CHN,9,1,37,36,73,129,155,284,14,10,24,2,3:09
7805,490507,2017-05-03,2017,TBA,MIA,6,10,10-6,MIA,9,0,40,47,87,191,169,360,12,20,32,1,3:33
7806,490515,2017-05-03,2017,NYA,TOR,8,6,8-6,NYA,9,1,42,39,81,153,174,327,20,13,33,4,3:39
7807,490510,2017-05-03,2017,MIN,OAK,7,4,7-4,MIN,9,1,40,38,78,148,179,327,16,13,29,2,3:17
7808,490509,2017-05-03,2017,ATL,NYN,5,16,16-5,NYN,9,0,41,52,93,181,183,364,14,26,40,1,3:34
7809,490505,2017-05-03,2017,SDN,COL,3,11,11-3,COL,9,0,35,45,80,162,130,292,8,15,23,1,2:53
7810,490523,2017-05-04,2017,SLN,MIL,4,5,5-4,MIL,9,0,42,45,87,175,163,338,16,21,37,2,3:29
7811,490522,2017-05-04,2017,TBA,MIA,5,1,5-1,TBA,9,1,37,38,75,167,158,325,12,12,24,1,3:22
7812,490526,2017-05-04,2017,CHN,PHI,5,4,5-4,CHN,13,0,54,57,111,225,185,410,22,22,44,2,4:22
7813,490528,2017-05-04,2017,HOU,TEX,4,10,10-4,TEX,9,0,47,42,89,159,197,356,20,15,35,3,3:52
7814,490517,2017-05-04,2017,BOS,BAL,3,8,8-3,BAL,9,0,36,46,82,167,140,307,10,21,31,1,3:21
7815,490527,2017-05-04,2017,CIN,PIT,4,2,4-2,CIN,9,1,34,35,69,128,120,248,13,8,21,0,2:40 (:56 delay)
7816,490518,2017-05-04,2017,KCA,CHA,3,8,8-3,CHA,9,0,35,42,77,168,129,297,8,16,24,3,3:00
7817,490516,2017-05-04,2017,WAS,ARI,4,2,4-2,WAS,9,1,40,34,74,131,171,302,17,7,24,2,3:18
7818,490521,2017-05-04,2017,SEA,ANA,11,3,11-3,SEA,9,1,43,37,80,124,154,278,22,10,32,0,2:53
7819,490520,2017-05-04,2017,SDN,COL,2,3,3-2,COL,11,0,47,45,92,168,174,342,14,16,30,3,4:13
7820,490525,2017-05-04,2017,MIN,OAK,5,8,8-5,OAK,9,0,39,48,87,194,168,362,12,23,35,2,3:48
7821,490537,2017-05-05,2017,PIT,MIL,4,0,4-0,PIT,9,1,34,35,69,138,115,253,10,8,18,1,2:41 (2:27 delay)
7822,490540,2017-05-05,2017,ATL,SLN,0,10,10-0,SLN,9,0,37,48,85,184,137,321,11,22,33,0,3:13
7823,490534,2017-05-05,2017,ANA,HOU,6,7,7-6,HOU,10,0,38,41,79,145,136,281,12,14,26,2,3:05
7824,490529,2017-05-05,2017,COL,ARI,3,6,6-3,ARI,9,0,37,38,75,140,137,277,10,11,21,1,2:56
7825,490532,2017-05-05,2017,KCA,CLE,3,1,3-1,KCA,9,1,36,32,68,134,151,285,13,6,19,3,2:50
7826,490538,2017-05-05,2017,CHN,NYA,2,3,3-2,NYA,9,0,35,39,74,171,147,318,7,15,22,1,3:17
7827,490539,2017-05-05,2017,CIN,SFN,13,3,13-3,CIN,9,1,52,35,87,144,181,325,30,9,39,2,3:15 (1:50 delay)
7828,490533,2017-05-05,2017,OAK,DET,2,7,7-2,DET,9,0,38,41,79,151,116,267,11,15,26,1,2:54
7829,490535,2017-05-05,2017,SDN,LAN,2,8,8-2,LAN,9,0,36,43,79,175,167,342,10,18,28,6,4:11
7830,490542,2017-05-05,2017,TBA,TOR,4,8,8-4,TOR,9,0,41,38,79,171,157,328,13,12,25,5,3:32
7831,490541,2017-05-05,2017,SEA,TEX,1,3,3-1,TEX,13,0,52,50,102,206,202,408,19,12,31,1,5:02
7832,490536,2017-05-05,2017,NYN,MIA,8,7,8-7,NYN,9,1,37,46,83,173,133,306,16,21,37,3,3:14
7833,490543,2017-05-05,2017,PHI,WAS,2,4,4-2,WAS,9,0,40,42,82,156,175,331,14,16,30,2,3:20
7834,490530,2017-05-05,2017,MIN,BOS,4,3,4-3,MIN,9,0,38,38,76,143,152,295,13,12,25,4,3:24
7835,490531,2017-05-05,2017,BAL,CHA,4,2,4-2,BAL,9,1,36,39,75,161,135,296,11,15,26,6,3:17
7836,490544,2017-05-06,2017,COL,ARI,9,1,9-1,COL,9,1,39,34,73,136,141,277,16,8,24,1,3:04
7837,490551,2017-05-06,2017,NYN,MIA,11,3,11-3,NYN,9,1,43,37,80,126,149,275,17,12,29,3,2:48 (:39 delay)
7838,490550,2017-05-06,2017,SDN,LAN,2,10,10-2,LAN,9,0,39,42,81,168,160,328,12,18,30,3,3:26
7839,490549,2017-05-06,2017,ANA,HOU,2,1,2-1,ANA,9,0,32,36,68,140,116,256,8,12,20,0,2:47
7840,490557,2017-05-06,2017,TBA,TOR,6,1,6-1,TBA,9,1,35,30,65,125,144,269,10,4,14,0,2:42
7841,490553,2017-05-06,2017,CHN,NYA,6,11,11-6,NYA,9,0,40,45,85,187,155,342,12,20,32,3,3:19
7842,490556,2017-05-06,2017,SEA,TEX,8,2,8-2,SEA,9,1,41,35,76,134,149,283,17,8,25,2,3:12
7843,490558,2017-05-06,2017,PHI,WAS,2,6,6-2,WAS,9,0,35,37,72,142,161,303,13,10,23,1,3:01
7844,490555,2017-05-06,2017,ATL,SLN,3,5,5-3,SLN,9,0,33,41,74,165,123,288,6,14,20,0,2:59
7845,490546,2017-05-06,2017,BAL,CHA,6,5,6-5,BAL,9,1,39,37,76,156,151,307,14,10,24,1,3:04 (:43 delay)
7846,490552,2017-05-06,2017,PIT,MIL,2,1,2-1,PIT,10,0,37,34,71,139,128,267,13,5,18,0,2:58
7847,490547,2017-05-06,2017,KCA,CLE,1,3,3-1,CLE,9,0,32,39,71,147,113,260,5,13,18,1,2:37
7848,490548,2017-05-06,2017,OAK,DET,6,5,6-5,OAK,9,0,35,45,80,199,132,331,9,15,24,4,3:28
7849,490545,2017-05-06,2017,MIN,BOS,1,11,11-1,BOS,9,0,34,49,83,179,136,315,8,22,30,2,3:03
7850,490554,2017-05-06,2017,CIN,SFN,14,2,14-2,CIN,9,1,46,36,82,131,171,302,21,10,31,1,2:46
7851,490559,2017-05-07,2017,COL,ARI,5,2,5-2,COL,9,1,33,31,64,122,125,247,10,7,17,3,2:35 (1:22 delay)
7852,490572,2017-05-07,2017,TBA,TOR,1,2,2-1,TOR,9,0,34,33,67,104,137,241,6,7,13,0,2:46
7853,490561,2017-05-07,2017,BAL,CHA,4,0,4-0,BAL,9,1,38,38,76,158,134,292,14,11,25,1,3:04
7854,490563,2017-05-07,2017,OAK,DET,8,6,8-6,OAK,9,0,40,38,78,159,159,318,15,11,26,3,3:41
7855,490566,2017-05-07,2017,NYN,MIA,0,7,7-0,MIA,9,0,32,43,75,168,111,279,5,16,21,2,2:40
7856,490567,2017-05-07,2017,PIT,MIL,2,6,6-2,MIL,9,0,37,39,76,134,157,291,11,12,23,4,3:07
7857,490569,2017-05-07,2017,CIN,SFN,4,0,4-0,CIN,9,1,33,32,65,119,134,253,9,6,15,0,2:28
7858,490564,2017-05-07,2017,ANA,HOU,3,5,5-3,HOU,9,0,36,35,71,118,159,277,10,9,19,1,3:00
7859,490562,2017-05-07,2017,KCA,CLE,0,1,1-0,CLE,9,0,34,35,69,130,146,276,8,9,17,3,2:51
7860,490560,2017-05-07,2017,MIN,BOS,6,17,17-6,BOS,9,0,39,52,91,184,181,365,13,28,41,5,3:46
7861,490571,2017-05-07,2017,SEA,TEX,4,3,4-3,SEA,9,1,34,37,71,142,146,288,12,9,21,4,3:09
7862,490573,2017-05-07,2017,PHI,WAS,6,5,6-5,PHI,10,0,43,43,86,175,174,349,17,13,30,4,3:51
7863,490570,2017-05-07,2017,ATL,SLN,4,6,6-4,SLN,14,0,57,56,113,208,190,398,22,15,37,0,4:06
7864,490568,2017-05-07,2017,CHN,NYA,4,5,5-4,NYA,18,0,76,70,146,294,289,583,26,15,41,1,6:05
7865,490582,2017-05-08,2017,BAL,WAS,6,4,6-4,BAL,9,1,37,36,73,160,148,308,14,10,24,0,2:54
7866,490577,2017-05-08,2017,OAK,ANA,3,2,3-2,OAK,11,0,38,44,82,148,154,302,6,11,17,0,3:06
7867,490623,2017-05-08,2017,MIA,SLN,4,9,9-4,SLN,9,0,33,45,78,181,130,311,9,16,25,1,2:47
7868,490581,2017-05-08,2017,SDN,TEX,5,1,5-1,SDN,9,1,36,34,70,146,127,273,12,8,20,1,2:38
7869,490579,2017-05-08,2017,LAN,PIT,12,1,12-1,LAN,9,1,43,34,77,154,170,324,19,7,26,0,3:08
7870,490580,2017-05-08,2017,NYN,SFN,4,3,4-3,NYN,9,0,41,35,76,142,174,316,16,8,24,4,3:22
7871,490576,2017-05-08,2017,TBA,KCA,3,7,7-3,KCA,9,0,39,41,80,171,150,321,13,16,29,2,3:18
7872,490578,2017-05-08,2017,CIN,NYA,4,10,10-4,NYA,9,0,37,48,85,193,134,327,12,23,35,1,3:28
7873,490575,2017-05-08,2017,TOR,CLE,4,2,4-2,TOR,9,1,32,35,67,146,159,305,11,11,22,1,2:55
7874,490591,2017-05-09,2017,CIN,NYA,5,3,5-3,CIN,9,1,37,38,75,152,126,278,13,14,27,0,2:49
7875,490593,2017-05-09,2017,NYN,SFN,6,1,6-1,NYN,9,1,37,33,70,129,137,266,13,7,20,2,2:38
7876,490583,2017-05-09,2017,HOU,ATL,8,3,8-3,HOU,9,1,35,37,72,136,134,270,11,10,21,2,2:41
7877,490595,2017-05-09,2017,MIA,SLN,5,6,6-5,SLN,9,0,36,37,73,137,146,283,12,13,25,2,2:56
7878,490589,2017-05-09,2017,OAK,ANA,3,7,7-3,ANA,9,0,39,37,76,134,157,291,14,11,25,2,3:07
7879,490586,2017-05-09,2017,TOR,CLE,0,6,6-0,CLE,9,0,29,40,69,147,120,267,4,14,18,3,2:46
7880,490584,2017-05-09,2017,MIL,BOS,11,7,11-7,MIL,9,1,38,43,81,209,140,349,17,18,35,3,3:38
7881,490596,2017-05-09,2017,SDN,TEX,0,11,11-0,TEX,9,0,30,44,74,167,104,271,5,18,23,0,2:33
7882,490590,2017-05-09,2017,CHA,MIN,2,7,7-2,MIN,9,0,35,41,76,165,141,306,9,14,23,3,2:58
7883,490594,2017-05-09,2017,PHI,SEA,9,10,10-9,SEA,9,0,43,50,93,185,154,339,19,22,41,3,3:48
7884,490574,2017-05-09,2017,COL,CHN,10,4,10-4,COL,9,1,41,39,80,154,146,300,18,13,31,1,3:01
7885,490585,2017-05-09,2017,COL,CHN,1,8,8-1,CHN,9,0,37,41,78,151,144,295,10,13,23,2,3:01
7886,490588,2017-05-09,2017,TBA,KCA,6,7,7-6,KCA,12,0,52,52,104,188,191,379,21,18,39,5,4:24
7887,490574,2017-05-09,2017,COL,CHN,10,4,10-4,COL,9,1,41,39,80,154,146,300,18,13,31,1,3:01
7888,490597,2017-05-09,2017,BAL,WAS,5,4,5-4,BAL,12,0,50,46,96,173,178,351,17,14,31,4,3:53
7889,490592,2017-05-09,2017,LAN,PIT,4,3,4-3,LAN,10,0,45,35,80,146,161,307,16,6,22,4,3:38
7890,490587,2017-05-09,2017,ARI,DET,3,7,7-3,DET,9,0,39,41,80,155,149,304,13,16,29,5,3:22
7891,490598,2017-05-10,2017,HOU,ATL,4,2,4-2,HOU,9,1,35,34,69,142,138,280,13,10,23,0,2:49
7892,490604,2017-05-10,2017,TBA,KCA,12,1,12-1,TBA,9,1,43,35,78,122,127,249,21,9,30,0,2:49
7893,490603,2017-05-10,2017,ARI,DET,7,1,7-1,ARI,9,1,41,30,71,119,130,249,19,6,25,0,2:37
7894,490607,2017-05-10,2017,LAN,PIT,5,2,5-2,LAN,9,1,33,32,65,110,122,232,12,5,17,1,2:37
7895,490601,2017-05-10,2017,COL,CHN,3,0,3-0,COL,9,1,32,31,63,113,119,232,8,4,12,1,2:14 (:50 delay)
7896,490608,2017-05-10,2017,TEX,SDN,4,3,4-3,TEX,9,1,35,38,73,143,139,282,16,11,27,2,3:24
7897,490599,2017-05-10,2017,WAS,BAL,7,6,7-6,WAS,9,0,43,38,81,138,192,330,20,13,33,2,3:17
7898,490600,2017-05-10,2017,MIL,BOS,7,4,7-4,MIL,9,1,37,40,77,165,142,307,14,16,30,4,3:37
7899,490605,2017-05-10,2017,OAK,ANA,3,1,3-1,OAK,9,1,34,34,68,148,153,301,11,7,18,2,2:55
7900,490611,2017-05-10,2017,MIA,SLN,5,7,7-5,SLN,9,0,43,43,86,160,208,368,18,17,35,2,3:46
7901,490602,2017-05-10,2017,TOR,CLE,8,7,8-7,TOR,9,0,42,40,82,163,184,347,17,15,32,4,3:31
7902,490610,2017-05-10,2017,PHI,SEA,6,11,11-6,SEA,9,0,43,51,94,180,174,354,16,25,41,1,3:40
7903,490609,2017-05-10,2017,NYN,SFN,5,6,6-5,SFN,9,0,43,43,86,160,158,318,15,15,30,6,3:33
7904,490621,2017-05-11,2017,TEX,SDN,5,2,5-2,TEX,9,0,33,36,69,120,117,237,10,12,22,2,2:39
7905,490617,2017-05-11,2017,TBA,KCA,0,6,6-0,KCA,9,0,29,38,67,170,119,289,5,12,17,1,2:41
7906,490620,2017-05-11,2017,ARI,PIT,2,1,2-1,ARI,9,1,31,28,59,128,113,241,8,3,11,0,2:34
7907,490613,2017-05-11,2017,MIL,BOS,1,4,4-1,BOS,9,0,32,40,72,171,138,309,6,14,20,3,3:29
7908,490619,2017-05-11,2017,CHA,MIN,6,7,7-6,MIN,9,0,39,38,77,154,158,312,12,12,24,4,3:27
7909,490615,2017-05-11,2017,ANA,DET,1,7,7-1,DET,9,0,35,41,76,153,142,295,7,15,22,0,3:00
7910,490622,2017-05-11,2017,TOR,SEA,7,2,7-2,TOR,9,1,36,37,73,145,136,281,13,10,23,0,2:45
7911,490614,2017-05-11,2017,SFN,CIN,2,3,3-2,CIN,9,0,38,35,73,124,133,257,12,10,22,1,2:36
7912,490616,2017-05-11,2017,NYA,HOU,2,3,3-2,HOU,9,0,38,38,76,144,153,297,11,12,23,2,3:09
7913,490618,2017-05-11,2017,COL,LAN,10,7,10-7,COL,9,1,44,43,87,148,166,314,20,17,37,3,3:23
7914,490629,2017-05-12,2017,NYA,HOU,1,5,5-1,HOU,9,0,35,40,75,148,141,289,7,13,20,1,3:09
7915,490626,2017-05-12,2017,SLN,CHN,2,3,3-2,CHN,9,0,36,39,75,147,166,313,10,11,21,2,3:01
7916,490630,2017-05-12,2017,COL,LAN,2,6,6-2,LAN,9,0,33,37,70,145,120,265,9,13,22,2,2:53
7917,490628,2017-05-12,2017,ANA,DET,7,0,7-0,ANA,9,1,40,32,72,132,140,272,17,6,23,1,3:04
7918,490625,2017-05-12,2017,KCA,BAL,3,2,3-2,KCA,9,1,34,36,70,122,164,286,12,11,23,0,2:37
7919,490632,2017-05-12,2017,MIL,NYN,7,4,7-4,MIL,9,1,41,36,77,149,149,298,19,12,31,2,3:08
7920,490631,2017-05-12,2017,CLE,MIN,0,1,1-0,MIN,9,0,35,32,67,118,124,242,8,7,15,2,2:30
7921,490638,2017-05-12,2017,BOS,TBA,4,5,5-4,TBA,9,0,37,38,75,150,147,297,9,11,20,5,3:24
7922,490633,2017-05-12,2017,TEX,OAK,5,2,5-2,TEX,9,0,35,34,69,146,115,261,12,9,21,1,2:58
7923,490635,2017-05-12,2017,ARI,PIT,11,4,11-4,ARI,9,1,43,36,79,127,161,288,20,9,29,1,2:57
7924,490637,2017-05-12,2017,TOR,SEA,4,0,4-0,TOR,9,1,34,34,68,130,99,229,11,7,18,4,2:36
7925,490624,2017-05-12,2017,MIA,ATL,4,8,8-4,ATL,9,0,39,43,82,171,149,320,13,20,33,2,3:11
7926,490636,2017-05-12,2017,CHA,SDN,3,6,6-3,SDN,9,0,37,41,78,149,133,282,10,14,24,3,3:16
7927,490627,2017-05-12,2017,SFN,CIN,3,2,3-2,SFN,17,0,58,69,127,269,222,491,13,22,35,2,5:28
7928,490643,2017-05-13,2017,ANA,DET,3,4,4-3,DET,9,0,37,36,73,137,146,283,11,10,21,1,3:14
7929,490648,2017-05-13,2017,TEX,OAK,6,5,6-5,TEX,9,1,37,36,73,139,165,304,14,12,26,2,3:26
7930,490647,2017-05-13,2017,MIL,NYN,11,4,11-4,MIL,9,1,44,40,84,173,158,331,20,14,34,1,3:27
7931,490649,2017-05-13,2017,WAS,PHI,6,4,6-4,WAS,9,0,39,39,78,200,155,355,14,14,28,4,3:34
7932,490641,2017-05-13,2017,SLN,CHN,5,3,5-3,SLN,9,1,34,37,71,127,151,278,13,10,23,2,2:51
7933,490653,2017-05-13,2017,BOS,TBA,6,3,6-3,BOS,9,1,33,32,65,153,147,300,10,5,15,1,2:54
7934,490645,2017-05-13,2017,COL,LAN,0,4,4-0,LAN,9,0,34,37,71,160,141,301,8,11,19,1,3:18
7935,490640,2017-05-13,2017,KCA,BAL,4,3,4-3,KCA,9,1,38,35,73,147,157,304,15,8,23,1,3:04
7936,490642,2017-05-13,2017,SFN,CIN,3,1,3-1,SFN,9,1,31,39,70,145,98,243,8,12,20,1,2:33
7937,490652,2017-05-13,2017,TOR,SEA,7,2,7-2,TOR,9,1,38,40,78,154,140,294,12,16,28,4,3:25
7938,490650,2017-05-13,2017,ARI,PIT,3,4,4-3,PIT,9,0,37,39,76,142,146,288,11,14,25,1,3:00
7939,490646,2017-05-13,2017,CLE,MIN,1,4,4-1,MIN,9,0,32,35,67,155,125,280,5,11,16,2,2:57
7940,490639,2017-05-13,2017,MIA,ATL,1,3,3-1,ATL,9,0,34,37,71,132,135,267,7,11,18,0,2:49
7941,490651,2017-05-13,2017,CHA,SDN,5,4,5-4,CHA,9,0,38,37,75,160,148,308,13,10,23,4,3:16
7942,490654,2017-05-14,2017,MIA,ATL,3,1,3-1,MIA,9,1,32,40,72,119,114,233,10,17,27,1,2:27
7943,490658,2017-05-14,2017,ANA,DET,4,1,4-1,ANA,9,1,35,31,66,132,132,264,12,7,19,4,3:09
7944,490664,2017-05-14,2017,WAS,PHI,3,4,4-3,PHI,9,0,37,38,75,168,121,289,12,14,26,3,3:02
7945,490663,2017-05-14,2017,TEX,OAK,6,4,6-4,TEX,9,1,35,39,74,130,125,255,14,14,28,4,2:51
7946,490655,2017-05-14,2017,KCA,BAL,9,8,9-8,KCA,9,1,44,47,91,175,182,357,19,20,39,5,3:31
7947,490656,2017-05-14,2017,SLN,CHN,5,0,5-0,SLN,9,1,37,33,70,130,133,263,14,8,22,0,2:38
7948,490667,2017-05-14,2017,TOR,SEA,3,2,3-2,TOR,9,0,37,35,72,128,164,292,12,9,21,3,3:17
7949,490661,2017-05-14,2017,CLE,MIN,8,3,8-3,CLE,9,1,40,36,76,151,160,311,17,10,27,3,3:00
7950,490634,2017-05-14,2017,WAS,PHI,6,5,6-5,WAS,9,1,36,39,75,149,157,306,13,13,26,2,3:34
7951,490644,2017-05-14,2017,NYA,HOU,7,10,10-7,HOU,9,0,43,41,84,169,188,357,17,13,30,5,3:49
7952,490659,2017-05-14,2017,NYA,HOU,11,6,11-6,NYA,9,1,40,41,81,181,158,339,15,15,30,4,3:20
7953,490657,2017-05-14,2017,SFN,CIN,8,3,8-3,SFN,9,1,39,36,75,146,133,279,14,11,25,2,2:55
7954,490660,2017-05-14,2017,COL,LAN,9,6,9-6,COL,9,1,36,44,80,174,144,318,16,18,34,5,3:38
7955,490666,2017-05-14,2017,CHA,SDN,9,3,9-3,CHA,9,1,41,35,76,148,155,303,18,10,28,2,3:16
7956,490634,2017-05-14,2017,WAS,PHI,6,5,6-5,WAS,9,1,36,39,75,149,157,306,13,13,26,2,3:34
7957,490662,2017-05-14,2017,MIL,NYN,11,9,11-9,MIL,9,1,42,42,84,163,180,343,18,17,35,5,3:33
7958,490644,2017-05-14,2017,NYA,HOU,7,10,10-7,HOU,9,0,43,41,84,169,188,357,17,13,30,5,3:49
7959,490665,2017-05-14,2017,ARI,PIT,4,6,6-4,PIT,10,0,49,46,95,191,190,381,22,16,38,1,4:08
7960,490668,2017-05-14,2017,BOS,TBA,2,11,11-2,TBA,9,0,38,48,86,203,167,370,10,22,32,6,4:32
7961,490669,2017-05-15,2017,TOR,ATL,6,10,10-6,ATL,9,0,43,46,89,157,159,316,15,21,36,4,3:15
7962,490676,2017-05-15,2017,CLE,TBA,8,7,8-7,CLE,9,1,41,45,86,175,133,308,19,19,38,4,3:33
7963,490675,2017-05-15,2017,SEA,OAK,6,5,6-5,SEA,9,1,35,41,76,166,147,313,11,15,26,4,3:14
7964,490671,2017-05-15,2017,MIA,HOU,2,7,7-2,HOU,9,0,38,40,78,148,146,294,14,16,30,1,2:57
7965,490674,2017-05-15,2017,ARI,NYN,7,3,7-3,ARI,9,1,39,37,76,136,151,287,17,10,27,4,3:02
7966,490672,2017-05-15,2017,SFN,LAN,8,4,8-4,SFN,9,1,37,37,74,162,143,305,12,12,24,5,3:09
7967,490670,2017-05-15,2017,ANA,CHA,5,3,5-3,ANA,9,1,34,35,69,137,152,289,10,8,18,3,3:01
7968,490673,2017-05-15,2017,SDN,MIL,6,5,6-5,SDN,10,0,43,41,84,152,166,318,18,13,31,2,3:37
7969,490686,2017-05-16,2017,ARI,NYN,5,4,5-4,ARI,9,1,34,35,69,144,138,282,13,8,21,3,2:52
7970,490690,2017-05-16,2017,CLE,TBA,4,6,6-4,TBA,9,0,35,39,74,159,137,296,9,13,22,2,3:12
7971,490687,2017-05-16,2017,KCA,NYA,1,7,7-1,NYA,9,0,37,43,80,172,126,298,11,16,27,1,3:02
7972,490685,2017-05-16,2017,SDN,MIL,2,6,6-2,MIL,9,0,34,39,73,138,130,268,9,13,22,1,2:41
7973,490684,2017-05-16,2017,SFN,LAN,2,1,2-1,SFN,9,1,33,34,67,132,133,265,12,9,21,1,2:47
7974,490688,2017-05-16,2017,SEA,OAK,6,9,9-6,OAK,9,0,38,44,82,167,159,326,14,18,32,3,3:25
7975,490682,2017-05-16,2017,MIN,COL,3,7,7-3,COL,9,0,37,38,75,135,150,285,11,11,22,3,3:13
7976,490689,2017-05-16,2017,TEX,PHI,5,1,5-1,TEX,9,1,35,33,68,112,128,240,11,6,17,0,2:44
7977,490677,2017-05-16,2017,TOR,ATL,5,9,9-5,ATL,9,0,37,42,79,147,140,287,12,18,30,3,3:07
7978,490681,2017-05-16,2017,CHN,CIN,9,5,9-5,CHN,9,1,40,40,80,168,141,309,18,13,31,2,3:07
7979,490679,2017-05-16,2017,SLN,BOS,3,6,6-3,BOS,9,0,36,37,73,150,157,307,10,10,20,3,3:21
7980,490678,2017-05-16,2017,DET,BAL,11,13,13-11,BAL,13,0,65,63,128,242,255,497,30,24,54,7,5:19
7981,490683,2017-05-16,2017,MIA,HOU,2,12,12-2,HOU,9,0,34,47,81,186,126,312,6,19,25,2,3:00
7982,490691,2017-05-16,2017,PIT,WAS,4,8,8-4,WAS,9,0,38,41,79,161,178,339,11,16,27,4,3:30
7983,490680,2017-05-16,2017,ANA,CHA,7,6,7-6,ANA,11,0,48,45,93,153,187,340,21,13,34,3,4:01
7984,490704,2017-05-17,2017,CLE,TBA,4,7,7-4,TBA,9,0,37,39,76,135,146,281,10,14,24,4,3:20
7985,490706,2017-05-17,2017,PIT,WAS,6,1,6-1,PIT,9,1,37,32,69,134,143,277,15,6,21,2,3:03
7986,490699,2017-05-17,2017,SDN,MIL,1,3,3-1,MIL,9,0,35,36,71,136,144,280,8,9,17,0,2:51
7987,490700,2017-05-17,2017,ARI,NYN,5,4,5-4,ARI,11,0,43,46,89,186,159,345,13,15,28,2,3:30
7988,490698,2017-05-17,2017,SFN,LAN,1,6,6-1,LAN,9,0,30,38,68,139,118,257,4,11,15,0,2:37
7989,490694,2017-05-17,2017,ANA,CHA,12,8,12-8,ANA,9,1,41,42,83,146,156,302,19,17,36,5,3:28
7990,490702,2017-05-17,2017,SEA,OAK,4,0,4-0,SEA,9,1,34,31,65,125,153,278,9,4,13,1,2:39
7991,490705,2017-05-17,2017,ATL,TOR,8,4,8-4,ATL,9,1,37,36,73,148,138,286,12,10,22,2,2:59
7992,490695,2017-05-17,2017,CHN,CIN,7,5,7-5,CHN,9,1,37,39,76,167,154,321,13,12,25,2,3:06
7993,490703,2017-05-17,2017,TEX,PHI,9,3,9-3,TEX,9,1,43,34,77,114,146,260,23,11,34,1,2:48
7994,490697,2017-05-17,2017,MIA,HOU,0,3,3-0,HOU,9,0,36,40,76,150,144,294,9,12,21,1,2:52
7995,490692,2017-05-17,2017,DET,BAL,5,4,5-4,DET,9,1,37,39,76,144,153,297,14,12,26,2,3:15
7996,490693,2017-05-17,2017,SLN,BOS,4,5,5-4,BOS,13,0,52,53,105,197,194,391,17,17,34,2,4:20
7997,490701,2017-05-17,2017,KCA,NYA,7,11,11-7,NYA,9,0,40,46,86,182,156,338,14,21,35,3,3:23
7998,490696,2017-05-18,2017,MIN,COL,2,0,2-0,MIN,9,1,37,32,69,124,156,280,14,7,21,1,2:52
7999,490717,2017-05-18,2017,PIT,WAS,10,4,10-4,PIT,9,1,41,37,78,150,176,326,18,10,28,3,3:17
8000,490707,2017-05-18,2017,DET,BAL,6,5,6-5,DET,9,1,36,36,72,140,127,267,15,9,24,1,2:53
8001,490709,2017-05-18,2017,SEA,CHA,5,4,5-4,SEA,9,0,38,38,76,149,135,284,14,11,25,0,3:02
8002,490713,2017-05-18,2017,SDN,MIL,2,4,4-2,MIL,9,0,35,38,73,137,140,277,10,14,24,1,3:01
8003,490696,2017-05-18,2017,MIN,COL,2,0,2-0,MIN,9,1,37,32,69,124,156,280,14,7,21,1,2:52
8004,490712,2017-05-18,2017,LAN,MIA,7,2,7-2,LAN,9,1,40,36,76,137,151,288,22,11,33,3,3:16
8005,490716,2017-05-18,2017,ATL,TOR,0,9,9-0,TOR,9,0,35,43,78,165,140,305,8,17,25,2,3:02 (:37 delay)
8006,490710,2017-05-18,2017,CHN,CIN,9,5,9-5,CHN,9,1,41,42,83,155,156,311,19,14,33,2,3:03
8007,490714,2017-05-18,2017,KCA,NYA,5,1,5-1,KCA,9,1,31,36,67,141,117,258,8,9,17,0,2:34
8008,490708,2017-05-18,2017,OAK,BOS,8,3,8-3,OAK,9,1,37,35,72,145,163,308,16,9,25,1,3:09
8009,490711,2017-05-18,2017,MIN,COL,1,5,5-1,COL,9,0,37,35,72,130,159,289,11,11,22,3,2:53
8010,490715,2017-05-18,2017,TEX,PHI,8,4,8-4,TEX,9,1,39,35,74,134,184,318,16,8,24,3,3:12
8011,490724,2017-05-19,2017,NYN,ANA,3,0,3-0,NYN,9,1,35,36,71,143,130,273,10,11,21,1,2:53
8012,490730,2017-05-19,2017,DET,TEX,3,5,5-3,TEX,9,0,40,36,76,148,183,331,12,12,24,1,3:23
8013,490727,2017-05-19,2017,TBA,NYA,5,4,5-4,TBA,9,1,40,35,75,119,158,277,16,11,27,4,3:18
8014,490725,2017-05-19,2017,LAN,MIA,7,2,7-2,LAN,9,1,36,36,72,122,141,263,13,12,25,1,2:58
8015,490718,2017-05-19,2017,SDN,ARI,1,10,10-1,ARI,9,0,34,49,83,215,134,349,8,23,31,2,3:12
8016,490720,2017-05-19,2017,SEA,CHA,1,2,2-1,CHA,10,0,33,39,72,140,123,263,2,10,12,0,2:46
8017,490728,2017-05-19,2017,PIT,PHI,2,7,7-2,PHI,9,0,32,38,70,136,125,261,4,11,15,1,2:54
8018,490719,2017-05-19,2017,OAK,BOS,3,2,3-2,OAK,10,0,34,42,76,166,139,305,8,14,22,0,3:12
8019,490723,2017-05-19,2017,MIN,KCA,4,3,4-3,MIN,10,0,42,41,83,154,162,316,15,12,27,1,3:20
8020,490729,2017-05-19,2017,SLN,SFN,5,6,6-5,SFN,9,0,37,45,82,168,123,291,13,21,34,4,3:15 (:46 delay)
8021,490721,2017-05-19,2017,HOU,CLE,3,5,5-3,CLE,9,0,34,40,74,162,142,304,7,14,21,4,3:02
8022,490732,2017-05-19,2017,ATL,WAS,7,4,7-4,ATL,9,1,42,38,80,161,177,338,20,12,32,2,3:32
8023,490731,2017-05-19,2017,BAL,TOR,5,3,5-3,BAL,10,0,42,41,83,169,156,325,13,13,26,0,3:29 (1:27 delay)
8024,490726,2017-05-19,2017,CHN,MIL,3,6,6-3,MIL,9,0,35,46,81,209,144,353,7,19,26,1,3:27 (1:59 delay)
8025,490722,2017-05-19,2017,CIN,COL,6,12,12-6,COL,9,0,39,50,89,203,164,367,13,24,37,1,3:38
8026,490735,2017-05-20,2017,SEA,CHA,1,16,16-1,CHA,9,0,31,47,78,166,126,292,8,21,29,1,2:52
8027,490733,2017-05-20,2017,SDN,ARI,1,9,9-1,ARI,9,0,37,45,82,170,146,316,10,19,29,2,2:56
8028,490747,2017-05-20,2017,ATL,WAS,5,2,5-2,ATL,9,1,36,35,71,160,159,319,13,8,21,1,3:20 (1:50 delay)
8029,490736,2017-05-20,2017,HOU,CLE,0,3,3-0,CLE,9,0,30,35,65,125,134,259,5,9,14,2,2:35
8030,490746,2017-05-20,2017,BAL,TOR,7,5,7-5,BAL,9,1,40,38,78,159,150,309,19,13,32,4,3:22
8031,490743,2017-05-20,2017,PIT,PHI,6,3,6-3,PIT,9,1,39,35,74,107,162,269,15,9,24,2,2:52
8032,490745,2017-05-20,2017,DET,TEX,9,3,9-3,DET,9,1,37,35,72,146,148,294,13,7,20,1,2:58
8033,490734,2017-05-20,2017,OAK,BOS,8,3,8-3,OAK,9,1,40,35,75,145,196,341,16,7,23,1,3:22
8034,490742,2017-05-20,2017,TBA,NYA,9,5,9-5,TBA,9,1,43,37,80,157,177,334,20,10,30,4,3:50
8035,490744,2017-05-20,2017,SLN,SFN,1,3,3-1,SFN,13,0,48,45,93,151,169,320,11,8,19,2,3:42 (:42 delay)
8036,490740,2017-05-20,2017,LAN,MIA,6,10,10-6,MIA,9,0,38,44,82,175,159,334,11,18,29,3,3:27
8037,490739,2017-05-20,2017,NYN,ANA,7,5,7-5,NYN,9,1,39,42,81,179,146,325,16,17,33,5,3:37
8038,490737,2017-05-20,2017,CIN,COL,12,8,12-8,CIN,9,1,45,43,88,158,165,323,22,19,41,3,3:32
8039,490762,2017-05-21,2017,ATL,WAS,2,3,3-2,WAS,9,0,33,35,68,111,133,244,7,7,14,1,2:50
8040,490755,2017-05-21,2017,LAN,MIA,6,3,6-3,LAN,9,1,39,35,74,118,151,269,16,9,25,1,2:46
8041,490757,2017-05-21,2017,TBA,NYA,2,3,3-2,NYA,9,0,32,38,70,158,146,304,6,10,16,4,3:26
8042,490753,2017-05-21,2017,MIN,KCA,4,6,6-4,KCA,9,0,41,42,83,163,174,337,15,18,33,3,3:21
8043,490759,2017-05-21,2017,SLN,SFN,8,3,8-3,SLN,9,1,37,37,74,158,137,295,15,10,25,2,2:53
8044,490758,2017-05-21,2017,PIT,PHI,1,0,1-0,PIT,9,1,32,33,65,150,108,258,11,5,16,2,2:45
8045,490738,2017-05-21,2017,MIN,KCA,8,4,8-4,MIN,9,1,40,34,74,113,156,269,17,9,26,0,2:29
8046,490761,2017-05-21,2017,BAL,TOR,1,3,3-1,TOR,9,0,35,34,69,133,135,268,9,8,17,1,2:31
8047,490748,2017-05-21,2017,SDN,ARI,5,1,5-1,SDN,9,1,34,32,66,96,117,213,12,5,17,0,2:16
8048,490750,2017-05-21,2017,SEA,CHA,1,8,8-1,CHA,9,0,32,42,74,160,118,278,9,16,25,2,2:46
8049,490738,2017-05-21,2017,MIN,KCA,8,4,8-4,MIN,9,1,40,34,74,113,156,269,17,9,26,0,2:29
8050,490751,2017-05-21,2017,HOU,CLE,6,8,8-6,CLE,9,0,36,42,78,165,158,323,10,16,26,2,3:06
8051,490749,2017-05-21,2017,OAK,BOS,3,12,12-3,BOS,9,0,34,46,80,182,115,297,7,21,28,2,3:11
8052,490760,2017-05-21,2017,DET,TEX,2,5,5-2,TEX,9,0,38,43,81,150,153,303,11,20,31,2,3:35
8053,490752,2017-05-21,2017,CIN,COL,4,6,6-4,COL,9,0,38,42,80,146,138,284,13,16,29,3,3:14
8054,490756,2017-05-21,2017,CHN,MIL,13,6,13-6,CHN,9,1,44,44,88,165,164,329,21,17,38,2,3:32
8055,490754,2017-05-21,2017,NYN,ANA,5,12,12-5,ANA,9,0,35,47,82,182,138,320,9,23,32,2,3:17
8056,490765,2017-05-22,2017,PHI,COL,1,8,8-1,COL,9,0,30,41,71,157,128,285,3,14,17,2,3:03
8057,490766,2017-05-22,2017,HOU,DET,1,0,1-0,HOU,9,1,34,29,63,119,134,253,11,4,15,1,2:45
8058,490764,2017-05-22,2017,CIN,CLE,5,1,5-1,CIN,9,1,33,35,68,143,95,238,10,9,19,2,2:39
8059,490768,2017-05-22,2017,TBA,ANA,2,3,3-2,ANA,9,0,35,38,73,162,153,315,10,15,25,4,3:37
8060,490771,2017-05-22,2017,CHN,SFN,4,6,6-4,SFN,9,0,36,40,76,165,127,292,12,14,26,4,2:59
8061,490769,2017-05-22,2017,BAL,MIN,7,14,14-7,MIN,9,0,42,51,93,190,146,336,16,24,40,3,3:31
8062,490770,2017-05-22,2017,ATL,PIT,5,2,5-2,ATL,9,1,39,38,77,165,152,317,17,12,29,3,3:23
8063,490767,2017-05-22,2017,NYA,KCA,4,2,4-2,NYA,9,1,32,35,67,141,123,264,9,8,17,1,2:42
8064,490763,2017-05-22,2017,ARI,CHA,5,1,5-1,ARI,9,1,33,31,64,105,131,236,10,5,15,3,2:39
8065,490777,2017-05-23,2017,TBA,ANA,0,4,4-0,ANA,9,0,32,37,69,132,126,258,6,14,20,3,2:56
8066,490782,2017-05-23,2017,CHN,SFN,4,1,4-1,CHN,9,1,29,29,58,99,120,219,6,4,10,0,2:05 (1:05 delay)
8067,490783,2017-05-23,2017,WAS,SEA,10,1,10-1,WAS,9,1,38,30,68,115,138,253,17,5,22,0,2:28
8068,490784,2017-05-23,2017,LAN,SLN,2,1,2-1,LAN,13,0,46,42,88,165,209,374,8,4,12,1,4:05
8069,490775,2017-05-23,2017,HOU,DET,6,2,6-2,HOU,9,1,37,35,72,166,127,293,13,9,22,2,3:01
8070,490785,2017-05-23,2017,BOS,TEX,11,6,11-6,BOS,9,1,43,38,81,145,170,315,21,14,35,3,3:23
8071,490781,2017-05-23,2017,NYN,SDN,9,3,9-3,NYN,9,1,38,37,75,167,144,311,15,11,26,2,2:56
8072,490779,2017-05-23,2017,BAL,MIN,0,2,2-0,MIN,9,0,31,35,66,129,105,234,4,9,13,0,2:23
8073,490774,2017-05-23,2017,PHI,COL,2,8,8-2,COL,9,0,38,36,74,140,147,287,13,12,25,0,2:44
8074,490780,2017-05-23,2017,ATL,PIT,6,5,6-5,ATL,9,0,41,45,86,152,136,288,20,20,40,2,3:03 (3:12 delay)
8075,490772,2017-05-23,2017,ARI,CHA,5,4,5-4,ARI,9,1,31,39,70,135,117,252,9,14,23,4,2:56
8076,490773,2017-05-23,2017,CIN,CLE,7,8,8-7,CLE,9,0,43,40,83,153,169,322,18,12,30,3,3:16
8077,490786,2017-05-23,2017,MIL,TOR,3,4,4-3,TOR,9,0,37,37,74,140,149,289,11,12,23,2,3:02
8078,490778,2017-05-23,2017,OAK,MIA,9,11,11-9,MIA,9,0,43,47,90,197,178,375,16,21,37,4,3:46
8079,490776,2017-05-23,2017,NYA,KCA,2,6,6-2,KCA,9,0,37,35,72,147,133,280,12,8,20,2,2:47
8080,490798,2017-05-24,2017,WAS,SEA,5,1,5-1,WAS,9,1,35,35,70,131,107,238,13,9,22,1,2:28
8081,490794,2017-05-24,2017,BAL,MIN,3,4,4-3,MIN,9,0,35,40,75,156,123,279,9,13,22,1,3:00
8082,490792,2017-05-24,2017,TBA,ANA,5,2,5-2,TBA,9,1,33,33,66,127,132,259,12,6,18,1,2:52
8083,490800,2017-05-24,2017,BOS,TEX,9,4,9-4,BOS,9,1,39,35,74,119,167,286,19,8,27,3,2:59
8084,490787,2017-05-24,2017,ARI,CHA,8,6,8-6,ARI,9,1,34,39,73,174,116,290,12,14,26,2,3:02
8085,490796,2017-05-24,2017,NYN,SDN,5,6,6-5,SDN,9,0,44,40,84,150,187,337,17,14,31,3,3:28
8086,490791,2017-05-24,2017,NYA,KCA,3,0,3-0,NYA,9,1,33,31,64,127,122,249,9,5,14,2,2:40
8087,490797,2017-05-24,2017,CHN,SFN,5,4,5-4,CHN,9,1,36,38,74,161,116,277,14,11,25,3,3:05
8088,490788,2017-05-24,2017,CLE,CIN,3,4,4-3,CIN,9,0,39,39,78,159,148,307,15,11,26,1,3:07 (2:01 delay)
8089,490789,2017-05-24,2017,PHI,COL,2,7,7-2,COL,9,0,34,41,75,147,161,308,9,16,25,1,3:09
8090,490795,2017-05-24,2017,ATL,PIT,5,12,12-5,PIT,10,0,44,52,96,213,160,373,15,22,37,3,4:02
8091,490793,2017-05-24,2017,OAK,MIA,4,1,4-1,OAK,9,1,35,34,69,124,129,253,13,6,19,0,2:38
8092,490799,2017-05-24,2017,LAN,SLN,1,6,6-1,SLN,9,0,30,43,73,170,108,278,4,18,22,1,2:44
8093,490790,2017-05-24,2017,HOU,DET,3,6,6-3,DET,9,0,36,37,73,141,135,276,8,13,21,1,2:52
8094,490801,2017-05-24,2017,MIL,TOR,4,8,8-4,TOR,9,0,34,38,72,130,150,280,9,11,20,2,2:51
8095,490808,2017-05-25,2017,ATL,PIT,4,9,9-4,PIT,9,0,38,43,81,150,110,260,12,18,30,1,2:41
8096,490802,2017-05-25,2017,MIL,ARI,0,4,4-0,ARI,9,0,30,36,66,145,125,270,4,11,15,1,2:45
8097,490807,2017-05-25,2017,TBA,ANA,4,0,4-0,TBA,9,1,37,35,72,128,135,263,13,10,23,1,3:04
8098,490810,2017-05-25,2017,CHN,SFN,5,1,5-1,CHN,9,1,33,33,66,110,137,247,10,8,18,0,2:33
8099,490813,2017-05-25,2017,BOS,TEX,6,2,6-2,BOS,9,1,38,33,71,153,157,310,17,5,22,2,3:23 (:28 delay)
8100,490805,2017-05-25,2017,HOU,DET,7,6,7-6,HOU,9,1,38,44,82,173,145,318,15,21,36,3,3:30
8101,490809,2017-05-25,2017,NYN,SDN,3,4,4-3,SDN,9,0,39,42,81,180,170,350,14,15,29,2,3:16
8102,490812,2017-05-25,2017,LAN,SLN,7,3,7-3,LAN,9,1,35,37,72,129,154,283,13,14,27,1,3:03
8103,490811,2017-05-25,2017,WAS,SEA,2,4,4-2,SEA,9,0,36,39,75,173,142,315,9,15,24,5,3:18
8104,490804,2017-05-25,2017,PHI,COL,2,1,2-1,PHI,11,0,42,43,85,161,155,316,12,12,24,2,3:39
8105,490822,2017-05-26,2017,PIT,NYN,1,8,8-1,NYN,9,0,34,44,78,169,123,292,7,16,23,2,2:57
8106,490815,2017-05-26,2017,SFN,ATL,0,2,2-0,ATL,9,0,34,36,70,117,118,235,8,12,20,1,2:40
8107,490816,2017-05-26,2017,HOU,BAL,2,0,2-0,HOU,9,1,34,33,67,127,120,247,10,7,17,1,2:31
8108,490818,2017-05-26,2017,PHI,CIN,2,5,5-2,CIN,9,0,33,36,69,134,121,255,7,9,16,1,2:34
8109,490817,2017-05-26,2017,LAN,CHN,4,0,4-0,LAN,9,1,31,31,62,137,128,265,9,6,15,0,2:49
8110,490826,2017-05-26,2017,COL,SLN,10,0,10-0,COL,9,1,38,28,66,110,131,241,16,5,21,2,2:25
8111,490819,2017-05-26,2017,CHA,DET,8,2,8-2,CHA,9,1,41,37,78,163,171,334,19,8,27,3,3:42 (1:25 delay)
8112,490827,2017-05-26,2017,MIN,TBA,2,5,5-2,TBA,9,0,34,36,70,161,126,287,7,9,16,4,3:04
8113,490823,2017-05-26,2017,NYA,OAK,1,4,4-1,OAK,9,0,34,37,71,144,149,293,8,10,18,1,3:09
8114,490820,2017-05-26,2017,CLE,KCA,4,6,6-4,KCA,9,0,36,39,75,133,152,285,9,13,22,3,2:57
8115,490825,2017-05-26,2017,BOS,SEA,3,0,3-0,BOS,9,1,38,34,72,143,154,297,15,9,24,1,3:11
8116,490828,2017-05-26,2017,TOR,TEX,7,6,7-6,TOR,9,1,37,42,79,159,156,315,14,15,29,5,3:30
8117,490814,2017-05-26,2017,MIL,ARI,2,4,4-2,ARI,10,0,40,42,82,154,149,303,14,12,26,1,3:24
8118,490821,2017-05-26,2017,MIA,ANA,8,5,8-5,MIA,9,1,40,39,79,156,147,303,20,11,31,3,3:13
8119,490824,2017-05-26,2017,WAS,SDN,5,1,5-1,WAS,9,1,36,32,68,112,132,244,13,6,19,1,2:25
8120,490832,2017-05-27,2017,LAN,CHN,5,0,5-0,LAN,9,1,37,32,69,123,145,268,12,5,17,0,2:41
8121,490831,2017-05-27,2017,HOU,BAL,5,2,5-2,HOU,9,1,37,34,71,132,144,276,15,9,24,3,2:56
8122,490838,2017-05-27,2017,NYA,OAK,3,2,3-2,NYA,9,1,31,37,68,151,153,304,8,11,19,4,3:14
8123,490830,2017-05-27,2017,SFN,ATL,6,3,6-3,SFN,9,1,35,37,72,127,125,252,13,12,25,2,2:31
8124,490842,2017-05-27,2017,MIN,TBA,5,3,5-3,MIN,9,1,40,37,77,150,172,322,17,11,28,3,3:35
8125,490833,2017-05-27,2017,PHI,CIN,4,3,4-3,PHI,9,0,31,39,70,156,123,279,8,13,21,1,2:47
8126,490836,2017-05-27,2017,MIA,ANA,2,5,5-2,ANA,9,0,34,40,74,143,129,272,10,14,24,3,3:03
8127,490835,2017-05-27,2017,CLE,KCA,2,5,5-2,KCA,9,0,39,41,80,152,144,296,14,17,31,4,3:06
8128,490829,2017-05-27,2017,MIL,ARI,6,1,6-1,MIL,9,1,32,32,64,144,135,279,9,7,16,2,2:52
8129,490124,2017-05-27,2017,CHA,DET,3,4,4-3,DET,9,0,36,43,79,176,151,327,10,17,27,3,3:14
8130,490841,2017-05-27,2017,COL,SLN,0,3,3-0,SLN,9,0,35,39,74,150,162,312,7,14,21,1,3:15
8131,490843,2017-05-27,2017,TOR,TEX,3,1,3-1,TOR,9,1,38,33,71,146,145,291,13,7,20,3,3:16
8132,490837,2017-05-27,2017,PIT,NYN,5,4,5-4,PIT,10,0,45,44,89,164,177,341,18,13,31,3,3:33
8133,490124,2017-05-27,2017,CHA,DET,3,4,4-3,DET,9,0,36,43,79,176,151,327,10,17,27,3,3:14
8134,490840,2017-05-27,2017,BOS,SEA,6,0,6-0,BOS,9,1,35,32,67,109,124,233,13,5,18,1,2:23
8135,490839,2017-05-27,2017,WAS,SDN,3,0,3-0,WAS,9,1,35,33,68,132,146,278,12,4,16,0,2:49
8136,490834,2017-05-27,2017,CHA,DET,3,0,3-0,CHA,9,1,32,39,71,185,96,281,10,13,23,0,2:54
8137,490124,2017-05-27,2017,CHA,DET,3,4,4-3,DET,9,0,36,43,79,176,151,327,10,17,27,3,3:14
8138,490848,2017-05-28,2017,PHI,CIN,4,8,8-4,CIN,9,0,36,38,74,137,141,278,13,13,26,0,2:50
8139,490849,2017-05-28,2017,CHA,DET,7,3,7-3,CHA,9,1,36,34,70,130,120,250,13,6,19,2,2:44 (:30 delay)
8140,490855,2017-05-28,2017,BOS,SEA,0,5,5-0,SEA,9,0,32,41,73,155,118,273,8,17,25,4,3:14
8141,490845,2017-05-28,2017,SFN,ATL,7,1,7-1,SFN,9,1,35,36,71,152,109,261,11,10,21,0,2:29
8142,490853,2017-05-28,2017,NYA,OAK,9,5,9-5,NYA,9,1,38,36,74,155,141,296,14,10,24,2,3:09
8143,490844,2017-05-28,2017,MIL,ARI,9,5,9-5,MIL,9,1,42,39,81,155,149,304,18,13,31,3,3:08
8144,490854,2017-05-28,2017,WAS,SDN,3,5,5-3,SDN,9,0,39,42,81,144,161,305,12,16,28,2,3:19 (1:20 delay)
8145,490852,2017-05-28,2017,PIT,NYN,2,7,7-2,NYN,9,0,39,41,80,157,162,319,13,14,27,0,3:13
8146,490847,2017-05-28,2017,LAN,CHN,9,4,9-4,LAN,9,1,39,42,81,183,161,344,16,14,30,3,3:28
8147,490858,2017-05-28,2017,TOR,TEX,1,3,3-1,TEX,9,0,34,39,73,146,129,275,9,12,21,0,2:53
8148,490846,2017-05-28,2017,HOU,BAL,8,4,8-4,HOU,9,1,36,37,73,163,146,309,13,9,22,0,2:58
8149,490856,2017-05-28,2017,COL,SLN,8,4,8-4,COL,9,1,36,39,75,144,129,273,11,12,23,3,2:52
8150,490850,2017-05-28,2017,CLE,KCA,10,1,10-1,CLE,9,1,45,32,77,111,180,291,22,6,28,1,2:48
8151,490851,2017-05-28,2017,MIA,ANA,9,2,9-2,MIA,9,1,41,38,79,158,162,320,17,12,29,2,3:28
8152,490857,2017-05-28,2017,MIN,TBA,6,8,8-6,TBA,15,0,68,71,139,289,264,553,28,28,56,4,6:26
8153,490865,2017-05-29,2017,MIN,HOU,8,16,16-8,HOU,9,0,40,50,90,193,155,348,14,24,38,3,3:44 (:10 delay)
8154,490868,2017-05-29,2017,BAL,NYA,3,2,3-2,BAL,9,1,35,33,68,119,154,273,10,9,19,1,2:54
8155,490861,2017-05-29,2017,CHA,BOS,5,4,5-4,CHA,9,1,33,36,69,150,159,309,10,9,19,0,3:16
8156,490860,2017-05-29,2017,ANA,ATL,3,6,6-3,ATL,9,0,36,36,72,127,123,250,10,10,20,2,2:50
8157,490866,2017-05-29,2017,SLN,LAN,1,5,5-1,LAN,9,0,34,36,70,129,145,274,8,11,19,1,2:50
8158,490859,2017-05-29,2017,PIT,ARI,4,3,4-3,PIT,9,0,33,37,70,129,150,279,11,10,21,3,3:02
8159,490870,2017-05-29,2017,MIA,PHI,4,1,4-1,MIA,9,1,33,33,66,139,121,260,12,7,19,1,2:37
8160,490871,2017-05-29,2017,COL,SEA,5,6,6-5,SEA,9,0,35,43,78,175,133,308,10,19,29,6,3:25
8161,490869,2017-05-29,2017,CLE,OAK,5,3,5-3,CLE,9,1,36,35,71,141,135,276,11,9,20,1,2:50
8162,490862,2017-05-29,2017,SDN,CHN,5,2,5-2,SDN,9,1,33,40,73,176,120,296,10,15,25,1,2:59
8163,490873,2017-05-29,2017,SFN,WAS,0,3,3-0,WAS,9,0,36,37,73,141,152,293,11,10,21,3,3:03
8164,490867,2017-05-29,2017,NYN,MIL,4,2,4-2,NYN,9,1,34,35,69,140,145,285,11,8,19,1,2:50
8165,490872,2017-05-29,2017,TEX,TBA,8,10,10-8,TBA,9,0,43,42,85,155,176,331,18,17,35,5,3:48
8166,490864,2017-05-29,2017,KCA,DET,7,10,10-7,DET,9,0,41,43,84,155,163,318,15,18,33,4,3:40
8167,490863,2017-05-29,2017,TOR,CIN,17,2,17-2,TOR,9,1,54,34,88,138,183,321,31,8,39,2,3:06
8168,490875,2017-05-30,2017,ANA,ATL,9,3,9-3,ANA,9,1,41,33,74,113,145,258,13,9,22,2,2:47
8169,490877,2017-05-30,2017,SDN,CHN,6,2,6-2,SDN,9,1,36,38,74,166,119,285,12,11,23,2,2:52
8170,490878,2017-05-30,2017,TOR,CIN,6,4,6-4,TOR,9,1,34,40,74,168,134,302,12,14,26,1,2:53
8171,490885,2017-05-30,2017,MIA,PHI,7,2,7-2,MIA,9,1,40,33,73,134,170,304,15,6,21,4,3:07
8172,490887,2017-05-30,2017,TEX,TBA,9,5,9-5,TEX,9,1,39,38,77,129,145,274,15,12,27,4,3:14
8173,490886,2017-05-30,2017,COL,SEA,4,10,10-4,SEA,9,0,37,46,83,147,130,277,12,23,35,2,3:11
8174,490883,2017-05-30,2017,BAL,NYA,3,8,8-3,NYA,9,0,40,45,85,170,150,320,12,19,31,5,3:19
8175,490879,2017-05-30,2017,KCA,DET,1,0,1-0,KCA,9,1,31,30,61,118,137,255,8,4,12,1,2:45
8176,490874,2017-05-30,2017,PIT,ARI,0,3,3-0,ARI,9,0,30,34,64,99,115,214,4,8,12,0,2:10
8177,490880,2017-05-30,2017,MIN,HOU,2,7,7-2,HOU,9,0,37,41,78,164,131,295,10,17,27,0,3:01
8178,490884,2017-05-30,2017,CLE,OAK,9,4,9-4,CLE,9,1,36,38,74,149,137,286,15,11,26,3,2:58
8179,490876,2017-05-30,2017,CHA,BOS,7,13,13-7,BOS,9,0,43,47,90,201,187,388,17,21,38,3,3:53
8180,490881,2017-05-30,2017,SLN,LAN,4,9,9-4,LAN,9,0,37,47,84,206,157,363,11,20,31,2,3:55
8181,490888,2017-05-30,2017,SFN,WAS,3,6,6-3,WAS,9,0,40,44,84,194,156,350,13,17,30,1,3:32
8182,490882,2017-05-30,2017,NYN,MIL,5,4,5-4,NYN,12,0,48,54,102,229,193,422,16,19,35,3,4:24
8183,490892,2017-05-31,2017,SDN,CHN,2,1,2-1,SDN,9,1,32,33,65,121,113,234,9,6,15,0,2:25
8184,490903,2017-05-31,2017,SFN,WAS,1,3,3-1,WAS,9,0,31,39,70,156,100,256,5,13,18,0,2:45
8185,490900,2017-05-31,2017,CLE,OAK,1,3,3-1,OAK,9,0,31,34,65,135,125,260,4,8,12,1,2:30
8186,490893,2017-05-31,2017,TOR,CIN,5,4,5-4,TOR,9,1,32,38,70,153,134,287,10,11,21,1,2:53
8187,490894,2017-05-31,2017,SEA,COL,5,0,5-0,SEA,9,1,35,30,65,122,154,276,12,4,16,2,2:46
8188,490899,2017-05-31,2017,BAL,NYA,10,4,10-4,BAL,9,1,39,42,81,165,148,313,16,16,32,3,3:18 (:14 delay)
8189,490891,2017-05-31,2017,CHA,BOS,1,4,4-1,BOS,9,0,35,36,71,140,130,270,7,11,18,0,2:59
8190,490902,2017-05-31,2017,TEX,TBA,5,7,7-5,TBA,10,0,41,46,87,164,155,319,12,15,27,1,3:45
8191,490890,2017-05-31,2017,ANA,ATL,2,1,2-1,ANA,9,1,31,33,64,119,115,234,9,7,16,1,2:49
8192,490895,2017-05-31,2017,KCA,DET,5,6,6-5,DET,9,0,38,40,78,149,147,296,12,14,26,2,3:19
8193,490901,2017-05-31,2017,MIA,PHI,10,2,10-2,MIA,9,1,42,38,80,165,168,333,18,12,30,1,3:16
8194,490889,2017-05-31,2017,PIT,ARI,5,6,6-5,ARI,14,0,55,61,116,253,197,450,17,21,38,1,4:40 (1:33 delay)
8195,490898,2017-05-31,2017,NYN,MIL,1,7,7-1,MIL,9,0,38,45,83,190,138,328,12,19,31,0,3:17
8196,490897,2017-05-31,2017,SLN,LAN,2,1,2-1,SLN,9,1,29,34,63,123,105,228,7,8,15,0,2:19
8197,490896,2017-05-31,2017,MIN,HOU,6,17,17-6,HOU,9,0,41,52,93,181,187,368,15,27,42,3,3:35
8198,490911,2017-06-01,2017,CLE,OAK,8,0,8-0,CLE,9,1,38,30,68,119,144,263,14,4,18,2,2:56
8199,490904,2017-06-01,2017,MIA,ARI,2,3,3-2,ARI,9,0,34,36,70,147,126,273,8,10,18,3,3:00
8200,490908,2017-06-01,2017,NYN,MIL,1,2,2-1,MIL,9,0,32,38,70,153,139,292,6,15,21,2,3:02
8201,490910,2017-06-01,2017,TOR,NYA,2,12,12-2,NYA,9,0,32,46,78,180,132,312,7,18,25,4,3:10
8202,490905,2017-06-01,2017,BAL,BOS,7,5,7-5,BAL,9,1,34,36,70,143,129,272,10,10,20,2,2:38
8203,490907,2017-06-01,2017,SLN,LAN,2,0,2-0,SLN,9,1,34,34,68,159,149,308,11,9,20,1,3:07
8204,490909,2017-06-01,2017,ANA,MIN,2,4,4-2,MIN,9,0,36,40,76,143,129,272,11,14,25,3,3:19
8205,490906,2017-06-01,2017,SEA,COL,3,6,6-3,COL,9,0,41,40,81,173,156,329,16,15,31,0,3:28
8206,490920,2017-06-02,2017,ANA,MIN,5,11,11-5,MIN,9,0,36,44,80,156,147,303,11,17,28,3,3:19
8207,490916,2017-06-02,2017,KCA,CLE,4,0,4-0,KCA,9,1,33,31,64,103,109,212,9,8,17,1,2:19
8208,490924,2017-06-02,2017,CHN,SLN,3,2,3-2,CHN,9,1,33,34,67,138,137,275,11,9,20,3,2:47
8209,490918,2017-06-02,2017,TEX,HOU,1,7,7-1,HOU,9,0,34,41,75,151,127,278,7,13,20,0,2:58 (2:06 delay)
8210,490914,2017-06-02,2017,BAL,BOS,3,2,3-2,BAL,9,1,33,31,64,137,150,287,10,5,15,3,2:59
8211,490921,2017-06-02,2017,TOR,NYA,7,5,7-5,TOR,9,1,39,39,78,156,142,298,15,12,27,2,3:13
8212,490912,2017-06-02,2017,MIA,ARI,7,5,7-5,MIA,9,1,37,36,73,158,147,305,13,10,23,5,3:00
8213,490915,2017-06-02,2017,DET,CHA,15,5,15-5,DET,9,1,46,36,82,132,158,290,24,9,33,2,3:01
8214,490917,2017-06-02,2017,SDN,COL,8,5,8-5,SDN,9,1,38,42,80,159,136,295,15,15,30,3,3:02
8215,490925,2017-06-02,2017,SEA,TBA,12,4,12-4,SEA,9,1,41,39,80,151,173,324,16,12,28,1,3:09
8216,490923,2017-06-02,2017,PHI,SFN,0,10,10-0,SFN,9,0,32,54,86,205,112,317,7,25,32,2,2:55
8217,490919,2017-06-02,2017,MIL,LAN,1,2,2-1,LAN,12,0,45,45,90,170,183,353,9,13,22,0,3:57
8218,490922,2017-06-02,2017,NYN,PIT,7,12,12-7,PIT,9,0,39,46,85,179,156,335,13,20,33,2,3:18
8219,490926,2017-06-02,2017,OAK,WAS,3,13,13-3,WAS,9,0,36,50,86,202,132,334,11,23,34,2,3:15
8220,490913,2017-06-02,2017,CIN,ATL,3,2,3-2,CIN,10,0,36,41,77,151,153,304,9,14,23,1,3:03
8221,490927,2017-06-03,2017,MIA,ARI,3,0,3-0,MIA,9,1,36,27,63,98,140,238,15,2,17,1,2:31
8222,490936,2017-06-03,2017,TOR,NYA,0,7,7-0,NYA,9,0,35,37,72,137,151,288,8,9,17,1,3:00
8223,490932,2017-06-03,2017,SDN,COL,1,10,10-1,COL,9,0,31,45,76,171,122,293,5,19,24,1,2:52
8224,490939,2017-06-03,2017,CHN,SLN,5,3,5-3,CHN,9,1,32,34,66,146,116,262,9,10,19,1,2:35
8225,490937,2017-06-03,2017,NYN,PIT,4,2,4-2,NYN,9,1,33,41,74,168,135,303,11,13,24,1,3:06
8226,490931,2017-06-03,2017,KCA,CLE,12,5,12-5,KCA,9,1,42,36,78,140,175,315,16,9,25,3,3:14
8227,490938,2017-06-03,2017,PHI,SFN,5,3,5-3,PHI,9,1,34,36,70,142,141,283,12,12,24,2,2:50
8228,490930,2017-06-03,2017,DET,CHA,10,1,10-1,DET,9,1,39,35,74,133,151,284,16,11,27,2,3:14
8229,490935,2017-06-03,2017,ANA,MIN,7,2,7-2,ANA,9,1,39,37,76,158,136,294,17,11,28,2,3:18
8230,490933,2017-06-03,2017,TEX,HOU,5,6,6-5,HOU,9,0,41,42,83,146,180,326,13,15,28,3,3:46
8231,490940,2017-06-03,2017,SEA,TBA,9,2,9-2,SEA,9,1,38,33,71,158,135,293,18,7,25,0,2:59
8232,490929,2017-06-03,2017,BAL,BOS,2,5,5-2,BOS,9,0,35,38,73,179,138,317,9,13,22,2,3:22
8233,490941,2017-06-03,2017,OAK,WAS,10,4,10-4,OAK,9,1,42,42,84,164,174,338,17,14,31,3,3:33
8234,490934,2017-06-03,2017,MIL,LAN,8,10,10-8,LAN,9,0,42,45,87,168,197,365,15,18,33,2,4:07
8235,490928,2017-06-03,2017,CIN,ATL,5,6,6-5,ATL,12,0,56,52,108,205,207,412,19,19,38,2,4:20
8236,490955,2017-06-04,2017,SEA,TBA,7,1,7-1,SEA,9,1,36,32,68,105,157,262,13,5,18,1,2:41
8237,490951,2017-06-04,2017,TOR,NYA,3,2,3-2,TOR,9,1,32,32,64,132,111,243,9,7,16,0,2:27
8238,490947,2017-06-04,2017,SDN,COL,1,3,3-1,COL,9,0,30,41,71,169,107,276,3,16,19,1,3:06
8239,490952,2017-06-04,2017,NYN,PIT,1,11,11-1,PIT,9,0,33,45,78,165,121,286,10,18,28,0,2:54
8240,490954,2017-06-04,2017,CHN,SLN,7,6,7-6,CHN,9,1,37,37,74,169,137,306,15,11,26,2,3:00
8241,490946,2017-06-04,2017,KCA,CLE,0,8,8-0,CLE,9,0,34,41,75,201,130,331,9,17,26,3,2:58 (1:50 delay)
8242,490949,2017-06-04,2017,MIL,LAN,3,0,3-0,MIL,9,1,35,33,68,154,167,321,11,6,17,2,3:12
8243,490942,2017-06-04,2017,MIA,ARI,6,5,6-5,MIA,9,1,41,40,81,153,164,317,16,14,30,4,3:32
8244,490948,2017-06-04,2017,TEX,HOU,2,7,7-2,HOU,9,0,37,41,78,180,151,331,10,14,24,3,3:18
8245,490944,2017-06-04,2017,BAL,BOS,3,7,7-3,BOS,9,0,36,40,76,149,149,298,10,14,24,2,3:06
8246,490956,2017-06-04,2017,OAK,WAS,10,11,11-10,WAS,9,0,39,42,81,169,142,311,12,17,29,4,3:12
8247,490953,2017-06-04,2017,PHI,SFN,9,7,9-7,PHI,9,1,37,39,76,162,150,312,14,13,27,4,3:28
8248,490950,2017-06-04,2017,ANA,MIN,2,3,3-2,MIN,9,0,34,35,69,142,137,279,11,9,20,2,3:13
8249,490943,2017-06-04,2017,CIN,ATL,8,13,13-8,ATL,9,0,41,48,89,165,161,326,15,22,37,1,3:23
8250,490945,2017-06-04,2017,DET,CHA,7,4,7-4,DET,9,0,41,42,83,176,166,342,19,18,37,6,4:07
8251,490958,2017-06-05,2017,CHN,MIA,3,1,3-1,CHN,9,1,30,32,62,117,105,222,6,7,13,1,2:16
8252,490963,2017-06-05,2017,LAN,WAS,2,4,4-2,WAS,9,0,36,37,73,133,156,289,9,8,17,1,3:05
8253,490957,2017-06-05,2017,KCA,HOU,3,7,7-3,HOU,9,0,38,38,76,144,153,297,11,13,24,4,3:09
8254,490960,2017-06-05,2017,MIL,SFN,2,7,7-2,SFN,9,0,32,43,75,161,130,291,6,20,26,1,3:05
8255,490962,2017-06-05,2017,OAK,TOR,5,3,5-3,OAK,9,1,32,38,70,171,130,301,8,11,19,1,3:05
8256,490961,2017-06-05,2017,CIN,SLN,4,2,4-2,CIN,9,1,30,34,64,140,123,263,8,11,19,1,2:35
8257,490959,2017-06-05,2017,ATL,PHI,4,11,11-4,PHI,9,0,37,43,80,170,154,324,12,17,29,2,3:18
8258,490975,2017-06-06,2017,MIL,SFN,5,2,5-2,MIL,9,1,35,35,70,131,114,245,13,10,23,2,2:35
8259,490972,2017-06-06,2017,ATL,PHI,1,3,3-1,PHI,9,0,34,34,68,119,111,230,8,9,17,2,2:42
8260,490978,2017-06-06,2017,LAN,WAS,1,2,2-1,WAS,9,0,35,33,68,130,137,267,6,7,13,1,2:57
8261,490977,2017-06-06,2017,OAK,TOR,4,1,4-1,OAK,9,1,31,36,67,146,115,261,9,12,21,2,2:45
8262,490968,2017-06-06,2017,DET,ANA,3,5,5-3,ANA,9,0,38,36,74,148,141,289,13,11,24,2,3:14
8263,490969,2017-06-06,2017,CHN,MIA,10,2,10-2,CHN,9,1,42,34,76,148,151,299,17,7,24,4,3:01
8264,490967,2017-06-06,2017,KCA,HOU,9,7,9-7,KCA,9,0,42,44,86,152,157,309,16,16,32,4,3:10
8265,490966,2017-06-06,2017,COL,CLE,11,3,11-3,COL,9,1,39,33,72,123,157,280,19,8,27,2,2:54
8266,490976,2017-06-06,2017,CIN,SLN,13,1,13-1,CIN,9,1,42,33,75,137,169,306,19,8,27,1,2:47
8267,490973,2017-06-06,2017,BAL,PIT,6,5,6-5,BAL,10,0,40,42,82,181,144,325,11,14,25,3,3:25
8268,490964,2017-06-06,2017,NYA,BOS,4,5,5-4,BOS,9,0,39,35,74,123,204,327,13,8,21,3,3:35
8269,490971,2017-06-06,2017,TEX,NYN,10,8,10-8,TEX,9,1,42,48,90,173,154,327,19,23,42,1,3:19
8270,490965,2017-06-06,2017,TBA,CHA,2,4,4-2,CHA,9,0,40,36,76,147,171,318,16,11,27,3,3:29
8271,490974,2017-06-06,2017,ARI,SDN,10,2,10-2,ARI,9,1,39,35,74,141,165,306,14,8,22,2,2:52
8272,490970,2017-06-06,2017,SEA,MIN,12,3,12-3,SEA,9,1,42,41,83,175,186,361,18,15,33,3,3:26
8273,490993,2017-06-07,2017,LAN,WAS,2,1,2-1,LAN,9,1,30,35,65,121,128,249,5,8,13,2,2:45
8274,490980,2017-06-07,2017,TBA,CHA,3,1,3-1,TBA,9,1,35,32,67,129,133,262,12,6,18,3,2:53
8275,490985,2017-06-07,2017,SEA,MIN,6,5,6-5,SEA,9,0,35,35,70,118,143,261,9,9,18,1,2:43
8276,490979,2017-06-07,2017,NYA,BOS,8,0,8-0,NYA,9,1,39,31,70,105,142,247,16,5,21,1,2:42
8277,490990,2017-06-07,2017,MIL,SFN,6,3,6-3,MIL,9,1,35,36,71,132,129,261,11,10,21,0,2:41
8278,490983,2017-06-07,2017,DET,ANA,4,0,4-0,DET,9,1,36,30,66,129,143,272,12,5,17,2,2:58
8279,490987,2017-06-07,2017,ATL,PHI,14,1,14-1,ATL,9,1,42,34,76,131,155,286,18,9,27,2,2:58
8280,490991,2017-06-07,2017,CIN,SLN,6,4,6-4,CIN,9,1,34,37,71,138,130,268,12,13,25,2,2:45
8281,490986,2017-06-07,2017,TEX,NYN,3,4,4-3,NYN,9,0,36,36,72,155,132,287,11,9,20,1,3:10
8282,490982,2017-06-07,2017,KCA,HOU,7,5,7-5,KCA,9,1,37,43,80,156,142,298,13,15,28,4,3:11
8283,490984,2017-06-07,2017,CHN,MIA,5,6,6-5,MIA,9,0,41,38,79,152,162,314,14,11,25,2,3:06
8284,490981,2017-06-07,2017,COL,CLE,8,1,8-1,COL,9,1,43,34,77,134,169,303,21,8,29,5,3:27
8285,490989,2017-06-07,2017,ARI,SDN,7,4,7-4,ARI,9,1,38,40,78,179,184,363,15,13,28,2,3:48
8286,490992,2017-06-07,2017,OAK,TOR,5,7,7-5,TOR,10,0,39,42,81,171,166,337,9,12,21,1,3:20
8287,490988,2017-06-07,2017,BAL,PIT,9,6,9-6,BAL,11,0,46,49,95,199,194,393,17,18,35,3,4:08
8288,490612,2017-06-08,2017,WAS,BAL,6,1,6-1,WAS,9,1,40,31,71,119,160,279,16,4,20,1,2:56
8289,490612,2017-06-08,2017,WAS,BAL,6,1,6-1,WAS,9,1,40,31,71,119,160,279,16,4,20,1,2:56
8290,491000,2017-06-08,2017,SEA,MIN,1,2,2-1,MIN,9,0,36,37,73,143,128,271,10,11,21,1,2:51
8291,491001,2017-06-08,2017,ATL,PHI,3,1,3-1,ATL,9,1,34,32,66,140,111,251,14,5,19,1,2:40
8292,490997,2017-06-08,2017,KCA,HOU,1,6,6-1,HOU,9,0,31,38,69,137,114,251,5,11,16,1,2:39
8293,490995,2017-06-08,2017,TBA,CHA,7,5,7-5,TBA,9,1,36,39,75,155,144,299,14,13,27,3,3:09
8294,491002,2017-06-08,2017,ARI,SDN,15,3,15-3,ARI,9,1,43,39,82,132,165,297,21,12,33,2,2:59
8295,490998,2017-06-08,2017,DET,ANA,4,11,11-4,ANA,9,0,42,43,85,134,168,302,17,18,35,2,3:24
8296,490999,2017-06-08,2017,PIT,MIA,1,7,7-1,MIA,9,0,35,41,76,167,142,309,8,15,23,1,3:06
8297,490994,2017-06-08,2017,NYA,BOS,9,1,9-1,NYA,9,1,43,35,78,153,160,313,19,8,27,2,3:27
8298,491004,2017-06-08,2017,CIN,SLN,5,2,5-2,CIN,9,1,38,32,70,122,117,239,16,6,22,0,2:21
8299,491003,2017-06-08,2017,MIL,SFN,5,9,9-5,SFN,10,0,47,51,98,207,188,395,18,23,41,5,4:22
8300,490996,2017-06-08,2017,CHN,COL,1,4,4-1,COL,9,0,33,35,68,142,140,282,8,8,16,0,2:44
8301,491005,2017-06-09,2017,NYA,BAL,8,2,8-2,NYA,9,1,39,34,73,125,141,266,15,7,22,1,2:45
8302,491007,2017-06-09,2017,LAN,CIN,7,2,7-2,LAN,9,1,38,35,73,158,147,305,16,8,24,2,3:02
8303,491019,2017-06-09,2017,SEA,TOR,4,2,4-2,SEA,9,1,33,37,70,151,117,268,11,13,24,1,2:53
8304,491016,2017-06-09,2017,TBA,OAK,13,4,13-4,TBA,9,1,41,38,79,161,163,324,17,11,28,1,3:16
8305,491006,2017-06-09,2017,CLE,CHA,7,3,7-3,CLE,9,1,37,38,75,144,139,283,14,12,26,1,3:00 (:36 delay)
8306,491010,2017-06-09,2017,SDN,KCA,6,3,6-3,SDN,9,1,39,34,73,136,146,282,20,9,29,3,2:51
8307,491015,2017-06-09,2017,ATL,NYN,3,2,3-2,ATL,9,0,36,35,71,140,163,303,13,9,22,4,3:11
8308,491013,2017-06-09,2017,ARI,MIL,6,8,8-6,MIL,9,0,41,46,87,170,149,319,13,21,34,5,3:38
8309,491018,2017-06-09,2017,WAS,TEX,2,5,5-2,TEX,9,0,37,45,82,150,123,273,11,17,28,2,3:00
8310,491012,2017-06-09,2017,PIT,MIA,7,12,12-7,MIA,9,0,46,46,92,143,170,313,20,20,40,2,3:25
8311,491008,2017-06-09,2017,CHN,COL,3,5,5-3,COL,9,0,41,38,79,161,182,343,14,14,28,0,3:42
8312,491014,2017-06-09,2017,SFN,MIN,0,4,4-0,MIN,9,0,31,37,68,130,91,221,5,12,17,0,2:27
8313,491017,2017-06-09,2017,SLN,PHI,3,2,3-2,SLN,9,1,36,35,71,134,125,259,15,10,25,0,2:43
8314,491011,2017-06-09,2017,HOU,ANA,4,9,9-4,ANA,9,0,34,44,78,181,116,297,9,20,29,1,3:20
8315,491009,2017-06-09,2017,BOS,DET,5,3,5-3,BOS,9,1,36,39,75,185,141,326,14,13,27,2,3:36
8316,490524,2017-06-10,2017,ATL,NYN,1,6,6-1,NYN,9,0,38,42,80,142,143,285,8,17,25,4,3:05
8317,491026,2017-06-10,2017,HOU,ANA,3,1,3-1,HOU,9,1,33,33,66,124,130,254,12,6,18,2,2:52
8318,491033,2017-06-10,2017,SLN,PHI,7,0,7-0,SLN,9,1,35,32,67,107,142,249,13,5,18,1,2:28
8319,491035,2017-06-10,2017,SEA,TOR,2,4,4-2,TOR,9,0,36,35,71,133,120,253,9,10,19,1,2:44
8320,491029,2017-06-10,2017,SFN,MIN,2,3,3-2,MIN,9,0,36,35,71,131,137,268,10,7,17,1,2:43
8321,491030,2017-06-10,2017,ATL,NYN,1,8,8-1,NYN,9,0,34,44,78,146,128,274,7,17,24,1,2:41
8322,491021,2017-06-10,2017,CLE,CHA,3,5,5-3,CHA,9,0,34,39,73,136,123,259,7,17,24,3,2:59
8323,491028,2017-06-10,2017,ARI,MIL,3,2,3-2,ARI,9,1,35,31,66,109,125,234,13,5,18,1,2:43
8324,491023,2017-06-10,2017,CHN,COL,1,9,9-1,COL,9,0,34,42,76,168,124,292,7,18,25,3,3:09
8325,491027,2017-06-10,2017,PIT,MIA,7,6,7-6,PIT,9,1,41,40,81,144,160,304,19,13,32,1,3:11
8326,491020,2017-06-10,2017,NYA,BAL,16,3,16-3,NYA,9,1,46,33,79,120,185,305,24,7,31,3,3:11
8327,491032,2017-06-10,2017,TBA,OAK,2,7,7-2,OAK,9,0,34,44,78,167,128,295,9,17,26,0,3:06
8328,491025,2017-06-10,2017,SDN,KCA,6,12,12-6,KCA,9,0,40,44,84,166,173,339,14,19,33,6,3:44
8329,491031,2017-06-10,2017,TBA,OAK,6,5,6-5,TBA,10,0,39,48,87,171,168,339,13,19,32,4,3:56
8330,491034,2017-06-10,2017,WAS,TEX,3,6,6-3,TEX,11,0,43,43,86,193,197,390,12,13,25,4,4:14
8331,490524,2017-06-10,2017,ATL,NYN,1,6,6-1,NYN,9,0,38,42,80,142,143,285,8,17,25,4,3:05
8332,491022,2017-06-10,2017,LAN,CIN,5,4,5-4,LAN,9,0,38,36,74,135,141,276,12,9,21,2,3:04
8333,491024,2017-06-10,2017,BOS,DET,11,3,11-3,BOS,9,1,46,36,82,138,191,329,25,9,34,2,3:39
8334,491046,2017-06-11,2017,ATL,NYN,1,2,2-1,NYN,9,0,35,37,72,130,119,249,9,13,22,1,3:01
8335,491041,2017-06-11,2017,SDN,KCA,3,8,8-3,KCA,9,0,35,36,71,132,127,259,8,8,16,1,2:27
8336,491048,2017-06-11,2017,SLN,PHI,6,5,6-5,SLN,9,1,35,40,75,151,145,296,13,16,29,1,3:09
8337,491049,2017-06-11,2017,WAS,TEX,1,5,5-1,TEX,9,0,30,35,65,146,116,262,4,7,11,2,2:53
8338,491043,2017-06-11,2017,PIT,MIA,3,1,3-1,PIT,9,1,36,32,68,113,119,232,14,4,18,2,2:32
8339,491039,2017-06-11,2017,CHN,COL,7,5,7-5,CHN,9,1,37,39,76,153,161,314,14,12,26,3,3:20
8340,491038,2017-06-11,2017,LAN,CIN,9,7,9-7,LAN,9,1,40,41,81,147,133,280,16,14,30,2,2:58
8341,491047,2017-06-11,2017,TBA,OAK,5,4,5-4,TBA,9,1,35,40,75,162,149,311,13,14,27,3,3:26
8342,491044,2017-06-11,2017,ARI,MIL,11,1,11-1,ARI,9,1,40,36,76,139,188,327,17,9,26,5,3:26
8343,491037,2017-06-11,2017,CLE,CHA,4,2,4-2,CLE,9,1,34,35,69,134,152,286,10,11,21,2,3:16
8344,491040,2017-06-11,2017,BOS,DET,3,8,8-3,DET,9,0,42,43,85,180,171,351,19,17,36,1,4:06
8345,491045,2017-06-11,2017,SFN,MIN,13,8,13-8,SFN,9,1,45,45,90,178,158,336,22,18,40,4,3:43
8346,491036,2017-06-11,2017,NYA,BAL,14,3,14-3,NYA,9,1,46,37,83,171,169,340,24,12,36,4,3:38
8347,491042,2017-06-11,2017,HOU,ANA,6,12,12-6,ANA,9,0,42,43,85,179,153,332,15,17,32,4,3:39
8348,491050,2017-06-11,2017,SEA,TOR,0,4,4-0,TOR,9,0,38,38,76,151,154,305,11,12,23,3,3:01
8349,491053,2017-06-12,2017,NYN,CHN,6,1,6-1,NYN,9,1,36,33,69,116,118,234,14,10,24,1,2:23
8350,491059,2017-06-12,2017,HOU,TEX,1,6,6-1,TEX,9,0,34,37,71,148,136,284,7,12,19,2,3:23
8351,491052,2017-06-12,2017,CHA,BAL,10,7,10-7,CHA,9,1,40,42,82,181,147,328,16,20,36,4,3:29
8352,491058,2017-06-12,2017,MIN,SEA,3,14,14-3,SEA,9,0,35,51,86,182,141,323,8,24,32,2,3:22
8353,491057,2017-06-12,2017,BOS,PHI,6,5,6-5,BOS,11,0,47,49,96,205,158,363,20,16,36,0,4:16
8354,491051,2017-06-12,2017,WAS,ATL,10,11,11-10,ATL,9,0,47,45,92,181,161,342,22,16,38,4,3:49
8355,491056,2017-06-12,2017,ANA,NYA,3,5,5-3,NYA,9,0,36,46,82,175,131,306,8,20,28,4,3:40
8356,491054,2017-06-12,2017,SDN,CIN,9,3,9-3,SDN,9,1,39,36,75,129,142,271,16,10,26,2,2:39
8357,491055,2017-06-12,2017,PIT,COL,7,2,7-2,PIT,9,1,42,39,81,153,138,291,18,15,33,2,3:11
8358,490508,2017-06-13,2017,SLN,MIL,6,0,6-0,SLN,9,1,36,36,72,146,174,320,12,10,22,1,3:03
8359,491062,2017-06-13,2017,CHA,BAL,6,1,6-1,CHA,9,1,36,35,71,133,137,270,13,11,24,1,2:54
8360,491070,2017-06-13,2017,MIA,OAK,8,1,8-1,MIA,9,1,39,32,71,136,145,281,15,5,20,1,2:57
8361,490508,2017-06-13,2017,SLN,MIL,6,0,6-0,SLN,9,1,36,36,72,146,174,320,12,10,22,1,3:03
8362,491064,2017-06-13,2017,SDN,CIN,6,2,6-2,SDN,9,1,38,38,76,134,131,265,14,12,26,2,2:35
8363,491067,2017-06-13,2017,CLE,LAN,5,7,7-5,LAN,9,0,37,44,81,179,145,324,10,18,28,5,3:27
8364,491069,2017-06-13,2017,ANA,NYA,3,2,3-2,ANA,11,0,45,46,91,182,176,358,14,13,27,4,4:14
8365,491073,2017-06-13,2017,TOR,TBA,1,8,8-1,TBA,9,0,37,42,79,175,139,314,10,18,28,2,3:15
8366,491061,2017-06-13,2017,WAS,ATL,10,5,10-5,WAS,9,1,39,41,80,155,132,287,16,18,34,4,3:16
8367,491072,2017-06-13,2017,MIN,SEA,20,7,20-7,MIN,9,1,51,41,92,130,166,296,30,14,44,4,3:04
8368,491063,2017-06-13,2017,NYN,CHN,3,14,14-3,CHN,9,0,35,49,84,196,132,328,8,25,33,2,3:07
8369,491065,2017-06-13,2017,PIT,COL,5,2,5-2,PIT,9,1,34,35,69,137,115,252,12,8,20,0,2:42
8370,491060,2017-06-13,2017,DET,ARI,6,7,7-6,ARI,9,0,39,42,81,174,155,329,12,19,31,4,3:48
8371,491066,2017-06-13,2017,SFN,KCA,1,8,8-1,KCA,9,0,34,44,78,141,119,260,7,21,28,1,2:38
8372,491068,2017-06-13,2017,SLN,MIL,5,8,8-5,MIL,9,0,39,41,80,163,134,297,16,14,30,3,3:19
8373,491071,2017-06-13,2017,BOS,PHI,4,3,4-3,BOS,12,0,50,52,102,214,180,394,20,19,39,1,4:24
8374,491074,2017-06-13,2017,HOU,TEX,2,4,4-2,TEX,9,0,34,38,72,154,135,289,9,11,20,2,3:07
8375,491080,2017-06-14,2017,SDN,CIN,4,2,4-2,SDN,9,1,36,31,67,102,137,239,14,7,21,0,2:26
8376,491075,2017-06-14,2017,DET,ARI,1,2,2-1,ARI,9,0,35,31,66,126,133,259,8,7,15,0,2:45
8377,491085,2017-06-14,2017,ANA,NYA,7,5,7-5,ANA,9,1,39,39,78,145,131,276,15,16,31,2,3:23
8378,491078,2017-06-14,2017,PHI,BOS,3,7,7-3,BOS,9,0,37,39,76,137,148,285,10,16,26,3,3:26
8379,491088,2017-06-14,2017,TOR,TBA,7,6,7-6,TOR,9,1,39,39,78,144,146,290,15,11,26,1,3:07
8380,491084,2017-06-14,2017,SLN,MIL,6,7,7-6,MIL,9,0,38,40,78,148,159,307,12,14,26,1,3:09 (1:50 delay)
8381,491079,2017-06-14,2017,NYN,CHN,9,4,9-4,NYN,9,1,42,37,79,133,160,293,17,10,27,2,3:02
8382,491083,2017-06-14,2017,CLE,LAN,4,6,6-4,LAN,9,0,37,40,77,162,158,320,11,14,25,5,3:35 (:50 delay)
8383,491089,2017-06-14,2017,HOU,TEX,13,2,13-2,HOU,9,1,46,36,82,137,190,327,25,10,35,3,3:37
8384,491076,2017-06-14,2017,WAS,ATL,2,13,13-2,ATL,9,0,33,47,80,196,114,310,8,22,30,2,3:17
8385,491086,2017-06-14,2017,MIA,OAK,11,6,11-6,MIA,9,1,42,43,85,181,162,343,18,16,34,3,3:31
8386,491087,2017-06-14,2017,MIN,SEA,4,6,6-4,SEA,9,0,37,44,81,160,126,286,11,16,27,3,3:06
8387,491077,2017-06-14,2017,CHA,BAL,6,10,10-6,BAL,9,0,40,42,82,167,163,330,14,15,29,1,3:22 (1:30 delay)
8388,491082,2017-06-14,2017,SFN,KCA,2,7,7-2,KCA,9,0,40,46,86,153,137,290,13,19,32,2,3:03
8389,491081,2017-06-14,2017,PIT,COL,1,5,5-1,COL,9,0,36,37,73,136,142,278,11,10,21,3,3:19
8390,491091,2017-06-15,2017,PHI,BOS,1,0,1-0,PHI,9,1,29,34,63,139,110,249,5,8,13,0,2:25
8391,491092,2017-06-15,2017,ANA,KCA,2,7,7-2,KCA,9,0,33,45,78,142,120,262,7,18,25,2,2:48
8392,491099,2017-06-15,2017,NYN,WAS,3,8,8-3,WAS,9,0,33,41,74,149,129,278,6,14,20,1,2:52
8393,491097,2017-06-15,2017,MIN,SEA,6,2,6-2,MIN,9,1,37,33,70,121,143,264,15,7,22,0,2:45
8394,491098,2017-06-15,2017,DET,TBA,5,3,5-3,DET,9,0,39,39,78,143,155,298,14,14,28,1,3:29
8395,491090,2017-06-15,2017,CHA,BAL,5,2,5-2,CHA,9,1,41,38,79,174,154,328,18,12,30,4,3:35
8396,491094,2017-06-15,2017,SLN,MIL,4,6,6-4,MIL,9,0,37,39,76,162,163,325,12,14,26,1,3:14
8397,491096,2017-06-15,2017,COL,SFN,10,9,10-9,COL,9,0,43,48,91,186,156,342,20,24,44,3,3:55
8398,491093,2017-06-15,2017,CLE,LAN,12,5,12-5,CLE,9,1,43,40,83,157,202,359,20,14,34,4,3:32
8399,491095,2017-06-15,2017,OAK,NYA,8,7,8-7,OAK,10,0,49,50,99,206,176,382,21,22,43,5,4:29
8400,491105,2017-06-16,2017,ANA,KCA,1,3,3-1,KCA,9,0,31,36,67,116,139,255,4,10,14,0,2:38
8401,491101,2017-06-16,2017,HOU,BOS,1,2,2-1,BOS,9,0,34,35,69,120,153,273,12,9,21,1,3:11
8402,491106,2017-06-16,2017,CIN,LAN,1,3,3-1,LAN,9,0,31,40,71,164,103,267,6,15,21,0,2:45
8403,491104,2017-06-16,2017,MIN,CLE,1,8,8-1,CLE,9,0,33,42,75,135,143,278,7,18,25,2,2:50
8404,491107,2017-06-16,2017,ATL,MIA,0,5,5-0,MIA,9,0,30,40,70,147,116,263,4,14,18,2,2:44
8405,491113,2017-06-16,2017,DET,TBA,13,4,13-4,DET,9,1,41,35,76,142,141,283,17,11,28,2,3:05
8406,491111,2017-06-16,2017,TEX,SEA,10,4,10-4,TEX,9,1,42,36,78,147,158,305,18,10,28,3,3:07
8407,491112,2017-06-16,2017,BAL,SLN,2,11,11-2,SLN,9,0,33,43,76,171,131,302,8,19,27,1,2:55
8408,491114,2017-06-16,2017,NYN,WAS,2,7,7-2,WAS,9,0,33,43,76,145,144,289,9,18,27,1,2:56
8409,491108,2017-06-16,2017,OAK,NYA,7,6,7-6,OAK,9,1,36,40,76,168,142,310,15,14,29,1,3:13
8410,491100,2017-06-16,2017,PHI,ARI,4,5,5-4,ARI,9,0,35,41,76,159,124,283,7,15,22,2,3:12
8411,491110,2017-06-16,2017,COL,SFN,10,8,10-8,COL,9,1,39,38,77,145,142,287,16,13,29,1,3:09
8412,491109,2017-06-16,2017,MIL,SDN,6,5,6-5,MIL,10,0,38,41,79,166,143,309,13,10,23,2,3:16
8413,491102,2017-06-16,2017,PIT,CHN,5,9,9-5,CHN,9,0,39,41,80,146,162,308,12,16,28,3,3:31
8414,491103,2017-06-16,2017,TOR,CHA,4,11,11-4,CHA,9,0,34,43,77,153,138,291,11,17,28,2,3:05
8415,490314,2017-06-17,2017,MIN,CLE,2,6,6-2,CLE,9,0,34,43,77,162,139,301,8,18,26,3,2:58 (1:15 delay)
8416,491116,2017-06-17,2017,HOU,BOS,7,1,7-1,HOU,9,1,35,30,65,112,128,240,12,4,16,0,2:34
8417,491118,2017-06-17,2017,TOR,CHA,2,5,5-2,CHA,9,0,32,38,70,120,128,248,7,11,18,2,2:44
8418,491125,2017-06-17,2017,COL,SFN,5,1,5-1,COL,9,1,40,38,78,147,124,271,18,14,32,1,3:01
8419,491126,2017-06-17,2017,TEX,SEA,10,4,10-4,TEX,9,1,37,38,75,152,133,285,12,11,23,1,2:54
8420,491115,2017-06-17,2017,PHI,ARI,1,5,5-1,ARI,9,0,41,40,81,161,161,322,14,14,28,4,3:25 (:50 delay)
8421,490314,2017-06-17,2017,MIN,CLE,2,6,6-2,CLE,9,0,34,43,77,162,139,301,8,18,26,3,2:58 (1:15 delay)
8422,491119,2017-06-17,2017,MIN,CLE,3,9,9-3,CLE,9,0,35,47,82,192,136,328,9,21,30,2,3:20
8423,491122,2017-06-17,2017,ATL,MIA,8,7,8-7,ATL,10,0,47,44,91,171,172,343,20,16,36,3,3:48
8424,491127,2017-06-17,2017,BAL,SLN,15,7,15-7,BAL,9,1,45,43,88,190,171,361,21,15,36,4,3:27
8425,491124,2017-06-17,2017,MIL,SDN,5,7,7-5,SDN,11,0,42,46,88,174,161,335,9,13,22,2,3:46
8426,491120,2017-06-17,2017,ANA,KCA,9,0,9-0,ANA,9,1,38,31,69,138,133,271,16,3,19,1,2:51
8427,491117,2017-06-17,2017,PIT,CHN,4,3,4-3,PIT,9,1,34,35,69,117,139,256,11,10,21,2,2:54
8428,491128,2017-06-17,2017,DET,TBA,2,3,3-2,TBA,9,0,38,36,74,135,149,284,10,12,22,2,3:23
8429,491123,2017-06-17,2017,OAK,NYA,5,2,5-2,OAK,9,1,40,36,76,158,161,319,16,8,24,0,3:17
8430,491129,2017-06-17,2017,NYN,WAS,4,7,7-4,WAS,9,0,38,41,79,144,176,320,15,15,30,5,3:32
8431,491121,2017-06-17,2017,CIN,LAN,2,10,10-2,LAN,9,0,39,45,84,168,172,340,13,17,30,2,3:28
8432,491139,2017-06-18,2017,MIL,SDN,2,1,2-1,MIL,9,1,32,34,66,118,115,233,11,9,20,0,2:37
8433,491138,2017-06-18,2017,OAK,NYA,4,3,4-3,OAK,9,1,32,35,67,135,135,270,9,9,18,1,2:55
8434,491134,2017-06-18,2017,MIN,CLE,2,5,5-2,CLE,9,0,34,41,75,153,132,285,9,16,25,2,3:01
8435,491141,2017-06-18,2017,TEX,SEA,3,7,7-3,SEA,9,0,36,41,77,189,137,326,10,16,26,5,3:43
8436,491140,2017-06-18,2017,COL,SFN,7,5,7-5,COL,9,0,39,40,79,159,147,306,15,15,30,2,3:16
8437,491135,2017-06-18,2017,ANA,KCA,3,7,7-3,KCA,9,0,39,42,81,173,140,313,15,16,31,4,3:28
8438,491144,2017-06-18,2017,NYN,WAS,5,1,5-1,NYN,9,1,39,34,73,123,142,265,15,6,21,0,2:50
8439,491143,2017-06-18,2017,DET,TBA,1,9,9-1,TBA,9,0,34,40,74,139,141,280,8,13,21,1,3:05 (:31 delay)
8440,491133,2017-06-18,2017,TOR,CHA,7,3,7-3,TOR,9,1,40,36,76,137,142,279,17,9,26,4,3:01
8441,491132,2017-06-18,2017,PIT,CHN,1,7,7-1,CHN,9,0,32,40,72,139,133,272,6,14,20,1,2:48
8442,491137,2017-06-18,2017,ATL,MIA,5,4,5-4,ATL,9,0,38,38,76,140,138,278,15,13,28,2,2:53
8443,491142,2017-06-18,2017,BAL,SLN,8,5,8-5,BAL,9,1,37,36,73,135,159,294,14,11,25,3,2:58
8444,491131,2017-06-18,2017,HOU,BOS,5,6,6-5,BOS,9,0,45,37,82,137,192,329,21,12,33,4,4:08
8445,491136,2017-06-18,2017,CIN,LAN,7,8,8-7,LAN,9,0,42,42,84,155,163,318,15,15,30,1,3:20
8446,491130,2017-06-18,2017,PHI,ARI,4,5,5-4,ARI,10,0,44,44,88,187,196,383,17,16,33,2,4:12
8447,491148,2017-06-19,2017,SEA,DET,6,2,6-2,SEA,9,1,36,38,74,149,142,291,14,12,26,3,3:16
8448,491150,2017-06-19,2017,LAN,NYN,10,6,10-6,LAN,9,1,44,38,82,164,177,341,20,12,32,2,3:27
8449,491146,2017-06-19,2017,TBA,CIN,3,7,7-3,CIN,9,0,35,43,78,164,133,297,9,18,27,2,3:08
8450,491147,2017-06-19,2017,BAL,CLE,0,12,12-0,CLE,9,0,30,52,82,212,108,320,3,25,28,2,2:57 (:29 delay)
8451,491153,2017-06-19,2017,ATL,SFN,9,0,9-0,ATL,9,1,39,32,71,104,142,246,16,6,22,2,2:46 (:44 delay)
8452,491145,2017-06-19,2017,KCA,BOS,4,2,4-2,KCA,9,1,36,40,76,122,142,264,12,13,25,3,3:11
8453,491152,2017-06-19,2017,CHN,SDN,3,2,3-2,CHN,9,1,31,40,71,173,126,299,11,13,24,2,3:06
8454,491151,2017-06-19,2017,MIL,PIT,1,8,8-1,PIT,9,0,34,42,76,173,134,307,8,15,23,2,3:18
8455,491149,2017-06-19,2017,OAK,HOU,1,4,4-1,HOU,9,0,33,37,70,142,145,287,7,11,18,2,2:56
8456,491155,2017-06-19,2017,MIA,WAS,8,7,8-7,MIA,9,0,40,42,82,156,165,321,18,16,34,3,3:31
8457,491154,2017-06-19,2017,TEX,TOR,6,7,7-6,TOR,9,0,41,43,84,184,161,345,14,16,30,3,3:48
8458,491167,2017-06-20,2017,ATL,SFN,3,6,6-3,SFN,9,0,36,35,71,112,140,252,10,9,19,5,2:56
8459,491170,2017-06-20,2017,MIA,WAS,3,12,12-3,WAS,9,0,36,44,80,162,122,284,10,19,29,1,3:02
8460,491163,2017-06-20,2017,NYA,ANA,3,8,8-3,ANA,9,0,36,42,78,163,160,323,9,15,24,2,3:26
8461,491159,2017-06-20,2017,TBA,CIN,6,5,6-5,TBA,9,1,36,42,78,153,162,315,13,15,28,2,3:20
8462,491166,2017-06-20,2017,CHN,SDN,4,0,4-0,CHN,9,1,35,35,70,131,121,252,17,9,26,1,2:38
8463,491168,2017-06-20,2017,PHI,SLN,1,8,8-1,SLN,11,0,40,47,87,177,156,333,9,16,25,2,3:28
8464,491156,2017-06-20,2017,COL,ARI,4,3,4-3,COL,9,1,33,37,70,141,108,249,10,11,21,3,2:45
8465,491157,2017-06-20,2017,KCA,BOS,3,8,8-3,BOS,9,0,31,42,73,178,116,294,5,16,21,2,2:54
8466,491165,2017-06-20,2017,MIL,PIT,3,7,7-3,PIT,9,0,41,41,82,148,161,309,14,15,29,1,3:13
8467,491161,2017-06-20,2017,SEA,DET,5,4,5-4,SEA,10,0,41,39,80,147,169,316,16,10,26,3,3:42
8468,491162,2017-06-20,2017,OAK,HOU,4,8,8-4,HOU,9,0,38,45,83,183,134,317,12,19,31,1,3:28
8469,491158,2017-06-20,2017,MIN,CHA,9,7,9-7,MIN,9,1,42,48,90,168,164,332,17,21,38,3,3:33
8470,491169,2017-06-20,2017,TEX,TOR,6,1,6-1,TEX,9,1,32,37,69,156,123,279,10,11,21,4,3:06
8471,491164,2017-06-20,2017,LAN,NYN,12,0,12-0,LAN,9,1,46,33,79,135,179,314,22,8,30,2,3:01
8472,491160,2017-06-20,2017,BAL,CLE,6,5,6-5,BAL,9,1,35,43,78,194,132,326,12,19,31,6,3:40
8473,491185,2017-06-21,2017,MIA,WAS,2,1,2-1,MIA,9,1,29,32,61,152,121,273,5,7,12,1,2:39
8474,491173,2017-06-21,2017,MIN,CHA,4,2,4-2,MIN,9,1,40,32,72,107,148,255,18,6,24,2,3:02
8475,491172,2017-06-21,2017,KCA,BOS,6,4,6-4,KCA,9,1,35,36,71,151,141,292,13,9,22,4,3:07
8476,491177,2017-06-21,2017,OAK,HOU,1,5,5-1,HOU,9,0,34,40,74,141,135,276,9,12,21,2,3:06
8477,491182,2017-06-21,2017,ATL,SFN,5,3,5-3,ATL,11,0,40,42,82,155,125,280,8,10,18,1,3:16 (1:15 delay)
8478,491180,2017-06-21,2017,MIL,PIT,4,3,4-3,MIL,9,1,34,39,73,176,122,298,11,15,26,2,3:13
8479,491174,2017-06-21,2017,TBA,CIN,8,3,8-3,TBA,9,1,39,38,77,154,139,293,18,11,29,5,3:16
8480,491181,2017-06-21,2017,CHN,SDN,2,3,3-2,SDN,9,0,30,39,69,177,127,304,4,14,18,4,3:09
8481,491179,2017-06-21,2017,LAN,NYN,8,2,8-2,LAN,9,1,37,38,75,158,153,311,14,10,24,1,3:12
8482,491178,2017-06-21,2017,NYA,ANA,8,4,8-4,NYA,9,1,39,36,75,148,143,291,17,10,27,3,3:14
8483,491184,2017-06-21,2017,TEX,TOR,5,7,7-5,TOR,9,0,38,40,78,173,136,309,11,15,26,3,3:20
8484,491176,2017-06-21,2017,SEA,DET,7,5,7-5,SEA,9,1,36,39,75,156,155,311,13,15,28,3,3:16
8485,491175,2017-06-21,2017,BAL,CLE,1,5,5-1,CLE,9,0,36,41,77,183,138,321,9,14,23,4,3:16 (:44 delay)
8486,491183,2017-06-21,2017,PHI,SLN,6,7,7-6,SLN,10,0,48,42,90,168,180,348,20,14,34,2,3:29
8487,491171,2017-06-21,2017,COL,ARI,5,16,16-5,ARI,9,0,39,51,90,175,141,316,13,26,39,1,3:28
8488,491190,2017-06-22,2017,SEA,DET,9,6,9-6,SEA,9,1,35,37,72,153,142,295,13,11,24,1,2:58
8489,491195,2017-06-22,2017,ATL,SFN,12,11,12-11,ATL,9,1,41,48,89,186,156,342,17,21,38,4,3:37 (1:26 delay)
8490,491191,2017-06-22,2017,OAK,HOU,9,12,12-9,HOU,9,0,43,45,88,156,189,345,17,17,34,2,3:24
8491,491189,2017-06-22,2017,BAL,CLE,3,6,6-3,CLE,9,0,40,42,82,178,181,359,16,17,33,3,3:35
8492,491196,2017-06-22,2017,PHI,SLN,5,1,5-1,PHI,9,1,33,32,65,127,117,244,13,6,19,1,2:31
8493,491194,2017-06-22,2017,MIL,PIT,4,2,4-2,MIL,9,1,34,33,67,140,113,253,14,8,22,0,2:57
8494,491197,2017-06-22,2017,TEX,TOR,11,4,11-4,TEX,9,1,41,38,79,137,154,291,17,14,31,1,3:07
8495,491193,2017-06-22,2017,LAN,NYN,6,3,6-3,LAN,9,1,38,38,76,167,157,324,16,12,28,6,3:33
8496,491186,2017-06-22,2017,COL,ARI,3,10,10-3,ARI,9,0,34,42,76,169,137,306,8,15,23,2,3:06
8497,491187,2017-06-22,2017,MIA,CHN,1,11,11-1,CHN,9,0,32,46,78,182,115,297,7,21,28,0,2:54
8498,491192,2017-06-22,2017,NYA,ANA,5,10,10-5,ANA,9,0,36,42,78,152,166,318,10,15,25,2,3:24
8499,491188,2017-06-22,2017,MIN,CHA,0,9,9-0,CHA,9,0,33,47,80,180,148,328,7,20,27,5,3:21 (4:50 delay)
8500,491208,2017-06-23,2017,CHA,OAK,0,3,3-0,OAK,9,0,32,38,70,162,110,272,8,12,20,4,2:59
8501,491210,2017-06-23,2017,SLN,PIT,3,4,4-3,PIT,9,0,38,36,74,143,166,309,13,8,21,3,3:08
8502,491204,2017-06-23,2017,BOS,ANA,9,4,9-4,BOS,9,1,36,36,72,140,152,292,13,11,24,2,3:07
8503,491211,2017-06-23,2017,NYA,TEX,2,1,2-1,NYA,10,0,36,38,74,159,135,294,8,9,17,1,3:32 (1:42 delay)
8504,491207,2017-06-23,2017,SFN,NYN,4,11,11-4,NYN,9,0,37,47,84,179,138,317,11,22,33,1,3:13
8505,491199,2017-06-23,2017,MIA,CHN,2,0,2-0,MIA,9,1,30,34,64,135,114,249,6,10,16,1,2:30
8506,491202,2017-06-23,2017,SDN,DET,1,0,1-0,SDN,9,1,30,33,63,143,113,256,7,8,15,0,2:36
8507,491201,2017-06-23,2017,LAN,COL,6,1,6-1,LAN,9,1,39,32,71,140,153,293,16,5,21,0,2:55
8508,491209,2017-06-23,2017,ARI,PHI,1,6,6-1,PHI,9,0,34,41,75,153,135,288,8,13,21,1,2:54
8509,491206,2017-06-23,2017,CLE,MIN,0,5,5-0,MIN,9,0,38,36,74,156,154,310,9,10,19,2,3:11
8510,491212,2017-06-23,2017,KCA,TOR,5,4,5-4,KCA,9,0,37,42,79,154,165,319,10,16,26,5,3:16
8511,491205,2017-06-23,2017,ATL,MIL,5,4,5-4,ATL,9,1,38,41,79,172,148,320,12,15,27,0,3:18
8512,491198,2017-06-23,2017,TBA,BAL,15,5,15-5,TBA,9,1,46,38,84,127,176,303,20,12,32,2,3:19
8513,491203,2017-06-23,2017,SEA,HOU,13,3,13-3,SEA,9,1,44,38,82,146,166,312,20,12,32,2,3:17
8514,491200,2017-06-23,2017,WAS,CIN,6,5,6-5,WAS,10,0,48,44,92,150,200,350,22,16,38,3,3:51
8515,491227,2017-06-24,2017,KCA,TOR,3,2,3-2,KCA,9,1,33,34,67,126,126,252,9,9,18,0,2:26
8516,491222,2017-06-24,2017,SFN,NYN,2,5,5-2,NYN,9,0,34,39,73,154,120,274,7,15,22,2,2:52
8517,491219,2017-06-24,2017,BOS,ANA,3,6,6-3,ANA,9,0,36,39,75,145,160,305,9,12,21,2,3:34
8518,491213,2017-06-24,2017,TBA,BAL,3,8,8-3,BAL,9,0,35,44,79,166,137,303,12,16,28,2,3:10
8519,491214,2017-06-24,2017,MIA,CHN,3,5,5-3,CHN,9,0,31,37,68,137,131,268,5,12,17,1,2:55
8520,491223,2017-06-24,2017,CHA,OAK,2,10,10-2,OAK,9,0,35,50,85,200,128,328,6,22,28,2,3:22
8521,491215,2017-06-24,2017,WAS,CIN,18,3,18-3,WAS,9,1,51,37,88,136,206,342,26,11,37,1,3:22
8522,491217,2017-06-24,2017,SDN,DET,7,3,7-3,SDN,9,1,35,35,70,127,121,248,11,7,18,2,2:51
8523,491220,2017-06-24,2017,ATL,MIL,3,1,3-1,ATL,9,1,34,34,68,128,132,260,10,8,18,1,2:57
8524,491225,2017-06-24,2017,SLN,PIT,3,7,7-3,PIT,9,0,37,39,76,145,156,301,12,13,25,1,3:00
8525,491226,2017-06-24,2017,NYA,TEX,1,8,8-1,TEX,9,0,32,40,72,166,118,284,6,13,19,1,3:03
8526,491216,2017-06-24,2017,LAN,COL,4,0,4-0,LAN,9,1,39,33,72,138,163,301,16,6,22,1,3:18
8527,491224,2017-06-24,2017,ARI,PHI,9,2,9-2,ARI,9,1,41,37,78,141,148,289,16,12,28,4,3:05
8528,491221,2017-06-24,2017,CLE,MIN,2,4,4-2,MIN,9,0,38,36,74,144,165,309,13,9,22,2,3:13
8529,491218,2017-06-24,2017,SEA,HOU,2,5,5-2,HOU,9,0,36,40,76,134,143,277,10,14,24,4,3:09
8530,491236,2017-06-25,2017,CLE,MIN,0,4,4-0,MIN,9,0,37,38,75,134,135,269,10,12,22,1,2:55
8531,491229,2017-06-25,2017,MIA,CHN,4,2,4-2,MIA,9,1,33,40,73,144,125,269,9,15,24,1,2:51
8532,491240,2017-06-25,2017,SLN,PIT,8,4,8-4,SLN,9,1,40,35,75,139,177,316,17,9,26,3,3:11
8533,491232,2017-06-25,2017,SDN,DET,5,7,7-5,DET,9,0,37,41,78,143,152,295,12,17,29,1,3:12
8534,491230,2017-06-25,2017,WAS,CIN,2,6,6-2,CIN,9,0,36,39,75,158,139,297,10,14,24,2,3:07
8535,491235,2017-06-25,2017,ATL,MIL,0,7,7-0,MIL,9,0,34,40,74,169,134,303,9,13,22,1,3:01
8536,491228,2017-06-25,2017,TBA,BAL,5,8,8-5,BAL,9,0,40,41,81,147,158,305,16,17,33,4,3:15
8537,491241,2017-06-25,2017,NYA,TEX,6,7,7-6,TEX,9,0,40,37,77,149,169,318,14,11,25,1,3:20
8538,491242,2017-06-25,2017,KCA,TOR,2,8,8-2,TOR,9,0,35,47,82,184,139,323,10,19,29,3,3:21
8539,491234,2017-06-25,2017,BOS,ANA,2,4,4-2,ANA,9,0,34,37,71,152,105,257,9,13,22,3,2:50
8540,491233,2017-06-25,2017,SEA,HOU,2,8,8-2,HOU,9,0,38,39,77,145,165,310,11,14,25,3,3:21
8541,491238,2017-06-25,2017,CHA,OAK,3,5,5-3,OAK,9,0,33,41,74,183,130,313,7,15,22,6,3:33
8542,491239,2017-06-25,2017,ARI,PHI,2,1,2-1,ARI,11,0,41,42,83,168,168,336,11,12,23,1,3:50
8543,491231,2017-06-25,2017,LAN,COL,12,6,12-6,LAN,9,1,43,41,84,176,197,373,20,14,34,5,4:19
8544,491237,2017-06-25,2017,SFN,NYN,2,8,8-2,NYN,9,0,37,50,87,191,171,362,12,24,36,3,3:44
8545,490449,2017-06-26,2017,SLN,CIN,8,2,8-2,SLN,9,1,40,36,76,130,140,270,18,10,28,1,2:49
8546,491245,2017-06-26,2017,LAN,ANA,0,4,4-0,ANA,9,0,34,37,71,134,119,253,8,12,20,1,2:53
8547,490449,2017-06-26,2017,SLN,CIN,8,2,8-2,SLN,9,1,40,36,76,130,140,270,18,10,28,1,2:49
8548,491248,2017-06-26,2017,ARI,PHI,6,1,6-1,ARI,9,1,39,36,75,159,163,322,16,9,25,1,3:11
8549,491247,2017-06-26,2017,CHA,NYA,5,6,6-5,NYA,9,0,41,42,83,167,158,325,14,14,28,3,3:28
8550,491246,2017-06-26,2017,BOS,MIN,4,1,4-1,BOS,9,1,35,31,66,141,130,271,13,6,19,3,2:55
8551,491244,2017-06-26,2017,SFN,COL,9,2,9-2,SFN,9,1,42,37,79,162,170,332,18,10,28,2,3:22
8552,491243,2017-06-26,2017,WAS,CHN,4,5,5-4,CHN,9,0,40,42,82,171,157,328,13,18,31,5,3:54
8553,491249,2017-06-26,2017,CLE,TEX,15,9,15-9,CLE,9,1,49,40,89,174,172,346,26,14,40,5,3:37
8554,491255,2017-06-27,2017,LAN,ANA,4,0,4-0,LAN,9,1,31,31,62,108,127,235,8,5,13,1,2:30
8555,491264,2017-06-27,2017,CLE,TEX,1,2,2-1,TEX,9,0,32,32,64,148,141,289,6,6,12,1,2:52
8556,491263,2017-06-27,2017,PIT,TBA,2,4,4-2,TBA,10,0,37,37,74,129,132,261,10,8,18,1,3:05
8557,491250,2017-06-27,2017,SDN,ATL,0,3,3-0,ATL,9,0,36,34,70,125,148,273,9,9,18,1,2:45
8558,491261,2017-06-27,2017,SEA,PHI,2,8,8-2,PHI,9,0,34,41,75,139,135,274,9,15,24,1,3:02
8559,491251,2017-06-27,2017,TOR,BAL,1,3,3-1,BAL,9,0,34,38,72,150,150,300,9,12,21,2,3:00
8560,491252,2017-06-27,2017,WAS,CHN,6,1,6-1,WAS,9,1,39,30,69,137,154,291,16,4,20,2,3:09
8561,491259,2017-06-27,2017,CHA,NYA,4,3,4-3,CHA,9,0,39,38,77,151,163,314,14,12,26,3,3:25
8562,491256,2017-06-27,2017,CIN,MIL,8,6,8-6,CIN,9,1,37,39,76,152,138,290,14,14,28,2,2:55
8563,491260,2017-06-27,2017,HOU,OAK,4,6,6-4,OAK,9,0,41,39,80,167,153,320,17,12,29,3,3:30
8564,491258,2017-06-27,2017,MIA,NYN,6,3,6-3,MIA,9,1,36,37,73,163,141,304,14,11,25,3,3:03
8565,491254,2017-06-27,2017,DET,KCA,5,3,5-3,DET,9,1,36,38,74,151,155,306,11,12,23,2,3:14
8566,491257,2017-06-27,2017,BOS,MIN,9,2,9-2,BOS,9,1,41,35,76,151,182,333,19,9,28,1,3:18 (2:06 delay)
8567,491262,2017-06-27,2017,ARI,SLN,6,5,6-5,ARI,10,0,45,43,88,150,176,326,17,13,30,1,3:22
8568,491253,2017-06-27,2017,SFN,COL,4,3,4-3,SFN,14,0,55,54,109,204,195,399,15,19,34,4,4:45
8569,491279,2017-06-28,2017,CLE,TEX,5,3,5-3,CLE,9,1,38,35,73,149,148,297,17,8,25,2,3:04
8570,491273,2017-06-28,2017,MIA,NYN,0,8,8-0,NYN,9,0,34,40,74,162,140,302,9,14,23,2,2:57
8571,491269,2017-06-28,2017,DET,KCA,2,8,8-2,KCA,9,0,33,43,76,136,114,250,8,19,27,1,2:46
8572,491270,2017-06-28,2017,ANA,LAN,3,2,3-2,ANA,9,0,37,35,72,136,133,269,10,9,19,1,3:11
8573,491266,2017-06-28,2017,TOR,BAL,4,0,4-0,TOR,9,1,33,33,66,141,146,287,11,7,18,1,2:27
8574,491267,2017-06-28,2017,WAS,CHN,8,4,8-4,WAS,9,1,39,35,74,143,141,284,15,8,23,1,2:50
8575,491271,2017-06-28,2017,CIN,MIL,4,3,4-3,CIN,9,1,34,36,70,151,145,296,11,11,22,2,2:56
8576,491278,2017-06-28,2017,PIT,TBA,6,2,6-2,PIT,9,1,34,40,74,146,143,289,11,14,25,0,3:01
8577,491268,2017-06-28,2017,SFN,COL,5,3,5-3,SFN,9,1,32,38,70,146,142,288,10,11,21,5,3:05
8578,491272,2017-06-28,2017,BOS,MIN,1,4,4-1,MIN,9,0,39,38,77,160,152,312,12,12,24,3,3:14
8579,491275,2017-06-28,2017,HOU,OAK,11,8,11-8,HOU,9,1,42,37,79,158,159,317,20,9,29,4,3:27
8580,491274,2017-06-28,2017,CHA,NYA,3,12,12-3,NYA,9,0,39,45,84,193,176,369,12,19,31,2,3:51
8581,491276,2017-06-28,2017,SEA,PHI,4,5,5-4,PHI,9,0,38,36,74,169,172,341,13,11,24,1,3:24
8582,491277,2017-06-28,2017,ARI,SLN,3,4,4-3,SLN,9,0,38,37,75,151,149,300,12,13,25,2,3:18
8583,491265,2017-06-28,2017,SDN,ATL,7,4,7-4,SDN,9,1,41,35,76,115,166,281,17,10,27,1,2:55
8584,491284,2017-06-29,2017,ANA,LAN,2,6,6-2,LAN,9,0,36,38,74,135,125,260,9,10,19,3,3:06
8585,491292,2017-06-29,2017,CLE,TEX,5,1,5-1,CLE,9,1,36,31,67,127,129,256,12,5,17,1,2:41
8586,491282,2017-06-29,2017,WAS,CHN,4,5,5-4,CHN,9,0,37,38,75,125,153,278,12,13,25,4,3:12
8587,491286,2017-06-29,2017,BOS,MIN,6,3,6-3,BOS,9,1,35,34,69,162,137,299,12,7,19,2,3:24
8588,491285,2017-06-29,2017,CIN,MIL,3,11,11-3,MIL,9,0,35,44,79,163,144,307,9,18,27,1,3:15
8589,491283,2017-06-29,2017,DET,KCA,7,3,7-3,DET,9,1,36,32,68,109,139,248,13,7,20,1,2:33
8590,491288,2017-06-29,2017,CHA,NYA,4,3,4-3,CHA,9,1,35,38,73,117,139,256,10,13,23,2,3:01 (2:50 delay)
8591,491281,2017-06-29,2017,TOR,BAL,0,2,2-0,BAL,9,0,31,36,67,122,114,236,4,10,14,1,2:20
8592,491280,2017-06-29,2017,SDN,ATL,6,0,6-0,SDN,9,1,36,32,68,125,122,247,13,5,18,1,2:40
8593,491291,2017-06-29,2017,PIT,TBA,4,0,4-0,PIT,9,1,35,37,72,138,130,268,13,11,24,2,2:54
8594,491289,2017-06-29,2017,HOU,OAK,6,1,6-1,HOU,9,1,36,39,75,172,148,320,14,12,26,1,3:08
8595,491287,2017-06-29,2017,MIA,NYN,3,6,6-3,NYN,9,0,34,36,70,145,126,271,10,9,19,1,2:43
8596,491290,2017-06-29,2017,ARI,SLN,4,10,10-4,SLN,9,0,34,44,78,180,135,315,8,18,26,0,3:18
8597,491300,2017-06-30,2017,KCA,MIN,8,1,8-1,KCA,9,1,37,34,71,121,135,256,12,7,19,1,2:39
8598,491293,2017-06-30,2017,OAK,ATL,1,3,3-1,ATL,9,0,33,32,65,126,133,259,6,6,12,1,2:45
8599,491302,2017-06-30,2017,NYN,PHI,2,1,2-1,NYN,9,1,32,32,64,137,134,271,10,5,15,2,2:38
8600,491304,2017-06-30,2017,ANA,SEA,0,10,10-0,SEA,9,0,33,43,76,134,129,263,8,19,27,1,2:45
8601,491307,2017-06-30,2017,SLN,WAS,8,1,8-1,SLN,9,1,42,32,74,113,170,283,18,10,28,1,2:54
8602,491299,2017-06-30,2017,MIL,MIA,3,2,3-2,MIL,9,1,31,37,68,140,137,277,8,11,19,0,3:14
8603,491301,2017-06-30,2017,HOU,NYA,4,13,13-4,NYA,9,0,36,48,84,182,121,303,9,21,30,3,3:20
8604,491297,2017-06-30,2017,ARI,COL,3,6,6-3,COL,9,0,39,40,79,173,144,317,11,13,24,2,3:31
8605,491306,2017-06-30,2017,CHA,TEX,8,7,8-7,CHA,9,0,38,42,80,189,134,323,14,18,32,3,3:42
8606,491298,2017-06-30,2017,SDN,LAN,4,10,10-4,LAN,9,0,39,48,87,192,165,357,12,24,36,3,3:27
8607,491294,2017-06-30,2017,TOR,BOS,4,7,7-4,BOS,11,0,46,57,103,241,204,445,14,30,44,3,4:44
8608,491305,2017-06-30,2017,BAL,TBA,4,6,6-4,TBA,10,0,35,43,78,174,152,326,5,16,21,3,3:37
8609,491295,2017-06-30,2017,CIN,CHN,5,0,5-0,CIN,9,1,34,32,66,134,133,267,13,5,18,1,2:37
8610,491303,2017-06-30,2017,PIT,SFN,5,13,13-5,SFN,9,0,42,51,93,189,176,365,16,25,41,5,4:01
8611,490519,2017-07-01,2017,DET,CLE,7,4,7-4,DET,9,1,40,35,75,147,140,287,20,8,28,4,2:59
8612,490452,2017-07-01,2017,KCA,MIN,5,10,10-5,MIN,9,0,36,45,81,172,147,319,11,18,29,3,3:28
8613,490519,2017-07-01,2017,DET,CLE,7,4,7-4,DET,9,1,40,35,75,147,140,287,20,8,28,4,2:59
8614,491309,2017-07-01,2017,TOR,BOS,1,7,7-1,BOS,9,0,37,41,78,155,149,304,10,16,26,1,2:54
8615,491315,2017-07-01,2017,KCA,MIN,11,6,11-6,KCA,9,1,42,48,90,224,148,372,19,21,40,2,3:39
8616,491313,2017-07-01,2017,SDN,LAN,0,8,8-0,LAN,9,0,32,45,77,168,122,290,5,20,25,1,2:59
8617,491310,2017-07-01,2017,CIN,CHN,5,3,5-3,CIN,9,1,37,36,73,149,144,293,18,11,29,2,3:02
8618,491322,2017-07-01,2017,SLN,WAS,2,1,2-1,SLN,9,1,30,36,66,163,135,298,6,10,16,2,2:53
8619,491311,2017-07-01,2017,DET,CLE,1,4,4-1,CLE,9,0,35,35,70,139,145,284,7,9,16,1,3:17
8620,491321,2017-07-01,2017,CHA,TEX,4,10,10-4,TEX,9,0,33,45,78,194,130,324,7,19,26,4,3:26
8621,490452,2017-07-01,2017,KCA,MIN,5,10,10-5,MIN,9,0,36,45,81,172,147,319,11,18,29,3,3:28
8622,491317,2017-07-01,2017,NYN,PHI,7,6,7-6,NYN,9,1,33,42,75,183,111,294,13,14,27,4,3:21 (:57 delay)
8623,491318,2017-07-01,2017,PIT,SFN,1,2,2-1,SFN,11,0,49,41,90,158,196,354,17,9,26,2,4:00
8624,491320,2017-07-01,2017,BAL,TBA,3,10,10-3,TBA,9,0,37,44,81,175,167,342,11,17,28,1,3:23 (1:12 delay)
8625,491319,2017-07-01,2017,ANA,SEA,4,0,4-0,ANA,9,1,32,30,62,105,114,219,11,4,15,2,2:32
8626,491312,2017-07-01,2017,ARI,COL,6,2,6-2,ARI,9,1,37,33,70,124,107,231,13,6,19,3,2:38
8627,491316,2017-07-01,2017,HOU,NYA,7,6,7-6,HOU,9,1,35,37,72,159,146,305,12,13,25,4,3:25
8628,491308,2017-07-01,2017,OAK,ATL,3,4,4-3,ATL,9,0,38,37,75,152,144,296,12,9,21,2,3:16
8629,491314,2017-07-01,2017,MIL,MIA,8,4,8-4,MIL,9,1,40,37,77,147,172,319,15,10,25,1,3:01
8630,491333,2017-07-02,2017,PIT,SFN,3,5,5-3,SFN,9,0,34,36,70,141,130,271,7,9,16,3,2:55
8631,491325,2017-07-02,2017,CIN,CHN,2,6,6-2,CHN,9,0,35,40,75,166,142,308,8,15,23,2,3:08
8632,491336,2017-07-02,2017,CHA,TEX,6,5,6-5,CHA,9,1,34,41,75,165,152,317,13,13,26,2,3:43
8633,491334,2017-07-02,2017,ANA,SEA,3,5,5-3,SEA,9,0,33,38,71,164,137,301,8,13,21,3,3:10
8634,491335,2017-07-02,2017,BAL,TBA,7,1,7-1,BAL,9,1,35,33,68,136,122,258,10,7,17,1,2:39
8635,491332,2017-07-02,2017,NYN,PHI,1,7,7-1,PHI,9,0,33,41,74,146,128,274,6,14,20,2,2:53
8636,491328,2017-07-02,2017,SDN,LAN,5,3,5-3,SDN,9,1,35,42,77,177,135,312,14,15,29,4,3:37
8637,491337,2017-07-02,2017,SLN,WAS,2,7,7-2,WAS,9,0,36,43,79,164,150,314,8,21,29,0,2:57
8638,491330,2017-07-02,2017,KCA,MIN,6,2,6-2,KCA,9,1,39,37,76,169,140,309,16,11,27,2,3:08
8639,491331,2017-07-02,2017,HOU,NYA,8,1,8-1,HOU,9,1,42,37,79,188,140,328,17,11,28,2,3:29
8640,491327,2017-07-02,2017,ARI,COL,4,3,4-3,ARI,9,0,35,39,74,138,144,282,11,13,24,3,3:04
8641,491324,2017-07-02,2017,TOR,BOS,1,15,15-1,BOS,9,0,34,50,84,198,157,355,8,25,33,2,3:34
8642,491329,2017-07-02,2017,MIL,MIA,3,10,10-3,MIA,9,0,37,52,89,214,150,364,10,28,38,2,3:43
8643,491326,2017-07-02,2017,DET,CLE,8,11,11-8,CLE,9,0,44,49,93,220,164,384,16,23,39,3,3:55
8644,491323,2017-07-02,2017,OAK,ATL,3,4,4-3,ATL,12,0,51,45,96,186,202,388,17,13,30,5,4:11
8645,491338,2017-07-03,2017,MIL,BAL,8,1,8-1,MIL,9,1,37,34,71,144,137,281,14,8,22,1,2:35
8646,491344,2017-07-03,2017,SLN,MIA,14,6,14-6,SLN,9,1,44,43,87,174,167,341,22,16,38,1,3:17
8647,491342,2017-07-03,2017,SEA,KCA,1,3,3-1,KCA,9,0,33,34,67,119,126,245,6,7,13,2,2:28
8648,491341,2017-07-03,2017,COL,CIN,5,3,5-3,COL,9,1,36,33,69,113,148,261,13,8,21,1,2:48
8649,491343,2017-07-03,2017,MIN,ANA,9,5,9-5,MIN,9,1,42,38,80,136,140,276,19,13,32,0,3:00
8650,491346,2017-07-03,2017,PHI,PIT,4,0,4-0,PHI,9,1,31,33,64,123,116,239,8,5,13,0,2:36
8651,491340,2017-07-03,2017,OAK,CHA,2,7,7-2,CHA,9,0,37,47,84,190,148,338,9,20,29,2,3:33
8652,491339,2017-07-03,2017,TEX,BOS,5,7,7-5,BOS,11,0,43,50,93,193,180,373,11,18,29,3,4:07
8653,491347,2017-07-03,2017,NYA,TOR,6,3,6-3,NYA,9,1,35,36,71,157,139,296,13,11,24,1,3:11
8654,491345,2017-07-03,2017,WAS,NYN,3,2,3-2,WAS,9,0,37,35,72,139,160,299,12,10,22,5,3:18
8655,491354,2017-07-04,2017,SEA,KCA,3,7,7-3,KCA,9,0,38,39,77,133,145,278,13,11,24,1,2:55
8656,491358,2017-07-04,2017,PHI,PIT,0,3,3-0,PIT,9,0,38,35,73,133,154,287,11,9,20,2,3:01 (:22 delay)
8657,491351,2017-07-04,2017,OAK,CHA,7,6,7-6,OAK,9,0,35,39,74,144,153,297,11,13,24,5,3:09
8658,491352,2017-07-04,2017,COL,CIN,1,8,8-1,CIN,9,0,35,41,76,150,142,292,10,14,24,1,2:58
8659,491350,2017-07-04,2017,TEX,BOS,4,11,11-4,BOS,9,0,41,49,90,183,176,359,14,22,36,2,3:56
8660,491360,2017-07-04,2017,DET,SFN,5,3,5-3,DET,9,1,33,33,66,117,108,225,10,6,16,1,2:23
8661,491349,2017-07-04,2017,MIL,BAL,6,2,6-2,MIL,9,1,33,33,66,116,121,237,11,8,19,0,2:25
8662,491355,2017-07-04,2017,MIN,ANA,5,4,5-4,MIN,9,1,38,36,74,145,147,292,15,12,27,2,3:20
8663,491359,2017-07-04,2017,CLE,SDN,0,1,1-0,SDN,9,0,34,32,66,121,153,274,8,6,14,1,2:59
8664,491362,2017-07-04,2017,NYA,TOR,1,4,4-1,TOR,9,0,34,38,72,152,163,315,7,12,19,3,3:08
8665,491357,2017-07-04,2017,WAS,NYN,11,4,11-4,WAS,9,1,42,40,82,145,144,289,19,14,33,2,3:17
8666,491353,2017-07-04,2017,ATL,HOU,4,16,16-4,HOU,9,0,38,49,87,185,147,332,12,26,38,2,3:39 (:18 delay)
8667,491356,2017-07-04,2017,SLN,MIA,2,5,5-2,MIA,9,0,37,37,74,157,154,311,10,11,21,1,3:04
8668,491348,2017-07-04,2017,LAN,ARI,4,3,4-3,LAN,9,1,36,36,72,162,168,330,12,9,21,3,3:26
8669,491361,2017-07-04,2017,CHN,TBA,5,6,6-5,TBA,9,0,42,37,79,143,189,332,17,12,29,1,3:25
8670,491376,2017-07-05,2017,CHN,TBA,7,3,7-3,CHN,9,1,39,34,73,125,159,284,18,10,28,2,3:10
8671,491366,2017-07-05,2017,OAK,CHA,7,4,7-4,OAK,9,1,36,33,69,155,188,343,14,7,21,3,3:24
8672,491374,2017-07-05,2017,CLE,SDN,2,6,6-2,SDN,9,0,38,42,80,166,147,313,14,16,30,3,3:21
8673,491373,2017-07-05,2017,PHI,PIT,2,5,5-2,PIT,9,0,37,40,77,163,153,316,11,12,23,1,3:16
8674,491377,2017-07-05,2017,NYA,TOR,6,7,7-6,TOR,9,0,38,43,81,168,177,345,13,17,30,4,3:28
8675,491363,2017-07-05,2017,LAN,ARI,1,0,1-0,LAN,9,1,31,34,65,120,135,255,9,7,16,1,2:56
8676,491364,2017-07-05,2017,MIL,BAL,4,0,4-0,MIL,9,1,33,37,70,148,120,268,8,10,18,3,3:04
8677,491365,2017-07-05,2017,TEX,BOS,8,2,8-2,TEX,9,1,38,33,71,127,157,284,14,6,20,1,2:52 (1:26 delay)
8678,491375,2017-07-05,2017,DET,SFN,4,5,5-4,SFN,9,0,37,40,77,150,137,287,11,18,29,3,3:18
8679,491371,2017-07-05,2017,SLN,MIA,6,9,9-6,MIA,9,0,40,43,83,158,154,312,13,19,32,3,3:19
8680,491367,2017-07-05,2017,COL,CIN,5,3,5-3,COL,9,1,34,40,74,161,141,302,10,14,24,4,3:24
8681,491370,2017-07-05,2017,MIN,ANA,1,2,2-1,ANA,9,0,37,34,71,117,151,268,10,9,19,0,2:54
8682,491368,2017-07-05,2017,ATL,HOU,4,10,10-4,HOU,9,0,36,44,80,161,148,309,9,20,29,3,3:21 (:26 delay)
8683,491369,2017-07-05,2017,SEA,KCA,6,9,9-6,KCA,10,0,39,46,85,202,143,345,11,15,26,3,3:34
8684,490741,2017-07-06,2017,CHN,MIL,2,11,11-2,MIL,9,0,33,48,81,198,144,342,8,22,30,2,3:11
8685,491386,2017-07-06,2017,PHI,PIT,3,6,6-3,PIT,9,0,30,40,70,145,123,268,9,13,22,2,2:58 (:47 delay)
8686,491382,2017-07-06,2017,COL,CIN,3,6,6-3,CIN,9,0,34,42,76,152,136,288,9,18,27,1,3:04
8687,491379,2017-07-06,2017,WAS,ATL,2,5,5-2,ATL,9,0,38,42,80,155,159,314,13,16,29,2,3:10 (3:05 delay)
8688,491381,2017-07-06,2017,TBA,BOS,4,1,4-1,TBA,9,1,33,36,69,143,130,273,10,11,21,0,2:43
8689,491378,2017-07-06,2017,LAN,ARI,5,4,5-4,LAN,9,0,40,36,76,134,150,284,20,10,30,3,3:07
8690,491380,2017-07-06,2017,MIN,BAL,6,4,6-4,MIN,9,1,36,41,77,165,132,297,11,13,24,1,3:03
8691,491387,2017-07-06,2017,CLE,SDN,11,2,11-2,CLE,9,1,43,32,75,118,179,297,18,5,23,4,3:08
8692,491384,2017-07-06,2017,SLN,MIA,4,3,4-3,SLN,9,1,38,42,80,155,144,299,15,17,32,2,3:11
8693,491388,2017-07-06,2017,DET,SFN,6,2,6-2,DET,9,1,35,33,68,123,133,256,13,6,19,1,2:38
8694,491385,2017-07-06,2017,SEA,OAK,4,7,7-4,OAK,9,0,36,40,76,161,125,286,13,15,28,3,2:56
8695,490741,2017-07-06,2017,CHN,MIL,2,11,11-2,MIL,9,0,33,48,81,198,144,342,8,22,30,2,3:11
8696,491383,2017-07-06,2017,TOR,HOU,7,4,7-4,TOR,9,1,40,39,79,148,173,321,16,14,30,4,3:18
8697,491403,2017-07-07,2017,PHI,SDN,3,4,4-3,SDN,9,0,38,36,74,130,136,266,11,9,20,1,2:41 (1:34 delay)
8698,491401,2017-07-07,2017,SEA,OAK,7,2,7-2,SEA,9,1,35,32,67,129,135,264,13,7,20,2,2:39
8699,491397,2017-07-07,2017,TEX,ANA,10,0,10-0,TEX,9,1,39,28,67,109,164,273,16,4,20,2,2:49
8700,491393,2017-07-07,2017,ARI,CIN,6,3,6-3,ARI,9,1,35,35,70,147,138,285,12,9,21,2,2:57
8701,491396,2017-07-07,2017,LAN,KCA,4,1,4-1,LAN,9,1,37,33,70,133,135,268,14,7,21,1,2:59
8702,491400,2017-07-07,2017,SLN,NYN,5,6,6-5,NYN,9,0,35,41,76,142,129,271,10,14,24,2,2:47
8703,491398,2017-07-07,2017,SFN,MIA,1,6,6-1,MIA,9,0,32,41,73,139,129,268,6,18,24,2,2:40
8704,491394,2017-07-07,2017,CLE,DET,11,2,11-2,CLE,9,1,45,34,79,113,184,297,24,11,35,2,3:21
8705,491392,2017-07-07,2017,COL,CHA,12,4,12-4,COL,9,1,41,37,78,137,176,313,18,13,31,3,3:08
8706,491391,2017-07-07,2017,TBA,BOS,3,8,8-3,BOS,9,0,40,42,82,175,154,329,16,15,31,2,3:24
8707,491402,2017-07-07,2017,CHN,PIT,6,1,6-1,CHN,9,1,39,40,79,179,168,347,15,13,28,3,3:46
8708,491390,2017-07-07,2017,MIN,BAL,9,6,9-6,MIN,9,1,38,38,76,140,158,298,15,13,28,4,3:13
8709,491389,2017-07-07,2017,WAS,ATL,5,4,5-4,WAS,10,0,41,40,81,148,164,312,14,14,28,3,3:28
8710,491399,2017-07-07,2017,NYA,MIL,4,9,9-4,MIL,9,0,39,45,84,183,177,360,11,20,31,5,3:57 (:51 delay)
8711,491395,2017-07-07,2017,TOR,HOU,2,12,12-2,HOU,9,0,32,45,77,171,151,322,8,19,27,1,3:00
8712,491406,2017-07-08,2017,TBA,BOS,1,0,1-0,TBA,9,1,32,34,66,141,111,252,8,7,15,1,2:41
8713,491415,2017-07-08,2017,SLN,NYN,4,1,4-1,SLN,9,1,38,34,72,124,159,283,16,7,23,4,3:07
8714,491417,2017-07-08,2017,CHN,PIT,2,4,4-2,PIT,9,0,33,38,71,143,126,269,6,12,18,4,2:59
8715,491409,2017-07-08,2017,CLE,DET,4,0,4-0,CLE,9,1,38,32,70,136,154,290,16,6,22,2,3:15
8716,491405,2017-07-08,2017,MIN,BAL,1,5,5-1,BAL,9,0,39,38,77,134,166,300,13,12,25,2,3:04
8717,491412,2017-07-08,2017,TEX,ANA,5,2,5-2,TEX,9,1,37,38,75,149,153,302,15,12,27,1,3:13
8718,491404,2017-07-08,2017,WAS,ATL,0,13,13-0,ATL,9,0,36,48,84,184,126,310,8,21,29,1,3:12
8719,491411,2017-07-08,2017,LAN,KCA,5,4,5-4,LAN,10,0,40,43,83,161,164,325,13,14,27,4,3:43
8720,491418,2017-07-08,2017,PHI,SDN,1,2,2-1,SDN,9,0,32,34,66,122,117,239,7,7,14,1,2:30
8721,491413,2017-07-08,2017,SFN,MIA,4,5,5-4,MIA,9,0,39,38,77,129,148,277,12,11,23,3,3:01
8722,491407,2017-07-08,2017,COL,CHA,4,5,5-4,CHA,9,0,38,37,75,125,151,276,12,13,25,2,3:09
8723,491410,2017-07-08,2017,TOR,HOU,7,2,7-2,TOR,9,1,38,33,71,129,143,272,15,10,25,0,2:44
8724,491414,2017-07-08,2017,NYA,MIL,5,3,5-3,NYA,9,0,34,35,69,131,128,259,9,9,18,1,2:36
8725,491416,2017-07-08,2017,SEA,OAK,3,4,4-3,OAK,9,0,35,41,76,148,138,286,9,15,24,0,2:54
8726,491408,2017-07-08,2017,ARI,CIN,0,7,7-0,CIN,9,0,34,40,74,166,146,312,6,13,19,1,3:00
8727,491426,2017-07-09,2017,LAN,KCA,5,2,5-2,LAN,9,1,30,33,63,99,112,211,6,6,12,0,2:16
8728,491430,2017-07-09,2017,SLN,NYN,6,0,6-0,SLN,9,1,36,29,65,117,140,257,12,4,16,1,2:28
8729,491431,2017-07-09,2017,SEA,OAK,4,0,4-0,SEA,9,1,31,33,64,137,116,253,10,7,17,3,2:39
8730,491427,2017-07-09,2017,TEX,ANA,0,3,3-0,ANA,9,0,33,35,68,125,142,267,8,11,19,2,3:08
8731,491423,2017-07-09,2017,ARI,CIN,1,2,2-1,CIN,9,0,36,37,73,143,136,279,12,11,23,1,2:53
8732,491421,2017-07-09,2017,TBA,BOS,5,3,5-3,TBA,9,1,35,39,74,144,142,286,11,13,24,2,3:07
8733,491433,2017-07-09,2017,PHI,SDN,7,1,7-1,PHI,9,1,33,39,72,135,132,267,10,12,22,0,2:45
8734,491422,2017-07-09,2017,COL,CHA,10,0,10-0,COL,9,1,41,31,72,132,163,295,18,5,23,4,3:13
8735,491432,2017-07-09,2017,CHN,PIT,3,14,14-3,PIT,9,0,40,48,88,173,140,313,16,21,37,2,3:14
8736,491419,2017-07-09,2017,WAS,ATL,10,5,10-5,WAS,9,1,42,36,78,135,182,317,19,10,29,4,3:32
8737,491429,2017-07-09,2017,NYA,MIL,3,5,5-3,MIL,9,0,40,40,80,172,174,346,13,14,27,7,3:59
8738,491420,2017-07-09,2017,MIN,BAL,5,11,11-5,BAL,9,0,38,44,82,165,154,319,10,17,27,2,3:11
8739,491424,2017-07-09,2017,CLE,DET,3,5,5-3,DET,9,0,38,43,81,182,146,328,13,17,30,4,3:49
8740,491425,2017-07-09,2017,TOR,HOU,1,19,19-1,HOU,9,0,38,54,92,209,144,353,12,26,38,2,3:24
8741,491428,2017-07-09,2017,SFN,MIA,8,10,10-8,MIA,11,0,48,57,105,202,187,389,16,26,42,5,4:10
8742,491434,2017-07-11,2017,NAS,AAS,1,2,2-1,AAS,10,0,39,40,79,153,159,312,12,11,23,0,3:16
8743,491449,2017-07-14,2017,CIN,WAS,0,5,5-0,WAS,9,0,35,39,74,160,132,292,9,13,22,3,2:55
8744,491438,2017-07-14,2017,NYN,COL,14,2,14-2,NYN,9,1,49,34,83,129,197,326,26,8,34,1,3:21
8745,491436,2017-07-14,2017,BAL,CHN,8,9,9-8,CHN,9,0,45,38,83,154,189,343,18,12,30,3,3:42 (:49 delay)
8746,491448,2017-07-14,2017,DET,TOR,2,7,7-2,TOR,9,0,38,45,83,219,162,381,12,18,30,2,3:48
8747,491446,2017-07-14,2017,ANA,TBA,1,2,2-1,TBA,10,0,39,35,74,133,142,275,9,6,15,2,3:04
8748,491447,2017-07-14,2017,KCA,TEX,3,5,5-3,TEX,9,0,33,38,71,157,107,264,9,10,19,1,2:58
8749,491437,2017-07-14,2017,OAK,CLE,5,0,5-0,OAK,9,1,33,33,66,152,125,277,9,5,14,2,2:48
8750,491445,2017-07-14,2017,PIT,SLN,5,2,5-2,PIT,9,0,40,33,73,135,140,275,19,6,25,0,3:06
8751,491442,2017-07-14,2017,MIL,PHI,9,6,9-6,MIL,9,1,38,42,80,166,142,308,12,15,27,3,3:10
8752,491443,2017-07-14,2017,SDN,SFN,4,5,5-4,SFN,9,0,42,41,83,145,160,305,16,17,33,3,3:27
8753,491444,2017-07-14,2017,CHA,SEA,2,4,4-2,SEA,9,0,32,39,71,146,139,285,5,14,19,1,2:50
8754,491435,2017-07-14,2017,ATL,ARI,4,3,4-3,ATL,9,1,34,39,73,151,142,293,9,14,23,1,3:02
8755,491441,2017-07-14,2017,BOS,NYA,5,4,5-4,BOS,9,0,41,34,75,136,181,317,17,8,25,0,3:27
8756,491439,2017-07-14,2017,MIA,LAN,4,6,6-4,LAN,9,0,37,36,73,145,139,284,11,12,23,1,3:00
8757,491440,2017-07-14,2017,HOU,MIN,10,5,10-5,HOU,9,1,44,43,87,183,179,362,21,15,36,3,3:42
8758,491462,2017-07-15,2017,KCA,TEX,0,1,1-0,TEX,9,0,32,30,62,100,116,216,6,5,11,3,2:32
8759,491457,2017-07-15,2017,MIL,PHI,3,2,3-2,MIL,9,1,34,33,67,130,126,256,10,8,18,1,2:44 (:20 delay)
8760,491461,2017-07-15,2017,ANA,TBA,3,6,6-3,TBA,9,0,36,42,78,141,126,267,11,17,28,1,3:00
8761,491452,2017-07-15,2017,OAK,CLE,5,3,5-3,OAK,9,0,31,35,66,138,130,268,7,9,16,2,2:35
8762,491463,2017-07-15,2017,DET,TOR,11,1,11-1,DET,9,1,43,29,72,115,175,290,21,3,24,2,2:47
8763,491458,2017-07-15,2017,SDN,SFN,5,3,5-3,SDN,9,0,34,37,71,141,130,271,10,11,21,1,2:53
8764,491453,2017-07-15,2017,NYN,COL,9,3,9-3,NYN,9,1,37,36,73,136,147,283,12,10,22,3,3:00
8765,491455,2017-07-15,2017,HOU,MIN,2,4,4-2,MIN,9,0,40,41,81,145,157,302,14,16,30,3,3:21
8766,491460,2017-07-15,2017,PIT,SLN,0,4,4-0,SLN,9,0,36,35,71,140,147,287,10,10,20,1,3:00
8767,491459,2017-07-15,2017,CHA,SEA,3,4,4-3,SEA,9,0,39,34,73,146,157,303,12,8,20,2,3:26
8768,491451,2017-07-15,2017,BAL,CHN,3,10,10-3,CHN,9,0,37,45,82,160,134,294,11,21,32,3,3:02
8769,491450,2017-07-15,2017,ATL,ARI,8,5,8-5,ATL,9,1,39,43,82,176,151,327,17,16,33,5,3:28
8770,491454,2017-07-15,2017,MIA,LAN,1,7,7-1,LAN,9,0,35,43,78,190,145,335,10,18,28,1,3:19
8771,491464,2017-07-15,2017,CIN,WAS,7,10,10-7,WAS,9,0,44,44,88,165,181,346,16,18,34,3,3:32
8772,491456,2017-07-15,2017,BOS,NYA,1,4,4-1,NYA,16,0,58,66,124,267,245,512,12,19,31,4,5:50
8773,490398,2017-07-16,2017,BOS,NYA,0,3,3-0,NYA,9,0,37,40,77,150,154,304,11,13,24,1,3:13
8774,491476,2017-07-16,2017,ANA,TBA,4,3,4-3,ANA,9,1,36,34,70,131,126,257,13,11,24,2,3:03
8775,491473,2017-07-16,2017,SDN,SFN,7,1,7-1,SDN,9,1,34,36,70,121,116,237,12,10,22,1,2:39
8776,491467,2017-07-16,2017,OAK,CLE,7,3,7-3,OAK,9,1,38,37,75,142,158,300,16,11,27,4,3:08
8777,491470,2017-07-16,2017,HOU,MIN,5,3,5-3,HOU,9,1,34,32,66,121,136,257,11,6,17,2,2:47
8778,491465,2017-07-16,2017,ATL,ARI,7,1,7-1,ATL,9,1,35,33,68,126,128,254,10,7,17,0,2:47
8779,491466,2017-07-16,2017,BAL,CHN,0,8,8-0,CHN,9,0,30,43,73,160,127,287,4,18,22,2,2:56
8780,491475,2017-07-16,2017,PIT,SLN,4,3,4-3,PIT,9,0,37,40,77,136,130,266,12,15,27,1,3:02
8781,491477,2017-07-16,2017,KCA,TEX,4,3,4-3,KCA,9,0,39,34,73,138,141,279,13,9,22,2,3:11
8782,491469,2017-07-16,2017,MIA,LAN,2,3,3-2,LAN,9,0,35,39,74,162,153,315,9,13,22,2,3:18
8783,491472,2017-07-16,2017,MIL,PHI,2,5,5-2,PHI,9,0,36,40,76,146,148,294,9,14,23,1,3:18
8784,490398,2017-07-16,2017,BOS,NYA,0,3,3-0,NYA,9,0,37,40,77,150,154,304,11,13,24,1,3:13
8785,491474,2017-07-16,2017,CHA,SEA,6,7,7-6,SEA,10,0,41,44,85,141,167,308,12,15,27,5,3:22
8786,491468,2017-07-16,2017,NYN,COL,4,13,13-4,COL,9,0,36,50,86,185,135,320,10,24,34,1,3:26
8787,491479,2017-07-16,2017,CIN,WAS,4,14,14-4,WAS,9,0,41,48,89,181,167,348,12,21,33,1,3:31
8788,491478,2017-07-16,2017,DET,TOR,6,5,6-5,DET,11,0,49,45,94,167,205,372,17,13,30,4,4:16
8789,491471,2017-07-16,2017,BOS,NYA,3,0,3-0,BOS,9,1,31,36,67,127,117,244,8,9,17,1,2:59
8790,491481,2017-07-17,2017,SFN,CLE,3,5,5-3,CLE,9,0,31,39,70,137,95,232,6,10,16,2,2:33
8791,491490,2017-07-17,2017,BAL,TEX,3,1,3-1,BAL,9,1,31,34,65,146,118,264,10,9,19,1,2:55
8792,491492,2017-07-17,2017,CIN,WAS,1,6,6-1,WAS,9,0,32,41,73,162,130,292,7,15,22,0,2:58
8793,491484,2017-07-17,2017,MIN,NYA,4,2,4-2,MIN,9,1,37,36,73,120,150,270,14,13,27,2,3:02
8794,491491,2017-07-17,2017,BOS,TOR,3,4,4-3,TOR,9,0,35,39,74,168,130,298,9,13,22,2,3:18
8795,491480,2017-07-17,2017,ATL,CHN,3,4,4-3,CHN,9,0,35,40,75,151,143,294,10,13,23,1,3:17 (1:03 delay)
8796,491483,2017-07-17,2017,PIT,MIL,4,2,4-2,PIT,9,1,38,40,78,166,127,293,18,14,32,3,3:15
8797,491488,2017-07-17,2017,NYN,SLN,3,6,6-3,SLN,9,0,39,42,81,163,148,311,12,15,27,4,3:20
8798,491486,2017-07-17,2017,COL,SDN,9,6,9-6,COL,9,1,39,42,81,149,141,290,18,16,34,6,3:23
8799,491487,2017-07-17,2017,HOU,SEA,7,9,9-7,SEA,10,0,47,45,92,180,168,348,19,15,34,4,3:49
8800,491485,2017-07-17,2017,MIA,PHI,6,5,6-5,MIA,10,0,46,42,88,179,152,331,21,14,35,4,3:41
8801,491482,2017-07-17,2017,KCA,DET,2,10,10-2,DET,9,0,40,46,86,175,159,334,13,22,35,4,3:29
8802,491489,2017-07-17,2017,OAK,TBA,2,3,3-2,TBA,9,0,33,37,70,135,134,269,5,10,15,0,2:48
8803,491507,2017-07-18,2017,ANA,WAS,3,4,4-3,WAS,9,0,31,38,69,134,127,261,5,13,18,1,2:57
8804,491496,2017-07-18,2017,KCA,DET,3,9,9-3,DET,9,0,39,43,82,142,123,265,13,16,29,1,2:54
8805,491502,2017-07-18,2017,HOU,SEA,6,2,6-2,HOU,9,1,33,34,67,138,126,264,13,7,20,2,3:02
8806,491500,2017-07-18,2017,MIA,PHI,2,5,5-2,PHI,9,0,31,40,71,137,126,263,6,16,22,0,2:41
8807,491503,2017-07-18,2017,NYN,SLN,0,5,5-0,SLN,9,0,31,42,73,156,119,275,4,15,19,2,2:52
8808,491504,2017-07-18,2017,OAK,TBA,3,4,4-3,TBA,9,0,34,36,70,132,145,277,8,9,17,2,2:50
8809,491501,2017-07-18,2017,COL,SDN,9,7,9-7,COL,9,1,40,40,80,157,143,300,17,14,31,2,3:14
8810,491495,2017-07-18,2017,SFN,CLE,2,1,2-1,SFN,10,0,38,37,75,139,158,297,12,9,21,1,3:04
8811,491497,2017-07-18,2017,CHA,LAN,0,1,1-0,LAN,9,0,35,39,74,147,129,276,9,18,27,3,3:21
8812,491499,2017-07-18,2017,MIN,NYA,3,6,6-3,NYA,9,0,42,40,82,145,161,306,15,15,30,4,3:28
8813,491498,2017-07-18,2017,PIT,MIL,4,3,4-3,PIT,9,1,31,38,69,129,127,256,8,15,23,1,2:58
8814,491494,2017-07-18,2017,ATL,CHN,1,5,5-1,CHN,9,0,37,41,78,153,156,309,10,14,24,1,3:01 (2:30 delay)
8815,491505,2017-07-18,2017,BAL,TEX,12,1,12-1,BAL,9,1,46,34,80,134,191,325,22,8,30,2,3:23
8816,491493,2017-07-18,2017,CIN,ARI,2,11,11-2,ARI,9,0,35,45,80,184,128,312,10,22,32,1,3:05
8817,491506,2017-07-18,2017,BOS,TOR,5,4,5-4,BOS,15,0,58,60,118,218,239,457,16,21,37,4,4:59 (1:00 delay)
8818,491521,2017-07-19,2017,BOS,TOR,5,1,5-1,BOS,9,1,34,35,69,150,122,272,12,10,22,1,2:47
8819,491522,2017-07-19,2017,ANA,WAS,7,0,7-0,ANA,9,1,37,29,66,121,152,273,13,2,15,2,2:47
8820,491514,2017-07-19,2017,MIN,NYA,6,1,6-1,MIN,9,1,33,37,70,151,136,287,9,12,21,1,2:58
8821,491517,2017-07-19,2017,HOU,SEA,1,4,4-1,SEA,9,0,36,34,70,142,144,286,10,7,17,2,2:51
8822,491510,2017-07-19,2017,SFN,CLE,5,4,5-4,SFN,9,1,35,40,75,135,157,292,12,15,27,3,3:16
8823,491511,2017-07-19,2017,KCA,DET,4,3,4-3,KCA,9,0,36,37,73,145,130,275,12,10,22,3,3:16
8824,491509,2017-07-19,2017,ATL,CHN,2,8,8-2,CHN,9,0,34,41,75,146,123,269,8,16,24,3,3:05
8825,491513,2017-07-19,2017,PIT,MIL,3,2,3-2,PIT,10,0,41,38,79,141,152,293,16,9,25,0,3:23
8826,491518,2017-07-19,2017,NYN,SLN,7,3,7-3,NYN,9,1,39,41,80,161,126,287,15,14,29,3,2:59
8827,491516,2017-07-19,2017,COL,SDN,18,4,18-4,COL,9,1,49,37,86,156,182,338,25,14,39,1,3:30
8828,491508,2017-07-19,2017,CIN,ARI,4,3,4-3,CIN,11,0,49,44,93,161,198,359,21,11,32,3,3:59
8829,491512,2017-07-19,2017,CHA,LAN,1,9,9-1,LAN,8,1,27,39,66,167,106,273,7,18,25,3,2:58 (:37 delay)
8830,491519,2017-07-19,2017,OAK,TBA,7,2,7-2,OAK,9,1,38,37,75,138,142,280,17,11,28,4,3:08
8831,491520,2017-07-19,2017,BAL,TEX,10,2,10-2,BAL,9,1,37,37,74,144,121,265,13,11,24,2,2:50
8832,491515,2017-07-19,2017,MIA,PHI,3,10,10-3,PHI,9,0,35,52,87,174,144,318,9,28,37,2,3:04
8833,491530,2017-07-20,2017,BAL,TEX,9,7,9-7,BAL,9,1,40,39,79,147,151,298,18,14,32,1,3:11
8834,491531,2017-07-20,2017,BOS,TOR,6,8,8-6,TOR,9,0,40,44,84,173,163,336,15,16,31,5,3:25
8835,491524,2017-07-20,2017,LAN,ATL,3,6,6-3,ATL,9,0,37,38,75,136,134,270,10,13,23,1,2:49
8836,491523,2017-07-20,2017,CIN,ARI,2,12,12-2,ARI,9,0,34,40,74,175,126,301,9,13,22,1,2:47
8837,491529,2017-07-20,2017,NYN,SLN,3,2,3-2,NYN,9,0,34,34,68,133,144,277,8,8,16,1,2:47
8838,491528,2017-07-20,2017,SFN,SDN,2,5,5-2,SDN,9,0,36,36,72,144,142,286,10,11,21,2,2:59
8839,491525,2017-07-20,2017,KCA,DET,16,4,16-4,KCA,9,1,48,39,87,144,187,331,23,13,36,3,3:34
8840,491526,2017-07-20,2017,PIT,MIL,4,2,4-2,PIT,9,1,32,38,70,173,127,300,9,13,22,1,3:03
8841,491527,2017-07-20,2017,SEA,NYA,1,4,4-1,NYA,9,0,40,37,77,157,144,301,13,10,23,1,3:14
8842,491533,2017-07-21,2017,ANA,BOS,2,6,6-2,BOS,9,0,37,36,73,149,163,312,11,10,21,1,3:05
8843,491539,2017-07-21,2017,SEA,NYA,1,5,5-1,NYA,9,0,37,38,75,123,151,274,11,13,24,1,2:50
8844,491532,2017-07-21,2017,LAN,ATL,3,12,12-3,ATL,9,0,35,46,81,163,124,287,9,19,28,1,3:07
8845,491546,2017-07-21,2017,ARI,WAS,6,5,6-5,ARI,9,0,42,39,81,148,167,315,20,12,32,3,3:23
8846,491541,2017-07-21,2017,COL,PIT,5,13,13-5,PIT,9,0,35,52,87,185,137,322,11,28,39,2,3:36
8847,491538,2017-07-21,2017,PHI,MIL,6,1,6-1,PHI,9,1,38,33,71,117,163,280,14,8,22,1,3:02
8848,491536,2017-07-21,2017,BAL,HOU,7,8,8-7,HOU,9,0,41,42,83,132,154,286,14,17,31,3,3:02
8849,491537,2017-07-21,2017,CIN,MIA,1,3,3-1,MIA,9,0,36,37,73,124,141,265,9,12,21,1,2:57 (1:47 delay)
8850,491540,2017-07-21,2017,NYN,OAK,7,5,7-5,NYN,9,1,34,43,77,167,120,287,12,17,29,4,3:14
8851,491543,2017-07-21,2017,CHN,SLN,4,11,11-4,SLN,9,0,40,45,85,196,131,327,13,19,32,3,3:17
8852,491535,2017-07-21,2017,MIN,DET,3,6,6-3,DET,9,0,37,40,77,166,143,309,11,15,26,3,3:34
8853,491544,2017-07-21,2017,TBA,TEX,3,4,4-3,TEX,10,0,37,39,76,143,120,263,7,11,18,1,3:10
8854,491545,2017-07-21,2017,CLE,TOR,13,3,13-3,CLE,9,1,44,39,83,168,164,332,21,14,35,4,3:23
8855,491534,2017-07-21,2017,KCA,CHA,7,6,7-6,KCA,10,0,46,41,87,169,194,363,20,14,34,4,4:10
8856,491542,2017-07-21,2017,SFN,SDN,9,12,12-9,SDN,11,0,49,57,106,233,191,424,16,26,42,5,4:46
8857,491558,2017-07-22,2017,CHN,SLN,3,2,3-2,CHN,9,1,31,32,63,122,118,240,8,6,14,2,2:34
8858,491551,2017-07-22,2017,BAL,HOU,4,8,8-4,HOU,9,0,35,43,78,175,134,309,8,16,24,2,3:28 (:58 delay)
8859,491552,2017-07-22,2017,CIN,MIA,4,5,5-4,MIA,9,0,39,38,77,142,155,297,18,13,31,3,3:12 (1:00 delay)
8860,491557,2017-07-22,2017,SFN,SDN,5,4,5-4,SFN,12,0,52,46,98,184,178,362,16,11,27,1,3:57
8861,491548,2017-07-22,2017,ANA,BOS,7,3,7-3,ANA,9,1,38,35,73,130,158,288,14,9,23,0,3:07
8862,491561,2017-07-22,2017,ARI,WAS,3,4,4-3,WAS,9,0,34,39,73,147,136,283,6,13,19,3,2:56
8863,491559,2017-07-22,2017,TBA,TEX,3,4,4-3,TEX,9,0,37,34,71,132,140,272,11,6,17,1,2:56
8864,491550,2017-07-22,2017,MIN,DET,6,5,6-5,MIN,9,1,41,38,79,143,148,291,19,12,31,4,3:20
8865,491549,2017-07-22,2017,KCA,CHA,7,2,7-2,KCA,9,1,36,37,73,162,155,317,15,11,26,3,3:20
8866,491560,2017-07-22,2017,CLE,TOR,2,1,2-1,CLE,10,0,38,34,72,136,150,286,13,5,18,2,3:01
8867,491554,2017-07-22,2017,SEA,NYA,6,5,6-5,SEA,10,0,40,40,80,168,146,314,14,13,27,3,3:28
8868,491556,2017-07-22,2017,COL,PIT,7,3,7-3,COL,9,1,39,38,77,151,145,296,17,13,30,1,3:07
8869,491555,2017-07-22,2017,NYN,OAK,6,5,6-5,NYN,9,0,40,41,81,158,138,296,16,16,32,2,3:07
8870,491553,2017-07-22,2017,PHI,MIL,8,9,9-8,MIL,9,0,41,43,84,165,153,318,14,18,32,1,3:24 (:26 delay)
8871,491547,2017-07-22,2017,LAN,ATL,6,2,6-2,LAN,9,1,37,36,73,130,125,255,13,9,22,3,2:51
8872,491563,2017-07-23,2017,ANA,BOS,3,2,3-2,ANA,9,1,31,33,64,106,96,202,7,7,14,0,2:13
8873,491572,2017-07-23,2017,SFN,SDN,2,5,5-2,SDN,9,0,36,40,76,150,120,270,9,14,23,1,2:48
8874,491576,2017-07-23,2017,ARI,WAS,2,6,6-2,WAS,9,0,40,39,79,158,181,339,13,12,25,3,3:39
8875,491573,2017-07-23,2017,CHN,SLN,5,3,5-3,CHN,9,1,31,36,67,152,128,280,7,11,18,0,2:50
8876,491570,2017-07-23,2017,NYN,OAK,2,3,3-2,OAK,9,0,36,33,69,129,141,270,8,11,19,0,2:41 (1:01 delay)
8877,491568,2017-07-23,2017,PHI,MIL,6,3,6-3,PHI,9,1,36,34,70,138,144,282,14,8,22,2,3:07
8878,491562,2017-07-23,2017,LAN,ATL,5,4,5-4,LAN,10,0,41,38,79,126,157,283,15,9,24,2,3:05
8879,491569,2017-07-23,2017,SEA,NYA,4,6,6-4,NYA,9,0,34,43,77,156,135,291,8,18,26,2,3:13
8880,491575,2017-07-23,2017,CLE,TOR,8,1,8-1,CLE,9,1,41,33,74,132,162,294,16,8,24,1,2:53
8881,491566,2017-07-23,2017,BAL,HOU,9,7,9-7,BAL,9,1,40,42,82,149,150,299,20,15,35,4,3:24
8882,491571,2017-07-23,2017,COL,PIT,13,3,13-3,COL,9,1,42,42,84,170,139,309,19,15,34,2,3:19
8883,491574,2017-07-23,2017,TBA,TEX,5,6,6-5,TEX,9,0,41,41,82,185,170,355,14,14,28,3,3:54
8884,491565,2017-07-23,2017,MIN,DET,6,9,9-6,DET,9,0,40,47,87,192,185,377,14,21,35,7,4:19
8885,491567,2017-07-23,2017,CIN,MIA,6,3,6-3,CIN,9,1,36,35,71,149,143,292,14,8,22,1,2:58
8886,491564,2017-07-23,2017,KCA,CHA,5,4,5-4,KCA,9,0,34,36,70,118,156,274,12,11,23,4,3:07
8887,490803,2017-07-24,2017,CLE,CIN,6,2,6-2,CLE,9,1,35,32,67,115,137,252,13,7,20,1,2:26
8888,490803,2017-07-24,2017,CLE,CIN,6,2,6-2,CLE,9,1,35,32,67,115,137,252,13,7,20,1,2:26
8889,491584,2017-07-24,2017,TEX,MIA,0,4,4-0,MIA,9,0,35,37,72,123,136,259,10,12,22,0,2:34
8890,491586,2017-07-24,2017,SDN,NYN,3,5,5-3,NYN,9,0,36,40,76,138,121,259,10,17,27,0,2:35
8891,491587,2017-07-24,2017,TOR,OAK,4,2,4-2,TOR,9,1,37,30,67,131,140,271,14,5,19,1,2:37
8892,491582,2017-07-24,2017,PHI,HOU,4,13,13-4,HOU,9,0,40,50,90,195,150,345,14,25,39,2,3:27 (1:52 delay)
8893,491583,2017-07-24,2017,DET,KCA,3,5,5-3,KCA,12,0,48,45,93,178,185,363,12,10,22,2,3:57
8894,491579,2017-07-24,2017,SEA,BOS,4,0,4-0,SEA,9,1,33,31,64,133,128,261,9,4,13,1,2:40
8895,491585,2017-07-24,2017,LAN,MIN,6,4,6-4,LAN,9,1,33,40,73,147,114,261,11,15,26,1,2:57
8896,491578,2017-07-24,2017,TBA,BAL,0,5,5-0,BAL,9,0,35,37,72,145,149,294,11,10,21,1,3:04
8897,491577,2017-07-24,2017,ARI,ATL,10,2,10-2,ARI,9,1,45,31,76,120,174,294,21,5,26,1,3:00
8898,491580,2017-07-24,2017,CHN,CHA,1,3,3-1,CHA,9,0,40,38,78,160,141,301,15,11,26,3,3:17
8899,491588,2017-07-24,2017,SFN,PIT,3,10,10-3,PIT,9,0,40,44,84,170,187,357,15,17,32,1,3:27
8900,491581,2017-07-24,2017,SLN,COL,8,2,8-2,SLN,9,1,39,35,74,132,152,284,18,8,26,2,2:50
8901,491590,2017-07-25,2017,TBA,BAL,5,4,5-4,TBA,9,1,33,40,73,133,130,263,11,14,25,2,2:50
8902,491599,2017-07-25,2017,WAS,MIL,0,8,8-0,MIL,9,0,35,46,81,179,126,305,8,17,25,1,3:05
8903,491598,2017-07-25,2017,TEX,MIA,10,4,10-4,TEX,9,1,42,38,80,143,139,282,21,12,33,1,2:54
8904,491597,2017-07-25,2017,CLE,ANA,11,7,11-7,CLE,11,0,49,48,97,177,195,372,24,18,42,4,4:14
8905,491602,2017-07-25,2017,TOR,OAK,4,1,4-1,TOR,9,1,35,33,68,120,152,272,11,8,19,1,2:55
8906,491593,2017-07-25,2017,NYA,CIN,4,2,4-2,NYA,9,1,33,32,65,128,132,260,11,6,17,2,2:38
8907,491596,2017-07-25,2017,DET,KCA,1,3,3-1,KCA,9,0,36,34,70,122,139,261,11,8,19,1,2:49
8908,491594,2017-07-25,2017,SLN,COL,3,2,3-2,SLN,9,0,36,34,70,145,142,287,12,10,22,2,3:11
8909,491600,2017-07-25,2017,LAN,MIN,6,2,6-2,LAN,9,1,35,36,71,139,138,277,13,8,21,1,3:35
8910,491595,2017-07-25,2017,PHI,HOU,0,5,5-0,HOU,9,0,36,35,71,128,138,266,7,9,16,1,2:44
8911,491592,2017-07-25,2017,CHN,CHA,7,2,7-2,CHN,9,1,44,39,83,152,191,343,21,14,35,2,3:38
8912,491589,2017-07-25,2017,ARI,ATL,3,8,8-3,ATL,9,0,41,41,82,161,167,328,14,15,29,2,3:10
8913,491601,2017-07-25,2017,SDN,NYN,5,6,6-5,NYN,9,0,37,37,74,162,140,302,10,11,21,2,3:05
8914,491603,2017-07-25,2017,SFN,PIT,11,3,11-3,SFN,9,1,43,41,84,149,169,318,19,15,34,1,3:10
8915,491591,2017-07-25,2017,SEA,BOS,6,5,6-5,SEA,13,0,55,54,109,220,253,473,18,15,33,3,4:59
8916,491608,2017-07-26,2017,NYA,CIN,9,5,9-5,NYA,9,1,40,36,76,144,134,278,15,7,22,3,2:52
8917,491606,2017-07-26,2017,SEA,BOS,0,4,4-0,BOS,9,0,35,37,72,146,153,299,8,11,19,3,2:53
8918,491618,2017-07-26,2017,SFN,PIT,2,1,2-1,SFN,9,1,35,33,68,131,127,258,13,8,21,0,2:38
8919,491605,2017-07-26,2017,TBA,BAL,5,1,5-1,TBA,9,1,33,32,65,127,137,264,11,7,18,0,2:46
8920,491617,2017-07-26,2017,TOR,OAK,3,2,3-2,TOR,9,0,31,35,66,159,126,285,9,8,17,3,2:51
8921,491615,2017-07-26,2017,LAN,MIN,6,5,6-5,LAN,9,0,39,36,75,135,156,291,13,8,21,4,3:28
8922,491616,2017-07-26,2017,SDN,NYN,6,3,6-3,SDN,9,1,35,36,71,143,138,281,12,9,21,2,2:47
8923,491610,2017-07-26,2017,PHI,HOU,9,0,9-0,PHI,9,1,43,36,79,146,167,313,19,10,29,0,3:25
8924,491612,2017-07-26,2017,CLE,ANA,10,4,10-4,CLE,9,1,41,39,80,148,160,308,21,14,35,4,3:31
8925,491614,2017-07-26,2017,WAS,MIL,8,5,8-5,WAS,9,1,36,38,74,142,132,274,13,11,24,3,2:58
8926,491607,2017-07-26,2017,CHA,CHN,3,8,8-3,CHN,9,0,33,46,79,221,144,365,7,19,26,4,3:53
8927,491611,2017-07-26,2017,DET,KCA,2,16,16-2,KCA,9,0,34,55,89,199,138,337,10,29,39,4,3:37
8928,491604,2017-07-26,2017,ARI,ATL,10,3,10-3,ARI,9,1,45,42,87,145,187,332,21,16,37,1,3:17
8929,491613,2017-07-26,2017,TEX,MIA,10,22,22-10,MIA,9,0,47,54,101,190,202,392,20,28,48,5,4:02
8930,491609,2017-07-26,2017,SLN,COL,10,5,10-5,SLN,9,1,46,36,82,122,185,307,24,11,35,0,3:23
8931,491619,2017-07-27,2017,SLN,ARI,0,4,4-0,ARI,9,0,33,35,68,146,139,285,7,10,17,0,2:47 (1:02 delay)
8932,491620,2017-07-27,2017,CHA,CHN,3,6,6-3,CHN,9,0,33,37,70,129,120,249,6,12,18,2,2:37
8933,491624,2017-07-27,2017,SDN,NYN,7,5,7-5,SDN,9,1,35,38,73,136,131,267,14,12,26,2,3:04
8934,491622,2017-07-27,2017,CLE,ANA,2,1,2-1,CLE,9,1,33,33,66,127,123,250,11,8,19,1,2:44
8935,491626,2017-07-27,2017,NYA,TBA,6,5,6-5,NYA,11,0,46,45,91,183,171,354,17,12,29,3,3:56
8936,491621,2017-07-27,2017,MIA,CIN,4,1,4-1,MIA,9,1,39,40,79,145,161,306,17,14,31,2,3:18
8937,491625,2017-07-27,2017,TOR,OAK,8,4,8-4,TOR,10,0,42,45,87,173,169,342,14,17,31,2,3:28
8938,491623,2017-07-27,2017,WAS,MIL,15,2,15-2,WAS,9,1,48,33,81,149,184,333,24,7,31,1,3:14
8939,491641,2017-07-28,2017,NYA,TBA,6,1,6-1,NYA,9,1,32,29,61,115,115,230,10,2,12,0,2:23
8940,491640,2017-07-28,2017,LAN,SFN,6,4,6-4,LAN,9,1,34,34,68,122,129,251,11,8,19,2,2:39
8941,491627,2017-07-28,2017,SLN,ARI,1,0,1-0,SLN,9,1,33,34,67,149,126,275,10,8,18,4,3:10
8942,491636,2017-07-28,2017,TOR,ANA,2,7,7-2,ANA,9,0,34,42,76,149,120,269,7,15,22,3,2:47
8943,491631,2017-07-28,2017,MIA,CIN,7,4,7-4,MIA,9,1,43,36,79,134,154,288,18,11,29,2,2:54
8944,491639,2017-07-28,2017,SDN,PIT,3,2,3-2,SDN,9,1,35,32,67,126,140,266,14,6,20,1,2:44
8945,491630,2017-07-28,2017,MIL,CHN,2,1,2-1,MIL,9,1,32,33,65,121,128,249,8,8,16,1,2:34
8946,491634,2017-07-28,2017,DET,HOU,5,6,6-5,HOU,9,0,40,36,76,113,165,278,14,9,23,2,2:54
8947,491628,2017-07-28,2017,PHI,ATL,10,3,10-3,PHI,9,1,39,40,79,141,139,280,16,15,31,2,3:01
8948,491637,2017-07-28,2017,OAK,MIN,3,6,6-3,MIN,9,0,37,43,80,178,142,320,12,18,30,2,3:19
8949,491638,2017-07-28,2017,SEA,NYN,5,7,7-5,NYN,9,0,40,38,78,149,180,329,14,11,25,4,3:21
8950,491629,2017-07-28,2017,TEX,BAL,8,2,8-2,TEX,9,1,36,35,71,145,147,292,12,9,21,2,3:02
8951,491632,2017-07-28,2017,CHA,CLE,3,9,9-3,CLE,9,0,39,46,85,171,161,332,12,23,35,2,3:21
8952,491635,2017-07-28,2017,BOS,KCA,2,4,4-2,KCA,9,0,35,33,68,134,140,274,9,9,18,2,2:44
8953,491649,2017-07-29,2017,DET,HOU,5,3,5-3,DET,9,1,34,33,67,92,133,225,11,9,20,2,2:41
8954,491648,2017-07-29,2017,WAS,COL,2,4,4-2,COL,9,0,30,36,66,160,118,278,3,11,14,0,2:49
8955,491646,2017-07-29,2017,MIA,CIN,7,3,7-3,MIA,9,1,37,36,73,125,145,270,14,10,24,3,2:32
8956,491651,2017-07-29,2017,TOR,ANA,5,6,6-5,ANA,9,0,37,38,75,142,142,284,11,11,22,0,2:52
8957,491655,2017-07-29,2017,LAN,SFN,2,1,2-1,LAN,9,1,32,33,65,130,115,245,11,9,20,2,2:43
8958,491652,2017-07-29,2017,OAK,MIN,5,4,5-4,OAK,9,0,37,41,78,174,148,322,15,15,30,1,3:22
8959,491656,2017-07-29,2017,NYA,TBA,5,4,5-4,NYA,9,0,37,39,76,157,147,304,13,12,25,3,3:22
8960,491653,2017-07-29,2017,SEA,NYN,3,2,3-2,SEA,9,1,33,38,71,150,154,304,11,13,24,4,3:12
8961,491654,2017-07-29,2017,SDN,PIT,4,2,4-2,SDN,9,1,31,34,65,154,105,259,9,9,18,2,2:50
8962,491642,2017-07-29,2017,SLN,ARI,1,7,7-1,ARI,9,0,33,44,77,181,118,299,6,18,24,2,3:12
8963,491644,2017-07-29,2017,TEX,BAL,0,4,4-0,BAL,9,0,34,41,75,161,121,282,10,14,24,1,3:08
8964,491643,2017-07-29,2017,PHI,ATL,4,3,4-3,PHI,11,0,45,46,91,171,192,363,14,16,30,1,3:50
8965,491647,2017-07-29,2017,CHA,CLE,4,5,5-4,CLE,9,0,41,46,87,181,144,325,15,17,32,3,3:46
8966,491645,2017-07-29,2017,MIL,CHN,1,2,2-1,CHN,11,0,45,46,91,180,190,370,13,15,28,3,4:05
8967,491650,2017-07-29,2017,BOS,KCA,9,8,9-8,BOS,10,0,47,47,94,222,211,433,20,19,39,5,4:45
8968,491633,2017-07-30,2017,WAS,COL,3,1,3-1,WAS,9,1,29,32,61,139,109,248,5,6,11,0,2:31
8969,491633,2017-07-30,2017,WAS,COL,3,1,3-1,WAS,9,1,29,32,61,139,109,248,5,6,11,0,2:31
8970,491669,2017-07-30,2017,SDN,PIT,1,7,7-1,PIT,9,0,35,40,75,166,124,290,9,14,23,0,2:49
8971,491668,2017-07-30,2017,SEA,NYN,9,1,9-1,SEA,9,1,40,37,77,151,159,310,15,11,26,0,2:55
8972,491665,2017-07-30,2017,BOS,KCA,3,5,5-3,KCA,9,0,37,40,77,160,138,298,12,14,26,3,3:13
8973,491661,2017-07-30,2017,MIA,CIN,4,6,6-4,CIN,9,0,33,45,78,173,132,305,7,18,25,1,3:04
8974,491670,2017-07-30,2017,LAN,SFN,3,2,3-2,LAN,11,0,49,40,89,141,172,313,21,14,35,4,3:54
8975,491664,2017-07-30,2017,DET,HOU,13,1,13-1,DET,9,1,46,37,83,150,168,318,23,11,34,2,3:26
8976,491660,2017-07-30,2017,MIL,CHN,2,4,4-2,CHN,9,0,35,37,72,129,120,249,10,11,21,2,2:49
8977,491657,2017-07-30,2017,SLN,ARI,3,2,3-2,SLN,9,1,34,37,71,158,146,304,10,10,20,3,3:06
8978,491662,2017-07-30,2017,CHA,CLE,3,1,3-1,CHA,9,0,31,36,67,153,124,277,6,10,16,2,2:56
8979,491658,2017-07-30,2017,PHI,ATL,2,1,2-1,PHI,9,0,38,37,75,139,152,291,14,13,27,2,3:20
8980,491671,2017-07-30,2017,NYA,TBA,3,5,5-3,TBA,9,0,40,43,83,182,167,349,12,18,30,6,3:51
8981,491666,2017-07-30,2017,TOR,ANA,11,10,11-10,TOR,9,0,41,43,84,167,173,340,18,19,37,3,3:38
8982,491659,2017-07-30,2017,TEX,BAL,6,10,10-6,BAL,9,0,40,40,80,162,186,348,12,16,28,4,3:47
8983,491663,2017-07-30,2017,WAS,COL,6,10,10-6,COL,9,0,42,45,87,176,163,339,15,20,35,2,3:48
8984,491667,2017-07-30,2017,OAK,MIN,6,5,6-5,OAK,12,0,50,51,101,204,183,387,16,16,32,3,4:06
8985,491680,2017-07-31,2017,MIA,WAS,0,1,1-0,WAS,9,0,31,31,62,115,115,230,6,4,10,1,2:12
8986,491673,2017-07-31,2017,BOS,CLE,6,2,6-2,BOS,9,1,40,34,74,125,138,263,18,9,27,3,2:47
8987,491675,2017-07-31,2017,BAL,KCA,2,1,2-1,BAL,9,0,36,32,68,119,136,255,11,7,18,0,2:33
8988,491679,2017-07-31,2017,CHA,TOR,7,6,7-6,CHA,9,0,40,37,77,141,148,289,13,12,25,1,3:01
8989,491676,2017-07-31,2017,OAK,SFN,8,5,8-5,OAK,9,1,43,38,81,139,176,315,21,12,33,5,3:26
8990,491674,2017-07-31,2017,NYA,DET,7,3,7-3,NYA,9,1,36,44,80,197,121,318,11,16,27,2,3:23
8991,491678,2017-07-31,2017,HOU,TBA,14,7,14-7,HOU,9,1,47,41,88,164,154,318,22,14,36,2,3:24
8992,491672,2017-07-31,2017,PHI,ATL,7,6,7-6,PHI,9,1,38,42,80,164,155,319,14,15,29,2,3:13
8993,491677,2017-07-31,2017,TEX,SEA,4,6,6-4,SEA,9,0,39,41,80,145,151,296,12,17,29,3,3:16
8994,491685,2017-08-01,2017,BAL,KCA,7,2,7-2,BAL,9,1,40,33,73,116,168,284,18,6,24,1,2:54
8995,491695,2017-08-01,2017,MIA,WAS,7,6,7-6,MIA,9,1,36,40,76,163,131,294,13,14,27,2,3:05
8996,491689,2017-08-01,2017,ANA,PHI,7,1,7-1,ANA,9,1,38,37,75,141,160,301,15,11,26,0,3:20
8997,491687,2017-08-01,2017,SDN,MIN,3,0,3-0,SDN,9,1,28,32,60,139,95,234,6,5,11,0,2:23
8998,491693,2017-08-01,2017,HOU,TBA,4,6,6-4,TBA,9,0,35,40,75,149,147,296,8,16,24,4,3:27
8999,491691,2017-08-01,2017,TEX,SEA,7,8,8-7,SEA,9,0,42,43,85,137,154,291,15,16,31,6,3:30
9000,491688,2017-08-01,2017,COL,NYN,5,4,5-4,COL,9,0,39,38,77,154,152,306,17,11,28,5,3:24
9001,491684,2017-08-01,2017,NYA,DET,3,4,4-3,DET,9,0,38,36,74,139,139,278,13,11,24,3,2:59
9002,491694,2017-08-01,2017,CHA,TOR,4,8,8-4,TOR,9,0,38,47,85,185,131,316,13,22,35,3,3:22
9003,491690,2017-08-01,2017,OAK,SFN,4,10,10-4,SFN,9,0,36,45,81,142,136,278,10,19,29,0,2:41
9004,491682,2017-08-01,2017,PIT,CIN,1,9,9-1,CIN,9,0,35,46,81,166,134,300,10,18,28,1,3:00
9005,491686,2017-08-01,2017,ATL,LAN,2,3,3-2,LAN,9,0,33,35,68,136,125,261,6,10,16,2,2:54
9006,491692,2017-08-01,2017,MIL,SLN,3,2,3-2,MIL,9,1,35,35,70,148,154,302,12,9,21,2,3:01
9007,491683,2017-08-01,2017,BOS,CLE,12,10,12-10,BOS,9,0,45,43,88,162,167,329,21,16,37,3,3:36
9008,491681,2017-08-01,2017,CHN,ARI,16,4,16-4,CHN,9,1,45,41,86,183,165,348,21,13,34,3,3:27
9009,491699,2017-08-02,2017,NYA,DET,0,2,2-0,DET,9,0,35,35,70,132,122,254,8,8,16,0,2:52 (4:37 delay)
9010,491705,2017-08-02,2017,ANA,PHI,7,0,7-0,ANA,9,1,35,33,68,108,132,240,12,8,20,0,2:33
9011,491702,2017-08-02,2017,SDN,MIN,2,5,5-2,MIN,9,0,32,34,66,123,110,233,5,10,15,0,2:24
9012,491696,2017-08-02,2017,CHN,ARI,0,3,3-0,ARI,9,0,31,36,67,128,139,267,5,10,15,0,2:44
9013,491701,2017-08-02,2017,ATL,LAN,5,3,5-3,ATL,9,1,38,34,72,120,135,255,15,8,23,1,2:55
9014,491700,2017-08-02,2017,BAL,KCA,6,0,6-0,BAL,9,1,35,34,69,133,155,288,12,8,20,0,2:47 (:35 delay)
9015,491706,2017-08-02,2017,TEX,SEA,5,1,5-1,TEX,9,1,32,37,69,155,123,278,9,11,20,1,2:53 (:40 delay)
9016,491704,2017-08-02,2017,SFN,OAK,1,6,6-1,OAK,9,0,33,42,75,159,122,281,8,16,24,1,2:48
9017,491708,2017-08-02,2017,HOU,TBA,0,3,3-0,TBA,9,0,34,40,74,142,128,270,8,13,21,2,3:06
9018,491703,2017-08-02,2017,COL,NYN,5,10,10-5,NYN,9,0,38,40,78,136,140,276,12,14,26,1,3:15
9019,491710,2017-08-02,2017,MIA,WAS,7,0,7-0,MIA,9,1,39,28,67,115,167,282,15,4,19,2,2:54
9020,491697,2017-08-02,2017,PIT,CIN,2,5,5-2,CIN,9,0,36,41,77,179,148,327,9,14,23,2,3:25
9021,491709,2017-08-02,2017,CHA,TOR,1,5,5-1,TOR,9,0,38,41,79,159,151,310,11,14,25,4,3:15
9022,491707,2017-08-02,2017,MIL,SLN,4,5,5-4,SLN,9,0,38,40,78,157,144,301,10,15,25,3,2:58
9023,491717,2017-08-03,2017,CLE,NYA,5,1,5-1,CLE,9,1,34,30,64,106,121,227,8,4,12,0,2:28
9024,491713,2017-08-03,2017,PIT,CIN,6,0,6-0,PIT,9,1,37,34,71,117,132,249,13,7,20,1,2:29
9025,491718,2017-08-03,2017,SFN,OAK,11,2,11-2,SFN,9,1,40,34,74,121,138,259,18,8,26,0,2:28
9026,491720,2017-08-03,2017,KCA,SEA,6,4,6-4,KCA,9,1,35,40,75,145,126,271,13,13,26,4,3:01
9027,491722,2017-08-03,2017,HOU,TBA,3,5,5-3,TBA,9,0,36,42,78,161,149,310,10,13,23,2,3:23
9028,491723,2017-08-03,2017,MIN,TEX,1,4,4-1,TEX,9,0,31,40,71,171,127,298,5,14,19,2,3:04
9029,491721,2017-08-03,2017,MIL,SLN,2,1,2-1,MIL,9,1,35,35,70,150,144,294,12,10,22,1,3:21
9030,491716,2017-08-03,2017,COL,NYN,5,4,5-4,COL,9,0,39,40,79,138,137,275,18,14,32,4,3:03
9031,491715,2017-08-03,2017,ATL,LAN,4,7,7-4,LAN,9,0,38,45,83,183,144,327,13,20,33,1,3:29
9032,491719,2017-08-03,2017,ANA,PHI,5,4,5-4,ANA,9,1,36,40,76,155,137,292,13,15,28,0,3:07
9033,491712,2017-08-03,2017,BOS,CHA,9,5,9-5,BOS,9,1,43,36,79,151,156,307,21,9,30,5,3:26
9034,491714,2017-08-03,2017,BAL,DET,5,7,7-5,DET,9,0,39,36,75,152,147,299,14,11,25,3,3:18 (1:42 delay)
9035,491711,2017-08-03,2017,CHN,ARI,8,10,10-8,ARI,9,0,43,45,88,203,165,368,17,17,34,6,3:59 (2:35 delay)
9036,491724,2017-08-04,2017,SFN,ARI,1,2,2-1,ARI,9,0,33,34,67,128,127,255,8,9,17,0,2:39
9037,491738,2017-08-04,2017,CHN,WAS,2,4,4-2,WAS,9,0,36,36,72,132,140,272,11,10,21,1,2:43
9038,491728,2017-08-04,2017,ATL,MIA,5,3,5-3,ATL,9,1,33,35,68,132,123,255,10,8,18,2,2:40
9039,491726,2017-08-04,2017,BAL,DET,2,5,5-2,DET,9,0,33,35,68,150,130,280,7,8,15,0,2:52
9040,491735,2017-08-04,2017,CIN,SLN,3,2,3-2,CIN,9,1,31,39,70,157,95,252,9,14,23,3,2:48
9041,491736,2017-08-04,2017,MIN,TEX,8,4,8-4,MIN,9,1,39,36,75,106,162,268,17,10,27,1,3:03
9042,491730,2017-08-04,2017,CLE,NYA,7,2,7-2,CLE,9,1,35,38,73,152,139,291,12,13,25,2,2:58
9043,491729,2017-08-04,2017,TBA,MIL,0,2,2-0,MIL,9,0,38,33,71,131,143,274,13,7,20,2,3:04
9044,491727,2017-08-04,2017,NYN,LAN,0,6,6-0,LAN,9,0,33,38,71,154,127,281,6,12,18,1,3:07
9045,491734,2017-08-04,2017,KCA,SEA,2,5,5-2,SEA,9,0,32,35,67,132,129,261,5,11,16,1,2:47
9046,491732,2017-08-04,2017,COL,PHI,4,3,4-3,COL,9,1,39,38,77,146,144,290,17,11,28,5,3:41
9047,491733,2017-08-04,2017,PIT,SDN,10,6,10-6,PIT,9,1,43,42,85,136,173,309,19,15,34,5,3:35 (2:05 delay)
9048,491737,2017-08-04,2017,HOU,TOR,16,7,16-7,HOU,9,1,47,37,84,133,175,308,25,12,37,2,3:05
9049,491731,2017-08-04,2017,ANA,OAK,8,6,8-6,ANA,9,1,43,40,83,157,153,310,19,13,32,4,3:31
9050,491725,2017-08-04,2017,BOS,CHA,3,2,3-2,BOS,11,0,40,45,85,197,162,359,8,13,21,1,3:43
9051,491740,2017-08-05,2017,BOS,CHA,4,1,4-1,BOS,9,1,32,34,66,123,121,244,8,10,18,2,2:41
9052,491751,2017-08-05,2017,MIN,TEX,1,4,4-1,TEX,9,0,30,37,67,152,96,248,5,11,16,1,2:41 (:45 delay)
9053,491747,2017-08-05,2017,COL,PHI,8,5,8-5,COL,9,1,38,39,77,127,142,269,15,13,28,2,2:53
9054,491745,2017-08-05,2017,CLE,NYA,1,2,2-1,NYA,9,0,33,35,68,144,128,272,6,9,15,1,2:58
9055,491743,2017-08-05,2017,ATL,MIA,7,2,7-2,ATL,9,1,37,36,73,144,155,299,13,9,22,4,2:58
9056,491752,2017-08-05,2017,HOU,TOR,3,4,4-3,TOR,10,0,37,44,81,161,138,299,8,14,22,2,3:16
9057,491750,2017-08-05,2017,CIN,SLN,1,4,4-1,SLN,9,0,35,38,73,145,147,292,10,14,24,1,3:01
9058,491744,2017-08-05,2017,TBA,MIL,0,3,3-0,MIL,9,0,34,37,71,172,141,313,7,11,18,1,3:20
9059,491746,2017-08-05,2017,ANA,OAK,0,5,5-0,OAK,9,0,32,41,73,175,140,315,6,14,20,2,3:24
9060,491748,2017-08-05,2017,PIT,SDN,2,5,5-2,SDN,9,0,37,41,78,150,157,307,12,15,27,3,3:13 (:26 delay)
9061,491741,2017-08-05,2017,BAL,DET,5,2,5-2,BAL,9,1,37,35,72,191,131,322,14,9,23,2,3:14
9062,491753,2017-08-05,2017,CHN,WAS,7,4,7-4,CHN,9,1,34,39,73,180,162,342,11,12,23,1,3:31
9063,491742,2017-08-05,2017,NYN,LAN,4,7,7-4,LAN,9,0,37,40,77,158,157,315,10,13,23,4,3:18
9064,491739,2017-08-05,2017,SFN,ARI,5,4,5-4,SFN,10,0,41,47,88,183,164,347,16,17,33,3,3:38 (:08 delay)
9065,491759,2017-08-06,2017,TBA,MIL,2,1,2-1,TBA,9,0,32,35,67,134,109,243,10,10,20,1,2:46
9066,491754,2017-08-06,2017,SFN,ARI,6,3,6-3,SFN,9,1,36,36,72,160,137,297,13,10,23,3,3:03
9067,491765,2017-08-06,2017,CIN,SLN,4,13,13-4,SLN,9,0,38,47,85,164,161,325,14,22,36,1,3:10
9068,491749,2017-08-06,2017,KCA,SEA,9,1,9-1,KCA,9,1,39,32,71,118,138,256,15,5,20,1,2:39
9069,491758,2017-08-06,2017,ATL,MIA,1,4,4-1,MIA,9,0,31,36,67,131,108,239,5,9,14,0,2:29
9070,491755,2017-08-06,2017,BOS,CHA,6,3,6-3,BOS,9,1,36,36,72,114,128,242,16,9,25,3,2:36
9071,491749,2017-08-06,2017,KCA,SEA,9,1,9-1,KCA,9,1,39,32,71,118,138,256,15,5,20,1,2:39
9072,491762,2017-08-06,2017,COL,PHI,2,3,3-2,PHI,9,0,37,37,74,135,131,266,10,12,22,1,3:14
9073,491766,2017-08-06,2017,MIN,TEX,6,5,6-5,MIN,9,1,33,37,70,141,130,271,10,10,20,0,2:53 (:32 delay)
9074,491768,2017-08-06,2017,CHN,WAS,4,9,9-4,WAS,9,0,38,40,78,151,144,295,16,14,30,3,3:06
9075,491760,2017-08-06,2017,CLE,NYA,1,8,8-1,NYA,9,0,30,42,72,157,140,297,3,16,19,2,2:56
9076,491764,2017-08-06,2017,KCA,SEA,7,8,8-7,SEA,9,0,40,42,82,146,146,292,13,15,28,5,3:03
9077,491757,2017-08-06,2017,NYN,LAN,0,8,8-0,LAN,9,0,29,39,68,176,136,312,2,14,16,1,2:59
9078,491767,2017-08-06,2017,HOU,TOR,7,6,7-6,HOU,9,0,44,42,86,156,160,316,18,16,34,3,3:16
9079,491756,2017-08-06,2017,BAL,DET,12,3,12-3,BAL,9,1,43,42,85,157,180,337,21,17,38,4,3:10
9080,491763,2017-08-06,2017,PIT,SDN,5,4,5-4,PIT,12,0,45,50,95,210,151,361,14,14,28,4,4:03
9081,491761,2017-08-06,2017,ANA,OAK,10,11,11-10,OAK,9,0,47,48,95,192,194,386,19,22,41,4,4:12
9082,491771,2017-08-07,2017,PIT,DET,3,0,3-0,PIT,9,1,31,29,60,129,120,249,9,3,12,0,2:37
9083,491769,2017-08-07,2017,ANA,BAL,2,6,6-2,BAL,9,0,33,37,70,116,141,257,7,12,19,0,2:42
9084,491773,2017-08-07,2017,MIN,MIL,5,4,5-4,MIN,9,1,40,37,77,130,163,293,16,11,27,4,3:13
9085,491775,2017-08-07,2017,KCA,SLN,3,11,11-3,SLN,9,0,35,41,76,141,118,259,8,15,23,1,2:32
9086,491774,2017-08-07,2017,CIN,SDN,11,3,11-3,CIN,9,1,37,36,73,144,161,305,14,9,23,3,3:06
9087,491770,2017-08-07,2017,SFN,CHN,3,5,5-3,CHN,9,0,37,41,78,153,118,271,11,15,26,1,2:55
9088,491772,2017-08-07,2017,WAS,MIA,3,2,3-2,WAS,9,1,31,36,67,144,128,272,9,9,18,1,2:58
9089,491776,2017-08-08,2017,ANA,BAL,3,2,3-2,ANA,9,1,31,36,67,119,121,240,8,8,16,2,2:46
9090,491779,2017-08-08,2017,CLE,COL,4,1,4-1,CLE,9,0,36,29,65,116,155,271,11,3,14,2,2:49
9091,491778,2017-08-08,2017,SFN,CHN,6,3,6-3,SFN,9,1,35,37,72,130,138,268,11,10,21,1,2:44
9092,491790,2017-08-08,2017,NYN,TEX,5,4,5-4,NYN,9,1,33,36,69,149,123,272,10,10,20,2,2:51
9093,491786,2017-08-08,2017,ATL,PHI,2,5,5-2,PHI,9,0,34,43,77,167,124,291,9,19,28,0,2:58
9094,491784,2017-08-08,2017,MIN,MIL,11,4,11-4,MIN,9,1,40,40,80,149,161,310,19,15,34,3,3:30
9095,491788,2017-08-08,2017,OAK,SEA,6,7,7-6,SEA,10,0,42,46,88,152,158,310,12,16,28,3,3:20
9096,491789,2017-08-08,2017,KCA,SLN,3,10,10-3,SLN,9,0,35,47,82,185,144,329,9,23,32,1,3:02
9097,491783,2017-08-08,2017,WAS,MIA,3,7,7-3,MIA,9,0,39,40,79,159,124,283,14,14,28,2,3:07
9098,491781,2017-08-08,2017,CHA,HOU,8,5,8-5,CHA,9,1,41,42,83,176,159,335,18,18,36,4,3:37
9099,491782,2017-08-08,2017,ARI,LAN,6,3,6-3,ARI,9,1,36,35,71,128,152,280,14,11,25,2,2:59
9100,491777,2017-08-08,2017,TBA,BOS,0,2,2-0,BOS,9,0,31,38,69,146,127,273,3,13,16,1,2:52
9101,491787,2017-08-08,2017,CIN,SDN,3,7,7-3,SDN,9,0,38,41,79,134,144,278,15,15,30,1,2:56
9102,491780,2017-08-08,2017,PIT,DET,6,3,6-3,PIT,9,1,36,32,68,115,135,250,11,6,17,1,2:36
9103,491785,2017-08-08,2017,TOR,NYA,4,2,4-2,TOR,9,1,36,39,75,151,134,285,13,14,27,3,2:50
9104,491791,2017-08-09,2017,ANA,BAL,5,1,5-1,ANA,9,1,36,31,67,128,158,286,14,5,19,3,3:06
9105,491795,2017-08-09,2017,CHA,HOU,7,1,7-1,CHA,9,1,36,35,71,119,137,256,15,7,22,1,2:54
9106,491797,2017-08-09,2017,ARI,LAN,2,3,3-2,LAN,9,0,35,36,71,133,118,251,9,11,20,1,2:48
9107,491799,2017-08-09,2017,MIL,MIN,0,4,4-0,MIN,9,0,33,40,73,165,133,298,6,14,20,2,3:13
9108,491804,2017-08-09,2017,OAK,SEA,3,6,6-3,SEA,9,0,37,37,74,133,149,282,10,10,20,1,2:58
9109,491803,2017-08-09,2017,CIN,SDN,8,3,8-3,CIN,9,1,40,34,74,142,160,302,15,7,22,1,2:59
9110,491793,2017-08-09,2017,SFN,CHN,3,1,3-1,SFN,9,1,35,34,69,123,135,258,13,7,20,2,2:50
9111,491802,2017-08-09,2017,DET,PIT,10,0,10-0,DET,9,1,43,33,76,123,158,281,19,7,26,2,3:03
9112,491796,2017-08-09,2017,SLN,KCA,8,5,8-5,SLN,9,1,40,40,80,143,167,310,19,16,35,3,3:15
9113,491805,2017-08-09,2017,NYN,TEX,1,5,5-1,TEX,9,0,30,47,77,210,102,312,4,20,24,1,3:07
9114,491798,2017-08-09,2017,WAS,MIA,10,1,10-1,WAS,9,1,44,36,80,134,171,305,25,10,35,1,3:02
9115,491800,2017-08-09,2017,TOR,NYA,5,11,11-5,NYA,9,0,41,46,87,176,178,354,14,20,34,6,3:44
9116,491801,2017-08-09,2017,ATL,PHI,2,3,3-2,PHI,9,0,35,35,70,132,137,269,10,7,17,2,2:55
9117,491792,2017-08-09,2017,TBA,BOS,2,8,8-2,BOS,9,0,32,41,73,165,116,281,6,16,22,2,2:59
9118,491794,2017-08-09,2017,CLE,COL,2,3,3-2,COL,12,0,48,48,96,196,169,365,13,14,27,3,3:59
9119,491815,2017-08-10,2017,TOR,NYA,4,0,4-0,TOR,9,1,32,38,70,151,130,281,9,11,20,0,2:55
9120,491807,2017-08-10,2017,TBA,CLE,4,1,4-1,TBA,9,1,38,32,70,131,144,275,15,6,21,2,2:52
9121,491812,2017-08-10,2017,WAS,MIA,3,2,3-2,WAS,9,1,31,37,68,150,117,267,8,13,21,2,2:51
9122,491806,2017-08-10,2017,OAK,BAL,2,7,7-2,BAL,9,0,39,39,78,150,164,314,12,11,23,2,3:09
9123,491809,2017-08-10,2017,SLN,KCA,8,6,8-6,SLN,9,1,41,42,83,140,166,306,16,19,35,7,3:37
9124,491816,2017-08-10,2017,DET,PIT,5,7,7-5,PIT,9,0,35,41,76,159,129,288,10,15,25,2,3:06
9125,491817,2017-08-10,2017,CIN,SDN,10,3,10-3,CIN,9,1,40,38,78,137,153,290,18,12,30,4,2:57
9126,491813,2017-08-10,2017,MIL,MIN,2,7,7-2,MIN,9,0,35,41,76,149,144,293,9,15,24,2,3:09
9127,491811,2017-08-10,2017,ARI,LAN,6,8,8-6,LAN,9,0,40,41,81,153,178,331,13,13,26,3,3:37
9128,491808,2017-08-10,2017,CHA,HOU,3,2,3-2,CHA,11,0,47,44,91,156,167,323,17,14,31,2,3:41
9129,491814,2017-08-10,2017,PHI,NYN,0,10,10-0,NYN,9,0,30,43,73,161,141,302,5,17,22,1,3:03
9130,491810,2017-08-10,2017,SEA,ANA,3,6,6-3,ANA,9,0,35,39,74,175,129,304,11,13,24,3,3:14
9131,491830,2017-08-11,2017,TOR,PIT,2,4,4-2,PIT,9,0,36,33,69,120,129,249,9,6,15,1,2:41
9132,491823,2017-08-11,2017,TBA,CLE,0,5,5-0,CLE,9,0,32,39,71,145,121,266,5,12,17,0,2:44
9133,491819,2017-08-11,2017,OAK,BAL,5,4,5-4,OAK,9,1,33,36,69,139,139,278,11,12,23,3,2:48
9134,491831,2017-08-11,2017,LAN,SDN,3,4,4-3,SDN,9,0,40,36,76,149,136,285,16,10,26,1,2:59
9135,491827,2017-08-11,2017,SEA,ANA,5,6,6-5,ANA,9,0,36,42,78,153,132,285,11,15,26,4,3:04
9136,491828,2017-08-11,2017,DET,MIN,4,9,9-4,MIN,9,0,38,41,79,151,159,310,12,17,29,4,3:21
9137,491825,2017-08-11,2017,TEX,HOU,6,4,6-4,TEX,9,1,37,39,76,157,136,293,12,13,25,3,3:22
9138,491818,2017-08-11,2017,SLN,ATL,8,5,8-5,SLN,9,1,41,36,77,145,168,313,17,12,29,3,3:08
9139,491824,2017-08-11,2017,MIA,COL,6,3,6-3,MIA,9,1,36,37,73,156,151,307,15,12,27,5,3:24
9140,491829,2017-08-11,2017,PHI,NYN,6,7,7-6,NYN,9,0,44,40,84,140,178,318,17,15,32,5,3:25
9141,491821,2017-08-11,2017,ARI,CHN,3,8,8-3,CHN,9,0,35,42,77,178,141,319,10,18,28,4,3:23
9142,491826,2017-08-11,2017,CHA,KCA,6,3,6-3,CHA,9,1,34,37,71,150,115,265,9,10,19,2,2:49
9143,491820,2017-08-11,2017,NYA,BOS,5,4,5-4,NYA,9,1,37,40,77,158,168,326,13,15,28,3,3:40
9144,491822,2017-08-11,2017,MIL,CIN,10,11,11-10,CIN,9,0,49,49,98,176,199,375,24,25,49,2,3:55
9145,491833,2017-08-12,2017,SLN,ATL,6,5,6-5,SLN,9,1,37,40,77,161,132,293,15,13,28,1,2:52
9146,491845,2017-08-12,2017,TOR,PIT,7,2,7-2,TOR,9,1,38,38,76,128,133,261,14,11,25,2,2:50
9147,491836,2017-08-12,2017,ARI,CHN,6,2,6-2,ARI,9,1,39,40,79,152,138,290,16,11,27,2,3:05
9148,491838,2017-08-12,2017,TBA,CLE,0,3,3-0,CLE,9,0,30,36,66,170,127,297,5,10,15,1,2:57
9149,491840,2017-08-12,2017,TEX,HOU,8,3,8-3,TEX,9,1,38,37,75,147,151,298,18,12,30,2,3:14 (:21 delay)
9150,491835,2017-08-12,2017,NYA,BOS,5,10,10-5,BOS,9,0,38,41,79,150,154,304,11,14,25,2,3:13
9151,491841,2017-08-12,2017,CHA,KCA,4,5,5-4,KCA,9,0,36,37,73,156,143,299,12,12,24,2,3:12
9152,491844,2017-08-12,2017,PHI,NYN,3,1,3-1,PHI,9,1,34,34,68,153,135,288,10,7,17,2,3:04
9153,491839,2017-08-12,2017,MIA,COL,4,3,4-3,MIA,9,1,36,41,77,156,120,276,13,17,30,1,3:07
9154,491843,2017-08-12,2017,DET,MIN,12,11,12-11,DET,9,0,39,49,88,182,146,328,16,22,38,5,3:36
9155,491837,2017-08-12,2017,MIL,CIN,6,5,6-5,MIL,10,0,47,41,88,176,191,367,19,12,31,0,3:46
9156,491834,2017-08-12,2017,OAK,BAL,5,12,12-5,BAL,9,0,41,48,89,175,159,334,14,25,39,3,3:20
9157,491847,2017-08-12,2017,WAS,SFN,3,1,3-1,WAS,9,1,37,36,73,141,157,298,14,9,23,0,3:11 (3:01 delay)
9158,491842,2017-08-12,2017,SEA,ANA,3,6,6-3,ANA,9,0,39,37,76,135,166,301,16,11,27,1,3:11
9159,491846,2017-08-12,2017,LAN,SDN,6,3,6-3,LAN,9,1,38,40,78,168,158,326,14,13,27,1,3:36
9160,491861,2017-08-13,2017,LAN,SDN,6,4,6-4,LAN,9,1,32,34,66,142,106,248,7,6,13,1,2:36
9161,491857,2017-08-13,2017,SEA,ANA,2,4,4-2,ANA,9,0,35,41,76,158,126,284,9,14,23,1,2:59
9162,491855,2017-08-13,2017,TEX,HOU,1,2,2-1,HOU,9,0,37,34,71,126,138,264,12,9,21,2,3:04
9163,491854,2017-08-13,2017,MIA,COL,5,3,5-3,MIA,9,1,34,39,73,151,139,290,11,16,27,2,3:06
9164,491862,2017-08-13,2017,WAS,SFN,2,4,4-2,SFN,9,0,35,40,75,146,140,286,8,13,21,1,3:09
9165,491852,2017-08-13,2017,MIL,CIN,7,4,7-4,MIL,9,1,35,39,74,145,133,278,12,14,26,1,3:07
9166,491851,2017-08-13,2017,ARI,CHN,2,7,7-2,CHN,9,0,35,43,78,174,135,309,9,16,25,4,3:12
9167,491850,2017-08-13,2017,NYA,BOS,2,3,3-2,BOS,10,0,40,41,81,163,170,333,10,11,21,4,3:40
9168,491832,2017-08-13,2017,WAS,SFN,6,2,6-2,WAS,11,0,42,40,82,173,153,326,16,10,26,0,3:31
9169,491849,2017-08-13,2017,OAK,BAL,9,3,9-3,OAK,9,1,35,36,71,131,109,240,10,11,21,3,2:33
9170,491858,2017-08-13,2017,DET,MIN,4,6,6-4,MIN,9,0,43,40,83,163,171,334,14,13,27,3,3:38
9171,491853,2017-08-13,2017,TBA,CLE,3,4,4-3,CLE,9,0,34,37,71,146,131,277,8,12,20,3,3:06
9172,491856,2017-08-13,2017,CHA,KCA,6,14,14-6,KCA,9,0,41,52,93,222,148,370,14,25,39,2,3:38
9173,491848,2017-08-13,2017,SLN,ATL,3,6,6-3,ATL,9,0,39,40,79,146,136,282,14,15,29,2,2:58
9174,491859,2017-08-13,2017,PHI,NYN,2,6,6-2,NYN,9,0,38,40,78,174,155,329,12,12,24,1,3:30
9175,491860,2017-08-13,2017,TOR,PIT,7,1,7-1,TOR,9,1,37,36,73,148,148,296,13,9,22,1,2:51
9176,491832,2017-08-13,2017,WAS,SFN,6,2,6-2,WAS,11,0,42,40,82,173,153,326,16,10,26,0,3:31
9177,491698,2017-08-14,2017,BOS,CLE,3,7,7-3,CLE,9,0,38,43,81,164,158,322,10,16,26,5,3:14
9178,491866,2017-08-14,2017,TEX,DET,6,2,6-2,TEX,9,1,35,37,72,147,126,273,14,11,25,0,2:56
9179,491867,2017-08-14,2017,ARI,HOU,2,0,2-0,ARI,9,1,34,34,68,130,139,269,11,9,20,2,2:48
9180,491698,2017-08-14,2017,BOS,CLE,3,7,7-3,CLE,9,0,38,43,81,164,158,322,10,16,26,5,3:14
9181,491871,2017-08-14,2017,MIA,SFN,8,3,8-3,MIA,9,1,40,37,77,148,136,284,18,12,30,1,2:44
9182,491868,2017-08-14,2017,OAK,KCA,2,6,6-2,KCA,9,0,35,39,74,150,124,274,7,14,21,0,2:40
9183,491869,2017-08-14,2017,NYA,NYN,4,2,4-2,NYA,9,1,33,34,67,149,144,293,10,9,19,3,3:03
9184,491872,2017-08-14,2017,TOR,TBA,2,1,2-1,TOR,9,1,33,37,70,134,140,274,10,10,20,3,2:54
9185,491864,2017-08-14,2017,SEA,BAL,3,11,11-3,BAL,9,0,36,45,81,183,143,326,10,18,28,1,3:06
9186,491865,2017-08-14,2017,CHN,CIN,15,5,15-5,CHN,9,1,49,43,92,180,171,351,25,17,42,3,3:45
9187,491870,2017-08-14,2017,SDN,PHI,7,4,7-4,SDN,9,1,40,41,81,156,151,307,16,14,30,1,3:20
9188,491863,2017-08-14,2017,COL,ATL,3,0,3-0,COL,9,1,34,34,68,116,129,245,13,8,21,1,2:44
9189,491874,2017-08-15,2017,SEA,BAL,3,1,3-1,SEA,9,1,34,32,66,113,149,262,11,7,18,2,2:48
9190,491882,2017-08-15,2017,NYA,NYN,5,4,5-4,NYA,9,1,35,36,71,156,115,271,12,10,22,3,3:07
9191,491881,2017-08-15,2017,WAS,ANA,3,1,3-1,WAS,9,1,34,32,66,126,126,252,11,7,18,0,2:36
9192,491875,2017-08-15,2017,LAN,CHA,6,1,6-1,LAN,9,1,39,34,73,113,158,271,16,7,23,3,3:05
9193,491873,2017-08-15,2017,COL,ATL,3,4,4-3,ATL,9,0,35,35,70,122,150,272,11,8,19,1,2:53
9194,491883,2017-08-15,2017,SDN,PHI,8,4,8-4,SDN,9,1,38,34,72,134,145,279,14,8,22,0,2:48
9195,491879,2017-08-15,2017,ARI,HOU,4,9,9-4,HOU,9,0,38,44,82,170,158,328,12,19,31,1,3:07
9196,491886,2017-08-15,2017,BOS,SLN,10,4,10-4,BOS,9,1,43,36,79,150,137,287,21,13,34,1,2:52
9197,491884,2017-08-15,2017,MIL,PIT,3,1,3-1,MIL,9,1,34,36,70,139,122,261,12,10,22,1,2:53
9198,491878,2017-08-15,2017,TEX,DET,10,4,10-4,TEX,9,1,38,38,76,167,172,339,18,13,31,2,3:23
9199,491887,2017-08-15,2017,TOR,TBA,4,6,6-4,TBA,9,0,36,46,82,164,137,301,9,18,27,2,3:13
9200,491885,2017-08-15,2017,MIA,SFN,4,9,9-4,SFN,9,0,39,40,79,157,143,300,14,16,30,1,3:13
9201,491880,2017-08-15,2017,OAK,KCA,10,8,10-8,OAK,9,1,39,37,76,162,150,312,17,11,28,4,3:16
9202,491877,2017-08-15,2017,MIN,CLE,1,8,8-1,CLE,9,0,30,43,73,163,127,290,3,17,20,2,2:53
9203,491876,2017-08-15,2017,CHN,CIN,1,2,2-1,CIN,9,0,38,39,77,154,144,298,12,14,26,2,3:04
9204,491898,2017-08-16,2017,SDN,PHI,3,0,3-0,SDN,9,1,33,32,65,114,134,248,10,4,14,2,2:30
9205,491899,2017-08-16,2017,MIL,PIT,7,6,7-6,MIL,9,1,35,38,73,151,157,308,11,12,23,2,3:06
9206,491900,2017-08-16,2017,MIA,SFN,8,1,8-1,MIA,9,1,41,36,77,135,151,286,16,10,26,0,2:49
9207,491901,2017-08-16,2017,BOS,SLN,5,4,5-4,BOS,9,0,38,38,76,153,164,317,15,11,26,3,3:35
9208,491890,2017-08-16,2017,SEA,BAL,7,6,7-6,SEA,9,1,39,42,81,156,146,302,19,17,36,4,3:13
9209,491895,2017-08-16,2017,OAK,KCA,6,7,7-6,KCA,9,0,42,46,88,189,171,360,15,22,37,1,3:37
9210,491902,2017-08-16,2017,TOR,TBA,3,2,3-2,TOR,9,1,32,38,70,158,125,283,10,11,21,4,3:10
9211,491896,2017-08-16,2017,WAS,ANA,2,3,3-2,ANA,9,0,37,32,69,118,157,275,10,6,16,2,2:51
9212,491892,2017-08-16,2017,CHN,CIN,7,6,7-6,CHN,9,0,38,38,76,147,152,299,14,12,26,4,3:35
9213,491891,2017-08-16,2017,LAN,CHA,5,4,5-4,LAN,9,0,34,37,71,127,133,260,13,13,26,3,2:59
9214,491888,2017-08-16,2017,HOU,ARI,9,5,9-5,HOU,9,1,41,38,79,153,152,305,18,13,31,4,3:17
9215,491897,2017-08-16,2017,NYN,NYA,3,5,5-3,NYA,9,0,35,40,75,145,152,297,9,13,22,3,3:13
9216,491889,2017-08-16,2017,COL,ATL,17,2,17-2,COL,9,1,49,34,83,137,207,344,25,9,34,2,3:16 (:16 delay)
9217,491894,2017-08-16,2017,TEX,DET,12,6,12-6,TEX,9,1,48,43,91,156,195,351,24,20,44,6,3:52
9218,491903,2017-08-17,2017,HOU,ARI,0,4,4-0,ARI,9,0,32,35,67,133,112,245,5,14,19,3,2:48
9219,491893,2017-08-17,2017,MIN,CLE,4,2,4-2,MIN,9,1,41,32,73,121,150,271,17,6,23,6,3:08
9220,491911,2017-08-17,2017,TOR,TBA,5,3,5-3,TOR,9,1,32,44,76,163,127,290,7,19,26,3,3:01
9221,491906,2017-08-17,2017,CHN,CIN,10,13,13-10,CIN,9,0,42,48,90,191,155,346,16,21,37,3,3:45
9222,491905,2017-08-17,2017,TEX,CHA,9,8,9-8,TEX,9,1,40,43,83,143,183,326,17,16,33,4,3:49
9223,491893,2017-08-17,2017,MIN,CLE,4,2,4-2,MIN,9,1,41,32,73,121,150,271,17,6,23,6,3:08
9224,491909,2017-08-17,2017,SFN,PHI,5,4,5-4,SFN,9,1,37,37,74,140,125,265,15,11,26,1,2:47
9225,491912,2017-08-17,2017,SDN,WAS,1,2,2-1,WAS,9,0,36,36,72,159,110,269,10,11,21,1,3:01
9226,491908,2017-08-17,2017,NYN,NYA,5,7,7-5,NYA,9,0,40,39,79,143,153,296,12,12,24,3,2:55
9227,491904,2017-08-17,2017,COL,ATL,4,10,10-4,ATL,9,0,42,43,85,150,156,306,14,17,31,2,3:27
9228,491907,2017-08-17,2017,MIN,CLE,3,9,9-3,CLE,9,0,38,46,84,183,172,355,13,21,34,7,3:53
9229,491910,2017-08-17,2017,PIT,SLN,7,11,11-7,SLN,9,0,44,46,90,187,168,355,21,21,42,2,3:36 (1:32 delay)
9230,491919,2017-08-18,2017,NYN,MIA,1,3,3-1,MIA,9,0,34,35,69,137,127,264,8,9,17,1,2:53 (1:53 delay)
9231,491924,2017-08-18,2017,TBA,SEA,1,7,7-1,SEA,9,0,34,42,76,141,137,278,7,17,24,1,2:53
9232,491916,2017-08-18,2017,KCA,CLE,1,10,10-1,CLE,9,0,37,44,81,154,129,283,11,17,28,3,2:58
9233,491914,2017-08-18,2017,TEX,CHA,3,4,4-3,CHA,9,0,36,39,75,142,145,287,11,14,25,4,3:25
9234,491915,2017-08-18,2017,ATL,CIN,3,5,5-3,CIN,9,0,38,40,78,155,142,297,12,15,27,1,3:09
9235,491920,2017-08-18,2017,COL,MIL,8,4,8-4,COL,9,1,36,38,74,138,127,265,15,11,26,3,2:55
9236,491918,2017-08-18,2017,DET,LAN,5,8,8-5,LAN,9,0,43,43,86,143,161,304,17,19,36,2,3:20
9237,491921,2017-08-18,2017,BOS,NYA,9,6,9-6,BOS,9,1,39,47,86,200,155,355,16,20,36,6,4:09
9238,491927,2017-08-18,2017,SDN,WAS,1,7,7-1,WAS,9,0,32,40,72,147,116,263,7,14,21,3,2:48
9239,491913,2017-08-18,2017,MIN,ARI,10,3,10-3,MIN,9,1,41,36,77,125,167,292,21,10,31,6,3:06
9240,491922,2017-08-18,2017,HOU,OAK,3,1,3-1,HOU,9,1,32,31,63,140,124,264,8,6,14,1,2:47
9241,491926,2017-08-18,2017,CHN,TOR,7,4,7-4,CHN,9,1,38,38,76,138,143,281,17,12,29,2,3:02
9242,491917,2017-08-18,2017,BAL,ANA,9,7,9-7,BAL,9,0,38,38,76,144,133,277,12,13,25,3,3:13 (:42 delay)
9243,491923,2017-08-18,2017,SFN,PHI,10,2,10-2,SFN,9,1,38,35,73,147,145,292,14,8,22,3,2:52
9244,491925,2017-08-18,2017,PIT,SLN,10,11,11-10,SLN,9,0,43,44,87,171,177,348,18,17,35,4,3:23
9245,491942,2017-08-19,2017,SDN,WAS,3,1,3-1,SDN,9,1,30,33,63,131,131,262,8,5,13,1,2:47
9246,491933,2017-08-19,2017,DET,LAN,0,3,3-0,LAN,9,0,36,35,71,137,148,285,9,10,19,0,2:57
9247,491937,2017-08-19,2017,HOU,OAK,3,0,3-0,HOU,9,1,32,32,64,128,125,253,12,10,22,1,2:47
9248,491928,2017-08-19,2017,MIN,ARI,5,0,5-0,MIN,9,1,38,30,68,123,167,290,15,3,18,1,2:54
9249,491941,2017-08-19,2017,CHN,TOR,4,3,4-3,CHN,9,1,35,36,71,149,144,293,14,9,23,3,3:09
9250,491936,2017-08-19,2017,BOS,NYA,3,4,4-3,NYA,9,0,36,39,75,153,129,282,9,12,21,3,3:09
9251,491932,2017-08-19,2017,BAL,ANA,1,5,5-1,ANA,9,0,36,39,75,154,140,294,10,13,23,4,3:15 (:40 delay)
9252,491931,2017-08-19,2017,KCA,CLE,0,5,5-0,CLE,9,0,35,39,74,159,133,292,10,12,22,2,2:50
9253,491934,2017-08-19,2017,NYN,MIA,8,1,8-1,NYN,9,1,36,35,71,129,152,281,11,13,24,2,2:48
9254,491935,2017-08-19,2017,COL,MIL,3,6,6-3,MIL,9,0,39,40,79,137,148,285,15,14,29,3,3:14
9255,491940,2017-08-19,2017,PIT,SLN,6,4,6-4,PIT,9,1,38,35,73,143,147,290,14,9,23,0,2:49 (1:56 delay)
9256,491939,2017-08-19,2017,TBA,SEA,6,7,7-6,SEA,9,0,38,43,81,172,151,323,11,17,28,4,3:15
9257,491938,2017-08-19,2017,SFN,PHI,9,12,12-9,PHI,9,0,45,44,89,159,167,326,20,17,37,4,3:21
9258,491930,2017-08-19,2017,ATL,CIN,8,11,11-8,CIN,9,0,49,45,94,177,159,336,19,19,38,1,3:35
9259,491929,2017-08-19,2017,TEX,CHA,17,7,17-7,TEX,9,1,50,42,92,158,201,359,28,16,44,2,3:50
9260,491955,2017-08-20,2017,PIT,SLN,6,3,6-3,PIT,9,1,35,39,74,159,126,285,11,13,24,2,2:58
9261,491946,2017-08-20,2017,KCA,CLE,7,4,7-4,KCA,9,1,38,38,76,159,130,289,17,10,27,1,3:02
9262,491943,2017-08-20,2017,MIN,ARI,12,5,12-5,MIN,9,1,42,38,80,137,174,311,17,11,28,1,3:06
9263,491945,2017-08-20,2017,ATL,CIN,8,1,8-1,ATL,9,1,41,41,82,153,150,303,18,17,35,1,3:11
9264,491953,2017-08-20,2017,SFN,PHI,2,5,5-2,PHI,9,0,37,40,77,164,155,319,14,14,28,2,3:14
9265,491956,2017-08-20,2017,CHN,TOR,6,5,6-5,CHN,10,0,43,45,88,172,169,341,13,17,30,3,3:44
9266,491950,2017-08-20,2017,COL,MIL,4,8,8-4,MIL,9,0,43,44,87,171,163,334,17,18,35,5,4:04
9267,491954,2017-08-20,2017,TBA,SEA,3,0,3-0,TBA,9,1,34,31,65,126,131,257,12,5,17,1,2:44
9268,491949,2017-08-20,2017,NYN,MIA,4,6,6-4,MIA,9,0,36,40,76,158,136,294,11,12,23,2,2:53
9269,491947,2017-08-20,2017,BAL,ANA,4,5,5-4,ANA,9,0,37,40,77,164,151,315,11,15,26,3,3:25
9270,491957,2017-08-20,2017,SDN,WAS,1,4,4-1,WAS,9,0,35,40,75,170,150,320,6,13,19,3,3:23
9271,491948,2017-08-20,2017,DET,LAN,6,1,6-1,DET,9,1,33,31,64,128,122,250,9,4,13,0,2:33
9272,491952,2017-08-20,2017,HOU,OAK,2,3,3-2,OAK,9,0,36,40,76,163,134,297,10,16,26,3,3:17
9273,491944,2017-08-20,2017,TEX,CHA,2,3,3-2,CHA,9,0,39,38,77,140,155,295,13,13,26,3,3:20
9274,491951,2017-08-20,2017,BOS,NYA,5,1,5-1,BOS,9,1,40,33,73,141,186,327,18,6,24,2,3:36
9275,490606,2017-08-21,2017,CHA,MIN,2,10,10-2,MIN,9,0,31,41,72,149,110,259,4,17,21,2,2:35
9276,491963,2017-08-21,2017,BAL,OAK,7,3,7-3,BAL,9,1,38,35,73,151,158,309,14,12,26,3,3:12
9277,491962,2017-08-21,2017,CHA,MIN,7,6,7-6,CHA,9,1,34,41,75,175,144,319,11,14,25,4,3:15 (:19 delay)
9278,490606,2017-08-21,2017,CHA,MIN,2,10,10-2,MIN,9,0,31,41,72,149,110,259,4,17,21,2,2:35
9279,491959,2017-08-21,2017,CLE,BOS,5,4,5-4,CLE,9,0,35,38,73,150,149,299,10,12,22,5,3:39
9280,491960,2017-08-21,2017,PIT,LAN,5,6,6-5,LAN,12,0,51,54,105,193,215,408,16,17,33,3,4:35
9281,491961,2017-08-21,2017,SFN,MIL,2,0,2-0,SFN,9,1,37,34,71,136,136,272,13,7,20,0,2:45
9282,491965,2017-08-21,2017,ANA,TEX,3,5,5-3,TEX,9,0,39,37,76,134,151,285,12,10,22,2,3:11
9283,491964,2017-08-21,2017,ATL,SEA,5,6,6-5,SEA,9,0,39,40,79,141,130,271,13,14,27,4,2:59
9284,491958,2017-08-21,2017,NYN,ARI,2,3,3-2,ARI,10,0,42,40,82,157,191,348,15,10,25,5,3:46
9285,490396,2017-08-22,2017,PHI,MIA,4,7,7-4,MIA,9,0,37,43,80,195,157,352,11,17,28,4,3:22
9286,491969,2017-08-22,2017,KCA,COL,3,2,3-2,KCA,9,1,31,35,66,135,119,254,7,7,14,4,2:51
9287,491967,2017-08-22,2017,CLE,BOS,1,9,9-1,BOS,9,0,29,41,70,149,114,263,4,14,18,2,2:41 (1:13 delay)
9288,491976,2017-08-22,2017,SLN,SDN,4,12,12-4,SDN,9,0,37,45,82,171,133,304,11,19,30,3,3:04
9289,491977,2017-08-22,2017,ATL,SEA,4,0,4-0,ATL,9,1,36,36,72,142,148,290,16,10,26,2,3:01
9290,490396,2017-08-22,2017,PHI,MIA,4,7,7-4,MIA,9,0,37,43,80,195,157,352,11,17,28,4,3:22
9291,491974,2017-08-22,2017,DET,NYA,4,13,13-4,NYA,9,0,33,49,82,185,123,308,8,20,28,2,3:14
9292,491973,2017-08-22,2017,CHA,MIN,1,4,4-1,MIN,9,0,34,33,67,139,118,257,9,8,17,0,2:40
9293,491980,2017-08-22,2017,HOU,WAS,3,4,4-3,WAS,9,0,38,34,72,127,162,289,13,7,20,2,3:05
9294,491979,2017-08-22,2017,TBA,TOR,6,5,6-5,TBA,9,1,39,36,75,142,133,275,17,8,25,3,2:54
9295,491966,2017-08-22,2017,NYN,ARI,4,7,7-4,ARI,9,0,35,40,75,168,131,299,10,12,22,4,3:03
9296,491975,2017-08-22,2017,BAL,OAK,4,6,6-4,OAK,9,0,34,43,77,149,157,306,9,16,25,5,3:16
9297,491971,2017-08-22,2017,PHI,MIA,8,12,12-8,MIA,9,0,37,43,80,162,164,326,10,17,27,1,3:06
9298,491970,2017-08-22,2017,PIT,LAN,5,8,8-5,LAN,9,0,37,43,80,169,156,325,14,17,31,1,3:24
9299,491978,2017-08-22,2017,ANA,TEX,10,1,10-1,ANA,9,1,47,38,85,170,182,352,22,12,34,4,3:58
9300,491972,2017-08-22,2017,SFN,MIL,3,4,4-3,MIL,9,0,40,40,80,141,164,305,16,13,29,2,3:15
9301,491968,2017-08-22,2017,CIN,CHN,9,13,13-9,CHN,9,0,44,50,94,200,176,376,18,24,42,3,4:04
9302,491995,2017-08-23,2017,HOU,WAS,6,1,6-1,HOU,9,1,39,32,71,113,139,252,16,7,23,2,2:48
9303,491981,2017-08-23,2017,NYN,ARI,4,2,4-2,NYN,9,1,36,39,75,148,143,291,15,13,28,2,3:15
9304,491993,2017-08-23,2017,ANA,TEX,5,7,7-5,TEX,10,0,41,46,87,164,157,321,12,19,31,2,3:41
9305,491989,2017-08-23,2017,DET,NYA,2,10,10-2,NYA,9,0,38,43,81,152,146,298,11,17,28,1,2:55
9306,491984,2017-08-23,2017,KCA,COL,6,4,6-4,KCA,9,0,40,39,79,167,157,324,16,14,30,3,3:36
9307,491988,2017-08-23,2017,CHA,MIN,4,3,4-3,CHA,9,0,35,33,68,139,120,259,13,6,19,1,2:43
9308,491987,2017-08-23,2017,SFN,MIL,4,2,4-2,SFN,9,1,36,34,70,143,135,278,13,9,22,1,3:08
9309,491986,2017-08-23,2017,PHI,MIA,8,0,8-0,PHI,9,1,39,30,69,122,160,282,16,4,20,1,2:50
9310,491985,2017-08-23,2017,PIT,LAN,1,0,1-0,PIT,10,0,29,41,70,136,99,235,1,14,15,0,2:34
9311,491991,2017-08-23,2017,SLN,SDN,6,2,6-2,SLN,9,1,42,35,77,147,149,296,21,8,29,2,2:53
9312,491983,2017-08-23,2017,CIN,CHN,3,9,9-3,CHN,9,0,34,43,77,165,135,300,8,16,24,1,2:55
9313,491994,2017-08-23,2017,TBA,TOR,6,7,7-6,TOR,9,0,41,39,80,155,154,309,15,13,28,5,3:13
9314,491982,2017-08-23,2017,CLE,BOS,1,6,6-1,BOS,9,0,36,38,74,148,159,307,9,11,20,5,3:11
9315,491992,2017-08-23,2017,ATL,SEA,6,9,9-6,SEA,9,0,43,47,90,144,144,288,17,22,39,3,3:07
9316,491990,2017-08-23,2017,BAL,OAK,8,7,8-7,BAL,12,0,47,54,101,206,195,401,17,19,36,5,4:20
9317,492006,2017-08-24,2017,TBA,TOR,2,0,2-0,TBA,9,1,34,35,69,169,145,314,10,8,18,3,3:21
9318,492001,2017-08-24,2017,PHI,MIA,8,9,9-8,MIA,9,0,42,46,88,152,151,303,17,21,38,1,3:14
9319,491997,2017-08-24,2017,CLE,BOS,13,6,13-6,CLE,9,1,47,39,86,171,174,345,24,14,38,4,3:28
9320,491999,2017-08-24,2017,KCA,COL,2,3,3-2,COL,9,0,36,38,74,127,136,263,11,13,24,3,2:43
9321,492005,2017-08-24,2017,ANA,TEX,0,3,3-0,TEX,9,0,35,34,69,135,133,268,9,8,17,0,2:46
9322,492004,2017-08-24,2017,SLN,SDN,3,4,4-3,SDN,9,0,37,42,79,151,121,272,14,17,31,4,3:06
9323,491998,2017-08-24,2017,CIN,CHN,4,2,4-2,CIN,9,1,36,36,72,127,147,274,14,12,26,1,2:47
9324,492007,2017-08-24,2017,HOU,WAS,4,5,5-4,WAS,11,0,42,43,85,176,163,339,11,9,20,0,3:47
9325,492002,2017-08-24,2017,CHA,MIN,5,1,5-1,CHA,9,1,33,36,69,158,150,308,9,10,19,2,2:53
9326,491996,2017-08-24,2017,NYN,ARI,2,3,3-2,ARI,9,0,40,39,79,165,176,341,15,15,30,4,3:45
9327,492000,2017-08-24,2017,PIT,LAN,2,5,5-2,LAN,9,0,38,47,85,203,148,351,11,22,33,3,3:37
9328,492003,2017-08-24,2017,DET,NYA,10,6,10-6,DET,9,1,44,39,83,154,178,332,21,13,34,7,4:13
9329,492014,2017-08-25,2017,LAN,MIL,3,1,3-1,LAN,9,1,36,30,66,117,157,274,12,4,16,1,3:00
9330,492018,2017-08-25,2017,MIA,SDN,8,6,8-6,MIA,9,1,37,37,74,130,155,285,14,10,24,1,2:53
9331,492008,2017-08-25,2017,BOS,BAL,3,16,16-3,BAL,9,0,37,52,89,199,146,345,8,23,31,1,3:37
9332,492011,2017-08-25,2017,CHA,DET,3,2,3-2,CHA,9,0,34,33,67,116,119,235,14,7,21,0,2:44
9333,492022,2017-08-25,2017,OAK,TEX,3,1,3-1,OAK,9,1,30,34,64,131,113,244,6,10,16,0,2:26
9334,492010,2017-08-25,2017,ATL,COL,5,2,5-2,ATL,9,1,36,32,68,109,130,239,12,6,18,1,2:32
9335,492012,2017-08-25,2017,ANA,HOU,1,2,2-1,HOU,9,0,36,35,71,128,151,279,10,8,18,0,2:56
9336,492019,2017-08-25,2017,ARI,SFN,4,3,4-3,ARI,9,1,33,33,66,146,132,278,10,8,18,3,2:54
9337,492015,2017-08-25,2017,TOR,MIN,1,6,6-1,MIN,9,0,39,42,81,162,127,289,12,15,27,2,3:05
9338,492013,2017-08-25,2017,CLE,KCA,4,0,4-0,CLE,9,1,36,35,71,128,155,283,13,9,22,4,2:44
9339,492016,2017-08-25,2017,WAS,NYN,2,4,4-2,NYN,9,0,37,40,77,158,139,297,10,14,24,2,3:08
9340,492021,2017-08-25,2017,SLN,TBA,3,7,7-3,TBA,9,0,35,47,82,195,138,333,9,22,31,3,3:38
9341,492009,2017-08-25,2017,PHI,CHN,7,1,7-1,PHI,9,1,36,39,75,147,135,282,16,12,28,0,3:00
9342,492017,2017-08-25,2017,CIN,PIT,9,5,9-5,CIN,9,1,42,41,83,174,170,344,17,16,33,3,3:35
9343,492020,2017-08-25,2017,NYA,SEA,1,2,2-1,SEA,11,0,47,44,91,158,205,363,14,11,25,3,3:51
9344,492023,2017-08-26,2017,BOS,BAL,0,7,7-0,BAL,9,0,34,37,71,153,142,295,8,11,19,2,2:58
9345,492026,2017-08-26,2017,CHA,DET,3,6,6-3,DET,9,0,38,42,80,150,141,291,11,14,25,4,3:14
9346,492031,2017-08-26,2017,WAS,NYN,9,4,9-4,WAS,9,1,41,38,79,149,136,285,18,13,31,1,3:03
9347,492025,2017-08-26,2017,ATL,COL,6,7,7-6,COL,9,0,38,43,81,180,119,299,15,17,32,3,3:24
9348,492024,2017-08-26,2017,PHI,CHN,2,17,17-2,CHN,9,0,33,47,80,196,114,310,8,20,28,1,3:03
9349,492035,2017-08-26,2017,NYA,SEA,6,3,6-3,NYA,9,1,38,38,76,149,162,311,15,10,25,2,3:25
9350,492030,2017-08-26,2017,TOR,MIN,10,9,10-9,TOR,9,1,42,39,81,157,155,312,18,12,30,5,3:04
9351,492036,2017-08-26,2017,SLN,TBA,6,4,6-4,SLN,9,0,38,33,71,95,148,243,14,6,20,1,2:30
9352,492028,2017-08-26,2017,CLE,KCA,4,0,4-0,CLE,9,1,33,34,67,147,113,260,9,7,16,1,2:38
9353,492034,2017-08-26,2017,ARI,SFN,2,1,2-1,ARI,9,1,30,33,63,141,124,265,7,6,13,1,2:34
9354,492032,2017-08-26,2017,CIN,PIT,0,1,1-0,PIT,9,0,31,31,62,134,127,261,5,5,10,0,2:28
9355,492027,2017-08-26,2017,ANA,HOU,7,6,7-6,ANA,9,1,33,38,71,153,139,292,10,10,20,2,3:01 (:40 delay)
9356,492029,2017-08-26,2017,LAN,MIL,0,3,3-0,MIL,9,0,32,35,67,147,139,286,5,8,13,0,2:58
9357,492037,2017-08-26,2017,OAK,TEX,8,3,8-3,OAK,9,1,38,39,77,172,158,330,17,13,30,2,3:21
9358,492033,2017-08-26,2017,MIA,SDN,2,1,2-1,MIA,11,0,44,42,86,170,182,352,14,8,22,2,3:53
9359,491372,2017-08-27,2017,WAS,NYN,5,4,5-4,WAS,9,1,33,38,71,166,142,308,10,11,21,3,3:21
9360,492049,2017-08-27,2017,ARI,SFN,11,0,11-0,ARI,9,1,43,31,74,118,167,285,20,7,27,4,3:03
9361,492044,2017-08-27,2017,LAN,MIL,2,3,3-2,MIL,9,0,35,36,71,158,144,302,9,12,21,2,3:31
9362,492050,2017-08-27,2017,NYA,SEA,10,1,10-1,NYA,9,1,44,34,78,119,150,269,19,7,26,1,2:57
9363,492048,2017-08-27,2017,MIA,SDN,6,2,6-2,MIA,9,1,34,36,70,134,111,245,12,10,22,1,2:31
9364,492041,2017-08-27,2017,CHA,DET,7,1,7-1,CHA,9,1,36,35,71,135,135,270,12,9,21,0,2:44
9365,492042,2017-08-27,2017,ANA,HOU,5,7,7-5,HOU,9,0,39,38,77,144,152,296,15,14,29,0,3:16
9366,492051,2017-08-27,2017,SLN,TBA,2,3,3-2,TBA,10,0,40,42,82,155,154,309,10,14,24,3,3:33
9367,492043,2017-08-27,2017,CLE,KCA,12,0,12-0,CLE,9,1,44,32,76,106,167,273,23,6,29,1,2:39
9368,492040,2017-08-27,2017,ATL,COL,0,3,3-0,COL,9,0,34,39,73,158,134,292,10,14,24,3,3:09
9369,492038,2017-08-27,2017,BOS,BAL,1,2,2-1,BAL,9,0,41,35,76,139,183,322,16,8,24,4,3:22
9370,492039,2017-08-27,2017,PHI,CHN,6,3,6-3,PHI,9,1,34,37,71,153,130,283,9,11,20,2,2:54
9371,492052,2017-08-27,2017,OAK,TEX,8,3,8-3,OAK,9,1,41,37,78,145,171,316,17,10,27,5,3:20
9372,491372,2017-08-27,2017,WAS,NYN,5,4,5-4,WAS,9,1,33,38,71,166,142,308,10,11,21,3,3:21
9373,492045,2017-08-27,2017,TOR,MIN,2,7,7-2,MIN,9,0,34,44,78,184,141,325,8,17,25,3,3:18
9374,492047,2017-08-27,2017,CIN,PIT,2,5,5-2,PIT,9,0,40,40,80,163,177,340,13,16,29,1,3:18
9375,492046,2017-08-27,2017,WAS,NYN,5,6,6-5,NYN,9,0,45,40,85,156,183,339,19,13,32,7,3:34
9376,492062,2017-08-28,2017,KCA,TBA,0,12,12-0,TBA,9,0,30,41,71,143,117,260,4,17,21,1,2:43
9377,492059,2017-08-28,2017,CHN,PIT,6,1,6-1,CHN,9,1,39,32,71,123,149,272,17,7,24,1,2:50
9378,492058,2017-08-28,2017,ANA,OAK,3,1,3-1,ANA,9,1,33,35,68,147,120,267,10,9,19,1,2:53
9379,492060,2017-08-28,2017,SDN,SFN,0,3,3-0,SFN,9,0,29,39,68,148,102,250,3,14,17,0,2:31
9380,492056,2017-08-28,2017,COL,DET,3,4,4-3,DET,9,0,41,36,77,152,155,307,15,12,27,3,3:29
9381,492061,2017-08-28,2017,BAL,SEA,7,6,7-6,BAL,9,1,40,38,78,144,128,272,19,13,32,3,3:01
9382,492054,2017-08-28,2017,TOR,BOS,5,6,6-5,BOS,9,0,41,41,82,170,148,318,15,17,32,2,3:23
9383,492057,2017-08-28,2017,WAS,MIA,11,2,11-2,WAS,9,1,41,37,78,142,188,330,17,12,29,1,3:06
9384,492055,2017-08-28,2017,NYA,CLE,2,6,6-2,CLE,9,0,32,36,68,148,120,268,4,10,14,1,2:42
9385,492053,2017-08-28,2017,PHI,ATL,6,1,6-1,PHI,9,1,37,33,70,126,138,264,13,8,21,2,2:52
9386,492074,2017-08-29,2017,BAL,SEA,4,0,4-0,BAL,9,1,33,33,66,116,130,246,12,4,16,0,2:26 (:32 delay)
9387,492073,2017-08-29,2017,SDN,SFN,6,3,6-3,SDN,9,1,36,38,74,125,121,246,13,11,24,0,2:38
9388,492064,2017-08-29,2017,TOR,BOS,0,3,3-0,BOS,9,0,31,35,66,143,149,292,4,10,14,2,2:44
9389,492067,2017-08-29,2017,COL,DET,7,3,7-3,COL,9,1,35,33,68,122,144,266,12,8,20,3,3:08
9390,492069,2017-08-29,2017,WAS,MIA,8,3,8-3,WAS,9,1,38,40,78,152,140,292,19,13,32,3,3:11 (:26 delay)
9391,492065,2017-08-29,2017,MIN,CHA,6,4,6-4,MIN,9,1,35,40,75,150,132,282,13,14,27,3,3:12
9392,492068,2017-08-29,2017,ARI,LAN,7,6,7-6,ARI,9,1,34,40,74,173,138,311,11,13,24,3,3:08
9393,492076,2017-08-29,2017,KCA,TBA,6,2,6-2,KCA,9,1,37,34,71,125,133,258,12,7,19,2,2:57
9394,492071,2017-08-29,2017,ANA,OAK,8,2,8-2,ANA,9,1,37,36,73,142,129,271,13,10,23,4,2:53
9395,492072,2017-08-29,2017,CHN,PIT,4,1,4-1,CHN,9,1,34,35,69,139,125,264,13,9,22,3,2:49
9396,492075,2017-08-29,2017,MIL,SLN,2,10,10-2,SLN,9,0,37,50,87,209,146,355,10,20,30,2,3:33
9397,492070,2017-08-29,2017,CIN,NYN,14,4,14-4,CIN,9,1,48,40,88,166,179,345,25,15,40,4,3:30
9398,492077,2017-08-29,2017,HOU,TEX,2,12,12-2,TEX,9,0,38,46,84,193,140,333,13,19,32,0,3:27
9399,492078,2017-08-30,2017,PHI,ATL,1,9,9-1,ATL,9,0,34,47,81,156,134,290,8,21,29,1,2:49
9400,492066,2017-08-30,2017,NYA,CLE,4,9,9-4,CLE,9,0,36,45,81,194,125,319,11,18,29,3,3:04
9401,492092,2017-08-30,2017,HOU,TEX,1,8,8-1,TEX,9,0,32,43,75,161,120,281,4,18,22,0,2:52
9402,492066,2017-08-30,2017,NYA,CLE,4,9,9-4,CLE,9,0,36,45,81,194,125,319,11,18,29,3,3:04
9403,492085,2017-08-30,2017,CIN,NYN,0,2,2-0,NYN,9,0,32,33,65,116,128,244,8,7,15,1,2:27
9404,492084,2017-08-30,2017,WAS,MIA,4,0,4-0,WAS,9,1,36,33,69,110,150,260,16,8,24,0,2:36
9405,492091,2017-08-30,2017,KCA,TBA,3,5,5-3,TBA,9,0,34,35,69,129,126,255,8,9,17,3,2:39
9406,492089,2017-08-30,2017,BAL,SEA,8,7,8-7,BAL,9,1,39,38,77,129,140,269,16,12,28,6,3:07
9407,492090,2017-08-30,2017,MIL,SLN,6,5,6-5,MIL,9,1,35,35,70,149,126,275,10,8,18,2,2:40
9408,492081,2017-08-30,2017,NYA,CLE,1,2,2-1,CLE,9,0,36,38,74,152,153,305,10,12,22,4,3:12
9409,492083,2017-08-30,2017,ARI,LAN,6,4,6-4,ARI,9,1,37,40,77,156,125,281,14,13,27,3,3:05
9410,492082,2017-08-30,2017,COL,DET,2,6,6-2,DET,9,0,35,41,76,149,145,294,8,16,24,0,3:03
9411,492080,2017-08-30,2017,MIN,CHA,11,1,11-1,MIN,9,1,48,36,84,117,182,299,25,9,34,2,3:17
9412,492063,2017-08-30,2017,PHI,ATL,2,5,5-2,ATL,9,0,37,43,80,145,158,303,10,18,28,4,3:17
9413,492063,2017-08-30,2017,PHI,ATL,2,5,5-2,ATL,9,0,37,43,80,145,158,303,10,18,28,4,3:17
9414,492086,2017-08-30,2017,ANA,OAK,10,8,10-8,ANA,9,1,40,41,81,167,154,321,17,15,32,4,3:34
9415,492087,2017-08-30,2017,CHN,PIT,17,3,17-3,CHN,9,1,47,35,82,145,168,313,22,8,30,2,3:12
9416,492088,2017-08-30,2017,SDN,SFN,5,0,5-0,SDN,9,1,35,37,72,169,137,306,11,12,23,3,3:02
9417,492079,2017-08-30,2017,TOR,BOS,1,7,7-1,BOS,9,0,34,41,75,181,132,313,8,16,24,2,2:58
9418,492102,2017-08-31,2017,MIL,WAS,6,3,6-3,MIL,9,1,38,34,72,119,152,271,16,9,25,0,2:50
9419,492098,2017-08-31,2017,MIA,PHI,2,3,3-2,PHI,9,0,41,37,78,159,148,307,15,11,26,1,3:09
9420,492095,2017-08-31,2017,MIN,CHA,5,4,5-4,MIN,9,0,41,40,81,138,158,296,15,15,30,2,3:17
9421,492101,2017-08-31,2017,BAL,TOR,8,11,11-8,TOR,9,0,43,43,86,153,165,318,17,17,34,3,3:28
9422,492093,2017-08-31,2017,CHN,ATL,6,2,6-2,CHN,9,1,41,36,77,149,162,311,16,10,26,1,2:59
9423,492094,2017-08-31,2017,NYA,BOS,6,2,6-2,NYA,9,1,41,41,82,155,149,304,19,14,33,3,3:44
9424,492099,2017-08-31,2017,SFN,SLN,2,5,5-2,SLN,9,0,35,42,77,166,132,298,9,14,23,3,3:17
9425,492100,2017-08-31,2017,HOU,TEX,5,1,5-1,HOU,9,1,33,35,68,154,122,276,12,9,21,2,3:02
9426,492096,2017-08-31,2017,ARI,LAN,8,1,8-1,ARI,9,1,36,35,71,143,142,285,14,8,22,0,3:02
9427,492097,2017-08-31,2017,CIN,NYN,7,2,7-2,CIN,9,1,38,37,75,137,125,262,14,11,25,2,2:42
9428,491296,2017-09-01,2017,DET,CLE,2,3,3-2,CLE,9,0,39,38,77,169,154,323,13,13,26,2,3:25
9429,491296,2017-09-01,2017,DET,CLE,2,3,3-2,CLE,9,0,39,38,77,169,154,323,13,13,26,2,3:25
9430,492104,2017-09-01,2017,CHN,ATL,2,0,2-0,CHN,9,1,34,31,65,106,145,251,12,5,17,3,2:38
9431,492105,2017-09-01,2017,NYA,BOS,1,4,4-1,BOS,9,0,32,36,68,130,124,254,5,8,13,0,2:44
9432,492113,2017-09-01,2017,MIA,PHI,1,2,2-1,PHI,9,0,32,37,69,128,128,256,7,10,17,1,2:44
9433,492112,2017-09-01,2017,SEA,OAK,3,2,3-2,SEA,9,1,33,35,68,135,124,259,12,10,22,4,2:32
9434,492110,2017-09-01,2017,SDN,LAN,0,1,1-0,LAN,9,0,29,38,67,152,107,259,2,14,16,1,2:57
9435,492103,2017-09-01,2017,COL,ARI,5,9,9-5,ARI,9,0,44,42,86,162,168,330,17,19,36,6,3:48
9436,492116,2017-09-01,2017,BAL,TOR,1,0,1-0,BAL,13,0,48,49,97,216,185,401,12,10,22,3,4:27
9437,492115,2017-09-01,2017,CHA,TBA,1,3,3-1,TBA,9,0,34,35,69,123,118,241,9,7,16,3,2:34
9438,492117,2017-09-01,2017,MIL,WAS,1,0,1-0,MIL,9,1,31,34,65,132,125,257,9,8,17,1,2:39
9439,492108,2017-09-01,2017,MIN,KCA,6,7,7-6,KCA,9,0,40,40,80,154,152,306,12,15,27,5,3:23
9440,492106,2017-09-01,2017,PIT,CIN,3,7,7-3,CIN,9,0,36,38,74,142,169,311,9,13,22,0,3:00
9441,492107,2017-09-01,2017,DET,CLE,0,10,10-0,CLE,9,0,34,46,80,187,133,320,8,20,28,2,3:04
9442,492114,2017-09-01,2017,SFN,SLN,6,11,11-6,SLN,9,0,41,44,85,171,147,318,15,18,33,5,3:23
9443,492109,2017-09-01,2017,TEX,ANA,10,9,10-9,TEX,9,1,44,49,93,189,191,380,19,22,41,7,4:33
9444,490565,2017-09-02,2017,SDN,LAN,6,5,6-5,SDN,9,0,40,37,77,117,179,296,16,14,30,1,3:11
9445,492132,2017-09-02,2017,MIL,WAS,2,3,3-2,WAS,9,0,35,35,70,133,131,264,9,10,19,3,3:01
9446,492118,2017-09-02,2017,COL,ARI,2,6,6-2,ARI,9,0,35,42,77,179,157,336,8,14,22,4,3:38
9447,492127,2017-09-02,2017,SEA,OAK,7,6,7-6,SEA,9,0,41,42,83,193,154,347,15,16,31,5,3:37
9448,492128,2017-09-02,2017,MIA,PHI,10,9,10-9,MIA,9,1,44,45,89,181,170,351,19,19,38,2,3:37
9449,492120,2017-09-02,2017,NYA,BOS,5,1,5-1,NYA,9,1,36,34,70,122,140,262,11,8,19,3,2:58
9450,492129,2017-09-02,2017,SFN,SLN,2,1,2-1,SFN,10,0,33,34,67,151,122,273,8,5,13,3,2:58
9451,492130,2017-09-02,2017,CHA,TBA,5,4,5-4,CHA,9,1,34,40,74,158,130,288,12,14,26,5,3:14 (1:18 delay)
9452,490565,2017-09-02,2017,SDN,LAN,6,5,6-5,SDN,9,0,40,37,77,117,179,296,16,14,30,1,3:11
9453,492122,2017-09-02,2017,DET,CLE,2,5,5-2,CLE,9,0,37,43,80,158,137,295,11,16,27,2,3:02
9454,492121,2017-09-02,2017,PIT,CIN,5,0,5-0,PIT,9,1,39,33,72,142,154,296,15,8,23,1,2:53
9455,492131,2017-09-02,2017,BAL,TOR,2,7,7-2,TOR,9,0,36,39,75,157,139,296,10,12,22,3,3:02
9456,492126,2017-09-02,2017,HOU,NYN,4,1,4-1,HOU,9,1,34,37,71,164,130,294,12,11,23,4,3:15
9457,492123,2017-09-02,2017,MIN,KCA,17,0,17-0,MIN,9,1,46,33,79,115,211,326,23,7,30,2,3:05
9458,492125,2017-09-02,2017,SDN,LAN,7,2,7-2,SDN,9,1,41,37,78,150,178,328,18,11,29,5,3:40
9459,492111,2017-09-02,2017,HOU,NYN,12,8,12-8,HOU,9,1,45,41,86,178,174,352,20,14,34,3,3:27
9460,492119,2017-09-02,2017,CHN,ATL,14,12,14-12,CHN,9,1,44,48,92,198,161,359,20,22,42,6,3:49
9461,492124,2017-09-02,2017,TEX,ANA,4,7,7-4,ANA,10,0,42,45,87,192,188,380,13,15,28,4,4:09
9462,492111,2017-09-02,2017,HOU,NYN,12,8,12-8,HOU,9,1,45,41,86,178,174,352,20,14,34,3,3:27
9463,492134,2017-09-03,2017,CHN,ATL,1,5,5-1,ATL,9,0,33,38,71,132,121,253,8,12,20,0,2:43
9464,492145,2017-09-03,2017,CHA,TBA,6,2,6-2,CHA,9,1,36,33,69,149,119,268,12,6,18,2,2:50
9465,492146,2017-09-03,2017,BAL,TOR,5,4,5-4,BAL,12,0,52,45,97,166,150,316,20,12,32,3,3:40
9466,492137,2017-09-03,2017,DET,CLE,1,11,11-1,CLE,9,0,32,52,84,213,112,325,10,26,36,4,3:16
9467,492143,2017-09-03,2017,MIA,PHI,1,3,3-1,PHI,12,0,42,48,90,183,174,357,7,14,21,0,3:46
9468,492147,2017-09-03,2017,MIL,WAS,7,2,7-2,MIL,9,1,35,32,67,122,152,274,11,6,17,1,2:49
9469,492142,2017-09-03,2017,SEA,OAK,10,2,10-2,SEA,9,1,45,33,78,153,163,316,24,7,31,3,3:21
9470,492136,2017-09-03,2017,PIT,CIN,3,1,3-1,PIT,9,1,34,38,72,132,131,263,10,14,24,1,2:49
9471,492140,2017-09-03,2017,SDN,LAN,6,4,6-4,SDN,9,1,36,34,70,129,134,263,14,7,21,1,2:51
9472,492141,2017-09-03,2017,HOU,NYN,8,6,8-6,HOU,9,1,38,44,82,170,130,300,15,20,35,3,3:14
9473,492144,2017-09-03,2017,SFN,SLN,3,7,7-3,SLN,9,0,36,40,76,138,142,280,10,14,24,2,2:45
9474,492133,2017-09-03,2017,COL,ARI,1,5,5-1,ARI,9,0,37,37,74,138,149,287,11,9,20,3,3:13
9475,492138,2017-09-03,2017,MIN,KCA,4,5,5-4,KCA,9,0,37,37,74,152,154,306,11,13,24,4,3:18
9476,492139,2017-09-03,2017,TEX,ANA,7,6,7-6,TEX,9,1,39,45,84,186,171,357,17,20,37,3,3:49
9477,492135,2017-09-03,2017,NYA,BOS,9,2,9-2,NYA,9,1,42,36,78,158,192,350,18,7,25,4,3:46
9478,492151,2017-09-04,2017,SEA,HOU,2,6,6-2,HOU,9,0,35,41,76,151,128,279,9,16,25,3,2:53
9479,492159,2017-09-04,2017,SDN,SLN,0,2,2-0,SLN,9,0,33,36,69,129,109,238,6,11,17,0,2:23
9480,492150,2017-09-04,2017,CHA,CLE,3,5,5-3,CLE,9,0,36,38,74,156,140,296,11,14,25,3,3:12
9481,492160,2017-09-04,2017,ATL,TEX,2,8,8-2,TEX,9,0,37,40,77,147,149,296,10,15,25,1,2:50
9482,492156,2017-09-04,2017,BAL,NYA,4,7,7-4,NYA,9,0,36,43,79,186,145,331,9,19,28,4,3:25
9483,492155,2017-09-04,2017,TBA,MIN,11,4,11-4,TBA,9,1,41,36,77,164,143,307,19,9,28,5,3:23
9484,492162,2017-09-04,2017,MIA,WAS,2,7,7-2,WAS,9,0,36,39,75,166,152,318,11,12,23,2,3:10
9485,492161,2017-09-04,2017,BOS,TOR,4,10,10-4,TOR,9,0,41,44,85,173,158,331,13,17,30,5,3:25
9486,492158,2017-09-04,2017,COL,SFN,4,3,4-3,COL,9,0,42,33,75,130,172,302,17,7,24,2,3:14
9487,492153,2017-09-04,2017,OAK,ANA,9,11,11-9,ANA,11,0,49,52,101,210,206,416,20,20,40,7,4:38
9488,492154,2017-09-04,2017,CIN,MIL,5,4,5-4,CIN,9,0,37,34,71,139,137,276,11,9,20,2,3:03
9489,492148,2017-09-04,2017,LAN,ARI,0,13,13-0,ARI,9,0,31,42,73,165,130,295,4,16,20,2,3:00
9490,492149,2017-09-04,2017,PIT,CHN,12,0,12-0,PIT,9,1,43,35,78,140,165,305,20,9,29,2,3:05
9491,492152,2017-09-04,2017,DET,KCA,6,7,7-6,KCA,9,0,43,43,86,140,177,317,16,17,33,1,3:13
9492,492157,2017-09-04,2017,NYN,PHI,11,7,11-7,NYN,9,1,41,40,81,167,148,315,16,15,31,4,3:18
9493,492174,2017-09-05,2017,SDN,SLN,4,8,8-4,SLN,9,0,35,39,74,157,132,289,12,13,25,1,2:47
9494,492172,2017-09-05,2017,NYN,PHI,1,9,9-1,PHI,9,0,36,47,83,176,137,313,10,21,31,1,3:04
9495,492171,2017-09-05,2017,BAL,NYA,7,6,7-6,BAL,9,0,38,42,80,173,155,328,12,15,27,3,3:34 (2:14 delay)
9496,492173,2017-09-05,2017,COL,SFN,9,6,9-6,COL,9,1,39,42,81,171,150,321,15,17,32,8,3:31
9497,492167,2017-09-05,2017,DET,KCA,13,2,13-2,DET,9,1,43,36,79,143,163,306,18,10,28,2,3:00
9498,492169,2017-09-05,2017,CIN,MIL,9,3,9-3,CIN,9,1,39,39,78,174,160,334,16,15,31,4,3:26
9499,492168,2017-09-05,2017,OAK,ANA,7,8,8-7,ANA,10,0,48,46,94,199,169,368,19,17,36,5,4:12
9500,492165,2017-09-05,2017,CHA,CLE,4,9,9-4,CLE,9,0,42,45,87,173,172,345,16,20,36,6,3:43
9501,492164,2017-09-05,2017,PIT,CHN,4,3,4-3,PIT,9,1,32,38,70,135,119,254,11,11,22,1,2:35
9502,492177,2017-09-05,2017,MIA,WAS,1,2,2-1,WAS,9,0,34,36,70,135,144,279,7,11,18,1,2:50
9503,492166,2017-09-05,2017,SEA,HOU,1,3,3-1,HOU,9,0,34,36,70,162,134,296,8,9,17,1,3:07
9504,492176,2017-09-05,2017,BOS,TOR,3,2,3-2,BOS,19,0,68,71,139,287,257,544,16,16,32,2,6:00
9505,492163,2017-09-05,2017,LAN,ARI,1,3,3-1,ARI,10,0,34,43,77,178,142,320,7,14,21,1,3:42
9506,492170,2017-09-05,2017,TBA,MIN,2,1,2-1,TBA,9,1,32,31,63,129,103,232,7,6,13,4,2:32
9507,492187,2017-09-06,2017,NYN,PHI,6,3,6-3,NYN,6,0,27,24,51,86,122,208,11,6,17,0,1:53 (:57 delay)
9508,492184,2017-09-06,2017,CIN,MIL,7,1,7-1,CIN,9,1,37,31,68,124,150,274,16,4,20,4,2:44
9509,492191,2017-09-06,2017,BOS,TOR,6,1,6-1,BOS,9,1,38,35,73,129,154,283,15,7,22,2,2:57
9510,492190,2017-09-06,2017,ATL,TEX,5,4,5-4,ATL,9,1,35,41,76,156,135,291,11,15,26,2,3:03
9511,492185,2017-09-06,2017,TBA,MIN,6,10,10-6,MIN,9,0,37,42,79,169,136,305,13,17,30,6,3:17
9512,492188,2017-09-06,2017,COL,SFN,3,11,11-3,SFN,9,0,37,48,85,175,154,329,10,20,30,2,3:32
9513,492175,2017-09-06,2017,ATL,TEX,8,12,12-8,TEX,9,0,44,44,88,166,177,343,17,18,35,2,3:30
9514,492189,2017-09-06,2017,SDN,SLN,1,3,3-1,SLN,9,0,36,35,71,147,140,287,11,10,21,1,2:58
9515,492178,2017-09-06,2017,LAN,ARI,1,3,3-1,ARI,9,0,33,41,74,161,139,300,8,14,22,1,3:18
9516,492192,2017-09-06,2017,MIA,WAS,1,8,8-1,WAS,9,0,37,41,78,152,165,317,11,18,29,0,3:02
9517,492175,2017-09-06,2017,ATL,TEX,8,12,12-8,TEX,9,0,44,44,88,166,177,343,17,18,35,2,3:30
9518,492181,2017-09-06,2017,SEA,HOU,3,5,5-3,HOU,9,0,35,39,74,129,123,252,9,12,21,4,2:46
9519,492179,2017-09-06,2017,PIT,CHN,0,1,1-0,CHN,9,0,33,34,67,127,150,277,8,8,16,0,3:05
9520,492183,2017-09-06,2017,OAK,ANA,3,1,3-1,OAK,9,1,34,37,71,159,137,296,10,10,20,2,3:10
9521,492182,2017-09-06,2017,DET,KCA,2,13,13-2,KCA,9,0,40,47,87,150,148,298,13,22,35,3,3:27
9522,492180,2017-09-06,2017,CHA,CLE,1,5,5-1,CLE,9,0,28,43,71,168,97,265,3,15,18,2,2:48
9523,492194,2017-09-07,2017,NYN,CIN,7,2,7-2,NYN,9,1,40,34,74,122,148,270,18,8,26,0,2:38
9524,492198,2017-09-07,2017,KCA,MIN,2,4,4-2,MIN,9,0,33,41,74,147,115,262,11,16,27,2,2:56
9525,492199,2017-09-07,2017,WAS,PHI,4,3,4-3,WAS,9,1,36,36,72,141,146,287,14,9,23,1,3:09
9526,492193,2017-09-07,2017,PIT,CHN,2,8,8-2,CHN,9,0,40,42,82,140,173,313,14,16,30,1,3:13 (:52 delay)
9527,492196,2017-09-07,2017,LAN,COL,1,9,9-1,COL,9,0,35,48,83,178,164,342,9,23,32,2,3:35
9528,492195,2017-09-07,2017,CHA,CLE,2,11,11-2,CLE,9,0,31,47,78,182,117,299,5,21,26,1,2:58
9529,492197,2017-09-07,2017,ATL,MIA,6,5,6-5,ATL,9,0,41,41,82,155,167,322,17,16,33,3,3:23
9530,492200,2017-09-07,2017,SDN,SLN,3,0,3-0,SDN,9,1,36,37,73,156,147,303,13,12,25,1,3:03
9531,492186,2017-09-07,2017,BAL,NYA,1,9,9-1,NYA,9,0,35,43,78,190,144,334,9,17,26,2,3:19
9532,492186,2017-09-07,2017,BAL,NYA,1,9,9-1,NYA,9,0,35,43,78,190,144,334,9,17,26,2,3:19
9533,492212,2017-09-08,2017,SLN,PIT,4,1,4-1,SLN,9,1,33,35,68,161,124,285,10,10,20,3,2:58
9534,492209,2017-09-08,2017,KCA,MIN,5,8,8-5,MIN,9,0,35,43,78,165,115,280,10,16,26,4,3:05
9535,492205,2017-09-08,2017,OAK,HOU,9,8,9-8,OAK,9,0,39,41,80,150,132,282,17,17,34,2,3:06
9536,492206,2017-09-08,2017,SEA,ANA,4,3,4-3,SEA,9,1,37,34,71,142,166,308,13,8,21,5,3:09
9537,492210,2017-09-08,2017,TEX,NYA,11,5,11-5,TEX,9,1,41,38,79,155,159,314,18,11,29,5,3:23
9538,492214,2017-09-08,2017,CHA,SFN,2,9,9-2,SFN,9,0,37,42,79,173,128,301,9,15,24,4,3:07
9539,492203,2017-09-08,2017,LAN,COL,4,5,5-4,COL,9,0,41,36,77,161,172,333,14,11,25,1,3:32
9540,492213,2017-09-08,2017,ARI,SDN,6,10,10-6,SDN,9,0,40,44,84,148,172,320,12,21,33,6,3:36
9541,492201,2017-09-08,2017,CLE,BAL,5,0,5-0,CLE,9,1,35,33,68,141,148,289,15,7,22,3,2:41
9542,492202,2017-09-08,2017,NYN,CIN,5,1,5-1,NYN,9,1,34,37,71,137,126,263,12,10,22,2,2:42
9543,492215,2017-09-08,2017,BOS,TBA,9,3,9-3,BOS,9,1,39,37,76,149,157,306,15,10,25,3,3:14
9544,492211,2017-09-08,2017,WAS,PHI,11,10,11-10,WAS,9,1,44,44,88,172,149,321,19,19,38,2,3:27
9545,492204,2017-09-08,2017,TOR,DET,4,5,5-4,DET,9,0,35,35,70,133,125,258,11,8,19,2,2:34
9546,492207,2017-09-08,2017,ATL,MIA,1,7,7-1,MIA,9,0,39,42,81,173,163,336,12,17,29,3,3:16
9547,492208,2017-09-08,2017,CHN,MIL,0,2,2-0,MIL,9,0,35,34,69,132,132,264,9,9,18,1,2:51
9548,490275,2017-09-09,2017,OAK,HOU,11,4,11-4,OAK,9,1,39,37,76,119,143,262,16,11,27,3,2:48
9549,492225,2017-09-09,2017,TEX,NYA,1,3,3-1,NYA,9,0,32,39,71,145,121,266,4,13,17,3,2:57
9550,492216,2017-09-09,2017,CLE,BAL,4,2,4-2,CLE,9,1,35,32,67,132,140,272,11,5,16,4,2:52
9551,492223,2017-09-09,2017,CHN,MIL,2,15,15-2,MIL,9,0,35,49,84,183,144,327,8,22,30,1,3:09
9552,492220,2017-09-09,2017,OAK,HOU,11,1,11-1,OAK,9,1,49,34,83,138,222,360,24,9,33,4,3:42
9553,492227,2017-09-09,2017,SLN,PIT,4,3,4-3,SLN,9,1,33,38,71,156,125,281,9,12,21,0,2:55
9554,490275,2017-09-09,2017,OAK,HOU,11,4,11-4,OAK,9,1,39,37,76,119,143,262,16,11,27,3,2:48
9555,492217,2017-09-09,2017,NYN,CIN,6,1,6-1,NYN,9,1,37,37,74,150,141,291,14,11,25,2,2:56
9556,492230,2017-09-09,2017,BOS,TBA,9,0,9-0,BOS,9,1,44,35,79,123,168,291,21,10,31,1,3:05
9557,492221,2017-09-09,2017,SEA,ANA,8,1,8-1,SEA,9,1,37,36,73,147,156,303,13,10,23,2,3:15
9558,492218,2017-09-09,2017,LAN,COL,5,6,6-5,COL,9,0,37,43,80,153,170,323,9,17,26,0,3:29
9559,492226,2017-09-09,2017,WAS,PHI,4,5,5-4,PHI,9,0,36,40,76,162,143,305,9,14,23,2,3:23
9560,492229,2017-09-09,2017,CHA,SFN,13,1,13-1,CHA,9,1,43,32,75,126,168,294,19,6,25,2,2:52
9561,492222,2017-09-09,2017,ATL,MIA,6,5,6-5,ATL,9,0,46,40,86,154,159,313,21,13,34,2,3:21
9562,492219,2017-09-09,2017,TOR,DET,5,4,5-4,TOR,9,1,39,35,74,137,154,291,19,9,28,3,3:03
9563,492228,2017-09-09,2017,ARI,SDN,7,8,8-7,SDN,9,0,44,40,84,154,186,340,20,13,33,4,3:33
9564,492224,2017-09-09,2017,KCA,MIN,5,2,5-2,KCA,9,1,36,37,73,137,110,247,16,14,30,5,2:51
9565,492242,2017-09-10,2017,SLN,PIT,7,0,7-0,SLN,9,1,36,32,68,108,151,259,12,6,18,0,2:35
9566,492244,2017-09-10,2017,CHA,SFN,8,1,8-1,CHA,9,1,36,34,70,132,140,272,14,8,22,0,2:47
9567,492239,2017-09-10,2017,KCA,MIN,11,3,11-3,KCA,9,1,41,37,78,149,138,287,20,11,31,2,2:55
9568,492241,2017-09-10,2017,WAS,PHI,3,2,3-2,WAS,9,1,31,31,62,125,103,228,8,6,14,0,2:16
9569,492231,2017-09-10,2017,CLE,BAL,3,2,3-2,CLE,9,1,31,32,63,143,117,260,6,7,13,3,2:58
9570,492243,2017-09-10,2017,ARI,SDN,3,2,3-2,ARI,9,1,32,35,67,146,125,271,8,8,16,2,2:58
9571,492235,2017-09-10,2017,OAK,HOU,10,2,10-2,OAK,9,1,46,37,83,158,190,348,22,11,33,5,3:48
9572,492232,2017-09-10,2017,NYN,CIN,5,10,10-5,CIN,9,0,41,45,86,179,176,355,16,19,35,3,3:38
9573,492245,2017-09-10,2017,BOS,TBA,1,4,4-1,TBA,9,0,33,39,72,148,145,293,8,12,20,3,3:22
9574,492236,2017-09-10,2017,SEA,ANA,3,5,5-3,ANA,9,0,34,36,70,142,124,266,9,10,19,3,2:45
9575,492238,2017-09-10,2017,CHN,MIL,1,3,3-1,MIL,9,0,35,38,73,161,123,284,9,11,20,0,2:54
9576,492234,2017-09-10,2017,TOR,DET,8,2,8-2,TOR,9,1,40,35,75,147,155,302,17,9,26,1,2:48
9577,492233,2017-09-10,2017,LAN,COL,1,8,8-1,COL,9,0,37,42,79,172,138,310,11,16,27,2,3:16
9578,492237,2017-09-10,2017,ATL,MIA,10,8,10-8,ATL,11,0,51,51,102,177,173,350,22,19,41,5,3:47
9579,492240,2017-09-10,2017,TEX,NYA,7,16,16-7,NYA,9,0,45,50,95,177,194,371,17,23,40,5,3:43
9580,492246,2017-09-11,2017,TOR,BAL,4,3,4-3,TOR,9,1,35,34,69,147,143,290,11,7,18,2,2:44
9581,492251,2017-09-11,2017,TBA,NYA,1,5,5-1,NYA,9,0,37,38,75,175,158,333,11,10,21,2,3:28
9582,492248,2017-09-11,2017,ARI,COL,4,5,5-4,COL,9,0,39,36,75,132,166,298,14,9,23,6,3:40
9583,492247,2017-09-11,2017,KCA,CHA,3,11,11-3,CHA,9,0,36,49,85,190,128,318,9,21,30,5,3:16
9584,492252,2017-09-11,2017,MIL,PIT,0,7,7-0,PIT,9,0,31,40,71,164,137,301,5,14,19,2,3:03
9585,492250,2017-09-11,2017,SFN,LAN,8,6,8-6,SFN,9,1,37,44,81,158,154,312,14,17,31,6,3:22 (3:34 delay)
9586,492249,2017-09-11,2017,CLE,DET,11,0,11-0,CLE,9,1,44,37,81,131,178,309,18,10,28,1,3:12
9587,492253,2017-09-11,2017,TEX,SEA,5,3,5-3,TEX,9,1,34,37,71,152,140,292,11,9,20,1,2:43
9588,492264,2017-09-12,2017,TBA,NYA,2,1,2-1,TBA,9,1,29,32,61,132,94,226,6,5,11,2,2:36
9589,492265,2017-09-12,2017,BOS,OAK,11,1,11-1,BOS,9,1,40,36,76,167,147,314,17,10,27,2,3:06
9590,492268,2017-09-12,2017,TEX,SEA,3,10,10-3,SEA,9,0,38,46,84,166,120,286,13,19,32,2,3:09
9591,492255,2017-09-12,2017,TOR,BAL,3,2,3-2,TOR,9,0,37,33,70,99,139,238,13,6,19,2,2:40
9592,492259,2017-09-12,2017,CLE,DET,2,0,2-0,CLE,9,1,36,30,66,113,156,269,14,5,19,1,2:41
9593,492258,2017-09-12,2017,ARI,COL,2,4,4-2,COL,9,0,35,39,74,142,122,264,9,13,22,3,2:54
9594,492256,2017-09-12,2017,KCA,CHA,4,3,4-3,KCA,9,1,31,40,71,140,114,254,9,14,23,3,2:42
9595,492257,2017-09-12,2017,SLN,CIN,13,4,13-4,SLN,9,1,48,34,82,121,191,312,23,10,33,1,3:04
9596,492267,2017-09-12,2017,MIN,SDN,16,0,16-0,MIN,9,1,44,33,77,126,187,313,20,6,26,2,2:59
9597,492263,2017-09-12,2017,CHN,NYN,8,3,8-3,CHN,9,1,40,39,79,155,173,328,19,13,32,1,3:16
9598,492262,2017-09-12,2017,PHI,MIA,9,8,9-8,PHI,15,0,68,62,130,217,228,445,29,18,47,3,4:57
9599,492261,2017-09-12,2017,SFN,LAN,3,5,5-3,LAN,9,0,41,45,86,178,148,326,15,20,35,2,3:29
9600,492254,2017-09-12,2017,WAS,ATL,0,8,8-0,ATL,9,0,35,42,77,157,141,298,11,15,26,0,2:57
9601,492260,2017-09-12,2017,ANA,HOU,0,1,1-0,HOU,9,0,29,32,61,121,119,240,4,6,10,0,2:51
9602,492266,2017-09-12,2017,MIL,PIT,5,2,5-2,MIL,9,1,35,36,71,156,128,284,13,9,22,3,3:00
9603,492270,2017-09-13,2017,TOR,BAL,1,2,2-1,BAL,9,0,33,37,70,131,123,254,9,11,20,1,2:40
9604,492275,2017-09-13,2017,ANA,HOU,9,1,9-1,ANA,9,1,39,30,69,106,129,235,15,6,21,1,2:28
9605,492280,2017-09-13,2017,BOS,OAK,3,7,7-3,OAK,9,0,37,37,74,167,146,313,12,11,23,2,3:07 (:19 delay)
9606,492282,2017-09-13,2017,MIN,SDN,3,1,3-1,MIN,10,0,40,39,79,157,144,301,13,10,23,6,3:39
9607,492283,2017-09-13,2017,TEX,SEA,1,8,8-1,SEA,9,0,34,42,76,173,129,302,8,18,26,5,3:08
9608,492281,2017-09-13,2017,MIL,PIT,8,2,8-2,MIL,9,1,41,39,80,136,173,309,20,13,33,3,3:26
9609,492278,2017-09-13,2017,CHN,NYN,17,5,17-5,CHN,9,1,51,41,92,179,190,369,28,16,44,4,3:42
9610,492272,2017-09-13,2017,SLN,CIN,0,6,6-0,CIN,9,0,35,36,71,119,142,261,9,11,20,1,2:40
9611,492276,2017-09-13,2017,SFN,LAN,1,4,4-1,LAN,9,0,30,40,70,153,118,271,5,15,20,1,2:58
9612,492273,2017-09-13,2017,ARI,COL,8,2,8-2,ARI,9,1,41,36,77,136,143,279,18,8,26,4,3:00
9613,492277,2017-09-13,2017,PHI,MIA,8,1,8-1,PHI,9,1,38,34,72,121,113,234,14,7,21,0,2:25
9614,492274,2017-09-13,2017,CLE,DET,5,3,5-3,CLE,9,1,33,37,70,143,152,295,10,9,19,2,2:59
9615,492269,2017-09-13,2017,WAS,ATL,2,8,8-2,ATL,9,0,32,44,76,163,112,275,7,19,26,1,3:08
9616,492271,2017-09-13,2017,KCA,CHA,3,5,5-3,CHA,9,0,40,41,81,162,157,319,14,14,28,4,3:23
9617,492279,2017-09-13,2017,TBA,NYA,2,3,3-2,NYA,9,0,38,41,79,170,167,337,12,15,27,4,3:40
9618,492287,2017-09-14,2017,SLN,CIN,5,2,5-2,SLN,9,1,38,33,71,154,144,298,14,7,21,1,2:50
9619,492288,2017-09-14,2017,ARI,COL,7,0,7-0,ARI,9,1,38,30,68,120,158,278,14,6,20,2,2:53
9620,492292,2017-09-14,2017,CHN,NYN,14,6,14-6,CHN,9,1,41,39,80,146,157,303,16,14,30,2,3:06
9621,492289,2017-09-14,2017,ANA,HOU,2,5,5-2,HOU,9,0,35,38,73,151,142,293,8,12,20,3,3:20
9622,492291,2017-09-14,2017,PHI,MIA,10,0,10-0,PHI,9,1,39,37,76,151,150,301,17,12,29,2,3:06
9623,492295,2017-09-14,2017,MIN,TOR,3,2,3-2,MIN,10,0,41,44,85,161,150,311,15,14,29,6,3:29
9624,492290,2017-09-14,2017,CLE,KCA,3,2,3-2,CLE,10,0,41,37,78,131,175,306,18,10,28,3,3:21
9625,492294,2017-09-14,2017,TEX,SEA,4,10,10-4,SEA,9,0,35,48,83,191,144,335,8,21,29,5,3:21
9626,492285,2017-09-14,2017,NYA,BAL,13,5,13-5,NYA,9,1,43,41,84,141,165,306,20,14,34,2,3:14
9627,492286,2017-09-14,2017,DET,CHA,7,17,17-7,CHA,9,0,40,58,98,213,144,357,13,31,44,4,3:42
9628,492284,2017-09-14,2017,WAS,ATL,5,2,5-2,WAS,9,1,33,34,67,146,133,279,11,7,18,0,2:40 (:30 delay)
9629,492293,2017-09-14,2017,BOS,OAK,6,2,6-2,BOS,9,1,34,39,73,188,119,307,11,15,26,4,3:19
9630,492304,2017-09-15,2017,PHI,OAK,0,4,4-0,OAK,9,0,28,37,65,155,118,273,2,10,12,0,2:43
9631,492297,2017-09-15,2017,NYA,BAL,8,2,8-2,NYA,9,1,37,32,69,118,120,238,14,5,19,3,2:38
9632,492310,2017-09-15,2017,MIN,TOR,3,4,4-3,TOR,9,0,35,40,75,141,128,269,8,14,22,2,2:57
9633,492308,2017-09-15,2017,CHN,SLN,8,2,8-2,CHN,9,1,36,35,71,154,137,291,12,11,23,4,3:07
9634,492303,2017-09-15,2017,ATL,NYN,3,2,3-2,ATL,9,1,34,36,70,140,150,290,13,10,23,4,3:05
9635,492299,2017-09-15,2017,DET,CHA,3,2,3-2,DET,9,0,35,37,72,148,142,290,9,10,19,7,3:18
9636,492300,2017-09-15,2017,CLE,KCA,3,4,4-3,KCA,9,0,37,40,77,146,157,303,12,13,25,3,3:11
9637,492296,2017-09-15,2017,SFN,ARI,2,3,3-2,ARI,9,0,32,32,64,119,127,246,6,6,12,0,2:26
9638,492306,2017-09-15,2017,COL,SDN,6,1,6-1,COL,9,1,34,36,70,149,114,263,13,9,22,3,2:50
9639,492309,2017-09-15,2017,ANA,TEX,7,6,7-6,ANA,9,1,35,35,70,127,140,267,12,9,21,6,3:20
9640,492307,2017-09-15,2017,HOU,SEA,5,2,5-2,HOU,9,1,38,36,74,138,152,290,15,10,25,2,3:12
9641,492302,2017-09-15,2017,MIA,MIL,2,10,10-2,MIL,9,0,34,46,80,190,129,319,7,22,29,3,3:23
9642,492305,2017-09-15,2017,CIN,PIT,4,2,4-2,CIN,9,1,38,38,76,170,146,316,16,12,28,3,3:14
9643,492301,2017-09-15,2017,WAS,LAN,0,7,7-0,LAN,9,0,35,39,74,148,148,296,9,12,21,1,3:09
9644,492298,2017-09-15,2017,TBA,BOS,6,13,13-6,BOS,15,0,64,74,138,275,266,541,22,30,52,7,6:05
9645,492324,2017-09-16,2017,ANA,TEX,2,0,2-0,ANA,9,1,31,31,62,129,118,247,9,5,14,2,2:45
9646,492325,2017-09-16,2017,MIN,TOR,2,7,7-2,TOR,9,0,32,41,73,163,113,276,5,16,21,3,2:50
9647,492321,2017-09-16,2017,COL,SDN,16,0,16-0,COL,9,1,45,32,77,124,183,307,24,6,30,2,3:13
9648,492311,2017-09-16,2017,SFN,ARI,0,2,2-0,ARI,9,0,30,34,64,116,116,232,3,9,12,0,2:32
9649,492317,2017-09-16,2017,MIA,MIL,7,4,7-4,MIA,9,1,36,40,76,168,138,306,13,14,27,3,3:03
9650,492315,2017-09-16,2017,CLE,KCA,8,4,8-4,CLE,9,1,38,36,74,123,124,247,15,11,26,1,2:44
9651,492316,2017-09-16,2017,WAS,LAN,2,3,3-2,LAN,9,0,33,38,71,135,111,246,7,13,20,2,2:46
9652,492319,2017-09-16,2017,PHI,OAK,5,3,5-3,PHI,9,1,36,33,69,124,150,274,12,6,18,3,2:56 (1:46 delay)
9653,492318,2017-09-16,2017,ATL,NYN,3,7,7-3,NYN,9,0,37,38,75,140,140,280,11,14,25,0,2:45
9654,492313,2017-09-16,2017,TBA,BOS,1,3,3-1,BOS,9,0,32,35,67,149,116,265,6,8,14,2,2:44
9655,492320,2017-09-16,2017,CIN,PIT,2,1,2-1,CIN,9,1,28,33,61,122,106,228,6,7,13,2,2:23
9656,492322,2017-09-16,2017,HOU,SEA,8,6,8-6,HOU,9,1,39,39,78,142,159,301,15,13,28,3,3:21
9657,492314,2017-09-16,2017,DET,CHA,4,10,10-4,CHA,9,0,39,48,87,178,129,307,12,23,35,2,3:25
9658,492312,2017-09-16,2017,NYA,BAL,9,3,9-3,NYA,9,1,38,40,78,189,157,346,15,14,29,2,3:37
9659,492323,2017-09-16,2017,CHN,SLN,4,1,4-1,CHN,9,1,40,33,73,128,137,265,17,8,25,3,2:49
9660,492337,2017-09-17,2017,HOU,SEA,7,1,7-1,HOU,9,1,38,32,70,127,142,269,13,7,20,1,2:50
9661,492335,2017-09-17,2017,CIN,PIT,5,2,5-2,CIN,9,1,34,33,67,137,131,268,10,7,17,1,2:39
9662,492330,2017-09-17,2017,CLE,KCA,3,2,3-2,CLE,9,1,32,37,69,147,123,270,6,9,15,3,2:59
9663,492340,2017-09-17,2017,MIN,TOR,13,7,13-7,MIN,9,1,45,39,84,135,181,316,20,12,32,5,3:17
9664,492328,2017-09-17,2017,TBA,BOS,3,2,3-2,TBA,9,1,34,31,65,124,138,262,9,5,14,1,2:37
9665,492339,2017-09-17,2017,ANA,TEX,2,4,4-2,TEX,9,0,34,35,69,145,134,279,11,7,18,3,3:22
9666,492333,2017-09-17,2017,ATL,NYN,1,5,5-1,NYN,9,0,35,39,74,154,146,300,6,13,19,2,2:59
9667,492331,2017-09-17,2017,WAS,LAN,7,1,7-1,WAS,9,1,37,37,74,138,173,311,13,9,22,1,3:22
9668,492327,2017-09-17,2017,NYA,BAL,4,6,6-4,BAL,9,0,39,37,76,136,181,317,12,11,23,2,3:15
9669,492336,2017-09-17,2017,COL,SDN,3,4,4-3,SDN,9,0,37,38,75,127,140,267,11,12,23,4,3:00 (1:23 delay)
9670,492326,2017-09-17,2017,SFN,ARI,7,2,7-2,SFN,9,1,37,34,71,138,142,280,16,8,24,4,2:55
9671,492334,2017-09-17,2017,PHI,OAK,3,6,6-3,OAK,9,0,39,36,75,150,151,301,10,9,19,4,3:09
9672,492329,2017-09-17,2017,DET,CHA,12,0,12-0,DET,9,1,40,29,69,121,148,269,19,2,21,2,2:45
9673,492332,2017-09-17,2017,MIA,MIL,3,10,10-3,MIL,9,0,35,46,81,180,113,293,8,22,30,1,3:11
9674,492338,2017-09-17,2017,CHN,SLN,4,3,4-3,CHN,9,1,40,41,81,164,153,317,17,16,33,3,3:44
9675,492345,2017-09-18,2017,NYA,MIN,2,1,2-1,NYA,9,1,35,33,68,133,139,272,10,7,17,5,3:16
9676,492341,2017-09-18,2017,SDN,ARI,4,2,4-2,SDN,9,1,32,38,70,148,129,277,11,12,23,1,3:02
9677,492346,2017-09-18,2017,MIA,NYN,13,1,13-1,MIA,9,1,48,39,87,185,147,332,25,14,39,3,3:22
9678,492347,2017-09-18,2017,DET,OAK,3,8,8-3,OAK,9,0,39,48,87,177,158,335,13,22,35,4,3:39
9679,492342,2017-09-18,2017,BAL,BOS,8,10,10-8,BOS,11,0,49,49,98,197,186,383,18,18,36,7,4:24
9680,492343,2017-09-18,2017,PHI,LAN,4,3,4-3,PHI,9,1,30,35,65,149,123,272,6,9,15,1,2:40
9681,492344,2017-09-18,2017,PIT,MIL,0,3,3-0,MIL,9,0,33,37,70,153,122,275,8,12,20,2,2:52
9682,492354,2017-09-19,2017,TOR,KCA,5,2,5-2,TOR,9,1,31,33,64,121,118,239,8,8,16,3,2:27
9683,492356,2017-09-19,2017,PIT,MIL,0,1,1-0,MIL,9,0,33,36,69,153,127,280,6,11,17,1,3:04
9684,492355,2017-09-19,2017,PHI,LAN,6,2,6-2,PHI,9,1,36,36,72,116,158,274,13,11,24,2,3:23 (:29 delay)
9685,492357,2017-09-19,2017,NYA,MIN,5,2,5-2,NYA,9,1,43,36,79,120,187,307,19,11,30,3,3:30 (1:05 delay)
9686,492349,2017-09-19,2017,BAL,BOS,0,1,1-0,BOS,11,0,41,40,81,152,173,325,8,9,17,1,3:27
9687,492351,2017-09-19,2017,HOU,CHA,3,1,3-1,HOU,9,1,31,37,68,141,114,255,9,9,18,1,2:47
9688,492360,2017-09-19,2017,CIN,SLN,7,8,8-7,SLN,10,0,43,43,86,170,173,343,15,13,28,5,3:23
9689,492350,2017-09-19,2017,TBA,CHN,1,2,2-1,CHN,9,0,29,33,62,139,121,260,2,7,9,3,2:45
9690,492352,2017-09-19,2017,ANA,CLE,3,6,6-3,CLE,9,0,33,41,74,156,145,301,9,18,27,3,3:20
9691,492362,2017-09-19,2017,ATL,WAS,2,4,4-2,WAS,9,0,34,40,74,139,142,281,7,13,20,1,3:01
9692,492348,2017-09-19,2017,SDN,ARI,6,2,6-2,SDN,9,1,36,31,67,134,141,275,13,6,19,0,2:45
9693,492361,2017-09-19,2017,SEA,TEX,1,3,3-1,TEX,9,0,35,35,70,122,153,275,10,10,20,3,2:54
9694,492353,2017-09-19,2017,SFN,COL,4,3,4-3,SFN,9,0,37,38,75,147,117,264,13,16,29,2,2:57
9695,492358,2017-09-19,2017,MIA,NYN,5,4,5-4,MIA,10,0,41,43,84,149,190,339,15,13,28,1,3:22
9696,492359,2017-09-19,2017,DET,OAK,8,9,9-8,OAK,9,0,48,46,94,192,177,369,24,18,42,7,3:58 (:15 delay)
9697,492366,2017-09-20,2017,HOU,CHA,4,3,4-3,HOU,9,1,36,33,69,146,135,281,13,6,19,4,3:08
9698,492377,2017-09-20,2017,ATL,WAS,3,7,7-3,WAS,9,0,33,40,73,154,137,291,6,15,21,3,2:51
9699,492365,2017-09-20,2017,TBA,CHN,8,1,8-1,TBA,9,1,40,34,74,142,171,313,18,9,27,1,3:04
9700,492369,2017-09-20,2017,TOR,KCA,5,15,15-5,KCA,9,0,37,50,87,172,129,301,9,23,32,2,3:01
9701,492371,2017-09-20,2017,PIT,MIL,6,4,6-4,PIT,9,0,37,39,76,140,159,299,12,16,28,5,3:33
9702,492375,2017-09-20,2017,CIN,SLN,2,9,9-2,SLN,9,0,33,44,77,162,131,293,6,18,24,0,2:47
9703,492373,2017-09-20,2017,MIA,NYN,9,2,9-2,MIA,9,1,41,35,76,129,154,283,17,9,26,1,2:42
9704,492368,2017-09-20,2017,SFN,COL,4,0,4-0,SFN,9,1,36,36,72,134,136,270,13,8,21,5,2:52
9705,492364,2017-09-20,2017,BAL,BOS,0,9,9-0,BOS,9,0,32,44,76,194,133,327,6,18,24,1,3:11
9706,492367,2017-09-20,2017,ANA,CLE,5,6,6-5,CLE,9,0,38,42,80,177,145,322,13,17,30,6,3:40
9707,492374,2017-09-20,2017,DET,OAK,2,3,3-2,OAK,9,0,37,37,74,172,140,312,10,9,19,1,3:07
9708,492370,2017-09-20,2017,PHI,LAN,7,5,7-5,PHI,9,1,34,41,75,176,126,302,10,14,24,4,3:18
9709,492363,2017-09-20,2017,SDN,ARI,7,13,13-7,ARI,9,0,43,44,87,165,162,327,17,17,34,4,3:47
9710,492376,2017-09-20,2017,SEA,TEX,6,8,8-6,TEX,9,0,42,41,83,170,158,328,17,13,30,4,3:27
9711,492372,2017-09-20,2017,NYA,MIN,11,3,11-3,NYA,9,1,43,35,78,155,159,314,19,9,28,2,3:20
9712,492380,2017-09-21,2017,ANA,CLE,1,4,4-1,CLE,9,0,34,34,68,141,144,285,10,8,18,5,3:01
9713,492386,2017-09-21,2017,BAL,TBA,3,1,3-1,BAL,9,1,32,34,66,111,109,220,9,9,18,0,2:28
9714,492381,2017-09-21,2017,SDN,COL,3,0,3-0,SDN,9,1,33,33,66,128,119,247,9,8,17,2,2:46
9715,492382,2017-09-21,2017,TOR,KCA,0,1,1-0,KCA,9,0,31,35,66,140,113,253,5,10,15,4,2:39
9716,492388,2017-09-21,2017,ATL,WAS,3,2,3-2,ATL,9,1,30,30,60,108,106,214,7,4,11,0,2:18
9717,492387,2017-09-21,2017,SEA,TEX,2,4,4-2,TEX,9,0,32,37,69,157,120,277,6,9,15,2,2:45
9718,492379,2017-09-21,2017,HOU,CHA,1,3,3-1,CHA,9,0,34,34,68,147,151,298,9,9,18,4,3:17
9719,492383,2017-09-21,2017,PHI,LAN,4,5,5-4,LAN,9,0,39,40,79,147,167,314,12,12,24,3,3:39
9720,492384,2017-09-21,2017,DET,MIN,1,12,12-1,MIN,9,0,35,50,85,213,143,356,7,24,31,3,3:34
9721,492385,2017-09-21,2017,CIN,SLN,5,8,8-5,SLN,9,0,41,47,88,177,143,320,15,22,37,3,3:12
9722,492378,2017-09-21,2017,MIL,CHN,3,5,5-3,CHN,10,0,45,43,88,147,182,329,17,19,36,4,3:57
9723,492394,2017-09-22,2017,HOU,ANA,3,0,3-0,HOU,9,1,29,30,59,136,125,261,5,5,10,1,3:00
9724,492391,2017-09-22,2017,SEA,CLE,3,1,3-1,SEA,9,0,31,31,62,115,132,247,10,4,14,0,2:23
9725,492402,2017-09-22,2017,OAK,TEX,4,1,4-1,OAK,9,1,33,37,70,134,114,248,9,11,20,2,2:37
9726,492396,2017-09-22,2017,DET,MIN,3,7,7-3,MIN,9,0,33,38,71,143,124,267,8,11,19,1,2:52
9727,492393,2017-09-22,2017,CHA,KCA,7,6,7-6,CHA,9,1,36,38,74,140,144,284,13,12,25,5,3:23
9728,492401,2017-09-22,2017,BAL,TBA,3,8,8-3,TBA,9,0,38,42,80,139,147,286,12,18,30,2,3:07
9729,492392,2017-09-22,2017,SDN,COL,1,4,4-1,COL,9,0,34,36,70,120,143,263,8,10,18,3,2:51
9730,492403,2017-09-22,2017,NYN,WAS,7,6,7-6,NYN,9,1,35,41,76,133,130,263,14,13,27,5,3:02
9731,492399,2017-09-22,2017,LAN,SFN,4,2,4-2,LAN,9,1,33,37,70,148,151,299,9,11,20,1,2:55
9732,492398,2017-09-22,2017,ATL,PHI,7,2,7-2,ATL,9,1,38,37,75,157,150,307,15,11,26,1,2:56
9733,492390,2017-09-22,2017,MIL,CHN,4,5,5-4,CHN,10,0,38,44,82,167,165,332,11,18,29,3,4:03
9734,492397,2017-09-22,2017,TOR,NYA,8,1,8-1,TOR,9,1,35,33,68,118,129,247,10,7,17,2,2:32
9735,492395,2017-09-22,2017,ARI,MIA,13,11,13-11,ARI,9,1,45,46,91,179,169,348,21,20,41,5,3:54
9736,492389,2017-09-22,2017,CIN,BOS,4,5,5-4,BOS,9,0,39,36,75,131,119,250,14,10,24,1,2:45
9737,492400,2017-09-22,2017,PIT,SLN,3,4,4-3,SLN,9,0,35,41,76,153,128,281,7,17,24,1,3:16
9738,492409,2017-09-23,2017,HOU,ANA,6,2,6-2,HOU,9,1,35,33,68,109,112,221,13,8,21,2,2:38
9739,492404,2017-09-23,2017,CIN,BOS,0,5,5-0,BOS,9,0,32,40,72,134,146,280,7,16,23,1,2:51
9740,492407,2017-09-23,2017,SDN,COL,5,0,5-0,SDN,9,1,38,36,74,139,145,284,15,9,24,4,3:11
9741,492411,2017-09-23,2017,DET,MIN,4,10,10-4,MIN,9,0,33,44,77,182,125,307,8,17,25,4,3:12
9742,492408,2017-09-23,2017,CHA,KCA,2,8,8-2,KCA,9,0,37,42,79,169,122,291,11,17,28,4,3:02
9743,492415,2017-09-23,2017,PIT,SLN,11,6,11-6,PIT,9,1,43,39,82,166,162,328,21,12,33,5,3:20
9744,492406,2017-09-23,2017,SEA,CLE,4,11,11-4,CLE,9,0,40,45,85,180,183,363,16,15,31,3,3:32
9745,492417,2017-09-23,2017,OAK,TEX,1,0,1-0,OAK,9,1,30,32,62,136,113,249,6,6,12,2,2:38
9746,492414,2017-09-23,2017,LAN,SFN,1,2,2-1,SFN,9,0,31,38,69,134,122,256,7,11,18,2,2:53
9747,492412,2017-09-23,2017,TOR,NYA,1,5,5-1,NYA,9,0,34,35,69,135,134,269,7,12,19,1,2:54
9748,492413,2017-09-23,2017,ATL,PHI,4,2,4-2,ATL,9,1,38,34,72,126,139,265,16,9,25,1,2:50
9749,492405,2017-09-23,2017,MIL,CHN,4,3,4-3,MIL,10,0,40,40,80,132,161,293,12,14,26,3,3:17
9750,492416,2017-09-23,2017,BAL,TBA,6,9,9-6,TBA,9,0,42,38,80,151,155,306,15,12,27,5,3:34
9751,492418,2017-09-23,2017,NYN,WAS,3,4,4-3,WAS,10,0,40,44,84,192,156,348,10,16,26,2,3:38
9752,492410,2017-09-23,2017,ARI,MIA,6,12,12-6,MIA,9,0,37,50,87,216,151,367,11,21,32,5,3:51
9753,492428,2017-09-24,2017,ATL,PHI,0,2,2-0,PHI,9,0,34,33,67,117,140,257,9,9,18,0,2:38
9754,492429,2017-09-24,2017,LAN,SFN,3,1,3-1,LAN,9,1,33,31,64,101,150,251,10,8,18,1,2:34
9755,492421,2017-09-24,2017,SEA,CLE,2,4,4-2,CLE,9,0,36,37,73,144,138,282,8,10,18,3,2:50
9756,492432,2017-09-24,2017,OAK,TEX,8,1,8-1,OAK,9,1,38,30,68,132,146,278,15,4,19,3,2:45
9757,492423,2017-09-24,2017,CHA,KCA,8,1,8-1,CHA,9,1,38,33,71,133,131,264,13,5,18,1,2:42
9758,492427,2017-09-24,2017,TOR,NYA,9,5,9-5,TOR,9,1,41,39,80,159,158,317,18,13,31,5,3:17
9759,492426,2017-09-24,2017,DET,MIN,4,10,10-4,MIN,9,0,38,43,81,167,143,310,12,18,30,3,3:16
9760,492422,2017-09-24,2017,SDN,COL,4,8,8-4,COL,9,0,35,41,76,156,146,302,11,15,26,3,3:02
9761,492433,2017-09-24,2017,NYN,WAS,2,3,3-2,WAS,9,0,37,33,70,140,148,288,11,6,17,1,3:01
9762,492420,2017-09-24,2017,MIL,CHN,0,5,5-0,CHN,9,0,31,36,67,135,116,251,4,12,16,3,2:53
9763,492419,2017-09-24,2017,CIN,BOS,4,5,5-4,BOS,9,0,36,37,73,161,153,314,12,10,22,4,3:11
9764,492431,2017-09-24,2017,BAL,TBA,9,4,9-4,BAL,9,1,38,38,76,144,148,292,14,11,25,5,3:10
9765,492425,2017-09-24,2017,ARI,MIA,3,2,3-2,ARI,9,0,40,34,74,136,161,297,14,11,25,2,3:10
9766,492430,2017-09-24,2017,PIT,SLN,4,1,4-1,PIT,9,1,35,36,71,160,123,283,12,9,21,2,2:56
9767,492424,2017-09-24,2017,HOU,ANA,5,7,7-5,ANA,9,0,39,44,83,185,141,326,13,16,29,5,3:49
9768,490806,2017-09-25,2017,NYA,KCA,11,3,11-3,NYA,9,1,42,35,77,131,144,275,19,10,29,3,2:51
9769,490390,2017-09-25,2017,NYN,ATL,3,2,3-2,NYN,9,1,35,36,71,140,107,247,13,8,21,3,2:49
9770,492442,2017-09-25,2017,BOS,TOR,4,6,6-4,TOR,9,0,35,37,72,148,134,282,10,14,24,3,2:57
9771,492434,2017-09-25,2017,NYN,ATL,2,9,9-2,ATL,9,0,33,43,76,171,118,289,8,18,26,2,3:03
9772,492435,2017-09-25,2017,SLN,CHN,2,10,10-2,CHN,9,0,35,43,78,165,147,312,9,17,26,2,3:11
9773,492438,2017-09-25,2017,COL,MIA,4,5,5-4,MIA,9,0,37,43,80,168,152,320,12,16,28,5,3:30 (:26 delay)
9774,490390,2017-09-25,2017,NYN,ATL,3,2,3-2,NYN,9,1,35,36,71,140,107,247,13,8,21,3,2:49
9775,492441,2017-09-25,2017,OAK,SEA,1,7,7-1,SEA,9,0,31,37,68,144,110,254,7,11,18,1,2:22
9776,490806,2017-09-25,2017,NYA,KCA,11,3,11-3,NYA,9,1,42,35,77,131,144,275,19,10,29,3,2:51
9777,492437,2017-09-25,2017,CHA,ANA,4,2,4-2,CHA,9,1,34,34,68,137,136,273,9,7,16,3,2:59
9778,492443,2017-09-25,2017,PHI,WAS,1,3,3-1,WAS,9,0,36,37,73,155,149,304,9,10,19,1,3:04
9779,492439,2017-09-25,2017,LAN,SDN,9,3,9-3,LAN,9,1,38,35,73,130,181,311,16,8,24,1,3:06
9780,492440,2017-09-25,2017,ARI,SFN,2,9,9-2,SFN,9,0,35,41,76,149,139,288,11,16,27,2,3:09
9781,492436,2017-09-25,2017,TEX,HOU,2,11,11-2,HOU,9,0,40,45,85,168,176,344,12,17,29,2,3:33
9782,492450,2017-09-26,2017,CHA,ANA,3,9,9-3,ANA,9,0,34,40,74,166,112,278,8,15,23,2,2:57
9783,492453,2017-09-26,2017,LAN,SDN,9,2,9-2,LAN,9,1,44,37,81,122,172,294,21,11,32,0,3:23
9784,492454,2017-09-26,2017,ARI,SFN,11,4,11-4,ARI,9,1,42,40,82,155,186,341,17,14,31,4,3:23
9785,492446,2017-09-26,2017,SLN,CHN,8,7,8-7,SLN,9,1,40,44,84,186,164,350,19,16,35,4,3:46
9786,492448,2017-09-26,2017,KCA,DET,2,1,2-1,KCA,9,1,31,29,60,122,125,247,10,8,18,0,2:31
9787,492451,2017-09-26,2017,COL,MIA,6,0,6-0,COL,9,1,37,30,67,120,129,249,19,5,24,1,2:39
9788,492444,2017-09-26,2017,NYN,ATL,4,3,4-3,NYN,9,0,35,41,76,144,129,273,9,15,24,2,2:57
9789,492457,2017-09-26,2017,BOS,TOR,4,9,9-4,TOR,9,0,35,43,78,162,145,307,8,17,25,3,3:04
9790,492445,2017-09-26,2017,PIT,BAL,10,1,10-1,PIT,9,1,37,34,71,133,145,278,14,7,21,0,2:38
9791,492458,2017-09-26,2017,PHI,WAS,4,1,4-1,PHI,9,1,37,33,70,151,158,309,13,7,20,1,2:59
9792,492455,2017-09-26,2017,OAK,SEA,3,6,6-3,SEA,9,0,35,38,73,134,138,272,9,14,23,3,2:45
9793,492456,2017-09-26,2017,NYA,TBA,6,1,6-1,NYA,9,1,41,35,76,111,175,286,18,8,26,1,3:11
9794,492447,2017-09-26,2017,MIL,CIN,7,6,7-6,MIL,9,1,40,41,81,156,164,320,16,15,31,2,3:19
9795,492452,2017-09-26,2017,CLE,MIN,6,8,8-6,MIN,9,0,39,44,83,165,154,319,13,18,31,7,3:35
9796,492449,2017-09-26,2017,TEX,HOU,3,14,14-3,HOU,9,0,35,50,85,191,155,346,9,24,33,2,3:23
9797,492468,2017-09-27,2017,LAN,SDN,10,0,10-0,LAN,9,1,38,34,72,127,144,271,15,6,21,0,2:42
9798,492470,2017-09-27,2017,OAK,SEA,6,5,6-5,OAK,9,0,35,37,72,140,137,277,11,11,22,2,2:50
9799,492469,2017-09-27,2017,ARI,SFN,4,3,4-3,ARI,9,0,37,35,72,155,142,297,13,8,21,3,3:20
9800,492464,2017-09-27,2017,TEX,HOU,2,12,12-2,HOU,9,0,33,45,78,174,141,315,8,18,26,2,3:17
9801,492466,2017-09-27,2017,COL,MIA,15,9,15-9,COL,9,1,47,41,88,154,171,325,27,14,41,4,3:27
9802,492460,2017-09-27,2017,PIT,BAL,5,3,5-3,PIT,9,1,33,37,70,121,117,238,11,12,23,2,2:34
9803,492467,2017-09-27,2017,CLE,MIN,4,2,4-2,CLE,9,1,39,33,72,131,170,301,16,6,22,6,3:09
9804,492471,2017-09-27,2017,NYA,TBA,6,1,6-1,NYA,9,1,37,33,70,137,163,300,12,7,19,3,3:19
9805,492463,2017-09-27,2017,KCA,DET,7,4,7-4,KCA,9,1,35,41,76,163,125,288,15,14,29,5,3:12
9806,492462,2017-09-27,2017,MIL,CIN,0,6,6-0,CIN,9,0,34,41,75,151,145,296,9,14,23,2,3:09
9807,492461,2017-09-27,2017,SLN,CHN,1,5,5-1,CHN,9,0,34,36,70,113,139,252,8,12,20,4,2:41
9808,492459,2017-09-27,2017,NYN,ATL,7,1,7-1,NYN,9,1,43,36,79,134,179,313,17,9,26,1,3:02
9809,492472,2017-09-27,2017,BOS,TOR,10,7,10-7,BOS,9,1,38,38,76,145,163,308,14,12,26,2,2:57
9810,492465,2017-09-27,2017,CHA,ANA,6,4,6-4,CHA,10,0,41,39,80,152,183,335,14,11,25,4,3:58
9811,492473,2017-09-27,2017,PHI,WAS,7,5,7-5,PHI,9,1,39,43,82,186,165,351,17,20,37,5,3:53
9812,492480,2017-09-28,2017,CLE,MIN,5,2,5-2,CLE,9,1,33,36,69,137,117,254,10,10,20,3,2:38
9813,492481,2017-09-28,2017,TEX,OAK,1,4,4-1,OAK,9,0,37,37,74,144,128,272,10,11,21,2,2:50
9814,492479,2017-09-28,2017,CHA,ANA,5,4,5-4,CHA,9,1,36,35,71,115,168,283,15,9,24,4,3:04
9815,492474,2017-09-28,2017,MIA,ATL,7,1,7-1,MIA,9,1,39,34,73,156,149,305,16,8,24,2,3:06
9816,492475,2017-09-28,2017,SLN,CHN,1,2,2-1,CHN,11,0,41,44,85,164,173,337,10,11,21,0,3:32
9817,492477,2017-09-28,2017,KCA,DET,1,4,4-1,DET,9,0,30,37,67,144,109,253,6,12,18,2,2:44
9818,492476,2017-09-28,2017,MIL,CIN,4,3,4-3,MIL,9,1,35,38,73,138,150,288,13,13,26,4,2:56
9819,492482,2017-09-28,2017,WAS,PIT,5,4,5-4,WAS,9,0,41,34,75,136,162,298,18,8,26,2,3:23
9820,492478,2017-09-28,2017,BOS,HOU,2,12,12-2,HOU,9,0,37,50,87,182,140,322,9,24,33,3,3:31
9821,492483,2017-09-28,2017,NYA,TBA,6,9,9-6,TBA,9,0,38,42,80,164,156,320,13,17,30,3,3:29
9822,492488,2017-09-29,2017,CHN,CIN,5,4,5-4,CHN,9,1,35,36,71,149,130,279,12,11,23,2,2:56
9823,492497,2017-09-29,2017,ANA,SEA,6,5,6-5,ANA,9,1,36,40,76,134,147,281,12,15,27,5,3:01
9824,492498,2017-09-29,2017,NYA,TOR,4,0,4-0,NYA,9,1,32,31,63,135,140,275,10,6,16,2,2:51
9825,492484,2017-09-29,2017,KCA,ARI,2,1,2-1,KCA,9,1,34,35,69,150,135,285,13,10,23,3,2:59
9826,492496,2017-09-29,2017,SFN,SDN,8,0,8-0,SFN,9,1,42,35,77,146,173,319,19,10,29,2,3:09 (:06 delay)
9827,492493,2017-09-29,2017,PHI,NYN,6,2,6-2,PHI,9,1,36,37,73,137,133,270,13,11,24,0,2:38
9828,492492,2017-09-29,2017,SLN,MIL,3,5,5-3,MIL,9,0,32,38,70,150,133,283,7,15,22,2,2:44
9829,492487,2017-09-29,2017,CLE,CHA,10,1,10-1,CLE,9,1,43,33,76,126,170,296,19,5,24,4,2:57
9830,492486,2017-09-29,2017,TBA,BAL,7,0,7-0,TBA,9,1,41,31,72,139,167,306,18,6,24,3,3:06
9831,492490,2017-09-29,2017,BOS,HOU,2,3,3-2,HOU,9,0,34,36,70,129,117,246,9,10,19,3,2:47
9832,492494,2017-09-29,2017,TEX,OAK,5,3,5-3,TEX,9,1,35,37,72,144,138,282,11,11,22,3,2:54
9833,492485,2017-09-29,2017,MIA,ATL,6,5,6-5,MIA,9,1,36,40,76,173,135,308,13,16,29,5,3:08
9834,492495,2017-09-29,2017,WAS,PIT,6,1,6-1,WAS,9,1,34,34,68,120,163,283,14,8,22,4,3:06
9835,492491,2017-09-29,2017,COL,LAN,9,1,9-1,COL,9,1,41,34,75,125,195,320,17,8,25,1,3:19
9836,492489,2017-09-29,2017,MIN,DET,6,3,6-3,MIN,9,1,38,38,76,178,151,329,14,12,26,4,3:29
9837,492513,2017-09-30,2017,NYA,TOR,2,1,2-1,NYA,9,1,33,33,66,135,145,280,11,8,19,4,2:57
9838,492502,2017-09-30,2017,CLE,CHA,1,2,2-1,CHA,9,0,34,35,69,134,150,284,8,10,18,3,3:13
9839,492510,2017-09-30,2017,WAS,PIT,1,4,4-1,PIT,9,0,32,36,68,157,114,271,6,10,16,2,2:56
9840,492505,2017-09-30,2017,BOS,HOU,6,3,6-3,BOS,9,1,37,37,74,143,146,289,15,12,27,4,3:19
9841,492511,2017-09-30,2017,SFN,SDN,2,3,3-2,SDN,9,0,38,36,74,142,146,288,12,9,21,1,3:00
9842,492501,2017-09-30,2017,TBA,BAL,4,3,4-3,TBA,9,1,36,37,73,138,143,281,12,11,23,2,2:45
9843,492504,2017-09-30,2017,MIN,DET,2,3,3-2,DET,9,0,37,34,71,144,143,287,11,6,17,3,2:59
9844,492503,2017-09-30,2017,CHN,CIN,9,0,9-0,CHN,9,1,41,35,76,151,180,331,17,10,27,1,3:04
9845,492507,2017-09-30,2017,SLN,MIL,7,6,7-6,SLN,9,1,34,44,78,168,143,311,13,18,31,4,3:13
9846,492506,2017-09-30,2017,COL,LAN,3,5,5-3,LAN,9,0,38,37,75,123,130,253,12,12,24,4,2:59 (:21 delay)
9847,492500,2017-09-30,2017,MIA,ATL,10,2,10-2,MIA,9,1,46,36,82,135,159,294,27,10,37,1,2:59
9848,492508,2017-09-30,2017,PHI,NYN,4,7,7-4,NYN,11,0,44,51,95,207,209,416,11,22,33,6,4:10
9849,492499,2017-09-30,2017,KCA,ARI,4,3,4-3,KCA,9,1,31,39,70,146,128,274,9,12,21,2,2:44
9850,492509,2017-09-30,2017,TEX,OAK,8,4,8-4,TEX,9,1,39,38,77,154,159,313,18,11,29,3,3:14
9851,492512,2017-09-30,2017,ANA,SEA,4,6,6-4,SEA,9,0,41,40,81,148,170,318,14,15,29,5,3:32
9852,492518,2017-10-01,2017,CHN,CIN,1,3,3-1,CIN,9,0,31,37,68,141,112,253,3,11,14,0,2:30
9853,492527,2017-10-01,2017,ANA,SEA,6,2,6-2,ANA,9,1,36,34,70,116,138,254,11,8,19,2,2:38
9854,492516,2017-10-01,2017,TBA,BAL,6,0,6-0,TBA,9,1,37,31,68,128,147,275,14,3,17,1,2:32
9855,492520,2017-10-01,2017,BOS,HOU,3,4,4-3,HOU,9,0,35,38,73,144,129,273,9,12,21,4,3:09
9856,492522,2017-10-01,2017,SLN,MIL,1,6,6-1,MIL,9,0,33,36,69,132,128,260,5,9,14,0,2:24
9857,492519,2017-10-01,2017,MIN,DET,5,1,5-1,MIN,9,1,35,32,67,120,143,263,11,7,18,3,2:36 (:41 delay)
9858,492517,2017-10-01,2017,CLE,CHA,3,1,3-1,CLE,9,1,35,33,68,117,126,243,11,5,16,4,2:37
9859,492528,2017-10-01,2017,NYA,TOR,1,2,2-1,TOR,9,0,32,31,63,119,136,255,6,4,10,2,2:28
9860,492521,2017-10-01,2017,COL,LAN,3,6,6-3,LAN,9,0,38,46,84,201,152,353,14,19,33,1,3:39
9861,492526,2017-10-01,2017,SFN,SDN,5,4,5-4,SFN,9,0,33,39,72,147,140,287,10,14,24,2,2:55
9862,492524,2017-10-01,2017,TEX,OAK,2,5,5-2,OAK,9,0,35,38,73,138,120,258,9,13,22,1,2:37
9863,492525,2017-10-01,2017,WAS,PIT,8,11,11-8,PIT,9,0,51,48,99,208,224,432,24,23,47,5,4:22
9864,492523,2017-10-01,2017,PHI,NYN,11,0,11-0,PHI,9,1,42,35,77,142,175,317,18,8,26,2,3:09
9865,492515,2017-10-01,2017,MIA,ATL,5,8,8-5,ATL,9,0,39,43,82,174,170,344,12,17,29,4,3:19
9866,492514,2017-10-01,2017,KCA,ARI,2,14,14-2,ARI,9,0,37,52,89,203,128,331,8,24,32,4,3:31
9867,529419,2018-03-29,2018,NYN,SLN,9,4,9-4,NYN,9,1,44,34,78,129,164,293,22,7,29,2,3:01
9868,529409,2018-03-29,2018,SEA,CLE,2,1,2-1,SEA,9,1,29,35,64,137,91,228,7,9,16,2,2:35
9869,529414,2018-03-29,2018,BAL,MIN,3,2,3-2,BAL,11,0,40,43,83,162,156,318,12,11,23,2,3:31
9870,529410,2018-03-29,2018,ARI,COL,8,2,8-2,ARI,9,1,42,36,78,147,169,316,18,11,29,5,3:36
9871,529418,2018-03-29,2018,LAN,SFN,0,1,1-0,SFN,9,0,36,36,72,131,154,285,11,10,21,0,2:55
9872,529411,2018-03-29,2018,TEX,HOU,1,4,4-1,HOU,9,0,34,37,71,145,133,278,9,12,21,1,2:59
9873,529406,2018-03-29,2018,TBA,BOS,6,4,6-4,TBA,9,1,35,35,70,123,154,277,11,10,21,2,3:00
9874,529407,2018-03-29,2018,MIA,CHN,4,8,8-4,CHN,9,0,40,44,84,163,157,320,15,19,34,2,3:18
9875,529416,2018-03-29,2018,ATL,PHI,8,5,8-5,ATL,9,0,40,38,78,171,137,308,15,13,28,7,3:28
9876,529415,2018-03-29,2018,TOR,NYA,1,6,6-1,NYA,9,0,32,40,72,172,136,308,5,13,18,2,2:51
9877,529408,2018-03-29,2018,KCA,CHA,7,14,14-7,CHA,9,0,39,47,86,183,168,351,12,22,34,5,3:26
9878,529413,2018-03-29,2018,SDN,MIL,1,2,2-1,MIL,12,0,45,45,90,153,198,351,13,13,26,1,3:36
9879,529412,2018-03-29,2018,OAK,ANA,6,5,6-5,OAK,11,0,47,47,94,164,198,362,18,14,32,3,4:02
9880,529429,2018-03-30,2018,LAN,SFN,0,1,1-0,SFN,9,0,27,32,59,102,124,226,1,2,3,0,2:23
9881,529421,2018-03-30,2018,TBA,BOS,0,1,1-0,BOS,9,0,31,34,65,139,109,248,5,9,14,2,2:46
9882,529424,2018-03-30,2018,TEX,HOU,5,1,5-1,TEX,9,1,35,36,71,138,137,275,12,10,22,1,3:02
9883,529427,2018-03-30,2018,TOR,NYA,2,4,4-2,NYA,9,0,33,37,70,131,125,256,6,12,18,2,2:49
9884,529425,2018-03-30,2018,OAK,ANA,1,2,2-1,ANA,9,0,36,32,68,116,150,266,10,6,16,2,2:48
9885,529420,2018-03-30,2018,CIN,WAS,0,2,2-0,WAS,9,0,36,37,73,152,147,299,9,10,19,1,3:09
9886,529426,2018-03-30,2018,SDN,MIL,6,8,8-6,MIL,9,0,42,40,82,136,150,286,17,12,29,2,3:08
9887,529420,2018-03-30,2018,CIN,WAS,0,2,2-0,WAS,9,0,36,37,73,152,147,299,9,10,19,1,3:09
9888,529423,2018-03-30,2018,ARI,COL,9,8,9-8,ARI,9,1,38,41,79,157,155,312,14,15,29,1,3:22
9889,529428,2018-03-30,2018,ATL,PHI,4,5,5-4,PHI,11,0,46,48,94,212,185,397,16,15,31,4,4:16
9890,529417,2018-03-30,2018,DET,PIT,10,13,13-10,PIT,13,0,62,58,120,214,251,465,23,21,44,5,5:27
9891,529417,2018-03-30,2018,DET,PIT,10,13,13-10,PIT,13,0,62,58,120,214,251,465,23,21,44,5,5:27
9892,529422,2018-03-30,2018,MIA,CHN,2,1,2-1,MIA,17,0,70,67,137,259,259,518,21,18,39,3,5:18
9893,529439,2018-03-31,2018,TOR,NYA,5,3,5-3,TOR,9,1,36,34,70,114,138,252,13,8,21,1,2:37
9894,529442,2018-03-31,2018,LAN,SFN,5,0,5-0,LAN,9,1,31,37,68,146,112,258,7,12,19,0,2:43
9895,529436,2018-03-31,2018,OAK,ANA,3,8,8-3,ANA,9,0,39,43,82,153,154,307,13,14,27,4,3:23
9896,529430,2018-03-31,2018,TBA,BOS,2,3,3-2,BOS,9,0,37,39,76,156,148,304,11,13,24,5,3:21
9897,529437,2018-03-31,2018,SDN,MIL,3,7,7-3,MIL,9,0,32,45,77,180,128,308,7,19,26,1,2:51
9898,529434,2018-03-31,2018,ARI,COL,1,2,2-1,COL,9,0,34,33,67,143,140,283,10,6,16,1,2:54
9899,529432,2018-03-31,2018,KCA,CHA,3,4,4-3,CHA,9,0,38,37,75,151,133,284,12,11,23,0,2:54
9900,529433,2018-03-31,2018,SEA,CLE,5,6,6-5,CLE,9,0,37,37,74,155,121,276,12,10,22,4,2:47
9901,529435,2018-03-31,2018,TEX,HOU,3,9,9-3,HOU,9,0,36,45,81,183,151,334,9,18,27,3,3:19
9902,529443,2018-03-31,2018,NYN,SLN,6,2,6-2,NYN,9,1,40,37,77,175,146,321,18,10,28,6,3:22
9903,529438,2018-03-31,2018,BAL,MIN,2,6,6-2,MIN,9,0,37,38,75,142,154,296,10,13,23,0,2:50
9904,529440,2018-03-31,2018,ATL,PHI,15,2,15-2,ATL,9,1,51,36,87,142,181,323,25,10,35,3,3:21
9905,529431,2018-03-31,2018,MIA,CHN,6,10,10-6,CHN,10,0,42,48,90,185,178,363,15,18,33,4,3:57
9906,529444,2018-03-31,2018,CIN,WAS,7,13,13-7,WAS,9,0,42,45,87,179,153,332,14,20,34,3,3:16
9907,529451,2018-04-01,2018,BAL,MIN,0,7,7-0,MIN,9,0,31,41,72,150,107,257,4,13,17,1,2:35
9908,529453,2018-04-01,2018,DET,PIT,0,1,1-0,PIT,9,0,32,32,64,113,127,240,8,10,18,0,2:30
9909,529445,2018-04-01,2018,TBA,BOS,1,2,2-1,BOS,9,0,37,40,77,156,128,284,10,13,23,4,3:24
9910,529446,2018-04-01,2018,MIA,CHN,6,0,6-0,MIA,9,1,36,37,73,131,136,267,14,10,24,0,2:36
9911,529448,2018-04-01,2018,SEA,CLE,5,4,5-4,SEA,9,1,37,37,74,139,150,289,13,11,24,1,2:57
9912,529454,2018-04-01,2018,LAN,SFN,9,0,9-0,LAN,9,1,37,35,72,126,135,261,14,10,24,2,2:47
9913,529450,2018-04-01,2018,OAK,ANA,4,7,7-4,ANA,9,0,36,40,76,138,150,288,10,15,25,3,3:07
9914,529456,2018-04-01,2018,CIN,WAS,5,6,6-5,WAS,9,0,37,41,78,151,140,291,12,16,28,2,2:47
9915,529441,2018-04-01,2018,DET,PIT,6,8,8-6,PIT,9,0,41,39,80,174,148,322,14,12,26,2,3:14
9916,529452,2018-04-01,2018,TOR,NYA,7,4,7-4,TOR,9,1,40,39,79,151,159,310,18,11,29,2,3:03
9917,529449,2018-04-01,2018,TEX,HOU,2,8,8-2,HOU,9,0,33,43,76,181,134,315,7,16,23,3,3:13
9918,529455,2018-04-01,2018,NYN,SLN,1,5,5-1,SLN,9,0,36,42,78,208,138,346,10,17,27,1,3:15
9919,529441,2018-04-01,2018,DET,PIT,6,8,8-6,PIT,9,0,41,39,80,174,148,322,14,12,26,2,3:14
9920,529459,2018-04-02,2018,CIN,CHN,1,0,1-0,CIN,9,1,35,33,68,141,124,265,11,8,19,1,2:33
9921,529463,2018-04-02,2018,DET,KCA,6,1,6-1,DET,9,1,38,33,71,132,143,275,15,7,22,2,2:46
9922,529467,2018-04-02,2018,MIL,SLN,4,8,8-4,SLN,9,0,36,40,76,145,132,277,9,15,24,4,2:59
9923,529460,2018-04-02,2018,TOR,CHA,4,2,4-2,TOR,9,1,32,35,67,140,144,284,8,11,19,2,2:51
9924,529457,2018-04-02,2018,HOU,BAL,6,1,6-1,HOU,9,1,40,36,76,131,145,276,17,9,26,1,2:52
9925,529469,2018-04-02,2018,OAK,TEX,3,1,3-1,OAK,9,1,34,39,73,165,129,294,12,11,23,3,3:10
9926,529461,2018-04-02,2018,ANA,CLE,0,6,6-0,CLE,9,0,37,40,77,163,155,318,10,13,23,6,3:25
9927,529458,2018-04-02,2018,MIA,BOS,3,7,7-3,BOS,9,0,40,41,81,159,137,296,14,15,29,1,3:09
9928,529465,2018-04-02,2018,PIT,MIN,5,4,5-4,PIT,9,1,39,37,76,162,167,329,17,11,28,4,3:26
9929,529470,2018-04-02,2018,ATL,WAS,1,8,8-1,WAS,9,0,31,48,79,196,117,313,5,22,27,2,2:55
9930,529462,2018-04-02,2018,SDN,COL,4,7,7-4,COL,9,0,41,44,85,165,156,321,14,18,32,2,3:11
9931,529464,2018-04-02,2018,ARI,LAN,8,7,8-7,ARI,15,0,63,71,134,280,250,530,25,28,53,2,5:46
9932,529479,2018-04-03,2018,NYN,PHI,2,0,2-0,NYN,9,1,33,34,67,151,127,278,10,6,16,4,2:51
9933,529477,2018-04-03,2018,DET,KCA,0,1,1-0,KCA,9,0,31,32,63,122,104,226,4,6,10,3,2:17
9934,529478,2018-04-03,2018,ARI,LAN,6,1,6-1,ARI,9,1,38,32,70,123,154,277,13,5,18,1,2:48
9935,529476,2018-04-03,2018,SDN,COL,8,4,8-4,SDN,9,1,36,36,72,133,149,282,13,11,24,2,2:47
9936,529482,2018-04-03,2018,OAK,TEX,1,4,4-1,TEX,9,0,38,34,72,133,154,287,12,12,24,2,2:50
9937,529480,2018-04-03,2018,SFN,SEA,4,6,6-4,SEA,9,0,34,41,75,153,132,285,9,17,26,2,3:02
9938,529471,2018-04-03,2018,HOU,BAL,10,6,10-6,HOU,9,1,38,41,79,155,159,314,15,14,29,2,3:19
9939,529475,2018-04-03,2018,ANA,CLE,13,2,13-2,ANA,9,1,39,34,73,138,158,296,16,6,22,1,2:49
9940,529474,2018-04-03,2018,TOR,CHA,14,5,14-5,TOR,9,1,45,40,85,164,167,331,22,13,35,3,3:27
9941,529481,2018-04-03,2018,MIL,SLN,5,4,5-4,MIL,9,0,39,39,78,160,153,313,14,12,26,2,3:11
9942,529468,2018-04-03,2018,NYA,TBA,11,4,11-4,NYA,9,1,41,37,78,137,168,305,17,11,28,2,3:29
9943,529483,2018-04-03,2018,ATL,WAS,13,6,13-6,ATL,9,1,44,42,86,154,164,318,21,15,36,3,3:10 (:12 delay)
9944,529468,2018-04-03,2018,NYA,TBA,11,4,11-4,NYA,9,1,41,37,78,137,168,305,17,11,28,2,3:29
9945,529472,2018-04-03,2018,MIA,BOS,2,4,4-2,BOS,13,0,49,50,99,196,227,423,13,15,28,1,4:27
9946,529489,2018-04-04,2018,ARI,LAN,3,0,3-0,ARI,9,1,29,31,60,134,111,245,7,4,11,1,2:25
9947,529495,2018-04-04,2018,OAK,TEX,6,2,6-2,OAK,9,1,38,31,69,103,152,255,15,6,21,2,2:23
9948,529494,2018-04-04,2018,NYA,TBA,7,2,7-2,NYA,9,1,34,32,66,117,162,279,10,7,17,2,2:44 (1:32 delay)
9949,529485,2018-04-04,2018,TOR,CHA,3,4,4-3,CHA,9,0,35,36,71,139,131,270,7,13,20,3,2:56
9950,529484,2018-04-04,2018,HOU,BAL,3,2,3-2,HOU,9,1,34,39,73,158,130,288,10,12,22,0,2:42
9951,529491,2018-04-04,2018,NYN,PHI,4,2,4-2,NYN,9,1,34,33,67,154,152,306,12,7,19,1,3:05
9952,529493,2018-04-04,2018,MIL,SLN,0,6,6-0,SLN,9,0,34,39,73,157,128,285,8,13,21,3,2:48
9953,529492,2018-04-04,2018,SFN,SEA,10,1,10-1,SFN,9,1,43,38,81,136,160,296,19,14,33,1,2:52
9954,529487,2018-04-04,2018,SDN,COL,2,5,5-2,COL,9,0,35,38,73,157,124,281,9,13,22,1,2:41
9955,529490,2018-04-04,2018,PIT,MIN,3,7,7-3,MIN,9,0,38,39,77,153,167,320,12,13,25,3,3:25
9956,529496,2018-04-04,2018,ATL,WAS,7,1,7-1,ATL,9,1,36,40,76,172,157,329,11,14,25,3,3:06
9957,529486,2018-04-04,2018,ANA,CLE,3,2,3-2,ANA,13,0,46,51,97,229,177,406,11,14,25,4,4:28
9958,529501,2018-04-05,2018,SDN,COL,1,3,3-1,COL,9,0,31,39,70,154,123,277,6,12,18,2,2:58
9959,529498,2018-04-05,2018,NYA,BAL,2,5,5-2,BAL,9,0,37,37,74,148,171,319,12,11,23,2,3:15
9960,529500,2018-04-05,2018,PIT,CIN,5,2,5-2,PIT,9,1,38,36,74,133,127,260,14,10,24,2,2:47
9961,529499,2018-04-05,2018,MIL,CHN,0,8,8-0,CHN,9,0,32,47,79,166,122,288,6,20,26,1,2:52
9962,529505,2018-04-05,2018,MIN,SEA,4,2,4-2,MIN,9,1,35,40,75,150,144,294,10,12,22,5,3:09
9963,529504,2018-04-05,2018,WAS,NYN,2,8,8-2,NYN,9,0,35,39,74,150,147,297,9,13,22,1,2:57
9964,529503,2018-04-05,2018,PHI,MIA,5,0,5-0,PHI,9,1,39,31,70,132,177,309,17,4,21,1,3:03
9965,529507,2018-04-05,2018,OAK,TEX,3,6,6-3,TEX,9,0,40,38,78,136,142,278,15,12,27,4,3:10
9966,529497,2018-04-05,2018,SLN,ARI,1,3,3-1,ARI,9,0,34,42,76,173,144,317,7,16,23,3,3:32
9967,529506,2018-04-05,2018,BOS,TBA,3,2,3-2,BOS,12,0,48,47,95,183,161,344,19,12,31,1,3:55
9968,529502,2018-04-05,2018,CHA,DET,7,9,9-7,DET,10,0,46,48,94,198,168,366,17,19,36,4,4:03
9969,529512,2018-04-06,2018,CLE,KCA,3,2,3-2,CLE,9,1,34,35,69,143,128,271,9,11,20,1,2:41
9970,529515,2018-04-06,2018,HOU,SDN,1,4,4-1,SDN,9,0,35,42,77,157,157,314,8,17,25,1,3:11
9971,529508,2018-04-06,2018,COL,ATL,3,8,8-3,ATL,9,0,36,44,80,152,147,299,9,20,29,2,2:56 (1:01 delay)
9972,529516,2018-04-06,2018,TEX,TOR,5,8,8-5,TOR,9,0,39,43,82,170,162,332,14,16,30,2,3:06 (:36 delay)
9973,529510,2018-04-06,2018,MIL,CHN,5,4,5-4,MIL,9,0,44,39,83,193,158,351,18,13,31,5,3:45
9974,529514,2018-04-06,2018,ANA,OAK,13,9,13-9,ANA,9,1,44,39,83,156,167,323,22,14,36,6,3:35
9975,529511,2018-04-06,2018,PIT,CIN,14,3,14-3,PIT,9,1,45,40,85,153,173,326,22,16,38,2,3:26
9976,529509,2018-04-06,2018,NYA,BAL,3,7,7-3,BAL,14,0,53,61,114,265,218,483,14,18,32,2,5:20
9977,529523,2018-04-07,2018,CLE,KCA,0,1,1-0,KCA,9,0,33,32,65,111,138,249,7,5,12,0,2:29
9978,529531,2018-04-07,2018,TEX,TOR,5,1,5-1,TEX,9,1,36,30,66,129,143,272,13,5,18,1,2:37
9979,529530,2018-04-07,2018,BOS,TBA,10,3,10-3,BOS,9,1,39,32,71,106,170,276,15,6,21,3,2:48
9980,529517,2018-04-07,2018,SLN,ARI,5,3,5-3,SLN,9,1,34,39,73,153,136,289,10,12,22,1,2:58
9981,529526,2018-04-07,2018,WAS,NYN,2,3,3-2,NYN,9,0,35,39,74,138,161,299,8,15,23,3,2:59
9982,529527,2018-04-07,2018,ANA,OAK,3,7,7-3,OAK,9,0,35,42,77,184,145,329,9,18,27,4,3:20
9983,529522,2018-04-07,2018,CHA,DET,1,6,6-1,DET,9,0,39,45,84,174,160,334,12,18,30,4,3:39
9984,529520,2018-04-07,2018,MIL,CHN,2,5,5-2,CHN,9,0,33,41,74,166,139,305,6,16,22,5,3:26
9985,529521,2018-04-07,2018,PIT,CIN,4,7,7-4,CIN,9,0,36,43,79,171,121,292,9,17,26,0,3:09
9986,529519,2018-04-07,2018,NYA,BAL,8,3,8-3,NYA,9,1,37,36,73,129,160,289,19,8,27,2,3:03
9987,529529,2018-04-07,2018,MIN,SEA,4,11,11-4,SEA,9,0,40,42,82,171,177,348,14,15,29,5,3:36
9988,529528,2018-04-07,2018,HOU,SDN,1,0,1-0,HOU,10,0,38,37,75,149,167,316,12,7,19,3,3:27
9989,529525,2018-04-07,2018,PHI,MIA,20,1,20-1,PHI,9,1,49,33,82,137,200,337,26,6,32,2,3:21
9990,529518,2018-04-07,2018,COL,ATL,3,2,3-2,COL,10,0,44,40,84,144,173,317,18,13,31,2,3:28
9991,529524,2018-04-07,2018,SFN,LAN,7,5,7-5,SFN,14,0,57,62,119,248,243,491,20,22,42,5,5:16
9992,529536,2018-04-08,2018,PIT,CIN,5,0,5-0,PIT,9,1,35,30,65,110,147,257,13,4,17,1,2:28
9993,529543,2018-04-08,2018,HOU,SDN,4,1,4-1,HOU,9,1,30,36,66,135,133,268,6,9,15,0,2:25
9994,529533,2018-04-08,2018,COL,ATL,0,4,4-0,ATL,9,0,31,36,67,127,113,240,6,10,16,2,2:26
9995,529537,2018-04-08,2018,CHA,DET,0,1,1-0,DET,9,0,31,33,64,117,128,245,6,7,13,2,2:38
9996,529542,2018-04-08,2018,ANA,OAK,6,1,6-1,ANA,9,1,36,31,67,128,147,275,12,5,17,2,2:53
9997,529535,2018-04-08,2018,MIL,CHN,0,3,3-0,CHN,9,0,31,36,67,146,126,272,5,10,15,0,2:41
9998,529538,2018-04-08,2018,CLE,KCA,3,1,3-1,CLE,9,0,34,34,68,134,146,280,8,12,20,2,2:55
9999,529532,2018-04-08,2018,SLN,ARI,1,4,4-1,ARI,9,0,32,35,67,157,125,282,7,9,16,3,2:53
10000,529539,2018-04-08,2018,SFN,LAN,1,2,2-1,LAN,10,0,36,41,77,156,135,291,8,15,23,2,3:04
10001,529540,2018-04-08,2018,PHI,MIA,3,6,6-3,MIA,9,0,36,38,74,147,153,300,11,14,25,3,3:04
10002,529546,2018-04-08,2018,TEX,TOR,4,7,7-4,TOR,9,0,42,39,81,147,179,326,15,13,28,5,3:16
10003,529541,2018-04-08,2018,WAS,NYN,5,6,6-5,NYN,12,0,55,48,103,187,194,381,23,15,38,1,4:03
10004,529545,2018-04-08,2018,BOS,TBA,8,7,8-7,BOS,9,1,39,44,83,190,166,356,15,17,32,4,3:50
10005,529534,2018-04-08,2018,NYA,BAL,7,8,8-7,BAL,12,0,57,54,111,226,225,451,23,20,43,3,4:48
10006,529548,2018-04-09,2018,WAS,ATL,2,0,2-0,WAS,9,1,36,28,64,102,133,235,15,2,17,0,2:21
10007,529554,2018-04-09,2018,MIA,NYN,2,4,4-2,NYN,9,0,39,36,75,155,143,298,13,11,24,2,3:10
10008,529551,2018-04-09,2018,MIN,HOU,0,2,2-0,HOU,9,0,35,37,72,165,149,314,8,11,19,3,3:28
10009,529557,2018-04-09,2018,KCA,SEA,10,0,10-0,KCA,9,1,44,32,76,113,176,289,20,7,27,1,2:45
10010,529556,2018-04-09,2018,COL,SDN,6,7,7-6,SDN,9,0,38,40,78,141,139,280,12,15,27,2,2:46
10011,529550,2018-04-09,2018,CLE,DET,2,0,2-0,CLE,9,1,31,30,61,112,139,251,9,4,13,1,2:39
10012,529547,2018-04-09,2018,SFN,ARI,1,2,2-1,ARI,9,0,30,32,62,124,139,263,5,6,11,0,2:33
10013,529552,2018-04-09,2018,TEX,ANA,3,8,8-3,ANA,9,0,41,43,84,162,161,323,14,16,30,4,3:28
10014,529559,2018-04-09,2018,BAL,TOR,1,7,7-1,TOR,9,0,39,41,80,157,151,308,13,16,29,1,2:56
10015,529549,2018-04-09,2018,PHI,CIN,6,5,6-5,PHI,9,1,35,41,76,169,163,332,10,17,27,2,3:22
10016,529558,2018-04-09,2018,CHA,TBA,4,5,5-4,TBA,9,0,43,42,85,179,154,333,15,17,32,5,3:47 (:21 delay)
10017,529553,2018-04-09,2018,SLN,MIL,4,5,5-4,MIL,10,0,41,46,87,159,176,335,12,17,29,4,3:41
10018,529570,2018-04-10,2018,COL,SDN,2,5,5-2,SDN,9,0,31,39,70,133,111,244,6,14,20,2,2:39
10019,529573,2018-04-10,2018,BAL,TOR,1,2,2-1,TOR,9,0,33,40,73,143,113,256,10,13,23,0,2:37
10020,529561,2018-04-10,2018,WAS,ATL,4,1,4-1,WAS,9,1,35,34,69,124,155,279,10,8,18,1,2:44
10021,529562,2018-04-10,2018,PHI,CIN,6,1,6-1,PHI,9,1,34,32,66,117,138,255,10,6,16,0,2:44
10022,529569,2018-04-10,2018,LAN,OAK,4,0,4-0,LAN,9,1,35,34,69,152,145,297,13,7,20,2,2:49
10023,529571,2018-04-10,2018,KCA,SEA,3,8,8-3,SEA,9,0,36,43,79,146,147,293,10,18,28,3,2:58
10024,529555,2018-04-10,2018,CHN,PIT,5,8,8-5,PIT,9,0,39,41,80,154,150,304,13,14,27,1,3:05
10025,529560,2018-04-10,2018,SFN,ARI,5,4,5-4,SFN,9,0,39,40,79,177,139,316,17,14,31,2,3:24
10026,529555,2018-04-10,2018,CHN,PIT,5,8,8-5,PIT,9,0,39,41,80,154,150,304,13,14,27,1,3:05
10027,529563,2018-04-10,2018,CLE,DET,2,1,2-1,CLE,9,1,29,36,65,155,117,272,6,9,15,1,2:47
10028,529567,2018-04-10,2018,MIA,NYN,6,8,8-6,NYN,9,0,41,40,81,154,143,297,15,12,27,1,2:59
10029,529564,2018-04-10,2018,MIN,HOU,4,1,4-1,MIN,9,1,39,37,76,145,176,321,15,13,28,0,3:21
10030,529565,2018-04-10,2018,TEX,ANA,1,11,11-1,ANA,9,0,39,46,85,174,166,340,11,22,33,1,3:07
10031,529568,2018-04-10,2018,BOS,NYA,14,1,14-1,BOS,9,1,44,37,81,142,161,303,19,11,30,1,3:11
10032,529566,2018-04-10,2018,SLN,MIL,5,3,5-3,SLN,11,0,48,49,97,171,192,363,19,18,37,4,4:02
10033,529572,2018-04-10,2018,CHA,TBA,5,6,6-5,TBA,9,0,41,47,88,169,176,345,13,23,36,4,3:44
10034,529587,2018-04-11,2018,CHA,TBA,2,1,2-1,CHA,9,1,35,36,71,136,124,260,12,10,22,3,3:02
10035,529585,2018-04-11,2018,COL,SDN,6,4,6-4,COL,9,1,37,35,72,125,147,272,13,8,21,2,2:56
10036,529581,2018-04-11,2018,MIA,NYN,1,4,4-1,NYN,9,0,30,36,66,128,112,240,4,12,16,3,2:27
10037,529577,2018-04-11,2018,CLE,DET,5,1,5-1,CLE,9,1,38,31,69,110,140,250,14,5,19,2,2:44
10038,529588,2018-04-11,2018,BAL,TOR,5,3,5-3,BAL,9,1,38,37,75,147,159,306,14,10,24,1,2:57
10039,529580,2018-04-11,2018,SLN,MIL,2,3,3-2,MIL,9,0,34,34,68,116,148,264,9,9,18,2,3:00
10040,529584,2018-04-11,2018,CHN,PIT,13,5,13-5,CHN,9,1,44,37,81,133,180,313,20,11,31,1,2:59
10041,529579,2018-04-11,2018,TEX,ANA,2,7,7-2,ANA,9,0,40,43,83,164,152,316,13,17,30,4,3:27
10042,529574,2018-04-11,2018,SFN,ARI,3,7,7-3,ARI,9,0,36,37,73,158,158,316,11,10,21,4,3:09
10043,529586,2018-04-11,2018,KCA,SEA,2,4,4-2,SEA,9,0,37,36,73,148,146,294,10,10,20,1,2:48
10044,529578,2018-04-11,2018,MIN,HOU,9,8,9-8,MIN,9,0,42,47,89,174,175,349,16,21,37,4,3:35
10045,529583,2018-04-11,2018,LAN,OAK,6,16,16-6,OAK,9,0,40,50,90,208,161,369,12,22,34,2,3:50
10046,529582,2018-04-11,2018,BOS,NYA,7,10,10-7,NYA,9,0,38,44,82,181,154,335,12,18,30,1,3:59
10047,529575,2018-04-11,2018,WAS,ATL,3,5,5-3,ATL,12,0,46,54,100,191,158,349,14,21,35,1,3:43
10048,529576,2018-04-11,2018,PHI,CIN,4,3,4-3,PHI,12,0,47,47,94,187,182,369,14,12,26,2,3:48
10049,529594,2018-04-12,2018,CHN,PIT,1,6,6-1,PIT,9,0,35,44,79,169,133,302,9,19,28,1,2:57
10050,529592,2018-04-12,2018,KCA,ANA,1,7,7-1,ANA,9,0,36,45,81,171,119,290,11,19,30,3,3:00
10051,529591,2018-04-12,2018,CLE,DET,9,3,9-3,CLE,9,1,42,41,83,143,146,289,18,12,30,1,2:58
10052,529590,2018-04-12,2018,WAS,COL,1,5,5-1,COL,9,0,31,40,71,163,125,288,6,12,18,0,2:43
10053,529589,2018-04-12,2018,MIN,CHA,4,0,4-0,MIN,9,1,36,31,67,127,143,270,13,4,17,1,2:55
10054,529595,2018-04-12,2018,SDN,SFN,0,7,7-0,SFN,9,0,30,46,76,171,126,297,4,19,23,1,2:47
10055,529593,2018-04-12,2018,BOS,NYA,6,3,6-3,BOS,9,1,38,35,73,138,139,277,12,8,20,2,3:01 (:45 delay)
10056,529596,2018-04-12,2018,CIN,SLN,4,13,13-4,SLN,9,0,38,52,90,220,154,374,11,25,36,3,3:32
10057,529608,2018-04-13,2018,SDN,SFN,5,1,5-1,SDN,9,1,36,37,73,126,118,244,10,12,22,3,2:32
10058,529607,2018-04-13,2018,MIA,PIT,7,2,7-2,MIA,9,1,38,33,71,122,144,266,16,8,24,1,2:48
10059,529606,2018-04-13,2018,TBA,PHI,1,2,2-1,PHI,9,0,34,36,70,133,131,264,7,11,18,4,2:53
10060,529601,2018-04-13,2018,WAS,COL,1,2,2-1,COL,9,0,35,33,68,136,167,303,8,6,14,3,3:04
10061,529603,2018-04-13,2018,NYN,MIL,6,5,6-5,NYN,9,1,35,38,73,134,155,289,12,13,25,5,3:10
10062,529598,2018-04-13,2018,CHN,ATL,0,4,4-0,ATL,9,0,32,44,76,173,137,310,6,17,23,1,3:09
10063,529610,2018-04-13,2018,HOU,TEX,3,2,3-2,HOU,9,1,36,36,72,129,141,270,11,9,20,2,2:50
10064,529611,2018-04-13,2018,CLE,TOR,4,8,8-4,TOR,9,0,39,40,79,170,154,324,14,11,25,2,3:12
10065,529604,2018-04-13,2018,DET,NYA,6,8,8-6,NYA,9,0,39,44,83,152,161,313,12,16,28,4,3:28
10066,529602,2018-04-13,2018,KCA,ANA,4,5,5-4,ANA,9,0,38,41,79,156,157,313,14,14,28,2,3:24
10067,529609,2018-04-13,2018,CIN,SLN,3,5,5-3,SLN,9,0,36,40,76,133,158,291,10,16,26,3,3:05
10068,529605,2018-04-13,2018,SEA,OAK,7,4,7-4,SEA,9,1,37,38,75,150,163,313,14,12,26,3,3:08
10069,529599,2018-04-13,2018,BOS,BAL,7,3,7-3,BOS,9,1,42,37,79,151,163,314,18,11,29,2,3:22
10070,529597,2018-04-13,2018,LAN,ARI,7,8,8-7,ARI,9,0,41,40,81,176,146,322,15,13,28,3,3:30
10071,529616,2018-04-14,2018,WAS,COL,6,2,6-2,WAS,9,1,37,31,68,140,139,279,15,4,19,2,2:53
10072,529624,2018-04-14,2018,CIN,SLN,1,6,6-1,SLN,9,0,36,40,76,159,123,282,10,14,24,1,2:43
10073,529622,2018-04-14,2018,MIA,PIT,0,1,1-0,PIT,9,0,36,33,69,113,140,253,10,9,19,0,2:31
10074,529623,2018-04-14,2018,SDN,SFN,5,4,5-4,SDN,9,1,39,37,76,149,149,298,15,12,27,5,2:59
10075,529618,2018-04-14,2018,NYN,MIL,1,5,5-1,MIL,9,0,31,37,68,157,118,275,6,10,16,1,2:46
10076,529612,2018-04-14,2018,LAN,ARI,1,9,9-1,ARI,9,0,36,38,74,149,164,313,10,12,22,0,3:10
10077,529621,2018-04-14,2018,TBA,PHI,4,9,9-4,PHI,9,0,36,42,78,150,118,268,11,16,27,1,2:46
10078,529625,2018-04-14,2018,HOU,TEX,5,6,6-5,TEX,10,0,42,43,85,175,183,358,12,15,27,2,3:26
10079,529620,2018-04-14,2018,SEA,OAK,10,8,10-8,SEA,9,1,44,40,84,176,159,335,19,14,33,4,3:32
10080,529614,2018-04-14,2018,BOS,BAL,10,3,10-3,BOS,9,1,41,35,76,146,149,295,17,10,27,2,3:05
10081,529617,2018-04-14,2018,KCA,ANA,3,5,5-3,ANA,9,0,37,39,76,166,160,326,11,11,22,4,3:03
10082,529613,2018-04-14,2018,CHN,ATL,14,10,14-10,CHN,9,1,47,49,96,201,196,397,23,23,46,5,3:43
10083,529629,2018-04-15,2018,BOS,BAL,3,1,3-1,BOS,9,1,36,33,69,151,124,275,12,6,18,1,2:54
10084,529627,2018-04-15,2018,LAN,ARI,7,2,7-2,LAN,9,1,40,33,73,133,164,297,15,5,20,1,3:09
10085,529635,2018-04-15,2018,SEA,OAK,1,2,2-1,OAK,9,0,32,36,68,125,116,241,5,10,15,3,2:40
10086,529640,2018-04-15,2018,HOU,TEX,1,3,3-1,TEX,10,0,36,37,73,141,148,289,5,7,12,1,3:06
10087,529639,2018-04-15,2018,CIN,SLN,2,3,3-2,SLN,9,0,37,31,68,111,144,255,11,7,18,1,2:40 (2:36 delay)
10088,529638,2018-04-15,2018,SDN,SFN,10,1,10-1,SDN,9,1,43,34,77,127,182,309,19,8,27,2,3:09
10089,529631,2018-04-15,2018,WAS,COL,5,6,6-5,COL,9,0,40,34,74,136,173,309,16,7,23,3,3:14
10090,529633,2018-04-15,2018,NYN,MIL,3,2,3-2,NYN,9,0,41,38,79,168,168,336,16,9,25,4,3:28
10091,529637,2018-04-15,2018,MIA,PIT,3,7,7-3,PIT,9,0,36,42,78,154,143,297,8,16,24,1,3:03
10092,529636,2018-04-15,2018,TBA,PHI,4,10,10-4,PHI,9,0,42,43,85,183,152,335,15,15,30,5,3:34
10093,529646,2018-04-16,2018,SEA,HOU,2,1,2-1,SEA,9,1,31,34,65,148,96,244,7,7,14,0,2:21
10094,529652,2018-04-16,2018,TBA,TEX,8,4,8-4,TBA,9,1,41,35,76,144,144,288,17,9,26,1,2:49
10095,529650,2018-04-16,2018,ATL,PHI,2,1,2-1,ATL,9,1,28,38,66,151,99,250,5,12,17,1,2:40
10096,529643,2018-04-16,2018,OAK,CHA,8,1,8-1,OAK,9,1,40,33,73,119,168,287,15,7,22,3,2:56
10097,529645,2018-04-16,2018,PIT,COL,2,6,6-2,COL,9,0,32,36,68,143,130,273,6,11,17,0,2:35
10098,529648,2018-04-16,2018,SDN,LAN,3,10,10-3,LAN,9,0,34,43,77,170,140,310,8,17,25,0,2:50
10099,529644,2018-04-16,2018,MIL,CIN,4,10,10-4,CIN,9,0,37,44,81,144,146,290,11,19,30,2,2:51
10100,529653,2018-04-16,2018,NYN,WAS,6,8,8-6,WAS,9,0,39,41,80,152,156,308,14,16,30,5,3:25
10101,529649,2018-04-16,2018,NYA,MIA,12,1,12-1,NYA,9,1,47,37,84,172,217,389,24,9,33,2,3:38
10102,529658,2018-04-17,2018,MIN,CLE,1,6,6-1,CLE,9,0,38,40,78,169,153,322,10,13,23,3,3:24
10103,529665,2018-04-17,2018,ARI,SFN,1,0,1-0,ARI,9,1,29,29,58,100,111,211,5,2,7,0,2:05
10104,529660,2018-04-17,2018,SEA,HOU,1,4,4-1,HOU,9,0,30,41,71,150,127,277,4,15,19,1,2:48
10105,529657,2018-04-17,2018,MIL,CIN,2,0,2-0,MIL,9,1,33,34,67,144,140,284,10,7,17,4,2:56
10106,529659,2018-04-17,2018,PIT,COL,0,2,2-0,COL,9,0,32,35,67,138,107,245,7,9,16,2,2:31
10107,529655,2018-04-17,2018,ANA,BOS,1,10,10-1,BOS,9,0,36,45,81,183,130,313,10,21,31,1,3:15
10108,529663,2018-04-17,2018,NYA,MIA,1,9,9-1,MIA,9,0,37,40,77,137,170,307,11,14,25,1,3:11
10109,529654,2018-04-17,2018,DET,BAL,4,2,4-2,DET,9,1,36,36,72,150,137,287,15,11,26,1,2:44
10110,529667,2018-04-17,2018,TBA,TEX,2,7,7-2,TEX,9,0,35,44,79,143,119,262,11,16,27,1,2:44
10111,529656,2018-04-17,2018,OAK,CHA,10,2,10-2,OAK,9,1,41,37,78,148,170,318,19,11,30,1,2:56
10112,529668,2018-04-17,2018,NYN,WAS,2,5,5-2,WAS,9,0,40,41,81,152,167,319,14,15,29,1,3:11
10113,529661,2018-04-17,2018,TOR,KCA,11,3,11-3,TOR,9,1,41,37,78,146,150,296,18,13,31,1,2:56
10114,529666,2018-04-17,2018,CHN,SLN,3,5,5-3,SLN,9,0,41,44,85,196,158,354,14,17,31,4,3:33
10115,529664,2018-04-17,2018,ATL,PHI,1,5,5-1,PHI,10,0,43,44,87,192,179,371,14,19,33,5,3:36
10116,529647,2018-04-17,2018,TOR,KCA,5,4,5-4,TOR,10,0,44,46,90,189,191,380,18,16,34,4,3:37
10117,529647,2018-04-17,2018,TOR,KCA,5,4,5-4,TOR,10,0,44,46,90,189,191,380,18,16,34,4,3:37
10118,529662,2018-04-17,2018,SDN,LAN,3,7,7-3,LAN,12,0,48,54,102,198,191,389,13,20,33,4,4:12
10119,529681,2018-04-18,2018,TBA,TEX,4,2,4-2,TBA,9,1,35,35,70,126,114,240,10,10,20,1,2:36
10120,529672,2018-04-18,2018,MIL,CIN,2,0,2-0,MIL,9,1,35,35,70,127,131,258,14,8,22,1,2:42
10121,529673,2018-04-18,2018,MIN,CLE,2,1,2-1,MIN,16,0,61,61,122,209,233,442,16,16,32,4,5:13
10122,529669,2018-04-18,2018,DET,BAL,6,5,6-5,DET,9,0,36,38,74,149,126,275,13,11,24,4,2:46
10123,529682,2018-04-18,2018,NYN,WAS,11,5,11-5,NYN,9,1,39,32,71,141,149,290,16,6,22,2,2:51
10124,529675,2018-04-18,2018,SEA,HOU,1,7,7-1,HOU,9,0,32,40,72,145,124,269,7,14,21,2,2:45
10125,529670,2018-04-18,2018,ANA,BOS,0,9,9-0,BOS,9,0,35,44,79,186,137,323,8,17,25,2,3:18
10126,529678,2018-04-18,2018,ATL,PHI,7,3,7-3,ATL,9,1,36,35,71,157,139,296,15,10,25,2,3:08
10127,529677,2018-04-18,2018,SDN,LAN,4,13,13-4,LAN,9,0,39,48,87,186,150,336,12,21,33,1,3:26
10128,529674,2018-04-18,2018,PIT,COL,10,2,10-2,PIT,9,1,41,38,79,140,189,329,17,11,28,1,3:04
10129,529679,2018-04-18,2018,ARI,SFN,3,4,4-3,SFN,10,0,42,43,85,184,155,339,14,15,29,1,3:44
10130,529676,2018-04-18,2018,TOR,KCA,15,5,15-5,TOR,9,1,48,40,88,153,182,335,23,12,35,3,3:05
10131,529671,2018-04-18,2018,OAK,CHA,12,11,12-11,OAK,14,0,68,65,133,268,288,556,28,24,52,7,5:48
10132,529688,2018-04-19,2018,PHI,PIT,7,0,7-0,PHI,9,1,38,31,69,130,165,295,15,4,19,2,2:53
10133,529689,2018-04-19,2018,ARI,SFN,3,1,3-1,ARI,9,1,34,32,66,122,118,240,10,6,16,0,2:23
10134,529683,2018-04-19,2018,DET,BAL,13,8,13-8,DET,9,1,45,42,87,160,156,316,21,17,38,3,3:11
10135,529690,2018-04-19,2018,NYA,TOR,4,3,4-3,NYA,9,1,34,38,72,142,142,284,12,10,22,1,3:00
10136,529684,2018-04-19,2018,ANA,BOS,2,8,8-2,BOS,9,0,35,42,77,148,155,303,7,19,26,3,3:35
10137,529685,2018-04-19,2018,SEA,HOU,2,9,9-2,HOU,9,0,35,40,75,166,133,299,8,17,25,2,3:02
10138,529680,2018-04-19,2018,CHN,SLN,8,5,8-5,CHN,9,1,42,38,80,165,159,324,19,11,30,2,3:10
10139,529687,2018-04-19,2018,ATL,NYN,12,4,12-4,ATL,9,1,42,35,77,151,151,302,18,9,27,2,3:00
10140,529680,2018-04-19,2018,CHN,SLN,8,5,8-5,CHN,9,1,42,38,80,165,159,324,19,11,30,2,3:10
10141,529686,2018-04-19,2018,MIL,MIA,12,3,12-3,MIL,9,1,43,34,77,150,169,319,21,9,30,3,3:19
10142,529488,2018-04-20,2018,DET,KCA,3,2,3-2,DET,10,0,34,42,76,157,109,266,8,13,21,0,2:46
10143,529700,2018-04-20,2018,PHI,PIT,2,1,2-1,PHI,9,1,31,37,68,131,129,260,9,10,19,0,2:42
10144,529694,2018-04-20,2018,BAL,CLE,3,1,3-1,BAL,9,1,33,37,70,143,144,287,11,11,22,0,2:52
10145,529488,2018-04-20,2018,DET,KCA,3,2,3-2,DET,10,0,34,42,76,157,109,266,8,13,21,0,2:46
10146,529695,2018-04-20,2018,CHA,HOU,0,10,10-0,HOU,9,0,31,43,74,172,129,301,5,17,22,2,3:04
10147,529702,2018-04-20,2018,ANA,SFN,1,8,8-1,SFN,9,0,35,39,74,147,133,280,9,12,21,1,2:50
10148,529701,2018-04-20,2018,ARI,SDN,1,4,4-1,SDN,9,0,32,36,68,134,153,287,5,7,12,2,2:54
10149,529698,2018-04-20,2018,TBA,MIN,8,7,8-7,TBA,10,0,46,39,85,148,160,308,20,10,30,5,3:30
10150,529696,2018-04-20,2018,DET,KCA,2,3,3-2,KCA,9,0,33,40,73,163,120,283,6,13,19,1,2:34
10151,529705,2018-04-20,2018,LAN,WAS,2,5,5-2,WAS,9,0,38,39,77,127,151,278,12,13,25,2,3:09
10152,529704,2018-04-20,2018,NYA,TOR,5,8,8-5,TOR,9,0,38,45,83,176,183,359,12,18,30,2,3:22
10153,529693,2018-04-20,2018,SLN,CIN,4,2,4-2,SLN,9,1,39,35,74,138,153,291,16,11,27,1,3:02
10154,529691,2018-04-20,2018,OAK,BOS,3,7,7-3,BOS,9,0,40,36,76,131,172,303,13,12,25,4,3:16
10155,529703,2018-04-20,2018,TEX,SEA,2,6,6-2,SEA,9,0,36,43,79,173,150,323,11,18,29,4,3:20
10156,529697,2018-04-20,2018,MIL,MIA,8,0,8-0,MIL,9,1,43,37,80,155,179,334,20,10,30,2,3:17
10157,529692,2018-04-20,2018,COL,CHN,5,16,16-5,CHN,9,0,39,49,88,174,164,338,15,23,38,2,3:30
10158,529699,2018-04-20,2018,ATL,NYN,3,5,5-3,NYN,12,0,45,48,93,204,196,400,11,16,27,0,3:51
10159,529706,2018-04-21,2018,OAK,BOS,3,0,3-0,OAK,9,1,33,30,63,108,125,233,9,2,11,0,2:16
10160,529720,2018-04-21,2018,LAN,WAS,4,0,4-0,LAN,9,1,33,33,66,117,127,244,12,6,18,0,2:29
10161,529716,2018-04-21,2018,ARI,SDN,6,2,6-2,ARI,9,1,37,34,71,132,150,282,15,10,25,2,2:55
10162,529709,2018-04-21,2018,BAL,CLE,0,4,4-0,CLE,9,0,31,35,66,125,107,232,4,12,16,0,2:21
10163,529717,2018-04-21,2018,ANA,SFN,4,3,4-3,ANA,9,1,31,37,68,161,126,287,8,11,19,2,2:58
10164,529707,2018-04-21,2018,COL,CHN,5,2,5-2,COL,9,1,37,33,70,120,157,277,13,8,21,3,3:03
10165,529708,2018-04-21,2018,SLN,CIN,4,3,4-3,SLN,9,1,34,40,74,143,125,268,11,16,27,3,2:57
10166,529719,2018-04-21,2018,NYA,TOR,9,1,9-1,NYA,9,1,40,34,74,126,158,284,16,7,23,1,2:50
10167,529713,2018-04-21,2018,TBA,MIN,10,1,10-1,TBA,9,1,38,33,71,141,141,282,15,9,24,1,2:53
10168,529715,2018-04-21,2018,PHI,PIT,6,2,6-2,PHI,9,1,37,34,71,134,156,290,12,8,20,5,3:11
10169,529714,2018-04-21,2018,ATL,NYN,4,3,4-3,ATL,9,0,37,38,75,135,139,274,13,12,25,3,3:07
10170,529712,2018-04-21,2018,MIL,MIA,6,5,6-5,MIL,9,0,34,36,70,142,166,308,11,11,22,0,2:57
10171,529710,2018-04-21,2018,CHA,HOU,1,10,10-1,HOU,9,0,35,44,79,167,145,312,8,20,28,3,3:13
10172,529711,2018-04-21,2018,DET,KCA,12,4,12-4,DET,9,1,48,39,87,111,186,297,24,12,36,5,3:04
10173,529718,2018-04-21,2018,TEX,SEA,7,9,9-7,SEA,9,0,47,41,88,134,207,341,19,16,35,4,3:29 (1:25 delay)
10174,529734,2018-04-22,2018,NYA,TOR,5,1,5-1,NYA,9,1,35,35,70,147,140,287,12,9,21,1,2:47
10175,529721,2018-04-22,2018,OAK,BOS,4,1,4-1,OAK,9,1,32,35,67,142,98,240,10,7,17,3,2:44
10176,529727,2018-04-22,2018,MIL,MIA,4,2,4-2,MIL,9,1,33,35,68,135,120,255,9,9,18,1,2:42
10177,529724,2018-04-22,2018,BAL,CLE,3,7,7-3,CLE,9,0,32,44,76,165,120,285,6,16,22,1,2:54
10178,529731,2018-04-22,2018,ARI,SDN,4,2,4-2,ARI,9,1,33,32,65,134,138,272,10,4,14,1,2:42
10179,529726,2018-04-22,2018,DET,KCA,5,8,8-5,KCA,9,0,36,41,77,164,152,316,11,15,26,3,3:09
10180,529723,2018-04-22,2018,SLN,CIN,9,2,9-2,SLN,9,1,41,33,74,104,159,263,19,5,24,1,2:37
10181,529735,2018-04-22,2018,LAN,WAS,4,3,4-3,LAN,9,1,32,38,70,149,138,287,10,13,23,3,3:21
10182,529733,2018-04-22,2018,TEX,SEA,7,4,7-4,TEX,9,1,36,43,79,160,111,271,13,14,27,3,2:55
10183,529728,2018-04-22,2018,TBA,MIN,8,6,8-6,TBA,9,0,39,41,80,169,162,331,17,15,32,7,3:39
10184,529725,2018-04-22,2018,CHA,HOU,1,7,7-1,HOU,9,0,35,45,80,184,137,321,13,17,30,2,3:20
10185,529730,2018-04-22,2018,PHI,PIT,3,2,3-2,PHI,11,0,44,44,88,157,167,324,13,13,26,1,3:35
10186,529722,2018-04-22,2018,COL,CHN,7,9,9-7,CHN,9,0,42,47,89,182,152,334,16,19,35,5,3:47
10187,529732,2018-04-22,2018,ANA,SFN,2,4,4-2,SFN,9,0,37,41,78,194,166,360,11,15,26,3,3:45
10188,529738,2018-04-23,2018,HOU,ANA,0,2,2-0,ANA,9,0,34,33,67,142,143,285,9,7,16,0,2:59
10189,529744,2018-04-23,2018,SFN,WAS,4,2,4-2,SFN,9,1,34,37,71,151,130,281,9,9,18,3,2:44
10190,529739,2018-04-23,2018,LAN,MIA,2,1,2-1,LAN,9,1,32,38,70,149,134,283,8,12,20,1,2:59
10191,529743,2018-04-23,2018,CHA,SEA,10,4,10-4,CHA,9,1,41,35,76,139,136,275,18,10,28,1,2:56
10192,529742,2018-04-23,2018,COL,SDN,5,13,13-5,SDN,9,0,36,49,85,208,144,352,11,22,33,3,3:24
10193,529741,2018-04-23,2018,TEX,OAK,4,9,9-4,OAK,9,0,34,46,80,161,147,308,9,23,32,6,3:20
10194,529740,2018-04-23,2018,NYA,MIN,14,1,14-1,NYA,9,1,44,37,81,144,197,341,20,10,30,4,3:38
10195,529737,2018-04-23,2018,BAL,CLE,1,2,2-1,CLE,9,0,34,32,66,115,108,223,10,5,15,1,2:21
10196,529736,2018-04-23,2018,CIN,ATL,10,4,10-4,CIN,9,1,42,35,77,136,198,334,18,8,26,4,3:11
10197,529757,2018-04-24,2018,CHA,SEA,0,1,1-0,SEA,9,0,33,34,67,141,120,261,6,7,13,4,2:52
10198,529748,2018-04-24,2018,CLE,CHN,3,10,10-3,CHN,9,0,38,43,81,160,135,295,15,16,31,2,3:00
10199,529759,2018-04-24,2018,SFN,WAS,4,3,4-3,SFN,9,1,34,34,68,120,131,251,11,10,21,0,2:27
10200,529752,2018-04-24,2018,KCA,MIL,2,5,5-2,MIL,9,0,35,39,74,143,143,286,10,16,26,3,2:59
10201,529756,2018-04-24,2018,COL,SDN,8,0,8-0,COL,9,1,37,32,69,113,138,251,14,6,20,1,2:24 (:46 delay)
10202,529747,2018-04-24,2018,TOR,BOS,4,3,4-3,TOR,10,0,37,39,76,163,132,295,8,11,19,0,2:51
10203,529753,2018-04-24,2018,NYA,MIN,8,3,8-3,NYA,9,1,38,35,73,147,165,312,13,8,21,2,3:11
10204,529751,2018-04-24,2018,LAN,MIA,2,3,3-2,MIA,9,0,37,36,73,138,162,300,10,9,19,2,3:06
10205,529755,2018-04-24,2018,TEX,OAK,2,3,3-2,OAK,9,0,35,41,76,155,129,284,9,16,25,3,3:07
10206,529750,2018-04-24,2018,HOU,ANA,7,8,8-7,ANA,9,0,45,39,84,146,178,324,21,14,35,5,3:48
10207,529745,2018-04-24,2018,PHI,ARI,4,8,8-4,ARI,9,0,38,41,79,174,176,350,12,17,29,5,3:49
10208,529754,2018-04-24,2018,SLN,NYN,5,6,6-5,NYN,10,0,43,42,85,169,167,336,15,14,29,2,3:28
10209,529746,2018-04-24,2018,CIN,ATL,9,7,9-7,CIN,12,0,49,51,100,204,179,383,17,16,33,3,4:06
10210,529765,2018-04-25,2018,HOU,ANA,5,2,5-2,HOU,9,1,33,31,64,117,135,252,10,4,14,1,2:44
10211,529773,2018-04-25,2018,BAL,TBA,4,8,8-4,TBA,9,0,35,42,77,131,138,269,8,17,25,3,2:53
10212,529767,2018-04-25,2018,KCA,MIL,2,6,6-2,MIL,9,0,35,40,75,155,121,276,9,11,20,4,2:57
10213,529760,2018-04-25,2018,PHI,ARI,5,3,5-3,PHI,9,1,32,36,68,150,123,273,11,9,20,2,2:55
10214,529763,2018-04-25,2018,CLE,CHN,4,1,4-1,CLE,9,1,33,37,70,143,125,268,9,9,18,3,2:50
10215,529770,2018-04-25,2018,TEX,OAK,4,2,4-2,TEX,9,1,37,34,71,151,149,300,13,7,20,2,2:59
10216,529769,2018-04-25,2018,SLN,NYN,9,1,9-1,SLN,9,1,38,35,73,143,152,295,11,8,19,1,2:47
10217,529761,2018-04-25,2018,CIN,ATL,4,5,5-4,ATL,9,0,41,43,84,151,131,282,17,17,34,1,3:07
10218,529772,2018-04-25,2018,CHA,SEA,3,4,4-3,SEA,9,0,35,41,76,156,141,297,9,15,24,1,2:57
10219,529762,2018-04-25,2018,TOR,BOS,3,4,4-3,BOS,9,0,35,41,76,157,136,293,7,14,21,3,3:04
10220,529771,2018-04-25,2018,COL,SDN,5,2,5-2,COL,9,1,37,33,70,165,154,319,13,8,21,0,3:06
10221,529749,2018-04-25,2018,PIT,DET,8,3,8-3,PIT,9,1,45,34,79,143,194,337,22,9,31,1,3:09
10222,529749,2018-04-25,2018,PIT,DET,8,3,8-3,PIT,9,1,45,34,79,143,194,337,22,9,31,1,3:09
10223,529774,2018-04-25,2018,SFN,WAS,2,15,15-2,WAS,9,0,38,53,91,190,140,330,11,26,37,2,3:13
10224,529768,2018-04-25,2018,NYA,MIN,7,4,7-4,NYA,9,1,42,42,84,169,179,348,20,16,36,3,3:40
10225,529764,2018-04-25,2018,PIT,DET,10,13,13-10,DET,9,0,46,52,98,171,201,372,18,25,43,3,3:51
10226,529766,2018-04-25,2018,LAN,MIA,6,8,8-6,MIA,9,0,40,47,87,199,191,390,13,18,31,3,3:54
10227,529780,2018-04-26,2018,CHN,MIL,1,0,1-0,CHN,9,1,29,31,60,120,95,215,8,6,14,0,2:22
10228,529783,2018-04-26,2018,CLE,SEA,4,5,5-4,SEA,9,0,39,37,76,121,150,271,12,13,25,5,2:46
10229,529779,2018-04-26,2018,PIT,DET,1,0,1-0,PIT,9,0,32,35,67,114,139,253,9,9,18,0,2:36
10230,529784,2018-04-26,2018,BAL,TBA,5,9,9-5,TBA,9,0,42,41,83,140,171,311,19,15,34,4,3:20
10231,529781,2018-04-26,2018,NYA,MIN,4,3,4-3,NYA,9,0,32,39,71,166,132,298,8,12,20,0,3:05
10232,529777,2018-04-26,2018,TOR,BOS,4,5,5-4,BOS,9,0,38,37,75,153,163,316,11,11,22,1,3:08
10233,529776,2018-04-26,2018,CIN,ATL,4,7,7-4,ATL,9,0,37,40,77,113,155,268,10,17,27,2,2:41
10234,529778,2018-04-26,2018,KCA,CHA,3,6,6-3,CHA,9,0,41,38,79,142,154,296,15,12,27,3,3:08
10235,529775,2018-04-26,2018,PHI,ARI,2,8,8-2,ARI,9,0,35,43,78,167,148,315,11,19,30,1,3:12
10236,529782,2018-04-26,2018,SLN,NYN,4,3,4-3,SLN,13,0,50,53,103,193,190,383,14,14,28,2,4:11
10237,529790,2018-04-27,2018,BAL,DET,6,0,6-0,BAL,9,1,33,32,65,127,114,241,10,5,15,0,2:26
10238,529795,2018-04-27,2018,HOU,OAK,1,8,8-1,OAK,9,0,33,36,69,135,110,245,6,10,16,1,2:30
10239,529793,2018-04-27,2018,SDN,NYN,1,5,5-1,NYN,9,0,34,39,73,133,135,268,10,14,24,3,2:40
10240,529792,2018-04-27,2018,CHN,MIL,3,2,3-2,CHN,9,1,33,36,69,155,148,303,8,8,16,3,3:03
10241,529786,2018-04-27,2018,PHI,ATL,7,3,7-3,PHI,9,1,36,37,73,134,127,261,14,10,24,0,2:50
10242,529785,2018-04-27,2018,WAS,ARI,4,5,5-4,ARI,9,0,41,34,75,119,163,282,14,8,22,2,3:02
10243,529799,2018-04-27,2018,TOR,TEX,4,6,6-4,TEX,9,0,38,38,76,141,129,270,12,12,24,2,2:50
10244,529789,2018-04-27,2018,MIA,COL,0,1,1-0,COL,9,0,37,38,75,138,162,300,10,16,26,2,3:16
10245,529798,2018-04-27,2018,BOS,TBA,3,4,4-3,TBA,9,0,35,37,72,139,138,277,9,14,23,2,3:10
10246,529794,2018-04-27,2018,ANA,NYA,3,4,4-3,NYA,10,0,35,41,76,159,134,293,7,12,19,1,3:15
10247,529791,2018-04-27,2018,SFN,LAN,6,4,6-4,SFN,9,1,36,41,77,183,152,335,12,15,27,3,3:27
10248,529797,2018-04-27,2018,PIT,SLN,6,5,6-5,PIT,11,0,48,44,92,156,187,343,17,12,29,4,3:34
10249,529787,2018-04-27,2018,KCA,CHA,4,7,7-4,CHA,11,0,47,44,91,174,173,347,15,13,28,2,3:34
10250,529788,2018-04-27,2018,MIN,CIN,9,15,15-9,CIN,9,0,45,54,99,176,202,378,20,27,47,7,4:00
10251,529796,2018-04-27,2018,CLE,SEA,6,5,6-5,CLE,9,1,38,35,73,124,130,254,14,9,23,2,2:36 (:10 delay)
10252,529807,2018-04-28,2018,CHN,MIL,3,0,3-0,CHN,9,1,33,30,63,122,132,254,9,3,12,2,2:37
10253,529804,2018-04-28,2018,MIA,COL,4,1,4-1,MIA,9,1,35,35,70,123,143,266,11,9,20,1,2:44
10254,529812,2018-04-28,2018,PIT,SLN,6,2,6-2,PIT,9,1,39,35,74,142,151,293,18,7,25,3,3:14
10255,529803,2018-04-28,2018,MIN,CIN,3,1,3-1,MIN,9,1,35,37,72,137,152,289,11,12,23,2,2:58
10256,529806,2018-04-28,2018,SFN,LAN,8,3,8-3,SFN,9,1,37,36,73,161,124,285,14,10,24,3,2:58
10257,529808,2018-04-28,2018,SDN,NYN,12,2,12-2,SDN,9,1,43,33,76,109,163,272,18,6,24,2,2:50
10258,529447,2018-04-28,2018,KCA,CHA,0,8,8-0,CHA,9,0,35,43,78,148,140,288,9,18,27,1,2:49
10259,529814,2018-04-28,2018,TOR,TEX,4,7,7-4,TEX,9,0,35,41,76,173,130,303,8,14,22,1,3:00
10260,529802,2018-04-28,2018,KCA,CHA,5,2,5-2,KCA,9,1,38,32,70,123,150,273,15,7,22,0,2:39
10261,529447,2018-04-28,2018,KCA,CHA,0,8,8-0,CHA,9,0,35,43,78,148,140,288,9,18,27,1,2:49
10262,529801,2018-04-28,2018,PHI,ATL,1,4,4-1,ATL,9,0,36,40,76,149,151,300,10,14,24,2,3:10
10263,529810,2018-04-28,2018,HOU,OAK,11,0,11-0,HOU,9,1,43,29,72,131,185,316,19,4,23,2,3:14
10264,529809,2018-04-28,2018,ANA,NYA,1,11,11-1,NYA,9,0,36,48,84,156,146,302,10,19,29,2,3:09
10265,529800,2018-04-28,2018,WAS,ARI,3,4,4-3,ARI,10,0,41,41,82,139,128,267,14,13,27,4,3:16
10266,529805,2018-04-28,2018,BAL,DET,5,9,9-5,DET,9,0,39,45,84,164,147,311,14,18,32,3,3:13 (:30 delay)
10267,529811,2018-04-28,2018,CLE,SEA,4,12,12-4,SEA,9,0,35,44,79,168,136,304,8,16,24,1,3:00
10268,529813,2018-04-28,2018,BOS,TBA,6,12,12-6,TBA,9,0,43,48,91,174,157,331,16,23,39,4,3:52
10269,529513,2018-04-28,2018,SFN,LAN,6,15,15-6,LAN,9,0,42,55,97,215,180,395,15,29,44,4,3:53
10270,529513,2018-04-28,2018,SFN,LAN,6,15,15-6,LAN,9,0,42,55,97,215,180,395,15,29,44,4,3:53
10271,529819,2018-04-29,2018,MIA,COL,3,0,3-0,MIA,9,1,31,31,62,123,128,251,8,5,13,0,2:28
10272,529828,2018-04-29,2018,BOS,TBA,4,3,4-3,BOS,9,1,36,36,72,142,142,284,12,10,22,4,3:01
10273,529821,2018-04-29,2018,SFN,LAN,4,2,4-2,SFN,9,1,33,34,67,132,119,251,11,9,20,1,2:40
10274,529829,2018-04-29,2018,TOR,TEX,7,2,7-2,TOR,9,1,36,32,68,123,132,255,15,6,21,1,2:37
10275,529822,2018-04-29,2018,CHN,MIL,2,0,2-0,CHN,9,1,32,31,63,123,119,242,9,6,15,2,2:35
10276,529826,2018-04-29,2018,CLE,SEA,4,10,10-4,SEA,9,0,38,44,82,140,148,288,12,16,28,1,3:01
10277,529815,2018-04-29,2018,WAS,ARI,3,1,3-1,WAS,9,1,36,35,71,136,136,272,13,10,23,2,2:49
10278,529824,2018-04-29,2018,ANA,NYA,1,2,2-1,NYA,9,0,37,34,71,152,141,293,9,7,16,1,3:00
10279,529827,2018-04-29,2018,PIT,SLN,5,0,5-0,PIT,9,1,38,30,68,147,147,294,14,4,18,1,2:51
10280,529820,2018-04-29,2018,BAL,DET,5,3,5-3,BAL,9,1,38,37,75,159,167,326,14,11,25,2,3:01
10281,529818,2018-04-29,2018,MIN,CIN,2,8,8-2,CIN,9,0,37,45,82,163,145,308,11,18,29,3,3:07
10282,529816,2018-04-29,2018,PHI,ATL,1,10,10-1,ATL,9,0,36,46,82,171,146,317,10,18,28,4,3:26
10283,529825,2018-04-29,2018,HOU,OAK,8,4,8-4,HOU,9,1,36,36,72,146,114,260,11,10,21,3,2:46
10284,529817,2018-04-29,2018,KCA,CHA,5,4,5-4,KCA,9,1,39,42,81,184,151,335,17,16,33,3,3:19
10285,529823,2018-04-29,2018,SDN,NYN,2,14,14-2,NYN,9,0,40,53,93,216,162,378,13,26,39,2,3:29
10286,529834,2018-04-30,2018,HOU,NYA,2,1,2-1,HOU,9,1,31,32,63,125,118,243,8,6,14,2,2:31
10287,529838,2018-04-30,2018,DET,TBA,2,3,3-2,TBA,9,0,34,33,67,132,150,282,9,6,15,2,2:52
10288,529830,2018-04-30,2018,CHN,COL,3,2,3-2,CHN,9,1,31,39,70,155,117,272,8,12,20,2,2:57
10289,529836,2018-04-30,2018,WAS,PIT,3,2,3-2,WAS,9,1,35,32,67,125,130,255,14,8,22,0,2:34
10290,529837,2018-04-30,2018,SFN,SDN,6,5,6-5,SFN,9,0,42,42,84,166,153,319,16,15,31,3,3:19
10291,529832,2018-04-30,2018,ARI,LAN,8,5,8-5,ARI,9,1,43,37,80,151,157,308,20,10,30,3,3:27
10292,529833,2018-04-30,2018,CIN,MIL,5,6,6-5,MIL,9,0,38,40,78,162,135,297,13,14,27,4,3:02
10293,529835,2018-04-30,2018,MIA,PHI,8,4,8-4,MIA,9,1,37,39,76,155,140,295,15,14,29,1,3:06
10294,529840,2018-04-30,2018,MIN,TOR,5,7,7-5,TOR,9,0,42,44,86,155,152,307,15,17,32,2,3:13
10295,529831,2018-04-30,2018,BOS,KCA,10,6,10-6,BOS,9,1,41,40,81,163,155,318,16,14,30,1,3:13
10296,529839,2018-04-30,2018,CLE,TEX,7,5,7-5,CLE,9,1,41,41,82,189,163,352,17,16,33,6,3:56
10297,529848,2018-05-01,2018,HOU,NYA,0,4,4-0,NYA,9,0,33,35,68,132,129,261,7,8,15,1,2:57
10298,529853,2018-05-01,2018,DET,TBA,2,1,2-1,DET,9,1,32,35,67,129,111,240,10,10,20,0,2:28
10299,529852,2018-05-01,2018,SFN,SDN,2,3,3-2,SDN,9,0,38,30,68,105,146,251,11,6,17,0,2:24
10300,529844,2018-05-01,2018,CHN,COL,1,3,3-1,COL,9,0,32,32,64,119,128,247,5,6,11,1,2:24
10301,529849,2018-05-01,2018,SEA,OAK,6,3,6-3,SEA,9,1,39,35,74,153,139,292,15,10,25,3,3:06
10302,529841,2018-05-01,2018,NYN,ATL,2,3,3-2,ATL,9,0,36,42,78,122,128,250,10,17,27,1,2:43
10303,529842,2018-05-01,2018,ANA,BAL,3,2,3-2,ANA,9,0,39,33,72,131,136,267,17,6,23,4,2:58
10304,529850,2018-05-01,2018,MIA,PHI,2,1,2-1,MIA,10,0,35,42,77,137,120,257,9,12,21,2,2:54
10305,529851,2018-05-01,2018,WAS,PIT,12,4,12-4,WAS,9,1,39,38,77,159,152,311,14,11,25,3,2:58
10306,529847,2018-05-01,2018,CIN,MIL,6,7,7-6,MIL,9,0,43,36,79,142,143,285,17,11,28,3,3:18
10307,529843,2018-05-01,2018,SLN,CHA,3,2,3-2,SLN,9,0,32,37,69,149,141,290,9,10,19,0,2:56
10308,529846,2018-05-01,2018,ARI,LAN,4,3,4-3,ARI,9,1,37,38,75,159,137,296,14,13,27,1,3:12
10309,529855,2018-05-01,2018,MIN,TOR,4,7,7-4,TOR,10,0,38,47,85,182,159,341,9,20,29,2,3:32
10310,529854,2018-05-01,2018,CLE,TEX,6,8,8-6,TEX,12,0,52,54,106,203,186,389,17,18,35,6,4:05
10311,529845,2018-05-01,2018,BOS,KCA,6,7,7-6,KCA,13,0,54,58,112,203,206,409,15,20,35,2,4:25
10312,529858,2018-05-02,2018,SLN,CHA,3,2,3-2,SLN,9,1,29,34,63,131,103,234,8,9,17,3,2:37
10313,529861,2018-05-02,2018,ARI,LAN,1,2,2-1,LAN,9,0,36,34,70,147,147,294,10,10,20,1,3:12
10314,529864,2018-05-02,2018,SEA,OAK,2,3,3-2,OAK,9,0,38,36,74,129,126,255,13,9,22,1,2:25
10315,529860,2018-05-02,2018,BOS,KCA,5,4,5-4,BOS,9,1,33,37,70,139,127,266,11,13,24,1,2:45
10316,529865,2018-05-02,2018,MIA,PHI,0,6,6-0,PHI,9,0,30,41,71,153,116,269,6,15,21,2,2:54
10317,529870,2018-05-02,2018,MIN,TOR,4,0,4-0,MIN,9,1,36,34,70,140,136,276,12,10,22,2,2:47
10318,529863,2018-05-02,2018,HOU,NYA,0,4,4-0,NYA,9,0,33,37,70,148,110,258,6,10,16,1,2:31
10319,529866,2018-05-02,2018,WAS,PIT,9,3,9-3,WAS,9,1,42,37,79,137,152,289,18,11,29,1,2:55
10320,529859,2018-05-02,2018,CHN,COL,2,11,11-2,COL,9,0,33,48,81,183,122,305,6,20,26,2,3:05
10321,529869,2018-05-02,2018,CLE,TEX,12,4,12-4,CLE,9,1,42,34,76,134,159,293,18,9,27,0,2:41
10322,529857,2018-05-02,2018,ANA,BAL,10,7,10-7,ANA,9,1,39,40,79,156,169,325,14,14,28,2,3:14
10323,529867,2018-05-02,2018,SFN,SDN,9,4,9-4,SFN,9,1,44,39,83,169,159,328,19,12,31,2,3:02
10324,529862,2018-05-02,2018,CIN,MIL,1,3,3-1,MIL,9,0,35,40,75,155,137,292,9,13,22,3,2:48
10325,529856,2018-05-02,2018,NYN,ATL,0,7,7-0,ATL,9,0,31,38,69,136,117,253,4,11,15,0,2:24
10326,529868,2018-05-02,2018,DET,TBA,3,2,3-2,DET,12,0,42,46,88,178,147,325,10,13,23,3,3:28
10327,529877,2018-05-03,2018,HOU,NYA,5,6,6-5,NYA,9,0,38,39,77,145,132,277,10,13,23,3,3:11
10328,529871,2018-05-03,2018,NYN,ATL,0,11,11-0,ATL,9,0,33,46,79,150,127,277,6,20,26,2,2:40
10329,529878,2018-05-03,2018,SEA,OAK,4,1,4-1,SEA,9,1,33,32,65,149,110,259,9,7,16,1,2:31
10330,529879,2018-05-03,2018,WAS,PIT,3,1,3-1,WAS,9,1,30,33,63,110,128,238,6,6,12,3,2:42
10331,529876,2018-05-03,2018,CHA,MIN,6,5,6-5,CHA,9,0,34,37,71,125,149,274,10,10,20,4,2:54
10332,529874,2018-05-03,2018,KCA,DET,10,6,10-6,KCA,9,1,40,44,84,161,143,304,16,18,34,4,3:07
10333,529872,2018-05-03,2018,ANA,BAL,12,3,12-3,ANA,9,1,40,36,76,133,165,298,19,10,29,3,3:02
10334,529875,2018-05-03,2018,ARI,LAN,2,5,5-2,LAN,9,0,36,38,74,148,157,305,9,13,22,2,3:17
10335,529641,2018-05-03,2018,CLE,TOR,13,4,13-4,CLE,9,1,48,37,85,140,192,332,24,10,34,2,3:11
10336,529873,2018-05-03,2018,TEX,BOS,11,5,11-5,TEX,9,1,40,41,81,148,157,305,15,13,28,3,3:20
10337,529641,2018-05-03,2018,CLE,TOR,13,4,13-4,CLE,9,1,48,37,85,140,192,332,24,10,34,2,3:11
10338,529626,2018-05-03,2018,CLE,TOR,11,13,13-11,TOR,11,0,52,59,111,251,188,439,22,27,49,5,4:47 (1:53 delay)
10339,529626,2018-05-03,2018,CLE,TOR,11,13,13-11,TOR,11,0,52,59,111,251,188,439,22,27,49,5,4:47 (1:53 delay)
10340,529888,2018-05-04,2018,SDN,LAN,0,4,4-0,LAN,9,0,31,37,68,164,146,310,5,12,17,0,3:07
10341,529881,2018-05-04,2018,TEX,BOS,1,5,5-1,BOS,9,0,31,35,66,130,146,276,5,8,13,0,2:36
10342,529885,2018-05-04,2018,KCA,DET,4,2,4-2,KCA,9,1,30,36,66,145,116,261,10,12,22,2,2:49
10343,529894,2018-05-04,2018,TBA,TOR,6,2,6-2,TBA,9,1,37,33,70,121,167,288,14,5,19,1,2:39
10344,529886,2018-05-04,2018,ARI,HOU,0,8,8-0,HOU,9,0,29,45,74,167,114,281,2,18,20,1,2:50
10345,529882,2018-05-04,2018,SLN,CHN,3,2,3-2,SLN,9,1,36,38,74,123,151,274,14,10,24,2,2:58
10346,529889,2018-05-04,2018,CIN,MIA,4,1,4-1,CIN,9,1,37,33,70,144,149,293,14,9,23,2,2:55
10347,529887,2018-05-04,2018,SEA,ANA,0,5,5-0,ANA,9,0,31,43,74,182,115,297,6,18,24,3,3:10
10348,529891,2018-05-04,2018,WAS,PHI,7,3,7-3,WAS,9,1,39,36,75,145,143,288,17,9,26,2,2:49 (:39 delay)
10349,529893,2018-05-04,2018,ATL,SFN,4,9,9-4,SFN,9,0,36,43,79,153,138,291,11,17,28,0,2:45
10350,529892,2018-05-04,2018,MIL,PIT,4,6,6-4,PIT,9,0,38,41,79,163,148,311,12,16,28,2,3:11
10351,529890,2018-05-04,2018,CHA,MIN,4,6,6-4,MIN,9,0,39,41,80,166,144,310,12,16,28,3,3:19
10352,529884,2018-05-04,2018,NYN,COL,7,8,8-7,COL,9,0,42,42,84,143,179,322,15,15,30,2,3:14
10353,529880,2018-05-04,2018,OAK,BAL,6,4,6-4,OAK,9,1,40,37,77,147,187,334,14,12,26,3,3:21
10354,529883,2018-05-04,2018,NYA,CLE,7,6,7-6,NYA,9,0,44,38,82,160,152,312,18,12,30,2,3:22
10355,529903,2018-05-05,2018,SDN,LAN,7,4,7-4,SDN,9,1,36,40,76,154,148,302,14,16,30,3,3:26
10356,529898,2018-05-05,2018,NYA,CLE,5,2,5-2,NYA,9,1,32,34,66,132,129,261,7,7,14,0,2:31
10357,529899,2018-05-05,2018,NYN,COL,0,2,2-0,COL,9,0,34,35,69,127,125,252,8,12,20,0,2:28
10358,529910,2018-05-05,2018,TBA,TOR,5,3,5-3,TBA,9,1,39,33,72,124,155,279,13,8,21,4,2:52
10359,529904,2018-05-05,2018,CIN,MIA,0,6,6-0,MIA,9,0,31,36,67,136,136,272,6,9,15,2,2:40 (:10 delay)
10360,529900,2018-05-05,2018,KCA,DET,2,3,3-2,DET,9,0,37,40,77,142,155,297,8,15,23,3,3:06
10361,529896,2018-05-05,2018,TEX,BOS,5,6,6-5,BOS,9,0,36,40,76,152,160,312,10,12,22,3,3:18
10362,529908,2018-05-05,2018,MIL,PIT,5,3,5-3,MIL,9,1,37,35,72,148,158,306,16,8,24,1,3:13
10363,529905,2018-05-05,2018,CHA,MIN,4,8,8-4,MIN,9,0,36,44,80,174,152,326,11,19,30,2,3:23
10364,529909,2018-05-05,2018,ATL,SFN,2,11,11-2,SFN,9,0,36,46,82,180,118,298,9,21,30,4,2:58
10365,529907,2018-05-05,2018,WAS,PHI,1,3,3-1,PHI,9,0,36,38,74,160,152,312,11,13,24,2,3:13
10366,529895,2018-05-05,2018,OAK,BAL,2,0,2-0,OAK,12,0,40,47,87,192,155,347,6,14,20,1,3:32
10367,529901,2018-05-05,2018,ARI,HOU,4,3,4-3,ARI,9,0,40,40,80,161,156,317,15,13,28,4,3:34
10368,529897,2018-05-05,2018,SLN,CHN,8,6,8-6,SLN,10,0,44,45,89,162,163,325,16,14,30,2,3:42
10369,529902,2018-05-05,2018,SEA,ANA,9,8,9-8,SEA,11,0,51,51,102,193,201,394,20,20,40,5,4:29
10370,529919,2018-05-06,2018,SDN,LAN,3,0,3-0,SDN,9,1,36,40,76,161,149,310,14,12,26,1,3:10
10371,529916,2018-05-06,2018,KCA,DET,4,2,4-2,KCA,9,1,30,38,68,128,109,237,8,12,20,2,2:16
10372,529917,2018-05-06,2018,ARI,HOU,3,1,3-1,ARI,9,1,31,37,68,133,121,254,8,10,18,3,2:55
10373,529911,2018-05-06,2018,OAK,BAL,2,1,2-1,OAK,9,1,32,31,63,112,133,245,8,5,13,0,2:25
10374,529923,2018-05-06,2018,MIL,PIT,0,9,9-0,PIT,9,0,30,44,74,184,136,320,4,17,21,1,3:02
10375,529912,2018-05-06,2018,TEX,BOS,1,6,6-1,BOS,9,0,35,39,74,144,127,271,8,13,21,1,2:33
10376,529915,2018-05-06,2018,NYN,COL,2,3,3-2,COL,9,0,35,38,73,139,142,281,8,14,22,2,3:02
10377,529921,2018-05-06,2018,CHA,MIN,3,5,5-3,MIN,9,0,35,35,70,140,136,276,7,7,14,3,2:56
10378,529924,2018-05-06,2018,ATL,SFN,3,4,4-3,SFN,9,0,37,41,78,161,140,301,11,16,27,2,3:09
10379,529918,2018-05-06,2018,SEA,ANA,2,8,8-2,ANA,9,0,37,46,83,169,136,305,13,19,32,3,3:11
10380,529920,2018-05-06,2018,CIN,MIA,5,8,8-5,MIA,9,0,42,47,89,189,174,363,14,20,34,3,3:36 (1:13 delay)
10381,529925,2018-05-06,2018,TBA,TOR,1,2,2-1,TOR,9,0,36,35,71,129,154,283,13,8,21,0,2:56
10382,529922,2018-05-06,2018,WAS,PHI,5,4,5-4,WAS,9,0,36,39,75,164,146,310,14,13,27,5,3:33
10383,529914,2018-05-06,2018,NYA,CLE,7,4,7-4,NYA,9,0,36,33,69,151,156,307,14,6,20,3,3:05
10384,529913,2018-05-06,2018,SLN,CHN,4,3,4-3,SLN,14,0,56,53,109,216,230,446,20,13,33,5,4:46 (:59 delay)
10385,529928,2018-05-07,2018,CHN,MIA,14,2,14-2,CHN,9,1,44,31,75,109,188,297,20,6,26,1,2:48
10386,529926,2018-05-07,2018,TEX,DET,7,6,7-6,TEX,9,1,35,44,79,152,140,292,11,16,27,3,3:08
10387,529929,2018-05-07,2018,SLN,MIN,0,6,6-0,MIN,9,0,34,41,75,160,137,297,8,16,24,1,2:55
10388,529932,2018-05-07,2018,SDN,WAS,5,8,8-5,WAS,9,0,36,42,78,160,152,312,12,16,28,0,3:00
10389,529927,2018-05-07,2018,OAK,HOU,2,16,16-2,HOU,9,0,37,51,88,175,119,294,10,26,36,2,2:57
10390,529930,2018-05-07,2018,CIN,NYN,6,7,7-6,NYN,9,0,37,41,78,165,121,286,10,15,25,2,2:47
10391,529931,2018-05-07,2018,PHI,SFN,11,0,11-0,PHI,9,1,42,36,78,152,175,327,16,10,26,1,3:05
10392,529945,2018-05-08,2018,PHI,SFN,4,2,4-2,PHI,9,1,34,33,67,143,125,268,12,7,19,2,2:53
10393,529947,2018-05-08,2018,SDN,WAS,0,4,4-0,WAS,9,0,30,36,66,132,116,248,4,10,14,1,2:31
10394,529940,2018-05-08,2018,COL,ANA,4,2,4-2,COL,9,1,35,34,69,129,123,252,12,8,20,0,2:42
10395,529938,2018-05-08,2018,OAK,HOU,2,4,4-2,HOU,9,0,34,40,74,129,132,261,10,15,25,1,2:46
10396,529941,2018-05-08,2018,CHN,MIA,4,3,4-3,CHN,9,1,34,35,69,134,126,260,10,9,19,1,2:38
10397,529946,2018-05-08,2018,TOR,SEA,0,5,5-0,SEA,9,0,29,41,70,148,99,247,3,15,18,1,2:19
10398,529936,2018-05-08,2018,MIL,CLE,3,2,3-2,MIL,9,1,34,34,68,148,140,288,11,8,19,3,2:49
10399,529937,2018-05-08,2018,TEX,DET,4,7,7-4,DET,9,0,37,40,77,150,150,300,12,14,26,4,3:04
10400,529942,2018-05-08,2018,SLN,MIN,1,7,7-1,MIN,9,0,30,42,72,141,137,278,4,14,18,0,2:54
10401,529943,2018-05-08,2018,CIN,NYN,7,2,7-2,CIN,9,1,39,36,75,142,139,281,16,10,26,5,2:55
10402,529934,2018-05-08,2018,TBA,ATL,0,1,1-0,ATL,9,0,34,36,70,152,151,303,10,8,18,2,2:55
10403,529935,2018-05-08,2018,NYA,BOS,3,2,3-2,NYA,9,1,34,36,70,157,153,310,11,9,20,3,3:29
10404,529944,2018-05-08,2018,CHA,PIT,6,10,10-6,PIT,9,0,38,45,83,187,194,381,13,21,34,2,3:53
10405,529939,2018-05-08,2018,BAL,KCA,7,15,15-7,KCA,9,0,45,48,93,192,183,375,18,23,41,3,3:21
10406,529933,2018-05-08,2018,LAN,ARI,5,8,8-5,ARI,12,0,52,51,103,196,213,409,18,17,35,4,4:29
10407,529957,2018-05-09,2018,CIN,NYN,2,1,2-1,CIN,10,0,35,36,71,144,121,265,8,6,14,0,2:30
10408,529949,2018-05-09,2018,TBA,ATL,2,5,5-2,ATL,9,0,37,34,71,129,161,290,9,7,16,1,2:51
10409,529960,2018-05-09,2018,TOR,SEA,5,2,5-2,TOR,9,1,36,39,75,149,139,288,14,12,26,2,3:08
10410,529951,2018-05-09,2018,MIL,CLE,2,6,6-2,CLE,9,0,31,39,70,155,117,272,6,13,19,0,2:41
10411,529958,2018-05-09,2018,CHA,PIT,5,6,6-5,PIT,9,0,38,36,74,127,150,277,14,9,23,1,2:46
10412,529950,2018-05-09,2018,NYA,BOS,9,6,9-6,NYA,9,1,40,42,82,165,148,313,17,18,35,5,3:42
10413,529956,2018-05-09,2018,CHN,MIA,13,4,13-4,CHN,9,1,45,38,83,160,173,333,21,12,33,1,3:13
10414,529953,2018-05-09,2018,OAK,HOU,1,4,4-1,HOU,9,0,33,35,68,125,139,264,7,10,17,2,2:43
10415,529955,2018-05-09,2018,COL,ANA,0,8,8-0,ANA,9,0,38,42,80,164,150,314,12,17,29,1,3:10
10416,529961,2018-05-09,2018,SDN,WAS,2,1,2-1,SDN,9,1,35,34,69,126,136,262,14,10,24,2,2:50
10417,529954,2018-05-09,2018,BAL,KCA,5,3,5-3,BAL,9,1,34,37,71,155,123,278,11,12,23,2,2:45
10418,529952,2018-05-09,2018,TEX,DET,5,4,5-4,TEX,10,0,39,44,83,188,149,337,17,13,30,4,3:22
10419,529959,2018-05-09,2018,PHI,SFN,11,3,11-3,PHI,9,1,41,38,79,175,170,345,17,12,29,2,3:19
10420,529948,2018-05-09,2018,LAN,ARI,6,3,6-3,LAN,9,1,38,39,77,157,175,332,15,13,28,3,3:48
10421,529970,2018-05-10,2018,SDN,SLN,1,2,2-1,SLN,9,0,32,34,66,139,134,273,7,9,16,1,2:39
10422,529968,2018-05-10,2018,PHI,SFN,6,3,6-3,PHI,9,1,37,33,70,135,151,286,14,6,20,1,2:47
10423,529966,2018-05-10,2018,COL,MIL,2,5,5-2,MIL,9,0,34,42,76,151,125,276,9,18,27,3,3:00
10424,529963,2018-05-10,2018,NYA,BOS,4,5,5-4,BOS,9,0,39,38,77,145,157,302,12,11,23,2,3:21 (:55 delay)
10425,529964,2018-05-10,2018,LAN,CIN,1,4,4-1,CIN,9,0,36,37,73,139,161,300,8,9,17,1,2:59
10426,529967,2018-05-10,2018,ANA,MIN,7,4,7-4,ANA,9,1,37,35,72,159,125,284,16,11,27,3,3:08
10427,529962,2018-05-10,2018,MIA,ATL,2,9,9-2,ATL,9,0,37,47,84,185,143,328,9,23,32,2,3:00
10428,529965,2018-05-10,2018,BAL,KCA,11,6,11-6,BAL,9,1,40,40,80,162,141,303,17,15,32,1,2:57
10429,529969,2018-05-10,2018,TOR,SEA,3,9,9-3,SEA,9,0,34,47,81,194,137,331,10,22,32,3,2:58
10430,529971,2018-05-10,2018,ARI,WAS,1,2,2-1,WAS,11,0,43,42,85,159,167,326,11,10,21,4,3:42
10431,529986,2018-05-11,2018,ARI,WAS,1,3,3-1,WAS,9,0,32,35,67,105,126,231,5,9,14,0,2:24
10432,529979,2018-05-11,2018,PHI,NYN,1,3,3-1,NYN,9,0,37,36,73,126,153,279,12,11,23,1,2:49
10433,529984,2018-05-11,2018,BAL,TBA,9,4,9-4,BAL,9,1,35,41,76,135,117,252,12,16,28,3,2:36
10434,529975,2018-05-11,2018,LAN,CIN,2,6,6-2,CIN,9,0,34,43,77,174,143,317,7,16,23,4,3:28
10435,529978,2018-05-11,2018,ANA,MIN,4,5,5-4,MIN,9,0,38,37,75,156,159,315,12,13,25,4,3:23
10436,529972,2018-05-11,2018,MIA,ATL,6,3,6-3,MIA,9,1,37,37,74,160,117,277,17,9,26,0,2:42
10437,529980,2018-05-11,2018,NYA,OAK,5,10,10-5,OAK,9,0,38,48,86,170,131,301,11,20,31,3,3:02
10438,529973,2018-05-11,2018,TOR,BOS,5,3,5-3,TOR,12,0,44,47,91,187,168,355,11,11,22,0,3:54
10439,529985,2018-05-11,2018,HOU,TEX,0,1,1-0,TEX,9,0,34,33,67,143,147,290,8,7,15,3,3:08
10440,529983,2018-05-11,2018,SDN,SLN,5,9,9-5,SLN,9,0,41,44,85,162,174,336,14,18,32,1,3:15
10441,529974,2018-05-11,2018,CHN,CHA,11,2,11-2,CHN,9,1,48,36,84,160,205,365,24,12,36,4,3:45
10442,529976,2018-05-11,2018,CLE,KCA,9,10,10-9,KCA,9,0,41,47,88,174,191,365,15,19,34,4,3:34
10443,529981,2018-05-11,2018,PIT,SFN,11,2,11-2,PIT,9,1,40,41,81,168,172,340,18,14,32,1,3:20
10444,529977,2018-05-11,2018,COL,MIL,10,11,11-10,MIL,10,0,49,50,99,183,224,407,20,23,43,3,4:20
10445,530000,2018-05-12,2018,HOU,TEX,6,1,6-1,HOU,9,1,34,31,65,132,132,264,12,4,16,2,2:37
10446,529999,2018-05-12,2018,BAL,TBA,6,3,6-3,BAL,9,1,34,35,69,120,115,235,10,8,18,1,2:27
10447,529991,2018-05-12,2018,CLE,KCA,6,2,6-2,CLE,9,1,36,33,69,128,141,269,13,8,21,3,2:31 (1:15 delay)
10448,529988,2018-05-12,2018,TOR,BOS,2,5,5-2,BOS,9,0,36,39,75,155,139,294,10,13,23,3,3:11
10449,529996,2018-05-12,2018,PIT,SFN,6,5,6-5,PIT,9,1,37,41,78,161,140,301,15,15,30,2,3:14 (1:33 delay)
10450,529990,2018-05-12,2018,LAN,CIN,3,5,5-3,CIN,9,0,41,41,82,162,136,298,16,13,29,4,3:17
10451,529992,2018-05-12,2018,COL,MIL,4,0,4-0,COL,9,1,35,36,71,131,120,251,11,9,20,2,2:47
10452,530001,2018-05-12,2018,ARI,WAS,1,2,2-1,WAS,9,0,36,40,76,167,145,312,8,14,22,3,3:17
10453,529758,2018-05-12,2018,BAL,TBA,3,10,10-3,TBA,9,0,32,45,77,159,127,286,6,20,26,5,2:58 (1:19 delay)
10454,529982,2018-05-12,2018,DET,SEA,5,9,9-5,SEA,9,0,40,43,83,191,153,344,13,20,33,3,3:35
10455,529989,2018-05-12,2018,CHN,CHA,8,4,8-4,CHN,9,1,41,39,80,173,147,320,17,12,29,4,3:20 (2:15 delay)
10456,529758,2018-05-12,2018,BAL,TBA,3,10,10-3,TBA,9,0,32,45,77,159,127,286,6,20,26,5,2:58 (1:19 delay)
10457,529982,2018-05-12,2018,DET,SEA,5,9,9-5,SEA,9,0,40,43,83,191,153,344,13,20,33,3,3:35
10458,529997,2018-05-12,2018,DET,SEA,4,3,4-3,DET,9,1,34,37,71,136,121,257,14,10,24,1,2:35
10459,529995,2018-05-12,2018,NYA,OAK,7,6,7-6,NYA,11,0,52,44,96,169,213,382,20,14,34,2,4:15
10460,529987,2018-05-12,2018,MIA,ATL,5,10,10-5,ATL,9,0,39,43,82,169,157,326,12,18,30,3,3:26
10461,529993,2018-05-12,2018,ANA,MIN,3,5,5-3,MIN,12,0,55,46,101,176,209,385,22,15,37,0,4:21
10462,529998,2018-05-12,2018,SDN,SLN,2,1,2-1,SDN,13,0,47,52,99,204,196,400,12,14,26,2,4:16
10463,530011,2018-05-13,2018,PIT,SFN,0,5,5-0,SFN,9,0,38,40,78,145,150,295,13,14,27,2,3:04
10464,530006,2018-05-13,2018,CLE,KCA,11,2,11-2,CLE,9,1,45,37,82,128,175,303,22,10,32,3,2:54
10465,530012,2018-05-13,2018,DET,SEA,5,4,5-4,DET,9,0,35,42,77,149,145,294,11,15,26,1,2:57
10466,530013,2018-05-13,2018,SDN,SLN,5,3,5-3,SDN,9,1,37,35,72,129,159,288,14,10,24,1,2:47
10467,530014,2018-05-13,2018,BAL,TBA,17,1,17-1,BAL,9,1,49,35,84,132,194,326,24,10,34,3,3:01
10468,530016,2018-05-13,2018,ARI,WAS,4,6,6-4,WAS,9,0,37,38,75,147,132,279,10,11,21,3,3:09
10469,530015,2018-05-13,2018,HOU,TEX,6,1,6-1,HOU,9,1,40,34,74,141,162,303,13,7,20,2,2:52
10470,530008,2018-05-13,2018,ANA,MIN,2,1,2-1,ANA,9,0,37,37,74,156,139,295,13,12,25,4,3:28
10471,530009,2018-05-13,2018,PHI,NYN,4,2,4-2,PHI,9,1,37,38,75,142,163,305,15,15,30,1,3:19 (:59 delay)
10472,530010,2018-05-13,2018,NYA,OAK,6,2,6-2,NYA,9,1,39,38,77,161,163,324,16,11,27,0,3:07 (2:45 delay)
10473,530003,2018-05-13,2018,TOR,BOS,3,5,5-3,BOS,9,0,40,38,78,167,167,334,15,13,28,3,3:42
10474,530004,2018-05-13,2018,CHN,CHA,3,5,5-3,CHA,9,0,37,35,72,145,144,289,11,8,19,2,2:47
10475,530005,2018-05-13,2018,LAN,CIN,3,5,5-3,CIN,9,0,32,43,75,144,150,294,5,16,21,3,2:55
10476,530002,2018-05-13,2018,MIA,ATL,3,4,4-3,ATL,9,0,36,37,73,152,141,293,9,11,20,1,2:50
10477,530007,2018-05-13,2018,COL,MIL,3,7,7-3,MIL,9,0,37,43,80,189,160,349,9,16,25,3,3:37
10478,530020,2018-05-14,2018,ANA,HOU,2,1,2-1,ANA,9,1,28,32,60,117,130,247,6,9,15,0,2:27
10479,530021,2018-05-14,2018,ARI,MIL,2,7,7-2,MIL,9,0,36,39,75,158,134,292,9,12,21,3,3:06
10480,529544,2018-05-14,2018,MIN,SEA,0,1,1-0,SEA,9,0,31,36,67,136,133,269,4,8,12,0,2:53 (1:42 delay)
10481,530023,2018-05-14,2018,KCA,TBA,1,2,2-1,TBA,9,0,34,32,66,112,128,240,9,8,17,3,2:33
10482,529544,2018-05-14,2018,MIN,SEA,0,1,1-0,SEA,9,0,31,36,67,136,133,269,4,8,12,0,2:53 (1:42 delay)
10483,530017,2018-05-14,2018,SFN,CIN,10,7,10-7,SFN,9,1,44,40,84,135,160,295,19,16,35,2,3:02
10484,529628,2018-05-14,2018,CHN,ATL,5,6,6-5,ATL,9,0,38,45,83,171,132,303,13,17,30,2,3:14
10485,530019,2018-05-14,2018,SDN,COL,4,6,6-4,COL,9,0,37,40,77,138,145,283,11,15,26,1,2:55
10486,530018,2018-05-14,2018,DET,CLE,6,3,6-3,DET,9,1,37,38,75,150,155,305,14,10,24,3,3:10
10487,529628,2018-05-14,2018,CHN,ATL,5,6,6-5,ATL,9,0,38,45,83,171,132,303,13,17,30,2,3:14
10488,530022,2018-05-14,2018,BOS,OAK,5,6,6-5,OAK,9,0,37,37,74,154,115,269,10,11,21,1,2:40
10489,530024,2018-05-15,2018,ATL,CHN,2,3,3-2,CHN,9,0,33,38,71,166,115,281,8,11,19,1,2:51
10490,530036,2018-05-15,2018,KCA,TBA,5,6,6-5,TBA,9,0,37,40,77,153,113,266,12,13,25,2,2:53
10491,530030,2018-05-15,2018,MIA,LAN,4,2,4-2,MIA,9,1,34,35,69,150,130,280,13,8,21,2,2:54
10492,530025,2018-05-15,2018,PIT,CHA,7,0,7-0,PIT,9,1,39,34,73,129,149,278,15,7,22,2,3:03
10493,530028,2018-05-15,2018,SDN,COL,4,0,4-0,SDN,9,1,32,30,62,113,127,240,10,3,13,2,2:23
10494,530035,2018-05-15,2018,MIN,SLN,4,1,4-1,MIN,9,1,33,31,64,124,144,268,10,4,14,4,2:45
10495,530033,2018-05-15,2018,BOS,OAK,3,5,5-3,OAK,9,0,39,38,77,178,143,321,11,13,24,1,3:16 (1:42 delay)
10496,530032,2018-05-15,2018,WAS,NYA,5,3,5-3,WAS,9,1,32,40,72,161,136,297,9,14,23,1,2:55 (1:10 delay)
10497,530027,2018-05-15,2018,DET,CLE,9,8,9-8,DET,9,1,37,47,84,191,137,328,13,22,35,4,3:21
10498,530038,2018-05-15,2018,NYN,TOR,12,2,12-2,NYN,9,1,43,35,78,147,147,294,20,9,29,2,3:02 (1:26 delay)
10499,530026,2018-05-15,2018,SFN,CIN,5,3,5-3,SFN,9,1,36,35,71,126,163,289,12,9,21,2,2:53
10500,530031,2018-05-15,2018,ARI,MIL,2,1,2-1,ARI,9,1,31,33,64,144,112,256,8,6,14,2,2:40
10501,530029,2018-05-15,2018,ANA,HOU,3,5,5-3,HOU,9,0,34,36,70,138,161,299,10,9,19,1,3:18
10502,530037,2018-05-15,2018,SEA,TEX,9,8,9-8,SEA,11,0,53,51,104,192,224,416,21,19,40,5,4:26
10503,530032,2018-05-15,2018,WAS,NYA,5,3,5-3,WAS,9,1,32,40,72,161,136,297,9,14,23,1,2:55 (1:10 delay)
10504,530043,2018-05-16,2018,ANA,HOU,0,2,2-0,HOU,9,0,33,33,66,123,118,241,6,6,12,0,2:39
10505,530040,2018-05-16,2018,PIT,CHA,3,2,3-2,PIT,9,1,34,39,73,135,133,268,11,12,23,1,2:45
10506,530039,2018-05-16,2018,ATL,CHN,4,1,4-1,ATL,9,1,35,36,71,132,138,270,15,10,25,3,2:55
10507,530041,2018-05-16,2018,SFN,CIN,3,6,6-3,CIN,9,0,39,37,76,125,149,274,14,10,24,0,2:41
10508,530050,2018-05-16,2018,KCA,TBA,3,5,5-3,TBA,9,0,39,38,77,118,155,273,13,12,25,2,2:59
10509,530045,2018-05-16,2018,ARI,MIL,2,8,8-2,MIL,9,0,35,38,73,144,155,299,8,12,20,1,3:04
10510,530044,2018-05-16,2018,MIA,LAN,6,5,6-5,MIA,9,1,40,39,79,143,149,292,17,12,29,2,3:01
10511,530051,2018-05-16,2018,SEA,TEX,1,5,5-1,TEX,9,0,33,39,72,144,124,268,7,11,18,5,2:52
10512,530047,2018-05-16,2018,BOS,OAK,6,4,6-4,BOS,9,1,34,36,70,169,149,318,11,10,21,0,3:08
10513,530042,2018-05-16,2018,DET,CLE,0,6,6-0,CLE,9,0,30,40,70,160,125,285,5,13,18,0,2:33
10514,530052,2018-05-16,2018,NYN,TOR,1,12,12-1,TOR,9,0,31,48,79,194,135,329,4,21,25,2,3:34
10515,530048,2018-05-16,2018,BAL,PHI,1,4,4-1,PHI,9,0,33,38,71,144,128,272,6,12,18,4,2:42
10516,530049,2018-05-16,2018,MIN,SLN,5,7,7-5,SLN,9,0,39,44,83,182,173,355,15,19,34,5,3:50
10517,529642,2018-05-17,2018,BOS,BAL,6,2,6-2,BOS,9,1,37,31,68,95,153,248,14,5,19,2,2:44
10518,529642,2018-05-17,2018,BOS,BAL,6,2,6-2,BOS,9,1,37,31,68,95,153,248,14,5,19,2,2:44
10519,530056,2018-05-17,2018,MIA,LAN,0,7,7-0,LAN,9,0,31,44,75,192,120,312,4,17,21,0,3:06
10520,530061,2018-05-17,2018,CHA,TEX,4,2,4-2,CHA,9,1,34,37,71,130,133,263,12,10,22,2,2:54
10521,530060,2018-05-17,2018,ANA,TBA,1,7,7-1,TBA,9,0,34,43,77,172,128,300,8,18,26,2,3:06
10522,530057,2018-05-17,2018,TOR,OAK,5,10,10-5,OAK,9,0,41,48,89,210,156,366,14,21,35,5,3:34
10523,530059,2018-05-17,2018,PIT,SDN,5,4,5-4,PIT,9,1,37,37,74,145,143,288,12,11,23,4,2:56
10524,530058,2018-05-17,2018,SLN,PHI,2,6,6-2,PHI,9,0,40,40,80,139,150,289,14,14,28,4,3:33
10525,530055,2018-05-17,2018,SEA,DET,2,3,3-2,DET,9,0,35,40,75,147,145,292,9,12,21,4,3:08
10526,530054,2018-05-17,2018,SFN,COL,3,5,5-3,COL,12,0,46,50,96,190,184,374,11,15,26,2,4:00
10527,530069,2018-05-18,2018,ATL,MIA,0,2,2-0,MIA,9,0,32,32,64,124,123,247,8,9,17,1,2:36
10528,530071,2018-05-18,2018,KCA,NYA,5,2,5-2,KCA,9,1,36,37,73,146,139,285,11,10,21,1,2:46
10529,530072,2018-05-18,2018,TOR,OAK,1,3,3-1,OAK,9,0,35,36,71,150,136,286,9,10,19,4,2:55
10530,530074,2018-05-18,2018,PIT,SDN,2,3,3-2,SDN,9,0,42,34,76,126,158,284,17,9,26,1,3:08
10531,530062,2018-05-18,2018,NYN,ARI,3,1,3-1,NYN,9,1,36,32,68,120,137,257,11,6,17,0,2:36
10532,530066,2018-05-18,2018,SFN,COL,1,6,6-1,COL,9,0,32,40,72,174,132,306,7,13,20,1,3:00
10533,530065,2018-05-18,2018,HOU,CLE,4,1,4-1,HOU,9,1,35,37,72,134,130,264,14,10,24,3,2:50
10534,530067,2018-05-18,2018,SEA,DET,5,4,5-4,SEA,9,1,34,36,70,143,129,272,10,10,20,3,2:48
10535,530070,2018-05-18,2018,MIN,MIL,3,8,8-3,MIL,9,0,36,44,80,163,143,306,9,21,30,2,2:52
10536,530075,2018-05-18,2018,ANA,TBA,3,8,8-3,TBA,9,0,38,46,84,188,159,347,11,20,31,4,3:32
10537,530064,2018-05-18,2018,CIN,CHN,1,8,8-1,CHN,9,0,31,49,80,161,156,317,5,27,32,1,3:17 (1:33 delay)
10538,530073,2018-05-18,2018,SLN,PHI,12,4,12-4,SLN,9,1,43,36,79,140,180,320,20,9,29,0,3:26 (1:35 delay)
10539,530063,2018-05-18,2018,BOS,BAL,4,7,7-4,BAL,9,0,41,42,83,153,159,312,16,15,31,4,3:18
10540,530076,2018-05-18,2018,CHA,TEX,5,12,12-5,TEX,9,0,42,44,86,183,183,366,14,17,31,3,3:52
10541,530089,2018-05-19,2018,PIT,SDN,2,6,6-2,SDN,9,0,33,38,71,140,103,243,8,11,19,1,2:26
10542,530078,2018-05-19,2018,BOS,BAL,6,3,6-3,BOS,9,1,34,36,70,155,137,292,11,9,20,1,2:54
10543,530084,2018-05-19,2018,ATL,MIA,8,1,8-1,ATL,9,1,33,34,67,137,114,251,12,7,19,0,2:28
10544,530080,2018-05-19,2018,HOU,CLE,4,5,5-4,CLE,9,0,36,35,71,160,150,310,10,11,21,1,3:09
10545,530083,2018-05-19,2018,WAS,LAN,4,5,5-4,LAN,9,0,37,40,77,161,139,300,11,15,26,3,3:27
10546,530082,2018-05-19,2018,SEA,DET,7,2,7-2,SEA,9,1,38,30,68,117,160,277,14,4,18,1,2:34
10547,530068,2018-05-19,2018,WAS,LAN,1,4,4-1,LAN,9,0,32,37,69,140,140,280,6,10,16,0,3:00
10548,530081,2018-05-19,2018,SFN,COL,9,4,9-4,SFN,9,1,43,37,80,133,157,290,19,12,31,1,3:05
10549,530079,2018-05-19,2018,CIN,CHN,0,10,10-0,CHN,9,0,32,46,78,166,126,292,7,20,27,0,2:57
10550,529473,2018-05-19,2018,CIN,CHN,5,4,5-4,CIN,11,0,45,51,96,186,155,341,16,23,39,2,3:38
10551,530085,2018-05-19,2018,MIN,MIL,4,5,5-4,MIL,9,0,36,35,71,148,142,290,13,10,23,4,3:02
10552,530068,2018-05-19,2018,WAS,LAN,1,4,4-1,LAN,9,0,32,37,69,140,140,280,6,10,16,0,3:00
10553,530086,2018-05-19,2018,KCA,NYA,3,8,8-3,NYA,9,0,36,42,78,171,124,295,12,17,29,0,2:57
10554,529473,2018-05-19,2018,CIN,CHN,5,4,5-4,CIN,11,0,45,51,96,186,155,341,16,23,39,2,3:38
10555,530087,2018-05-19,2018,TOR,OAK,4,5,5-4,OAK,9,0,40,41,81,162,162,324,13,14,27,2,3:16
10556,530090,2018-05-19,2018,ANA,TBA,3,5,5-3,TBA,9,0,32,39,71,157,132,289,7,13,20,3,3:00
10557,530091,2018-05-19,2018,CHA,TEX,5,3,5-3,CHA,9,1,36,36,72,144,131,275,13,9,22,4,2:58
10558,530077,2018-05-19,2018,NYN,ARI,5,4,5-4,NYN,9,0,39,35,74,159,151,310,15,9,24,2,3:04 (:34 delay)
10559,530088,2018-05-19,2018,SLN,PHI,6,7,7-6,PHI,9,0,38,40,78,180,150,330,10,12,22,3,3:42 (:44 delay)
10560,530094,2018-05-20,2018,CIN,CHN,1,6,6-1,CHN,9,0,34,42,76,136,134,270,8,17,25,1,2:51
10561,530105,2018-05-20,2018,ANA,TBA,5,2,5-2,ANA,9,1,37,36,73,134,158,292,13,9,22,4,3:15
10562,530103,2018-05-20,2018,SLN,PHI,5,1,5-1,SLN,9,1,35,32,67,148,129,277,11,5,16,1,2:53
10563,530092,2018-05-20,2018,NYN,ARI,4,1,4-1,NYN,9,1,33,33,66,131,109,240,9,7,16,2,2:41
10564,530106,2018-05-20,2018,CHA,TEX,3,0,3-0,CHA,9,1,31,32,63,121,127,248,8,4,12,0,2:28
10565,530093,2018-05-20,2018,BOS,BAL,5,0,5-0,BOS,9,1,41,41,82,170,153,323,18,13,31,3,3:25
10566,530101,2018-05-20,2018,KCA,NYA,1,10,10-1,NYA,9,0,32,45,77,156,105,261,6,19,25,0,2:31
10567,530095,2018-05-20,2018,HOU,CLE,3,1,3-1,HOU,9,1,33,32,65,134,116,250,10,5,15,4,2:48
10568,530097,2018-05-20,2018,SEA,DET,3,2,3-2,SEA,11,0,38,42,80,175,139,314,9,11,20,1,3:21
10569,530104,2018-05-20,2018,PIT,SDN,5,8,8-5,SDN,9,0,44,38,82,149,157,306,16,9,25,2,3:15
10570,530099,2018-05-20,2018,ATL,MIA,10,9,10-9,ATL,9,0,44,46,90,155,167,322,18,22,40,2,3:19
10571,530096,2018-05-20,2018,SFN,COL,9,5,9-5,SFN,9,1,40,41,81,171,155,326,17,17,34,4,3:25
10572,530100,2018-05-20,2018,MIN,MIL,3,1,3-1,MIN,9,1,34,35,69,155,151,306,12,9,21,5,3:23
10573,530098,2018-05-20,2018,WAS,LAN,2,7,7-2,LAN,9,0,34,39,73,158,143,301,7,13,20,2,3:08
10574,530102,2018-05-20,2018,TOR,OAK,2,9,9-2,OAK,9,0,34,44,78,198,142,340,8,16,24,2,3:11
10575,530112,2018-05-21,2018,SLN,KCA,6,0,6-0,SLN,9,1,35,31,66,109,141,250,11,6,17,1,2:28
10576,530111,2018-05-21,2018,MIN,DET,4,2,4-2,MIN,9,1,35,31,66,119,138,257,13,5,18,1,2:35
10577,530107,2018-05-21,2018,MIL,ARI,4,2,4-2,MIL,9,1,30,34,64,118,119,237,6,8,14,1,2:31
10578,530110,2018-05-21,2018,LAN,COL,1,2,2-1,COL,9,0,33,32,65,128,117,245,7,5,12,1,2:35
10579,530108,2018-05-21,2018,PHI,ATL,3,0,3-0,PHI,9,1,34,33,67,133,138,271,11,6,17,0,2:33
10580,530113,2018-05-21,2018,NYN,MIA,2,0,2-0,NYN,9,1,33,35,68,157,132,289,10,9,19,2,2:52
10581,530115,2018-05-21,2018,WAS,SDN,10,2,10-2,WAS,9,1,40,34,74,144,145,289,17,7,24,0,2:27
10582,530114,2018-05-21,2018,TEX,NYA,5,10,10-5,NYA,9,0,37,44,81,173,139,312,11,16,27,1,3:07
10583,530109,2018-05-21,2018,CHA,BAL,2,3,3-2,BAL,9,0,40,34,74,138,156,294,16,9,25,1,3:02
10584,530124,2018-05-22,2018,TOR,ANA,5,3,5-3,TOR,9,1,32,32,64,121,128,249,9,7,16,0,2:31
10585,530116,2018-05-22,2018,MIL,ARI,1,0,1-0,MIL,9,1,30,32,62,144,121,265,7,10,17,1,2:40
10586,530118,2018-05-22,2018,CHA,BAL,3,2,3-2,CHA,9,1,39,36,75,147,152,299,15,11,26,3,3:03
10587,530125,2018-05-22,2018,NYN,MIA,1,5,5-1,MIA,9,0,32,39,71,174,134,308,7,11,18,1,2:50
10588,530129,2018-05-22,2018,HOU,SFN,11,2,11-2,HOU,9,1,41,35,76,155,156,311,19,11,30,3,3:05
10589,530119,2018-05-22,2018,TBA,BOS,2,4,4-2,BOS,9,0,36,36,72,138,150,288,10,12,22,2,2:55
10590,530130,2018-05-22,2018,OAK,SEA,2,3,3-2,SEA,10,0,38,40,78,160,141,301,8,11,19,2,2:50
10591,530122,2018-05-22,2018,MIN,DET,6,0,6-0,MIN,9,1,33,35,68,142,130,272,11,9,20,2,3:01
10592,530121,2018-05-22,2018,LAN,COL,5,3,5-3,LAN,9,1,33,36,69,140,130,270,9,10,19,0,2:48
10593,530128,2018-05-22,2018,WAS,SDN,2,1,2-1,WAS,9,0,35,32,67,119,141,260,11,8,19,1,2:48 (:10 delay)
10594,530126,2018-05-22,2018,TEX,NYA,6,4,6-4,TEX,9,1,38,37,75,141,171,312,15,10,25,2,3:07
10595,530123,2018-05-22,2018,SLN,KCA,1,5,5-1,KCA,9,0,36,40,76,135,112,247,12,14,26,2,2:53
10596,530117,2018-05-22,2018,PHI,ATL,1,3,3-1,ATL,9,0,35,39,74,155,133,288,9,13,22,3,3:18
10597,530127,2018-05-22,2018,CIN,PIT,7,2,7-2,CIN,9,1,35,37,72,154,122,276,12,11,23,3,2:49 (1:05 delay)
10598,530120,2018-05-22,2018,CHN,CLE,1,10,10-1,CLE,9,0,39,47,86,188,148,336,13,22,35,2,3:20
10599,530135,2018-05-23,2018,CHN,CLE,0,1,1-0,CLE,9,0,33,35,68,135,117,252,7,10,17,2,2:39
10600,530136,2018-05-23,2018,LAN,COL,3,0,3-0,LAN,9,1,32,33,65,136,108,244,11,8,19,2,2:38
10601,530144,2018-05-23,2018,HOU,SFN,4,1,4-1,HOU,9,1,34,34,68,135,140,275,10,7,17,1,2:56
10602,530145,2018-05-23,2018,OAK,SEA,0,1,1-0,SEA,9,0,31,36,67,147,130,277,5,9,14,1,2:43
10603,530134,2018-05-23,2018,TBA,BOS,1,4,4-1,BOS,9,0,32,36,68,164,127,291,6,11,17,2,3:10
10604,530131,2018-05-23,2018,MIL,ARI,9,2,9-2,MIL,9,1,41,33,74,136,165,301,18,6,24,3,3:04
10605,530132,2018-05-23,2018,PHI,ATL,4,0,4-0,PHI,9,1,37,35,72,139,135,274,13,10,23,2,2:51
10606,530140,2018-05-23,2018,NYN,MIA,1,2,2-1,MIA,9,0,35,41,76,145,144,289,9,15,24,0,2:47
10607,530137,2018-05-23,2018,MIN,DET,1,4,4-1,DET,9,0,34,37,71,153,157,310,9,12,21,3,2:59
10608,530143,2018-05-23,2018,WAS,SDN,1,3,3-1,SDN,9,0,34,35,69,147,143,290,8,11,19,5,3:00
10609,530133,2018-05-23,2018,CHA,BAL,11,1,11-1,CHA,9,1,41,35,76,124,167,291,18,7,25,1,2:54
10610,530138,2018-05-23,2018,SLN,KCA,2,5,5-2,KCA,10,0,38,40,78,157,141,298,8,11,19,3,3:04
10611,530141,2018-05-23,2018,TEX,NYA,12,10,12-10,TEX,9,1,41,45,86,171,163,334,16,16,32,4,3:20
10612,530139,2018-05-23,2018,TOR,ANA,4,5,5-4,ANA,9,0,39,45,84,197,157,354,14,18,32,4,3:45
10613,530142,2018-05-23,2018,CIN,PIT,4,5,5-4,PIT,12,0,53,56,109,211,178,389,18,21,39,3,4:21
10614,530148,2018-05-24,2018,CLE,HOU,2,8,8-2,HOU,9,0,35,40,75,156,122,278,10,16,26,3,2:56
10615,530150,2018-05-24,2018,TOR,ANA,1,8,8-1,ANA,9,0,31,43,74,164,113,277,6,16,22,3,2:53
10616,530149,2018-05-24,2018,TEX,KCA,2,8,8-2,KCA,9,0,32,42,74,152,146,298,8,15,23,2,2:53
10617,530152,2018-05-24,2018,CIN,PIT,5,4,5-4,CIN,9,1,35,35,70,135,141,276,11,9,20,3,2:50
10618,530147,2018-05-24,2018,TBA,BOS,6,3,6-3,TBA,9,1,39,35,74,148,162,310,17,9,26,2,2:58
10619,530146,2018-05-24,2018,CHA,BAL,3,9,9-3,BAL,9,0,31,47,78,203,121,324,4,20,24,2,3:00
10620,530151,2018-05-24,2018,MIL,NYN,0,5,5-0,NYN,9,0,34,43,77,180,135,315,9,17,26,1,2:56
10621,530153,2018-05-24,2018,OAK,SEA,4,3,4-3,OAK,9,1,30,36,66,149,117,266,6,14,20,2,2:44
10622,530164,2018-05-25,2018,LAN,SDN,4,1,4-1,LAN,9,1,31,32,63,133,121,254,8,6,14,1,2:26
10623,530162,2018-05-25,2018,SEA,MIN,2,1,2-1,SEA,9,1,29,31,60,128,112,240,7,4,11,0,2:14
10624,530158,2018-05-25,2018,COL,CIN,5,4,5-4,COL,9,1,35,38,73,145,115,260,14,12,26,2,2:43
10625,530161,2018-05-25,2018,NYA,ANA,2,1,2-1,NYA,9,1,32,35,67,145,126,271,9,11,20,3,3:00
10626,530166,2018-05-25,2018,PIT,SLN,8,1,8-1,PIT,9,1,38,33,71,98,127,225,14,7,21,2,2:37
10627,530163,2018-05-25,2018,MIL,NYN,4,3,4-3,MIL,10,0,40,39,79,153,138,291,13,11,24,3,3:08
10628,530154,2018-05-25,2018,OAK,ARI,1,7,7-1,ARI,9,0,34,44,78,166,133,299,7,17,24,2,3:02
10629,530155,2018-05-25,2018,BOS,ATL,6,2,6-2,BOS,9,1,33,38,71,153,140,293,10,11,21,2,3:13
10630,530156,2018-05-25,2018,TBA,BAL,0,2,2-0,BAL,9,0,35,35,70,137,134,271,11,9,20,4,2:47
10631,530157,2018-05-25,2018,DET,CHA,5,4,5-4,DET,9,1,32,40,72,150,113,263,12,14,26,3,2:51
10632,530167,2018-05-25,2018,PHI,TOR,5,6,6-5,TOR,9,0,39,38,77,145,146,291,12,12,24,1,2:59
10633,530165,2018-05-25,2018,CHN,SFN,6,2,6-2,CHN,9,1,36,34,70,127,135,262,14,7,21,4,2:46
10634,530160,2018-05-25,2018,TEX,KCA,8,4,8-4,TEX,9,1,40,40,80,154,169,323,15,13,28,3,3:07
10635,530159,2018-05-25,2018,CLE,HOU,2,11,11-2,HOU,9,0,39,47,86,177,159,336,12,20,32,5,3:41
10636,530168,2018-05-25,2018,MIA,WAS,5,9,9-5,WAS,9,0,43,42,85,181,171,352,15,17,32,5,3:37
10637,530169,2018-05-26,2018,OAK,ARI,3,0,3-0,OAK,9,1,30,30,60,102,114,216,6,2,8,0,2:15
10638,530182,2018-05-26,2018,PHI,TOR,2,1,2-1,PHI,9,1,31,31,62,135,88,223,7,6,13,2,2:25 (:42 delay)
10639,530183,2018-05-26,2018,MIA,WAS,1,4,4-1,WAS,9,0,34,38,72,142,136,278,8,12,20,3,2:56
10640,530171,2018-05-26,2018,TBA,BAL,5,1,5-1,TBA,9,1,38,31,69,111,135,246,17,4,21,2,2:28
10641,530181,2018-05-26,2018,PIT,SLN,1,4,4-1,SLN,9,0,34,37,71,150,126,276,8,14,22,1,2:52
10642,530173,2018-05-26,2018,COL,CIN,5,6,6-5,CIN,9,0,38,39,77,148,148,296,16,14,30,2,3:00
10643,530180,2018-05-26,2018,CHN,SFN,4,5,5-4,SFN,9,0,35,41,76,160,136,296,10,17,27,2,3:04
10644,530175,2018-05-26,2018,TEX,KCA,4,3,4-3,TEX,10,0,38,38,76,134,157,291,13,10,23,0,2:59
10645,530179,2018-05-26,2018,LAN,SDN,5,7,7-5,SDN,9,0,40,40,80,142,162,304,13,16,29,4,3:12
10646,530174,2018-05-26,2018,CLE,HOU,8,6,8-6,CLE,9,1,38,38,76,155,169,324,13,12,25,4,3:28 (1:00 delay)
10647,530176,2018-05-26,2018,NYA,ANA,4,11,11-4,ANA,9,0,36,45,81,186,155,341,10,19,29,3,3:30
10648,530172,2018-05-26,2018,DET,CHA,4,8,8-4,CHA,9,0,41,42,83,152,155,307,13,15,28,2,3:16
10649,530170,2018-05-26,2018,BOS,ATL,8,6,8-6,BOS,9,1,42,41,83,161,189,350,17,15,32,2,3:29
10650,530177,2018-05-26,2018,SEA,MIN,4,3,4-3,SEA,12,0,44,44,88,165,160,325,12,11,23,3,3:40
10651,530178,2018-05-26,2018,MIL,NYN,17,6,17-6,MIL,9,1,51,43,94,167,193,360,27,17,44,3,3:36
10652,530184,2018-05-27,2018,OAK,ARI,2,1,2-1,OAK,9,1,33,32,65,114,145,259,11,5,16,1,2:38
10653,530192,2018-05-27,2018,SEA,MIN,3,1,3-1,SEA,9,1,34,30,64,95,115,210,12,4,16,3,2:18
10654,530194,2018-05-27,2018,LAN,SDN,6,1,6-1,LAN,9,1,34,33,67,127,111,238,12,6,18,0,2:26
10655,530193,2018-05-27,2018,MIL,NYN,8,7,8-7,MIL,9,1,38,38,76,133,151,284,14,13,27,3,2:56
10656,530190,2018-05-27,2018,TEX,KCA,3,5,5-3,KCA,9,0,37,37,74,128,160,288,12,12,24,4,3:00
10657,530185,2018-05-27,2018,BOS,ATL,1,7,7-1,ATL,9,0,34,42,76,159,143,302,8,15,23,1,2:53
10658,530191,2018-05-27,2018,NYA,ANA,3,1,3-1,NYA,9,1,36,34,70,161,157,318,12,9,21,1,3:27
10659,530186,2018-05-27,2018,TBA,BAL,8,3,8-3,TBA,9,1,43,39,82,131,188,319,21,14,35,4,3:10
10660,530198,2018-05-27,2018,MIA,WAS,2,5,5-2,WAS,9,0,38,38,76,131,189,320,10,14,24,1,3:08
10661,530187,2018-05-27,2018,DET,CHA,3,2,3-2,DET,9,1,32,33,65,117,116,233,9,6,15,0,2:17
10662,530188,2018-05-27,2018,COL,CIN,8,2,8-2,COL,9,1,40,38,78,142,131,273,16,14,30,4,2:53
10663,530196,2018-05-27,2018,PIT,SLN,4,6,6-4,SLN,9,0,33,41,74,150,132,282,6,14,20,3,2:58
10664,530197,2018-05-27,2018,PHI,TOR,3,5,5-3,TOR,9,0,35,38,73,149,130,279,9,14,23,2,2:50
10665,530195,2018-05-27,2018,CHN,SFN,8,3,8-3,CHN,9,1,42,43,85,181,172,353,19,17,36,2,3:31
10666,530189,2018-05-27,2018,CLE,HOU,10,9,10-9,CLE,14,0,54,56,110,220,231,451,17,14,31,4,4:53
10667,530200,2018-05-28,2018,CLE,CHA,9,6,9-6,CLE,9,1,38,38,76,144,141,285,16,13,29,5,3:12
10668,530211,2018-05-28,2018,SEA,TEX,2,1,2-1,SEA,9,1,32,33,65,136,107,243,9,10,19,2,2:32
10669,530212,2018-05-28,2018,BOS,TOR,8,3,8-3,BOS,9,1,38,38,76,148,124,272,15,12,27,0,2:54
10670,530202,2018-05-28,2018,NYA,HOU,1,5,5-1,HOU,9,0,34,36,70,150,146,296,8,9,17,2,3:14
10671,530208,2018-05-28,2018,COL,SFN,6,5,6-5,COL,10,0,43,45,88,151,164,315,16,15,31,2,3:31 (:55 delay)
10672,530209,2018-05-28,2018,MIL,SLN,8,3,8-3,MIL,9,1,37,33,70,131,155,286,14,7,21,0,3:03
10673,530199,2018-05-28,2018,PIT,CHN,0,7,7-0,CHN,9,0,28,43,71,156,114,270,2,18,20,2,2:53
10674,530207,2018-05-28,2018,LAN,PHI,5,4,5-4,LAN,9,1,33,38,71,153,148,301,9,10,19,3,3:32
10675,530206,2018-05-28,2018,ATL,NYN,4,3,4-3,ATL,9,0,36,37,73,150,147,297,12,13,25,0,3:05 (:31 delay)
10676,530213,2018-05-28,2018,BAL,WAS,0,6,6-0,WAS,9,0,33,40,73,145,128,273,9,14,23,2,2:44
10677,530203,2018-05-28,2018,DET,ANA,9,3,9-3,DET,9,1,38,39,77,172,138,310,16,13,29,4,3:17
10678,530204,2018-05-28,2018,SDN,MIA,2,7,7-2,MIA,9,0,33,39,72,157,125,282,7,17,24,2,2:41
10679,529729,2018-05-28,2018,ATL,NYN,5,8,8-5,NYN,9,0,42,44,86,157,157,314,17,17,34,3,3:21 (2:57 delay)
10680,529729,2018-05-28,2018,ATL,NYN,5,8,8-5,NYN,9,0,42,44,86,157,157,314,17,17,34,3,3:21 (2:57 delay)
10681,530201,2018-05-28,2018,ARI,CIN,12,5,12-5,ARI,9,1,41,41,82,137,177,314,16,18,34,3,3:19
10682,530205,2018-05-28,2018,KCA,MIN,5,8,8-5,MIN,9,0,44,45,89,149,147,296,17,18,35,3,3:13
10683,530210,2018-05-28,2018,OAK,TBA,0,1,1-0,TBA,13,0,49,47,96,164,189,353,13,8,21,3,3:55
10684,530216,2018-05-29,2018,ARI,CIN,5,2,5-2,ARI,9,1,32,35,67,137,126,263,8,10,18,0,2:40
10685,530227,2018-05-29,2018,BOS,TOR,8,3,8-3,BOS,9,1,38,39,77,140,142,282,16,13,29,4,2:59
10686,530224,2018-05-29,2018,MIL,SLN,1,6,6-1,SLN,9,0,34,39,73,127,135,262,7,15,22,1,2:41
10687,530228,2018-05-29,2018,BAL,WAS,2,3,3-2,WAS,9,0,36,39,75,143,152,295,12,15,27,0,3:14
10688,530221,2018-05-29,2018,ATL,NYN,7,6,7-6,ATL,9,0,42,40,82,136,149,285,19,14,33,1,3:11 (:41 delay)
10689,530219,2018-05-29,2018,SDN,MIA,9,5,9-5,SDN,9,1,36,36,72,150,151,301,12,11,23,4,3:02
10690,530214,2018-05-29,2018,PIT,CHN,6,8,8-6,CHN,9,0,41,46,87,144,147,291,14,21,35,3,3:03
10691,530223,2018-05-29,2018,COL,SFN,11,4,11-4,COL,9,1,43,37,80,152,152,304,16,13,29,2,3:17
10692,530225,2018-05-29,2018,OAK,TBA,3,4,4-3,TBA,9,0,37,35,72,145,160,305,8,12,20,1,2:55
10693,530215,2018-05-29,2018,CLE,CHA,7,3,7-3,CLE,9,1,37,36,73,163,142,305,15,11,26,4,2:58
10694,530218,2018-05-29,2018,DET,ANA,2,9,9-2,ANA,9,0,38,42,80,185,159,344,12,19,31,3,3:25
10695,530222,2018-05-29,2018,LAN,PHI,1,6,6-1,PHI,9,0,36,43,79,169,136,305,11,18,29,2,3:26
10696,530226,2018-05-29,2018,SEA,TEX,5,9,9-5,TEX,9,0,41,47,88,190,166,356,14,22,36,5,3:40
10697,530220,2018-05-29,2018,KCA,MIN,2,1,2-1,KCA,14,0,53,56,109,218,187,405,13,16,29,1,4:12 (:24 delay)
10698,530217,2018-05-29,2018,NYA,HOU,6,5,6-5,NYA,10,0,45,45,90,180,167,347,16,15,31,1,3:47
10699,530229,2018-05-30,2018,PIT,CHN,2,1,2-1,PIT,9,1,34,39,73,126,107,233,13,14,27,1,2:50
10700,530233,2018-05-30,2018,DET,ANA,6,1,6-1,DET,9,1,40,35,75,132,147,279,15,9,24,2,2:53 (1:04 delay)
10701,530243,2018-05-30,2018,BAL,WAS,0,2,2-0,WAS,9,0,31,35,66,143,125,268,5,9,14,0,2:34
10702,530231,2018-05-30,2018,ARI,CIN,4,7,7-4,CIN,9,0,40,43,83,156,144,300,14,15,29,2,3:06
10703,530234,2018-05-30,2018,SDN,MIA,3,2,3-2,SDN,9,0,36,33,69,122,131,253,12,6,18,0,2:20
10704,530230,2018-05-30,2018,CLE,CHA,9,1,9-1,CLE,9,1,43,32,75,139,177,316,18,7,25,2,3:09
10705,530236,2018-05-30,2018,ATL,NYN,1,4,4-1,NYN,9,0,34,39,73,145,116,261,8,15,23,1,2:42
10706,530237,2018-05-30,2018,LAN,PHI,8,2,8-2,LAN,9,1,42,38,80,149,151,300,18,11,29,0,3:03
10707,530242,2018-05-30,2018,BOS,TOR,6,4,6-4,BOS,9,1,35,35,70,137,130,267,12,8,20,2,2:52
10708,530240,2018-05-30,2018,OAK,TBA,0,6,6-0,TBA,9,0,30,43,73,170,125,295,3,15,18,0,2:50
10709,530238,2018-05-30,2018,COL,SFN,4,7,7-4,SFN,9,0,39,42,81,162,131,293,13,15,28,1,3:11
10710,530232,2018-05-30,2018,NYA,HOU,5,3,5-3,NYA,9,1,35,36,71,138,156,294,12,8,20,1,2:47
10711,530235,2018-05-30,2018,KCA,MIN,11,8,11-8,KCA,9,1,42,42,84,169,148,317,18,16,34,4,3:01
10712,530239,2018-05-30,2018,MIL,SLN,3,2,3-2,MIL,9,1,39,39,78,147,170,317,17,12,29,2,3:31
10713,530241,2018-05-30,2018,SEA,TEX,6,7,7-6,TEX,9,0,41,44,85,164,160,324,15,20,35,3,3:17
10714,530244,2018-05-31,2018,HOU,BOS,4,2,4-2,HOU,9,1,33,36,69,146,143,289,13,9,22,1,2:57
10715,530254,2018-05-31,2018,ATL,WAS,4,2,4-2,ATL,9,1,35,34,69,127,122,249,16,7,23,2,2:39
10716,530252,2018-05-31,2018,OAK,TBA,7,3,7-3,OAK,9,1,38,36,74,121,142,263,14,10,24,3,2:37
10717,530248,2018-05-31,2018,SDN,MIA,8,3,8-3,SDN,9,1,42,38,80,155,159,314,18,12,30,2,2:59
10718,530250,2018-05-31,2018,LAN,PHI,1,2,2-1,PHI,9,0,31,32,63,118,134,252,3,7,10,0,2:40
10719,530246,2018-05-31,2018,MIN,CLE,8,9,9-8,CLE,9,0,40,43,83,187,154,341,15,17,32,6,3:29
10720,530245,2018-05-31,2018,NYN,CHN,1,5,5-1,CHN,9,0,34,43,77,165,143,308,8,17,25,3,3:02
10721,530253,2018-05-31,2018,SEA,TEX,6,1,6-1,SEA,9,1,37,35,72,148,140,288,14,10,24,0,2:53
10722,530247,2018-05-31,2018,DET,ANA,6,2,6-2,DET,9,1,39,36,75,147,136,283,16,9,25,1,3:09
10723,530251,2018-05-31,2018,SLN,PIT,10,8,10-8,SLN,9,0,42,42,84,176,146,322,18,16,34,4,3:43
10724,530267,2018-06-01,2018,ANA,TEX,6,0,6-0,ANA,9,1,37,35,72,132,128,260,13,10,23,1,2:37
10725,530258,2018-06-01,2018,MIN,CLE,7,4,7-4,MIN,9,1,38,35,73,134,130,264,16,8,24,1,2:39
10726,530264,2018-06-01,2018,SFN,PHI,4,0,4-0,SFN,9,1,38,33,71,136,155,291,13,7,20,0,2:49
10727,530269,2018-06-01,2018,ATL,WAS,4,0,4-0,ATL,9,1,33,29,62,106,125,231,10,3,13,2,2:24 (:11 delay)
10728,530263,2018-06-01,2018,KCA,OAK,0,16,16-0,OAK,9,0,34,47,81,201,110,311,10,21,31,1,2:49
10729,530262,2018-06-01,2018,BAL,NYA,1,4,4-1,NYA,9,0,36,39,75,153,152,305,10,13,23,0,3:03
10730,530260,2018-06-01,2018,ARI,MIA,9,1,9-1,ARI,9,1,36,37,73,130,137,267,13,10,23,1,2:40
10731,530257,2018-06-01,2018,SDN,CIN,2,7,7-2,CIN,9,0,36,41,77,144,150,294,10,15,25,2,2:57
10732,530255,2018-06-01,2018,HOU,BOS,7,3,7-3,HOU,9,1,38,36,74,135,146,281,15,10,25,1,2:55
10733,530268,2018-06-01,2018,DET,TOR,5,2,5-2,DET,9,1,34,38,72,143,127,270,12,13,25,2,2:52
10734,530261,2018-06-01,2018,CHA,MIL,8,3,8-3,CHA,9,1,34,40,74,169,136,305,13,13,26,4,3:00
10735,530259,2018-06-01,2018,COL,LAN,8,11,11-8,LAN,9,0,43,45,88,184,155,339,16,19,35,3,3:36
10736,530256,2018-06-01,2018,NYN,CHN,4,7,7-4,CHN,9,0,38,44,82,157,159,316,12,19,31,5,3:20
10737,530266,2018-06-01,2018,SEA,TBA,4,3,4-3,SEA,13,0,50,49,99,203,189,392,16,14,30,4,4:16
10738,530265,2018-06-01,2018,SLN,PIT,0,4,4-0,PIT,9,0,31,39,70,145,122,267,5,12,17,1,2:46
10739,530279,2018-06-02,2018,SFN,PHI,2,0,2-0,SFN,9,1,32,30,62,103,120,223,8,3,11,2,2:24
10740,530280,2018-06-02,2018,SLN,PIT,3,2,3-2,SLN,9,0,34,32,66,143,128,271,10,6,16,0,2:48
10741,530276,2018-06-02,2018,CHA,MIL,0,5,5-0,MIL,9,0,34,36,70,138,133,271,7,12,19,2,2:52
10742,530283,2018-06-02,2018,DET,TOR,7,4,7-4,DET,9,1,36,34,70,122,165,287,13,8,21,1,2:37
10743,530272,2018-06-02,2018,SDN,CIN,8,2,8-2,SDN,9,1,37,36,73,153,150,303,14,11,25,1,2:50
10744,530275,2018-06-02,2018,ARI,MIA,6,2,6-2,ARI,9,1,35,38,73,157,138,295,14,12,26,3,3:01
10745,530282,2018-06-02,2018,ANA,TEX,2,3,3-2,TEX,10,0,38,37,75,162,138,300,9,8,17,2,3:21 (:20 delay)
10746,530273,2018-06-02,2018,MIN,CLE,7,1,7-1,MIN,9,1,36,39,75,174,141,315,11,13,24,2,3:12
10747,530281,2018-06-02,2018,SEA,TBA,3,1,3-1,SEA,9,1,36,33,69,129,147,276,14,8,22,2,2:57
10748,530270,2018-06-02,2018,HOU,BOS,4,5,5-4,BOS,9,0,36,37,73,159,164,323,9,10,19,2,3:41
10749,530277,2018-06-02,2018,BAL,NYA,5,8,8-5,NYA,9,0,39,42,81,178,162,340,13,15,28,2,3:31 (1:44 delay)
10750,530278,2018-06-02,2018,KCA,OAK,5,4,5-4,KCA,9,1,34,39,73,151,144,295,13,13,26,2,3:00
10751,530284,2018-06-02,2018,ATL,WAS,3,5,5-3,WAS,14,0,47,55,102,206,177,383,5,14,19,1,4:00
10752,530274,2018-06-02,2018,COL,LAN,4,12,12-4,LAN,9,0,38,45,83,197,136,333,14,19,33,2,3:25
10753,530271,2018-06-02,2018,NYN,CHN,1,7,7-1,CHN,14,0,54,66,120,263,210,473,12,29,41,2,4:53
10754,530294,2018-06-03,2018,SFN,PHI,6,1,6-1,SFN,9,1,31,36,67,125,111,236,11,9,20,0,2:28
10755,530295,2018-06-03,2018,SLN,PIT,5,0,5-0,SLN,9,1,34,31,65,127,137,264,9,4,13,2,2:25
10756,530299,2018-06-03,2018,ATL,WAS,4,2,4-2,ATL,9,0,36,33,69,132,130,262,13,5,18,1,2:47
10757,530296,2018-06-03,2018,SEA,TBA,2,1,2-1,SEA,9,1,30,35,65,123,131,254,5,8,13,1,2:40
10758,530297,2018-06-03,2018,ANA,TEX,3,1,3-1,ANA,9,1,28,38,66,174,111,285,4,12,16,0,2:39
10759,530290,2018-06-03,2018,ARI,MIA,6,1,6-1,ARI,9,1,38,33,71,125,149,274,14,8,22,3,2:47
10760,530291,2018-06-03,2018,CHA,MIL,6,1,6-1,CHA,9,1,35,35,70,138,139,277,12,9,21,3,2:53
10761,530285,2018-06-03,2018,HOU,BOS,3,9,9-3,BOS,9,0,39,41,80,167,141,308,11,17,28,3,3:25
10762,530287,2018-06-03,2018,SDN,CIN,6,3,6-3,SDN,9,1,35,39,74,163,139,302,13,14,27,2,3:06
10763,530286,2018-06-03,2018,NYN,CHN,0,2,2-0,CHN,9,0,34,33,67,130,143,273,8,8,16,1,2:30
10764,530298,2018-06-03,2018,DET,TOR,4,8,8-4,TOR,9,0,37,41,78,159,163,322,10,16,26,3,3:02
10765,530288,2018-06-03,2018,MIN,CLE,7,5,7-5,MIN,9,0,38,35,73,158,156,314,15,10,25,6,3:14
10766,530289,2018-06-03,2018,COL,LAN,7,10,10-7,LAN,9,0,39,41,80,164,172,336,12,13,25,4,3:43
10767,530293,2018-06-03,2018,KCA,OAK,1,5,5-1,OAK,9,0,32,38,70,135,115,250,6,12,18,1,2:26
10768,529619,2018-06-04,2018,DET,NYA,4,7,7-4,NYA,9,0,36,41,77,176,135,311,7,14,21,2,2:46
10769,529619,2018-06-04,2018,DET,NYA,4,7,7-4,NYA,9,0,36,41,77,176,135,311,7,14,21,2,2:46
10770,529634,2018-06-04,2018,DET,NYA,4,2,4-2,DET,9,1,38,39,77,158,134,292,14,12,26,2,3:07
10771,529634,2018-06-04,2018,DET,NYA,4,2,4-2,DET,9,1,38,39,77,158,134,292,14,12,26,2,3:07
10772,529619,2018-06-04,2018,DET,NYA,4,7,7-4,NYA,9,0,36,41,77,176,135,311,7,14,21,2,2:46
10773,530300,2018-06-04,2018,SFN,ARI,10,3,10-3,SFN,9,1,39,36,75,164,157,321,17,10,27,2,3:11
10774,530301,2018-06-04,2018,SDN,ATL,11,4,11-4,SDN,9,1,42,39,81,145,163,308,18,12,30,2,2:57
10775,530302,2018-06-04,2018,ANA,KCA,9,6,9-6,ANA,9,1,41,41,82,156,175,331,21,14,35,4,3:35
10776,529600,2018-06-05,2018,MIN,CHA,3,6,6-3,CHA,9,0,38,40,78,156,153,309,14,14,28,4,3:07
10777,530312,2018-06-05,2018,CLE,MIL,3,2,3-2,CLE,9,1,32,34,66,139,123,262,9,8,17,1,2:39
10778,530305,2018-06-05,2018,NYN,BAL,1,2,2-1,BAL,9,0,33,33,66,122,143,265,6,8,14,1,2:33
10779,530309,2018-06-05,2018,ANA,KCA,1,0,1-0,ANA,9,1,30,30,60,116,119,235,8,3,11,1,2:16
10780,530303,2018-06-05,2018,SFN,ARI,2,3,3-2,ARI,9,0,40,38,78,127,161,288,13,10,23,2,3:05
10781,530311,2018-06-05,2018,SLN,MIA,4,7,7-4,MIA,9,0,37,44,81,179,145,324,13,18,31,0,3:12
10782,530304,2018-06-05,2018,SDN,ATL,1,14,14-1,ATL,9,0,33,51,84,185,144,329,9,24,33,1,2:55
10783,530310,2018-06-05,2018,PIT,LAN,0,5,5-0,LAN,9,0,34,36,70,145,150,295,8,9,17,0,3:01 (:53 delay)
10784,530306,2018-06-05,2018,MIN,CHA,4,2,4-2,MIN,9,1,32,37,69,144,136,280,8,9,17,1,2:37
10785,530317,2018-06-05,2018,WAS,TBA,4,2,4-2,WAS,9,1,30,31,61,106,134,240,5,5,10,0,2:16
10786,530307,2018-06-05,2018,CIN,COL,6,9,9-6,COL,9,0,43,41,84,170,150,320,18,18,36,2,3:16
10787,530316,2018-06-05,2018,HOU,SEA,1,7,7-1,SEA,9,0,34,36,70,138,119,257,10,9,19,2,2:29
10788,530308,2018-06-05,2018,BOS,DET,6,0,6-0,BOS,9,1,37,31,68,124,129,253,16,6,22,1,2:41
10789,530313,2018-06-05,2018,TOR,NYA,2,7,7-2,NYA,9,0,31,38,69,165,114,279,4,13,17,2,2:38
10790,530315,2018-06-05,2018,CHN,PHI,1,6,6-1,PHI,9,0,36,42,78,155,121,276,10,16,26,2,2:46
10791,530314,2018-06-05,2018,TEX,OAK,7,4,7-4,TEX,9,1,37,41,78,148,140,288,14,15,29,3,2:52
10792,529600,2018-06-05,2018,MIN,CHA,3,6,6-3,CHA,9,0,38,40,78,156,153,309,14,14,28,4,3:07
10793,530320,2018-06-06,2018,NYN,BAL,0,1,1-0,BAL,9,0,34,34,68,122,123,245,9,9,18,0,2:27
10794,530319,2018-06-06,2018,SDN,ATL,3,1,3-1,SDN,9,1,34,34,68,132,143,275,11,7,18,1,2:47
10795,530332,2018-06-06,2018,WAS,TBA,11,2,11-2,WAS,9,1,42,35,77,126,169,295,20,9,29,2,2:50
10796,530331,2018-06-06,2018,HOU,SEA,7,5,7-5,HOU,9,1,38,40,78,150,151,301,18,14,32,3,3:14
10797,530324,2018-06-06,2018,ANA,KCA,4,3,4-3,ANA,9,1,38,38,76,155,142,297,14,13,27,1,3:11
10798,530322,2018-06-06,2018,CIN,COL,3,6,6-3,COL,9,0,43,38,81,148,172,320,16,11,27,3,3:25
10799,530321,2018-06-06,2018,MIN,CHA,2,5,5-2,CHA,9,0,38,38,76,171,174,345,13,11,24,2,3:27
10800,530329,2018-06-06,2018,TEX,OAK,8,2,8-2,TEX,9,1,35,38,73,158,155,313,13,13,26,2,3:05
10801,530327,2018-06-06,2018,CLE,MIL,3,1,3-1,CLE,9,1,37,35,72,144,160,304,12,10,22,4,3:23
10802,530323,2018-06-06,2018,BOS,DET,7,1,7-1,BOS,9,1,37,38,75,174,133,307,14,10,24,2,3:20
10803,530330,2018-06-06,2018,CHN,PHI,7,5,7-5,CHN,9,0,38,38,76,152,148,300,13,11,24,3,3:20
10804,530318,2018-06-06,2018,SFN,ARI,5,4,5-4,SFN,10,0,40,44,84,176,164,340,13,18,31,1,3:38
10805,530326,2018-06-06,2018,SLN,MIA,3,11,11-3,MIA,9,0,37,49,86,182,150,332,11,21,32,2,3:23
10806,530328,2018-06-06,2018,TOR,NYA,0,3,3-0,NYA,13,0,43,50,93,204,165,369,6,13,19,1,3:41
10807,530325,2018-06-06,2018,PIT,LAN,11,9,11-9,PIT,9,1,45,41,86,199,164,363,24,16,40,5,3:48
10808,530338,2018-06-07,2018,OAK,KCA,4,1,4-1,OAK,9,1,33,30,63,110,117,227,10,4,14,0,2:18
10809,530334,2018-06-07,2018,MIN,CHA,7,2,7-2,MIN,9,1,35,31,66,109,120,229,12,6,18,0,2:14
10810,530342,2018-06-07,2018,TBA,SEA,4,5,5-4,SEA,9,0,37,37,74,134,122,256,12,11,23,1,2:43
10811,530336,2018-06-07,2018,BOS,DET,2,7,7-2,DET,9,0,38,40,78,157,141,298,12,13,25,1,2:55
10812,530337,2018-06-07,2018,TEX,HOU,2,5,5-2,HOU,9,0,37,36,73,124,151,275,11,11,22,2,2:36 (:40 delay)
10813,530340,2018-06-07,2018,SLN,MIA,4,1,4-1,SLN,9,1,35,34,69,130,133,263,13,7,20,2,2:42
10814,530341,2018-06-07,2018,CHN,PHI,4,3,4-3,CHN,9,1,31,43,74,190,122,312,7,16,23,2,3:20
10815,530339,2018-06-07,2018,PIT,LAN,7,8,8-7,LAN,9,0,40,43,83,169,173,342,12,17,29,3,3:37
10816,530333,2018-06-07,2018,TOR,BAL,5,4,5-4,TOR,10,0,43,40,83,143,174,317,18,11,29,3,3:13
10817,530335,2018-06-07,2018,CIN,COL,7,5,7-5,CIN,13,0,50,55,105,191,197,388,17,18,35,1,4:15
10818,530352,2018-06-08,2018,NYN,NYA,1,4,4-1,NYA,9,0,32,33,65,116,133,249,6,7,13,0,2:28
10819,530346,2018-06-08,2018,BOS,CHA,0,1,1-0,CHA,9,0,31,33,64,124,122,246,4,7,11,1,2:24
10820,530347,2018-06-08,2018,DET,CLE,1,4,4-1,CLE,9,0,36,34,70,143,131,274,9,8,17,0,2:43
10821,530349,2018-06-08,2018,OAK,KCA,7,2,7-2,OAK,9,1,36,36,72,118,138,256,12,9,21,4,2:32
10822,530356,2018-06-08,2018,TBA,SEA,3,4,4-3,SEA,9,0,35,38,73,147,131,278,10,12,22,4,2:50
10823,530345,2018-06-08,2018,TOR,BAL,5,1,5-1,TOR,9,1,37,33,70,123,144,267,16,7,23,1,2:44
10824,530350,2018-06-08,2018,MIN,ANA,2,4,4-2,ANA,9,0,36,36,72,147,165,312,10,9,19,2,3:21
10825,530343,2018-06-08,2018,COL,ARI,4,9,9-4,ARI,9,0,39,42,81,149,135,284,14,16,30,1,2:51
10826,530348,2018-06-08,2018,TEX,HOU,3,7,7-3,HOU,9,0,35,38,73,152,149,301,8,13,21,0,3:02
10827,530354,2018-06-08,2018,MIA,SDN,4,0,4-0,MIA,9,1,40,33,73,138,162,300,18,8,26,1,3:00
10828,530344,2018-06-08,2018,LAN,ATL,7,3,7-3,LAN,9,1,33,33,66,132,131,263,11,7,18,4,2:52
10829,530355,2018-06-08,2018,WAS,SFN,5,9,9-5,SFN,9,0,38,42,80,158,142,300,11,16,27,2,3:04
10830,530351,2018-06-08,2018,PHI,MIL,4,12,12-4,MIL,9,0,38,44,82,164,152,316,11,17,28,2,3:27
10831,530353,2018-06-08,2018,CHN,PIT,3,1,3-1,CHN,9,1,33,37,70,140,146,286,12,12,24,3,3:00
10832,530357,2018-06-08,2018,CIN,SLN,6,7,7-6,SLN,10,0,48,44,92,171,185,356,22,15,37,3,3:51 (:36 delay)
10833,530364,2018-06-09,2018,OAK,KCA,0,2,2-0,KCA,9,0,34,34,68,123,126,249,7,7,14,0,2:27
10834,530368,2018-06-09,2018,CHN,PIT,2,0,2-0,CHN,9,1,35,30,65,136,119,255,13,3,16,2,2:32
10835,530361,2018-06-09,2018,BOS,CHA,4,2,4-2,BOS,9,1,35,35,70,125,143,268,10,10,20,1,2:48
10836,530371,2018-06-09,2018,TBA,SEA,7,3,7-3,TBA,9,1,35,40,75,151,123,274,12,15,27,1,2:52
10837,530367,2018-06-09,2018,NYN,NYA,3,4,4-3,NYA,9,0,36,37,73,153,146,299,9,14,23,0,2:57
10838,530359,2018-06-09,2018,LAN,ATL,3,5,5-3,ATL,9,0,34,40,74,144,140,284,9,14,23,4,3:11
10839,530369,2018-06-09,2018,MIA,SDN,4,5,5-4,SDN,9,0,36,41,77,176,136,312,9,18,27,2,3:07
10840,530358,2018-06-09,2018,COL,ARI,7,12,12-7,ARI,9,0,35,48,83,202,135,337,10,22,32,2,3:34
10841,530363,2018-06-09,2018,TEX,HOU,3,4,4-3,HOU,9,0,47,35,82,141,180,321,20,12,32,3,3:31
10842,530360,2018-06-09,2018,TOR,BAL,4,3,4-3,TOR,10,0,43,46,89,175,150,325,16,17,33,4,3:19
10843,530362,2018-06-09,2018,DET,CLE,4,2,4-2,DET,12,0,49,45,94,175,175,350,15,10,25,3,3:46 (1:51 delay)
10844,530372,2018-06-09,2018,CIN,SLN,4,6,6-4,SLN,9,0,41,39,80,163,173,336,14,12,26,3,3:22
10845,530365,2018-06-09,2018,MIN,ANA,1,2,2-1,ANA,9,0,34,34,68,145,143,288,8,9,17,0,2:53 (4:00 delay)
10846,530370,2018-06-09,2018,WAS,SFN,7,5,7-5,WAS,9,1,40,43,83,168,160,328,16,16,32,4,3:23
10847,530366,2018-06-09,2018,PHI,MIL,3,12,12-3,MIL,9,0,36,46,82,193,153,346,10,18,28,3,3:31
10848,530379,2018-06-10,2018,OAK,KCA,3,2,3-2,OAK,9,1,35,35,70,110,129,239,13,7,20,3,2:25
10849,530385,2018-06-10,2018,WAS,SFN,0,2,2-0,SFN,9,0,31,36,67,137,142,279,7,9,16,1,2:51
10850,530374,2018-06-10,2018,LAN,ATL,7,2,7-2,LAN,9,1,37,34,71,127,132,259,14,7,21,3,2:37
10851,530384,2018-06-10,2018,MIA,SDN,1,3,3-1,SDN,9,0,33,34,67,136,115,251,6,9,15,0,2:24
10852,530382,2018-06-10,2018,NYN,NYA,2,0,2-0,NYN,9,1,32,31,63,123,151,274,8,4,12,0,2:40
10853,530380,2018-06-10,2018,MIN,ANA,7,5,7-5,MIN,9,1,38,42,80,160,134,294,15,16,31,1,3:08
10854,530376,2018-06-10,2018,BOS,CHA,2,5,5-2,CHA,9,0,41,41,82,161,142,303,14,14,28,2,3:15
10855,530375,2018-06-10,2018,TOR,BAL,13,3,13-3,TOR,9,1,46,36,82,153,173,326,22,10,32,3,3:03
10856,530386,2018-06-10,2018,TBA,SEA,4,5,5-4,SEA,9,0,36,34,70,167,142,309,10,8,18,2,2:50
10857,530383,2018-06-10,2018,CHN,PIT,1,7,7-1,PIT,9,0,33,41,74,185,141,326,6,15,21,2,3:22
10858,530381,2018-06-10,2018,PHI,MIL,4,3,4-3,PHI,9,1,34,38,72,148,133,281,8,11,19,1,2:57
10859,530378,2018-06-10,2018,TEX,HOU,7,8,8-7,HOU,9,0,44,41,85,128,183,311,18,16,34,2,3:09
10860,530387,2018-06-10,2018,CIN,SLN,6,3,6-3,CIN,9,1,38,39,77,146,165,311,17,14,31,2,3:21
10861,530373,2018-06-10,2018,COL,ARI,3,8,8-3,ARI,9,0,37,43,80,173,145,318,11,16,27,3,3:23
10862,530377,2018-06-10,2018,DET,CLE,2,9,9-2,CLE,9,0,32,43,75,170,115,285,5,17,22,0,2:49
10863,530391,2018-06-11,2018,SEA,ANA,5,3,5-3,SEA,9,1,32,37,69,144,104,248,10,10,20,1,2:35
10864,530395,2018-06-11,2018,TBA,TOR,8,4,8-4,TBA,9,1,39,34,73,137,125,262,14,10,24,2,2:34
10865,530390,2018-06-11,2018,CHA,CLE,0,4,4-0,CLE,9,0,32,40,72,161,131,292,5,13,18,2,2:59
10866,530392,2018-06-11,2018,ARI,PIT,9,5,9-5,ARI,9,1,39,39,78,149,132,281,14,16,30,3,3:07
10867,530394,2018-06-11,2018,MIA,SFN,7,5,7-5,MIA,9,1,34,41,75,154,134,288,10,16,26,4,3:03
10868,530388,2018-06-11,2018,BAL,BOS,0,2,2-0,BOS,12,0,49,46,95,170,196,366,13,11,24,3,3:45
10869,530389,2018-06-11,2018,MIL,CHN,2,7,7-2,CHN,11,0,40,48,88,179,171,350,10,17,27,2,3:54
10870,530393,2018-06-11,2018,SLN,SDN,5,2,5-2,SLN,9,1,35,35,70,156,130,286,12,8,20,2,2:53
10871,530409,2018-06-12,2018,TBA,TOR,4,1,4-1,TBA,9,1,33,34,67,120,133,253,11,7,18,3,2:41
10872,530406,2018-06-12,2018,SLN,SDN,2,4,4-2,SDN,9,0,32,34,66,117,113,230,6,7,13,0,2:25
10873,530401,2018-06-12,2018,OAK,HOU,3,6,6-3,HOU,9,0,39,42,81,138,134,272,12,17,29,2,2:57
10874,530404,2018-06-12,2018,ATL,NYN,8,2,8-2,ATL,9,1,37,33,70,135,136,271,15,6,21,2,2:45
10875,530398,2018-06-12,2018,KCA,CIN,1,5,5-1,CIN,10,0,36,43,79,150,128,278,6,15,21,0,2:58
10876,530402,2018-06-12,2018,SEA,ANA,6,3,6-3,SEA,9,1,36,38,74,152,135,287,15,10,25,2,3:01
10877,530400,2018-06-12,2018,PHI,COL,5,4,5-4,PHI,9,1,33,39,72,156,134,290,9,12,21,2,3:07
10878,530399,2018-06-12,2018,CHA,CLE,5,1,5-1,CHA,9,1,36,34,70,139,139,278,13,7,20,4,2:57
10879,530410,2018-06-12,2018,NYA,WAS,3,0,3-0,NYA,9,1,33,36,69,154,135,289,10,10,20,1,2:48
10880,530403,2018-06-12,2018,DET,MIN,4,6,6-4,MIN,9,0,41,36,77,163,173,336,13,10,23,4,3:24
10881,530407,2018-06-12,2018,MIA,SFN,3,1,3-1,MIA,9,1,33,30,63,138,127,265,11,6,17,1,2:35
10882,530408,2018-06-12,2018,LAN,TEX,12,5,12-5,LAN,9,1,42,40,82,148,169,317,20,14,34,1,3:08
10883,530396,2018-06-12,2018,BAL,BOS,4,6,6-4,BOS,9,0,44,43,87,163,199,362,17,21,38,3,3:58
10884,530405,2018-06-12,2018,ARI,PIT,13,8,13-8,ARI,9,1,41,43,84,169,192,361,18,17,35,3,3:56
10885,530397,2018-06-12,2018,MIL,CHN,4,0,4-0,MIL,9,1,34,30,64,140,150,290,10,4,14,0,2:49
10886,530414,2018-06-13,2018,CHA,CLE,3,2,3-2,CHA,9,1,30,38,68,115,122,237,6,14,20,2,2:31
10887,530419,2018-06-13,2018,ATL,NYN,2,0,2-0,ATL,9,1,31,31,62,118,103,221,8,5,13,1,2:12
10888,530413,2018-06-13,2018,KCA,CIN,0,7,7-0,CIN,9,0,33,38,71,119,128,247,8,10,18,5,2:41
10889,530412,2018-06-13,2018,MIL,CHN,1,0,1-0,MIL,9,1,29,36,65,149,118,267,6,9,15,3,2:54
10890,530421,2018-06-13,2018,SLN,SDN,2,4,4-2,SDN,9,0,34,37,71,128,132,260,9,11,20,3,2:45
10891,530425,2018-06-13,2018,NYA,WAS,4,5,5-4,WAS,9,0,36,34,70,156,151,307,10,12,22,1,3:18
10892,530418,2018-06-13,2018,DET,MIN,5,2,5-2,DET,9,1,38,35,73,169,135,304,14,8,22,1,3:08
10893,530422,2018-06-13,2018,MIA,SFN,5,4,5-4,MIA,9,0,38,42,80,160,144,304,15,16,31,4,3:13
10894,530411,2018-06-13,2018,BAL,BOS,1,5,5-1,BOS,9,0,37,39,76,175,155,330,10,14,24,4,3:20
10895,530415,2018-06-13,2018,PHI,COL,2,7,7-2,COL,9,0,35,41,76,150,139,289,8,15,23,0,2:55
10896,530420,2018-06-13,2018,ARI,PIT,4,5,5-4,PIT,9,0,39,37,76,153,159,312,14,11,25,1,3:07
10897,530416,2018-06-13,2018,OAK,HOU,5,13,13-5,HOU,9,0,36,48,84,190,138,328,9,22,31,1,3:04
10898,530417,2018-06-13,2018,SEA,ANA,8,6,8-6,SEA,9,0,39,42,81,171,156,327,16,19,35,2,3:35
10899,530423,2018-06-13,2018,LAN,TEX,3,2,3-2,LAN,11,0,44,46,90,176,176,352,16,16,32,1,3:49
10900,530424,2018-06-13,2018,TBA,TOR,1,0,1-0,TBA,9,0,37,35,72,139,159,298,10,9,19,2,3:00
10901,530430,2018-06-14,2018,DET,MIN,3,1,3-1,DET,9,1,32,34,66,121,127,248,8,7,15,1,2:32
10902,530429,2018-06-14,2018,OAK,HOU,3,7,7-3,HOU,9,0,33,42,75,137,121,258,6,17,23,1,2:45
10903,530432,2018-06-14,2018,ATL,SDN,4,2,4-2,ATL,9,1,33,34,67,117,119,236,10,8,18,1,2:26
10904,530426,2018-06-14,2018,SEA,BOS,1,2,2-1,BOS,9,0,33,36,69,135,134,269,9,10,19,0,2:56
10905,530427,2018-06-14,2018,CHA,CLE,2,5,5-2,CLE,9,0,35,40,75,175,136,311,8,12,20,1,2:52
10906,530431,2018-06-14,2018,ARI,NYN,6,3,6-3,ARI,9,1,35,32,67,138,130,268,14,6,20,2,2:38
10907,530428,2018-06-14,2018,PHI,COL,9,3,9-3,PHI,9,1,39,31,70,139,169,308,16,5,21,3,3:21
10908,530434,2018-06-14,2018,NYA,TBA,4,3,4-3,NYA,9,1,33,34,67,139,149,288,10,9,19,0,2:49
10909,530433,2018-06-14,2018,MIA,SFN,3,6,6-3,SFN,16,0,62,63,125,260,218,478,18,21,39,3,4:49
10910,530443,2018-06-15,2018,CLE,MIN,3,6,6-3,MIN,9,0,37,34,71,126,142,268,11,7,18,2,2:42
10911,530448,2018-06-15,2018,NYA,TBA,5,0,5-0,NYA,9,1,34,33,67,150,112,262,11,9,20,1,2:44
10912,530437,2018-06-15,2018,PIT,CIN,3,2,3-2,PIT,9,1,32,39,71,137,144,281,10,11,21,2,2:53
10913,530447,2018-06-15,2018,LAN,SFN,3,2,3-2,LAN,9,1,34,31,65,118,153,271,9,4,13,2,2:53
10914,530440,2018-06-15,2018,KCA,HOU,3,7,7-3,HOU,9,0,35,38,73,151,134,285,9,14,23,1,2:49
10915,530446,2018-06-15,2018,ATL,SDN,3,9,9-3,SDN,9,0,37,42,79,140,130,270,9,19,28,2,2:50
10916,530441,2018-06-15,2018,OAK,ANA,4,8,8-4,ANA,9,0,38,43,81,177,154,331,13,15,28,0,3:22
10917,530439,2018-06-15,2018,CHA,DET,3,4,4-3,DET,9,0,40,40,80,160,128,288,16,13,29,4,3:23
10918,530442,2018-06-15,2018,BAL,MIA,0,2,2-0,MIA,9,0,30,39,69,158,126,284,5,12,17,2,2:43
10919,530438,2018-06-15,2018,TEX,COL,5,9,9-5,COL,9,0,36,42,78,179,163,342,12,16,28,1,3:15
10920,530436,2018-06-15,2018,SLN,CHN,5,13,13-5,CHN,9,0,38,46,84,177,161,338,12,20,32,2,3:29
10921,530449,2018-06-15,2018,TOR,WAS,6,5,6-5,TOR,9,1,35,38,73,147,129,276,12,12,24,2,2:35
10922,530435,2018-06-15,2018,SEA,BOS,7,6,7-6,SEA,9,1,37,43,80,169,145,314,13,16,29,1,3:09
10923,530444,2018-06-15,2018,ARI,NYN,7,3,7-3,ARI,9,1,39,37,76,146,166,312,16,11,27,3,3:20
10924,530445,2018-06-15,2018,MIL,PHI,13,2,13-2,MIL,9,1,44,35,79,144,166,310,18,11,29,1,2:51
10925,530461,2018-06-16,2018,ATL,SDN,1,0,1-0,ATL,9,1,29,33,62,137,107,244,5,6,11,0,2:19 (:25 delay)
10926,530463,2018-06-16,2018,NYA,TBA,4,1,4-1,NYA,9,1,35,32,67,124,147,271,11,7,18,2,2:47
10927,530462,2018-06-16,2018,LAN,SFN,3,1,3-1,LAN,9,1,33,35,68,134,134,268,11,8,19,1,2:50
10928,530456,2018-06-16,2018,OAK,ANA,6,4,6-4,OAK,9,1,36,35,71,136,148,284,12,9,21,1,2:42
10929,530458,2018-06-16,2018,CLE,MIN,3,9,9-3,MIN,9,0,38,43,81,143,130,273,12,18,30,3,2:55
10930,530455,2018-06-16,2018,KCA,HOU,2,10,10-2,HOU,9,0,36,40,76,150,149,299,9,14,23,0,2:46
10931,530454,2018-06-16,2018,CHA,DET,5,7,7-5,DET,9,0,36,42,78,150,147,297,9,15,24,3,3:03
10932,530459,2018-06-16,2018,ARI,NYN,1,5,5-1,NYN,9,0,36,40,76,148,141,289,8,15,23,1,2:56
10933,530464,2018-06-16,2018,TOR,WAS,2,0,2-0,TOR,9,1,30,33,63,140,131,271,6,6,12,2,2:34
10934,530452,2018-06-16,2018,PIT,CIN,6,2,6-2,PIT,9,1,36,39,75,146,129,275,14,12,26,0,2:44
10935,530450,2018-06-16,2018,SEA,BOS,1,0,1-0,SEA,9,1,31,28,59,115,120,235,8,2,10,1,2:22
10936,530451,2018-06-16,2018,SLN,CHN,3,6,6-3,CHN,9,0,38,46,84,147,154,301,13,20,33,3,3:23
10937,530457,2018-06-16,2018,BAL,MIA,4,5,5-4,MIA,9,0,39,36,75,128,153,281,14,10,24,1,2:41
10938,530453,2018-06-16,2018,TEX,COL,5,2,5-2,TEX,9,1,34,35,69,133,134,267,12,8,20,1,2:42
10939,530460,2018-06-16,2018,MIL,PHI,1,4,4-1,PHI,9,0,32,46,78,187,133,320,7,20,27,2,3:32
10940,530469,2018-06-17,2018,CHA,DET,1,3,3-1,DET,9,0,36,36,72,149,138,287,10,11,21,4,2:59
10941,530470,2018-06-17,2018,KCA,HOU,4,7,7-4,HOU,9,0,36,41,77,118,133,251,10,18,28,2,2:46
10942,530473,2018-06-17,2018,CLE,MIN,4,1,4-1,CLE,9,1,35,38,73,134,154,288,11,13,24,2,3:03
10943,530476,2018-06-17,2018,ATL,SDN,4,1,4-1,ATL,9,1,33,36,69,166,132,298,8,10,18,2,3:10
10944,530477,2018-06-17,2018,LAN,SFN,1,4,4-1,SFN,9,0,31,37,68,155,137,292,5,10,15,3,2:54
10945,530465,2018-06-17,2018,SEA,BOS,3,9,9-3,BOS,9,0,38,42,80,152,160,312,11,16,27,2,3:15
10946,530466,2018-06-17,2018,SLN,CHN,5,0,5-0,SLN,9,1,36,35,71,147,161,308,14,9,23,2,3:24
10947,530474,2018-06-17,2018,ARI,NYN,3,5,5-3,NYN,9,0,37,40,77,177,145,322,11,14,25,2,3:27
10948,530478,2018-06-17,2018,NYA,TBA,1,3,3-1,TBA,9,0,37,38,75,118,141,259,11,13,24,3,2:45
10949,530479,2018-06-17,2018,TOR,WAS,8,6,8-6,TOR,9,1,41,41,82,161,170,331,18,16,34,3,3:30
10950,530467,2018-06-17,2018,PIT,CIN,6,8,8-6,CIN,9,0,39,41,80,137,161,298,13,16,29,4,3:15
10951,530471,2018-06-17,2018,OAK,ANA,6,5,6-5,OAK,11,0,43,46,89,157,167,324,13,15,28,4,3:38
10952,530475,2018-06-17,2018,MIL,PHI,9,10,10-9,PHI,9,0,47,43,90,159,180,339,21,19,40,7,4:02
10953,530472,2018-06-17,2018,BAL,MIA,10,4,10-4,BAL,9,1,40,40,80,138,168,306,16,13,29,4,3:11
10954,530468,2018-06-17,2018,TEX,COL,13,12,13-12,TEX,9,0,44,44,88,173,196,369,19,18,37,6,3:54
10955,530046,2018-06-18,2018,WAS,NYA,2,4,4-2,NYA,9,0,38,41,79,160,162,322,11,17,28,4,3:26
10956,530487,2018-06-18,2018,HOU,TBA,5,4,5-4,HOU,9,0,38,35,73,141,129,270,12,9,21,4,2:57
10957,530484,2018-06-18,2018,PIT,MIL,1,0,1-0,PIT,9,1,31,32,63,126,98,224,10,5,15,1,2:32
10958,530488,2018-06-18,2018,KCA,TEX,3,6,6-3,TEX,9,0,36,41,77,161,129,290,10,17,27,1,3:04
10959,530480,2018-06-18,2018,ANA,ARI,4,7,7-4,ARI,9,0,40,41,81,160,156,316,15,13,28,3,3:21
10960,530485,2018-06-18,2018,COL,NYN,2,12,12-2,NYN,9,0,33,47,80,180,122,302,7,22,29,3,3:10
10961,530481,2018-06-18,2018,CLE,CHA,6,2,6-2,CLE,9,1,41,35,76,142,162,304,18,9,27,2,3:02 (:35 delay)
10962,530486,2018-06-18,2018,PHI,SLN,6,5,6-5,PHI,10,0,42,42,84,168,175,343,14,10,24,2,3:39
10963,530046,2018-06-18,2018,WAS,NYA,2,4,4-2,NYA,9,0,38,41,79,160,162,322,11,17,28,4,3:26
10964,530483,2018-06-18,2018,SFN,MIA,4,5,5-4,MIA,9,0,37,36,73,127,146,273,10,11,21,2,2:47
10965,530489,2018-06-19,2018,ANA,ARI,5,4,5-4,ANA,9,1,37,39,76,167,121,288,13,12,25,2,3:11
10966,530499,2018-06-19,2018,SDN,OAK,2,4,4-2,OAK,10,0,39,40,79,168,166,334,9,12,21,1,3:21
10967,530497,2018-06-19,2018,PIT,MIL,2,3,3-2,MIL,9,0,35,36,71,161,175,336,7,10,17,1,3:17
10968,530496,2018-06-19,2018,SFN,MIA,6,3,6-3,SFN,9,1,40,38,78,147,147,294,19,12,31,3,2:51
10969,530482,2018-06-19,2018,CHN,LAN,3,4,4-3,LAN,9,0,43,42,85,181,164,345,18,15,33,6,3:46
10970,530490,2018-06-19,2018,TOR,ATL,4,11,11-4,ATL,9,0,37,48,85,164,129,293,10,21,31,4,3:03
10971,530494,2018-06-19,2018,CIN,DET,9,5,9-5,CIN,9,1,45,41,86,177,178,355,21,16,37,3,3:32
10972,530495,2018-06-19,2018,CHN,LAN,2,1,2-1,CHN,10,0,39,44,83,172,131,303,14,17,31,2,3:19
10973,530491,2018-06-19,2018,WAS,BAL,9,7,9-7,WAS,9,1,41,38,79,141,149,290,20,13,33,2,2:59
10974,530482,2018-06-19,2018,CHN,LAN,3,4,4-3,LAN,9,0,43,42,85,181,164,345,18,15,33,6,3:46
10975,530500,2018-06-19,2018,NYA,SEA,7,2,7-2,NYA,9,1,35,30,65,124,127,251,12,2,14,1,2:28
10976,530501,2018-06-19,2018,PHI,SLN,6,7,7-6,SLN,9,0,42,38,80,136,154,290,15,12,27,2,3:16
10977,530503,2018-06-19,2018,KCA,TEX,1,4,4-1,TEX,9,0,33,41,74,139,133,272,7,17,24,1,2:46
10978,530493,2018-06-19,2018,CLE,CHA,6,3,6-3,CLE,9,1,36,39,75,145,129,274,15,10,25,3,2:46
10979,530492,2018-06-19,2018,MIN,BOS,6,2,6-2,MIN,9,1,33,40,73,155,142,297,10,13,23,3,3:14
10980,530502,2018-06-19,2018,HOU,TBA,1,2,2-1,TBA,9,0,36,37,73,163,138,301,13,10,23,3,3:19
10981,530498,2018-06-19,2018,COL,NYN,10,8,10-8,COL,9,1,42,39,81,157,153,310,21,13,34,3,3:06 (1:20 delay)
10982,530516,2018-06-20,2018,HOU,TBA,5,1,5-1,HOU,9,1,34,36,70,129,127,256,12,10,22,0,2:32
10983,530509,2018-06-20,2018,CHN,LAN,4,0,4-0,CHN,9,1,35,34,69,137,115,252,14,9,23,2,2:46
10984,530517,2018-06-20,2018,KCA,TEX,2,3,3-2,TEX,9,0,33,40,73,150,127,277,9,14,23,2,2:53
10985,530510,2018-06-20,2018,SFN,MIA,6,5,6-5,SFN,9,1,36,40,76,157,142,299,14,15,29,3,3:04
10986,530515,2018-06-20,2018,PHI,SLN,4,3,4-3,PHI,9,1,36,38,74,149,139,288,11,12,23,3,3:08
10987,530507,2018-06-20,2018,CLE,CHA,12,0,12-0,CLE,9,1,45,32,77,130,176,306,23,5,28,1,3:06
10988,530514,2018-06-20,2018,NYA,SEA,7,5,7-5,NYA,9,0,40,40,80,172,160,332,15,14,29,3,3:28
10989,530506,2018-06-20,2018,MIN,BOS,4,1,4-1,MIN,9,1,33,35,68,155,140,295,10,9,19,0,3:13
10990,530505,2018-06-20,2018,WAS,BAL,0,3,3-0,BAL,9,0,36,34,70,116,154,270,9,8,17,1,2:34 (2:43 delay)
10991,530513,2018-06-20,2018,SDN,OAK,4,12,12-4,OAK,9,0,39,47,86,195,148,343,13,20,33,2,3:04
10992,530504,2018-06-20,2018,TOR,ATL,5,4,5-4,TOR,9,1,36,35,71,129,142,271,13,8,21,2,2:30
10993,530512,2018-06-20,2018,COL,NYN,10,8,10-8,COL,9,1,41,47,88,182,160,342,17,23,40,2,3:25
10994,530508,2018-06-20,2018,CIN,DET,5,3,5-3,CIN,9,1,38,39,77,139,146,285,15,13,28,4,3:04
10995,530519,2018-06-21,2018,WAS,BAL,4,2,4-2,WAS,9,1,33,33,66,129,145,274,12,6,18,0,2:42
10996,530524,2018-06-21,2018,SFN,SDN,3,0,3-0,SFN,9,1,33,33,66,114,132,246,11,7,18,1,2:23
10997,530518,2018-06-21,2018,PIT,ARI,3,9,9-3,ARI,9,0,37,44,81,163,147,310,12,16,28,2,3:11
10998,530526,2018-06-21,2018,MIL,SLN,11,3,11-3,MIL,9,1,42,36,78,133,170,303,16,10,26,0,2:49
10999,530522,2018-06-21,2018,COL,NYN,6,4,6-4,COL,9,1,37,37,74,164,139,303,14,15,29,5,2:55
11000,530521,2018-06-21,2018,CIN,CHN,6,2,6-2,CIN,9,1,34,39,73,156,125,281,12,13,25,3,3:07
11001,530527,2018-06-21,2018,ANA,TOR,8,5,8-5,ANA,9,1,38,36,74,154,151,305,16,10,26,2,3:03
11002,530525,2018-06-21,2018,NYA,SEA,4,3,4-3,NYA,9,1,36,37,73,164,150,314,12,13,25,1,2:51
11003,530520,2018-06-21,2018,MIN,BOS,2,9,9-2,BOS,9,0,32,47,79,182,124,306,6,21,27,1,2:58
11004,530542,2018-06-22,2018,ANA,TOR,2,1,2-1,ANA,9,1,28,36,64,121,105,226,5,9,14,0,2:17
11005,530530,2018-06-22,2018,CIN,CHN,6,3,6-3,CIN,9,1,38,33,71,125,130,255,16,6,22,1,2:39
11006,530540,2018-06-22,2018,MIL,SLN,2,1,2-1,MIL,9,0,32,36,68,162,140,302,7,8,15,1,3:19
11007,530531,2018-06-22,2018,CLE,DET,10,0,10-0,CLE,9,1,40,32,72,119,153,272,15,6,21,1,2:43 (1:41 delay)
11008,530536,2018-06-22,2018,CHA,OAK,2,11,11-2,OAK,9,0,36,42,78,165,149,314,9,13,22,3,3:04
11009,530523,2018-06-22,2018,CHA,OAK,6,4,6-4,CHA,9,1,37,37,74,132,125,257,12,11,23,4,2:47
11010,530541,2018-06-22,2018,MIN,TEX,1,8,8-1,TEX,9,0,30,41,71,158,141,299,5,16,21,0,3:01
11011,530534,2018-06-22,2018,COL,MIA,11,3,11-3,COL,9,1,43,39,82,138,147,285,20,11,31,0,2:55
11012,530538,2018-06-22,2018,SFN,SDN,2,6,6-2,SDN,9,0,33,40,73,149,129,278,6,16,22,4,2:53
11013,530539,2018-06-22,2018,BOS,SEA,14,10,14-10,BOS,9,1,46,42,88,140,175,315,23,17,40,4,3:34
11014,530523,2018-06-22,2018,CHA,OAK,6,4,6-4,CHA,9,1,37,37,74,132,125,257,12,11,23,4,2:47
11015,530537,2018-06-22,2018,WAS,PHI,2,12,12-2,PHI,9,0,36,49,85,226,143,369,10,23,33,2,3:30
11016,530535,2018-06-22,2018,TBA,NYA,2,1,2-1,TBA,9,1,37,37,74,153,142,295,15,11,26,3,3:08
11017,530533,2018-06-22,2018,NYN,LAN,2,5,5-2,LAN,9,0,36,35,71,134,127,261,9,9,18,1,2:40
11018,530528,2018-06-22,2018,PIT,ARI,1,2,2-1,ARI,13,0,49,50,99,185,192,377,11,11,22,0,3:51
11019,530532,2018-06-22,2018,HOU,KCA,0,1,1-0,KCA,9,0,36,40,76,156,154,310,10,14,24,0,3:09
11020,530529,2018-06-22,2018,ATL,BAL,7,10,10-7,BAL,15,0,65,62,127,252,248,500,24,22,46,4,5:21 (:11 delay)
11021,530543,2018-06-23,2018,PIT,ARI,2,7,7-2,ARI,9,0,35,41,76,144,142,286,8,16,24,1,2:52 (1:21 delay)
11022,530550,2018-06-23,2018,TBA,NYA,4,0,4-0,TBA,9,1,36,31,67,126,141,267,12,6,18,3,2:39
11023,530549,2018-06-23,2018,COL,MIA,2,6,6-2,MIA,9,0,32,40,72,142,122,264,6,13,19,2,2:47
11024,530557,2018-06-23,2018,ANA,TOR,1,4,4-1,TOR,9,0,35,38,73,154,134,288,10,15,25,3,3:07
11025,530546,2018-06-23,2018,CLE,DET,4,1,4-1,CLE,9,1,32,36,68,149,134,283,9,10,19,1,2:51
11026,530548,2018-06-23,2018,NYN,LAN,3,8,8-3,LAN,9,0,38,43,81,165,143,308,12,16,28,0,3:01
11027,530553,2018-06-23,2018,SFN,SDN,5,3,5-3,SFN,9,1,35,36,71,125,133,258,11,14,25,4,2:36
11028,530551,2018-06-23,2018,CHA,OAK,6,7,7-6,OAK,9,0,40,40,80,182,139,321,12,15,27,4,3:28
11029,530552,2018-06-23,2018,WAS,PHI,3,5,5-3,PHI,9,0,35,38,73,144,138,282,9,15,24,1,3:03
11030,530555,2018-06-23,2018,MIL,SLN,2,3,3-2,SLN,9,0,35,35,70,148,140,288,11,9,20,2,2:55
11031,530554,2018-06-23,2018,BOS,SEA,2,7,7-2,SEA,9,0,35,46,81,173,117,290,8,19,27,0,3:01
11032,530556,2018-06-23,2018,MIN,TEX,6,9,9-6,TEX,9,0,41,42,83,189,175,364,15,15,30,3,3:35
11033,530547,2018-06-23,2018,HOU,KCA,4,3,4-3,HOU,12,0,49,42,91,186,187,373,17,7,24,1,3:55
11034,530544,2018-06-23,2018,ATL,BAL,5,7,7-5,BAL,9,0,44,37,81,149,161,310,18,10,28,3,3:08 (:20 delay)
11035,530545,2018-06-23,2018,CIN,CHN,11,2,11-2,CIN,9,1,40,36,76,135,161,296,18,11,29,4,2:58
11036,530558,2018-06-24,2018,PIT,ARI,0,3,3-0,ARI,9,0,30,33,63,114,107,221,5,7,12,1,2:32 (:30 delay)
11037,530569,2018-06-24,2018,BOS,SEA,5,0,5-0,BOS,9,1,32,31,63,117,128,245,8,5,13,0,2:29
11038,530571,2018-06-24,2018,MIN,TEX,2,0,2-0,MIN,9,1,32,31,63,132,104,236,9,4,13,0,2:21
11039,530559,2018-06-24,2018,ATL,BAL,7,3,7-3,ATL,9,1,37,33,70,120,153,273,14,8,22,0,2:54
11040,530560,2018-06-24,2018,CIN,CHN,8,6,8-6,CIN,9,1,40,37,77,120,129,249,18,11,29,2,2:44
11041,530570,2018-06-24,2018,MIL,SLN,2,8,8-2,SLN,9,0,36,45,81,166,144,310,8,18,26,2,3:14
11042,530564,2018-06-24,2018,COL,MIA,5,8,8-5,MIA,9,0,35,44,79,163,135,298,8,17,25,3,3:14 (1:31 delay)
11043,530566,2018-06-24,2018,CHA,OAK,10,3,10-3,CHA,9,1,36,35,71,129,136,265,14,10,24,2,2:42
11044,530561,2018-06-24,2018,CLE,DET,12,2,12-2,CLE,9,1,44,33,77,116,146,262,23,6,29,3,2:55
11045,530572,2018-06-24,2018,ANA,TOR,6,7,7-6,TOR,10,0,42,45,87,167,149,316,11,14,25,3,3:33
11046,530567,2018-06-24,2018,WAS,PHI,8,6,8-6,WAS,9,1,43,39,82,177,163,340,22,15,37,4,3:47 (:38 delay)
11047,530568,2018-06-24,2018,SFN,SDN,3,2,3-2,SFN,11,0,42,41,83,155,167,322,13,9,22,1,3:02
11048,530563,2018-06-24,2018,NYN,LAN,7,8,8-7,LAN,11,0,48,46,94,186,186,372,16,15,31,2,3:50
11049,530562,2018-06-24,2018,HOU,KCA,11,3,11-3,HOU,9,1,41,38,79,178,148,326,16,10,26,0,3:04
11050,530565,2018-06-24,2018,TBA,NYA,7,6,7-6,TBA,12,0,48,50,98,202,182,384,15,17,32,5,4:16
11051,529632,2018-06-25,2018,KCA,ANA,2,0,2-0,KCA,9,1,31,32,63,141,130,271,12,6,18,1,2:44
11052,530574,2018-06-25,2018,LAN,CHN,2,1,2-1,LAN,9,1,30,33,63,110,118,228,8,8,16,2,2:32
11053,530583,2018-06-25,2018,TBA,WAS,11,0,11-0,TBA,9,1,43,32,75,133,177,310,18,6,24,1,2:51
11054,530577,2018-06-25,2018,PHI,NYA,2,4,4-2,NYA,9,0,35,39,74,150,154,304,8,13,21,4,3:20
11055,530581,2018-06-25,2018,BAL,SEA,3,5,5-3,SEA,9,0,35,43,78,168,120,288,8,18,26,3,3:02
11056,530578,2018-06-25,2018,DET,OAK,4,5,5-4,OAK,9,0,39,42,81,166,133,299,10,16,26,4,3:17
11057,529632,2018-06-25,2018,KCA,ANA,2,0,2-0,KCA,9,1,31,32,63,141,130,271,12,6,18,1,2:44
11058,530582,2018-06-25,2018,HOU,TOR,3,6,6-3,TOR,9,0,39,39,78,159,159,318,12,12,24,1,3:10
11059,530580,2018-06-25,2018,TEX,SDN,7,4,7-4,TEX,9,1,40,37,77,135,163,298,16,12,28,4,3:14
11060,530579,2018-06-25,2018,NYN,PIT,4,6,6-4,PIT,9,0,38,42,80,170,158,328,12,14,26,2,3:27
11061,530575,2018-06-25,2018,ATL,CIN,5,4,5-4,ATL,11,0,47,47,94,188,165,353,18,15,33,3,3:45 (1:20 delay)
11062,530573,2018-06-25,2018,MIA,ARI,9,5,9-5,MIA,9,1,39,37,76,144,161,305,15,8,23,3,3:14
11063,530576,2018-06-25,2018,SLN,CLE,4,0,4-0,SLN,9,1,35,35,70,129,145,274,13,10,23,1,2:48 (1:21 delay)
11064,530597,2018-06-26,2018,HOU,TOR,7,0,7-0,HOU,9,1,40,34,74,131,143,274,17,8,25,1,2:42
11065,530598,2018-06-26,2018,TBA,WAS,1,0,1-0,TBA,9,1,33,34,67,149,124,273,9,8,17,3,2:45
11066,530591,2018-06-26,2018,CHA,MIN,8,4,8-4,CHA,9,1,42,33,75,133,165,298,17,7,24,6,3:16 (1:48 delay)
11067,530588,2018-06-26,2018,SFN,COL,3,2,3-2,SFN,9,1,38,37,75,133,144,277,17,12,29,3,2:57
11068,530586,2018-06-26,2018,ATL,CIN,3,5,5-3,CIN,9,0,38,42,80,145,130,275,14,16,30,4,3:20
11069,530596,2018-06-26,2018,BAL,SEA,2,3,3-2,SEA,9,0,33,36,69,152,120,272,9,11,20,2,2:41
11070,530592,2018-06-26,2018,PHI,NYA,0,6,6-0,NYA,9,0,33,40,73,128,141,269,7,13,20,0,2:38
11071,530590,2018-06-26,2018,BOS,ANA,9,1,9-1,BOS,9,1,42,34,76,143,133,276,19,7,26,2,2:54
11072,530595,2018-06-26,2018,TEX,SDN,2,3,3-2,SDN,9,0,39,37,76,157,150,307,12,12,24,1,3:07
11073,530585,2018-06-26,2018,LAN,CHN,4,9,9-4,CHN,9,0,35,47,82,178,159,337,9,20,29,3,3:26
11074,530589,2018-06-26,2018,MIL,KCA,5,1,5-1,MIL,9,1,37,33,70,149,138,287,13,6,19,1,2:41
11075,530587,2018-06-26,2018,SLN,CLE,11,2,11-2,SLN,9,1,40,34,74,138,151,289,15,7,22,1,2:53 (1:26 delay)
11076,530593,2018-06-26,2018,DET,OAK,7,9,9-7,OAK,9,0,45,44,89,180,181,361,20,17,37,3,3:47
11077,530594,2018-06-26,2018,NYN,PIT,4,3,4-3,NYN,10,0,41,40,81,158,174,332,12,11,23,1,3:20
11078,530584,2018-06-26,2018,MIA,ARI,3,5,5-3,ARI,9,0,42,43,85,161,163,324,15,17,32,1,3:24
11079,530603,2018-06-27,2018,SFN,COL,1,0,1-0,SFN,9,0,33,31,64,120,129,249,7,4,11,2,2:34
11080,530609,2018-06-27,2018,NYN,PIT,3,5,5-3,PIT,9,0,34,40,74,157,126,283,8,14,22,2,3:03
11081,530607,2018-06-27,2018,PHI,NYA,3,0,3-0,PHI,9,1,34,32,66,117,150,267,10,6,16,0,2:43
11082,530604,2018-06-27,2018,MIL,KCA,4,5,5-4,KCA,9,0,38,37,75,127,152,279,13,11,24,3,2:48
11083,530606,2018-06-27,2018,CHA,MIN,6,1,6-1,CHA,9,1,35,36,71,152,130,282,13,9,22,1,2:56
11084,530600,2018-06-27,2018,LAN,CHN,7,5,7-5,LAN,9,1,44,37,81,120,181,301,21,11,32,3,3:08
11085,530611,2018-06-27,2018,BAL,SEA,7,8,8-7,SEA,11,0,45,51,96,180,135,315,13,19,32,3,3:39
11086,530601,2018-06-27,2018,ATL,CIN,5,6,6-5,CIN,9,0,37,41,78,162,136,298,11,15,26,4,3:01
11087,530612,2018-06-27,2018,HOU,TOR,7,6,7-6,HOU,9,0,38,39,77,147,145,292,13,13,26,1,2:55
11088,530608,2018-06-27,2018,DET,OAK,0,3,3-0,OAK,9,0,34,40,74,166,143,309,8,12,20,0,3:11
11089,530610,2018-06-27,2018,TEX,SDN,5,2,5-2,TEX,9,1,40,33,73,124,125,249,17,6,23,2,2:24
11090,530602,2018-06-27,2018,SLN,CLE,1,5,5-1,CLE,9,0,36,40,76,157,132,289,9,13,22,1,2:56
11091,530599,2018-06-27,2018,MIA,ARI,1,2,2-1,ARI,9,0,32,34,66,136,132,268,6,8,14,1,2:52
11092,530605,2018-06-27,2018,BOS,ANA,9,6,9-6,BOS,9,1,41,44,85,179,170,349,17,15,32,5,4:00
11093,530618,2018-06-28,2018,CIN,MIL,4,6,6-4,MIL,9,0,38,37,75,122,149,271,11,10,21,2,3:01
11094,530613,2018-06-28,2018,MIA,ARI,0,4,4-0,ARI,9,0,37,38,75,142,134,276,11,15,26,2,3:06
11095,530622,2018-06-28,2018,PHI,WAS,4,3,4-3,PHI,9,1,36,36,72,135,140,275,15,9,24,3,3:09
11096,530620,2018-06-28,2018,DET,OAK,2,4,4-2,OAK,9,0,33,36,69,119,127,246,7,10,17,0,2:29
11097,530617,2018-06-28,2018,BOS,ANA,4,2,4-2,BOS,9,1,33,38,71,155,138,293,12,11,23,1,3:06
11098,530616,2018-06-28,2018,TBA,HOU,0,1,1-0,HOU,9,0,34,37,71,151,132,283,9,13,22,1,2:53
11099,530614,2018-06-28,2018,LAN,CHN,5,11,11-5,CHN,9,0,42,43,85,155,141,296,15,17,32,3,3:03
11100,530621,2018-06-28,2018,BAL,SEA,2,4,4-2,SEA,10,0,38,43,81,140,148,288,10,13,23,2,3:04
11101,530615,2018-06-28,2018,SFN,COL,8,9,9-8,COL,9,0,43,39,82,138,150,288,17,15,32,2,3:10
11102,530619,2018-06-28,2018,CHA,MIN,1,2,2-1,MIN,13,0,53,54,107,207,222,429,17,17,34,3,4:51
11103,530628,2018-06-29,2018,TOR,DET,3,2,3-2,TOR,9,1,34,31,65,125,136,261,14,5,19,0,2:33
11104,530631,2018-06-29,2018,BAL,ANA,1,7,7-1,ANA,9,0,32,42,74,143,129,272,8,17,25,3,2:53
11105,530632,2018-06-29,2018,CIN,MIL,2,8,8-2,MIL,9,0,33,44,77,159,133,292,8,18,26,1,3:04
11106,530627,2018-06-29,2018,LAN,COL,1,3,3-1,COL,9,0,31,36,67,150,111,261,6,11,17,1,2:39
11107,530629,2018-06-29,2018,TBA,HOU,3,2,3-2,TBA,9,1,35,32,67,126,135,261,10,5,15,2,2:35
11108,530633,2018-06-29,2018,CHN,MIN,10,6,10-6,CHN,9,1,42,42,84,153,141,294,19,16,35,3,3:27
11109,530630,2018-06-29,2018,SEA,KCA,4,1,4-1,SEA,9,1,34,31,65,96,140,236,10,7,17,0,2:26
11110,530634,2018-06-29,2018,MIA,NYN,8,2,8-2,MIA,9,1,35,39,74,170,129,299,13,16,29,3,2:57
11111,530635,2018-06-29,2018,SDN,PIT,3,6,6-3,PIT,9,0,40,38,78,143,137,280,14,12,26,2,3:02
11112,530626,2018-06-29,2018,OAK,CLE,3,1,3-1,OAK,9,1,33,34,67,144,131,275,11,9,20,5,2:50
11113,530624,2018-06-29,2018,NYA,BOS,8,1,8-1,NYA,9,1,35,34,69,125,137,262,13,8,21,0,2:41
11114,530625,2018-06-29,2018,TEX,CHA,11,3,11-3,TEX,9,1,41,33,74,109,161,270,15,6,21,3,2:47
11115,530636,2018-06-29,2018,ARI,SFN,1,2,2-1,SFN,9,0,36,34,70,147,133,280,9,8,17,2,2:49
11116,530623,2018-06-29,2018,SLN,ATL,1,5,5-1,ATL,9,0,35,43,78,155,139,294,8,16,24,5,3:14
11117,530637,2018-06-29,2018,PHI,WAS,7,17,17-7,WAS,9,0,40,52,92,213,173,386,15,25,40,4,3:43
11118,530642,2018-06-30,2018,LAN,COL,1,3,3-1,COL,9,0,30,35,65,125,107,232,3,8,11,1,2:39
11119,530645,2018-06-30,2018,SEA,KCA,6,4,6-4,SEA,9,1,37,39,76,141,117,258,14,11,25,0,2:38
11120,530643,2018-06-30,2018,TOR,DET,4,3,4-3,TOR,9,0,32,36,68,129,125,254,10,10,20,1,2:38
11121,530652,2018-06-30,2018,PHI,WAS,3,2,3-2,PHI,9,1,34,37,71,153,146,299,10,12,22,2,3:20
11122,530644,2018-06-30,2018,TBA,HOU,5,2,5-2,TBA,9,1,36,34,70,120,136,256,13,6,19,1,2:39
11123,530646,2018-06-30,2018,BAL,ANA,2,6,6-2,ANA,9,0,36,40,76,165,132,297,8,15,23,3,3:09
11124,530641,2018-06-30,2018,OAK,CLE,7,2,7-2,OAK,9,1,34,32,66,136,143,279,11,6,17,5,2:50
11125,530651,2018-06-30,2018,ARI,SFN,0,7,7-0,SFN,9,0,34,42,76,159,139,298,9,15,24,1,2:51
11126,530649,2018-06-30,2018,MIA,NYN,5,2,5-2,MIA,9,1,34,34,68,133,123,256,11,8,19,0,2:23
11127,530650,2018-06-30,2018,SDN,PIT,4,3,4-3,SDN,9,1,31,37,68,158,115,273,7,11,18,1,2:48
11128,530640,2018-06-30,2018,TEX,CHA,13,4,13-4,TEX,9,1,42,41,83,139,178,317,18,15,33,6,3:28
11129,530638,2018-06-30,2018,SLN,ATL,4,11,11-4,ATL,9,0,37,44,81,154,141,295,12,18,30,3,3:11
11130,530639,2018-06-30,2018,NYA,BOS,0,11,11-0,BOS,9,0,32,46,78,184,134,318,5,20,25,1,3:17
11131,530648,2018-06-30,2018,CHN,MIN,14,9,14-9,CHN,9,1,49,43,92,160,182,342,29,16,45,3,3:44
11132,530647,2018-06-30,2018,CIN,MIL,12,3,12-3,CIN,9,1,45,38,83,161,170,331,23,11,34,3,3:20
11133,530660,2018-07-01,2018,SEA,KCA,1,0,1-0,SEA,9,1,29,31,60,125,102,227,6,4,10,0,2:00
11134,530658,2018-07-01,2018,TOR,DET,1,9,9-1,DET,9,0,33,39,72,148,121,269,6,15,21,1,2:31
11135,530654,2018-07-01,2018,NYA,BOS,11,1,11-1,NYA,9,1,42,34,76,135,148,283,19,7,26,4,3:14
11136,530657,2018-07-01,2018,LAN,COL,6,4,6-4,LAN,9,1,36,37,73,127,148,275,15,11,26,2,3:00
11137,530664,2018-07-01,2018,MIA,NYN,2,5,5-2,NYN,9,0,36,38,74,143,172,315,7,13,20,1,2:53
11138,530655,2018-07-01,2018,TEX,CHA,5,10,10-5,CHA,9,0,44,42,86,130,170,300,18,16,34,3,3:16
11139,530656,2018-07-01,2018,OAK,CLE,3,15,15-3,CLE,9,0,36,51,87,186,151,337,12,24,36,4,3:21
11140,530666,2018-07-01,2018,ARI,SFN,6,9,9-6,SFN,9,0,43,50,93,179,153,332,18,28,46,4,3:45
11141,530665,2018-07-01,2018,SDN,PIT,5,7,7-5,PIT,9,0,43,39,82,138,189,327,16,12,28,5,3:30
11142,530659,2018-07-01,2018,TBA,HOU,3,2,3-2,TBA,9,1,34,34,68,130,128,258,11,7,18,2,2:36
11143,530661,2018-07-01,2018,BAL,ANA,8,2,8-2,BAL,9,1,34,33,67,120,143,263,12,7,19,1,2:29
11144,530667,2018-07-01,2018,PHI,WAS,4,3,4-3,PHI,13,0,49,51,100,207,189,396,13,17,30,5,4:28
11145,530653,2018-07-01,2018,SLN,ATL,5,6,6-5,ATL,9,0,37,37,74,131,162,293,11,10,21,3,3:11
11146,530662,2018-07-01,2018,CIN,MIL,8,2,8-2,CIN,9,1,37,33,70,127,142,269,14,6,20,1,2:36 (:54 delay)
11147,530663,2018-07-01,2018,CHN,MIN,11,10,11-10,CHN,9,1,45,48,93,177,161,338,21,21,42,3,3:43
11148,530675,2018-07-02,2018,COL,SFN,5,2,5-2,COL,9,1,39,33,72,125,130,255,15,7,22,2,2:45
11149,530674,2018-07-02,2018,LAN,PIT,17,1,17-1,LAN,9,1,52,33,85,144,186,330,27,9,36,1,3:20
11150,530670,2018-07-02,2018,CIN,CHA,5,3,5-3,CIN,9,1,39,39,78,150,141,291,14,11,25,6,3:19
11151,530669,2018-07-02,2018,WAS,BOS,3,4,4-3,BOS,9,0,40,38,78,143,161,304,14,14,28,1,3:15
11152,530673,2018-07-02,2018,MIL,MIN,6,5,6-5,MIL,10,0,46,40,86,153,172,325,19,11,30,3,3:28
11153,530672,2018-07-02,2018,TOR,DET,2,3,3-2,DET,10,0,39,36,75,139,127,266,10,8,18,1,2:44
11154,530677,2018-07-02,2018,MIA,TBA,3,2,3-2,MIA,10,0,40,38,78,144,154,298,14,9,23,1,3:05
11155,530668,2018-07-02,2018,NYA,ATL,3,5,5-3,ATL,11,0,48,44,92,206,174,380,19,10,29,0,3:53
11156,530671,2018-07-02,2018,KCA,CLE,3,9,9-3,CLE,9,0,34,42,76,142,133,275,8,16,24,1,2:44
11157,530676,2018-07-02,2018,ARI,SLN,3,6,6-3,SLN,9,0,36,38,74,145,129,274,10,12,22,2,2:52
11158,530685,2018-07-03,2018,SEA,ANA,4,1,4-1,SEA,9,1,34,33,67,126,118,244,8,7,15,0,2:27
11159,530691,2018-07-03,2018,ARI,SLN,4,2,4-2,ARI,9,1,32,36,68,144,135,279,10,10,20,3,2:51
11160,530679,2018-07-03,2018,PHI,BAL,3,2,3-2,PHI,9,1,35,36,71,125,123,248,11,9,20,2,2:45 (1:25 delay)
11161,530686,2018-07-03,2018,MIL,MIN,2,0,2-0,MIL,9,1,32,35,67,139,144,283,8,6,14,0,2:55
11162,530680,2018-07-03,2018,WAS,BOS,4,11,11-4,BOS,9,0,40,41,81,137,146,283,14,17,31,1,2:55
11163,530687,2018-07-03,2018,TOR,NYN,8,6,8-6,TOR,9,1,37,40,77,170,153,323,14,15,29,7,3:13
11164,530690,2018-07-03,2018,COL,SFN,8,1,8-1,COL,9,1,38,34,72,133,143,276,14,8,22,2,2:51
11165,530684,2018-07-03,2018,TEX,HOU,3,5,5-3,HOU,9,0,38,39,77,154,172,326,11,15,26,3,3:27
11166,530678,2018-07-03,2018,NYA,ATL,8,5,8-5,NYA,9,1,40,41,81,167,170,337,16,14,30,4,3:46
11167,530689,2018-07-03,2018,OAK,SDN,6,2,6-2,OAK,9,1,32,38,70,158,108,266,13,13,26,1,2:39
11168,530681,2018-07-03,2018,CIN,CHA,8,12,12-8,CHA,12,0,52,59,111,223,202,425,15,22,37,4,4:36
11169,530688,2018-07-03,2018,LAN,PIT,8,3,8-3,LAN,9,1,38,31,69,119,153,272,16,5,21,1,2:57
11170,530683,2018-07-03,2018,CHN,DET,5,3,5-3,CHN,9,1,37,35,72,144,141,285,15,9,24,1,2:57
11171,530682,2018-07-03,2018,KCA,CLE,4,6,6-4,CLE,9,0,39,43,82,140,155,295,15,18,33,2,2:58
11172,530692,2018-07-03,2018,MIA,TBA,6,9,9-6,TBA,16,0,68,70,138,253,257,510,24,29,53,1,5:31
11173,530707,2018-07-04,2018,MIA,TBA,3,0,3-0,MIA,9,1,34,31,65,131,116,247,10,9,19,0,2:28
11174,530697,2018-07-04,2018,KCA,CLE,2,3,3-2,CLE,9,0,35,37,72,142,131,273,10,10,20,1,2:49
11175,530698,2018-07-04,2018,CHN,DET,5,2,5-2,CHN,9,1,36,38,74,144,141,285,13,13,26,0,3:04
11176,530693,2018-07-04,2018,NYA,ATL,6,2,6-2,NYA,9,1,34,40,74,160,155,315,11,14,25,0,3:07
11177,530705,2018-07-04,2018,COL,SFN,1,0,1-0,COL,9,1,32,32,64,114,111,225,8,6,14,0,2:15 (:17 delay)
11178,530701,2018-07-04,2018,MIL,MIN,3,2,3-2,MIL,9,1,31,33,64,122,114,236,8,7,15,2,2:35
11179,530704,2018-07-04,2018,OAK,SDN,4,2,4-2,OAK,9,1,35,36,71,110,132,242,14,12,26,4,2:33
11180,530703,2018-07-04,2018,LAN,PIT,6,4,6-4,LAN,9,1,38,37,75,141,144,285,16,11,27,4,3:23
11181,530695,2018-07-04,2018,WAS,BOS,0,3,3-0,BOS,9,0,34,38,72,160,140,300,7,12,19,2,3:23
11182,530696,2018-07-04,2018,CIN,CHA,7,4,7-4,CIN,9,1,38,36,74,162,162,324,13,11,24,3,3:22
11183,530694,2018-07-04,2018,PHI,BAL,4,1,4-1,PHI,9,1,30,37,67,139,128,267,6,11,17,0,2:55
11184,530699,2018-07-04,2018,TEX,HOU,4,5,5-4,HOU,10,0,43,44,87,153,182,335,14,17,31,0,3:33
11185,530700,2018-07-04,2018,SEA,ANA,4,7,7-4,ANA,9,0,39,44,83,167,163,330,13,19,32,3,3:33
11186,530706,2018-07-04,2018,ARI,SLN,4,8,8-4,SLN,9,0,42,44,86,179,154,333,16,17,33,4,3:47
11187,530702,2018-07-04,2018,TOR,NYN,3,6,6-3,NYN,9,0,37,38,75,148,124,272,10,14,24,2,2:46
11188,530708,2018-07-05,2018,MIL,ATL,7,2,7-2,MIL,9,1,33,32,65,113,145,258,11,6,17,0,2:45
11189,530709,2018-07-05,2018,MIN,BAL,5,2,5-2,MIN,9,1,36,34,70,121,139,260,12,9,21,0,2:29
11190,530714,2018-07-05,2018,SFN,SLN,2,11,11-2,SLN,9,0,29,46,75,161,103,264,2,21,23,1,2:35
11191,530713,2018-07-05,2018,ARI,SDN,3,6,6-3,SDN,9,0,39,36,75,152,152,304,14,11,25,3,3:15
11192,530710,2018-07-05,2018,HOU,CHA,4,3,4-3,HOU,9,0,40,32,72,130,171,301,17,7,24,2,3:05
11193,530715,2018-07-05,2018,DET,TEX,5,7,7-5,TEX,9,0,39,38,77,144,151,295,13,10,23,1,2:55 (:44 delay)
11194,530712,2018-07-05,2018,WAS,MIA,14,12,14-12,WAS,9,1,42,46,88,158,157,315,20,18,38,2,3:15
11195,530711,2018-07-05,2018,SEA,ANA,4,1,4-1,SEA,9,1,36,37,73,156,153,309,14,10,24,3,3:22
11196,530720,2018-07-06,2018,CHN,CIN,2,3,3-2,CIN,9,0,38,39,77,152,151,303,12,15,27,5,3:09
11197,530727,2018-07-06,2018,ARI,SDN,3,1,3-1,ARI,9,1,35,33,68,128,135,263,11,7,18,2,2:52
11198,530730,2018-07-06,2018,DET,TEX,3,1,3-1,DET,9,1,29,31,60,115,97,212,5,5,10,0,2:05
11199,530716,2018-07-06,2018,MIL,ATL,5,4,5-4,MIL,9,1,32,36,68,158,136,294,8,14,22,1,2:47
11200,530725,2018-07-06,2018,CLE,OAK,10,4,10-4,CLE,9,1,36,37,73,161,132,293,13,13,26,6,3:16
11201,530728,2018-07-06,2018,SFN,SLN,3,2,3-2,SFN,9,1,35,32,67,115,126,241,12,8,20,1,2:26
11202,530726,2018-07-06,2018,PIT,PHI,5,17,17-5,PHI,9,0,45,57,102,236,185,421,18,30,48,5,4:30
11203,530729,2018-07-06,2018,NYN,TBA,5,1,5-1,NYN,9,0,38,35,73,128,128,256,12,9,21,2,2:43
11204,530719,2018-07-06,2018,HOU,CHA,11,4,11-4,HOU,9,1,44,33,77,130,148,278,23,7,30,2,2:55
11205,530717,2018-07-06,2018,MIN,BAL,6,2,6-2,MIN,9,1,35,39,74,150,124,274,12,13,25,2,2:51
11206,530722,2018-07-06,2018,ANA,LAN,3,2,3-2,ANA,9,0,35,34,69,123,144,267,10,7,17,3,3:12
11207,530721,2018-07-06,2018,SEA,COL,1,7,7-1,COL,9,0,33,43,76,169,147,316,8,16,24,0,3:11
11208,530718,2018-07-06,2018,KCA,BOS,5,10,10-5,BOS,9,0,38,43,81,168,157,325,11,17,28,1,2:59
11209,530723,2018-07-06,2018,WAS,MIA,3,2,3-2,WAS,9,0,36,37,73,164,155,319,13,14,27,0,3:13
11210,530724,2018-07-06,2018,TOR,NYA,6,2,6-2,TOR,9,1,39,38,77,190,140,330,15,10,25,3,3:07
11211,530737,2018-07-07,2018,ANA,LAN,1,3,3-1,LAN,9,0,35,36,71,162,131,293,7,9,16,3,3:18
11212,530744,2018-07-07,2018,NYN,TBA,0,3,3-0,TBA,9,0,34,41,75,158,134,292,11,15,26,4,2:58
11213,530738,2018-07-07,2018,WAS,MIA,18,4,18-4,WAS,9,1,45,34,79,127,174,301,22,9,31,2,3:01
11214,530734,2018-07-07,2018,HOU,CHA,12,6,12-6,HOU,9,1,45,37,82,147,169,316,22,9,31,4,3:19
11215,530739,2018-07-07,2018,TOR,NYA,5,8,8-5,NYA,9,0,37,46,83,191,168,359,11,19,30,5,3:31
11216,530741,2018-07-07,2018,PIT,PHI,2,3,3-2,PHI,9,0,36,36,72,124,135,259,9,12,21,1,2:48
11217,530743,2018-07-07,2018,SFN,SLN,2,3,3-2,SLN,9,0,35,37,72,146,132,278,8,10,18,0,2:51
11218,530732,2018-07-07,2018,MIN,BAL,5,4,5-4,MIN,9,1,34,37,71,151,143,294,11,11,22,0,2:54
11219,530736,2018-07-07,2018,SEA,COL,1,5,5-1,COL,9,0,36,38,74,127,157,284,11,11,22,0,2:53
11220,530731,2018-07-07,2018,MIL,ATL,1,5,5-1,ATL,9,0,33,40,73,173,130,303,6,14,20,2,3:06
11221,530742,2018-07-07,2018,ARI,SDN,20,5,20-5,ARI,9,1,50,36,86,146,201,347,26,11,37,2,3:23
11222,530740,2018-07-07,2018,CLE,OAK,3,6,6-3,OAK,11,0,45,46,91,178,166,344,14,14,28,4,3:49
11223,530735,2018-07-07,2018,CHN,CIN,8,7,8-7,CHN,9,1,41,41,82,153,140,293,17,15,32,4,3:15
11224,530733,2018-07-07,2018,KCA,BOS,4,15,15-4,BOS,9,0,40,54,94,215,166,381,11,30,41,5,4:03
11225,530745,2018-07-07,2018,DET,TEX,7,2,7-2,DET,9,1,43,36,79,143,183,326,19,9,28,1,3:08
11226,530754,2018-07-08,2018,TOR,NYA,1,2,2-1,NYA,10,0,38,39,77,147,164,311,8,12,20,0,2:51
11227,530752,2018-07-08,2018,ANA,LAN,4,3,4-3,ANA,9,1,31,33,64,133,106,239,10,8,18,2,2:39
11228,530751,2018-07-08,2018,SEA,COL,6,4,6-4,SEA,9,1,36,32,68,131,122,253,14,5,19,0,2:28
11229,530756,2018-07-08,2018,PIT,PHI,4,1,4-1,PIT,9,1,35,34,69,125,132,257,11,7,18,0,2:42
11230,530760,2018-07-08,2018,DET,TEX,0,3,3-0,TEX,9,0,31,38,69,137,140,277,7,13,20,2,2:48
11231,530759,2018-07-08,2018,NYN,TBA,0,9,9-0,TBA,9,0,29,45,74,178,110,288,4,20,24,0,2:42
11232,530755,2018-07-08,2018,CLE,OAK,0,6,6-0,OAK,9,0,36,42,78,166,153,319,8,15,23,3,3:04
11233,530748,2018-07-08,2018,KCA,BOS,4,7,7-4,BOS,9,0,40,44,84,168,150,318,13,21,34,3,3:25
11234,530750,2018-07-08,2018,CHN,CIN,6,5,6-5,CHN,10,0,45,40,85,143,184,327,18,13,31,5,3:32
11235,530753,2018-07-08,2018,WAS,MIA,2,10,10-2,MIA,9,0,42,54,96,206,166,372,15,29,44,2,3:43
11236,530758,2018-07-08,2018,SFN,SLN,13,8,13-8,SFN,9,1,48,42,90,175,187,362,24,16,40,4,3:47
11237,530746,2018-07-08,2018,MIL,ATL,10,3,10-3,MIL,9,1,43,40,83,164,181,345,19,15,34,2,3:24
11238,530749,2018-07-08,2018,HOU,CHA,2,1,2-1,HOU,9,1,30,36,66,128,111,239,7,10,17,1,2:28
11239,530757,2018-07-08,2018,ARI,SDN,3,4,4-3,SDN,16,0,63,67,130,277,241,518,17,22,39,3,5:31
11240,530747,2018-07-08,2018,MIN,BAL,10,1,10-1,MIN,9,1,38,34,72,141,144,285,13,8,21,2,2:54
11241,530249,2018-07-09,2018,BAL,NYA,5,4,5-4,BAL,9,1,36,36,72,129,145,274,14,10,24,1,2:55
11242,529466,2018-07-09,2018,NYN,PHI,1,3,3-1,PHI,9,0,32,33,65,136,141,277,5,7,12,2,2:41
11243,530768,2018-07-09,2018,HOU,OAK,0,2,2-0,OAK,9,0,32,37,69,164,125,289,7,11,18,2,2:56
11244,530771,2018-07-09,2018,PIT,WAS,6,3,6-3,PIT,9,1,37,36,73,137,127,264,14,10,24,1,2:49
11245,530249,2018-07-09,2018,BAL,NYA,5,4,5-4,BAL,9,1,36,36,72,129,145,274,14,10,24,1,2:55
11246,529466,2018-07-09,2018,NYN,PHI,1,3,3-1,PHI,9,0,32,33,65,136,141,277,5,7,12,2,2:41
11247,530762,2018-07-09,2018,CLE,CIN,5,7,7-5,CIN,9,0,39,41,80,152,129,281,13,16,29,3,2:57
11248,530770,2018-07-09,2018,BOS,TEX,5,0,5-0,BOS,9,1,33,36,69,153,139,292,9,8,17,2,2:52
11249,530765,2018-07-09,2018,SDN,LAN,2,8,8-2,LAN,9,0,35,43,78,149,136,285,6,19,25,0,2:50
11250,530764,2018-07-09,2018,MIN,KCA,3,1,3-1,MIN,9,1,39,35,74,143,175,318,15,9,24,1,3:03
11251,530761,2018-07-09,2018,SFN,CHN,2,1,2-1,SFN,11,0,42,41,83,170,137,307,12,9,21,3,3:09
11252,530767,2018-07-09,2018,BAL,NYA,2,10,10-2,NYA,9,0,33,48,81,201,130,331,10,23,33,3,3:13
11253,530769,2018-07-09,2018,NYN,PHI,4,3,4-3,NYN,10,0,34,45,79,194,139,333,7,17,24,2,3:24
11254,530766,2018-07-09,2018,MIA,MIL,4,3,4-3,MIA,10,0,44,42,86,157,178,335,18,17,35,3,3:34
11255,530763,2018-07-09,2018,TBA,DET,10,9,10-9,TBA,10,0,48,50,98,192,165,357,22,20,42,7,3:55
11256,530777,2018-07-10,2018,SDN,LAN,4,1,4-1,SDN,9,1,32,32,64,121,111,232,9,6,15,1,2:18
11257,530773,2018-07-10,2018,SFN,CHN,0,2,2-0,CHN,9,0,30,33,63,141,127,268,5,8,13,1,2:43
11258,530785,2018-07-10,2018,ATL,TOR,2,6,6-2,TOR,9,0,36,40,76,160,126,286,10,13,23,3,2:58
11259,530784,2018-07-10,2018,BOS,TEX,8,4,8-4,BOS,9,1,38,38,76,148,149,297,19,12,31,2,2:56
11260,530774,2018-07-10,2018,CLE,CIN,4,7,7-4,CIN,9,0,37,41,78,152,119,271,8,18,26,2,2:48
11261,530783,2018-07-10,2018,CHA,SLN,2,14,14-2,SLN,9,0,33,51,84,189,133,322,7,24,31,3,3:10
11262,530780,2018-07-10,2018,HOU,OAK,6,5,6-5,HOU,11,0,47,43,90,184,189,373,14,11,25,2,4:03
11263,530775,2018-07-10,2018,TBA,DET,5,2,5-2,TBA,9,1,34,33,67,128,131,259,10,7,17,1,2:25
11264,530782,2018-07-10,2018,ANA,SEA,9,3,9-3,ANA,9,1,43,36,79,135,151,286,21,8,29,3,3:10
11265,530781,2018-07-10,2018,NYN,PHI,3,7,7-3,PHI,9,0,35,41,76,155,125,280,10,17,27,2,2:50
11266,530786,2018-07-10,2018,PIT,WAS,1,5,5-1,WAS,9,0,37,42,79,178,131,309,10,17,27,2,3:21 (:50 delay)
11267,530778,2018-07-10,2018,MIA,MIL,4,8,8-4,MIL,9,0,38,39,77,166,142,308,12,14,26,1,3:03
11268,530772,2018-07-10,2018,COL,ARI,3,5,5-3,ARI,9,0,42,41,83,160,195,355,14,15,29,4,3:40
11269,530779,2018-07-10,2018,BAL,NYA,6,5,6-5,BAL,9,0,41,34,75,132,148,280,15,10,25,2,3:07
11270,530776,2018-07-10,2018,MIN,KCA,4,9,9-4,KCA,9,0,37,45,82,197,151,348,12,20,32,3,3:30
11271,530790,2018-07-11,2018,TBA,DET,4,2,4-2,TBA,9,1,37,35,72,128,126,254,13,8,21,2,2:40
11272,530797,2018-07-11,2018,ANA,SEA,0,3,3-0,SEA,9,0,30,35,65,129,107,236,3,10,13,1,2:40
11273,530801,2018-07-11,2018,PIT,WAS,2,0,2-0,PIT,9,1,31,35,66,137,126,263,8,9,17,0,2:34
11274,530791,2018-07-11,2018,MIN,KCA,8,5,8-5,MIN,9,1,41,40,81,187,152,339,20,14,34,2,3:19
11275,530799,2018-07-11,2018,BOS,TEX,4,2,4-2,BOS,9,1,35,38,73,158,118,276,13,12,25,1,2:58
11276,530796,2018-07-11,2018,NYN,PHI,3,0,3-0,NYN,10,0,36,37,73,134,145,279,9,8,17,1,3:07
11277,530792,2018-07-11,2018,SDN,LAN,2,4,4-2,LAN,9,0,33,42,75,158,134,292,7,17,24,2,3:18
11278,530800,2018-07-11,2018,ATL,TOR,9,5,9-5,ATL,9,1,43,36,79,129,167,296,18,10,28,3,2:58
11279,530795,2018-07-11,2018,HOU,OAK,3,8,8-3,OAK,9,0,35,46,81,186,134,320,8,19,27,3,3:13
11280,530787,2018-07-11,2018,COL,ARI,19,2,19-2,COL,9,1,49,35,84,136,173,309,25,9,34,2,3:05
11281,530788,2018-07-11,2018,SFN,CHN,5,4,5-4,SFN,13,0,58,57,115,225,227,452,22,18,40,2,4:30
11282,530794,2018-07-11,2018,BAL,NYA,0,9,9-0,NYA,9,0,33,50,83,210,131,341,6,22,28,2,3:22
11283,530789,2018-07-11,2018,CLE,CIN,19,4,19-4,CLE,9,1,49,40,89,162,217,379,26,14,40,2,3:31
11284,530793,2018-07-11,2018,MIA,MIL,5,4,5-4,MIA,12,0,48,50,98,213,197,410,16,16,32,2,4:23
11285,530798,2018-07-11,2018,CHA,SLN,4,0,4-0,CHA,9,1,31,35,66,137,129,266,9,7,16,2,2:46
11286,530034,2018-07-12,2018,BAL,PHI,4,5,5-4,PHI,9,0,35,42,77,142,133,275,8,16,24,5,3:04
11287,530808,2018-07-12,2018,MIN,TBA,5,1,5-1,MIN,9,1,34,35,69,136,136,272,10,8,18,1,2:50 (2:00 delay)
11288,530034,2018-07-12,2018,BAL,PHI,4,5,5-4,PHI,9,0,35,42,77,142,133,275,8,16,24,5,3:04
11289,530810,2018-07-12,2018,NYN,WAS,4,5,5-4,WAS,9,0,36,41,77,136,135,271,11,14,25,2,2:48
11290,530805,2018-07-12,2018,CLE,NYA,4,7,7-4,NYA,9,0,36,38,74,141,148,289,11,11,22,4,3:07
11291,530809,2018-07-12,2018,BOS,TOR,6,4,6-4,BOS,9,1,34,37,71,153,163,316,10,11,21,2,3:19
11292,530807,2018-07-12,2018,ANA,SEA,11,2,11-2,ANA,9,1,43,37,80,131,156,287,20,12,32,1,3:02
11293,530803,2018-07-12,2018,SDN,LAN,2,3,3-2,LAN,9,0,38,36,74,144,155,299,11,11,22,3,3:14
11294,530806,2018-07-12,2018,HOU,OAK,4,6,6-4,OAK,9,0,36,41,77,190,153,343,10,14,24,4,3:21
11295,530802,2018-07-12,2018,COL,ARI,5,1,5-1,COL,9,1,37,37,74,150,147,297,15,11,26,4,3:17
11296,530804,2018-07-12,2018,PIT,MIL,6,3,6-3,PIT,9,1,39,40,79,165,154,319,17,13,30,1,3:00
11297,530820,2018-07-13,2018,MIA,PHI,0,2,2-0,PHI,9,0,30,36,66,139,128,267,7,10,17,0,2:34
11298,530816,2018-07-13,2018,LAN,ANA,3,2,3-2,LAN,9,1,37,36,73,136,151,287,15,10,25,1,3:13
11299,530811,2018-07-13,2018,ATL,ARI,1,2,2-1,ARI,9,0,35,35,70,144,147,291,8,9,17,2,3:05
11300,530817,2018-07-13,2018,PIT,MIL,7,3,7-3,PIT,9,1,36,36,72,132,133,265,14,10,24,2,2:48
11301,530819,2018-07-13,2018,SFN,OAK,7,1,7-1,SFN,9,1,37,33,70,134,155,289,15,6,21,3,3:16
11302,530812,2018-07-13,2018,SDN,CHN,4,5,5-4,CHN,10,0,44,42,86,160,164,324,16,15,31,2,3:29
11303,530824,2018-07-13,2018,BOS,TOR,7,13,13-7,TOR,9,0,45,50,95,202,165,367,18,23,41,6,3:43
11304,530814,2018-07-13,2018,HOU,DET,3,0,3-0,HOU,9,1,34,36,70,148,119,267,11,10,21,0,2:44
11305,530823,2018-07-13,2018,BAL,TEX,4,5,5-4,TEX,9,0,38,37,75,147,136,283,12,11,23,4,3:08
11306,530821,2018-07-13,2018,COL,SEA,10,7,10-7,COL,9,1,41,41,82,161,130,291,18,16,34,4,3:19
11307,530825,2018-07-13,2018,NYN,WAS,4,2,4-2,NYN,9,1,38,37,75,137,146,283,14,12,26,0,2:53
11308,530818,2018-07-13,2018,CLE,NYA,6,5,6-5,CLE,9,1,38,35,73,129,160,289,14,11,25,3,2:59
11309,530815,2018-07-13,2018,CHA,KCA,9,6,9-6,CHA,9,1,43,41,84,159,180,339,20,12,32,5,3:34
11310,530822,2018-07-13,2018,MIN,TBA,11,8,11-8,MIN,9,1,42,43,85,156,151,307,19,16,35,5,3:23
11311,530813,2018-07-13,2018,SLN,CIN,1,9,9-1,CIN,9,0,34,45,79,179,141,320,7,20,27,4,3:14
11312,530836,2018-07-14,2018,COL,SEA,4,1,4-1,COL,9,1,35,32,67,113,138,251,13,6,19,2,2:50
11313,530838,2018-07-14,2018,BAL,TEX,1,0,1-0,BAL,9,1,30,35,65,153,105,258,8,9,17,1,2:45
11314,530830,2018-07-14,2018,CHA,KCA,0,5,5-0,KCA,9,0,36,35,71,124,149,273,9,9,18,2,2:47 (:21 delay)
11315,530826,2018-07-14,2018,ATL,ARI,0,3,3-0,ARI,9,0,33,37,70,159,130,289,6,10,16,3,2:53
11316,530835,2018-07-14,2018,MIA,PHI,2,0,2-0,MIA,9,1,32,36,68,151,127,278,7,10,17,1,3:00
11317,530840,2018-07-14,2018,NYN,WAS,7,4,7-4,NYN,9,1,38,36,74,124,143,267,14,10,24,2,2:48
11318,530832,2018-07-14,2018,PIT,MIL,2,1,2-1,PIT,9,1,33,35,68,145,130,275,10,10,20,2,3:03
11319,530834,2018-07-14,2018,SFN,OAK,3,4,4-3,OAK,9,0,41,40,81,146,142,288,16,13,29,2,3:10
11320,530833,2018-07-14,2018,CLE,NYA,4,5,5-4,NYA,9,0,35,37,72,147,153,300,8,11,19,4,3:10
11321,530511,2018-07-14,2018,PIT,MIL,6,2,6-2,PIT,9,1,34,40,74,169,134,303,10,15,25,2,2:58
11322,530511,2018-07-14,2018,PIT,MIL,6,2,6-2,PIT,9,1,34,40,74,169,134,303,10,15,25,2,2:58
11323,530828,2018-07-14,2018,SLN,CIN,2,8,8-2,CIN,9,0,34,48,82,165,113,278,9,23,32,5,3:07 (2:43 delay)
11324,530839,2018-07-14,2018,BOS,TOR,6,2,6-2,BOS,10,0,40,41,81,166,160,326,16,12,28,3,3:32
11325,530831,2018-07-14,2018,LAN,ANA,4,5,5-4,ANA,10,0,45,44,89,168,167,335,16,14,30,3,3:47
11326,530837,2018-07-14,2018,MIN,TBA,6,19,19-6,TBA,9,0,44,50,94,180,189,369,18,26,44,4,3:45
11327,530827,2018-07-14,2018,SDN,CHN,6,11,11-6,CHN,9,0,37,43,80,163,168,331,12,17,29,3,3:13
11328,530829,2018-07-14,2018,HOU,DET,9,1,9-1,HOU,9,1,36,35,71,146,143,289,14,7,21,2,2:42
11329,530841,2018-07-15,2018,ATL,ARI,5,1,5-1,ATL,9,1,33,33,66,110,130,240,9,8,17,2,2:42
11330,530849,2018-07-15,2018,SFN,OAK,2,6,6-2,OAK,9,0,32,39,71,167,119,286,8,14,22,0,2:44
11331,530855,2018-07-15,2018,NYN,WAS,1,6,6-1,WAS,9,0,35,38,73,157,123,280,9,13,22,2,2:54 (:47 delay)
11332,530850,2018-07-15,2018,MIA,PHI,10,5,10-5,MIA,9,1,42,36,78,149,145,294,19,9,28,5,2:58
11333,530853,2018-07-15,2018,BAL,TEX,6,5,6-5,BAL,9,1,35,38,73,177,134,311,10,14,24,4,3:02 (:26 delay)
11334,530854,2018-07-15,2018,BOS,TOR,5,2,5-2,BOS,9,1,34,38,72,154,167,321,13,12,25,3,3:12
11335,530842,2018-07-15,2018,SDN,CHN,4,7,7-4,CHN,9,0,40,42,82,161,177,338,15,17,32,1,3:24
11336,530848,2018-07-15,2018,CLE,NYA,5,2,5-2,CLE,9,1,35,36,71,136,114,250,13,9,22,1,2:52
11337,530851,2018-07-15,2018,COL,SEA,4,3,4-3,COL,9,0,32,37,69,143,117,260,11,10,21,1,3:11
11338,530843,2018-07-15,2018,SLN,CIN,6,4,6-4,SLN,9,1,34,39,73,160,106,266,11,13,24,1,2:53
11339,530852,2018-07-15,2018,MIN,TBA,11,7,11-7,MIN,10,0,48,48,96,190,196,386,25,19,44,11,4:38
11340,530846,2018-07-15,2018,LAN,ANA,5,3,5-3,LAN,9,1,34,38,72,142,138,280,13,12,25,1,3:10
11341,530845,2018-07-15,2018,CHA,KCA,10,1,10-1,CHA,9,1,38,33,71,140,133,273,15,8,23,1,2:39
11342,530847,2018-07-15,2018,PIT,MIL,7,6,7-6,PIT,10,0,42,44,86,137,153,290,13,16,29,4,3:25
11343,530844,2018-07-15,2018,HOU,DET,3,6,6-3,DET,9,0,32,33,65,129,135,264,7,6,13,0,2:28
11344,530856,2018-07-17,2018,NAS,AAS,6,8,8-6,AAS,10,0,43,47,90,194,169,363,13,17,30,3,3:34
11345,530857,2018-07-19,2018,CHN,SLN,9,6,9-6,CHN,9,1,40,43,83,193,141,334,16,17,33,4,3:29
11346,530861,2018-07-20,2018,SEA,CHA,3,1,3-1,SEA,9,1,33,33,66,105,120,225,11,7,18,3,2:37
11347,530860,2018-07-20,2018,DET,BOS,0,1,1-0,BOS,9,0,36,37,73,168,149,317,8,10,18,5,3:31
11348,530858,2018-07-20,2018,WAS,ATL,5,8,8-5,ATL,9,0,38,43,81,152,148,300,11,17,28,1,2:57
11349,530859,2018-07-20,2018,TOR,BAL,8,7,8-7,TOR,10,0,44,42,86,144,168,312,15,12,27,3,3:01
11350,530869,2018-07-20,2018,CIN,PIT,1,12,12-1,PIT,9,0,36,47,83,177,161,338,10,22,32,2,3:27 (2:55 delay)
11351,530872,2018-07-20,2018,CHN,SLN,5,18,18-5,SLN,9,0,44,52,96,204,193,397,19,26,45,4,3:54
11352,530864,2018-07-20,2018,ANA,HOU,1,3,3-1,HOU,9,0,31,38,69,143,120,263,3,13,16,2,2:47
11353,530863,2018-07-20,2018,ARI,COL,10,11,11-10,COL,9,0,45,47,92,186,178,364,18,20,38,4,4:02
11354,530871,2018-07-20,2018,OAK,SFN,1,5,5-1,SFN,9,0,34,36,70,139,119,258,7,9,16,5,2:47
11355,530862,2018-07-20,2018,TEX,CLE,8,9,9-8,CLE,11,0,56,51,107,205,222,427,25,22,47,5,4:48
11356,530868,2018-07-20,2018,NYA,NYN,5,7,7-5,NYN,9,0,46,42,88,188,184,372,19,16,35,2,3:46
11357,530865,2018-07-20,2018,MIL,LAN,4,6,6-4,LAN,9,0,39,42,81,147,147,294,14,17,31,4,3:07
11358,530870,2018-07-20,2018,PHI,SDN,11,5,11-5,PHI,9,1,38,40,78,180,135,315,16,14,30,2,3:15
11359,530866,2018-07-20,2018,TBA,MIA,5,6,6-5,MIA,9,0,40,38,78,166,138,304,13,11,24,3,2:54
11360,530867,2018-07-20,2018,KCA,MIN,6,5,6-5,KCA,9,1,35,43,78,183,148,331,11,16,27,2,3:08
11361,529651,2018-07-21,2018,CHN,SLN,7,2,7-2,CHN,9,1,41,36,77,132,149,281,21,10,31,4,3:13
11362,530876,2018-07-21,2018,SEA,CHA,0,5,5-0,CHA,9,0,31,37,68,127,111,238,4,11,15,1,2:28
11363,530875,2018-07-21,2018,DET,BOS,5,0,5-0,DET,9,1,33,37,70,127,123,250,8,11,19,1,2:27
11364,530881,2018-07-21,2018,TBA,MIA,2,3,3-2,MIA,9,0,34,38,72,158,133,291,8,11,19,0,2:48
11365,529651,2018-07-21,2018,CHN,SLN,7,2,7-2,CHN,9,1,41,36,77,132,149,281,21,10,31,4,3:13
11366,530882,2018-07-21,2018,KCA,MIN,4,2,4-2,KCA,9,1,39,35,74,156,163,319,16,10,26,3,3:11
11367,530879,2018-07-21,2018,ANA,HOU,0,7,7-0,HOU,9,0,36,41,77,147,146,293,11,15,26,2,3:20
11368,530883,2018-07-21,2018,NYA,NYN,7,6,7-6,NYA,9,1,37,39,76,160,131,291,13,13,26,3,3:01
11369,530887,2018-07-21,2018,CHN,SLN,3,6,6-3,SLN,9,0,41,43,84,162,146,308,14,18,32,4,3:38
11370,530877,2018-07-21,2018,TEX,CLE,3,16,16-3,CLE,9,0,35,50,85,166,131,297,10,24,34,3,3:11
11371,530880,2018-07-21,2018,MIL,LAN,4,2,4-2,MIL,9,1,33,38,71,185,109,294,7,14,21,2,3:15
11372,530886,2018-07-21,2018,OAK,SFN,4,3,4-3,OAK,11,0,45,44,89,172,194,366,18,11,29,5,4:04
11373,530874,2018-07-21,2018,TOR,BAL,4,1,4-1,TOR,9,1,32,33,65,129,131,260,10,8,18,0,2:30
11374,530884,2018-07-21,2018,CIN,PIT,2,6,6-2,PIT,9,0,36,40,76,136,118,254,9,15,24,2,2:41 (:47 delay)
11375,530878,2018-07-21,2018,ARI,COL,5,6,6-5,COL,9,0,42,40,82,133,148,281,15,14,29,3,3:21
11376,530885,2018-07-22,2018,PHI,SDN,5,0,5-0,PHI,9,1,36,30,66,105,138,243,12,4,16,2,2:41
11377,530885,2018-07-22,2018,PHI,SDN,5,0,5-0,PHI,9,1,36,30,66,105,138,243,12,4,16,2,2:41
11378,530893,2018-07-22,2018,ARI,COL,6,1,6-1,ARI,9,1,35,30,65,122,134,256,12,4,16,3,2:45
11379,530892,2018-07-22,2018,TEX,CLE,5,0,5-0,TEX,9,1,34,36,70,123,128,251,11,11,22,2,2:33
11380,530897,2018-07-22,2018,KCA,MIN,5,3,5-3,KCA,9,1,31,33,64,124,146,270,7,6,13,2,2:35
11381,530899,2018-07-22,2018,CIN,PIT,2,9,9-2,PIT,9,0,34,42,76,153,124,277,8,15,23,2,2:46
11382,530896,2018-07-22,2018,TBA,MIA,6,4,6-4,TBA,9,0,36,39,75,140,163,303,10,11,21,1,3:04
11383,530890,2018-07-22,2018,DET,BOS,1,9,9-1,BOS,9,0,35,37,72,152,154,306,8,10,18,2,2:55 (1:35 delay)
11384,530891,2018-07-22,2018,SEA,CHA,8,2,8-2,SEA,9,1,35,33,68,124,141,265,12,6,18,3,2:53
11385,530900,2018-07-22,2018,PHI,SDN,2,10,10-2,SDN,9,0,40,43,83,170,148,318,12,16,28,2,3:10
11386,530902,2018-07-22,2018,CHN,SLN,7,2,7-2,CHN,9,1,40,38,78,152,136,288,19,14,33,1,3:05
11387,530888,2018-07-22,2018,WAS,ATL,6,2,6-2,WAS,9,1,42,39,81,159,158,317,18,15,33,4,3:26 (3:33 delay)
11388,530895,2018-07-22,2018,MIL,LAN,2,11,11-2,LAN,9,0,38,45,83,169,150,319,10,18,28,1,2:59
11389,530901,2018-07-22,2018,OAK,SFN,6,5,6-5,OAK,10,0,42,39,81,158,151,309,16,10,26,2,3:19
11390,530894,2018-07-22,2018,ANA,HOU,14,5,14-5,ANA,9,1,45,41,86,179,187,366,23,14,37,6,3:41
11391,530889,2018-07-22,2018,TOR,BAL,5,4,5-4,TOR,9,1,33,39,72,175,122,297,11,12,23,3,2:54
11392,530912,2018-07-23,2018,CLE,PIT,0,7,7-0,PIT,6,0,24,28,52,91,84,175,6,11,17,0,1:47 (2:03 delay)
11393,530913,2018-07-23,2018,NYN,SDN,2,3,3-2,SDN,9,0,38,34,72,125,156,281,10,8,18,1,2:57
11394,530914,2018-07-23,2018,CIN,SLN,2,1,2-1,CIN,9,0,35,32,67,122,152,274,9,7,16,2,2:48
11395,530905,2018-07-23,2018,BAL,BOS,3,5,5-3,BOS,9,0,36,37,73,155,141,296,12,13,25,2,2:54 (1:00 delay)
11396,530910,2018-07-23,2018,TBA,NYA,7,6,7-6,TBA,9,1,38,42,80,153,149,302,14,16,30,6,3:26
11397,530906,2018-07-23,2018,ANA,CHA,3,5,5-3,CHA,9,0,40,39,79,152,154,306,14,14,28,7,3:36
11398,530904,2018-07-23,2018,MIA,ATL,1,12,12-1,ATL,9,0,35,48,83,168,143,311,10,24,34,0,2:48
11399,530909,2018-07-23,2018,TOR,MIN,3,8,8-3,MIN,9,0,43,41,84,157,160,317,16,15,31,2,3:18
11400,530908,2018-07-23,2018,PHI,LAN,6,7,7-6,LAN,9,0,35,42,77,188,156,344,8,16,24,3,3:43
11401,530903,2018-07-23,2018,CHN,ARI,1,7,7-1,ARI,9,0,32,40,72,154,124,278,7,14,21,3,2:55
11402,530907,2018-07-23,2018,KCA,DET,4,5,5-4,DET,9,0,44,38,82,126,159,285,16,13,29,5,3:13
11403,530915,2018-07-23,2018,MIL,WAS,6,1,6-1,MIL,9,1,36,36,72,161,156,317,13,8,21,4,3:20
11404,530911,2018-07-23,2018,TEX,OAK,3,15,15-3,OAK,9,0,36,49,85,189,132,321,11,23,34,2,3:13
11405,530927,2018-07-24,2018,NYN,SDN,6,3,6-3,NYN,9,1,36,32,68,130,139,269,12,7,19,0,2:31
11406,530923,2018-07-24,2018,TOR,MIN,0,5,5-0,MIN,9,0,31,37,68,148,123,271,6,10,16,1,2:30
11407,530924,2018-07-24,2018,TBA,NYA,0,4,4-0,NYA,9,0,29,36,65,124,105,229,4,11,15,1,2:37
11408,530919,2018-07-24,2018,ANA,CHA,2,4,4-2,CHA,9,0,35,39,74,129,146,275,9,11,20,3,2:58
11409,530916,2018-07-24,2018,CHN,ARI,1,5,5-1,ARI,9,0,35,43,78,194,135,329,9,17,26,2,3:13
11410,530920,2018-07-24,2018,KCA,DET,5,4,5-4,KCA,9,1,34,32,66,143,123,266,10,5,15,2,2:43
11411,530928,2018-07-24,2018,SEA,SFN,3,4,4-3,SFN,9,0,37,38,75,152,133,285,12,12,24,3,2:58
11412,530918,2018-07-24,2018,BAL,BOS,7,6,7-6,BAL,9,1,37,37,74,160,153,313,14,11,25,3,3:07 (:27 delay)
11413,530917,2018-07-24,2018,MIA,ATL,9,3,9-3,MIA,9,1,37,35,72,134,128,262,13,10,23,1,2:37
11414,530929,2018-07-24,2018,CIN,SLN,2,4,4-2,SLN,11,0,41,46,87,189,156,345,10,14,24,3,3:32
11415,530925,2018-07-24,2018,TEX,OAK,10,13,13-10,OAK,10,0,44,51,95,248,172,420,13,20,33,3,4:08
11416,530921,2018-07-24,2018,COL,HOU,2,8,8-2,HOU,10,0,36,41,77,141,147,288,8,14,22,3,3:12 (1:00 delay)
11417,530930,2018-07-24,2018,MIL,WAS,5,4,5-4,MIL,10,0,42,40,82,152,146,298,17,10,27,1,3:33
11418,530926,2018-07-24,2018,CLE,PIT,4,9,9-4,PIT,9,0,38,40,78,159,128,287,11,15,26,1,2:55
11419,530922,2018-07-24,2018,PHI,LAN,7,4,7-4,PHI,16,0,63,63,126,251,233,484,18,18,36,3,5:55 (:14 delay)
11420,530940,2018-07-25,2018,CLE,PIT,4,0,4-0,CLE,9,1,33,32,65,126,112,238,10,6,16,3,2:39
11421,530938,2018-07-25,2018,TBA,NYA,3,2,3-2,TBA,9,1,31,37,68,156,116,272,7,9,16,3,2:46
11422,530936,2018-07-25,2018,PHI,LAN,7,3,7-3,PHI,9,1,34,36,70,144,150,294,11,10,21,2,2:58
11423,530931,2018-07-25,2018,CHN,ARI,2,1,2-1,CHN,9,1,28,32,60,138,114,252,7,5,12,1,2:39
11424,530942,2018-07-25,2018,SEA,SFN,3,2,3-2,SEA,9,1,30,34,64,117,120,237,7,6,13,2,2:37
11425,530941,2018-07-25,2018,NYN,SDN,6,4,6-4,NYN,9,1,32,36,68,115,120,235,8,11,19,2,2:18 (:36 delay)
11426,530944,2018-07-25,2018,MIL,WAS,3,7,7-3,WAS,9,0,35,36,71,118,129,247,8,9,17,1,2:24
11427,530943,2018-07-25,2018,CIN,SLN,7,3,7-3,CIN,9,1,37,41,78,152,151,303,16,13,29,0,3:11
11428,530935,2018-07-25,2018,COL,HOU,3,2,3-2,COL,9,0,37,32,69,129,146,275,14,4,18,2,2:56
11429,530933,2018-07-25,2018,ANA,CHA,11,3,11-3,ANA,9,1,41,35,76,151,153,304,20,8,28,1,3:03
11430,530939,2018-07-25,2018,TEX,OAK,5,6,6-5,OAK,9,0,36,41,77,173,161,334,11,17,28,2,3:48
11431,530934,2018-07-25,2018,KCA,DET,4,8,8-4,DET,9,0,39,42,81,165,142,307,11,15,26,1,2:50
11432,530937,2018-07-25,2018,TOR,MIN,6,12,12-6,MIN,11,0,49,57,106,215,185,400,19,26,45,3,4:20
11433,530948,2018-07-26,2018,ATL,LAN,2,8,8-2,LAN,9,0,36,43,79,151,134,285,8,17,25,3,2:55
11434,530947,2018-07-26,2018,NYA,KCA,7,2,7-2,NYA,9,1,39,37,76,143,151,294,15,11,26,1,2:58
11435,530955,2018-07-26,2018,MIA,WAS,3,10,10-3,WAS,9,0,35,47,82,197,134,331,10,26,36,3,3:14
11436,530950,2018-07-26,2018,BOS,MIN,1,2,2-1,MIN,9,0,36,36,72,140,145,285,10,12,22,2,2:59
11437,530954,2018-07-26,2018,BAL,TBA,3,4,4-3,TBA,9,0,38,36,74,127,160,287,12,12,24,4,3:03
11438,530946,2018-07-26,2018,ANA,CHA,12,8,12-8,ANA,9,1,45,40,85,142,160,302,23,14,37,6,3:29
11439,530952,2018-07-26,2018,TEX,OAK,6,7,7-6,OAK,9,0,43,39,82,131,178,309,16,13,29,0,3:27
11440,530953,2018-07-26,2018,CIN,PHI,4,9,9-4,PHI,9,0,35,45,80,193,138,331,9,21,30,3,3:24
11441,530951,2018-07-26,2018,PIT,NYN,6,12,12-6,NYN,9,0,37,51,88,193,156,349,11,25,36,1,3:05
11442,530949,2018-07-26,2018,SFN,MIL,5,7,7-5,MIL,9,0,40,44,84,166,151,317,15,17,32,3,3:22
11443,530945,2018-07-26,2018,CHN,ARI,7,6,7-6,CHN,9,0,37,42,79,174,135,309,12,18,30,2,3:22
11444,530957,2018-07-27,2018,SLN,CHN,5,2,5-2,SLN,9,1,37,34,71,113,140,253,17,8,25,0,2:48
11445,530964,2018-07-27,2018,COL,OAK,3,1,3-1,COL,9,1,34,41,75,163,116,279,11,14,25,1,3:03
11446,530960,2018-07-27,2018,ATL,LAN,1,4,4-1,LAN,9,0,33,40,73,171,117,288,7,14,21,1,2:51
11447,530969,2018-07-27,2018,CHA,TOR,5,10,10-5,TOR,9,0,38,42,80,171,144,315,12,15,27,2,3:05
11448,530961,2018-07-27,2018,SFN,MIL,1,3,3-1,MIL,9,0,34,35,69,114,138,252,8,7,15,0,2:33
11449,530966,2018-07-27,2018,ANA,SEA,4,3,4-3,ANA,10,0,36,39,75,121,135,256,11,12,23,1,2:54
11450,530970,2018-07-27,2018,MIA,WAS,1,9,9-1,WAS,9,0,34,47,81,168,115,283,5,23,28,1,2:45
11451,530958,2018-07-27,2018,DET,CLE,3,8,8-3,CLE,9,0,38,39,77,166,142,308,13,12,25,4,3:09
11452,530962,2018-07-27,2018,BOS,MIN,4,3,4-3,BOS,10,0,37,42,79,169,154,323,10,12,22,1,3:26
11453,530963,2018-07-27,2018,PIT,NYN,5,4,5-4,PIT,9,0,41,39,80,137,171,308,19,13,32,4,3:17
11454,530956,2018-07-27,2018,SDN,ARI,2,6,6-2,ARI,9,0,32,39,71,142,126,268,8,13,21,1,2:37
11455,530965,2018-07-27,2018,CIN,PHI,6,4,6-4,CIN,9,1,38,38,76,157,151,308,16,10,26,3,3:10
11456,530967,2018-07-27,2018,BAL,TBA,15,5,15-5,BAL,9,1,47,41,88,139,166,305,23,17,40,2,3:10 (1:19 delay)
11457,530968,2018-07-27,2018,HOU,TEX,2,11,11-2,TEX,9,0,36,47,83,201,150,351,11,18,29,2,3:23
11458,530981,2018-07-28,2018,ANA,SEA,11,5,11-5,ANA,9,1,39,37,76,135,130,265,15,10,25,1,2:41
11459,530982,2018-07-28,2018,BAL,TBA,11,2,11-2,BAL,9,1,41,36,77,130,163,293,20,12,32,1,2:53
11460,530983,2018-07-28,2018,HOU,TEX,3,7,7-3,TEX,9,0,32,43,75,160,120,280,6,15,21,0,2:44
11461,530976,2018-07-28,2018,SFN,MIL,1,7,7-1,MIL,9,0,32,40,72,136,136,272,7,16,23,1,2:34
11462,530979,2018-07-28,2018,COL,OAK,4,1,4-1,COL,9,1,37,37,74,160,114,274,16,11,27,1,2:57 (:51 delay)
11463,530975,2018-07-28,2018,ATL,LAN,1,5,5-1,LAN,9,0,34,41,75,178,138,316,9,15,24,2,3:22
11464,530971,2018-07-28,2018,SDN,ARI,4,9,9-4,ARI,9,0,36,47,83,174,143,317,11,21,32,2,3:15
11465,530977,2018-07-28,2018,BOS,MIN,10,4,10-4,BOS,9,1,44,36,80,146,177,323,22,8,30,3,3:28
11466,530985,2018-07-28,2018,MIA,WAS,2,1,2-1,MIA,10,0,39,37,76,162,147,309,13,9,22,1,3:26
11467,530973,2018-07-28,2018,DET,CLE,2,1,2-1,DET,9,1,33,34,67,128,116,244,8,8,16,2,2:27
11468,530984,2018-07-28,2018,CHA,TOR,9,5,9-5,CHA,9,1,37,40,77,162,147,309,15,15,30,4,3:11
11469,530974,2018-07-28,2018,NYA,KCA,5,10,10-5,KCA,9,0,41,41,82,169,138,307,18,15,33,3,3:06
11470,530972,2018-07-28,2018,SLN,CHN,6,2,6-2,SLN,9,1,35,33,68,129,143,272,13,9,22,0,2:41
11471,530980,2018-07-28,2018,CIN,PHI,6,2,6-2,CIN,9,1,41,32,73,142,144,286,18,7,25,2,3:14
11472,530978,2018-07-28,2018,PIT,NYN,5,0,5-0,PIT,9,1,36,35,71,143,118,261,12,9,21,0,2:41
11473,530959,2018-07-28,2018,NYA,KCA,5,4,5-4,NYA,9,1,38,46,84,168,139,307,15,19,34,3,3:27
11474,530959,2018-07-28,2018,NYA,KCA,5,4,5-4,NYA,9,1,38,46,84,168,139,307,15,19,34,3,3:27
11475,530993,2018-07-29,2018,PIT,NYN,0,1,1-0,NYN,9,0,33,38,71,127,118,245,7,13,20,0,2:44
11476,530992,2018-07-29,2018,BOS,MIN,3,0,3-0,BOS,9,1,39,31,70,110,146,256,14,6,20,1,2:42
11477,531000,2018-07-29,2018,MIA,WAS,5,0,5-0,MIA,9,1,35,33,68,143,118,261,10,8,18,1,2:46
11478,530995,2018-07-29,2018,CIN,PHI,4,0,4-0,CIN,9,1,36,35,71,145,116,261,13,9,22,3,2:48
11479,530994,2018-07-29,2018,COL,OAK,3,2,3-2,COL,9,1,34,32,66,118,128,246,10,6,16,2,2:28
11480,530989,2018-07-29,2018,NYA,KCA,6,3,6-3,NYA,9,1,36,34,70,150,142,292,14,8,22,2,2:51
11481,530999,2018-07-29,2018,CHA,TOR,4,7,7-4,TOR,9,0,37,38,75,145,156,301,10,13,23,2,2:57
11482,530987,2018-07-29,2018,SLN,CHN,2,5,5-2,CHN,9,0,33,39,72,142,137,279,6,13,19,1,2:53 (1:16 delay)
11483,530988,2018-07-29,2018,DET,CLE,1,8,8-1,CLE,9,0,32,45,77,190,106,296,6,19,25,1,2:55
11484,530997,2018-07-29,2018,BAL,TBA,11,5,11-5,BAL,9,1,44,37,81,138,157,295,20,11,31,2,3:05
11485,530986,2018-07-29,2018,SDN,ARI,4,5,5-4,ARI,9,0,38,38,76,150,145,295,11,13,24,2,3:18
11486,530990,2018-07-29,2018,ATL,LAN,4,1,4-1,ATL,9,1,34,30,64,139,149,288,10,3,13,1,2:47
11487,530998,2018-07-29,2018,HOU,TEX,3,4,4-3,TEX,9,0,37,35,72,155,134,289,11,7,18,1,3:01
11488,530991,2018-07-29,2018,SFN,MIL,8,5,8-5,SFN,9,1,41,37,78,124,189,313,18,12,30,1,3:12
11489,530996,2018-07-29,2018,ANA,SEA,5,8,8-5,SEA,9,0,41,45,86,173,151,324,14,20,34,4,3:32
11490,531004,2018-07-30,2018,ATL,MIA,5,3,5-3,ATL,9,1,32,39,71,149,117,266,10,13,23,1,2:49
11491,531002,2018-07-30,2018,SLN,COL,5,4,5-4,SLN,10,0,40,42,82,170,145,315,13,13,26,3,3:38
11492,531001,2018-07-30,2018,MIN,CLE,5,4,5-4,MIN,9,0,36,41,77,151,133,284,12,16,28,3,2:56
11493,531003,2018-07-30,2018,SEA,HOU,2,0,2-0,SEA,9,1,31,32,63,116,115,231,7,5,12,1,2:19
11494,531005,2018-07-30,2018,LAN,MIL,2,5,5-2,MIL,9,0,40,40,80,156,200,356,13,13,26,1,3:44 (:23 delay)
11495,531009,2018-07-30,2018,OAK,TOR,10,1,10-1,OAK,9,1,43,37,80,145,154,299,19,9,28,2,2:59
11496,531006,2018-07-30,2018,BOS,PHI,2,1,2-1,BOS,13,0,45,52,97,185,165,350,9,15,24,2,4:03
11497,531008,2018-07-30,2018,ARI,TEX,5,9,9-5,TEX,9,0,40,45,85,179,143,322,13,18,31,3,3:33 (:22 delay)
11498,531007,2018-07-30,2018,SDN,SFN,3,5,5-3,SFN,12,0,48,49,97,198,180,378,11,16,27,3,4:01
11499,531012,2018-07-31,2018,DET,CIN,2,1,2-1,DET,9,1,28,32,60,122,111,233,4,6,10,0,2:18
11500,531010,2018-07-31,2018,NYA,BAL,6,3,6-3,NYA,9,1,36,36,72,166,141,307,12,10,22,1,3:11
11501,531018,2018-07-31,2018,ATL,MIA,11,6,11-6,ATL,9,1,44,40,84,134,152,286,22,14,36,2,2:53 (1:27 delay)
11502,531022,2018-07-31,2018,SDN,SFN,2,3,3-2,SFN,10,0,39,45,84,158,163,321,11,16,27,0,3:05
11503,531019,2018-07-31,2018,LAN,MIL,0,1,1-0,MIL,9,0,30,32,62,133,117,250,4,6,10,0,2:17
11504,531023,2018-07-31,2018,ARI,TEX,6,0,6-0,ARI,9,1,37,32,69,128,135,263,14,6,20,0,2:45
11505,531014,2018-07-31,2018,SLN,COL,3,6,6-3,COL,9,0,32,39,71,172,103,275,6,13,19,3,2:51
11506,531011,2018-07-31,2018,PIT,CHN,5,4,5-4,PIT,9,1,33,38,71,132,127,259,11,14,25,1,2:38
11507,531015,2018-07-31,2018,SEA,HOU,2,5,5-2,HOU,9,0,34,42,76,150,131,281,8,17,25,3,3:09
11508,531021,2018-07-31,2018,BOS,PHI,1,3,3-1,PHI,9,0,35,43,78,168,122,290,9,18,27,0,3:13
11509,531013,2018-07-31,2018,MIN,CLE,2,6,6-2,CLE,9,0,38,41,79,146,139,285,12,16,28,3,3:08
11510,531024,2018-07-31,2018,OAK,TOR,6,2,6-2,OAK,9,1,40,35,75,145,170,315,16,9,25,2,3:10
11511,531016,2018-07-31,2018,CHA,KCA,2,4,4-2,KCA,9,0,42,36,78,133,177,310,16,9,25,2,3:10
11512,531017,2018-07-31,2018,TBA,ANA,10,6,10-6,TBA,9,1,39,43,82,162,154,316,18,17,35,2,3:17
11513,531020,2018-07-31,2018,WAS,NYN,25,4,25-4,WAS,9,1,59,37,96,146,225,371,36,10,46,3,3:16
11514,531035,2018-08-01,2018,WAS,NYN,5,3,5-3,WAS,9,1,35,33,68,135,116,251,10,7,17,0,2:38
11515,531027,2018-08-01,2018,DET,CIN,7,4,7-4,DET,9,1,38,37,75,134,139,273,15,13,28,4,2:55
11516,531032,2018-08-01,2018,TBA,ANA,7,2,7-2,TBA,9,1,41,36,77,143,152,295,18,10,28,3,3:01
11517,531030,2018-08-01,2018,SEA,HOU,3,8,8-3,HOU,9,0,36,44,80,177,134,311,11,17,28,1,3:02
11518,531036,2018-08-01,2018,OAK,TOR,8,3,8-3,OAK,9,1,39,40,79,172,143,315,17,14,31,4,3:04
11519,531034,2018-08-01,2018,LAN,MIL,6,4,6-4,LAN,10,0,40,43,83,159,150,309,15,16,31,1,3:19
11520,531025,2018-08-01,2018,NYA,BAL,5,7,7-5,BAL,9,0,42,42,84,157,163,320,15,17,32,3,3:08 (:39 delay)
11521,531031,2018-08-01,2018,CHA,KCA,5,10,10-5,KCA,9,0,38,43,81,168,128,296,13,15,28,3,3:01
11522,531026,2018-08-01,2018,PIT,CHN,2,9,9-2,CHN,9,0,38,49,87,200,157,357,12,25,37,1,3:31
11523,531029,2018-08-01,2018,SLN,COL,6,3,6-3,SLN,9,1,41,40,81,176,195,371,17,13,30,3,3:59
11524,531028,2018-08-01,2018,MIN,CLE,0,2,2-0,CLE,9,0,31,38,69,155,128,283,6,14,20,1,3:03
11525,531041,2018-08-02,2018,CHA,KCA,6,4,6-4,CHA,9,1,35,36,71,123,133,256,14,9,23,7,2:52
11526,531042,2018-08-02,2018,TBA,ANA,4,2,4-2,TBA,9,1,33,31,64,133,130,263,9,4,13,0,2:29
11527,531043,2018-08-02,2018,PHI,MIA,5,2,5-2,PHI,9,0,34,31,65,118,143,261,10,5,15,0,2:37 (:33 delay)
11528,531040,2018-08-02,2018,SLN,COL,3,2,3-2,SLN,9,0,36,35,71,130,136,266,12,11,23,0,3:08
11529,531037,2018-08-02,2018,NYN,ATL,2,4,4-2,ATL,9,0,34,36,70,141,149,290,8,9,17,2,2:49
11530,531046,2018-08-02,2018,CHN,SDN,1,6,6-1,SDN,9,0,32,43,75,165,131,296,5,18,23,1,2:57
11531,531039,2018-08-02,2018,WAS,CIN,10,4,10-4,WAS,9,1,41,38,79,157,162,319,19,11,30,1,3:14
11532,531048,2018-08-02,2018,SEA,TOR,3,7,7-3,TOR,9,0,38,42,80,168,130,298,13,14,27,1,3:01
11533,531045,2018-08-02,2018,BOS,NYA,15,7,15-7,BOS,9,1,50,39,89,160,175,335,25,11,36,3,3:25
11534,531044,2018-08-02,2018,LAN,MIL,21,5,21-5,LAN,9,1,49,39,88,161,213,374,25,12,37,3,3:42
11535,531038,2018-08-02,2018,TEX,BAL,17,8,17-8,TEX,9,1,51,43,94,160,205,365,28,16,44,3,3:20
11536,531047,2018-08-02,2018,ARI,SFN,1,8,8-1,SFN,9,0,40,42,82,169,175,344,13,16,29,2,3:26
11537,531059,2018-08-03,2018,BOS,NYA,4,1,4-1,BOS,9,1,34,28,62,86,140,226,11,2,13,1,2:15
11538,531053,2018-08-03,2018,MIL,COL,5,3,5-3,MIL,9,0,34,34,68,113,141,254,8,8,16,1,2:46
11539,531057,2018-08-03,2018,CLE,ANA,4,7,7-4,ANA,9,0,38,41,79,147,144,291,11,18,29,3,3:10
11540,531055,2018-08-03,2018,LAN,HOU,1,2,2-1,HOU,9,0,32,36,68,142,127,269,5,10,15,1,2:59
11541,531049,2018-08-03,2018,NYN,ATL,1,2,2-1,ATL,9,0,32,33,65,117,138,255,5,7,12,0,2:26
11542,531051,2018-08-03,2018,TBA,CHA,2,3,3-2,CHA,10,0,38,37,75,163,158,321,13,10,23,6,3:33
11543,531050,2018-08-03,2018,TEX,BAL,11,3,11-3,TEX,9,1,40,37,77,145,163,308,15,12,27,1,3:03
11544,531063,2018-08-03,2018,SEA,TOR,2,7,7-2,TOR,9,0,34,38,72,111,134,245,6,11,17,0,2:23
11545,531060,2018-08-03,2018,CHN,SDN,5,4,5-4,CHN,9,1,36,38,74,158,133,291,13,10,23,3,3:06
11546,531056,2018-08-03,2018,MIN,KCA,6,4,6-4,MIN,9,1,39,37,76,154,171,325,17,11,28,3,3:21 (2:24 delay)
11547,531058,2018-08-03,2018,PHI,MIA,5,1,5-1,PHI,9,1,38,34,72,138,156,294,15,8,23,4,3:10
11548,531061,2018-08-03,2018,ARI,SFN,6,3,6-3,ARI,9,1,39,36,75,140,138,278,18,9,27,2,2:59
11549,531054,2018-08-03,2018,OAK,DET,1,0,1-0,OAK,13,0,45,44,89,167,182,349,10,7,17,0,3:32
11550,531062,2018-08-03,2018,PIT,SLN,7,6,7-6,PIT,9,1,38,49,87,187,135,322,14,25,39,2,3:34
11551,531069,2018-08-04,2018,OAK,DET,2,1,2-1,OAK,9,1,33,32,65,109,123,232,9,8,17,2,2:30
11552,531072,2018-08-04,2018,CLE,ANA,3,0,3-0,CLE,9,1,32,32,64,98,134,232,9,5,14,1,2:28
11553,531065,2018-08-04,2018,TEX,BAL,3,1,3-1,TEX,9,1,32,31,63,110,132,242,10,5,15,1,2:25
11554,531066,2018-08-04,2018,TBA,CHA,1,2,2-1,CHA,9,0,34,33,67,118,146,264,10,10,20,1,2:43
11555,531073,2018-08-04,2018,PHI,MIA,8,3,8-3,PHI,9,1,37,31,68,106,135,241,13,5,18,0,2:20
11556,531078,2018-08-04,2018,SEA,TOR,1,5,5-1,TOR,9,0,32,36,68,142,124,266,6,14,20,1,2:34
11557,531076,2018-08-04,2018,ARI,SFN,9,3,9-3,ARI,9,1,36,39,75,141,146,287,15,13,28,1,2:59
11558,531068,2018-08-04,2018,MIL,COL,8,4,8-4,MIL,9,1,37,37,74,169,135,304,15,11,26,2,3:09
11559,531052,2018-08-04,2018,WAS,CIN,1,7,7-1,CIN,9,0,36,44,80,174,133,307,10,18,28,2,2:58
11560,531064,2018-08-04,2018,NYN,ATL,3,0,3-0,NYN,9,1,35,32,67,128,127,255,12,6,18,2,2:41
11561,531067,2018-08-04,2018,WAS,CIN,6,2,6-2,WAS,9,1,39,35,74,137,123,260,18,9,27,2,3:05
11562,531075,2018-08-04,2018,CHN,SDN,5,4,5-4,CHN,9,1,38,33,71,134,134,268,15,7,22,1,2:38
11563,531077,2018-08-04,2018,PIT,SLN,4,8,8-4,SLN,9,0,38,47,85,188,129,317,14,22,36,1,3:21
11564,531070,2018-08-04,2018,LAN,HOU,0,14,14-0,HOU,9,0,33,46,79,170,153,323,9,21,30,3,3:37
11565,531071,2018-08-04,2018,MIN,KCA,8,2,8-2,MIN,9,1,39,36,75,138,160,298,15,9,24,1,2:45
11566,531052,2018-08-04,2018,WAS,CIN,1,7,7-1,CIN,9,0,36,44,80,174,133,307,10,18,28,2,2:58
11567,531074,2018-08-04,2018,BOS,NYA,4,1,4-1,BOS,9,1,31,33,64,125,136,261,8,8,16,0,2:33
11568,531093,2018-08-05,2018,SEA,TOR,6,3,6-3,SEA,9,1,37,35,72,112,127,239,13,10,23,3,2:37
11569,531087,2018-08-05,2018,CLE,ANA,4,3,4-3,CLE,9,1,34,41,75,138,126,264,13,14,27,5,3:06
11570,531084,2018-08-05,2018,OAK,DET,6,0,6-0,OAK,9,1,35,34,69,134,144,278,12,7,19,0,2:41
11571,531092,2018-08-05,2018,PIT,SLN,1,2,2-1,SLN,9,0,34,38,72,148,132,280,8,11,19,2,2:58
11572,531082,2018-08-05,2018,WAS,CIN,2,1,2-1,WAS,9,1,34,33,67,112,127,239,12,7,19,2,2:39
11573,531085,2018-08-05,2018,LAN,HOU,3,2,3-2,LAN,9,1,32,35,67,134,141,275,8,11,19,1,2:54
11574,531091,2018-08-05,2018,ARI,SFN,2,3,3-2,SFN,9,0,35,35,70,155,151,306,9,12,21,4,3:15
11575,531079,2018-08-05,2018,NYN,ATL,4,5,5-4,ATL,10,0,42,42,84,158,162,320,14,12,26,4,3:19
11576,531086,2018-08-05,2018,MIN,KCA,6,5,6-5,MIN,9,1,35,41,76,147,135,282,13,14,27,3,2:53
11577,531081,2018-08-05,2018,TBA,CHA,7,8,8-7,CHA,9,0,44,41,85,165,184,349,18,15,33,5,3:38
11578,531089,2018-08-05,2018,BOS,NYA,5,4,5-4,BOS,10,0,47,44,91,183,215,398,18,13,31,3,4:39
11579,531090,2018-08-05,2018,CHN,SDN,6,10,10-6,SDN,9,0,39,45,84,185,161,346,13,21,34,2,3:29
11580,531088,2018-08-05,2018,PHI,MIA,5,3,5-3,PHI,9,1,35,39,74,125,163,288,13,11,24,2,3:15
11581,531083,2018-08-05,2018,MIL,COL,4,5,5-4,COL,11,0,43,49,92,167,147,314,11,15,26,0,3:35
11582,531080,2018-08-05,2018,TEX,BAL,6,9,9-6,BAL,9,0,42,38,80,149,192,341,15,14,29,3,3:19
11583,531101,2018-08-06,2018,COL,PIT,2,0,2-0,COL,9,1,30,32,62,128,99,227,6,6,12,0,2:33 (:32 delay)
11584,531097,2018-08-06,2018,SFN,HOU,1,3,3-1,HOU,9,0,33,33,66,130,121,251,7,7,14,0,2:26
11585,531099,2018-08-06,2018,CHA,NYA,0,7,7-0,NYA,9,0,32,41,73,149,140,289,5,14,19,2,2:59
11586,531103,2018-08-06,2018,MIA,SLN,2,1,2-1,MIA,9,1,31,38,69,180,111,291,8,11,19,2,3:04
11587,531095,2018-08-06,2018,NYN,CIN,6,4,6-4,NYN,9,1,39,38,77,144,135,279,17,11,28,3,3:05
11588,531094,2018-08-06,2018,KCA,CHN,1,3,3-1,CHN,9,0,35,38,73,144,125,269,10,14,24,2,2:52 (:22 delay)
11589,531098,2018-08-06,2018,CLE,MIN,10,0,10-0,CLE,9,1,39,33,72,143,157,300,17,6,23,0,2:52
11590,531102,2018-08-06,2018,TEX,SEA,3,4,4-3,SEA,12,0,46,52,98,175,171,346,10,18,28,4,3:54
11591,531100,2018-08-06,2018,ARI,PHI,3,2,3-2,ARI,14,0,57,53,110,181,213,394,19,15,34,3,4:38
11592,531096,2018-08-06,2018,ANA,DET,6,2,6-2,ANA,9,1,34,32,66,131,141,272,11,7,18,3,2:53
11593,530873,2018-08-07,2018,WAS,ATL,8,3,8-3,WAS,9,1,42,36,78,133,161,294,20,9,29,1,3:08
11594,531115,2018-08-07,2018,COL,PIT,2,10,10-2,PIT,9,0,36,39,75,144,107,251,11,12,23,1,2:34
11595,531110,2018-08-07,2018,SFN,HOU,1,2,2-1,HOU,9,0,35,38,73,139,144,283,8,13,21,2,3:02
11596,531117,2018-08-07,2018,TEX,SEA,11,4,11-4,TEX,9,1,39,36,75,127,110,237,16,10,26,0,2:26
11597,531104,2018-08-07,2018,WAS,ATL,1,3,3-1,ATL,9,0,35,36,71,139,145,284,10,10,20,2,2:54
11598,531107,2018-08-07,2018,KCA,CHN,0,5,5-0,CHN,9,0,36,39,75,147,143,290,9,14,23,1,2:49
11599,530873,2018-08-07,2018,WAS,ATL,8,3,8-3,WAS,9,1,42,36,78,133,161,294,20,9,29,1,3:08
11600,531109,2018-08-07,2018,ANA,DET,11,5,11-5,ANA,9,1,44,36,80,133,164,297,20,12,32,1,3:08
11601,531118,2018-08-07,2018,MIA,SLN,2,3,3-2,SLN,9,0,33,35,68,151,105,256,7,8,15,0,2:34
11602,531111,2018-08-07,2018,OAK,LAN,2,4,4-2,LAN,9,0,34,42,76,175,147,322,8,16,24,4,3:21
11603,531108,2018-08-07,2018,NYN,CIN,1,6,6-1,CIN,9,0,35,38,73,150,124,274,9,11,20,2,2:43 (1:40 delay)
11604,531112,2018-08-07,2018,CLE,MIN,2,3,3-2,MIN,9,0,37,39,76,130,139,269,10,14,24,1,2:53 (2:10 delay)
11605,531105,2018-08-07,2018,TBA,BAL,4,3,4-3,TBA,9,0,36,34,70,140,148,288,11,9,20,3,2:51
11606,531106,2018-08-07,2018,TOR,BOS,7,10,10-7,BOS,10,0,47,43,90,150,177,327,19,14,33,2,3:27
11607,531116,2018-08-07,2018,MIL,SDN,5,11,11-5,SDN,9,0,39,48,87,187,147,334,13,20,33,3,3:23
11608,531113,2018-08-07,2018,CHA,NYA,3,4,4-3,NYA,13,0,51,52,103,206,207,413,12,14,26,4,4:26
11609,531114,2018-08-07,2018,ARI,PHI,2,5,5-2,PHI,9,0,34,40,74,155,133,288,10,13,23,2,3:08
11610,531124,2018-08-08,2018,ANA,DET,6,0,6-0,ANA,9,1,33,33,66,135,132,267,11,6,17,1,2:45
11611,531132,2018-08-08,2018,MIA,SLN,1,7,7-1,SLN,9,0,31,39,70,157,103,260,4,16,20,2,2:42
11612,531125,2018-08-08,2018,OAK,LAN,3,2,3-2,OAK,9,1,33,36,69,143,136,279,8,9,17,2,3:00
11613,531119,2018-08-08,2018,WAS,ATL,3,8,8-3,ATL,9,0,41,39,80,117,164,281,13,12,25,1,3:04
11614,531120,2018-08-08,2018,TBA,BAL,4,5,5-4,BAL,9,0,38,36,74,139,137,276,9,9,18,2,2:52
11615,531122,2018-08-08,2018,KCA,CHN,9,0,9-0,KCA,9,1,37,31,68,114,136,250,13,5,18,1,2:31
11616,531130,2018-08-08,2018,MIL,SDN,8,4,8-4,MIL,9,1,38,38,76,159,142,301,14,11,25,0,2:55
11617,531129,2018-08-08,2018,COL,PIT,3,4,4-3,PIT,9,0,39,43,82,137,166,303,13,18,31,1,3:22
11618,531121,2018-08-08,2018,TOR,BOS,5,10,10-5,BOS,9,0,38,45,83,171,131,302,11,22,33,2,3:02
11619,531128,2018-08-08,2018,ARI,PHI,6,0,6-0,ARI,9,1,39,30,69,128,144,272,17,5,22,2,2:58
11620,531127,2018-08-08,2018,CHA,NYA,3,7,7-3,NYA,9,0,36,42,78,175,155,330,10,14,24,1,3:05
11621,531123,2018-08-08,2018,NYN,CIN,8,0,8-0,NYN,9,1,44,33,77,140,180,320,21,8,29,3,3:08
11622,531126,2018-08-08,2018,CLE,MIN,5,2,5-2,CLE,9,0,37,36,73,141,158,299,12,10,22,2,3:21
11623,531131,2018-08-08,2018,TEX,SEA,11,7,11-7,TEX,9,1,45,38,83,155,149,304,21,12,33,3,3:13
11624,531141,2018-08-09,2018,NYA,TEX,7,3,7-3,NYA,9,1,34,38,72,146,115,261,12,11,23,0,2:31
11625,531134,2018-08-09,2018,TBA,BAL,5,4,5-4,TBA,9,1,34,33,67,126,154,280,11,9,20,2,2:41
11626,531133,2018-08-09,2018,WAS,ATL,6,3,6-3,WAS,9,1,37,36,73,120,138,258,15,11,26,0,2:30
11627,531136,2018-08-09,2018,COL,LAN,5,8,8-5,LAN,9,0,36,42,78,171,142,313,14,15,29,3,3:29
11628,531139,2018-08-09,2018,MIL,SDN,4,8,8-4,SDN,9,0,37,42,79,165,142,307,11,19,30,3,3:14
11629,531138,2018-08-09,2018,SFN,PIT,5,10,10-5,PIT,9,0,36,42,78,178,140,318,8,15,23,1,3:00
11630,531135,2018-08-09,2018,TOR,BOS,8,5,8-5,TOR,9,1,37,39,76,160,138,298,15,14,29,1,2:49
11631,531140,2018-08-09,2018,HOU,SEA,6,8,8-6,SEA,9,0,42,42,84,166,162,328,14,16,30,3,3:36
11632,531137,2018-08-09,2018,CLE,MIN,5,4,5-4,CLE,9,0,38,33,71,140,153,293,14,7,21,2,2:58
11633,531154,2018-08-10,2018,TOR,TBA,0,7,7-0,TBA,9,0,30,39,69,142,103,245,4,12,16,1,2:27
11634,531150,2018-08-10,2018,SDN,PHI,2,0,2-0,SDN,9,1,30,37,67,137,114,251,9,11,20,1,2:34
11635,531144,2018-08-10,2018,CHA,CLE,1,0,1-0,CHA,9,0,31,35,66,132,131,263,7,8,15,4,2:46
11636,531152,2018-08-10,2018,HOU,SEA,2,5,5-2,SEA,9,0,36,36,72,116,142,258,11,9,20,1,2:48
11637,531148,2018-08-10,2018,MIA,NYN,2,6,6-2,NYN,9,0,34,41,75,149,134,283,7,15,22,2,2:44
11638,531156,2018-08-10,2018,CHN,WAS,3,2,3-2,CHN,9,1,33,38,71,145,127,272,10,12,22,5,3:10
11639,531147,2018-08-10,2018,DET,MIN,5,3,5-3,DET,9,1,31,37,68,137,124,261,7,10,17,1,2:37
11640,531142,2018-08-10,2018,CIN,ARI,3,0,3-0,CIN,9,1,34,30,64,118,109,227,12,5,17,1,2:30
11641,531155,2018-08-10,2018,NYA,TEX,7,12,12-7,TEX,9,0,40,46,86,190,160,350,13,19,32,3,3:34
11642,531153,2018-08-10,2018,KCA,SLN,0,7,7-0,SLN,9,0,38,42,80,158,156,314,12,16,28,2,3:04
11643,531146,2018-08-10,2018,ATL,MIL,10,1,10-1,ATL,9,1,45,33,78,106,184,290,22,6,28,2,2:59
11644,531143,2018-08-10,2018,BAL,BOS,12,19,19-12,BOS,9,0,47,53,100,185,180,365,21,28,49,5,4:01
11645,531145,2018-08-10,2018,COL,LAN,5,4,5-4,COL,9,1,38,39,77,152,154,306,12,13,25,4,3:31
11646,531151,2018-08-10,2018,SFN,PIT,13,10,13-10,SFN,9,1,51,46,97,181,183,364,29,19,48,3,3:44
11647,531149,2018-08-10,2018,ANA,OAK,4,3,4-3,ANA,9,1,30,33,63,129,104,233,7,7,14,3,2:22 (:27 delay)
11648,530932,2018-08-11,2018,BAL,BOS,0,5,5-0,BOS,9,0,32,38,70,135,132,267,5,12,17,1,2:48
11649,531166,2018-08-11,2018,SFN,PIT,0,4,4-0,PIT,9,0,31,34,65,125,124,249,7,8,15,0,2:18 (:16 delay)
11650,531167,2018-08-11,2018,HOU,SEA,2,3,3-2,SEA,9,0,34,35,69,136,138,274,8,12,20,3,2:56
11651,531161,2018-08-11,2018,ATL,MIL,2,4,4-2,MIL,9,0,33,39,72,133,119,252,8,12,20,1,2:42
11652,531168,2018-08-11,2018,KCA,SLN,3,8,8-3,SLN,9,0,34,40,74,158,140,298,10,14,24,2,2:56
11653,530932,2018-08-11,2018,BAL,BOS,0,5,5-0,BOS,9,0,32,38,70,135,132,267,5,12,17,1,2:48
11654,531162,2018-08-11,2018,DET,MIN,3,4,4-3,MIN,9,0,37,41,78,163,147,310,12,15,27,0,3:09
11655,531159,2018-08-11,2018,CHA,CLE,1,3,3-1,CLE,9,0,32,37,69,135,148,283,5,10,15,2,2:53
11656,531160,2018-08-11,2018,COL,LAN,3,2,3-2,COL,9,0,34,35,69,144,141,285,10,9,19,1,2:54
11657,531170,2018-08-11,2018,NYA,TEX,5,3,5-3,NYA,9,1,35,41,76,183,124,307,12,15,27,3,3:16
11658,531157,2018-08-11,2018,CIN,ARI,6,3,6-3,CIN,9,1,39,34,73,131,167,298,18,8,26,3,3:04 (:40 delay)
11659,531158,2018-08-11,2018,BAL,BOS,4,6,6-4,BOS,9,0,41,38,79,167,174,341,16,14,30,2,3:39 (:20 delay)
11660,531163,2018-08-11,2018,MIA,NYN,4,3,4-3,MIA,11,0,45,44,89,190,159,349,15,15,30,1,3:26
11661,531164,2018-08-11,2018,ANA,OAK,0,7,7-0,OAK,9,0,35,43,78,136,137,273,9,17,26,2,3:08
11662,531171,2018-08-11,2018,CHN,WAS,4,9,9-4,WAS,9,0,39,45,84,184,140,324,14,18,32,2,3:11
11663,531165,2018-08-11,2018,SDN,PHI,1,5,5-1,PHI,9,0,38,37,75,161,153,314,12,10,22,2,3:12
11664,531169,2018-08-11,2018,TOR,TBA,1,3,3-1,TBA,9,0,33,37,70,148,132,280,10,11,21,2,2:56
11665,531184,2018-08-12,2018,TOR,TBA,2,1,2-1,TOR,9,1,28,34,62,124,116,240,7,8,15,3,2:34
11666,531172,2018-08-12,2018,CIN,ARI,2,9,9-2,ARI,9,0,33,40,73,154,128,282,8,13,21,3,2:53
11667,531185,2018-08-12,2018,NYA,TEX,7,2,7-2,NYA,9,1,35,39,74,166,125,291,12,11,23,2,2:59
11668,531178,2018-08-12,2018,MIA,NYN,3,4,4-3,NYN,9,0,39,34,73,145,133,278,12,7,19,0,2:56
11669,531175,2018-08-12,2018,COL,LAN,4,3,4-3,COL,9,0,34,38,72,126,125,251,11,12,23,2,2:48
11670,531182,2018-08-12,2018,HOU,SEA,3,4,4-3,SEA,10,0,39,39,78,146,144,290,11,12,23,3,3:10
11671,531177,2018-08-12,2018,DET,MIN,4,2,4-2,DET,9,1,34,32,66,133,118,251,12,5,17,3,2:33 (:22 delay)
11672,531173,2018-08-12,2018,BAL,BOS,1,4,4-1,BOS,9,0,37,38,75,146,162,308,10,12,22,2,3:04
11673,531181,2018-08-12,2018,SFN,PIT,4,3,4-3,SFN,9,1,33,33,66,145,112,257,8,6,14,1,2:40
11674,531180,2018-08-12,2018,SDN,PHI,9,3,9-3,SDN,9,1,39,36,75,158,150,308,15,11,26,2,3:20
11675,531186,2018-08-12,2018,CHN,WAS,4,3,4-3,CHN,9,0,35,33,68,130,139,269,10,7,17,1,2:56
11676,531174,2018-08-12,2018,CHA,CLE,7,9,9-7,CLE,9,0,38,46,84,206,139,345,10,20,30,4,3:31
11677,531183,2018-08-12,2018,KCA,SLN,2,8,8-2,SLN,9,0,34,43,77,170,132,302,8,17,25,3,3:04
11678,531176,2018-08-12,2018,ATL,MIL,8,7,8-7,ATL,9,1,36,47,83,167,137,304,12,24,36,1,3:19
11679,531179,2018-08-12,2018,ANA,OAK,7,8,8-7,OAK,9,0,43,44,87,185,178,363,16,18,34,6,3:49
11680,530898,2018-08-13,2018,NYA,NYN,5,8,8-5,NYN,9,0,37,44,81,189,153,342,10,18,28,2,3:18
11681,531033,2018-08-13,2018,ATL,MIA,9,1,9-1,ATL,9,1,39,35,74,145,143,288,17,10,27,1,2:39
11682,531194,2018-08-13,2018,SLN,WAS,7,6,7-6,SLN,9,0,41,37,78,146,138,284,20,11,31,5,3:19
11683,531190,2018-08-13,2018,ATL,MIA,6,1,6-1,ATL,9,1,37,33,70,134,165,299,15,9,24,1,2:58
11684,531193,2018-08-13,2018,KCA,TOR,3,1,3-1,KCA,9,1,32,32,64,140,149,289,12,9,21,0,2:42
11685,531189,2018-08-13,2018,SDN,ANA,3,6,6-3,ANA,10,0,38,40,78,119,140,259,8,10,18,1,2:47
11686,531191,2018-08-13,2018,LAN,SFN,2,5,5-2,SFN,9,0,37,36,73,141,150,291,11,9,20,1,3:05
11687,530898,2018-08-13,2018,NYA,NYN,5,8,8-5,NYN,9,0,37,44,81,189,153,342,10,18,28,2,3:18
11688,531187,2018-08-13,2018,DET,CHA,9,5,9-5,DET,9,1,40,40,80,153,170,323,18,15,33,3,3:35
11689,531195,2018-08-13,2018,TEX,ARI,5,3,5-3,TEX,9,1,35,34,69,128,142,270,11,7,18,2,2:51
11690,531033,2018-08-13,2018,ATL,MIA,9,1,9-1,ATL,9,1,39,35,74,145,143,288,17,10,27,1,2:39
11691,531192,2018-08-13,2018,OAK,SEA,7,6,7-6,OAK,9,1,39,40,79,143,157,300,16,16,32,3,3:09
11692,531188,2018-08-13,2018,CIN,CLE,3,10,10-3,CLE,9,0,42,48,90,165,164,329,16,23,39,1,3:24
11693,531196,2018-08-14,2018,PHI,BOS,1,2,2-1,BOS,9,0,30,34,64,129,126,255,3,8,11,0,2:40
11694,531207,2018-08-14,2018,NYA,TBA,4,1,4-1,NYA,9,1,34,33,67,130,145,275,11,8,19,0,2:32 (:21 delay)
11695,531199,2018-08-14,2018,HOU,COL,1,5,5-1,COL,9,0,33,41,74,167,130,297,7,14,21,2,3:08
11696,531205,2018-08-14,2018,LAN,SFN,1,2,2-1,SFN,9,0,35,35,70,147,147,294,8,10,18,1,3:09
11697,531198,2018-08-14,2018,CIN,CLE,1,8,8-1,CLE,9,0,32,40,72,146,121,267,7,15,22,1,2:37
11698,531208,2018-08-14,2018,KCA,TOR,5,6,6-5,TOR,9,0,40,39,79,149,153,302,17,14,31,1,3:06 (:31 delay)
11699,531206,2018-08-14,2018,OAK,SEA,3,2,3-2,OAK,9,1,33,34,67,110,120,230,12,9,21,2,2:28
11700,531197,2018-08-14,2018,DET,CHA,3,6,6-3,CHA,9,0,39,36,75,124,166,290,11,9,20,1,3:01
11701,531202,2018-08-14,2018,CHN,MIL,0,7,7-0,MIL,9,0,32,39,71,147,142,289,5,13,18,0,2:42
11702,531201,2018-08-14,2018,ATL,MIA,10,6,10-6,ATL,9,1,41,42,83,150,141,291,17,15,32,1,2:52
11703,531209,2018-08-14,2018,SLN,WAS,6,4,6-4,SLN,9,1,37,38,75,164,142,306,13,11,24,2,3:12
11704,531210,2018-08-14,2018,TEX,ARI,4,6,6-4,ARI,9,0,35,41,76,174,136,310,9,16,25,2,3:08
11705,531204,2018-08-14,2018,MIN,PIT,5,2,5-2,MIN,9,1,34,36,70,153,127,280,11,10,21,2,2:45
11706,531203,2018-08-14,2018,BAL,NYN,6,3,6-3,BAL,9,1,37,36,73,131,140,271,16,10,26,3,2:38
11707,531200,2018-08-14,2018,SDN,ANA,3,7,7-3,ANA,9,0,36,39,75,169,155,324,11,15,26,1,3:14
11708,531224,2018-08-15,2018,SLN,WAS,4,2,4-2,SLN,9,1,36,37,73,142,135,277,13,11,24,3,3:07
11709,531219,2018-08-15,2018,MIN,PIT,6,4,6-4,MIN,9,1,34,43,77,178,143,321,10,17,27,3,3:18
11710,531215,2018-08-15,2018,SDN,ANA,2,3,3-2,ANA,9,0,34,36,70,127,135,262,8,10,18,0,2:43
11711,531217,2018-08-15,2018,CHN,MIL,8,4,8-4,CHN,9,1,41,40,81,137,142,279,18,13,31,5,3:12
11712,531212,2018-08-15,2018,DET,CHA,5,6,6-5,CHA,9,0,36,41,77,143,132,275,11,13,24,1,2:54
11713,531216,2018-08-15,2018,ATL,MIA,5,2,5-2,ATL,9,1,35,32,67,135,107,242,11,6,17,1,2:50
11714,531222,2018-08-15,2018,NYA,TBA,1,6,6-1,TBA,9,0,38,42,80,164,143,307,11,16,27,3,3:17
11715,531221,2018-08-15,2018,OAK,SEA,0,2,2-0,SEA,12,0,44,47,91,159,161,320,10,12,22,4,3:13
11716,531211,2018-08-15,2018,PHI,BOS,7,4,7-4,PHI,9,1,39,40,79,159,146,305,14,15,29,3,3:27
11717,531220,2018-08-15,2018,LAN,SFN,4,3,4-3,LAN,12,0,55,44,99,164,202,366,28,9,37,2,4:05
11718,531223,2018-08-15,2018,KCA,TOR,5,6,6-5,TOR,9,0,35,41,76,146,126,272,9,15,24,2,2:39 (:15 delay)
11719,531214,2018-08-15,2018,HOU,COL,12,1,12-1,HOU,9,1,38,32,70,136,137,273,15,6,21,2,2:43
11720,531218,2018-08-15,2018,BAL,NYN,5,16,16-5,NYN,9,0,42,52,94,179,163,342,16,26,42,3,3:27
11721,531213,2018-08-15,2018,CIN,CLE,3,4,4-3,CLE,9,0,41,36,77,149,175,324,14,11,25,4,3:25
11722,529994,2018-08-16,2018,PHI,NYN,9,6,9-6,PHI,9,1,39,42,81,149,152,301,16,14,30,2,3:03
11723,531232,2018-08-16,2018,KCA,TOR,6,2,6-2,KCA,9,1,37,36,73,151,121,272,15,11,26,2,2:43 (2:14 delay)
11724,531229,2018-08-16,2018,TEX,ANA,8,6,8-6,TEX,9,1,39,36,75,114,151,265,15,12,27,2,2:53
11725,531231,2018-08-16,2018,NYA,TBA,1,3,3-1,TBA,9,0,36,37,73,139,149,288,9,12,21,3,3:22
11726,531226,2018-08-16,2018,PIT,CHN,0,1,1-0,CHN,9,0,32,36,68,138,140,278,7,9,16,1,2:48
11727,531227,2018-08-16,2018,ATL,COL,3,5,5-3,COL,9,0,33,38,71,138,129,267,8,10,18,1,2:53
11728,531233,2018-08-16,2018,SLN,WAS,4,5,5-4,WAS,9,0,38,44,82,174,148,322,11,14,25,1,3:28
11729,531230,2018-08-16,2018,PHI,NYN,4,24,24-4,NYN,9,0,38,61,99,177,146,323,11,34,45,2,3:01
11730,531225,2018-08-16,2018,SDN,ARI,1,5,5-1,ARI,9,0,32,43,75,192,112,304,5,16,21,2,3:00
11731,529994,2018-08-16,2018,PHI,NYN,9,6,9-6,PHI,9,1,39,42,81,149,152,301,16,14,30,2,3:03
11732,531228,2018-08-16,2018,MIN,DET,15,8,15-8,MIN,9,1,45,43,88,166,183,349,20,16,36,3,3:35
11733,531236,2018-08-17,2018,PIT,CHN,0,1,1-0,CHN,9,0,31,36,67,133,126,259,11,10,21,2,2:53 (1:47 delay)
11734,531248,2018-08-17,2018,NYA,TOR,7,5,7-5,NYA,7,0,30,30,60,131,127,258,11,10,21,2,2:32 (1:25 delay)
11735,531235,2018-08-17,2018,CLE,BAL,2,1,2-1,CLE,9,1,32,35,67,164,113,277,11,7,18,1,2:39
11736,531241,2018-08-17,2018,TEX,ANA,6,4,6-4,TEX,9,1,34,37,71,141,138,279,12,11,23,1,2:56
11737,531245,2018-08-17,2018,PHI,NYN,4,2,4-2,PHI,9,1,35,35,70,154,146,300,13,8,21,2,3:21
11738,531240,2018-08-17,2018,CHA,KCA,9,3,9-3,CHA,9,1,40,34,74,130,155,285,15,9,24,3,2:57
11739,531242,2018-08-17,2018,SEA,LAN,1,11,11-1,LAN,9,0,34,42,76,153,130,283,6,16,22,1,2:44
11740,531244,2018-08-17,2018,SLN,MIL,5,2,5-2,SLN,9,1,36,37,73,147,144,291,13,12,25,1,3:07
11741,531238,2018-08-17,2018,MIN,DET,5,4,5-4,MIN,9,1,31,37,68,146,115,261,7,15,22,2,2:43
11742,531247,2018-08-17,2018,BOS,TBA,7,3,7-3,BOS,9,1,37,35,72,142,131,273,13,10,23,1,2:47 (:10 delay)
11743,531239,2018-08-17,2018,OAK,HOU,4,3,4-3,OAK,10,0,41,39,80,168,169,337,15,11,26,0,3:33
11744,531234,2018-08-17,2018,SDN,ARI,4,9,9-4,ARI,9,0,41,45,86,193,173,366,13,20,33,2,3:46
11745,531237,2018-08-17,2018,ATL,COL,5,11,11-5,COL,9,0,42,48,90,180,170,350,16,22,38,1,3:37
11746,531243,2018-08-17,2018,WAS,MIA,8,2,8-2,WAS,9,1,38,35,73,151,141,292,15,10,25,2,3:03
11747,531246,2018-08-17,2018,CIN,SFN,2,1,2-1,CIN,11,0,41,41,82,144,142,286,13,9,22,2,3:04
11748,531250,2018-08-18,2018,CLE,BAL,2,4,4-2,BAL,9,0,30,34,64,136,100,236,6,7,13,0,2:17
11749,531254,2018-08-18,2018,OAK,HOU,7,1,7-1,OAK,9,1,37,29,66,133,124,257,13,3,16,1,2:33
11750,531255,2018-08-18,2018,CHA,KCA,1,3,3-1,KCA,9,0,36,37,73,144,156,300,10,11,21,5,3:06
11751,531253,2018-08-18,2018,MIN,DET,5,7,7-5,DET,9,0,41,42,83,175,169,344,14,14,28,3,3:29
11752,531249,2018-08-18,2018,SDN,ARI,7,6,7-6,SDN,9,0,41,38,79,118,157,275,16,12,28,2,2:54
11753,531261,2018-08-18,2018,CIN,SFN,7,1,7-1,CIN,9,1,36,36,72,137,122,259,13,9,22,2,2:35
11754,531251,2018-08-18,2018,PIT,CHN,3,1,3-1,PIT,9,1,34,34,68,110,128,238,12,6,18,1,2:40
11755,531262,2018-08-18,2018,BOS,TBA,5,2,5-2,BOS,9,1,30,35,65,123,110,233,7,8,15,1,2:28
11756,531259,2018-08-18,2018,SLN,MIL,7,2,7-2,SLN,9,1,36,34,70,139,159,298,10,7,17,0,2:54
11757,531260,2018-08-18,2018,PHI,NYN,1,3,3-1,NYN,9,0,32,36,68,151,108,259,7,8,15,0,2:31 (:41 delay)
11758,531263,2018-08-18,2018,NYA,TOR,11,6,11-6,NYA,9,1,41,42,83,182,161,343,16,17,33,5,3:29 (:24 delay)
11759,531256,2018-08-18,2018,TEX,ANA,7,11,11-7,ANA,9,0,43,45,88,157,175,332,17,19,36,1,3:28 (2:26 delay)
11760,531258,2018-08-18,2018,WAS,MIA,5,7,7-5,MIA,10,0,41,45,86,154,169,323,12,17,29,5,3:37
11761,531252,2018-08-18,2018,ATL,COL,3,5,5-3,COL,10,0,38,43,81,176,145,321,12,15,27,2,3:31
11762,531257,2018-08-18,2018,SEA,LAN,5,4,5-4,SEA,10,0,40,41,81,176,168,344,14,12,26,3,3:36
11763,531274,2018-08-19,2018,SLN,MIL,1,2,2-1,MIL,9,0,33,36,69,148,123,271,6,13,19,1,2:54
11764,531269,2018-08-19,2018,OAK,HOU,4,9,9-4,HOU,9,0,36,38,74,142,153,295,10,13,23,3,3:07
11765,531275,2018-08-19,2018,PHI,NYN,2,8,8-2,NYN,9,0,35,40,75,163,144,307,8,16,24,2,3:11
11766,531273,2018-08-19,2018,WAS,MIA,1,12,12-1,MIA,9,0,30,50,80,172,108,280,4,22,26,1,2:40
11767,531270,2018-08-19,2018,CHA,KCA,7,6,7-6,CHA,9,1,37,39,76,166,143,309,15,12,27,4,3:11
11768,531267,2018-08-19,2018,ATL,COL,2,4,4-2,COL,9,0,35,36,71,141,127,268,8,10,18,1,2:41
11769,531276,2018-08-19,2018,CIN,SFN,11,4,11-4,CIN,9,1,43,36,79,131,170,301,20,8,28,3,2:50
11770,531264,2018-08-19,2018,SDN,ARI,3,4,4-3,ARI,9,0,36,41,77,161,158,319,10,16,26,1,3:09
11771,531278,2018-08-19,2018,NYA,TOR,10,2,10-2,NYA,9,1,42,38,80,164,163,327,20,12,32,3,3:18
11772,531277,2018-08-19,2018,BOS,TBA,0,2,2-0,TBA,9,0,30,36,66,139,138,277,4,10,14,2,2:47
11773,531271,2018-08-19,2018,TEX,ANA,4,2,4-2,TEX,9,1,35,32,67,120,136,256,14,8,22,0,2:35 (1:14 delay)
11774,531272,2018-08-19,2018,SEA,LAN,1,12,12-1,LAN,9,0,33,51,84,210,115,325,6,23,29,0,3:12
11775,531265,2018-08-19,2018,CLE,BAL,8,0,8-0,CLE,9,1,41,34,75,137,162,299,18,11,29,2,2:56
11776,531268,2018-08-19,2018,MIN,DET,5,4,5-4,MIN,9,1,33,40,73,178,133,311,10,14,24,4,3:16
11777,531266,2018-08-19,2018,PIT,CHN,2,1,2-1,PIT,11,0,45,45,90,172,173,345,15,17,32,3,3:41
11778,529630,2018-08-20,2018,MIN,CHA,5,8,8-5,CHA,9,0,37,45,82,176,162,338,10,18,28,1,3:24 (:33 delay)
11779,531281,2018-08-20,2018,MIL,CIN,5,2,5-2,MIL,9,1,38,30,68,115,136,251,15,4,19,2,2:38
11780,531287,2018-08-20,2018,OAK,TEX,9,0,9-0,OAK,9,1,42,31,73,125,159,284,18,5,23,1,2:48
11781,531282,2018-08-20,2018,BOS,CLE,4,5,5-4,CLE,9,0,42,35,77,132,166,298,16,8,24,3,3:01
11782,531283,2018-08-20,2018,SEA,HOU,7,4,7-4,SEA,9,1,41,34,75,136,157,293,17,7,24,1,3:05
11783,531286,2018-08-20,2018,LAN,SLN,3,5,5-3,SLN,9,0,44,41,85,163,186,349,19,15,34,4,4:10
11784,529630,2018-08-20,2018,MIN,CHA,5,8,8-5,CHA,9,0,37,45,82,176,162,338,10,18,28,1,3:24 (:33 delay)
11785,531279,2018-08-20,2018,PIT,ATL,0,1,1-0,ATL,9,0,35,37,72,154,151,305,11,14,25,2,3:10
11786,531280,2018-08-20,2018,TOR,BAL,5,3,5-3,TOR,9,1,34,38,72,138,131,269,11,11,22,2,2:34
11787,531284,2018-08-20,2018,TBA,KCA,1,0,1-0,TBA,9,1,34,34,68,126,149,275,12,8,20,2,2:49
11788,531285,2018-08-20,2018,NYN,SFN,1,2,2-1,SFN,13,0,50,50,100,189,222,411,12,10,22,2,4:20
11789,531290,2018-08-21,2018,DET,CHN,2,1,2-1,DET,9,1,32,38,70,150,108,258,12,11,23,0,2:45
11790,531292,2018-08-21,2018,BOS,CLE,3,6,6-3,CLE,9,0,32,42,74,161,118,279,5,17,22,2,2:57
11791,531299,2018-08-21,2018,COL,SDN,3,4,4-3,SDN,9,0,35,40,75,149,108,257,9,12,21,2,2:34
11792,531288,2018-08-21,2018,PIT,ATL,1,6,6-1,ATL,9,0,33,39,72,150,117,267,7,12,19,0,2:36 (:41 delay)
11793,531300,2018-08-21,2018,NYN,SFN,6,3,6-3,NYN,9,1,32,33,65,141,112,253,11,6,17,1,2:24
11794,531289,2018-08-21,2018,TOR,BAL,8,2,8-2,TOR,9,1,37,36,73,135,131,266,14,9,23,2,2:39
11795,531295,2018-08-21,2018,ARI,ANA,5,4,5-4,ARI,9,0,37,38,75,147,125,272,14,12,26,2,2:54
11796,531291,2018-08-21,2018,MIL,CIN,7,9,9-7,CIN,9,0,43,42,85,155,171,326,17,16,33,4,3:22
11797,531301,2018-08-21,2018,LAN,SLN,2,5,5-2,SLN,9,0,40,38,78,139,166,305,14,12,26,3,3:25
11798,531294,2018-08-21,2018,TBA,KCA,4,1,4-1,TBA,9,1,40,36,76,163,154,317,17,10,27,0,3:03
11799,531296,2018-08-21,2018,CHA,MIN,2,5,5-2,MIN,9,0,33,39,72,178,130,308,9,16,25,3,3:16 (:52 delay)
11800,531302,2018-08-21,2018,OAK,TEX,6,0,6-0,OAK,9,1,38,30,68,127,125,252,14,4,18,1,2:26
11801,531298,2018-08-21,2018,WAS,PHI,10,4,10-4,WAS,9,1,44,39,83,149,155,304,22,11,33,5,3:16 (1:42 delay)
11802,531293,2018-08-21,2018,SEA,HOU,2,3,3-2,HOU,9,0,39,35,74,116,153,269,13,14,27,2,2:56
11803,531297,2018-08-21,2018,MIA,NYA,1,2,2-1,NYA,12,0,47,50,97,197,198,395,15,15,30,1,4:14
11804,531315,2018-08-22,2018,NYN,SFN,5,3,5-3,NYN,9,1,37,35,72,152,125,277,11,8,19,2,2:44
11805,531303,2018-08-22,2018,PIT,ATL,1,2,2-1,ATL,9,0,31,35,66,123,120,243,5,9,14,1,2:36
11806,531317,2018-08-22,2018,OAK,TEX,2,4,4-2,TEX,9,0,35,40,75,151,139,290,10,14,24,2,3:03
11807,531310,2018-08-22,2018,ARI,ANA,5,1,5-1,ARI,9,1,37,32,69,122,166,288,13,6,19,2,3:05
11808,531306,2018-08-22,2018,MIL,CIN,4,0,4-0,MIL,9,1,40,33,73,136,141,277,20,8,28,2,2:56
11809,531304,2018-08-22,2018,TOR,BAL,6,0,6-0,TOR,9,1,32,33,65,145,128,273,8,6,14,1,2:37
11810,531305,2018-08-22,2018,DET,CHN,2,8,8-2,CHN,9,0,37,41,78,159,157,316,11,15,26,6,3:26
11811,531314,2018-08-22,2018,COL,SDN,6,2,6-2,COL,9,1,37,33,70,123,148,271,13,6,19,1,2:43
11812,531309,2018-08-22,2018,TBA,KCA,6,3,6-3,TBA,9,1,39,33,72,133,139,272,16,7,23,5,2:52
11813,531307,2018-08-22,2018,BOS,CLE,10,4,10-4,BOS,9,1,41,37,78,156,175,331,17,11,28,4,3:24
11814,531316,2018-08-22,2018,LAN,SLN,1,3,3-1,SLN,9,0,33,35,68,143,154,297,5,9,14,0,3:02
11815,531308,2018-08-22,2018,SEA,HOU,7,10,10-7,HOU,9,0,39,44,83,154,138,292,13,19,32,5,3:13
11816,531313,2018-08-22,2018,WAS,PHI,8,7,8-7,WAS,9,0,42,40,82,177,157,334,17,13,30,3,3:45
11817,531312,2018-08-22,2018,MIA,NYA,9,3,9-3,MIA,9,1,42,37,79,150,174,324,18,12,30,4,3:25
11818,531311,2018-08-22,2018,CHA,MIN,7,3,7-3,CHA,9,1,38,39,77,164,148,312,15,12,27,2,3:06
11819,531323,2018-08-23,2018,MIN,OAK,6,4,6-4,MIN,9,1,34,40,74,169,133,302,11,14,25,2,2:58
11820,531322,2018-08-23,2018,TBA,KCA,4,3,4-3,TBA,9,0,43,36,79,133,160,293,19,11,30,2,2:51
11821,531325,2018-08-23,2018,COL,SDN,4,3,4-3,COL,9,0,33,38,71,157,124,281,8,12,20,3,3:00
11822,531321,2018-08-23,2018,BOS,CLE,7,0,7-0,BOS,9,1,41,30,71,124,156,280,20,6,26,2,2:47
11823,531320,2018-08-23,2018,CHN,CIN,7,1,7-1,CHN,9,1,38,33,71,114,127,241,16,10,26,1,2:27
11824,531324,2018-08-23,2018,WAS,PHI,0,2,2-0,PHI,9,0,33,33,66,128,115,243,6,7,13,0,2:41
11825,531319,2018-08-23,2018,DET,CHA,7,2,7-2,DET,9,1,35,37,72,163,130,293,12,13,25,1,2:47
11826,531326,2018-08-23,2018,NYN,SFN,1,3,3-1,SFN,9,0,33,35,68,146,128,274,7,9,16,0,2:36
11827,531318,2018-08-23,2018,MIA,ATL,0,5,5-0,ATL,9,0,36,42,78,159,155,314,10,17,27,1,3:00
11828,531338,2018-08-24,2018,ARI,SEA,3,6,6-3,SEA,9,0,36,38,74,137,124,261,8,12,20,0,2:47
11829,531332,2018-08-24,2018,ANA,HOU,3,9,9-3,HOU,9,0,36,41,77,141,136,277,10,17,27,1,3:04
11830,531339,2018-08-24,2018,COL,SLN,5,7,7-5,SLN,9,0,45,40,85,152,166,318,19,14,33,3,3:31
11831,531328,2018-08-24,2018,TBA,BOS,10,3,10-3,TBA,9,1,39,41,80,169,162,331,15,16,31,2,3:10
11832,531341,2018-08-24,2018,NYN,WAS,3,0,3-0,NYN,9,1,33,31,64,140,121,261,10,4,14,1,2:35
11833,531331,2018-08-24,2018,KCA,CLE,5,4,5-4,KCA,9,0,34,39,73,176,132,308,10,13,23,0,2:55 (:30 delay)
11834,531335,2018-08-24,2018,TOR,PHI,4,2,4-2,TOR,9,1,33,38,71,150,132,282,10,12,22,3,2:43
11835,531327,2018-08-24,2018,MIA,ATL,1,0,1-0,MIA,9,1,33,31,64,139,148,287,9,5,14,1,2:48
11836,531330,2018-08-24,2018,CHN,CIN,3,2,3-2,CHN,10,0,35,37,72,148,143,291,10,7,17,3,3:01
11837,531334,2018-08-24,2018,MIN,OAK,1,7,7-1,OAK,9,0,35,38,73,161,132,293,8,12,20,1,3:05
11838,531337,2018-08-24,2018,LAN,SDN,11,1,11-1,LAN,9,1,42,33,75,143,161,304,19,6,25,1,2:48
11839,531329,2018-08-24,2018,DET,CHA,3,6,6-3,CHA,9,0,39,37,76,150,176,326,11,10,21,6,3:28
11840,531333,2018-08-24,2018,BAL,NYA,5,7,7-5,NYA,10,0,42,45,87,208,138,346,12,16,28,2,3:29
11841,531340,2018-08-24,2018,SFN,TEX,6,7,7-6,TEX,10,0,47,46,93,171,181,352,17,16,33,2,3:48
11842,531336,2018-08-24,2018,MIL,PIT,7,6,7-6,MIL,15,0,62,70,132,253,249,502,21,28,49,2,5:36
11843,530292,2018-08-25,2018,BAL,NYA,3,10,10-3,NYA,9,0,38,41,79,171,160,331,10,15,25,1,3:06
11844,531343,2018-08-25,2018,TBA,BOS,5,1,5-1,TBA,9,1,40,31,71,121,153,274,16,6,22,2,2:53
11845,531346,2018-08-25,2018,KCA,CLE,7,1,7-1,KCA,9,1,36,33,69,152,117,269,16,7,23,2,2:45
11846,531356,2018-08-25,2018,NYN,WAS,3,0,3-0,NYN,9,1,31,35,66,142,122,264,8,11,19,3,2:51
11847,531351,2018-08-25,2018,MIL,PIT,1,9,9-1,PIT,9,0,33,45,78,156,141,297,6,22,28,1,3:01
11848,531344,2018-08-25,2018,DET,CHA,1,6,6-1,CHA,9,0,32,39,71,147,125,272,5,14,19,1,2:41
11849,531348,2018-08-25,2018,BAL,NYA,1,5,5-1,NYA,9,0,36,38,74,143,137,280,9,14,23,2,2:50
11850,531354,2018-08-25,2018,COL,SLN,9,1,9-1,COL,9,1,42,33,75,136,138,274,19,7,26,3,3:02
11851,530292,2018-08-25,2018,BAL,NYA,3,10,10-3,NYA,9,0,38,41,79,171,160,331,10,15,25,1,3:06
11852,531355,2018-08-25,2018,SFN,TEX,5,3,5-3,SFN,9,1,35,36,71,158,143,301,11,11,22,1,3:08
11853,531350,2018-08-25,2018,TOR,PHI,8,6,8-6,TOR,9,1,37,41,78,143,131,274,14,15,29,3,2:59
11854,531342,2018-08-25,2018,MIA,ATL,3,1,3-1,MIA,9,1,32,38,70,150,135,285,8,11,19,2,2:54
11855,531347,2018-08-25,2018,ANA,HOU,3,8,8-3,HOU,9,0,35,44,79,176,134,310,9,18,27,1,3:26
11856,531349,2018-08-25,2018,MIN,OAK,2,6,6-2,OAK,9,0,37,40,77,164,144,308,11,16,27,3,3:10
11857,531352,2018-08-25,2018,LAN,SDN,5,4,5-4,LAN,12,0,47,46,93,163,165,328,15,11,26,0,3:26 (:20 delay)
11858,531345,2018-08-25,2018,CHN,CIN,10,6,10-6,CHN,9,1,44,40,84,141,180,321,18,15,33,5,3:26
11859,531353,2018-08-25,2018,ARI,SEA,3,4,4-3,SEA,10,0,43,49,92,214,166,380,14,21,35,3,4:11
11860,531360,2018-08-26,2018,CHN,CIN,9,0,9-0,CHN,9,1,39,30,69,115,145,260,14,4,18,0,2:36
11861,531362,2018-08-26,2018,ANA,HOU,1,3,3-1,HOU,9,0,34,35,69,141,132,273,8,9,17,0,2:54
11862,531366,2018-08-26,2018,MIL,PIT,7,4,7-4,MIL,9,1,35,35,70,135,132,267,12,9,21,1,2:59
11863,531359,2018-08-26,2018,DET,CHA,2,7,7-2,CHA,9,0,41,42,83,143,141,284,15,16,31,3,3:03
11864,531367,2018-08-26,2018,LAN,SDN,7,3,7-3,LAN,9,1,39,42,81,129,175,304,16,16,32,3,3:07
11865,531361,2018-08-26,2018,KCA,CLE,5,12,12-5,CLE,9,0,37,47,84,177,150,327,10,20,30,3,3:08
11866,531370,2018-08-26,2018,SFN,TEX,3,1,3-1,SFN,9,1,30,36,66,138,113,251,7,9,16,1,2:35
11867,531368,2018-08-26,2018,ARI,SEA,5,2,5-2,ARI,9,1,31,38,69,148,115,263,8,10,18,2,2:48
11868,531358,2018-08-26,2018,TBA,BOS,9,1,9-1,TBA,9,1,40,31,71,118,182,300,16,5,21,0,3:05
11869,531369,2018-08-26,2018,COL,SLN,3,12,12-3,SLN,9,0,34,45,79,165,120,285,9,19,28,1,2:48
11870,531364,2018-08-26,2018,MIN,OAK,2,6,6-2,OAK,9,0,38,40,78,147,147,294,12,13,25,3,3:12
11871,531365,2018-08-26,2018,TOR,PHI,3,8,8-3,PHI,9,0,36,46,82,186,142,328,11,21,32,2,3:17
11872,531357,2018-08-26,2018,MIA,ATL,0,4,4-0,ATL,9,0,31,43,74,168,142,310,4,18,22,1,3:16
11873,531363,2018-08-26,2018,BAL,NYA,3,5,5-3,NYA,9,0,38,40,78,177,156,333,10,14,24,2,3:18
11874,531371,2018-08-26,2018,NYN,WAS,0,15,15-0,WAS,9,0,35,47,82,175,145,320,8,21,29,2,3:25
11875,531372,2018-08-27,2018,SFN,ARI,2,0,2-0,SFN,9,1,29,34,63,146,110,256,5,7,12,2,2:32
11876,531373,2018-08-27,2018,NYA,CHA,2,6,6-2,CHA,9,0,33,41,74,130,135,265,7,13,20,1,3:02
11877,531377,2018-08-27,2018,BAL,TOR,7,0,7-0,BAL,9,1,37,36,73,133,136,269,15,9,24,2,2:49
11878,531375,2018-08-27,2018,CHN,NYN,7,4,7-4,CHN,9,1,40,38,78,148,153,301,18,12,30,3,3:15
11879,531378,2018-08-27,2018,PHI,WAS,3,5,5-3,WAS,9,0,35,41,76,167,134,301,9,14,23,2,3:13
11880,531376,2018-08-27,2018,HOU,OAK,11,4,11-4,HOU,9,1,43,34,77,130,162,292,21,8,29,2,3:16
11881,531374,2018-08-27,2018,ANA,COL,10,7,10-7,ANA,9,1,40,44,84,173,149,322,15,18,33,7,3:37
11882,531388,2018-08-28,2018,HOU,OAK,3,4,4-3,OAK,9,0,34,39,73,154,131,285,8,12,20,2,3:21
11883,531384,2018-08-28,2018,BOS,MIA,8,7,8-7,BOS,9,0,42,44,86,171,159,330,19,18,37,3,3:29
11884,531385,2018-08-28,2018,CIN,MIL,9,7,9-7,CIN,9,1,45,39,84,151,185,336,23,13,36,5,3:33
11885,531390,2018-08-28,2018,SDN,SEA,2,1,2-1,SDN,9,1,31,33,64,97,121,218,7,8,15,1,2:13
11886,531383,2018-08-28,2018,TEX,LAN,4,8,8-4,LAN,9,0,37,46,83,163,163,326,11,19,30,2,3:19
11887,531386,2018-08-28,2018,CLE,MIN,8,1,8-1,CLE,9,1,41,37,78,134,147,281,17,10,27,2,3:04
11888,531389,2018-08-28,2018,SLN,PIT,5,2,5-2,SLN,9,1,37,32,69,116,152,268,14,9,23,2,2:51
11889,531379,2018-08-28,2018,SFN,ARI,1,0,1-0,SFN,9,0,36,38,74,131,133,264,13,10,23,2,3:03
11890,531382,2018-08-28,2018,KCA,DET,6,2,6-2,KCA,9,1,36,32,68,104,129,233,13,7,20,0,2:24
11891,531392,2018-08-28,2018,BAL,TOR,12,5,12-5,BAL,9,1,42,42,84,167,134,301,20,16,36,1,3:02
11892,531380,2018-08-28,2018,NYA,CHA,5,4,5-4,NYA,9,0,36,39,75,136,145,281,12,10,22,3,3:03
11893,531381,2018-08-28,2018,ANA,COL,2,3,3-2,COL,9,0,35,33,68,140,144,284,8,6,14,0,2:59
11894,531393,2018-08-28,2018,PHI,WAS,4,5,5-4,WAS,9,0,35,35,70,149,160,309,9,9,18,4,3:28
11895,531387,2018-08-28,2018,CHN,NYN,2,1,2-1,CHN,11,0,44,45,89,189,153,342,14,15,29,2,3:41 (:57 delay)
11896,531391,2018-08-28,2018,ATL,TBA,9,5,9-5,ATL,9,1,39,42,81,151,125,276,16,15,31,4,3:10
11897,531387,2018-08-28,2018,CHN,NYN,2,1,2-1,CHN,11,0,44,45,89,189,153,342,14,15,29,2,3:41 (:57 delay)
11898,531395,2018-08-29,2018,NYA,CHA,1,4,4-1,CHA,9,0,34,35,69,138,134,272,8,9,17,0,2:55
11899,531396,2018-08-29,2018,KCA,DET,9,2,9-2,KCA,9,1,37,35,72,158,134,292,15,7,22,2,2:38
11900,531398,2018-08-29,2018,BOS,MIA,14,6,14-6,BOS,9,1,41,38,79,137,154,291,20,13,33,5,3:10
11901,531403,2018-08-29,2018,SLN,PIT,0,2,2-0,PIT,9,0,36,37,73,142,144,286,9,11,20,0,3:12
11902,531402,2018-08-29,2018,HOU,OAK,5,4,5-4,HOU,9,0,41,41,82,150,160,310,19,14,33,3,3:27
11903,531394,2018-08-29,2018,SFN,ARI,1,3,3-1,ARI,9,0,32,37,69,138,121,259,7,9,16,2,2:45
11904,531406,2018-08-29,2018,BAL,TOR,10,5,10-5,BAL,9,1,42,44,86,163,159,322,15,18,33,7,3:22
11905,531407,2018-08-29,2018,PHI,WAS,8,6,8-6,PHI,9,1,40,40,80,167,174,341,16,14,30,4,3:38
11906,531401,2018-08-29,2018,CHN,NYN,3,10,10-3,NYN,9,0,36,45,81,179,156,335,10,19,29,2,3:10
11907,531405,2018-08-29,2018,ATL,TBA,5,8,8-5,TBA,9,0,41,41,82,160,150,310,15,14,29,1,3:06 (1:47 delay)
11908,531404,2018-08-29,2018,SDN,SEA,8,3,8-3,SDN,9,1,41,38,79,164,154,318,16,13,29,2,3:16
11909,531397,2018-08-29,2018,TEX,LAN,1,3,3-1,LAN,9,0,35,33,68,131,137,268,9,8,17,1,2:49
11910,531400,2018-08-29,2018,CLE,MIN,3,4,4-3,MIN,9,0,37,42,79,166,149,315,11,16,27,2,3:09
11911,531399,2018-08-29,2018,CIN,MIL,12,13,13-12,MIL,10,0,49,53,102,180,191,371,21,24,45,6,4:16 (:27 delay)
11912,530053,2018-08-30,2018,ATL,CHN,4,5,5-4,CHN,9,0,37,37,74,131,123,254,12,10,22,3,2:42
11913,531415,2018-08-30,2018,SLN,PIT,5,0,5-0,SLN,9,1,31,39,70,159,111,270,8,12,20,3,2:53
11914,531416,2018-08-30,2018,OAK,SEA,1,7,7-1,SEA,9,0,34,38,72,136,136,272,8,11,19,0,2:40
11915,531414,2018-08-30,2018,CLE,MIN,5,3,5-3,CLE,9,1,34,35,69,156,147,303,10,8,18,3,3:06
11916,531413,2018-08-30,2018,CIN,MIL,1,2,2-1,MIL,11,0,39,42,81,156,137,293,7,12,19,4,3:06
11917,531412,2018-08-30,2018,HOU,ANA,2,5,5-2,ANA,9,0,33,39,72,159,138,297,9,12,21,2,3:20
11918,531408,2018-08-30,2018,LAN,ARI,1,3,3-1,ARI,9,0,34,39,73,148,154,302,10,12,22,2,3:14
11919,531411,2018-08-30,2018,NYA,DET,7,8,8-7,DET,9,0,38,43,81,172,157,329,15,14,29,3,3:32
11920,531409,2018-08-30,2018,CHA,BOS,4,9,9-4,BOS,9,0,38,42,80,196,149,345,13,15,28,3,3:37
11921,531410,2018-08-30,2018,SDN,COL,3,2,3-2,SDN,13,0,45,52,97,181,169,350,10,12,22,0,3:36
11922,530053,2018-08-30,2018,ATL,CHN,4,5,5-4,CHN,9,0,37,37,74,131,123,254,12,10,22,3,2:42
11923,531430,2018-08-31,2018,CLE,TBA,3,0,3-0,CLE,9,1,30,30,60,128,102,230,7,4,11,0,2:18
11924,531424,2018-08-31,2018,HOU,ANA,0,3,3-0,ANA,9,0,35,36,71,149,156,305,9,10,19,1,3:18
11925,531423,2018-08-31,2018,NYA,DET,7,5,7-5,NYA,9,1,36,40,76,160,142,302,12,14,26,2,3:10
11926,531429,2018-08-31,2018,OAK,SEA,7,5,7-5,OAK,9,1,40,37,77,147,151,298,16,10,26,2,3:07
11927,531428,2018-08-31,2018,ATL,PIT,2,3,3-2,PIT,9,0,35,35,70,144,133,277,9,9,18,2,2:55
11928,531420,2018-08-31,2018,PHI,CHN,2,1,2-1,PHI,10,0,33,41,74,174,144,318,6,14,20,4,3:23
11929,531426,2018-08-31,2018,TEX,MIN,7,10,10-7,MIN,9,0,43,45,88,171,189,360,14,17,31,3,3:42
11930,531418,2018-08-31,2018,KCA,BAL,9,2,9-2,KCA,9,1,42,33,75,124,158,282,19,6,25,1,2:39
11931,531417,2018-08-31,2018,LAN,ARI,3,2,3-2,LAN,9,1,32,32,64,120,110,230,8,6,14,1,2:33
11932,531421,2018-08-31,2018,SLN,CIN,12,5,12-5,SLN,9,1,45,44,89,151,165,316,21,17,38,2,3:22
11933,531419,2018-08-31,2018,CHA,BOS,6,1,6-1,CHA,9,1,40,34,74,123,154,277,18,9,27,1,2:53 (2:09 delay)
11934,531431,2018-08-31,2018,MIA,TOR,5,6,6-5,TOR,9,0,44,38,82,143,169,312,20,11,31,2,3:11
11935,531427,2018-08-31,2018,SFN,NYN,7,0,7-0,SFN,9,1,36,30,66,115,143,258,13,4,17,3,2:22
11936,531422,2018-08-31,2018,SDN,COL,7,0,7-0,SDN,9,1,36,35,71,116,124,240,13,8,21,1,2:38
11937,531425,2018-08-31,2018,WAS,MIL,1,4,4-1,MIL,9,0,40,33,73,120,156,276,13,6,19,1,3:11
11938,531438,2018-09-01,2018,NYA,DET,2,1,2-1,NYA,9,1,32,36,68,118,141,259,8,10,18,2,3:00
11939,531435,2018-09-01,2018,PHI,CHN,1,7,7-1,CHN,9,0,34,39,73,136,124,260,8,12,20,0,2:41
11940,531446,2018-09-01,2018,MIA,TOR,6,3,6-3,MIA,9,1,35,32,67,127,133,260,12,5,17,1,2:37
11941,531437,2018-09-01,2018,SDN,COL,2,4,4-2,COL,9,0,35,38,73,132,130,262,8,12,20,1,2:42
11942,531433,2018-09-01,2018,KCA,BAL,5,4,5-4,KCA,9,0,37,38,75,131,150,281,12,14,26,1,2:56
11943,531439,2018-09-01,2018,HOU,ANA,7,3,7-3,HOU,9,1,35,34,69,158,132,290,9,7,16,3,3:16
11944,531445,2018-09-01,2018,CLE,TBA,3,5,5-3,TBA,9,0,36,40,76,153,135,288,11,17,28,6,3:13
11945,531443,2018-09-01,2018,ATL,PIT,5,3,5-3,ATL,9,1,33,33,66,127,125,252,7,6,13,3,2:53
11946,531432,2018-09-01,2018,LAN,ARI,3,2,3-2,LAN,9,1,34,34,68,120,157,277,9,5,14,2,2:59
11947,531441,2018-09-01,2018,TEX,MIN,7,4,7-4,TEX,9,1,33,35,68,137,152,289,8,10,18,3,2:52
11948,531436,2018-09-01,2018,SLN,CIN,0,4,4-0,CIN,9,0,33,36,69,141,151,292,6,11,17,3,2:55
11949,531444,2018-09-01,2018,OAK,SEA,7,8,8-7,SEA,9,0,42,43,85,160,177,337,14,16,30,4,3:33
11950,531442,2018-09-01,2018,SFN,NYN,1,2,2-1,NYN,11,0,38,41,79,172,154,326,5,10,15,0,2:56
11951,531440,2018-09-01,2018,WAS,MIL,5,4,5-4,WAS,9,1,33,40,73,159,160,319,11,14,25,5,3:44 (1:57 delay)
11952,531434,2018-09-01,2018,CHA,BOS,1,6,6-1,BOS,9,0,32,39,71,141,138,279,6,12,18,3,2:56
11953,531457,2018-09-02,2018,SFN,NYN,1,4,4-1,NYN,9,0,30,35,65,121,114,235,3,9,12,0,2:23
11954,531460,2018-09-02,2018,CLE,TBA,4,6,6-4,TBA,9,0,34,42,76,163,132,295,8,17,25,5,3:10
11955,531452,2018-09-02,2018,SDN,COL,3,7,7-3,COL,9,0,36,39,75,141,136,277,10,12,22,1,2:47
11956,531456,2018-09-02,2018,TEX,MIN,18,4,18-4,TEX,9,1,48,36,84,141,198,339,24,11,35,3,3:09
11957,531448,2018-09-02,2018,KCA,BAL,9,1,9-1,KCA,9,1,40,31,71,121,150,271,18,6,24,2,2:48
11958,531458,2018-09-02,2018,ATL,PIT,5,1,5-1,ATL,9,1,35,33,68,115,137,252,10,7,17,2,2:44
11959,531459,2018-09-02,2018,OAK,SEA,8,2,8-2,OAK,9,1,36,37,73,126,142,268,14,10,24,5,2:53
11960,531447,2018-09-02,2018,LAN,ARI,3,2,3-2,LAN,9,0,36,37,73,148,147,295,11,12,23,7,3:35
11961,531454,2018-09-02,2018,HOU,ANA,4,2,4-2,HOU,9,1,37,41,78,157,168,325,13,14,27,4,3:40
11962,531455,2018-09-02,2018,WAS,MIL,4,9,9-4,MIL,9,0,38,47,85,188,146,334,11,21,32,1,3:22
11963,531451,2018-09-02,2018,SLN,CIN,4,6,6-4,CIN,10,0,47,45,92,173,182,355,22,16,38,4,3:44
11964,531450,2018-09-02,2018,PHI,CHN,1,8,8-1,CHN,9,0,36,39,75,168,156,324,10,13,23,3,3:37
11965,531449,2018-09-02,2018,CHA,BOS,8,0,8-0,CHA,9,1,45,35,80,137,180,317,21,9,30,2,3:12
11966,531453,2018-09-02,2018,NYA,DET,7,11,11-7,DET,9,0,42,45,87,177,172,349,15,21,36,2,3:41
11967,531461,2018-09-02,2018,MIA,TOR,1,6,6-1,TOR,9,0,34,41,75,166,133,299,8,14,22,0,2:51
11968,531467,2018-09-03,2018,CLE,KCA,1,5,5-1,KCA,9,0,32,38,70,159,122,281,7,11,18,1,2:40
11969,531471,2018-09-03,2018,OAK,NYA,6,3,6-3,OAK,9,1,37,35,72,151,132,283,13,8,21,2,3:04
11970,531473,2018-09-03,2018,ARI,SDN,2,6,6-2,SDN,9,0,37,38,75,138,169,307,11,12,23,2,3:19
11971,531464,2018-09-03,2018,MIL,CHN,4,3,4-3,MIL,9,0,38,35,73,133,159,292,13,8,21,3,3:13
11972,531472,2018-09-03,2018,MIA,PHI,3,1,3-1,MIA,9,1,30,30,60,125,103,228,7,4,11,2,2:24
11973,531462,2018-09-03,2018,SEA,BAL,2,1,2-1,SEA,9,1,32,30,62,132,133,265,9,3,12,2,2:33
11974,531469,2018-09-03,2018,HOU,MIN,4,1,4-1,HOU,9,1,30,39,69,160,114,274,6,11,17,2,2:59
11975,531475,2018-09-03,2018,WAS,SLN,4,3,4-3,WAS,10,0,48,37,85,143,195,338,20,10,30,2,3:51
11976,531466,2018-09-03,2018,CHA,DET,4,2,4-2,CHA,9,0,33,33,66,128,144,272,9,6,15,2,2:48
11977,531465,2018-09-03,2018,PIT,CIN,5,1,5-1,PIT,9,1,33,34,67,139,112,251,9,9,18,1,2:33
11978,531476,2018-09-03,2018,TOR,TBA,1,7,7-1,TBA,9,0,32,39,71,156,98,254,8,13,21,2,2:39
11979,531468,2018-09-03,2018,TEX,ANA,1,3,3-1,ANA,9,0,35,37,72,145,140,285,9,11,20,3,3:10
11980,531474,2018-09-03,2018,COL,SFN,9,8,9-8,COL,9,1,38,40,78,170,143,313,15,12,27,2,3:18
11981,531470,2018-09-03,2018,LAN,NYN,2,4,4-2,NYN,9,0,35,39,74,165,154,319,9,15,24,3,3:30
11982,531463,2018-09-03,2018,ATL,BOS,2,8,8-2,BOS,9,0,42,43,85,138,199,337,15,18,33,4,3:40
11983,531491,2018-09-04,2018,TOR,TBA,0,4,4-0,TBA,9,0,32,40,72,144,116,260,6,12,18,3,2:38
11984,531480,2018-09-04,2018,PIT,CIN,7,3,7-3,PIT,9,1,36,35,71,151,127,278,13,8,21,1,2:39
11985,531486,2018-09-04,2018,OAK,NYA,1,5,5-1,NYA,9,0,30,38,68,161,124,285,5,13,18,6,3:12
11986,531482,2018-09-04,2018,CLE,KCA,9,3,9-3,CLE,9,1,42,36,78,149,161,310,17,9,26,3,2:59
11987,531488,2018-09-04,2018,ARI,SDN,6,0,6-0,ARI,9,1,34,31,65,137,127,264,12,5,17,3,2:47
11988,531478,2018-09-04,2018,ATL,BOS,1,5,5-1,BOS,9,0,36,44,80,162,157,319,9,18,27,1,3:03
11989,531481,2018-09-04,2018,CHA,DET,3,8,8-3,DET,9,0,36,41,77,196,140,336,8,15,23,3,3:26
11990,531489,2018-09-04,2018,COL,SFN,6,2,6-2,COL,9,1,41,36,77,144,155,299,20,11,31,3,3:09
11991,531479,2018-09-04,2018,MIL,CHN,11,1,11-1,MIL,9,1,46,34,80,138,194,332,22,7,29,3,3:20
11992,531484,2018-09-04,2018,HOU,MIN,5,2,5-2,HOU,9,1,34,34,68,129,127,256,11,8,19,1,2:58
11993,531483,2018-09-04,2018,TEX,ANA,4,2,4-2,TEX,9,1,34,36,70,144,123,267,10,8,18,1,2:44
11994,531485,2018-09-04,2018,LAN,NYN,11,4,11-4,LAN,9,1,41,40,81,153,170,323,17,13,30,5,3:17
11995,531490,2018-09-04,2018,WAS,SLN,8,11,11-8,SLN,9,0,44,43,87,181,203,384,21,17,38,5,4:10
11996,531487,2018-09-04,2018,MIA,PHI,4,9,9-4,PHI,9,0,39,48,87,189,134,323,13,23,36,2,3:14
11997,531477,2018-09-04,2018,SEA,BAL,3,5,5-3,BAL,9,0,38,42,80,149,151,300,13,17,30,4,3:19
11998,531492,2018-09-05,2018,SEA,BAL,5,2,5-2,SEA,9,1,40,39,79,129,161,290,15,9,24,4,3:04
11999,531497,2018-09-05,2018,CLE,KCA,3,1,3-1,CLE,9,1,36,30,66,144,110,254,12,3,15,2,2:31
12000,531502,2018-09-05,2018,MIA,PHI,2,1,2-1,MIA,9,1,32,36,68,139,122,261,8,11,19,2,2:44
12001,531503,2018-09-05,2018,COL,SFN,5,3,5-3,COL,9,1,34,37,71,145,124,269,10,11,21,2,2:48 (1:08 delay)
12002,531505,2018-09-05,2018,TOR,TBA,10,3,10-3,TOR,9,1,45,37,82,138,150,288,22,10,32,1,2:42
12003,531499,2018-09-05,2018,HOU,MIN,9,1,9-1,HOU,9,1,40,36,76,136,168,304,18,11,29,5,3:21
12004,531495,2018-09-05,2018,PIT,CIN,3,2,3-2,PIT,9,1,32,40,72,158,123,281,10,15,25,2,2:55
12005,531494,2018-09-05,2018,MIL,CHN,4,6,6-4,CHN,9,0,38,36,74,139,150,289,12,14,26,4,3:14
12006,531500,2018-09-05,2018,LAN,NYN,3,7,7-3,NYN,9,0,32,39,71,133,126,259,5,14,19,0,2:39
12007,531498,2018-09-05,2018,TEX,ANA,3,9,9-3,ANA,9,0,36,45,81,180,134,314,10,19,29,1,3:12
12008,531496,2018-09-05,2018,CHA,DET,2,10,10-2,DET,9,0,34,47,81,200,140,340,8,20,28,3,3:17 (1:01 delay)
12009,531504,2018-09-05,2018,WAS,SLN,6,7,7-6,SLN,9,0,44,41,85,175,164,339,17,17,34,1,3:35
12010,531493,2018-09-05,2018,ATL,BOS,8,9,9-8,BOS,9,0,44,42,86,165,167,332,20,16,36,4,3:44
12011,531501,2018-09-05,2018,OAK,NYA,8,2,8-2,OAK,9,1,37,34,71,144,127,271,13,8,21,3,2:53
12012,531507,2018-09-06,2018,WAS,CHN,4,6,6-4,CHN,10,0,42,47,89,178,161,339,13,18,31,4,4:00
12013,531506,2018-09-06,2018,ARI,ATL,6,7,7-6,ATL,10,0,45,47,92,178,184,362,16,16,32,7,4:11
12014,531509,2018-09-06,2018,CIN,SDN,2,6,6-2,SDN,9,0,34,38,72,152,154,306,8,10,18,1,2:57
12015,531508,2018-09-06,2018,TOR,CLE,4,9,9-4,CLE,9,0,38,41,79,159,133,292,13,15,28,3,2:53
12016,531522,2018-09-07,2018,MIL,SFN,4,2,4-2,MIL,9,1,36,33,69,131,142,273,13,7,20,1,2:51
12017,531516,2018-09-07,2018,CHA,ANA,2,5,5-2,ANA,9,0,35,43,78,158,127,285,10,18,28,2,2:55
12018,531523,2018-09-07,2018,DET,SLN,5,3,5-3,DET,9,0,37,35,72,148,128,276,13,8,21,2,2:51
12019,531521,2018-09-07,2018,CIN,SDN,12,6,12-6,CIN,9,1,40,35,75,126,160,286,16,11,27,2,2:52 (2:37 delay)
12020,531520,2018-09-07,2018,NYN,PHI,3,4,4-3,PHI,9,0,32,35,67,165,116,281,5,9,14,2,2:43
12021,531518,2018-09-07,2018,PIT,MIA,5,3,5-3,PIT,9,1,34,36,70,144,143,287,10,10,20,2,3:03
12022,531511,2018-09-07,2018,TBA,BAL,14,2,14-2,TBA,9,1,44,32,76,152,181,333,21,6,27,3,3:05
12023,531519,2018-09-07,2018,SEA,NYA,0,4,4-0,NYA,9,0,31,34,65,140,120,260,4,7,11,0,2:32
12024,531524,2018-09-07,2018,OAK,TEX,8,4,8-4,OAK,9,1,42,39,81,151,174,325,18,13,31,3,3:17
12025,531517,2018-09-07,2018,COL,LAN,2,4,4-2,LAN,9,0,39,43,82,175,170,345,12,18,30,5,3:53
12026,531515,2018-09-07,2018,MIN,KCA,10,6,10-6,MIN,9,1,43,43,86,174,175,349,19,17,36,3,3:36
12027,531510,2018-09-07,2018,ARI,ATL,5,3,5-3,ARI,9,1,40,38,78,161,172,333,20,10,30,4,3:48
12028,531513,2018-09-07,2018,TOR,CLE,3,2,3-2,TOR,11,0,42,48,90,212,157,369,11,15,26,5,3:51
12029,531514,2018-09-07,2018,BOS,HOU,3,6,6-3,HOU,9,0,39,38,77,152,148,300,12,12,24,2,3:38
12030,531529,2018-09-08,2018,BOS,HOU,3,5,5-3,HOU,9,0,39,43,82,148,155,303,13,17,30,2,3:25
12031,531537,2018-09-08,2018,MIL,SFN,4,3,4-3,MIL,9,1,32,36,68,160,123,283,8,9,17,3,2:53
12032,531536,2018-09-08,2018,CIN,SDN,7,2,7-2,CIN,7,1,27,27,54,105,90,195,10,8,18,0,1:44 (1:13 delay)
12033,531534,2018-09-08,2018,SEA,NYA,2,4,4-2,NYA,9,0,33,36,69,138,136,274,6,12,18,2,2:49
12034,531526,2018-09-08,2018,TBA,BAL,10,5,10-5,TBA,9,1,41,38,79,143,153,296,16,15,31,5,3:00
12035,531528,2018-09-08,2018,TOR,CLE,8,9,9-8,CLE,9,0,47,47,94,195,179,374,21,20,41,6,3:38
12036,531538,2018-09-08,2018,DET,SLN,4,3,4-3,DET,9,0,39,32,71,131,150,281,15,5,20,3,2:56 (:28 delay)
12037,531512,2018-09-08,2018,WAS,CHN,6,5,6-5,WAS,9,1,37,37,74,154,153,307,14,14,28,4,3:15 (1:29 delay)
12038,531539,2018-09-08,2018,OAK,TEX,8,6,8-6,OAK,9,1,39,37,76,160,168,328,16,10,26,3,3:25
12039,531531,2018-09-08,2018,CHA,ANA,3,12,12-3,ANA,9,0,35,45,80,176,155,331,11,23,34,4,3:45
12040,531532,2018-09-08,2018,COL,LAN,4,2,4-2,COL,9,1,31,36,67,166,120,286,8,10,18,1,2:41
12041,531530,2018-09-08,2018,MIN,KCA,1,4,4-1,KCA,9,0,29,39,68,158,119,277,2,12,14,3,2:42
12042,531527,2018-09-08,2018,WAS,CHN,10,3,10-3,WAS,9,1,41,36,77,111,158,269,17,10,27,2,2:45 (2:10 delay)
12043,531533,2018-09-08,2018,PIT,MIA,5,1,5-1,PIT,9,1,35,36,71,155,152,307,13,8,21,0,3:00
12044,531512,2018-09-08,2018,WAS,CHN,6,5,6-5,WAS,9,1,37,37,74,154,153,307,14,14,28,4,3:15 (1:29 delay)
12045,531535,2018-09-08,2018,NYN,PHI,10,5,10-5,NYN,9,1,41,44,85,147,149,296,18,21,39,4,3:12
12046,531525,2018-09-08,2018,ARI,ATL,4,5,5-4,ATL,10,0,46,44,90,167,187,354,17,18,35,5,4:07
12047,531541,2018-09-09,2018,TBA,BAL,8,3,8-3,TBA,9,1,40,37,77,155,145,300,17,12,29,3,2:51
12048,531553,2018-09-09,2018,DET,SLN,2,5,5-2,SLN,9,0,34,37,71,131,132,263,8,11,19,2,2:41
12049,531543,2018-09-09,2018,TOR,CLE,6,2,6-2,TOR,9,1,33,37,70,151,138,289,8,10,18,4,2:43
12050,531545,2018-09-09,2018,MIN,KCA,3,1,3-1,MIN,9,0,35,34,69,144,121,265,10,8,18,3,2:36
12051,531554,2018-09-09,2018,OAK,TEX,7,3,7-3,OAK,9,1,36,35,71,136,143,279,13,11,24,5,2:59
12052,531552,2018-09-09,2018,MIL,SFN,6,3,6-3,MIL,9,1,33,36,69,137,128,265,10,10,20,2,2:52
12053,531550,2018-09-09,2018,NYN,PHI,6,4,6-4,NYN,9,1,40,38,78,159,140,299,16,11,27,3,3:12 (:27 delay)
12054,531544,2018-09-09,2018,BOS,HOU,6,5,6-5,BOS,9,0,41,39,80,152,151,303,17,14,31,4,3:35
12055,531551,2018-09-09,2018,CIN,SDN,6,7,7-6,SDN,9,0,39,43,82,181,154,335,13,16,29,3,3:12 (1:32 delay)
12056,531549,2018-09-09,2018,SEA,NYA,3,2,3-2,SEA,9,1,32,38,70,143,132,275,9,11,20,2,3:05
12057,531546,2018-09-09,2018,CHA,ANA,0,1,1-0,ANA,9,0,33,38,71,169,130,299,6,12,18,4,3:17
12058,531540,2018-09-09,2018,ARI,ATL,5,9,9-5,ATL,9,0,41,41,82,167,173,340,16,16,32,4,3:45
12059,531547,2018-09-09,2018,COL,LAN,6,9,9-6,LAN,9,0,36,48,84,208,151,359,9,22,31,7,3:51
12060,531556,2018-09-10,2018,SFN,ATL,1,4,4-1,ATL,9,0,30,37,67,140,122,262,3,11,14,1,2:33
12061,531565,2018-09-10,2018,ANA,TEX,2,5,5-2,TEX,9,0,40,39,79,141,147,288,12,12,24,1,3:10
12062,531557,2018-09-10,2018,KCA,CHA,4,3,4-3,KCA,10,0,36,36,72,124,138,262,10,8,18,1,2:51
12063,531555,2018-09-10,2018,COL,ARI,13,2,13-2,COL,9,1,42,34,76,115,145,260,22,9,31,3,3:09
12064,531564,2018-09-10,2018,SLN,PIT,8,7,8-7,SLN,9,1,35,40,75,149,125,274,11,14,25,2,2:55
12065,531559,2018-09-10,2018,DET,HOU,2,3,3-2,HOU,9,0,34,37,71,126,122,248,8,9,17,0,2:42
12066,531563,2018-09-10,2018,MIN,NYA,2,7,7-2,NYA,9,0,36,48,84,205,144,349,10,21,31,3,3:39
12067,531562,2018-09-10,2018,CHN,MIL,2,3,3-2,MIL,9,0,35,39,74,156,143,299,9,16,25,2,3:19
12068,531560,2018-09-10,2018,CIN,LAN,10,6,10-6,CIN,9,1,42,42,84,169,159,328,19,15,34,3,3:23
12069,531558,2018-09-10,2018,TBA,CLE,6,5,6-5,TBA,9,0,39,44,83,178,179,357,15,17,32,4,3:38
12070,531568,2018-09-11,2018,SFN,ATL,1,4,4-1,ATL,9,0,32,40,72,131,108,239,7,15,22,2,2:31
12071,531579,2018-09-11,2018,ANA,TEX,1,0,1-0,ANA,9,1,28,32,60,132,119,251,5,5,10,3,2:45
12072,531570,2018-09-11,2018,TBA,CLE,0,2,2-0,CLE,9,0,35,37,72,127,136,263,8,10,18,2,2:44
12073,531578,2018-09-11,2018,SEA,SDN,1,2,2-1,SDN,9,0,37,35,72,123,130,253,11,8,19,1,2:49
12074,531571,2018-09-11,2018,DET,HOU,4,5,5-4,HOU,9,0,38,40,78,164,166,330,12,14,26,3,3:29
12075,531580,2018-09-11,2018,BOS,TOR,7,2,7-2,BOS,9,1,34,35,69,178,131,309,11,9,20,5,3:08
12076,531576,2018-09-11,2018,BAL,OAK,2,3,3-2,OAK,9,0,33,37,70,142,125,267,7,10,17,0,2:45
12077,531575,2018-09-11,2018,MIN,NYA,10,5,10-5,MIN,9,1,43,34,77,132,171,303,20,11,31,2,3:04
12078,531577,2018-09-11,2018,SLN,PIT,11,5,11-5,SLN,9,1,42,38,80,153,151,304,18,12,30,4,3:23
12079,531572,2018-09-11,2018,CIN,LAN,3,1,3-1,CIN,9,1,35,33,68,136,121,257,12,8,20,3,2:40
12080,531581,2018-09-11,2018,PHI,WAS,1,3,3-1,WAS,9,0,35,38,73,173,167,340,9,15,24,4,3:27
12081,531574,2018-09-11,2018,CHN,MIL,3,0,3-0,CHN,9,1,30,32,62,136,126,262,5,5,10,3,2:54
12082,531573,2018-09-11,2018,NYN,MIA,3,5,5-3,MIA,9,0,37,35,72,140,147,287,10,9,19,1,2:39
12083,531566,2018-09-11,2018,PHI,WAS,6,7,7-6,WAS,10,0,46,43,89,199,176,375,20,14,34,6,4:16
12084,531566,2018-09-11,2018,PHI,WAS,6,7,7-6,WAS,10,0,46,43,89,199,176,375,20,14,34,6,4:16
12085,531569,2018-09-11,2018,KCA,CHA,6,3,6-3,KCA,9,1,33,38,71,157,110,267,13,11,24,4,2:55
12086,531567,2018-09-11,2018,COL,ARI,3,6,6-3,ARI,9,0,37,38,75,144,132,276,11,14,25,4,3:14
12087,531595,2018-09-12,2018,BOS,TOR,1,0,1-0,BOS,9,1,31,33,64,127,116,243,9,6,15,0,2:41
12088,531585,2018-09-12,2018,TBA,CLE,3,1,3-1,TBA,9,1,33,30,63,126,113,239,9,4,13,0,2:20
12089,531588,2018-09-12,2018,NYN,MIA,13,0,13-0,NYN,9,1,43,31,74,107,160,267,17,5,22,1,2:30 (5:35 delay)
12090,531583,2018-09-12,2018,SFN,ATL,1,2,2-1,ATL,9,0,39,37,76,147,142,289,15,11,26,1,2:59
12091,531594,2018-09-12,2018,ANA,TEX,8,1,8-1,ANA,9,1,38,35,73,119,145,264,14,10,24,1,2:50
12092,531582,2018-09-12,2018,COL,ARI,5,4,5-4,COL,9,0,38,34,72,154,125,279,15,7,22,3,3:07
12093,531590,2018-09-12,2018,MIN,NYA,3,1,3-1,MIN,9,1,30,32,62,144,127,271,7,5,12,3,2:46
12094,531591,2018-09-12,2018,BAL,OAK,0,10,10-0,OAK,9,0,29,46,75,180,99,279,2,19,21,1,2:39
12095,531589,2018-09-12,2018,CHN,MIL,1,5,5-1,MIL,9,0,35,43,78,150,132,282,9,17,26,5,3:14
12096,531593,2018-09-12,2018,SEA,SDN,4,5,5-4,SDN,9,0,36,40,76,147,145,292,10,12,22,3,3:07
12097,531586,2018-09-12,2018,DET,HOU,4,5,5-4,HOU,9,0,38,38,76,149,152,301,10,12,22,1,3:09
12098,531592,2018-09-12,2018,SLN,PIT,3,4,4-3,PIT,9,0,37,38,75,143,133,276,10,12,22,2,3:00
12099,531587,2018-09-12,2018,CIN,LAN,1,8,8-1,LAN,9,0,32,46,78,177,121,298,6,20,26,4,3:10
12100,531584,2018-09-12,2018,KCA,CHA,2,4,4-2,CHA,12,0,46,47,93,179,193,372,15,14,29,3,3:53
12101,531596,2018-09-12,2018,PHI,WAS,1,5,5-1,WAS,9,0,34,36,70,143,134,277,7,10,17,1,2:56
12102,531597,2018-09-13,2018,COL,ARI,10,3,10-3,COL,9,1,43,33,76,111,144,255,22,8,30,3,3:04
12103,531603,2018-09-13,2018,BOS,TOR,4,3,4-3,BOS,9,1,35,37,72,121,131,252,10,10,20,5,2:50
12104,531561,2018-09-13,2018,NYN,MIA,5,2,5-2,NYN,9,1,36,35,71,147,140,287,13,8,21,1,2:47
12105,531599,2018-09-13,2018,NYN,MIA,4,3,4-3,NYN,9,0,32,35,67,155,127,282,7,9,16,3,2:33
12106,531561,2018-09-13,2018,NYN,MIA,5,2,5-2,NYN,9,1,36,35,71,147,140,287,13,8,21,1,2:47
12107,531600,2018-09-13,2018,KCA,MIN,6,4,6-4,KCA,9,1,40,35,75,123,183,306,16,8,24,5,3:12
12108,531601,2018-09-13,2018,BAL,OAK,5,3,5-3,BAL,9,1,34,38,72,149,130,279,14,12,26,3,2:51
12109,531561,2018-09-13,2018,NYN,MIA,5,2,5-2,NYN,9,1,36,35,71,147,140,287,13,8,21,1,2:47
12110,531602,2018-09-13,2018,ANA,SEA,2,8,8-2,SEA,9,0,35,45,80,169,153,322,9,20,29,2,3:19
12111,531598,2018-09-13,2018,SLN,LAN,7,9,9-7,LAN,9,0,43,42,85,160,149,309,16,17,33,2,3:28
12112,531542,2018-09-13,2018,WAS,CHN,3,4,4-3,CHN,10,0,42,42,84,146,167,313,12,16,28,7,3:46
12113,531542,2018-09-13,2018,WAS,CHN,3,4,4-3,CHN,10,0,42,42,84,146,167,313,12,16,28,7,3:46
12114,531607,2018-09-14,2018,SFN,COL,2,0,2-0,SFN,9,1,31,31,62,114,121,235,8,4,12,0,2:20
12115,531616,2018-09-14,2018,SDN,TEX,0,4,4-0,TEX,9,0,33,34,67,118,145,263,10,9,19,1,2:42
12116,531613,2018-09-14,2018,TBA,OAK,1,2,2-1,OAK,10,0,38,34,72,137,141,278,12,6,18,2,3:05
12117,531612,2018-09-14,2018,BOS,NYN,0,8,8-0,NYN,9,0,33,42,75,170,129,299,7,16,23,3,2:59
12118,531609,2018-09-14,2018,SLN,LAN,0,3,3-0,LAN,9,0,32,37,69,168,116,284,5,12,17,1,3:04
12119,531608,2018-09-14,2018,CLE,DET,4,5,5-4,DET,9,0,37,39,76,137,141,278,10,13,23,3,3:06
12120,531604,2018-09-14,2018,HOU,ARI,2,4,4-2,ARI,9,0,37,41,78,157,154,311,12,15,27,4,3:36
12121,531611,2018-09-14,2018,KCA,MIN,8,4,8-4,KCA,9,0,40,43,83,164,143,307,17,16,33,1,3:15
12122,531615,2018-09-14,2018,ANA,SEA,0,5,5-0,SEA,9,0,36,38,74,163,153,316,9,11,20,2,3:22
12123,531617,2018-09-14,2018,NYA,TOR,11,0,11-0,NYA,9,1,45,37,82,142,163,305,22,10,32,1,3:07
12124,531614,2018-09-14,2018,MIL,PIT,7,4,7-4,MIL,9,1,37,40,77,169,155,324,15,13,28,3,3:28
12125,531605,2018-09-14,2018,BAL,CHA,6,8,8-6,CHA,9,0,39,42,81,163,173,336,12,16,28,3,3:35
12126,531618,2018-09-14,2018,ATL,WAS,10,5,10-5,ATL,9,1,44,41,85,155,181,336,21,16,37,5,3:54
12127,531610,2018-09-14,2018,PHI,MIA,14,2,14-2,PHI,9,1,44,38,82,129,171,300,22,12,34,1,2:54
12128,531606,2018-09-14,2018,CHN,CIN,3,2,3-2,CHN,9,1,35,37,72,150,143,293,10,13,23,3,2:58
12129,531620,2018-09-15,2018,BAL,CHA,0,2,2-0,CHA,9,0,34,32,66,128,136,264,8,8,16,2,2:52
12130,531621,2018-09-15,2018,CHN,CIN,1,0,1-0,CHN,9,1,31,31,62,128,135,263,7,6,13,2,2:39
12131,531630,2018-09-15,2018,ANA,SEA,5,6,6-5,SEA,9,0,34,43,77,155,117,272,9,17,26,3,3:06
12132,531622,2018-09-15,2018,SFN,COL,3,0,3-0,SFN,9,1,32,35,67,114,112,226,11,9,20,1,2:28
12133,531629,2018-09-15,2018,MIL,PIT,1,3,3-1,PIT,9,0,35,34,69,168,127,295,9,9,18,2,3:03
12134,531631,2018-09-15,2018,SDN,TEX,3,6,6-3,TEX,9,0,38,41,79,159,154,313,13,14,27,3,3:10
12135,531619,2018-09-15,2018,HOU,ARI,10,4,10-4,HOU,9,1,44,36,80,122,157,279,22,8,30,3,3:17
12136,531627,2018-09-15,2018,BOS,NYN,5,3,5-3,BOS,9,1,39,33,72,155,157,312,16,6,22,3,3:11
12137,531633,2018-09-15,2018,ATL,WAS,1,7,7-1,WAS,9,0,33,47,80,198,145,343,6,22,28,2,3:41
12138,531624,2018-09-15,2018,SLN,LAN,4,17,17-4,LAN,9,0,36,52,88,189,142,331,9,28,37,4,3:32
12139,531632,2018-09-15,2018,NYA,TOR,7,8,8-7,TOR,9,0,44,43,87,166,185,351,17,17,34,8,3:54
12140,531628,2018-09-15,2018,TBA,OAK,7,5,7-5,TBA,9,1,37,40,77,161,150,311,14,15,29,6,3:19
12141,531625,2018-09-15,2018,PHI,MIA,5,4,5-4,PHI,9,1,33,35,68,150,134,284,8,7,15,1,2:48
12142,531626,2018-09-15,2018,KCA,MIN,10,3,10-3,KCA,9,1,41,39,80,140,165,305,16,13,29,3,3:04
12143,531623,2018-09-15,2018,CLE,DET,15,0,15-0,CLE,9,1,52,32,84,138,201,339,26,6,32,5,3:21
12144,531636,2018-09-16,2018,CHN,CIN,1,2,2-1,CIN,9,0,34,38,72,135,126,261,10,11,21,1,2:43
12145,531645,2018-09-16,2018,ANA,SEA,4,3,4-3,ANA,9,1,32,33,65,131,122,253,9,8,17,0,2:55
12146,531647,2018-09-16,2018,NYA,TOR,2,3,3-2,TOR,9,0,34,36,70,138,132,270,8,9,17,0,2:50
12147,531634,2018-09-16,2018,HOU,ARI,5,4,5-4,HOU,9,1,38,34,72,130,144,274,17,7,24,2,3:09
12148,531646,2018-09-16,2018,SDN,TEX,7,3,7-3,SDN,9,0,37,38,75,135,148,283,13,13,26,4,3:15
12149,531643,2018-09-16,2018,TBA,OAK,5,4,5-4,TBA,9,1,37,33,70,135,141,276,14,8,22,2,2:59
12150,531638,2018-09-16,2018,CLE,DET,4,6,6-4,DET,9,0,37,39,76,140,120,260,11,12,23,1,2:33
12151,531639,2018-09-16,2018,SLN,LAN,5,0,5-0,SLN,9,1,33,34,67,150,143,293,9,9,18,4,3:20
12152,531637,2018-09-16,2018,SFN,COL,2,3,3-2,COL,9,0,36,37,73,128,150,278,10,12,22,3,3:02
12153,531641,2018-09-16,2018,KCA,MIN,6,9,9-6,MIN,9,0,38,45,83,198,130,328,13,21,34,3,3:24
12154,531640,2018-09-16,2018,PHI,MIA,4,6,6-4,MIA,9,0,38,37,75,152,160,312,9,11,20,0,3:04
12155,531648,2018-09-16,2018,ATL,WAS,4,6,6-4,WAS,9,0,37,42,79,167,144,311,10,16,26,3,3:15
12156,531644,2018-09-16,2018,MIL,PIT,2,3,3-2,PIT,9,0,34,35,69,128,142,270,7,11,18,0,2:57
12157,531642,2018-09-16,2018,BOS,NYN,4,3,4-3,BOS,9,1,31,36,67,160,119,279,7,11,18,2,2:55
12158,531635,2018-09-16,2018,BAL,CHA,8,4,8-4,BAL,9,1,40,42,82,185,132,317,16,14,30,3,3:27
12159,531655,2018-09-17,2018,SDN,SFN,2,4,4-2,SFN,9,0,34,38,72,141,113,254,9,12,21,2,2:41
12160,531652,2018-09-17,2018,PIT,KCA,7,6,7-6,PIT,9,0,44,39,83,122,161,283,19,11,30,3,3:08
12161,531660,2018-09-17,2018,MIA,WAS,8,5,8-5,MIA,9,1,39,36,75,139,171,310,15,10,25,4,3:17
12162,531657,2018-09-17,2018,ATL,SLN,6,11,11-6,SLN,9,0,43,45,88,175,189,364,16,19,35,2,3:38
12163,531659,2018-09-17,2018,BAL,TOR,0,5,5-0,TOR,9,0,30,33,63,121,118,239,4,6,10,1,2:16 (:30 delay)
12164,531650,2018-09-17,2018,MIL,CIN,8,0,8-0,MIL,9,1,38,36,74,146,137,283,14,10,24,1,2:41
12165,531654,2018-09-17,2018,PHI,NYN,4,9,9-4,NYN,9,0,36,41,77,161,125,286,11,16,27,3,3:07
12166,531658,2018-09-17,2018,TEX,TBA,0,3,3-0,TBA,9,0,33,36,69,128,134,262,6,13,19,2,2:41
12167,531653,2018-09-17,2018,DET,MIN,1,6,6-1,MIN,9,0,35,39,74,154,142,296,9,13,22,1,2:54
12168,531656,2018-09-17,2018,HOU,SEA,1,4,4-1,SEA,9,0,31,42,73,160,129,289,6,17,23,2,3:02
12169,531651,2018-09-17,2018,LAN,COL,8,2,8-2,LAN,9,1,40,34,74,134,163,297,18,9,27,3,3:07
12170,531649,2018-09-17,2018,ARI,CHN,1,5,5-1,CHN,9,0,31,37,68,151,110,261,4,10,14,2,2:46
12171,531663,2018-09-18,2018,CLE,CHA,5,3,5-3,CLE,9,1,34,39,73,126,99,225,13,11,24,0,2:25
12172,531671,2018-09-18,2018,HOU,SEA,7,0,7-0,HOU,9,1,34,37,71,150,112,262,10,10,20,3,2:55
12173,531661,2018-09-18,2018,NYA,BOS,3,2,3-2,NYA,9,1,32,37,69,145,133,278,9,9,18,1,3:13
12174,531673,2018-09-18,2018,TEX,TBA,0,4,4-0,TBA,9,0,32,44,76,164,138,302,6,20,26,3,3:04
12175,531674,2018-09-18,2018,BAL,TOR,4,6,6-4,TOR,9,0,36,37,73,144,128,272,11,11,22,1,2:47
12176,531664,2018-09-18,2018,MIL,CIN,1,3,3-1,CIN,9,0,31,38,69,152,112,264,6,11,17,4,2:54
12177,531665,2018-09-18,2018,LAN,COL,3,2,3-2,LAN,10,0,37,39,76,131,143,274,10,9,19,2,3:13
12178,531668,2018-09-18,2018,DET,MIN,3,5,5-3,MIN,9,0,34,40,74,170,129,299,7,14,21,3,3:02
12179,531670,2018-09-18,2018,SDN,SFN,4,5,5-4,SFN,9,0,39,39,78,162,150,312,14,11,25,0,3:20
12180,531662,2018-09-18,2018,ARI,CHN,1,9,9-1,CHN,9,0,33,42,75,178,126,304,5,14,19,1,3:10
12181,531675,2018-09-18,2018,MIA,WAS,2,4,4-2,WAS,9,0,36,45,81,172,135,307,9,20,29,2,3:14
12182,531667,2018-09-18,2018,OAK,ANA,7,9,9-7,ANA,9,0,40,40,80,155,182,337,14,14,28,4,3:42
12183,531672,2018-09-18,2018,ATL,SLN,1,8,8-1,SLN,9,0,40,41,81,173,161,334,13,15,28,3,3:18
12184,531666,2018-09-18,2018,PIT,KCA,2,1,2-1,PIT,11,0,42,41,83,166,163,329,13,10,23,2,3:29
12185,531669,2018-09-18,2018,PHI,NYN,5,2,5-2,PHI,9,1,38,37,75,153,159,312,15,11,26,3,3:22
12186,531677,2018-09-19,2018,ARI,CHN,9,0,9-0,ARI,9,1,36,32,68,131,109,240,13,5,18,1,2:20
12187,531682,2018-09-19,2018,OAK,ANA,10,0,10-0,OAK,9,1,39,31,70,110,134,244,14,4,18,2,2:23
12188,531680,2018-09-19,2018,LAN,COL,5,2,5-2,LAN,9,1,31,35,66,132,127,259,8,6,14,4,3:05
12189,531685,2018-09-19,2018,SDN,SFN,8,4,8-4,SDN,9,1,36,37,73,137,158,295,12,11,23,2,2:54
12190,531689,2018-09-19,2018,BAL,TOR,2,1,2-1,BAL,9,1,32,33,65,122,140,262,7,7,14,2,2:34
12191,531688,2018-09-19,2018,TEX,TBA,3,9,9-3,TBA,9,0,35,45,80,152,127,279,10,21,31,4,2:55
12192,531683,2018-09-19,2018,DET,MIN,2,8,8-2,MIN,9,0,32,40,72,164,124,288,7,13,20,1,2:47
12193,531686,2018-09-19,2018,HOU,SEA,0,9,9-0,SEA,9,0,33,40,73,161,116,277,8,13,21,1,2:47
12194,531687,2018-09-19,2018,ATL,SLN,7,3,7-3,ATL,9,1,36,39,75,147,142,289,13,14,27,3,3:09
12195,531684,2018-09-19,2018,PHI,NYN,4,0,4-0,PHI,9,1,37,35,72,141,153,294,12,9,21,2,3:02
12196,531679,2018-09-19,2018,MIL,CIN,7,0,7-0,MIL,9,1,34,32,66,137,137,274,11,6,17,1,2:39
12197,531678,2018-09-19,2018,CLE,CHA,4,1,4-1,CLE,9,0,36,37,73,152,146,298,10,7,17,5,3:12
12198,531676,2018-09-19,2018,NYA,BOS,10,1,10-1,NYA,9,1,40,37,77,145,144,289,15,11,26,2,3:17
12199,531681,2018-09-19,2018,PIT,KCA,2,1,2-1,PIT,9,1,31,33,64,119,103,222,9,8,17,0,2:22
12200,531697,2018-09-20,2018,TOR,TBA,9,8,9-8,TOR,9,0,39,43,82,157,137,294,13,16,29,6,3:13
12201,531696,2018-09-20,2018,ATL,PHI,8,3,8-3,ATL,9,1,39,34,73,134,163,297,17,8,25,5,3:25
12202,531690,2018-09-20,2018,NYA,BOS,6,11,11-6,BOS,9,0,40,43,83,181,168,349,14,18,32,5,4:02
12203,531695,2018-09-20,2018,WAS,NYN,4,5,5-4,NYN,12,0,49,51,100,190,184,374,15,17,32,5,4:16
12204,531694,2018-09-20,2018,OAK,ANA,21,3,21-3,OAK,9,1,51,35,86,140,183,323,29,8,37,4,3:22
12205,531693,2018-09-20,2018,DET,KCA,11,8,11-8,DET,9,1,43,42,85,166,152,318,19,13,32,3,3:12
12206,531692,2018-09-20,2018,MIA,CIN,2,4,4-2,CIN,9,0,37,38,75,140,131,271,12,13,25,1,2:41
12207,531691,2018-09-20,2018,CLE,CHA,4,5,5-4,CHA,11,0,48,52,100,183,207,390,19,20,39,5,4:23
12208,531704,2018-09-21,2018,HOU,ANA,11,3,11-3,HOU,9,1,40,35,75,132,138,270,15,8,23,0,2:56
12209,531705,2018-09-21,2018,PIT,MIL,3,8,8-3,MIL,9,0,34,42,76,147,142,289,9,17,26,3,3:05 (2:14 delay)
12210,531709,2018-09-21,2018,LAN,SDN,3,5,5-3,SDN,9,0,40,41,81,158,178,336,13,14,27,7,3:57
12211,531699,2018-09-21,2018,CLE,BOS,5,7,7-5,BOS,9,0,41,39,80,150,176,326,14,17,31,5,3:34
12212,531698,2018-09-21,2018,NYA,BAL,10,8,10-8,NYA,9,1,39,43,82,158,175,333,16,17,33,6,3:35
12213,531712,2018-09-21,2018,TOR,TBA,3,11,11-3,TBA,9,0,34,51,85,216,130,346,8,26,34,5,3:20
12214,531703,2018-09-21,2018,DET,KCA,3,4,4-3,KCA,9,0,36,38,74,134,127,261,10,11,21,1,2:51
12215,531701,2018-09-21,2018,MIA,CIN,1,0,1-0,MIA,10,0,34,34,68,143,121,264,8,4,12,2,2:36
12216,531702,2018-09-21,2018,ARI,COL,2,6,6-2,COL,9,0,34,39,73,133,125,258,8,13,21,3,2:54
12217,531711,2018-09-21,2018,TEX,SEA,8,3,8-3,TEX,7,1,29,31,60,119,113,232,13,12,25,2,2:17 (1:09 delay)
12218,531710,2018-09-21,2018,SLN,SFN,5,3,5-3,SLN,9,1,37,39,76,170,140,310,13,14,27,3,3:22
12219,531707,2018-09-21,2018,WAS,NYN,2,4,4-2,NYN,9,0,33,40,73,149,133,282,8,13,21,0,2:57
12220,531708,2018-09-21,2018,ATL,PHI,6,5,6-5,ATL,9,1,37,36,73,138,159,297,14,11,25,3,3:24
12221,531706,2018-09-21,2018,OAK,MIN,7,6,7-6,OAK,10,0,40,42,82,162,164,326,13,14,27,4,3:21
12222,531700,2018-09-21,2018,CHA,CHN,10,4,10-4,CHA,9,1,41,39,80,155,167,322,20,11,31,6,3:33
12223,531721,2018-09-22,2018,OAK,MIN,3,2,3-2,OAK,9,0,37,36,73,132,136,268,13,10,23,6,3:03
12224,531723,2018-09-22,2018,ATL,PHI,5,3,5-3,ATL,9,1,35,34,69,115,135,250,13,8,21,4,2:38
12225,531720,2018-09-22,2018,PIT,MIL,3,0,3-0,PIT,9,1,34,32,66,138,143,281,14,6,20,2,3:01
12226,531722,2018-09-22,2018,WAS,NYN,6,0,6-0,WAS,9,1,35,32,67,134,128,262,13,5,18,0,2:32
12227,531717,2018-09-22,2018,ARI,COL,1,5,5-1,COL,9,0,29,43,72,169,90,259,3,19,22,2,3:02
12228,531727,2018-09-22,2018,TOR,TBA,5,2,5-2,TOR,9,1,34,38,72,143,125,268,12,12,24,2,2:44
12229,531726,2018-09-22,2018,TEX,SEA,0,13,13-0,SEA,9,0,30,48,78,190,116,306,5,22,27,3,3:07
12230,531713,2018-09-22,2018,NYA,BAL,3,2,3-2,NYA,11,0,41,47,88,201,176,377,11,17,28,0,3:53
12231,531718,2018-09-22,2018,DET,KCA,5,4,5-4,DET,9,1,37,33,70,126,150,276,12,8,20,0,2:42
12232,531724,2018-09-22,2018,LAN,SDN,7,2,7-2,LAN,9,1,36,36,72,139,134,273,12,9,21,4,2:51
12233,531716,2018-09-22,2018,MIA,CIN,5,1,5-1,MIA,9,1,33,34,67,118,107,225,8,8,16,4,2:22
12234,531715,2018-09-22,2018,CHA,CHN,3,8,8-3,CHN,9,0,37,41,78,147,165,312,10,14,24,3,3:25
12235,531719,2018-09-22,2018,HOU,ANA,10,5,10-5,HOU,9,1,41,38,79,164,173,337,19,10,29,5,4:04
12236,531725,2018-09-22,2018,SLN,SFN,5,4,5-4,SLN,10,0,36,45,81,163,126,289,9,16,25,2,3:13
12237,531714,2018-09-22,2018,CLE,BOS,5,4,5-4,CLE,11,0,47,47,94,191,193,384,20,15,35,3,3:46
12238,531738,2018-09-23,2018,ATL,PHI,2,1,2-1,ATL,9,1,29,36,65,131,115,246,5,10,15,0,2:43
12239,531742,2018-09-23,2018,TOR,TBA,2,5,5-2,TBA,9,0,36,37,73,142,133,275,10,11,21,3,2:41
12240,531728,2018-09-23,2018,NYA,BAL,3,6,6-3,BAL,9,0,35,40,75,174,147,321,8,14,22,1,3:19
12241,531731,2018-09-23,2018,MIA,CIN,6,0,6-0,MIA,9,1,39,31,70,120,138,258,16,5,21,1,2:30
12242,531737,2018-09-23,2018,WAS,NYN,6,8,8-6,NYN,9,0,46,48,94,196,191,387,19,23,42,6,4:14 (:25 delay)
12243,531741,2018-09-23,2018,TEX,SEA,6,1,6-1,TEX,9,1,37,35,72,133,135,268,15,8,23,4,2:56
12244,531734,2018-09-23,2018,HOU,ANA,6,2,6-2,HOU,9,1,39,34,73,140,144,284,17,7,24,2,3:11
12245,531732,2018-09-23,2018,ARI,COL,0,2,2-0,COL,9,0,37,38,75,143,137,280,10,13,23,1,3:15
12246,531736,2018-09-23,2018,OAK,MIN,1,5,5-1,MIN,9,0,37,35,72,136,151,287,12,9,21,4,3:02
12247,531740,2018-09-23,2018,SLN,SFN,9,2,9-2,SLN,9,1,41,34,75,138,154,292,17,5,22,2,3:02
12248,531739,2018-09-23,2018,LAN,SDN,14,0,14-0,LAN,9,1,45,32,77,129,178,307,20,5,25,2,3:11
12249,531735,2018-09-23,2018,PIT,MIL,6,13,13-6,MIL,9,0,35,50,85,182,146,328,8,23,31,3,3:22
12250,531730,2018-09-23,2018,CHA,CHN,1,6,6-1,CHN,9,0,31,47,78,175,123,298,4,21,25,2,3:08
12251,531729,2018-09-23,2018,CLE,BOS,4,3,4-3,CLE,11,0,43,49,92,201,189,390,16,17,33,4,4:20
12252,531733,2018-09-23,2018,DET,KCA,2,3,3-2,KCA,9,0,36,38,74,165,136,301,10,12,22,0,2:47
12253,531744,2018-09-24,2018,CHA,CLE,0,4,4-0,CLE,9,0,32,42,74,143,137,280,5,16,21,2,2:53
12254,531753,2018-09-24,2018,SFN,SDN,0,5,5-0,SDN,9,0,36,42,78,146,122,268,10,14,24,1,2:41
12255,531752,2018-09-24,2018,CHN,PIT,1,5,5-1,PIT,9,0,36,39,75,165,121,286,10,12,22,3,2:53
12256,531750,2018-09-24,2018,SEA,OAK,3,7,7-3,OAK,9,0,33,41,74,168,128,296,7,14,21,3,3:03
12257,531743,2018-09-24,2018,BOS,BAL,6,2,6-2,BOS,9,1,38,34,72,139,173,312,15,9,24,1,3:06
12258,531749,2018-09-24,2018,TBA,NYA,1,4,4-1,NYA,9,0,35,38,73,163,151,314,8,12,20,0,3:01
12259,531745,2018-09-24,2018,TOR,HOU,3,5,5-3,HOU,9,0,38,38,76,155,148,303,14,12,26,5,3:12
12260,531746,2018-09-24,2018,ARI,LAN,4,7,7-4,LAN,9,0,36,44,80,181,122,303,9,19,28,3,3:33
12261,531751,2018-09-24,2018,COL,PHI,10,1,10-1,COL,9,1,44,32,76,129,152,281,22,8,30,1,2:57
12262,531754,2018-09-24,2018,ANA,TEX,5,4,5-4,ANA,11,0,42,41,83,133,155,288,13,8,21,2,3:12
12263,531747,2018-09-24,2018,WAS,MIA,7,3,7-3,WAS,9,1,39,40,79,174,140,314,15,12,27,0,3:09
12264,531748,2018-09-24,2018,SLN,MIL,4,6,6-4,MIL,9,0,38,41,79,173,133,306,11,17,28,7,3:49 (:31 delay)
12265,531759,2018-09-25,2018,TOR,HOU,1,4,4-1,HOU,9,0,34,40,74,142,118,260,9,10,19,3,3:00
12266,531758,2018-09-25,2018,MIN,DET,2,4,4-2,DET,9,0,38,37,75,152,158,310,12,8,20,2,3:12
12267,531761,2018-09-25,2018,ARI,LAN,4,3,4-3,ARI,9,0,35,39,74,139,141,280,13,14,27,5,3:23
12268,531769,2018-09-25,2018,ANA,TEX,4,1,4-1,ANA,9,1,33,35,68,134,126,260,11,8,19,2,3:01
12269,531760,2018-09-25,2018,CIN,KCA,3,4,4-3,KCA,9,0,39,36,75,129,142,271,13,8,21,1,2:40 (:51 delay)
12270,531757,2018-09-25,2018,CHA,CLE,5,4,5-4,CHA,9,0,39,38,77,147,141,288,13,12,25,2,3:10 (:51 delay)
12271,531762,2018-09-25,2018,WAS,MIA,9,4,9-4,WAS,9,1,42,37,79,142,159,301,23,10,33,2,3:12
12272,531764,2018-09-25,2018,TBA,NYA,2,9,9-2,NYA,9,0,36,43,79,171,150,321,9,18,27,4,3:14
12273,531763,2018-09-25,2018,SLN,MIL,4,12,12-4,MIL,9,0,38,49,87,156,151,307,12,21,33,6,3:29
12274,531755,2018-09-25,2018,NYN,ATL,3,7,7-3,ATL,9,0,40,42,82,172,158,330,13,14,27,2,3:24 (:32 delay)
12275,531767,2018-09-25,2018,CHN,PIT,0,6,6-0,PIT,9,0,34,45,79,167,128,295,8,18,26,5,3:17 (:55 delay)
12276,531766,2018-09-25,2018,COL,PHI,10,3,10-3,COL,9,1,43,41,84,138,149,287,19,14,33,4,3:21
12277,531765,2018-09-25,2018,SEA,OAK,10,8,10-8,SEA,11,0,50,51,101,208,181,389,18,20,38,3,3:57
12278,531768,2018-09-25,2018,SFN,SDN,5,4,5-4,SFN,12,0,44,52,96,202,158,360,9,19,28,2,3:38
12279,531772,2018-09-26,2018,CHA,CLE,2,10,10-2,CLE,9,0,37,51,88,206,152,358,10,25,35,3,3:47
12280,531770,2018-09-26,2018,NYN,ATL,3,0,3-0,NYN,9,1,34,28,62,121,139,260,10,2,12,0,2:22
12281,531780,2018-09-26,2018,SEA,OAK,3,9,9-3,OAK,9,0,39,41,80,149,156,305,13,15,28,4,3:13
12282,531773,2018-09-26,2018,MIN,DET,11,4,11-4,MIN,9,1,43,40,83,164,177,341,21,14,35,3,3:36
12283,531771,2018-09-26,2018,BOS,BAL,3,10,10-3,BAL,9,0,39,46,85,200,159,359,11,18,29,4,3:45
12284,531756,2018-09-26,2018,BOS,BAL,19,3,19-3,BOS,9,1,48,37,85,136,187,323,25,11,36,2,3:10
12285,531775,2018-09-26,2018,CIN,KCA,1,6,6-1,KCA,9,0,34,38,72,149,135,284,8,11,19,3,2:48
12286,531777,2018-09-26,2018,WAS,MIA,9,3,9-3,WAS,8,1,38,30,68,125,129,254,17,9,26,2,2:45 (:51 delay)
12287,531783,2018-09-26,2018,SFN,SDN,2,3,3-2,SDN,9,0,35,36,71,141,150,291,9,9,18,1,2:57
12288,531776,2018-09-26,2018,ARI,LAN,7,2,7-2,ARI,9,1,36,37,73,144,135,279,14,12,26,2,3:14
12289,531778,2018-09-26,2018,SLN,MIL,1,2,2-1,MIL,9,0,32,39,71,178,107,285,6,13,19,5,3:16
12290,531781,2018-09-26,2018,COL,PHI,14,0,14-0,COL,9,1,43,32,75,131,151,282,20,6,26,3,2:51
12291,531774,2018-09-26,2018,TOR,HOU,3,1,3-1,TOR,9,1,28,34,62,124,119,243,6,8,14,3,2:27
12292,531756,2018-09-26,2018,BOS,BAL,19,3,19-3,BOS,9,1,48,37,85,136,187,323,25,11,36,2,3:10
12293,531784,2018-09-26,2018,ANA,TEX,3,2,3-2,ANA,9,1,33,34,67,126,137,263,11,8,19,3,2:41
12294,531782,2018-09-26,2018,CHN,PIT,7,6,7-6,CHN,10,0,44,42,86,170,165,335,17,15,32,3,3:42
12295,531779,2018-09-26,2018,TBA,NYA,8,7,8-7,TBA,9,1,38,42,80,189,158,347,14,15,29,6,3:52
12296,531791,2018-09-27,2018,CHN,PIT,3,0,3-0,CHN,9,1,35,36,71,148,142,290,13,9,22,0,2:53
12297,531792,2018-09-27,2018,SEA,TEX,0,2,2-0,TEX,9,0,31,38,69,143,117,260,4,12,16,1,2:36
12298,531787,2018-09-27,2018,MIN,DET,9,3,9-3,MIN,9,1,39,42,81,187,173,360,16,15,31,2,3:20
12299,531785,2018-09-27,2018,NYN,ATL,4,1,4-1,NYN,9,1,33,35,68,118,138,256,9,8,17,3,2:41
12300,531789,2018-09-27,2018,TBA,NYA,1,12,12-1,NYA,9,0,32,43,75,172,118,290,5,17,22,2,2:49
12301,531786,2018-09-27,2018,KCA,CLE,2,1,2-1,KCA,10,0,40,41,81,151,153,304,11,12,23,2,3:08
12302,531790,2018-09-27,2018,COL,PHI,5,3,5-3,COL,9,1,35,40,75,175,127,302,10,13,23,3,3:06
12303,529615,2018-09-28,2018,MIN,CHA,2,1,2-1,MIN,9,1,33,34,67,130,136,266,10,8,18,1,2:45
12304,531798,2018-09-28,2018,BAL,HOU,1,2,2-1,HOU,9,0,33,35,68,126,135,261,7,10,17,1,2:39
12305,529615,2018-09-28,2018,MIN,CHA,2,1,2-1,MIN,9,1,33,34,67,130,136,266,10,8,18,1,2:45
12306,531806,2018-09-28,2018,TBA,TOR,6,7,7-6,TOR,9,0,44,43,87,158,168,326,17,18,35,7,3:39
12307,531795,2018-09-28,2018,MIN,CHA,12,4,12-4,MIN,9,1,47,37,84,128,178,306,21,11,32,1,3:02
12308,531794,2018-09-28,2018,PHI,ATL,2,10,10-2,ATL,9,0,36,48,84,184,162,346,9,22,31,5,3:42
12309,531801,2018-09-28,2018,BOS,NYA,6,11,11-6,NYA,9,0,41,45,86,192,165,357,13,17,30,2,3:27
12310,531800,2018-09-28,2018,NYN,MIA,1,8,8-1,MIA,9,0,36,47,83,192,146,338,11,18,29,1,3:07
12311,531804,2018-09-28,2018,CHN,SLN,8,4,8-4,CHN,9,1,38,39,77,118,152,270,13,12,25,3,3:07
12312,531802,2018-09-28,2018,ANA,OAK,8,5,8-5,ANA,9,1,37,40,77,174,123,297,15,14,29,4,3:17
12313,531799,2018-09-28,2018,SFN,LAN,1,3,3-1,LAN,9,0,33,36,69,159,141,300,10,10,20,2,3:16
12314,531805,2018-09-28,2018,SEA,TEX,12,6,12-6,SEA,9,1,45,40,85,165,202,367,20,15,35,4,3:47
12315,531807,2018-09-28,2018,COL,WAS,5,2,5-2,COL,9,1,31,39,70,133,121,254,9,13,22,2,2:51
12316,531796,2018-09-28,2018,KCA,CLE,6,14,14-6,CLE,9,0,37,47,84,175,157,332,10,19,29,4,3:16
12317,531803,2018-09-28,2018,CIN,PIT,4,8,8-4,PIT,9,0,44,43,87,160,176,336,19,15,34,3,3:36
12318,531793,2018-09-28,2018,SDN,ARI,3,2,3-2,SDN,15,0,55,61,116,204,223,427,15,20,35,2,5:02
12319,531797,2018-09-28,2018,MIL,DET,6,5,6-5,MIL,9,1,35,36,71,157,151,308,13,10,23,1,3:07
12320,531820,2018-09-29,2018,SEA,TEX,4,1,4-1,SEA,9,1,34,37,71,140,97,237,11,11,22,2,2:37
12321,531818,2018-09-29,2018,CIN,PIT,3,0,3-0,CIN,9,1,30,34,64,113,112,225,7,8,15,1,2:17
12322,531819,2018-09-29,2018,CHN,SLN,1,2,2-1,SLN,9,0,31,34,65,134,104,238,5,7,12,0,2:25
12323,531821,2018-09-29,2018,TBA,TOR,4,3,4-3,TBA,9,1,33,36,69,147,120,267,13,9,22,1,2:38
12324,531788,2018-09-29,2018,BAL,HOU,2,5,5-2,HOU,9,0,35,40,75,157,134,291,11,13,24,1,2:53
12325,531817,2018-09-29,2018,ANA,OAK,2,5,5-2,OAK,9,0,38,37,75,152,145,297,10,12,22,2,3:11
12326,531814,2018-09-29,2018,SFN,LAN,6,10,10-6,LAN,9,0,36,51,87,173,139,312,10,28,38,7,3:33
12327,531813,2018-09-29,2018,BAL,HOU,3,4,4-3,HOU,9,0,34,39,73,156,145,301,9,13,22,0,2:58
12328,531816,2018-09-29,2018,BOS,NYA,5,8,8-5,NYA,9,0,43,43,86,164,189,353,16,15,31,3,3:40
12329,531810,2018-09-29,2018,MIN,CHA,8,3,8-3,MIN,9,1,42,38,80,146,186,332,19,10,29,1,3:20
12330,531809,2018-09-29,2018,PHI,ATL,3,0,3-0,PHI,9,1,35,34,69,114,134,248,13,9,22,1,2:43
12331,531808,2018-09-29,2018,SDN,ARI,4,5,5-4,ARI,9,0,36,39,75,148,137,285,10,13,23,2,2:49
12332,531811,2018-09-29,2018,KCA,CLE,9,4,9-4,KCA,9,1,45,38,83,149,161,310,21,12,33,2,3:07
12333,531788,2018-09-29,2018,BAL,HOU,2,5,5-2,HOU,9,0,35,40,75,157,134,291,11,13,24,1,2:53
12334,531812,2018-09-29,2018,MIL,DET,6,5,6-5,MIL,9,1,37,39,76,154,163,317,12,12,24,5,3:24
12335,531815,2018-09-29,2018,NYN,MIA,1,0,1-0,NYN,13,0,52,45,97,202,199,401,18,9,27,2,4:14
12336,531822,2018-09-29,2018,COL,WAS,2,12,12-2,WAS,9,0,37,48,85,173,156,329,9,22,31,2,3:40
12337,531830,2018-09-30,2018,NYN,MIA,1,0,1-0,NYN,9,1,29,31,60,101,107,208,6,5,11,0,2:10
12338,531824,2018-09-30,2018,PHI,ATL,3,1,3-1,PHI,9,1,35,35,70,150,133,283,10,8,18,3,2:57
12339,531837,2018-09-30,2018,COL,WAS,12,0,12-0,COL,9,1,42,32,74,117,155,272,18,9,27,2,3:02
12340,531832,2018-09-30,2018,ANA,OAK,5,4,5-4,ANA,9,0,32,34,66,145,128,273,8,7,15,0,2:40
12341,531831,2018-09-30,2018,BOS,NYA,10,2,10-2,BOS,9,1,42,34,76,152,180,332,18,8,26,2,3:20
12342,531828,2018-09-30,2018,BAL,HOU,4,0,4-0,BAL,9,1,33,29,62,97,116,213,10,4,14,2,2:23
12343,531825,2018-09-30,2018,MIN,CHA,5,4,5-4,MIN,9,1,33,38,71,152,119,271,9,11,20,3,2:56
12344,531836,2018-09-30,2018,TBA,TOR,9,4,9-4,TBA,9,1,41,38,79,145,142,287,18,12,30,4,3:06
12345,531833,2018-09-30,2018,CIN,PIT,5,6,6-5,PIT,10,0,41,41,82,132,160,292,11,14,25,2,3:07
12346,531829,2018-09-30,2018,SFN,LAN,0,15,15-0,LAN,9,0,29,47,76,190,105,295,2,22,24,2,2:47
12347,531835,2018-09-30,2018,SEA,TEX,3,1,3-1,SEA,9,1,33,29,62,107,107,214,8,4,12,1,2:14
12348,531827,2018-09-30,2018,MIL,DET,11,0,11-0,MIL,9,1,41,34,75,130,177,307,17,8,25,4,3:15
12349,531826,2018-09-30,2018,KCA,CLE,1,2,2-1,CLE,9,0,34,38,72,147,128,275,7,11,18,0,2:44
12350,531823,2018-09-30,2018,SDN,ARI,4,3,4-3,SDN,10,0,45,35,80,130,179,309,18,7,25,1,3:29
12351,531834,2018-09-30,2018,CHN,SLN,10,5,10-5,CHN,9,1,41,44,85,189,161,350,19,18,37,6,3:44
12352,570334,2018-10-01,2018,CHN,MIL,1,3,3-1,MIL,9,0,31,36,67,128,134,262,6,12,18,6,3:06
12353,570335,2018-10-01,2018,LAN,COL,5,2,5-2,LAN,9,1,35,35,70,141,127,268,12,9,21,6,3:21
12354,565221,2019-05-27,2019,CIN,PIT,8,1,8-1,CIN,9,1,36,36,72,144,147,291,13,10,23,0,2:57
12355,566962,2019-03-28,2019,MIN,CLE,2,0,2-0,MIN,9,1,31,30,61,111,92,203,7,3,10,3,2:18
12356,565229,2019-04-13,2019,CIN,SLN,5,2,5-2,CIN,9,1,34,39,73,169,121,290,10,15,25,6,3:08
12357,566275,2019-03-28,2019,SDN,SFN,2,0,2-0,SDN,9,1,28,31,59,108,102,210,7,6,13,2,2:18
12358,567384,2019-05-19,2019,MIA,NYN,3,0,3-0,MIA,9,1,30,28,58,89,104,193,8,3,11,0,1:59
12359,567362,2019-03-31,2019,MIA,COL,3,0,3-0,MIA,9,1,31,32,63,112,112,224,8,6,14,3,2:32
12360,566864,2019-03-28,2019,TOR,DET,0,2,2-0,DET,10,0,33,37,70,137,108,245,3,9,12,0,2:25
12361,567463,2019-04-13,2019,NYA,CHA,4,0,4-0,NYA,9,1,32,29,61,105,124,229,8,1,9,2,2:28
12362,564835,2019-04-07,2019,ARI,BOS,0,1,1-0,BOS,9,0,31,33,64,113,115,228,4,8,12,0,2:29
12363,567460,2019-04-02,2019,NYA,DET,1,3,3-1,DET,9,0,34,38,72,123,121,244,9,12,21,2,2:41
12364,565136,2019-05-03,2019,CHN,SLN,4,0,4-0,CHN,9,1,35,30,65,81,141,222,13,4,17,1,2:28
12365,566301,2019-05-21,2019,SDN,ARI,3,2,3-2,SDN,9,1,29,32,61,114,111,225,5,5,10,0,2:21
12366,566183,2019-04-05,2019,PIT,CIN,2,0,2-0,PIT,9,1,30,30,60,111,103,214,5,5,10,3,2:25
12367,566086,2019-03-28,2019,OAK,ANA,4,0,4-0,OAK,9,1,32,33,65,118,103,221,8,8,16,0,2:18
12368,566187,2019-04-20,2019,PIT,SFN,3,1,3-1,PIT,5,0,20,20,40,79,78,157,5,5,10,0,1:32 (3:08 delay)
12369,565225,2019-04-03,2019,CIN,MIL,0,1,1-0,MIL,9,0,31,34,65,134,125,259,4,8,12,0,2:33
12370,566664,2019-03-28,2019,TBA,HOU,1,5,5-1,HOU,9,0,34,37,71,145,124,269,7,12,19,0,2:38
12371,566766,2019-04-01,2019,TEX,HOU,1,2,2-1,HOU,9,0,28,37,65,143,113,256,2,12,14,1,2:39
12372,566865,2019-03-29,2019,TOR,DET,6,0,6-0,TOR,9,1,34,31,65,114,138,252,10,4,14,0,2:28
12373,567552,2019-03-28,2019,MIL,SLN,5,4,5-4,MIL,9,1,32,34,66,145,127,272,9,7,16,1,2:36
12374,566089,2019-03-31,2019,OAK,ANA,2,1,2-1,OAK,9,1,34,31,65,113,146,259,11,5,16,2,2:40
12375,567065,2019-04-08,2019,PHI,WAS,4,3,4-3,PHI,9,1,35,33,68,129,116,245,12,7,19,2,2:32
12376,565126,2019-04-11,2019,CHN,PIT,2,0,2-0,CHN,9,1,32,33,65,134,120,254,8,6,14,1,2:38 (1:09 delay)
12377,565127,2019-04-12,2019,CHN,ANA,5,1,5-1,CHN,9,1,35,31,66,116,138,254,11,4,15,1,2:29
12378,564839,2019-04-12,2019,ARI,SDN,1,2,2-1,SDN,9,0,31,34,65,128,141,269,4,7,11,2,2:38
12379,566667,2019-03-31,2019,TBA,HOU,3,1,3-1,TBA,9,1,32,29,61,120,110,230,8,4,12,2,2:12
12380,565895,2019-03-28,2019,WAS,NYN,0,2,2-0,NYN,9,0,33,34,67,135,139,274,7,8,15,2,2:44
12381,566278,2019-03-31,2019,SDN,SFN,3,1,3-1,SDN,9,1,37,29,66,129,124,253,15,4,19,1,2:47
12382,566668,2019-04-01,2019,TBA,COL,7,1,7-1,TBA,9,1,37,34,71,133,137,270,13,8,21,5,2:54
12383,566665,2019-03-29,2019,TBA,HOU,4,2,4-2,TBA,9,1,32,36,68,130,133,263,7,11,18,1,2:38
12384,567371,2019-04-17,2019,MIA,CHN,0,6,6-0,CHN,9,0,31,35,66,125,130,255,5,9,14,0,2:25
12385,565220,2019-03-28,2019,CIN,PIT,5,3,5-3,CIN,9,1,34,39,73,167,115,282,9,12,21,5,2:54
12386,566476,2019-04-10,2019,SFN,SDN,1,3,3-1,SDN,9,0,35,35,70,128,114,242,8,9,17,2,2:37
12387,567459,2019-04-01,2019,NYA,DET,3,1,3-1,NYA,9,1,33,36,69,137,134,271,9,9,18,1,2:43
12388,564738,2019-04-08,2019,ANA,MIL,5,2,5-2,ANA,9,1,32,34,66,137,125,262,10,8,18,2,2:40
12389,566570,2019-04-08,2019,SLN,LAN,4,3,4-3,SLN,9,1,30,36,66,132,111,243,7,11,18,2,2:41
12390,566090,2019-04-01,2019,OAK,BOS,7,0,7-0,OAK,9,1,36,31,67,136,126,262,11,6,17,1,2:42
12391,566975,2019-04-29,2019,MIN,HOU,1,0,1-0,MIN,9,1,29,33,62,117,116,233,5,7,12,0,2:31
12392,566567,2019-04-05,2019,SLN,SDN,3,5,5-3,SDN,9,0,33,42,75,170,121,291,6,15,21,0,2:54
12393,566182,2019-04-04,2019,PIT,CIN,2,0,2-0,PIT,9,1,32,37,69,143,116,259,10,11,21,2,2:40
12394,564755,2019-05-18,2019,ANA,KCA,6,3,6-3,ANA,9,1,34,36,70,134,123,257,11,10,21,1,2:42
12395,565512,2019-04-07,2019,DET,KCA,3,1,3-1,DET,9,1,33,33,66,127,146,273,10,9,19,0,2:24
12396,566480,2019-04-14,2019,SFN,COL,0,4,4-0,COL,9,0,29,35,64,145,105,250,2,9,11,0,2:25
12397,566872,2019-04-13,2019,TOR,TBA,3,1,3-1,TOR,9,1,31,34,65,117,134,251,8,10,18,2,2:44
12398,566102,2019-05-07,2019,OAK,CIN,2,0,2-0,OAK,9,1,30,29,59,131,128,259,6,2,8,1,2:25 (1:38 delay)
12399,566988,2019-05-27,2019,MIN,MIL,4,5,5-4,MIL,9,0,41,35,76,140,179,319,14,8,22,2,3:12
12400,566087,2019-03-29,2019,OAK,ANA,2,6,6-2,ANA,9,0,36,39,75,136,139,275,11,15,26,2,2:52
12401,567359,2019-03-28,2019,MIA,COL,3,6,6-3,COL,9,0,34,39,73,149,121,270,6,12,18,1,2:55
12402,566666,2019-03-30,2019,TBA,HOU,3,1,3-1,TBA,9,1,32,36,68,132,123,255,8,11,19,1,2:40
12403,567063,2019-04-06,2019,PHI,MIN,2,6,6-2,MIN,9,0,36,39,75,118,136,254,10,14,24,2,2:50
12404,565240,2019-05-16,2019,CIN,CHN,4,2,4-2,CIN,9,1,38,32,70,127,123,250,15,5,20,1,2:36 (1:51 delay)
12405,567187,2019-05-19,2019,ATL,MIL,2,3,3-2,MIL,10,0,34,37,71,135,117,252,5,9,14,1,2:44
12406,567173,2019-04-29,2019,ATL,SDN,3,1,3-1,ATL,9,1,36,33,69,119,135,254,10,7,17,2,2:33
12407,565327,2019-05-03,2019,CLE,SEA,2,1,2-1,CLE,9,0,32,36,68,147,120,267,7,10,17,2,2:46
12408,565618,2019-04-28,2019,HOU,CLE,4,1,4-1,HOU,9,1,34,37,71,144,110,254,11,10,21,3,2:48
12409,567292,2019-05-31,2019,CHA,CLE,6,1,6-1,CHA,9,1,39,36,75,131,119,250,12,10,22,0,2:41
12410,566091,2019-04-02,2019,OAK,BOS,1,0,1-0,OAK,9,1,30,34,64,123,117,240,7,8,15,0,2:42
12411,566768,2019-04-03,2019,TEX,HOU,4,0,4-0,TEX,9,1,33,34,67,120,142,262,9,8,17,0,2:39
12412,565720,2019-05-02,2019,KCA,TBA,1,3,3-1,TBA,9,0,33,34,67,142,132,274,6,9,15,3,2:33
12413,566964,2019-03-31,2019,MIN,CLE,9,3,9-3,MIN,9,1,39,37,76,155,109,264,18,12,30,2,2:39
12414,565799,2019-03-28,2019,LAN,ARI,12,5,12-5,LAN,9,1,39,35,74,125,144,269,15,9,24,1,2:49
12415,565702,2019-03-28,2019,KCA,CHA,5,3,5-3,KCA,9,1,36,36,72,136,156,292,9,9,18,5,3:12 (1:46 delay)
12416,565804,2019-04-02,2019,LAN,SFN,6,5,6-5,LAN,9,1,34,36,70,131,134,265,11,11,22,1,2:50
12417,565510,2019-04-04,2019,DET,KCA,5,4,5-4,DET,9,1,37,37,74,126,147,273,13,10,23,1,2:47
12418,566088,2019-03-30,2019,OAK,ANA,4,2,4-2,OAK,9,1,34,36,70,146,123,269,10,8,18,3,2:42
12419,566107,2019-05-12,2019,OAK,CLE,3,5,5-3,CLE,9,0,35,36,71,136,138,274,10,12,22,1,2:57
12420,566585,2019-05-08,2019,SLN,PHI,0,5,5-0,PHI,9,0,31,38,69,151,119,270,6,10,16,0,2:41
12421,565533,2019-05-18,2019,DET,OAK,1,4,4-1,OAK,9,0,33,34,67,141,117,258,7,8,15,2,2:40
12422,566400,2019-05-31,2019,SEA,ANA,4,3,4-3,SEA,9,1,29,35,64,149,114,263,6,9,15,2,2:35
12423,567566,2019-04-29,2019,MIL,COL,5,1,5-1,MIL,9,1,34,35,69,136,107,243,10,7,17,3,2:38
12424,566295,2019-05-08,2019,SDN,NYN,3,2,3-2,SDN,9,1,30,35,65,137,124,261,6,9,15,1,2:44
12425,566593,2019-05-25,2019,SLN,ATL,6,3,6-3,SLN,9,1,35,35,70,120,116,236,11,12,23,1,2:40
12426,564740,2019-04-10,2019,ANA,MIL,4,2,4-2,ANA,9,1,30,37,67,145,126,271,7,12,19,2,3:00
12427,565635,2019-05-29,2019,HOU,CHN,1,2,2-1,CHN,9,0,34,35,69,135,120,255,7,10,17,0,2:37
12428,566014,2019-05-26,2019,NYN,DET,4,3,4-3,NYN,9,1,32,35,67,143,107,250,10,8,18,2,2:33
12429,565803,2019-04-01,2019,LAN,SFN,2,4,4-2,SFN,9,0,34,37,71,145,136,281,9,10,19,2,2:59
12430,565227,2019-04-10,2019,CIN,MIA,2,1,2-1,CIN,9,1,30,34,64,155,138,293,8,8,16,1,2:47
12431,567360,2019-03-29,2019,MIA,COL,1,6,6-1,COL,9,0,31,42,73,147,135,282,6,15,21,2,3:04
12432,565704,2019-03-31,2019,KCA,CHA,3,6,6-3,CHA,9,0,34,41,75,155,125,280,7,16,23,3,2:57
12433,566889,2019-05-24,2019,TOR,SDN,3,6,6-3,SDN,9,0,32,38,70,162,122,284,5,11,16,1,2:49
12434,566869,2019-04-02,2019,TOR,BAL,1,2,2-1,BAL,9,0,35,36,71,152,127,279,10,13,23,1,2:45
12435,566109,2019-05-25,2019,OAK,SEA,6,5,6-5,OAK,9,1,35,36,71,139,133,272,13,9,22,1,2:52
12436,566970,2019-04-17,2019,MIN,TOR,4,1,4-1,MIN,9,1,35,34,69,141,140,281,13,9,22,2,2:57
12437,567072,2019-04-26,2019,PHI,MIA,4,0,4-0,PHI,9,1,34,33,67,129,151,280,12,7,19,2,2:47 (1:33 delay)
12438,566198,2019-05-21,2019,PIT,COL,0,5,5-0,COL,9,0,33,40,73,146,124,270,5,14,19,0,2:41
12439,566492,2019-05-20,2019,SFN,ATL,1,4,4-1,ATL,9,0,29,38,67,161,114,275,2,12,14,0,2:23
12440,566473,2019-04-07,2019,SFN,TBA,0,3,3-0,TBA,9,0,32,39,71,153,130,283,7,13,20,4,3:06
12441,565821,2019-05-12,2019,LAN,WAS,6,0,6-0,LAN,9,1,36,29,65,130,148,278,13,2,15,1,2:46
12442,567162,2019-04-07,2019,ATL,MIA,4,3,4-3,ATL,9,0,33,35,68,127,124,251,10,9,19,1,2:33
12443,566963,2019-03-30,2019,MIN,CLE,1,2,2-1,CLE,9,0,32,34,66,141,136,277,7,7,14,2,3:00
12444,567386,2019-05-29,2019,MIA,SFN,4,2,4-2,MIA,9,1,35,35,70,137,108,245,14,8,22,1,2:38
12445,566870,2019-04-03,2019,TOR,BAL,5,3,5-3,TOR,9,1,33,33,66,142,123,265,12,8,20,2,2:42
12446,564753,2019-05-05,2019,ANA,HOU,4,10,10-4,HOU,9,0,34,42,76,139,127,266,7,17,24,2,3:04
12447,566277,2019-03-30,2019,SDN,SFN,2,3,3-2,SFN,9,0,35,39,74,152,134,286,8,14,22,4,3:10
12448,565416,2019-04-08,2019,COL,ATL,6,8,8-6,ATL,9,0,37,42,79,156,121,277,11,17,28,3,2:59
12449,567555,2019-03-31,2019,MIL,SLN,5,4,5-4,MIL,9,0,38,36,74,140,149,289,16,9,25,2,2:54
12450,565242,2019-05-18,2019,CIN,LAN,4,0,4-0,CIN,9,1,33,36,69,144,126,270,8,9,17,0,2:39
12451,566572,2019-04-10,2019,SLN,LAN,7,2,7-2,SLN,9,1,34,33,67,148,118,266,11,7,18,2,2:52
12452,565902,2019-04-14,2019,WAS,PIT,3,4,4-3,PIT,9,0,39,36,75,121,143,264,14,12,26,0,2:47
12453,566281,2019-04-03,2019,SDN,ARI,4,1,4-1,SDN,9,1,34,34,68,138,125,263,11,8,19,1,2:59
12454,564735,2019-04-05,2019,ANA,TEX,3,1,3-1,ANA,9,1,30,35,65,155,120,275,7,9,16,1,2:52
12455,566685,2019-05-12,2019,TBA,NYA,1,7,7-1,NYA,9,0,34,41,75,165,104,269,7,15,22,1,2:55 (:43 delay)
12456,566188,2019-04-21,2019,PIT,SFN,2,3,3-2,SFN,9,0,34,39,73,146,133,279,8,13,21,1,2:47
12457,566987,2019-05-26,2019,MIN,CHA,7,0,7-0,MIN,9,1,32,35,67,158,126,284,8,8,16,2,2:55
12458,567061,2019-03-31,2019,PHI,ATL,5,1,5-1,PHI,9,1,39,36,75,141,156,297,16,11,27,2,3:17
12459,567558,2019-04-07,2019,MIL,CHN,4,2,4-2,MIL,9,1,39,36,75,145,142,287,15,9,24,4,3:04
12460,566279,2019-04-01,2019,SDN,ARI,3,10,10-3,ARI,9,0,34,45,79,161,121,282,8,19,27,1,3:04
12461,564935,2019-04-10,2019,BAL,OAK,3,10,10-3,OAK,9,0,34,42,76,168,129,297,7,16,23,1,2:35
12462,565607,2019-04-06,2019,HOU,OAK,6,0,6-0,HOU,9,1,36,36,72,150,144,294,13,10,23,1,2:47
12463,566486,2019-05-01,2019,SFN,LAN,2,1,2-1,SFN,9,0,31,36,67,165,123,288,7,8,15,1,3:01
12464,564934,2019-04-09,2019,BAL,OAK,2,13,13-2,OAK,9,0,33,45,78,175,113,288,8,18,26,3,2:53
12465,565723,2019-05-12,2019,KCA,PHI,1,6,6-1,PHI,9,0,35,41,76,149,122,271,8,14,22,2,2:37
12466,566868,2019-04-01,2019,TOR,BAL,5,6,6-5,BAL,9,0,34,38,72,156,126,282,8,11,19,2,2:46
12467,567486,2019-05-29,2019,NYA,SDN,7,0,7-0,NYA,9,1,38,34,72,134,155,289,13,7,20,1,2:39
12468,565827,2019-05-30,2019,LAN,NYN,2,0,2-0,LAN,9,1,34,33,67,126,126,252,12,6,18,2,2:47
12469,567564,2019-04-20,2019,MIL,LAN,5,0,5-0,MIL,9,1,34,34,68,155,125,280,11,7,18,2,2:51
12470,567064,2019-04-07,2019,PHI,MIN,2,1,2-1,PHI,9,1,32,33,65,134,133,267,8,7,15,2,2:47
12471,567288,2019-05-27,2019,CHA,KCA,2,1,2-1,CHA,9,0,35,32,67,111,149,260,14,7,21,3,2:56 (3:04 delay)
12472,565241,2019-05-17,2019,CIN,LAN,0,6,6-0,LAN,9,0,30,38,68,121,127,248,4,13,17,0,2:24
12473,565221,2019-05-27,2019,CIN,PIT,8,1,8-1,CIN,9,1,36,36,72,144,147,291,13,10,23,0,2:57
12474,565703,2019-03-30,2019,KCA,CHA,8,6,8-6,KCA,9,1,39,38,77,154,153,307,16,12,28,4,3:16 (:30 delay)
12475,564936,2019-04-11,2019,BAL,OAK,5,8,8-5,OAK,9,0,38,40,78,146,141,287,10,13,23,4,2:50
12476,567269,2019-04-15,2019,CHA,KCA,5,4,5-4,CHA,9,1,37,37,74,148,136,284,14,13,27,0,3:02
12477,565224,2019-04-02,2019,CIN,MIL,3,4,4-3,MIL,9,0,36,40,76,151,141,292,9,15,24,3,3:07
12478,566567,2019-04-05,2019,SLN,SDN,3,5,5-3,SDN,9,0,33,42,75,170,121,291,6,15,21,0,2:54
12479,566776,2019-04-20,2019,TEX,HOU,9,4,9-4,TEX,9,1,38,38,76,124,165,289,14,13,27,2,2:51
12480,564834,2019-04-06,2019,ARI,BOS,5,4,5-4,ARI,9,0,35,38,73,152,125,277,12,13,25,2,3:19
12481,565513,2019-04-09,2019,DET,CLE,2,8,8-2,CLE,9,0,37,37,74,143,129,272,9,12,21,1,2:32
12482,565610,2019-04-09,2019,HOU,NYA,6,3,6-3,HOU,9,1,40,34,74,131,163,294,16,8,24,3,3:15
12483,566787,2019-05-21,2019,TEX,SEA,5,3,5-3,TEX,9,1,37,33,70,145,157,302,13,7,20,1,2:56
12484,565632,2019-05-26,2019,HOU,BOS,1,4,4-1,BOS,9,0,33,37,70,137,147,284,7,8,15,0,3:06
12485,565316,2019-04-01,2019,CLE,CHA,5,3,5-3,CLE,9,1,37,36,73,148,127,275,14,8,22,4,3:02
12486,565029,2019-04-12,2019,BOS,BAL,6,4,6-4,BOS,9,1,36,34,70,139,129,268,12,6,18,5,2:55
12487,566286,2019-04-20,2019,SDN,CIN,2,4,4-2,CIN,9,0,36,37,73,154,139,293,10,11,21,2,3:04
12488,564957,2019-05-28,2019,BAL,DET,0,3,3-0,DET,9,0,35,37,72,131,160,291,9,10,19,2,3:00
12489,565912,2019-05-02,2019,WAS,SLN,2,1,2-1,WAS,9,1,31,38,69,159,122,281,7,12,19,3,3:00 (2:32 delay)
12490,566185,2019-04-07,2019,PIT,CIN,7,5,7-5,PIT,9,1,38,36,74,142,123,265,19,10,29,2,2:54
12491,565994,2019-04-10,2019,NYN,MIN,9,6,9-6,NYN,9,1,39,36,75,134,162,296,16,10,26,3,3:15
12492,565620,2019-05-07,2019,HOU,KCA,2,12,12-2,KCA,9,0,35,45,80,152,126,278,11,18,29,2,2:45
12493,566474,2019-04-08,2019,SFN,SDN,5,6,6-5,SDN,9,0,38,37,75,129,141,270,11,11,22,1,2:55
12494,567087,2019-05-28,2019,PHI,SLN,4,3,4-3,PHI,9,1,31,34,65,169,115,284,8,7,15,1,2:28 (:50 delay)
12495,567363,2019-04-01,2019,MIA,NYN,3,7,7-3,NYN,9,0,36,40,76,166,135,301,10,14,24,1,3:10
12496,566373,2019-03-29,2019,SEA,BOS,6,7,7-6,BOS,9,0,40,38,78,149,146,295,12,12,24,3,3:20
12497,565317,2019-04-03,2019,CLE,CHA,3,8,8-3,CHA,9,0,35,44,79,159,147,306,6,17,23,1,3:01
12498,567263,2019-04-05,2019,CHA,SEA,10,8,10-8,CHA,9,1,40,41,81,162,165,327,15,14,29,4,3:36
12499,567059,2019-03-28,2019,PHI,ATL,10,4,10-4,PHI,9,1,37,36,73,156,148,304,15,13,28,1,3:04
12500,566299,2019-05-19,2019,SDN,PIT,4,6,6-4,PIT,9,0,33,39,72,152,127,279,8,13,21,2,2:56
12501,565518,2019-04-18,2019,DET,CHA,9,7,9-7,DET,9,1,40,42,82,157,130,287,19,12,31,4,3:10
12502,566866,2019-03-30,2019,TOR,DET,3,0,3-0,TOR,9,1,35,36,71,164,135,299,12,10,22,4,3:00
12503,566888,2019-05-23,2019,TOR,BOS,2,8,8-2,BOS,9,0,33,44,77,157,134,291,6,18,24,1,3:01
12504,567554,2019-03-30,2019,MIL,SLN,4,2,4-2,MIL,9,1,38,35,73,145,147,292,14,8,22,2,3:07
12505,567366,2019-04-12,2019,MIA,PHI,1,9,9-1,PHI,9,0,33,44,77,150,133,283,8,19,27,0,2:46
12506,566669,2019-04-02,2019,TBA,COL,4,0,4-0,TBA,9,1,40,29,69,127,171,298,15,4,19,1,2:50
12507,567361,2019-03-30,2019,MIA,COL,7,3,7-3,MIA,9,1,40,36,76,147,139,286,17,9,26,3,3:00
12508,565609,2019-04-08,2019,HOU,NYA,4,3,4-3,HOU,9,1,34,38,72,150,124,274,11,11,22,1,2:59
12509,565809,2019-04-15,2019,LAN,CIN,4,3,4-3,LAN,9,0,37,32,69,121,146,267,12,7,19,1,2:49
12510,564836,2019-04-09,2019,ARI,TEX,5,4,5-4,ARI,9,0,35,37,72,133,127,260,11,9,20,1,2:48
12511,566475,2019-04-09,2019,SFN,SDN,7,2,7-2,SFN,9,1,34,33,67,147,138,285,10,9,19,0,2:39
12512,565032,2019-04-15,2019,BOS,BAL,1,8,8-1,BAL,9,0,32,41,73,172,134,306,7,17,24,2,3:17
12513,566569,2019-04-07,2019,SLN,SDN,4,1,4-1,SLN,9,1,36,34,70,149,150,299,13,8,21,3,3:08
12514,566377,2019-04-02,2019,SEA,ANA,2,1,2-1,SEA,9,1,29,32,61,109,110,219,5,5,10,1,2:16
12515,566965,2019-05-11,2019,MIN,DET,8,3,8-3,MIN,9,1,42,36,78,132,160,292,18,10,28,1,2:45
12516,566689,2019-05-28,2019,TBA,TOR,3,1,3-1,TBA,9,1,35,35,70,127,145,272,12,8,20,2,2:49
12517,566276,2019-03-29,2019,SDN,SFN,4,1,4-1,SDN,9,1,34,37,71,149,142,291,13,10,23,3,3:07
12518,566966,2019-04-13,2019,MIN,DET,4,3,4-3,MIN,9,1,34,37,71,149,143,292,12,11,23,2,3:07
12519,567471,2019-05-03,2019,NYA,MIN,6,3,6-3,NYA,9,1,34,35,69,164,145,309,12,8,20,0,3:08
12520,566011,2019-05-23,2019,NYN,WAS,6,4,6-4,NYN,9,1,34,40,74,150,125,275,12,17,29,0,2:53
12521,565606,2019-04-05,2019,HOU,OAK,3,2,3-2,HOU,9,1,36,36,72,137,150,287,13,10,23,0,3:03
12522,566489,2019-05-12,2019,SFN,CIN,6,5,6-5,SFN,9,1,35,39,74,172,120,292,11,13,24,2,3:01
12523,565515,2019-04-11,2019,DET,CLE,0,4,4-0,CLE,9,0,32,41,73,180,118,298,4,17,21,0,2:47
12524,567484,2019-05-27,2019,NYA,SDN,5,2,5-2,NYA,9,1,35,33,68,124,132,256,11,7,18,1,2:40
12525,567290,2019-05-29,2019,CHA,KCA,8,7,8-7,CHA,9,1,35,42,77,160,126,286,12,18,30,3,3:03
12526,566396,2019-05-27,2019,SEA,TEX,6,2,6-2,SEA,9,1,39,34,73,134,171,305,15,7,22,3,3:14
12527,565897,2019-03-31,2019,WAS,NYN,6,5,6-5,WAS,9,0,38,41,79,152,165,317,13,15,28,4,3:15
12528,564933,2019-04-08,2019,BAL,OAK,12,4,12-4,BAL,9,1,42,39,81,143,163,306,18,13,31,3,3:07
12529,567469,2019-04-20,2019,NYA,KCA,9,2,9-2,NYA,9,1,42,35,77,132,173,305,18,10,28,0,3:00
12530,567088,2019-05-29,2019,PHI,SLN,11,4,11-4,PHI,9,1,44,38,82,137,152,289,21,11,32,3,3:01 (1:39 delay)
12531,564760,2019-05-24,2019,ANA,TEX,3,4,4-3,TEX,9,0,38,40,78,174,132,306,12,12,24,0,3:13
12532,567476,2019-05-08,2019,NYA,SEA,1,10,10-1,SEA,9,0,32,45,77,179,116,295,6,19,25,1,3:07
12533,566008,2019-05-20,2019,NYN,WAS,5,3,5-3,NYN,9,1,37,38,75,150,152,302,14,13,27,3,3:12
12534,565330,2019-05-06,2019,CLE,CHA,1,9,9-1,CHA,9,0,39,40,79,149,141,290,13,15,28,2,3:01
12535,565633,2019-05-27,2019,HOU,CHN,6,5,6-5,HOU,9,1,38,38,76,157,159,316,14,11,25,2,3:12
12536,567456,2019-03-28,2019,NYA,BAL,7,2,7-2,NYA,9,1,39,35,74,135,164,299,18,9,27,2,3:06
12537,564943,2019-05-03,2019,BAL,TBA,0,7,7-0,TBA,9,0,31,43,74,158,114,272,5,19,24,1,2:38
12538,565828,2019-05-31,2019,LAN,PHI,6,3,6-3,LAN,9,1,36,35,71,139,137,276,13,8,21,1,2:59
12539,565537,2019-05-23,2019,DET,MIA,2,5,5-2,MIA,9,0,35,39,74,143,135,278,13,12,25,2,2:58
12540,567291,2019-05-30,2019,CHA,CLE,10,4,10-4,CHA,9,1,39,38,77,152,137,289,16,13,29,3,3:10
12541,565514,2019-04-10,2019,DET,CLE,4,1,4-1,DET,9,1,38,37,75,151,168,319,14,11,25,3,3:14
12542,567184,2019-05-16,2019,ATL,SLN,10,2,10-2,ATL,9,1,42,35,77,148,153,301,22,10,32,3,3:16
12543,565230,2019-04-14,2019,CIN,SLN,5,9,9-5,SLN,9,0,39,43,82,170,133,303,14,18,32,5,3:19
12544,567286,2019-05-18,2019,CHA,TOR,4,1,4-1,CHA,5,1,20,19,39,78,74,152,8,5,13,0,1:31 (3:00 delay)
12545,566372,2019-03-28,2019,SEA,BOS,12,4,12-4,SEA,9,1,43,40,83,142,187,329,18,12,30,2,3:34
12546,565339,2019-05-21,2019,CLE,OAK,3,5,5-3,OAK,9,0,37,40,77,168,157,325,11,14,25,4,3:22
12547,567164,2019-04-12,2019,ATL,NYN,2,6,6-2,NYN,9,0,37,43,80,156,153,309,10,17,27,1,3:07
12548,565027,2019-04-09,2019,BOS,TOR,5,7,7-5,TOR,9,0,38,40,78,164,160,324,11,13,24,4,3:36
12549,564938,2019-04-20,2019,BAL,MIN,5,6,6-5,MIN,9,0,42,40,82,153,151,304,17,13,30,1,3:16
12550,566876,2019-04-26,2019,TOR,OAK,4,2,4-2,TOR,9,0,35,34,69,132,136,268,9,7,16,1,2:50
12551,565516,2019-04-16,2019,DET,PIT,3,5,5-3,PIT,10,0,39,39,78,147,162,309,10,9,19,1,3:03
12552,566479,2019-04-13,2019,SFN,COL,5,2,5-2,SFN,9,1,38,32,70,130,115,245,14,6,20,2,2:48
12553,565335,2019-05-17,2019,CLE,BAL,1,5,5-1,BAL,9,0,36,36,72,140,158,298,7,11,18,4,2:54
12554,566097,2019-04-20,2019,OAK,TOR,1,10,10-1,TOR,9,0,34,46,80,165,129,294,8,19,27,1,3:05
12555,567163,2019-04-11,2019,ATL,NYN,3,6,6-3,NYN,9,0,39,41,80,166,164,330,12,14,26,3,3:14
12556,566280,2019-04-02,2019,SDN,ARI,5,8,8-5,ARI,9,0,39,45,84,150,159,309,12,18,30,1,3:21
12557,565124,2019-04-08,2019,CHN,PIT,10,0,10-0,CHN,9,1,40,36,76,158,173,331,14,11,25,1,3:12
12558,565708,2019-04-09,2019,KCA,SEA,3,6,6-3,SEA,9,0,38,43,81,171,137,308,11,16,27,2,3:17
12559,565608,2019-04-07,2019,HOU,OAK,9,8,9-8,HOU,9,0,47,40,87,148,170,318,23,14,37,2,3:39
12560,564850,2019-05-12,2019,ARI,ATL,3,5,5-3,ATL,9,0,41,39,80,149,163,312,15,14,29,2,3:21
12561,565904,2019-04-17,2019,WAS,SFN,9,6,9-6,WAS,9,1,40,42,82,142,144,286,18,16,34,5,3:07
12562,567373,2019-04-20,2019,MIA,WAS,9,3,9-3,MIA,9,1,41,39,80,138,167,305,16,14,30,1,3:12
12563,566374,2019-03-30,2019,SEA,BOS,6,5,6-5,SEA,9,1,38,41,79,145,167,312,14,12,26,2,3:10
12564,567367,2019-04-13,2019,MIA,PHI,10,3,10-3,MIA,9,1,41,37,78,158,149,307,18,10,28,0,3:01
12565,565226,2019-04-09,2019,CIN,MIA,14,0,14-0,CIN,9,1,45,31,76,127,176,303,24,6,30,0,2:47
12566,566763,2019-03-28,2019,TEX,CHN,4,12,12-4,CHN,9,0,34,46,80,177,132,309,8,22,30,5,3:07
12567,565436,2019-05-25,2019,COL,BAL,6,9,9-6,BAL,9,0,38,43,81,159,150,309,11,20,31,1,3:12
12568,566784,2019-05-18,2019,TEX,SLN,2,8,8-2,SLN,9,0,35,44,79,174,136,310,9,16,25,3,3:14 (2:11 delay)
12569,565040,2019-04-29,2019,BOS,OAK,9,4,9-4,BOS,9,1,41,40,81,160,137,297,18,15,33,4,3:23
12570,567159,2019-04-04,2019,ATL,CHN,9,4,9-4,ATL,9,1,42,37,79,155,170,325,20,10,30,3,3:29
12571,565418,2019-08-26,2019,COL,ATL,3,1,3-1,COL,9,0,32,37,69,165,144,309,10,12,22,1,3:27
12572,567169,2019-04-18,2019,ATL,ARI,1,4,4-1,ARI,9,0,37,44,81,156,161,317,10,16,26,2,3:25
12573,567060,2019-03-30,2019,PHI,ATL,8,6,8-6,PHI,9,1,36,40,76,159,164,323,15,14,29,6,3:27
12574,566886,2019-05-21,2019,TOR,BOS,10,3,10-3,TOR,9,1,40,40,80,161,166,327,17,15,32,3,3:17
12575,567485,2019-05-28,2019,NYA,SDN,4,5,5-4,SDN,9,0,37,42,79,148,149,297,11,17,28,5,3:15
12576,565028,2019-04-11,2019,BOS,TOR,7,6,7-6,BOS,9,0,42,37,79,154,168,322,18,14,32,1,3:21
12577,566200,2019-05-23,2019,PIT,COL,14,6,14-6,PIT,9,1,42,39,81,137,153,290,21,13,34,3,3:01
12578,567482,2019-05-18,2019,NYA,TBA,1,2,2-1,TBA,11,0,40,40,80,156,166,322,10,6,16,1,3:39
12579,566881,2019-05-08,2019,TOR,MIN,1,9,9-1,MIN,9,0,31,48,79,183,128,311,4,21,25,1,3:06
12580,565342,2019-05-24,2019,CLE,TBA,3,1,3-1,CLE,9,1,35,38,73,167,132,299,12,10,22,5,3:20
12581,567161,2019-04-06,2019,ATL,MIA,2,4,4-2,MIA,9,0,43,35,78,135,170,305,17,11,28,2,3:16
12582,566891,2019-05-26,2019,TOR,SDN,10,1,10-1,TOR,9,1,41,36,77,161,165,326,18,11,29,1,3:08
12583,566885,2019-05-20,2019,TOR,BOS,2,12,12-2,BOS,9,0,32,46,78,174,129,303,4,20,24,1,2:56
12584,567462,2019-04-12,2019,NYA,CHA,6,9,9-6,CHA,7,1,30,34,64,137,123,260,12,15,27,4,2:43 (:41 delay)
12585,565807,2019-04-13,2019,LAN,MIL,1,4,4-1,MIL,9,0,32,41,73,153,123,276,8,15,23,2,2:54
12586,565901,2019-04-13,2019,WAS,PIT,3,2,3-2,WAS,9,1,30,37,67,127,116,243,8,10,18,0,2:22
12587,567077,2019-05-03,2019,PHI,WAS,4,2,4-2,PHI,9,1,30,36,66,142,127,269,7,9,16,1,2:42
12588,565318,2019-04-04,2019,CLE,TOR,4,1,4-1,CLE,9,1,36,40,76,166,133,299,13,13,26,2,3:06
12589,566769,2019-04-12,2019,TEX,OAK,6,8,8-6,OAK,9,0,37,38,75,172,155,327,11,13,24,4,3:16
12590,567364,2019-04-02,2019,MIA,NYN,5,6,6-5,NYN,9,0,46,44,90,167,145,312,20,15,35,1,3:23
12591,565616,2019-04-26,2019,HOU,CLE,3,6,6-3,CLE,9,0,41,41,82,163,161,324,13,14,27,3,3:19
12592,565435,2019-05-24,2019,COL,BAL,8,6,8-6,COL,9,0,38,38,76,155,167,322,16,12,28,2,3:17
12593,566867,2019-03-31,2019,TOR,DET,3,4,4-3,DET,11,0,41,48,89,180,139,319,10,16,26,2,3:17
12594,567365,2019-04-03,2019,MIA,NYN,4,6,6-4,NYN,9,0,37,41,78,159,164,323,10,15,25,2,3:07
12595,566093,2019-04-04,2019,OAK,BOS,7,3,7-3,OAK,9,1,40,40,80,160,147,307,18,16,34,2,3:16
12596,566767,2019-04-02,2019,TEX,HOU,6,4,6-4,TEX,9,1,37,42,79,161,152,313,14,18,32,3,3:23
12597,566376,2019-04-01,2019,SEA,ANA,6,3,6-3,SEA,9,1,40,37,77,138,158,296,17,11,28,5,3:20
12598,565228,2019-04-11,2019,CIN,MIA,5,0,5-0,CIN,9,1,35,32,67,144,148,292,13,8,21,1,2:51
12599,566774,2019-04-17,2019,TEX,ANA,5,4,5-4,TEX,9,1,33,41,74,169,146,315,9,15,24,2,3:19
12600,565319,2019-04-05,2019,CLE,TOR,3,2,3-2,CLE,9,0,31,33,64,139,131,270,7,7,14,1,2:42
12601,565323,2019-04-20,2019,CLE,ATL,8,4,8-4,CLE,9,1,41,36,77,136,176,312,17,9,26,2,3:04
12602,565421,2019-04-20,2019,COL,PHI,5,8,8-5,PHI,9,0,42,41,83,153,157,310,16,15,31,4,3:25
12603,564932,2019-04-07,2019,BAL,NYA,3,15,15-3,NYA,9,0,36,50,86,199,148,347,8,25,33,3,3:05
12604,565802,2019-03-31,2019,LAN,ARI,8,7,8-7,LAN,9,1,41,40,81,160,170,330,15,14,29,2,3:29
12605,566765,2019-03-31,2019,TEX,CHN,11,10,11-10,TEX,9,0,41,47,88,174,171,345,17,20,37,6,3:46
12606,565222,2019-03-31,2019,CIN,PIT,0,5,5-0,PIT,9,0,32,44,76,181,139,320,6,18,24,2,3:15
12607,565030,2019-04-13,2019,BOS,BAL,5,9,9-5,BAL,9,0,36,48,84,189,142,331,11,21,32,5,3:39
12608,565705,2019-04-02,2019,KCA,MIN,4,5,5-4,MIN,10,0,40,49,89,179,136,315,12,20,32,2,3:30
12609,564756,2019-05-19,2019,ANA,KCA,1,5,5-1,KCA,9,0,38,41,79,177,156,333,11,14,25,2,3:21
12610,567263,2019-04-05,2019,CHA,SEA,10,8,10-8,CHA,9,1,40,41,81,162,165,327,15,14,29,4,3:36
12611,565915,2019-05-16,2019,WAS,NYN,7,6,7-6,WAS,9,1,40,40,80,161,147,308,18,13,31,2,3:16
12612,567157,2019-04-01,2019,ATL,CHN,8,0,8-0,ATL,9,1,43,37,80,150,169,319,20,13,33,2,3:12
12613,564833,2019-04-05,2019,ARI,BOS,15,8,15-8,ARI,9,1,45,41,86,173,169,342,23,15,38,3,3:23
12614,567575,2019-05-08,2019,MIL,WAS,7,3,7-3,MIL,9,1,42,37,79,160,182,342,17,9,26,2,3:24
12615,566493,2019-05-21,2019,SFN,ATL,4,3,4-3,SFN,9,0,37,39,76,148,150,298,12,14,26,4,3:16
12616,566001,2019-04-29,2019,NYN,CIN,4,5,5-4,CIN,9,0,41,41,82,137,161,298,15,19,34,3,3:15
12617,564955,2019-05-23,2019,BAL,NYA,5,6,6-5,NYA,9,0,37,39,76,152,142,294,11,14,25,3,3:02
12618,564838,2019-04-11,2019,ARI,SDN,6,7,7-6,SDN,9,0,43,37,80,138,171,309,15,12,27,4,3:13
12619,567268,2019-04-10,2019,CHA,TBA,1,9,9-1,TBA,9,0,34,47,81,179,133,312,7,20,27,1,3:00 (1:39 delay)
12620,567464,2019-04-14,2019,NYA,CHA,2,5,5-2,CHA,9,0,33,39,72,173,151,324,6,15,21,3,3:21
12621,565414,2019-04-06,2019,COL,LAN,2,7,7-2,LAN,9,0,36,39,75,149,149,298,10,15,25,5,3:19
12622,566092,2019-04-03,2019,OAK,BOS,3,6,6-3,BOS,9,0,39,39,78,168,161,329,12,12,24,4,3:21
12623,566289,2019-04-24,2019,SDN,SEA,1,0,1-0,SDN,9,1,29,30,59,107,90,197,5,4,9,0,2:05
12624,564855,2019-05-18,2019,ARI,SFN,5,8,8-5,SFN,9,0,38,41,79,176,149,325,10,16,26,2,3:24
12625,565611,2019-04-10,2019,HOU,NYA,8,6,8-6,HOU,9,1,41,40,81,168,172,340,21,13,34,5,3:30
12626,564748,2019-04-25,2019,ANA,NYA,11,5,11-5,ANA,9,1,39,43,82,181,157,338,16,17,33,4,3:49
12627,566770,2019-06-08,2019,TEX,OAK,10,5,10-5,TEX,9,1,43,38,81,138,188,326,18,13,31,0,3:12
12628,566201,2019-05-24,2019,PIT,LAN,2,10,10-2,LAN,9,0,36,44,80,176,156,332,9,18,27,2,3:15
12629,565801,2019-03-30,2019,LAN,ARI,18,5,18-5,LAN,9,1,51,35,86,146,182,328,29,10,39,2,3:14
12630,565051,2019-05-27,2019,BOS,CLE,12,5,12-5,BOS,9,1,42,42,84,154,181,335,19,15,34,2,3:32
12631,565223,2019-04-01,2019,CIN,MIL,3,4,4-3,MIL,9,0,39,41,80,165,155,320,13,18,31,2,3:31
12632,565146,2019-05-20,2019,CHN,PHI,4,5,5-4,PHI,10,0,43,42,85,164,152,316,15,13,28,1,3:34
12633,567186,2019-05-18,2019,ATL,MIL,4,3,4-3,ATL,10,0,39,43,82,155,149,304,13,15,28,3,3:34
12634,565898,2019-04-02,2019,WAS,PHI,2,8,8-2,PHI,9,0,34,45,79,179,146,325,8,21,29,2,3:30 (:41 delay)
12635,564939,2019-04-21,2019,BAL,MIN,3,4,4-3,MIN,9,0,39,40,79,138,152,290,13,13,26,1,3:08
12636,565707,2019-04-08,2019,KCA,SEA,5,13,13-5,SEA,9,0,41,46,87,191,137,328,14,20,34,3,3:17
12637,566379,2019-04-13,2019,SEA,HOU,1,3,3-1,HOU,9,0,31,34,65,129,155,284,4,8,12,0,2:46
12638,564743,2019-04-20,2019,ANA,SEA,5,6,6-5,SEA,9,0,42,41,83,183,163,346,16,14,30,2,3:41
12639,566477,2019-04-11,2019,SFN,COL,1,0,1-0,SFN,9,1,33,30,63,107,128,235,10,4,14,3,2:34
12640,565417,2019-04-09,2019,COL,ATL,1,7,7-1,ATL,9,0,35,38,73,165,140,305,9,12,21,1,3:12
12641,564739,2019-04-09,2019,ANA,MIL,11,8,11-8,ANA,9,1,42,41,83,165,174,339,19,14,33,4,3:50
12642,564931,2019-04-06,2019,BAL,NYA,4,6,6-4,NYA,9,0,42,39,81,179,183,362,13,15,28,7,3:42
12643,564930,2019-04-04,2019,BAL,NYA,4,8,8-4,NYA,9,0,39,41,80,174,164,338,14,16,30,5,3:27
12644,566771,2019-04-14,2019,TEX,OAK,8,7,8-7,TEX,9,1,38,39,77,168,143,311,13,14,27,1,3:05
12645,566981,2019-05-12,2019,MIN,DET,3,5,5-3,DET,9,0,41,38,79,146,162,308,14,12,26,4,3:07
12646,565998,2019-04-26,2019,NYN,MIL,2,10,10-2,MIL,9,0,38,45,83,181,150,331,11,19,30,1,3:20 (2:42 delay)
12647,566380,2019-04-14,2019,SEA,HOU,2,3,3-2,HOU,9,0,30,35,65,117,144,261,4,10,14,1,2:40
12648,567481,2019-05-17,2019,NYA,TBA,4,3,4-3,NYA,9,0,36,40,76,144,142,286,11,13,24,2,3:08 (:35 delay)
12649,565321,2019-04-07,2019,CLE,TOR,3,1,3-1,CLE,9,1,31,31,62,124,122,246,7,5,12,3,2:36
12650,566393,2019-05-17,2019,SEA,MIN,1,7,7-1,MIN,9,0,36,39,75,133,125,258,10,12,22,1,2:36
12651,566571,2019-04-09,2019,SLN,LAN,4,0,4-0,SLN,9,1,36,40,76,176,145,321,11,16,27,3,3:17
12652,565824,2019-05-27,2019,LAN,NYN,9,5,9-5,LAN,9,1,44,42,86,160,167,327,21,17,38,4,3:42
12653,567556,2019-04-05,2019,MIL,CHN,13,10,13-10,MIL,9,1,42,43,85,168,177,345,20,16,36,2,3:36
12654,567189,2019-05-29,2019,ATL,WAS,4,14,14-4,WAS,9,0,34,49,83,206,135,341,7,22,29,2,3:11
12655,567264,2019-04-06,2019,CHA,SEA,2,9,9-2,SEA,9,0,38,45,83,193,152,345,11,21,32,4,3:31
12656,565031,2019-04-14,2019,BOS,BAL,4,0,4-0,BOS,9,1,34,34,68,135,139,274,10,7,17,2,3:07
12657,566184,2019-04-06,2019,PIT,CIN,6,5,6-5,PIT,10,0,42,38,80,134,158,292,15,8,23,2,3:11
12658,566688,2019-05-27,2019,TBA,TOR,8,3,8-3,TBA,9,1,41,35,76,143,165,308,18,9,27,2,3:20
12659,565511,2019-04-06,2019,DET,KCA,7,4,7-4,DET,9,1,40,35,75,128,146,274,17,8,25,2,2:45
12660,565320,2019-04-06,2019,CLE,TOR,7,2,7-2,CLE,9,1,39,39,78,158,162,320,14,12,26,4,3:20
12661,566773,2019-04-16,2019,TEX,ANA,5,0,5-0,TEX,9,1,34,30,64,103,133,236,12,5,17,2,2:31
12662,565413,2019-04-05,2019,COL,LAN,6,10,10-6,LAN,9,0,41,45,86,170,174,344,16,19,35,5,3:52
12663,566181,2019-04-03,2019,PIT,SLN,4,5,5-4,SLN,10,0,45,40,85,158,189,347,15,10,25,3,3:30
12664,567553,2019-03-29,2019,MIL,SLN,5,9,9-5,SLN,9,0,35,49,84,190,151,341,11,23,34,2,3:41
12665,567158,2019-04-03,2019,ATL,CHN,6,4,6-4,ATL,9,1,39,41,80,180,154,334,16,18,34,4,3:32
12666,565991,2019-04-06,2019,NYN,WAS,6,5,6-5,NYN,9,1,35,39,74,179,130,309,14,13,27,3,3:13
12667,565900,2019-04-12,2019,WAS,PIT,3,6,6-3,PIT,10,0,41,42,83,167,156,323,11,12,23,3,3:28
12668,567165,2019-04-13,2019,ATL,NYN,11,7,11-7,ATL,9,1,42,42,84,155,194,349,20,16,36,3,3:34
12669,566592,2019-05-24,2019,SLN,ATL,2,5,5-2,ATL,9,0,35,37,72,142,127,269,8,12,20,3,2:44
12670,565905,2019-04-18,2019,WAS,SFN,4,2,4-2,WAS,9,1,37,33,70,129,135,264,14,7,21,3,2:52
12671,565899,2019-04-03,2019,WAS,PHI,9,8,9-8,WAS,9,0,42,44,86,173,171,344,19,19,38,3,3:53
12672,566789,2019-05-30,2019,TEX,KCA,2,4,4-2,KCA,9,0,34,38,72,177,140,317,8,12,20,1,3:06
12673,567066,2019-04-09,2019,PHI,WAS,6,10,10-6,WAS,10,0,44,46,90,180,160,340,15,17,32,3,3:51
12674,566764,2019-03-30,2019,TEX,CHN,8,6,8-6,TEX,9,1,44,42,86,160,186,346,22,16,38,3,3:47
12675,566387,2019-04-28,2019,SEA,TEX,1,14,14-1,TEX,9,0,36,49,85,168,144,312,11,19,30,1,3:10
12676,566378,2019-04-12,2019,SEA,HOU,6,10,10-6,HOU,9,0,40,45,85,161,157,318,12,19,31,3,3:22
12677,566375,2019-03-31,2019,SEA,BOS,10,8,10-8,SEA,9,1,45,45,90,166,175,341,19,17,36,4,3:39
12678,565714,2019-04-26,2019,KCA,ANA,1,5,5-1,ANA,9,0,31,39,70,167,137,304,8,14,22,2,3:06
12679,565148,2019-05-22,2019,CHN,PHI,8,4,8-4,CHN,9,1,36,43,79,186,135,321,13,16,29,2,3:04
12680,567188,2019-05-28,2019,ATL,WAS,4,5,5-4,WAS,9,0,39,44,83,152,152,304,13,20,33,2,3:21
12681,565896,2019-03-30,2019,WAS,NYN,8,11,11-8,NYN,9,0,42,46,88,188,181,369,14,19,33,5,3:50
12682,564734,2019-04-04,2019,ANA,TEX,4,11,11-4,TEX,9,0,42,45,87,188,187,375,15,21,36,2,3:49
12683,565535,2019-05-21,2019,DET,MIA,4,5,5-4,MIA,11,0,41,47,88,170,178,348,8,15,23,1,3:29
12684,566573,2019-04-11,2019,SLN,LAN,11,7,11-7,SLN,9,1,41,39,80,164,174,338,16,12,28,2,3:12
12685,565706,2019-04-03,2019,KCA,MIN,6,7,7-6,MIN,9,0,39,42,81,174,159,333,12,18,30,4,3:32
12686,565048,2019-05-17,2019,BOS,HOU,1,3,3-1,HOU,9,0,38,36,74,128,158,286,11,9,20,1,3:00
12687,567266,2019-04-08,2019,CHA,TBA,1,5,5-1,TBA,9,0,34,46,80,184,143,327,9,19,28,2,3:25
12688,566294,2019-05-07,2019,SDN,NYN,6,7,7-6,NYN,9,0,41,44,85,180,157,337,17,18,35,3,3:38
12689,567478,2019-05-15,2019,NYA,BAL,3,1,3-1,NYA,9,1,33,34,67,113,124,237,9,8,17,1,2:29
12690,567160,2019-04-05,2019,ATL,MIA,4,0,4-0,ATL,9,1,34,31,65,126,137,263,10,7,17,0,2:35
12691,567557,2019-04-06,2019,MIL,CHN,8,14,14-8,CHN,9,0,41,49,90,203,173,376,13,21,34,3,3:54
12692,567369,2019-04-15,2019,MIA,CHN,2,7,7-2,CHN,9,0,38,44,82,159,148,307,12,18,30,3,3:27
12693,564857,2019-05-31,2019,ARI,NYN,4,5,5-4,NYN,9,0,37,41,78,147,135,282,11,16,27,0,3:14
12694,567385,2019-05-28,2019,MIA,SFN,11,3,11-3,MIA,9,1,41,35,76,130,172,302,18,8,26,2,2:51
12695,565415,2019-04-07,2019,COL,LAN,6,12,12-6,LAN,9,0,43,48,91,199,156,355,17,23,40,5,3:52
12696,565712,2019-04-13,2019,KCA,CLE,3,0,3-0,KCA,9,1,31,30,61,134,120,254,8,4,12,1,2:26
12697,566203,2019-05-26,2019,PIT,LAN,7,11,11-7,LAN,9,0,41,50,91,194,147,341,14,23,37,1,3:44
12698,567487,2019-08-03,2019,NYA,BOS,6,4,6-4,NYA,9,1,40,42,82,198,184,382,18,16,34,3,4:02
12699,565334,2019-05-16,2019,CLE,BAL,14,7,14-7,CLE,9,1,47,40,87,148,205,353,25,14,39,6,3:54
12700,567457,2019-03-30,2019,NYA,BAL,3,5,5-3,BAL,9,0,41,37,78,140,182,322,16,10,26,2,3:24
12701,567488,2019-05-31,2019,NYA,BOS,4,1,4-1,NYA,9,1,32,33,65,140,146,286,10,9,19,0,2:51
12702,567288,2019-05-27,2019,CHA,KCA,2,1,2-1,CHA,9,0,35,32,67,111,149,260,14,7,21,3,2:56 (3:04 delay)
12703,566568,2019-04-06,2019,SLN,SDN,4,6,6-4,SDN,9,0,42,45,87,189,198,387,15,19,34,3,3:37
12704,567067,2019-04-10,2019,PHI,WAS,1,15,15-1,WAS,9,0,36,51,87,217,160,377,11,23,34,4,3:35
12705,565322,2019-04-20,2019,CLE,ATL,7,8,8-7,ATL,9,0,44,42,86,203,189,392,20,16,36,6,3:54
12706,567458,2019-03-31,2019,NYA,BAL,5,7,7-5,BAL,9,0,46,41,87,181,226,407,18,15,33,3,3:48 (3:17 delay)
12707,565128,2019-04-13,2019,CHN,ANA,5,6,6-5,ANA,9,0,43,43,86,184,179,363,16,18,34,5,3:56
12708,564736,2019-04-06,2019,ANA,TEX,5,1,5-1,ANA,9,1,40,34,74,146,172,318,18,8,26,3,3:22
12709,566111,2019-05-27,2019,OAK,ANA,8,5,8-5,OAK,9,1,35,38,73,149,135,284,12,13,25,3,3:06
12710,565805,2019-04-03,2019,LAN,SFN,5,3,5-3,LAN,9,1,36,34,70,115,163,278,12,8,20,3,2:59
12711,567272,2019-04-26,2019,CHA,DET,12,11,12-11,CHA,9,0,47,48,95,202,166,368,26,22,48,5,4:02
12712,565631,2019-05-25,2019,HOU,BOS,4,3,4-3,HOU,9,0,40,39,79,148,150,298,17,13,30,3,3:28
12713,564751,2019-05-02,2019,ANA,TOR,6,2,6-2,ANA,9,1,37,35,72,138,147,285,14,9,23,2,3:01
12714,566282,2019-04-15,2019,SDN,COL,2,5,5-2,COL,9,0,36,36,72,117,134,251,11,10,21,2,2:38
12715,565992,2019-04-07,2019,NYN,WAS,9,12,12-9,WAS,9,0,42,46,88,198,173,371,17,22,39,4,3:42
12716,566972,2019-04-26,2019,MIN,BAL,6,1,6-1,MIN,9,1,36,38,74,163,145,308,11,12,23,2,3:07
12717,566786,2019-05-20,2019,TEX,SEA,10,9,10-9,TEX,9,1,39,42,81,162,140,302,16,15,31,2,2:53
12718,565125,2019-04-10,2019,CHN,PIT,2,5,5-2,PIT,9,0,37,38,75,146,154,300,9,12,21,2,3:10
12719,566383,2019-04-17,2019,SEA,CLE,0,1,1-0,CLE,9,0,31,31,62,128,137,265,5,4,9,0,2:32
12720,567282,2019-05-13,2019,CHA,CLE,5,2,5-2,CHA,9,1,32,32,64,121,122,243,9,5,14,3,2:28
12721,565052,2019-05-28,2019,BOS,CLE,5,7,7-5,CLE,9,0,40,43,83,183,163,346,13,18,31,3,4:03 (1:09 delay)
12722,565719,2019-05-01,2019,KCA,TBA,3,2,3-2,KCA,9,1,31,36,67,128,118,246,8,10,18,2,2:37
12723,566675,2019-04-20,2019,TBA,BOS,5,6,6-5,BOS,9,0,38,39,77,149,158,307,14,14,28,3,3:12
12724,567465,2019-04-16,2019,NYA,BOS,8,0,8-0,NYA,9,1,38,32,70,124,134,258,14,5,19,0,2:23
12725,565132,2019-04-21,2019,CHN,ARI,2,1,2-1,CHN,9,0,33,30,63,111,130,241,10,5,15,1,2:28
12726,565914,2019-05-15,2019,WAS,NYN,5,1,5-1,WAS,9,1,33,32,65,122,119,241,11,5,16,1,2:28
12727,565816,2019-05-07,2019,LAN,ATL,9,0,9-0,LAN,9,1,39,30,69,93,147,240,15,4,19,1,2:42
12728,564752,2019-05-04,2019,ANA,HOU,2,14,14-2,HOU,9,0,39,45,84,179,148,327,12,19,31,2,3:15
12729,565625,2019-05-12,2019,HOU,TEX,15,5,15-5,HOU,9,1,45,41,86,162,161,323,20,13,33,3,3:08
12730,565709,2019-04-10,2019,KCA,SEA,5,6,6-5,SEA,9,0,39,41,80,176,129,305,16,15,31,3,3:17
12731,566497,2019-05-25,2019,SFN,ARI,4,10,10-4,ARI,9,0,40,43,83,140,150,290,14,17,31,2,3:06
12732,567370,2019-04-16,2019,MIA,CHN,0,4,4-0,CHN,9,0,34,38,72,155,119,274,8,16,24,1,2:49
12733,566471,2019-04-05,2019,SFN,TBA,2,5,5-2,TBA,9,0,39,40,79,156,134,290,11,13,24,4,3:06
12734,566482,2019-04-27,2019,SFN,NYA,4,6,6-4,NYA,9,0,36,38,74,138,128,266,9,14,23,1,2:35
12735,566671,2019-04-16,2019,TBA,BAL,4,2,4-2,TBA,9,1,34,33,67,112,149,261,11,7,18,1,2:41
12736,566968,2019-04-15,2019,MIN,TOR,3,5,5-3,TOR,9,0,36,38,74,144,134,278,9,13,22,1,3:00
12737,565990,2019-04-04,2019,NYN,WAS,0,4,4-0,WAS,9,0,34,37,71,167,146,313,6,10,16,3,3:19
12738,565039,2019-04-28,2019,BOS,TBA,2,5,5-2,TBA,9,0,34,35,69,134,126,260,8,10,18,1,2:31
12739,567478,2019-05-15,2019,NYA,BAL,3,1,3-1,NYA,9,1,33,34,67,113,124,237,9,8,17,1,2:29
12740,565129,2019-06-03,2019,CHN,ANA,8,1,8-1,CHN,9,1,38,33,71,133,144,277,14,8,22,2,3:00
12741,566300,2019-05-20,2019,SDN,ARI,2,1,2-1,SDN,9,1,31,35,66,140,110,250,8,9,17,2,2:40
12742,564944,2019-05-04,2019,BAL,TBA,3,0,3-0,BAL,9,1,31,31,62,120,99,219,8,6,14,2,2:19
12743,565333,2019-05-09,2019,CLE,CHA,5,0,5-0,CLE,5,0,30,17,47,63,104,167,16,2,18,1,1:45 (2:34 delay)
12744,565614,2019-04-24,2019,HOU,MIN,7,1,7-1,HOU,9,1,35,32,67,113,131,244,13,5,18,0,2:28
12745,567267,2019-04-09,2019,CHA,TBA,5,10,10-5,TBA,9,0,39,47,86,209,193,402,13,21,34,4,3:56
12746,565149,2019-05-23,2019,CHN,PHI,7,9,9-7,PHI,9,0,44,44,88,188,184,372,19,17,36,5,3:55
12747,565808,2019-04-14,2019,LAN,MIL,7,1,7-1,LAN,9,1,40,32,72,109,144,253,16,6,22,1,2:34
12748,564761,2019-05-25,2019,ANA,TEX,3,2,3-2,ANA,9,0,36,37,73,150,157,307,12,10,22,2,3:11
12749,567270,2019-04-16,2019,CHA,KCA,5,1,5-1,CHA,9,1,34,33,67,141,133,274,11,8,19,1,2:39
12750,566472,2019-04-06,2019,SFN,TBA,6,4,6-4,SFN,9,1,35,38,73,146,137,283,11,11,22,1,2:51
12751,565344,2019-05-26,2019,CLE,TBA,3,6,6-3,TBA,9,0,39,39,78,152,163,315,13,13,26,3,3:18
12752,566104,2019-05-09,2019,OAK,CIN,0,3,3-0,CIN,9,0,35,33,68,110,154,264,10,9,19,2,2:36
12753,566989,2019-05-28,2019,MIN,MIL,5,3,5-3,MIN,9,1,36,34,70,125,114,239,12,8,20,2,2:40
12754,565920,2019-05-25,2019,WAS,MIA,5,0,5-0,WAS,9,1,36,29,65,116,128,244,13,5,18,0,2:25
12755,566788,2019-05-22,2019,TEX,SEA,2,1,2-1,TEX,9,1,30,35,65,146,92,238,10,9,19,2,2:27
12756,566965,2019-05-11,2019,MIN,DET,8,3,8-3,MIN,9,1,42,36,78,132,160,292,18,10,28,1,2:45
12757,566588,2019-05-11,2019,SLN,PIT,1,2,2-1,PIT,9,0,34,32,66,123,146,269,7,5,12,1,2:42 (2:56 delay)
12758,565811,2019-04-17,2019,LAN,CIN,3,2,3-2,LAN,9,1,29,32,61,127,116,243,6,5,11,2,2:37
12759,565822,2019-05-14,2019,LAN,SDN,6,3,6-3,LAN,9,1,35,32,67,126,130,256,10,8,18,1,2:32
12760,565238,2019-05-14,2019,CIN,CHN,1,3,3-1,CHN,9,0,31,39,70,147,110,257,4,12,16,2,2:39
12761,567567,2019-04-30,2019,MIL,COL,4,3,4-3,MIL,9,1,29,34,63,141,96,237,6,8,14,1,2:22
12762,567062,2019-04-05,2019,PHI,MIN,10,4,10-4,PHI,9,1,44,39,83,136,192,328,22,12,34,3,3:31
12763,565033,2019-04-23,2019,BOS,DET,4,7,7-4,DET,9,0,33,41,74,176,112,288,7,17,24,2,2:55
12764,565615,2019-04-25,2019,HOU,CLE,1,2,2-1,CLE,9,0,33,33,66,133,133,266,10,7,17,0,2:40
12765,566875,2019-04-24,2019,TOR,SFN,0,4,4-0,SFN,9,0,30,38,68,141,136,277,4,13,17,2,2:41
12766,565913,2019-05-14,2019,WAS,NYN,2,6,6-2,NYN,9,0,32,39,71,136,122,258,7,13,20,1,2:38
12767,566095,2019-04-17,2019,OAK,HOU,2,1,2-1,OAK,9,1,30,35,65,131,120,251,7,8,15,1,2:29
12768,564841,2019-04-14,2019,ARI,SDN,8,4,8-4,ARI,9,1,36,33,69,130,129,259,14,8,22,1,2:49
12769,566974,2019-04-28,2019,MIN,BAL,4,1,4-1,MIN,9,1,35,33,68,131,146,277,12,5,17,0,2:42
12770,565053,2019-05-29,2019,BOS,CLE,9,14,14-9,CLE,9,0,43,49,92,189,155,344,15,23,38,3,3:42
12771,566670,2019-04-03,2019,TBA,COL,0,1,1-0,COL,11,0,46,38,84,151,158,309,14,7,21,3,3:19
12772,566190,2019-04-23,2019,PIT,ARI,1,2,2-1,ARI,9,0,35,34,69,145,131,276,10,8,18,1,2:53
12773,566099,2019-04-22,2019,OAK,TEX,6,1,6-1,OAK,9,1,34,38,72,157,125,282,10,12,22,1,2:48
12774,567468,2019-04-19,2019,NYA,KCA,6,2,6-2,NYA,9,1,35,37,72,151,128,279,14,11,25,1,2:51
12775,566672,2019-04-17,2019,TBA,BAL,8,1,8-1,TBA,9,1,37,32,69,142,143,285,18,5,23,1,2:43
12776,565903,2019-04-16,2019,WAS,SFN,3,7,7-3,SFN,9,0,38,40,78,161,154,315,13,13,26,3,3:16
12777,566684,2019-05-11,2019,TBA,NYA,7,2,7-2,TBA,9,1,38,32,70,121,147,268,15,8,23,0,2:54
12778,564749,2019-04-30,2019,ANA,TOR,4,3,4-3,ANA,9,1,32,34,66,139,133,272,10,8,18,1,2:56
12779,567289,2019-05-28,2019,CHA,KCA,4,3,4-3,CHA,9,1,36,31,67,122,130,252,13,5,18,0,2:31
12780,566006,2019-05-11,2019,NYN,MIA,4,1,4-1,NYN,9,1,35,35,70,139,128,267,13,8,21,1,2:41
12781,565810,2019-04-16,2019,LAN,CIN,6,1,6-1,LAN,9,1,36,34,70,131,138,269,15,7,22,1,2:51
12782,565710,2019-04-11,2019,KCA,SEA,6,7,7-6,SEA,10,0,46,43,89,171,177,348,14,14,28,1,3:27
12783,567265,2019-04-07,2019,CHA,SEA,5,12,12-5,SEA,9,0,41,44,85,202,155,357,13,16,29,3,3:49
12784,565806,2019-04-12,2019,LAN,MIL,5,8,8-5,MIL,9,0,43,42,85,152,175,327,16,15,31,3,3:54
12785,566575,2019-04-20,2019,SLN,NYN,10,2,10-2,SLN,9,1,41,33,74,109,166,275,18,6,24,2,2:45
12786,565331,2019-05-07,2019,CLE,CHA,0,2,2-0,CHA,9,0,34,37,71,135,144,279,9,11,20,4,2:58
12787,567171,2019-04-27,2019,ATL,COL,5,9,9-5,COL,9,0,38,39,77,128,141,269,13,12,25,3,2:58
12788,566284,2019-04-18,2019,SDN,CIN,1,4,4-1,CIN,9,0,32,32,64,138,138,276,8,6,14,2,2:45
12789,564848,2019-05-10,2019,ARI,ATL,1,2,2-1,ATL,9,0,34,33,67,129,140,269,6,8,14,0,3:00
12790,566003,2019-05-01,2019,NYN,CIN,0,1,1-0,CIN,9,0,33,35,68,135,125,260,6,8,14,4,2:46
12791,566687,2019-05-22,2019,TBA,LAN,8,1,8-1,TBA,9,1,38,35,73,127,147,274,15,9,24,4,2:51
12792,565325,2019-04-23,2019,CLE,MIA,1,3,3-1,MIA,9,0,34,37,71,141,118,259,6,10,16,3,2:42
12793,567580,2019-05-26,2019,MIL,PHI,9,1,9-1,MIL,9,1,39,28,67,107,157,264,16,1,17,2,2:49
12794,565813,2019-04-27,2019,LAN,PIT,3,1,3-1,LAN,9,1,33,34,67,139,119,258,9,7,16,2,2:58
12795,565626,2019-05-20,2019,HOU,CHA,3,0,3-0,HOU,9,1,32,35,67,151,104,255,10,8,18,1,2:40
12796,566287,2019-04-21,2019,SDN,CIN,4,3,4-3,SDN,9,1,32,37,69,134,114,248,9,11,20,3,2:50
12797,565711,2019-04-12,2019,KCA,CLE,8,1,8-1,KCA,9,1,42,38,80,154,159,313,19,13,32,3,3:10
12798,567274,2019-04-28,2019,CHA,DET,4,1,4-1,CHA,9,1,37,33,70,141,141,282,14,6,20,0,2:58
12799,566114,2019-05-31,2019,OAK,HOU,2,3,3-2,HOU,9,0,35,35,70,138,129,267,9,11,20,1,2:52
12800,564946,2019-05-06,2019,BAL,BOS,4,1,4-1,BAL,9,1,35,31,66,129,129,258,11,3,14,2,2:39
12801,564941,2019-04-23,2019,BAL,CHA,9,1,9-1,BAL,9,1,40,32,72,116,158,274,17,7,24,2,2:56
12802,566674,2019-04-19,2019,TBA,BOS,4,6,6-4,BOS,9,0,36,36,72,134,141,275,12,12,24,2,3:04
12803,565150,2019-05-24,2019,CHN,CIN,5,6,6-5,CIN,9,0,38,44,82,167,158,325,12,17,29,5,3:19
12804,567578,2019-05-24,2019,MIL,PHI,4,6,6-4,PHI,9,0,36,40,76,162,176,338,10,13,23,0,3:23
12805,566873,2019-04-14,2019,TOR,TBA,4,8,8-4,TBA,9,0,40,43,83,181,175,356,13,15,28,5,3:41
12806,566283,2019-04-16,2019,SDN,COL,2,8,8-2,COL,9,0,34,43,77,169,125,294,10,15,25,1,3:01
12807,567561,2019-04-17,2019,MIL,SLN,3,6,6-3,SLN,9,0,34,40,74,160,137,297,9,17,26,3,2:55
12808,566285,2019-04-19,2019,SDN,CIN,2,3,3-2,CIN,11,0,40,38,78,124,151,275,7,4,11,1,3:04
12809,564937,2019-04-20,2019,BAL,MIN,7,16,16-7,MIN,9,0,37,46,83,162,142,304,12,19,31,1,2:50
12810,566683,2019-05-10,2019,TBA,NYA,3,4,4-3,NYA,9,0,37,37,74,147,145,292,12,10,22,2,3:05
12811,565233,2019-04-25,2019,CIN,ATL,4,2,4-2,CIN,9,1,32,37,69,156,138,294,12,12,24,2,2:54 (2:42 delay)
12812,565042,2019-05-01,2019,BOS,OAK,7,3,7-3,BOS,9,1,38,35,73,129,139,268,15,8,23,1,2:54
12813,566775,2019-04-19,2019,TEX,HOU,2,7,7-2,HOU,9,0,34,42,76,190,134,324,8,16,24,3,3:16
12814,565911,2019-05-01,2019,WAS,SLN,1,5,5-1,SLN,9,0,37,40,77,145,135,280,10,14,24,1,3:02
12815,566587,2019-05-10,2019,SLN,PIT,1,2,2-1,PIT,9,0,38,35,73,132,132,264,12,10,22,0,2:54
12816,566790,2019-05-31,2019,TEX,KCA,6,2,6-2,TEX,9,1,32,36,68,138,133,271,9,10,19,1,2:36
12817,565917,2019-05-18,2019,WAS,CHN,5,2,5-2,WAS,9,1,39,29,68,100,155,255,17,4,21,2,2:56
12818,565336,2019-05-18,2019,CLE,BAL,4,1,4-1,CLE,9,1,34,31,65,125,139,264,11,4,15,2,2:36
12819,566978,2019-05-02,2019,MIN,HOU,8,2,8-2,MIN,9,1,37,36,73,123,126,249,13,9,22,1,2:32
12820,565613,2019-04-23,2019,HOU,MIN,10,4,10-4,HOU,9,1,40,34,74,130,152,282,17,7,24,3,3:04
12821,565910,2019-04-30,2019,WAS,SLN,2,3,3-2,SLN,9,0,38,38,76,171,125,296,12,11,23,5,3:09
12822,567368,2019-04-14,2019,MIA,PHI,1,3,3-1,PHI,14,0,50,58,108,231,193,424,10,18,28,2,4:38
12823,566967,2019-04-14,2019,MIN,DET,6,4,6-4,MIN,9,1,37,41,78,179,143,322,16,14,30,4,3:19
12824,566094,2019-04-16,2019,OAK,HOU,1,9,9-1,HOU,9,0,34,46,80,187,141,328,9,19,28,2,3:03
12825,567560,2019-04-16,2019,MIL,SLN,8,4,8-4,MIL,9,1,39,39,78,145,155,300,15,14,29,3,3:13
12826,566496,2019-05-24,2019,SFN,ARI,2,18,18-2,ARI,9,0,37,55,92,225,156,381,10,27,37,3,3:35
12827,567562,2019-04-18,2019,MIL,LAN,1,3,3-1,LAN,9,0,33,35,68,164,143,307,7,10,17,1,3:02
12828,566971,2019-04-18,2019,MIN,TOR,4,7,7-4,TOR,9,0,38,36,74,143,139,282,11,10,21,3,3:00
12829,565995,2019-04-22,2019,NYN,PHI,5,1,5-1,NYN,9,1,37,32,69,141,135,276,14,5,19,2,2:46 (1:35 delay)
12830,566381,2019-04-15,2019,SEA,CLE,4,6,6-4,CLE,9,0,38,41,79,169,154,323,12,15,27,7,3:33
12831,566288,2019-04-23,2019,SDN,SEA,6,3,6-3,SDN,9,1,33,38,71,164,117,281,8,13,21,1,2:54
12832,566110,2019-05-26,2019,OAK,SEA,7,1,7-1,OAK,9,1,35,35,70,137,142,279,10,11,21,4,2:38
12833,566677,2019-04-22,2019,TBA,KCA,6,3,6-3,TBA,9,1,33,35,68,131,138,269,11,9,20,2,2:37
12834,565630,2019-05-24,2019,HOU,BOS,4,3,4-3,HOU,9,1,36,36,72,156,127,283,9,10,19,0,2:48
12835,566692,2019-05-31,2019,TBA,MIN,3,5,5-3,MIN,9,0,35,41,76,128,126,254,8,16,24,4,2:48
12836,567474,2019-05-06,2019,NYA,SEA,7,3,7-3,NYA,9,1,32,38,70,161,106,267,10,11,21,2,2:36
12837,566983,2019-05-14,2019,MIN,ANA,4,3,4-3,MIN,9,1,35,37,72,138,119,257,11,14,25,5,3:06
12838,567461,2019-04-03,2019,NYA,DET,1,2,2-1,DET,9,0,35,33,68,128,136,264,9,6,15,1,2:37
12839,567074,2019-04-28,2019,PHI,MIA,5,1,5-1,PHI,9,1,34,32,66,107,143,250,11,7,18,1,2:34
12840,567470,2019-04-21,2019,NYA,KCA,7,6,7-6,NYA,10,0,44,42,86,184,167,351,16,13,29,3,3:29
12841,565727,2019-05-25,2019,KCA,NYA,5,6,6-5,NYA,9,0,36,43,79,165,149,314,11,18,29,2,3:07
12842,565033,2019-04-23,2019,BOS,DET,4,7,7-4,DET,9,0,33,41,74,176,112,288,7,17,24,2,2:55
12843,566969,2019-04-16,2019,MIN,TOR,5,6,6-5,TOR,9,0,36,40,76,159,134,293,12,15,27,3,3:06
12844,566485,2019-04-30,2019,SFN,LAN,3,10,10-3,LAN,9,0,33,42,75,158,142,300,7,15,22,2,2:45
12845,565617,2019-04-27,2019,HOU,CLE,4,3,4-3,HOU,10,0,36,38,74,150,143,293,9,9,18,3,3:12
12846,564742,2019-04-19,2019,ANA,SEA,3,5,5-3,SEA,9,0,36,40,76,173,114,287,12,13,25,3,3:04
12847,564737,2019-04-07,2019,ANA,TEX,7,2,7-2,ANA,9,1,40,36,76,158,169,327,18,13,31,3,3:30
12848,567380,2019-05-14,2019,MIA,TBA,0,4,4-0,TBA,9,0,31,41,72,176,115,291,6,16,22,1,2:52
12849,565135,2019-04-25,2019,CHN,LAN,1,2,2-1,LAN,9,0,36,35,71,146,143,289,11,8,19,3,3:08
12850,564846,2019-05-01,2019,ARI,NYA,3,2,3-2,ARI,9,1,31,37,68,156,130,286,7,12,19,2,3:12
12851,566591,2019-05-22,2019,SLN,KCA,2,8,8-2,KCA,9,0,36,39,75,156,125,281,10,14,24,3,2:44
12852,565131,2019-04-20,2019,CHN,ARI,0,6,6-0,ARI,9,0,32,42,74,159,139,298,7,17,24,1,3:08
12853,566297,2019-05-17,2019,SDN,PIT,3,5,5-3,PIT,9,0,36,38,74,140,141,281,9,12,21,3,3:00
12854,564852,2019-05-14,2019,ARI,PIT,2,6,6-2,PIT,9,0,32,41,73,153,117,270,6,15,21,0,2:45
12855,566007,2019-08-05,2019,NYN,MIA,5,4,5-4,NYN,9,1,35,36,71,134,162,296,12,12,24,2,3:09
12856,566576,2019-04-21,2019,SLN,NYN,6,4,6-4,SLN,9,1,36,39,75,161,133,294,10,11,21,2,3:07
12857,566292,2019-05-05,2019,SDN,LAN,8,5,8-5,SDN,9,0,36,39,75,129,132,261,10,13,23,1,2:58
12858,566303,2019-05-31,2019,SDN,MIA,5,2,5-2,SDN,9,1,36,33,69,119,164,283,12,5,17,3,2:59
12859,565326,2019-04-24,2019,CLE,MIA,6,2,6-2,CLE,9,1,40,34,74,134,149,283,17,7,24,2,2:53
12860,565341,2019-05-23,2019,CLE,TBA,2,7,7-2,TBA,9,0,34,40,74,138,132,270,7,16,23,2,2:47
12861,566584,2019-05-07,2019,SLN,PHI,1,11,11-1,PHI,9,0,33,43,76,151,144,295,7,16,23,1,3:04
12862,565629,2019-05-23,2019,HOU,CHA,0,4,4-0,CHA,9,0,32,41,73,158,107,265,6,14,20,1,2:40
12863,567383,2019-05-18,2019,MIA,NYN,2,0,2-0,MIA,9,1,33,29,62,122,143,265,10,4,14,2,2:38
12864,564958,2019-05-29,2019,BAL,DET,2,4,4-2,DET,9,0,36,34,70,143,131,274,9,7,16,1,2:35
12865,565036,2019-04-25,2019,BOS,DET,7,3,7-3,BOS,9,1,36,37,73,131,147,278,13,10,23,0,2:39
12866,566180,2019-04-01,2019,PIT,SLN,5,6,6-5,SLN,11,0,47,51,98,238,191,429,17,19,36,6,4:50
12867,564840,2019-04-13,2019,ARI,SDN,4,5,5-4,SDN,9,0,41,36,77,150,178,328,16,11,27,2,3:41
12868,565038,2019-04-27,2019,BOS,TBA,1,2,2-1,TBA,9,0,39,35,74,142,164,306,13,10,23,4,3:21
12869,565425,2019-04-24,2019,COL,WAS,9,5,9-5,COL,9,1,43,41,84,140,153,293,21,14,35,1,2:48
12870,565130,2019-04-19,2019,CHN,ARI,5,1,5-1,CHN,9,1,43,35,78,135,182,317,19,9,28,2,3:24
12871,566191,2019-04-24,2019,PIT,ARI,2,11,11-2,ARI,9,0,37,42,79,152,136,288,11,16,27,0,2:49
12872,565422,2019-04-21,2019,COL,PHI,4,1,4-1,COL,9,1,39,38,77,160,135,295,17,12,29,0,2:58 (:33 delay)
12873,567467,2019-04-18,2019,NYA,KCA,1,6,6-1,KCA,9,0,34,39,73,170,142,312,7,12,19,2,3:06
12874,564942,2019-04-24,2019,BAL,CHA,4,3,4-3,BAL,9,1,32,41,73,177,109,286,9,14,23,2,2:56
12875,565996,2019-04-23,2019,NYN,PHI,9,0,9-0,NYN,9,1,41,32,73,136,156,292,16,7,23,0,2:43
12876,567190,2019-05-31,2019,ATL,DET,2,8,8-2,DET,9,0,33,42,75,156,127,283,8,15,23,2,2:52
12877,566302,2019-05-22,2019,SDN,ARI,5,2,5-2,SDN,9,1,38,33,71,127,157,284,18,7,25,2,2:57
12878,566783,2019-05-17,2019,TEX,SLN,7,3,7-3,TEX,9,1,35,37,72,145,154,299,13,10,23,4,2:59
12879,567576,2019-05-21,2019,MIL,CIN,0,3,3-0,CIN,9,0,35,33,68,147,149,296,11,7,18,0,2:39
12880,564744,2019-04-21,2019,ANA,SEA,8,6,8-6,ANA,9,1,39,39,78,155,127,282,17,14,31,2,2:51
12881,566205,2019-05-31,2019,PIT,MIL,9,4,9-4,PIT,9,1,43,35,78,119,154,273,19,8,27,1,2:54
12882,567084,2019-05-17,2019,PHI,COL,5,4,5-4,PHI,9,1,33,34,67,116,140,256,11,6,17,1,2:45 (:36 delay)
12883,567183,2019-05-15,2019,ATL,SLN,4,0,4-0,ATL,9,1,34,34,68,122,133,255,10,9,19,1,2:40
12884,567070,2019-04-17,2019,PHI,NYN,3,2,3-2,PHI,9,1,32,35,67,125,125,250,8,11,19,2,2:52
12885,565532,2019-05-17,2019,DET,OAK,2,7,7-2,OAK,9,0,32,38,70,149,114,263,5,12,17,2,2:28
12886,566574,2019-04-19,2019,SLN,NYN,4,5,5-4,NYN,9,0,42,44,86,160,174,334,15,16,31,5,3:31
12887,565909,2019-04-29,2019,WAS,SLN,3,6,6-3,SLN,9,0,37,40,77,140,177,317,10,14,24,0,3:05
12888,564842,2019-04-26,2019,ARI,CHN,8,3,8-3,ARI,9,1,41,37,78,149,152,301,17,11,28,0,3:04
12889,567565,2019-04-21,2019,MIL,LAN,5,6,6-5,LAN,9,0,37,41,78,161,146,307,11,15,26,2,3:13
12890,565140,2019-05-07,2019,CHN,MIA,5,2,5-2,CHN,9,0,38,37,75,149,158,307,14,9,23,1,3:10
12891,565037,2019-06-08,2019,BOS,TBA,5,1,5-1,BOS,9,1,36,36,72,159,146,305,13,8,21,2,3:21
12892,564953,2019-05-21,2019,BAL,NYA,4,11,11-4,NYA,9,0,37,42,79,171,139,310,10,16,26,0,2:49
12893,566579,2019-04-24,2019,SLN,MIL,5,2,5-2,SLN,9,1,37,34,71,147,145,292,15,9,24,2,2:51
12894,564757,2019-05-20,2019,ANA,MIN,1,3,3-1,MIN,9,0,36,38,74,148,147,295,9,12,21,2,3:28
12895,567375,2019-04-30,2019,MIA,CLE,4,7,7-4,CLE,9,0,38,40,78,147,142,289,11,12,23,1,2:56
12896,564854,2019-05-17,2019,ARI,SFN,7,0,7-0,ARI,9,1,38,37,75,144,131,275,16,10,26,3,3:06
12897,565133,2019-04-23,2019,CHN,LAN,7,2,7-2,CHN,9,1,37,36,73,150,131,281,15,9,24,1,2:56
12898,567283,2019-05-14,2019,CHA,CLE,0,9,9-0,CLE,9,0,34,40,74,172,140,312,7,16,23,4,3:06
12899,566395,2019-05-19,2019,SEA,MIN,7,4,7-4,SEA,9,1,36,38,74,139,140,279,13,11,24,0,3:00
12900,566986,2019-05-25,2019,MIN,CHA,8,1,8-1,MIN,9,1,39,34,73,120,173,293,16,8,24,1,3:16
12901,565134,2019-04-24,2019,CHN,LAN,7,6,7-6,CHN,9,1,34,38,72,167,130,297,12,13,25,2,2:48
12902,565721,2019-05-10,2019,KCA,PHI,5,1,5-1,KCA,9,1,35,35,70,143,145,288,13,9,22,4,3:07
12903,564853,2019-05-15,2019,ARI,PIT,11,1,11-1,ARI,9,1,40,33,73,127,155,282,15,7,22,3,2:58
12904,565718,2019-05-01,2019,KCA,TBA,8,2,8-2,KCA,9,1,37,35,72,121,156,277,15,8,23,1,2:41
12905,565439,2019-05-28,2019,COL,ARI,6,2,6-2,COL,9,1,34,39,73,135,134,269,12,13,25,1,3:02
12906,565151,2019-05-25,2019,CHN,CIN,8,6,8-6,CHN,9,1,39,41,80,134,132,266,16,17,33,3,3:13
12907,566004,2019-05-02,2019,NYN,CIN,1,0,1-0,NYN,9,1,28,31,59,104,118,222,5,5,10,0,2:10
12908,565245,2019-05-28,2019,CIN,PIT,11,6,11-6,CIN,9,1,37,36,73,130,140,270,14,11,25,2,2:42
12909,565728,2019-05-25,2019,KCA,NYA,3,7,7-3,NYA,9,0,33,40,73,140,129,269,6,13,19,1,2:42
12910,564759,2019-05-23,2019,ANA,MIN,7,16,16-7,MIN,9,0,44,50,94,177,184,361,17,23,40,3,3:27
12911,567563,2019-04-19,2019,MIL,LAN,3,5,5-3,LAN,9,0,37,42,79,185,160,345,12,17,29,6,3:47
12912,566973,2019-04-27,2019,MIN,BAL,9,2,9-2,MIN,9,1,39,35,74,146,186,332,14,8,22,1,3:24
12913,564837,2019-04-10,2019,ARI,TEX,2,5,5-2,TEX,9,0,39,41,80,187,159,346,12,12,24,5,3:35
12914,567071,2019-04-25,2019,PHI,MIA,1,3,3-1,MIA,10,0,35,42,77,162,145,307,5,15,20,3,3:35
12915,566392,2019-05-16,2019,SEA,MIN,6,11,11-6,MIN,9,0,36,45,81,188,119,307,9,18,27,1,3:03
12916,566580,2019-04-26,2019,SLN,CIN,1,12,12-1,CIN,9,0,38,44,82,166,128,294,14,17,31,3,2:55
12917,566578,2019-04-23,2019,SLN,MIL,4,3,4-3,SLN,9,1,36,35,71,155,157,312,15,10,25,1,3:00
12918,566488,2019-05-11,2019,SFN,CIN,4,5,5-4,CIN,9,0,38,40,78,158,141,299,11,13,24,0,2:59
12919,564843,2019-04-27,2019,ARI,CHN,1,9,9-1,CHN,9,0,34,42,76,161,139,300,7,18,25,1,3:05
12920,565722,2019-05-11,2019,KCA,PHI,0,7,7-0,PHI,9,0,31,44,75,193,110,303,6,17,23,1,3:01
12921,565419,2019-04-18,2019,COL,PHI,6,2,6-2,COL,9,1,37,35,72,155,136,291,15,8,23,2,3:03
12922,565232,2019-04-24,2019,CIN,ATL,1,3,3-1,ATL,9,0,35,42,77,152,149,301,9,17,26,2,2:58
12923,567089,2019-05-30,2019,PHI,SLN,3,5,5-3,SLN,9,0,37,36,73,141,133,274,14,11,25,3,3:01
12924,567287,2019-05-19,2019,CHA,TOR,2,5,5-2,TOR,9,0,35,37,72,150,145,295,10,10,20,1,3:06
12925,565050,2019-05-19,2019,BOS,HOU,4,3,4-3,BOS,9,1,34,37,71,160,130,290,11,12,23,2,3:02 (:55 delay)
12926,566691,2019-05-30,2019,TBA,MIN,14,3,14-3,TBA,9,1,42,33,75,121,148,269,19,7,26,1,2:44
12927,565337,2019-05-19,2019,CLE,BAL,10,0,10-0,CLE,9,1,42,31,73,107,174,281,18,5,23,2,2:49
12928,564845,2019-04-30,2019,ARI,NYA,3,1,3-1,ARI,9,1,33,31,64,115,122,237,10,6,16,2,2:33
12929,565922,2019-05-27,2019,WAS,MIA,2,3,3-2,MIA,9,0,34,40,74,154,119,273,8,12,20,2,3:00
12930,565231,2019-04-23,2019,CIN,ATL,7,6,7-6,CIN,9,1,42,39,81,147,158,305,19,11,30,5,3:22
12931,565624,2019-05-11,2019,HOU,TEX,11,4,11-4,HOU,9,1,43,36,79,146,166,312,18,10,28,3,3:15
12932,565243,2019-05-19,2019,CIN,LAN,3,8,8-3,LAN,9,0,37,43,80,173,136,309,11,16,27,3,3:03
12933,564754,2019-05-17,2019,ANA,KCA,5,2,5-2,ANA,9,1,36,38,74,155,153,308,15,12,27,2,3:17
12934,565247,2019-05-31,2019,CIN,WAS,9,3,9-3,CIN,9,1,41,36,77,152,142,294,18,10,28,1,2:49
12935,566595,2019-05-31,2019,SLN,CHN,2,1,2-1,SLN,10,0,37,38,75,150,154,304,11,10,21,2,3:24
12936,565814,2019-04-28,2019,LAN,PIT,7,6,7-6,LAN,9,1,36,39,75,152,145,297,12,11,23,1,3:07
12937,565424,2019-04-23,2019,COL,WAS,3,6,6-3,WAS,9,0,35,41,76,175,140,315,7,14,21,4,3:14
12938,566005,2019-05-10,2019,NYN,MIA,11,2,11-2,NYN,9,1,46,41,87,143,165,308,25,13,38,0,3:04
12939,566010,2019-05-22,2019,NYN,WAS,6,1,6-1,NYN,9,1,37,33,70,133,152,285,13,6,19,3,2:59
12940,567579,2019-05-25,2019,MIL,PHI,2,7,7-2,PHI,9,0,31,43,74,179,111,290,6,17,23,0,2:52
12941,566106,2019-05-11,2019,OAK,CLE,3,2,3-2,OAK,9,0,34,38,72,163,153,316,8,13,21,2,3:13
12942,566494,2019-05-22,2019,SFN,ATL,2,9,9-2,ATL,9,0,33,41,74,160,131,291,8,12,20,0,2:48
12943,565343,2019-05-25,2019,CLE,TBA,2,6,6-2,TBA,9,0,35,40,75,142,154,296,9,13,22,1,2:55 (2:48 delay)
12944,567284,2019-05-16,2019,CHA,TOR,4,2,4-2,CHA,9,1,38,34,72,123,157,280,14,7,21,1,3:16
12945,566977,2019-05-01,2019,MIN,HOU,6,2,6-2,MIN,9,1,33,35,68,120,129,249,9,9,18,0,2:28
12946,567466,2019-04-17,2019,NYA,BOS,5,3,5-3,NYA,9,1,33,36,69,122,144,266,8,10,18,2,2:56
12947,567376,2019-05-01,2019,MIA,CLE,4,2,4-2,MIA,9,1,35,34,69,131,107,238,13,9,22,1,2:38
12948,566293,2019-05-06,2019,SDN,NYN,4,0,4-0,SDN,9,1,32,32,64,104,124,228,8,5,13,1,2:14
12949,567480,2019-05-15,2019,NYA,BAL,5,3,5-3,NYA,9,1,33,33,66,112,110,222,8,7,15,2,2:12
12950,565438,2019-05-27,2019,COL,ARI,4,3,4-3,COL,11,0,46,44,90,174,199,373,16,12,28,4,4:23
12951,564937,2019-04-20,2019,BAL,MIN,7,16,16-7,MIN,9,0,37,46,83,162,142,304,12,19,31,1,2:50
12952,565727,2019-05-25,2019,KCA,NYA,5,6,6-5,NYA,9,0,36,43,79,165,149,314,11,18,29,2,3:07
12953,567276,2019-05-01,2019,CHA,BAL,7,6,7-6,CHA,9,0,40,41,81,154,166,320,14,14,28,3,3:22
12954,565612,2019-04-22,2019,HOU,MIN,5,9,9-5,MIN,9,0,41,42,83,154,166,320,15,17,32,1,3:25
12955,567086,2019-05-19,2019,PHI,COL,7,5,7-5,PHI,9,1,39,38,77,134,179,313,17,10,27,4,3:30
12956,565716,2019-04-28,2019,KCA,ANA,3,7,7-3,ANA,9,0,39,36,75,160,143,303,11,11,22,0,3:02
12957,564956,2019-05-27,2019,BAL,DET,5,3,5-3,BAL,9,1,35,38,73,162,132,294,10,11,21,2,2:55
12958,566871,2019-04-12,2019,TOR,TBA,7,11,11-7,TBA,9,0,39,49,88,174,132,306,14,24,38,3,3:21
12959,567382,2019-05-17,2019,MIA,NYN,8,6,8-6,MIA,9,1,36,42,78,138,143,281,10,18,28,2,3:01
12960,565522,2019-05-03,2019,DET,KCA,4,3,4-3,DET,9,1,34,35,69,139,118,257,11,9,20,0,2:33
12961,565623,2019-05-10,2019,HOU,TEX,3,0,3-0,HOU,9,1,31,31,62,124,129,253,8,5,13,0,2:29
12962,567179,2019-04-30,2019,ATL,SDN,3,4,4-3,SDN,9,0,36,32,68,111,136,247,10,7,17,0,2:42
12963,566000,2019-04-28,2019,NYN,MIL,5,2,5-2,NYN,9,1,37,30,67,128,157,285,15,5,20,2,2:52
12964,565997,2019-04-24,2019,NYN,PHI,0,6,6-0,PHI,9,0,36,44,80,170,148,318,10,14,24,2,3:21
12965,567168,2019-04-17,2019,ATL,ARI,2,3,3-2,ARI,10,0,41,41,82,159,164,323,11,10,21,2,3:32
12966,566590,2019-05-22,2019,SLN,KCA,10,3,10-3,SLN,9,1,40,38,78,155,175,330,18,13,31,3,3:30
12967,565340,2019-05-22,2019,CLE,OAK,2,7,7-2,OAK,9,0,40,45,85,163,165,328,14,17,31,1,3:14
12968,565338,2019-05-20,2019,CLE,OAK,4,6,6-4,OAK,9,0,38,41,79,179,138,317,11,16,27,5,3:19
12969,565434,2019-05-12,2019,COL,SDN,10,7,10-7,COL,9,1,40,40,80,148,162,310,19,13,32,3,3:06
12970,564758,2019-05-21,2019,ANA,MIN,3,8,8-3,MIN,9,0,37,41,78,178,130,308,10,15,25,2,3:27
12971,566498,2019-05-26,2019,SFN,ARI,2,6,6-2,ARI,9,0,38,40,78,146,159,305,13,13,26,3,3:17
12972,565628,2019-05-22,2019,HOU,CHA,4,9,9-4,CHA,9,0,38,38,76,164,138,302,16,12,28,3,3:16
12973,565034,2019-04-23,2019,BOS,DET,2,4,4-2,DET,9,0,42,37,79,144,171,315,17,15,32,5,3:29
12974,567479,2019-08-12,2019,NYA,BAL,8,5,8-5,NYA,9,1,35,38,73,166,138,304,11,12,23,1,2:50
12975,567374,2019-04-21,2019,MIA,WAS,0,5,5-0,WAS,9,0,33,37,70,134,136,270,7,12,19,3,2:45
12976,567275,2019-04-29,2019,CHA,BAL,5,3,5-3,CHA,9,1,40,38,78,154,150,304,16,13,29,5,3:18
12977,567572,2019-05-05,2019,MIL,NYN,3,2,3-2,MIL,9,1,30,32,62,136,109,245,7,7,14,3,2:39
12978,566096,2019-04-19,2019,OAK,TOR,1,5,5-1,TOR,9,0,35,36,71,138,123,261,8,10,18,1,2:36
12979,567069,2019-04-16,2019,PHI,NYN,14,3,14-3,PHI,9,1,44,39,83,159,171,330,18,14,32,2,3:07
12980,565441,2019-05-30,2019,COL,ARI,11,10,11-10,COL,10,0,50,45,95,182,185,367,24,18,42,3,3:51
12981,567559,2019-04-15,2019,MIL,SLN,10,7,10-7,MIL,9,1,43,43,86,156,175,331,21,15,36,5,3:51
12982,566483,2019-04-28,2019,SFN,NYA,5,11,11-5,NYA,9,0,37,46,83,184,145,329,9,20,29,1,3:16
12983,567170,2019-04-26,2019,ATL,COL,4,8,8-4,COL,9,0,39,40,79,153,157,310,14,12,26,5,3:21
12984,565437,2019-05-26,2019,COL,BAL,8,7,8-7,COL,9,0,44,42,86,134,157,291,18,13,31,7,3:28
12985,566108,2019-05-24,2019,OAK,SEA,6,2,6-2,OAK,9,1,35,44,79,195,127,322,12,18,30,2,3:25
12986,565528,2019-05-13,2019,DET,HOU,1,8,8-1,HOU,9,0,37,40,77,178,141,319,11,15,26,0,3:03
12987,565426,2019-05-03,2019,COL,ARI,9,10,10-9,ARI,9,0,43,42,85,159,155,314,15,14,29,3,3:24
12988,566202,2019-05-25,2019,PIT,LAN,2,7,7-2,LAN,9,0,37,43,80,157,132,289,11,17,28,0,3:12 (1:48 delay)
12989,566490,2019-05-14,2019,SFN,TOR,3,7,7-3,TOR,9,0,39,43,82,170,155,325,11,17,28,3,3:02
12990,564747,2019-04-24,2019,ANA,NYA,5,6,6-5,NYA,9,0,37,38,75,158,148,306,10,11,21,2,3:29
12991,567076,2019-05-01,2019,PHI,DET,7,3,7-3,PHI,9,1,37,41,78,162,131,293,17,16,33,4,3:16
12992,565536,2019-05-22,2019,DET,MIA,3,6,6-3,MIA,9,0,38,37,75,156,148,304,13,13,26,2,3:01
12993,567085,2019-05-18,2019,PHI,COL,2,1,2-1,PHI,9,1,35,38,73,143,152,295,11,11,22,4,3:18
12994,565718,2019-05-01,2019,KCA,TBA,8,2,8-2,KCA,9,1,37,35,72,121,156,277,15,8,23,1,2:41
12995,566581,2019-04-27,2019,SLN,CIN,6,3,6-3,SLN,9,1,36,34,70,131,118,249,14,9,23,2,2:32
12996,566883,2019-05-11,2019,TOR,CHA,2,7,7-2,CHA,9,0,35,44,79,174,135,309,11,17,28,3,3:20
12997,565328,2019-05-04,2019,CLE,SEA,5,4,5-4,CLE,9,1,32,34,66,117,134,251,11,8,19,2,2:41
12998,566679,2019-04-24,2019,TBA,KCA,2,10,10-2,KCA,9,0,40,43,83,163,136,299,14,21,35,3,3:06
12999,566399,2019-05-30,2019,SEA,ANA,3,9,9-3,ANA,9,0,34,45,79,179,147,326,8,21,29,3,3:21
13000,566012,2019-05-24,2019,NYN,DET,8,9,9-8,DET,9,0,39,45,84,161,149,310,13,18,31,2,3:12
13001,565043,2019-05-10,2019,BOS,SEA,14,1,14-1,BOS,9,1,44,36,80,138,168,306,18,9,27,2,3:02
13002,566686,2019-05-21,2019,TBA,LAN,3,7,7-3,LAN,9,0,37,44,81,166,132,298,11,18,29,5,3:10
13003,565440,2019-05-29,2019,COL,ARI,5,4,5-4,COL,9,1,34,39,73,162,136,298,17,14,31,1,3:11
13004,565918,2019-05-19,2019,WAS,CHN,5,6,6-5,CHN,9,0,37,42,79,157,127,284,11,16,27,4,3:15
13005,565246,2019-05-29,2019,CIN,PIT,2,7,7-2,PIT,9,0,38,42,80,148,134,282,12,16,28,4,3:09 (2:13 delay)
13006,567387,2019-05-30,2019,MIA,SFN,1,3,3-1,SFN,9,0,35,39,74,157,138,295,12,16,28,3,3:05
13007,567180,2019-05-01,2019,ATL,SDN,5,1,5-1,ATL,9,1,34,34,68,122,128,250,10,7,17,2,2:39
13008,565519,2019-04-19,2019,DET,CHA,3,7,7-3,CHA,9,0,35,41,76,147,145,292,10,16,26,2,2:50
13009,566192,2019-04-25,2019,PIT,ARI,0,5,5-0,ARI,9,0,33,37,70,132,139,271,6,11,17,0,2:41 (:31 delay)
13010,564759,2019-05-23,2019,ANA,MIN,7,16,16-7,MIN,9,0,44,50,94,177,184,361,17,23,40,3,3:27
13011,565324,2019-04-21,2019,CLE,ATL,5,11,11-5,ATL,9,0,43,48,91,185,149,334,16,21,37,3,3:22
13012,565907,2019-04-27,2019,WAS,SDN,3,8,8-3,SDN,10,0,41,43,84,183,165,348,11,14,25,5,3:45
13013,564762,2019-05-26,2019,ANA,TEX,7,6,7-6,ANA,9,1,37,41,78,183,140,323,16,12,28,2,3:27
13014,565529,2019-05-14,2019,DET,HOU,4,11,11-4,HOU,9,0,36,47,83,169,150,319,11,19,30,0,2:49
13015,567082,2019-05-15,2019,PHI,MIL,2,5,5-2,MIL,9,0,35,43,78,180,136,316,10,16,26,2,3:20
13016,565047,2019-05-15,2019,BOS,COL,6,5,6-5,BOS,10,0,43,43,86,175,134,309,20,14,34,5,3:44
13017,566980,2019-05-11,2019,MIN,DET,3,5,5-3,DET,9,0,40,39,79,157,169,326,13,11,24,4,3:24
13018,567081,2019-05-14,2019,PHI,MIL,1,6,6-1,MIL,9,0,36,41,77,175,150,325,10,17,27,0,3:11
13019,565442,2019-05-31,2019,COL,TOR,13,6,13-6,COL,9,1,45,41,86,146,162,308,22,16,38,2,3:10
13020,566582,2019-04-28,2019,SLN,CIN,5,2,5-2,SLN,9,1,34,35,69,127,144,271,12,9,21,3,2:53
13021,565521,2019-04-21,2019,DET,CHA,4,3,4-3,DET,9,1,32,33,65,145,134,279,9,7,16,2,2:49
13022,567473,2019-05-05,2019,NYA,MIN,4,1,4-1,NYA,8,0,32,33,65,137,144,281,12,9,21,2,2:53 (1:01 delay)
13023,566979,2019-05-10,2019,MIN,DET,6,0,6-0,MIN,9,1,38,30,68,119,145,264,15,3,18,1,2:36
13024,565235,2019-05-04,2019,CIN,SFN,9,2,9-2,CIN,9,1,36,34,70,141,125,266,14,7,21,1,2:26
13025,565041,2019-04-30,2019,BOS,OAK,5,1,5-1,BOS,9,1,35,33,68,138,133,271,10,6,16,2,2:34
13026,565322,2019-04-20,2019,CLE,ATL,7,8,8-7,ATL,9,0,44,42,86,203,189,392,20,16,36,6,3:54
13027,565713,2019-04-14,2019,KCA,CLE,9,8,9-8,KCA,9,0,42,39,81,159,190,349,19,15,34,6,3:27
13028,565999,2019-04-27,2019,NYN,MIL,6,8,8-6,MIL,9,0,40,44,84,171,164,335,16,21,37,2,3:57
13029,564954,2019-05-22,2019,BAL,NYA,5,7,7-5,NYA,9,0,40,43,83,164,164,328,13,17,30,2,3:18
13030,566298,2019-05-18,2019,SDN,PIT,2,7,7-2,PIT,9,0,39,43,82,169,160,329,13,17,30,4,3:24
13031,565520,2019-08-06,2019,DET,CHA,3,5,5-3,CHA,9,0,39,41,80,165,165,330,12,17,29,3,3:19
13032,565634,2019-05-28,2019,HOU,CHN,9,6,9-6,HOU,9,1,39,42,81,175,147,322,16,15,31,2,3:08
13033,566002,2019-04-30,2019,NYN,CIN,4,3,4-3,NYN,10,0,38,44,82,171,148,319,12,15,27,6,3:24
13034,566100,2019-04-23,2019,OAK,TEX,11,5,11-5,OAK,9,1,45,42,87,159,165,324,21,16,37,3,3:17
13035,565725,2019-05-15,2019,KCA,TEX,1,6,6-1,TEX,9,0,38,42,80,176,135,311,12,17,29,2,3:24
13036,566590,2019-05-22,2019,SLN,KCA,10,3,10-3,SLN,9,1,40,38,78,155,175,330,18,13,31,3,3:30
13037,564959,2019-05-31,2019,BAL,SFN,9,6,9-6,BAL,9,1,37,41,78,163,162,325,15,16,31,3,3:09
13038,566985,2019-05-24,2019,MIN,CHA,11,4,11-4,MIN,9,1,44,38,82,128,184,312,19,11,30,3,3:27
13039,565531,2019-05-16,2019,DET,OAK,3,17,17-3,OAK,9,0,35,50,85,185,126,311,9,22,31,0,2:55
13040,565812,2019-04-26,2019,LAN,PIT,6,2,6-2,LAN,9,1,37,35,72,119,165,284,14,9,23,1,2:52
13041,567372,2019-04-19,2019,MIA,WAS,3,2,3-2,MIA,9,1,37,33,70,132,124,256,11,7,18,4,2:52
13042,566389,2019-05-01,2019,SEA,CHN,0,11,11-0,CHN,9,0,30,43,73,146,122,268,2,15,17,1,2:41
13043,565906,2019-04-26,2019,WAS,SDN,3,4,4-3,SDN,9,0,36,33,69,155,138,293,9,7,16,1,3:02
13044,566678,2019-04-23,2019,TBA,KCA,5,2,5-2,TBA,9,1,36,36,72,132,149,281,13,9,22,3,2:54
13045,566186,2019-04-19,2019,PIT,SFN,4,1,4-1,PIT,9,1,32,34,66,150,126,276,8,10,18,2,2:48 (1:25 delay)
13046,564940,2019-04-22,2019,BAL,CHA,2,12,12-2,CHA,9,0,37,48,85,187,158,345,10,19,29,3,3:26
13047,566189,2019-04-22,2019,PIT,ARI,4,12,12-4,ARI,9,0,41,48,89,174,162,336,15,21,36,4,3:35
13048,566398,2019-05-29,2019,SEA,TEX,7,8,8-7,TEX,9,0,42,43,85,166,158,324,17,15,32,2,3:20
13049,566397,2019-05-28,2019,SEA,TEX,4,11,11-4,TEX,9,0,40,44,84,170,156,326,14,18,32,2,3:17
13050,564952,2019-05-20,2019,BAL,NYA,7,10,10-7,NYA,9,0,46,41,87,152,179,331,20,15,35,3,3:35
13051,566112,2019-05-28,2019,OAK,ANA,4,6,6-4,ANA,9,0,38,40,78,180,166,346,12,14,26,1,3:32
13052,567167,2019-04-16,2019,ATL,ARI,6,9,9-6,ARI,9,0,39,47,86,185,150,335,16,24,40,5,3:36
13053,566976,2019-04-30,2019,MIN,HOU,0,11,11-0,HOU,9,0,34,50,84,200,135,335,8,21,29,2,3:18
13054,567273,2019-07-03,2019,CHA,DET,7,5,7-5,CHA,9,1,37,39,76,162,152,314,16,12,28,3,3:05
13055,567569,2019-05-02,2019,MIL,COL,6,11,11-6,COL,9,0,40,46,86,162,162,324,13,17,30,2,3:24
13056,566382,2019-04-16,2019,SEA,CLE,2,4,4-2,CLE,9,0,37,38,75,150,143,293,10,14,24,2,3:07
13057,564847,2019-05-09,2019,ARI,ATL,3,2,3-2,ARI,10,0,45,37,82,152,164,316,19,9,28,0,3:13
13058,566199,2019-05-22,2019,PIT,COL,3,9,9-3,COL,9,0,36,47,83,179,137,316,11,22,33,2,3:25
13059,566880,2019-05-07,2019,TOR,MIN,0,3,3-0,MIN,9,0,33,37,70,126,119,245,6,11,17,1,2:30
13060,565800,2019-03-29,2019,LAN,ARI,4,5,5-4,ARI,13,0,60,56,116,232,262,494,24,18,42,3,6:05
13061,566384,2019-04-25,2019,SEA,TEX,14,2,14-2,SEA,9,1,47,37,84,149,208,357,23,11,34,4,3:25
13062,565429,2019-05-07,2019,COL,SFN,4,14,14-4,SFN,9,0,39,47,86,202,149,351,13,22,35,1,3:23
13063,567185,2019-05-17,2019,ATL,MIL,12,8,12-8,ATL,9,1,47,42,89,158,183,341,23,15,38,3,3:25
13064,564851,2019-05-13,2019,ARI,PIT,9,3,9-3,ARI,9,1,41,42,83,172,160,332,17,15,32,0,3:27
13065,566098,2019-04-21,2019,OAK,TOR,4,5,5-4,TOR,9,0,37,41,78,168,136,304,13,15,28,4,3:19
13066,564856,2019-05-19,2019,ARI,SFN,2,3,3-2,SFN,10,0,40,40,80,170,161,331,10,10,20,1,3:28
13067,566577,2019-04-22,2019,SLN,MIL,13,5,13-5,SLN,9,1,45,34,79,139,179,318,22,6,28,2,3:12
13068,564947,2019-05-07,2019,BAL,BOS,5,8,8-5,BOS,9,0,36,41,77,192,142,334,10,16,26,2,3:21
13069,565138,2019-05-05,2019,CHN,SLN,13,5,13-5,CHN,9,1,39,41,80,163,141,304,16,14,30,3,3:21
13070,567166,2019-04-14,2019,ATL,NYN,7,3,7-3,ATL,9,1,41,40,81,151,194,345,18,13,31,2,3:36 (:27 delay)
13071,566984,2019-05-15,2019,MIN,ANA,8,7,8-7,MIN,9,1,37,48,85,182,145,327,14,22,36,6,3:41
13072,566877,2019-04-27,2019,TOR,OAK,7,1,7-1,TOR,9,1,41,36,77,139,146,285,17,9,26,1,2:50
13073,566583,2019-05-06,2019,SLN,PHI,6,0,6-0,SLN,9,1,37,31,68,131,148,279,16,6,22,2,2:52
13074,565332,2019-05-08,2019,CLE,CHA,5,3,5-3,CLE,9,0,39,36,75,128,135,263,14,10,24,2,2:50
13075,566882,2019-05-10,2019,TOR,CHA,4,3,4-3,TOR,9,1,35,35,70,138,137,275,11,8,19,4,3:08
13076,566874,2019-04-23,2019,TOR,SFN,6,7,7-6,SFN,9,0,38,37,75,149,140,289,11,10,21,4,3:06
13077,565423,2019-04-22,2019,COL,WAS,7,5,7-5,COL,9,1,37,35,72,162,126,288,14,10,24,1,3:00
13078,565815,2019-05-06,2019,LAN,ATL,5,3,5-3,LAN,9,1,38,32,70,132,138,270,14,5,19,1,2:45
13079,565236,2019-05-05,2019,CIN,SFN,5,6,6-5,SFN,9,0,36,33,69,121,170,291,10,8,18,1,2:38
13080,565627,2019-05-21,2019,HOU,CHA,5,1,5-1,HOU,9,1,36,30,66,120,152,272,14,3,17,1,2:53
13081,565717,2019-04-29,2019,KCA,TBA,5,8,8-5,TBA,9,0,35,42,77,157,123,280,7,17,24,2,2:51
13082,565825,2019-05-28,2019,LAN,NYN,3,7,7-3,NYN,9,0,39,43,82,183,150,333,13,16,29,3,3:22
13083,567271,2019-04-17,2019,CHA,KCA,3,4,4-3,KCA,10,0,47,44,91,165,183,348,18,17,35,5,4:04
13084,566101,2019-04-24,2019,OAK,TEX,6,5,6-5,OAK,9,0,41,36,77,158,165,323,17,10,27,0,3:22
13085,566296,2019-05-16,2019,SDN,PIT,4,3,4-3,SDN,9,1,32,38,70,155,143,298,10,9,19,3,3:05
13086,566484,2019-04-29,2019,SFN,LAN,3,2,3-2,SFN,9,1,38,37,75,156,125,281,16,12,28,3,3:14
13087,567574,2019-05-07,2019,MIL,WAS,6,0,6-0,MIL,9,1,37,36,73,134,149,283,15,9,24,2,3:00
13088,567472,2019-05-04,2019,NYA,MIN,3,7,7-3,MIN,9,0,36,42,78,135,153,288,11,15,26,4,3:06
13089,566196,2019-05-07,2019,PIT,TEX,5,4,5-4,PIT,9,1,36,39,75,153,120,273,14,13,27,1,2:50
13090,567570,2019-05-03,2019,MIL,NYN,3,1,3-1,MIL,9,1,35,35,70,154,134,288,12,10,22,2,3:01
13091,565921,2019-05-26,2019,WAS,MIA,9,6,9-6,WAS,9,1,43,41,84,169,152,321,19,17,36,1,3:06 (:24 delay)
13092,566884,2019-05-12,2019,TOR,CHA,1,5,5-1,CHA,9,0,32,39,71,145,124,269,5,13,18,0,2:47
13093,565619,2019-05-06,2019,HOU,KCA,6,4,6-4,HOU,9,1,37,37,74,151,145,296,15,10,25,3,2:57
13094,567477,2019-05-09,2019,NYA,SEA,3,1,3-1,NYA,9,1,34,32,66,153,130,283,11,7,18,1,2:54
13095,565993,2019-04-09,2019,NYN,MIN,8,14,14-8,MIN,9,0,45,46,91,186,219,405,18,19,37,3,4:08 (:25 delay)
13096,567068,2019-04-15,2019,PHI,NYN,6,7,7-6,NYN,11,0,50,50,100,171,209,380,20,19,39,1,4:29
13097,566390,2019-05-13,2019,SEA,OAK,6,5,6-5,SEA,10,0,42,46,88,173,179,352,14,17,31,1,3:47
13098,566772,2019-04-15,2019,TEX,ANA,12,7,12-7,TEX,9,1,46,44,90,170,188,358,22,17,39,4,3:26
13099,566785,2019-05-19,2019,TEX,SLN,5,4,5-4,TEX,10,0,39,42,81,185,160,345,14,12,26,2,3:41
13100,566676,2019-04-21,2019,TBA,BOS,3,4,4-3,BOS,11,0,42,46,88,171,180,351,10,17,27,2,4:09
13101,567276,2019-05-01,2019,CHA,BAL,7,6,7-6,CHA,9,0,40,41,81,154,166,320,14,14,28,3,3:22
13102,565244,2019-05-27,2019,CIN,PIT,5,8,8-5,PIT,9,0,42,44,86,174,170,344,17,18,35,6,3:51
13103,565724,2019-05-14,2019,KCA,TEX,11,5,11-5,KCA,9,1,43,39,82,175,163,338,20,12,32,4,3:24
13104,567075,2019-04-30,2019,PHI,DET,1,3,3-1,DET,9,0,35,38,73,171,133,304,8,11,19,1,3:10
13105,566388,2019-04-30,2019,SEA,CHN,5,6,6-5,CHN,9,0,41,40,81,145,153,298,16,14,30,4,3:10
13106,564849,2019-05-11,2019,ARI,ATL,4,6,6-4,ATL,9,0,39,39,78,136,135,271,12,14,26,3,3:09
13107,565145,2019-05-12,2019,CHN,MIL,4,1,4-1,CHN,9,1,34,37,71,142,130,272,10,11,21,1,2:55
13108,566391,2019-05-14,2019,SEA,OAK,4,3,4-3,SEA,9,1,33,36,69,136,148,284,10,9,19,3,2:37
13109,566879,2019-05-06,2019,TOR,MIN,0,8,8-0,MIN,9,0,31,41,72,154,125,279,5,16,21,3,2:52
13110,566890,2019-05-25,2019,TOR,SDN,4,19,19-4,SDN,9,0,32,54,86,213,128,341,6,29,35,1,3:04
13111,567577,2019-05-22,2019,MIL,CIN,11,9,11-9,MIL,9,1,43,43,86,185,173,358,18,18,36,5,3:48
13112,565517,2019-04-17,2019,DET,PIT,2,3,3-2,PIT,10,0,39,42,81,162,143,305,10,13,23,2,3:21
13113,566779,2019-05-01,2019,TEX,PIT,5,7,7-5,PIT,9,0,38,40,78,152,147,299,10,13,23,3,3:10
13114,565142,2019-05-09,2019,CHN,MIA,4,1,4-1,CHN,9,1,36,37,73,168,140,308,12,12,24,0,2:59
13115,565527,2019-05-09,2019,DET,ANA,0,13,13-0,ANA,9,0,32,44,76,173,112,285,5,19,24,1,2:44 (:53 delay)
13116,566782,2019-05-05,2019,TEX,TOR,10,2,10-2,TEX,9,1,37,33,70,132,149,281,14,9,23,1,2:50
13117,565621,2019-05-08,2019,HOU,KCA,9,0,9-0,HOU,9,1,39,35,74,139,147,286,15,7,22,1,2:45
13118,567079,2019-05-05,2019,PHI,WAS,7,1,7-1,PHI,9,1,39,34,73,137,168,305,14,8,22,1,3:03
13119,565526,2019-05-08,2019,DET,ANA,10,3,10-3,DET,9,1,39,37,76,148,144,292,14,9,23,1,2:53
13120,565826,2019-05-29,2019,LAN,NYN,9,8,9-8,LAN,9,0,43,42,85,168,176,344,20,16,36,0,3:31
13121,565534,2019-05-19,2019,DET,OAK,3,7,7-3,OAK,9,0,34,42,76,162,133,295,8,17,25,3,2:58 (1:41 delay)
13122,565729,2019-05-26,2019,KCA,NYA,8,7,8-7,KCA,10,0,47,44,91,173,175,348,17,15,32,0,3:17
13123,567278,2019-05-02,2019,CHA,BOS,6,4,6-4,CHA,9,0,35,41,76,168,141,309,11,16,27,2,3:33
13124,565525,2019-05-07,2019,DET,ANA,2,5,5-2,ANA,9,0,33,41,74,165,137,302,6,14,20,2,2:59
13125,567381,2019-05-15,2019,MIA,TBA,0,1,1-0,TBA,9,0,38,35,73,131,149,280,11,11,22,4,3:06
13126,567483,2019-05-19,2019,NYA,TBA,13,5,13-5,NYA,9,1,45,40,85,172,181,353,20,14,34,4,3:27
13127,564741,2019-04-18,2019,ANA,SEA,10,11,11-10,SEA,9,0,45,52,97,199,171,370,20,25,45,4,3:59
13128,565152,2019-05-26,2019,CHN,CIN,2,10,10-2,CIN,9,0,38,46,84,174,172,346,12,20,32,2,3:27
13129,567181,2019-05-02,2019,ATL,SDN,2,11,11-2,SDN,9,0,37,48,85,179,119,298,11,20,31,1,2:53
13130,565622,2019-05-09,2019,HOU,TEX,4,2,4-2,HOU,9,1,37,32,69,144,164,308,15,7,22,2,2:58
13131,566777,2019-04-21,2019,TEX,HOU,11,10,11-10,TEX,9,1,39,44,83,169,134,303,15,17,32,5,3:16
13132,566781,2019-05-04,2019,TEX,TOR,8,5,8-5,TEX,9,1,38,38,76,138,162,300,14,14,28,1,2:59
13133,565237,2019-05-06,2019,CIN,SFN,12,4,12-4,CIN,9,1,46,35,81,134,169,303,23,8,31,2,2:57 (:18 delay)
13134,566487,2019-05-10,2019,SFN,CIN,0,7,7-0,CIN,9,0,38,43,81,147,156,303,11,14,25,1,2:47
13135,567475,2019-05-07,2019,NYA,SEA,5,4,5-4,NYA,9,0,37,39,76,148,147,295,13,12,25,2,3:15 (1:12 delay)
13136,566680,2019-05-06,2019,TBA,ARI,12,1,12-1,TBA,9,1,43,33,76,140,166,306,20,6,26,0,2:54
13137,566491,2019-05-15,2019,SFN,TOR,4,3,4-3,SFN,9,1,34,35,69,148,133,281,11,8,19,0,3:01
13138,565818,2019-05-09,2019,LAN,WAS,0,6,6-0,WAS,9,0,36,40,76,166,146,312,11,13,24,1,3:11
13139,565530,2019-05-15,2019,DET,HOU,1,5,5-1,HOU,9,0,32,40,72,157,129,286,4,13,17,0,2:36
13140,566478,2019-04-12,2019,SFN,COL,3,2,3-2,SFN,18,0,62,67,129,265,238,503,15,15,30,3,5:35
13141,564945,2019-07-13,2019,BAL,TBA,2,1,2-1,BAL,9,1,31,33,64,149,156,305,7,8,15,4,3:02
13142,566385,2019-04-26,2019,SEA,TEX,5,4,5-4,SEA,11,0,46,46,92,204,189,393,15,16,31,1,4:06
13143,565428,2019-05-05,2019,COL,ARI,8,7,8-7,COL,9,1,36,41,77,155,130,285,12,13,25,2,3:09
13144,565919,2019-05-24,2019,WAS,MIA,12,10,12-10,WAS,9,1,43,48,91,178,180,358,20,20,40,7,3:59
13145,564746,2019-04-23,2019,ANA,NYA,5,7,7-5,NYA,9,0,37,46,83,178,140,318,11,19,30,3,3:12
13146,566204,2019-05-30,2019,PIT,MIL,5,11,11-5,MIL,9,0,40,50,90,182,156,338,13,27,40,1,3:39
13147,565143,2019-05-10,2019,CHN,MIL,0,7,7-0,MIL,9,0,35,42,77,149,148,297,11,16,27,5,3:18
13148,565432,2019-05-10,2019,COL,SDN,12,2,12-2,COL,9,1,43,41,84,130,158,288,20,13,33,2,3:10
13149,566290,2019-05-03,2019,SDN,LAN,3,4,4-3,LAN,9,0,35,38,73,154,142,296,8,11,19,2,3:13
13150,567279,2019-05-03,2019,CHA,BOS,1,6,6-1,BOS,9,0,36,42,78,172,156,328,10,17,27,2,3:15
13151,565141,2019-05-08,2019,CHN,MIA,3,2,3-2,CHN,11,0,37,40,77,136,144,280,11,9,20,1,2:59
13152,567377,2019-05-03,2019,MIA,ATL,2,7,7-2,ATL,9,0,38,40,78,161,145,306,12,15,27,3,3:08
13153,564949,2019-05-10,2019,BAL,ANA,3,8,8-3,ANA,9,0,34,42,76,179,126,305,6,16,22,1,3:04 (1:49 delay)
13154,565819,2019-05-10,2019,LAN,WAS,5,0,5-0,LAN,9,1,37,34,71,126,163,289,14,7,21,1,2:58
13155,566194,2019-05-04,2019,PIT,OAK,6,4,6-4,PIT,9,1,40,38,78,149,149,298,18,12,30,1,3:08
13156,567073,2019-04-27,2019,PHI,MIA,12,9,12-9,PHI,9,1,43,45,88,180,183,363,21,20,41,1,3:38
13157,566386,2019-04-27,2019,SEA,TEX,1,15,15-1,TEX,9,0,32,55,87,213,140,353,5,26,31,0,3:11
13158,564750,2019-05-01,2019,ANA,TOR,6,3,6-3,ANA,9,1,41,37,78,149,179,328,15,7,22,3,3:32
13159,567378,2019-05-04,2019,MIA,ATL,2,9,9-2,ATL,9,0,36,47,83,188,113,301,6,19,25,2,3:15
13160,566681,2019-05-07,2019,TBA,ARI,6,3,6-3,TBA,9,1,37,37,74,151,156,307,14,10,24,3,3:19
13161,565524,2019-05-05,2019,DET,KCA,5,2,5-2,DET,10,0,42,40,82,157,165,322,14,9,23,2,3:14
13162,567281,2019-05-05,2019,CHA,BOS,2,9,9-2,BOS,9,0,36,43,79,176,156,332,8,19,27,3,3:33
13163,565049,2019-05-18,2019,BOS,HOU,3,7,7-3,HOU,9,0,36,45,81,186,144,330,10,19,29,2,3:31
13164,567379,2019-05-05,2019,MIA,ATL,1,3,3-1,ATL,10,0,38,39,77,160,156,316,9,10,19,1,3:29
13165,567285,2019-05-17,2019,CHA,TOR,2,10,10-2,TOR,9,0,36,47,83,186,128,314,10,21,31,2,3:14
13166,566009,2019-05-21,2019,NYN,WAS,6,5,6-5,NYN,9,0,38,37,75,153,137,290,14,12,26,5,3:05
13167,564745,2019-04-22,2019,ANA,NYA,3,4,4-3,NYA,14,0,53,53,106,210,195,405,16,12,28,0,4:35
13168,566878,2019-04-28,2019,TOR,OAK,5,4,5-4,TOR,11,0,47,49,96,205,167,372,13,17,30,1,3:56
13169,565035,2019-04-24,2019,BOS,DET,11,4,11-4,BOS,9,1,45,40,85,158,175,333,24,13,37,3,3:24
13170,566197,2019-05-08,2019,PIT,TEX,6,9,9-6,TEX,9,0,38,43,81,184,142,326,11,18,29,1,3:18
13171,565137,2019-05-04,2019,CHN,SLN,6,5,6-5,CHN,9,1,34,43,77,168,122,290,12,17,29,3,3:03
13172,565817,2019-05-08,2019,LAN,ATL,9,4,9-4,LAN,9,1,40,38,78,132,146,278,18,12,30,3,2:58
13173,566594,2019-05-26,2019,SLN,ATL,3,4,4-3,ATL,10,0,43,44,87,204,162,366,11,17,28,5,4:07
13174,566690,2019-05-29,2019,TBA,TOR,4,3,4-3,TBA,11,0,52,47,99,171,187,358,24,17,41,3,4:03
13175,566481,2019-04-26,2019,SFN,NYA,3,7,7-3,NYA,9,0,39,41,80,160,181,341,12,16,28,3,3:26
13176,565147,2019-05-21,2019,CHN,PHI,3,2,3-2,CHN,9,0,43,36,79,155,157,312,18,9,27,3,3:34
13177,565427,2019-05-04,2019,COL,ARI,2,9,9-2,ARI,9,0,33,42,75,147,142,289,6,17,23,0,2:51
13178,565916,2019-05-17,2019,WAS,CHN,6,14,14-6,CHN,9,0,44,52,96,217,175,392,19,27,46,4,4:09
13179,567172,2019-04-28,2019,ATL,COL,8,7,8-7,ATL,9,1,41,41,82,158,175,333,16,14,30,5,3:47
13180,566394,2019-05-18,2019,SEA,MIN,4,18,18-4,MIN,9,0,38,53,91,208,184,392,10,25,35,2,3:50
13181,565523,2019-05-04,2019,DET,KCA,3,15,15-3,KCA,9,0,37,54,91,188,124,312,10,29,39,3,3:00
13182,565044,2019-05-11,2019,BOS,SEA,9,5,9-5,BOS,9,1,44,36,80,143,189,332,21,8,29,2,3:15
13183,565329,2019-05-05,2019,CLE,SEA,0,10,10-0,SEA,9,0,32,42,74,164,148,312,5,18,23,2,2:54
13184,566982,2019-05-13,2019,MIN,ANA,4,5,5-4,ANA,9,0,39,42,81,150,156,306,11,18,29,1,3:14
13185,566673,2019-04-18,2019,TBA,BAL,5,6,6-5,BAL,11,0,46,51,97,203,212,415,14,21,35,3,4:15
13186,566682,2019-05-08,2019,TBA,ARI,2,3,3-2,ARI,13,0,52,52,104,198,224,422,16,17,33,6,4:39
13187,565715,2019-04-27,2019,KCA,ANA,9,4,9-4,KCA,9,1,42,39,81,170,181,351,19,14,33,3,3:40
13188,567568,2019-05-01,2019,MIL,COL,4,11,11-4,COL,9,0,41,43,84,172,194,366,16,18,34,1,3:44
13189,567280,2019-05-04,2019,CHA,BOS,2,15,15-2,BOS,9,0,35,53,88,194,152,346,10,26,36,2,3:34
13190,567573,2019-05-06,2019,MIL,WAS,5,3,5-3,MIL,9,1,41,36,77,170,177,347,14,9,23,2,3:33
13191,564951,2019-05-12,2019,BAL,ANA,5,1,5-1,BAL,9,1,41,34,75,146,175,321,17,8,25,1,3:08 (2:42 delay)
13192,567182,2019-05-14,2019,ATL,SLN,3,14,14-3,SLN,9,0,35,46,81,182,159,341,9,21,30,1,3:00
13193,565420,2019-04-19,2019,COL,PHI,4,3,4-3,COL,12,0,46,58,104,210,185,395,13,24,37,1,4:26
13194,566586,2019-05-09,2019,SLN,PIT,17,4,17-4,SLN,9,1,50,39,89,135,189,324,25,12,37,2,3:30
13195,567277,2019-05-01,2019,CHA,BAL,4,5,5-4,BAL,9,0,39,45,84,189,176,365,10,18,28,5,3:48
13196,565139,2019-05-06,2019,CHN,MIA,5,6,6-5,MIA,9,0,41,38,79,155,177,332,18,12,30,2,3:26
13197,564950,2019-05-11,2019,BAL,ANA,2,7,7-2,ANA,9,0,39,40,79,163,181,344,12,13,25,2,3:34
13198,566013,2019-05-25,2019,NYN,DET,5,4,5-4,NYN,13,0,48,57,105,242,164,406,11,22,33,1,4:11
13199,567080,2019-05-13,2019,PHI,MIL,7,4,7-4,PHI,9,1,38,46,84,199,148,347,13,22,35,4,3:57 (:52 delay)
13200,567083,2019-05-16,2019,PHI,MIL,3,11,11-3,MIL,9,0,34,50,84,203,129,332,6,23,29,1,3:18
13201,566193,2019-05-03,2019,PIT,OAK,1,14,14-1,OAK,9,0,38,50,88,203,152,355,9,23,32,1,3:26 (:41 delay)
13202,566589,2019-05-12,2019,SLN,PIT,6,10,10-6,PIT,9,0,43,46,89,163,166,329,16,23,39,2,3:29
13203,566105,2019-05-10,2019,OAK,CLE,4,3,4-3,OAK,12,0,48,46,94,165,189,354,17,12,29,1,3:41
13204,565430,2019-07-15,2019,COL,SFN,2,19,19-2,SFN,9,0,36,52,88,199,145,344,9,25,34,3,3:15
13205,566887,2019-05-22,2019,TOR,BOS,5,6,6-5,BOS,13,0,53,53,106,211,207,418,15,17,32,1,4:30
13206,565908,2019-04-28,2019,WAS,SDN,7,6,7-6,WAS,11,0,50,46,96,183,194,377,18,14,32,1,4:03
13207,565234,2019-05-03,2019,CIN,SFN,11,12,12-11,SFN,11,0,57,53,110,180,238,418,21,21,42,6,4:29
13208,566495,2019-05-23,2019,SFN,ATL,4,5,5-4,ATL,13,0,53,52,105,216,212,428,14,14,28,2,4:21
13209,566113,2019-05-29,2019,OAK,ANA,7,12,12-7,ANA,11,0,47,60,107,236,182,418,14,28,42,4,4:36
13210,565726,2019-05-16,2019,KCA,TEX,1,16,16-1,TEX,9,0,36,56,92,209,117,326,12,29,41,3,3:14
13211,564844,2019-04-28,2019,ARI,CHN,5,6,6-5,CHN,15,0,61,66,127,273,244,517,19,22,41,5,5:36
13212,565144,2019-05-11,2019,CHN,MIL,2,1,2-1,CHN,15,0,59,52,111,238,229,467,23,13,36,5,4:56
13213,566780,2019-05-03,2019,TEX,TOR,0,1,1-0,TOR,12,0,43,49,92,202,184,386,11,16,27,1,4:00
13214,565431,2019-05-09,2019,COL,SFN,12,11,12-11,COL,9,1,48,44,92,191,195,386,25,16,41,3,3:56
13215,566291,2019-05-04,2019,SDN,LAN,6,7,7-6,LAN,9,0,42,44,86,197,190,387,16,17,33,4,4:12
13216,567078,2019-05-04,2019,PHI,WAS,8,10,10-8,WAS,9,0,45,43,88,162,184,346,17,17,34,3,3:45
13217,566778,2019-04-30,2019,TEX,PIT,4,6,6-4,PIT,11,0,46,50,96,191,220,411,14,17,31,3,4:14
13218,564948,2019-05-08,2019,BAL,BOS,1,2,2-1,BOS,12,0,43,48,91,211,167,378,7,13,20,0,4:01
13219,566195,2019-05-05,2019,PIT,OAK,5,3,5-3,PIT,13,0,47,53,100,213,177,390,11,17,28,1,3:58
13220,566103,2019-05-08,2019,OAK,CIN,5,4,5-4,OAK,13,0,51,53,104,201,212,413,18,16,34,2,3:58
13221,567571,2019-05-04,2019,MIL,NYN,4,3,4-3,MIL,18,0,69,64,133,253,247,500,19,12,31,4,5:22
13222,565823,2019-05-15,2019,LAN,SDN,2,0,2-0,LAN,9,1,37,33,70,131,124,255,12,5,17,3,3:06
13223,565820,2019-05-11,2019,LAN,WAS,2,5,5-2,WAS,9,0,35,36,71,142,139,281,9,9,18,2,2:58
13224,565433,2019-05-11,2019,COL,SDN,3,4,4-3,SDN,9,0,34,38,72,145,122,267,7,12,19,3,3:05
13225,565045,2019-05-12,2019,BOS,SEA,11,2,11-2,BOS,9,1,42,33,75,133,189,322,20,6,26,1,3:23
13226,565046,2019-05-14,2019,BOS,COL,4,5,5-4,COL,11,0,46,41,87,180,180,360,13,8,21,1,3:42
13227,565239,2019-05-15,2019,CIN,CHN,6,5,6-5,CIN,10,0,41,40,81,160,167,327,15,10,25,4,3:27
13228,567294,2019-06-02,2019,CHA,CLE,2,0,2-0,CHA,9,1,30,31,61,118,121,239,8,6,14,2,2:30
13229,565345,2019-06-04,2019,CLE,MIN,5,2,5-2,CLE,9,1,32,33,65,125,102,227,9,7,16,2,2:25
13230,566993,2019-06-14,2019,MIN,KCA,2,0,2-0,MIN,9,1,31,28,59,98,117,215,9,2,11,0,2:21
13231,567095,2019-06-12,2019,PHI,ARI,0,2,2-0,ARI,9,0,30,32,62,92,107,199,3,8,11,1,2:16
13232,567310,2019-07-23,2019,CHA,MIA,1,5,5-1,MIA,9,0,31,33,64,113,119,232,4,6,10,0,2:27
13233,565443,2019-06-01,2019,COL,TOR,4,2,4-2,COL,9,1,31,35,66,124,107,231,8,7,15,2,2:28
13234,565925,2019-06-13,2019,WAS,ARI,0,5,5-0,ARI,9,0,29,35,64,115,98,213,4,10,14,1,2:15 (1:03 delay)
13235,565153,2019-06-04,2019,CHN,COL,6,3,6-3,CHN,9,1,33,34,67,138,123,261,10,7,17,0,2:34
13236,565734,2019-06-08,2019,KCA,CHA,0,2,2-0,CHA,9,0,32,32,64,112,132,244,5,6,11,1,2:26
13237,566020,2019-06-09,2019,NYN,COL,6,1,6-1,NYN,9,1,33,31,64,131,101,232,11,5,16,1,2:32
13238,565262,2019-07-04,2019,CIN,MIL,1,0,1-0,CIN,9,1,31,32,63,122,111,233,9,5,14,2,2:19 (1:09 delay)
13239,565642,2019-06-15,2019,HOU,TOR,7,2,7-2,HOU,9,1,36,34,70,116,123,239,15,8,23,0,2:26
13240,566115,2019-06-01,2019,OAK,HOU,1,5,5-1,HOU,9,0,34,36,70,127,133,260,7,10,17,1,2:37
13241,567090,2019-06-07,2019,PHI,CIN,4,2,4-2,PHI,9,1,32,39,71,142,117,259,8,13,21,2,2:48
13242,566209,2019-06-05,2019,PIT,ATL,7,4,7-4,PIT,9,1,38,34,72,117,132,249,15,8,23,1,2:48 (2:04 delay)
13243,566996,2019-06-17,2019,MIN,BOS,0,2,2-0,BOS,9,0,34,33,67,125,125,250,7,7,14,0,2:43
13244,566795,2019-06-06,2019,TEX,BAL,4,3,4-3,TEX,9,1,32,36,68,138,115,253,10,11,21,1,2:29 (:13 delay)
13245,567311,2019-07-24,2019,CHA,MIA,0,2,2-0,MIA,9,0,35,33,68,109,134,243,8,7,15,0,2:38
13246,567309,2019-07-22,2019,CHA,MIA,9,1,9-1,CHA,9,1,35,31,66,112,145,257,11,5,16,0,2:29
13247,565267,2019-07-20,2019,CIN,SLN,3,2,3-2,CIN,9,1,32,33,65,126,119,245,12,8,20,1,2:36
13248,566499,2019-06-07,2019,SFN,LAN,2,1,2-1,SFN,9,1,32,34,66,146,110,256,10,8,18,0,2:31
13249,565349,2019-06-08,2019,CLE,NYA,8,4,8-4,CLE,9,1,36,35,71,135,121,256,14,7,21,1,2:39
13250,565454,2019-06-29,2019,COL,LAN,5,3,5-3,COL,9,1,32,38,70,139,107,246,8,11,19,1,2:43
13251,566016,2019-06-05,2019,NYN,SFN,7,0,7-0,NYN,9,1,37,31,68,117,154,271,13,6,19,0,2:41
13252,565156,2019-06-07,2019,CHN,SLN,3,1,3-1,CHN,9,1,32,31,63,120,149,269,12,5,17,0,2:39
13253,566797,2019-06-08,2019,TEX,OAK,3,1,3-1,TEX,9,1,32,32,64,109,135,244,8,5,13,1,2:45
13254,566895,2019-06-07,2019,TOR,ARI,2,8,8-2,ARI,9,0,33,39,72,152,126,278,7,13,20,1,2:50
13255,565829,2019-06-01,2019,LAN,PHI,4,3,4-3,LAN,9,0,35,35,70,126,143,269,13,8,21,1,2:48
13256,566503,2019-06-12,2019,SFN,SDN,4,2,4-2,SFN,9,1,34,36,70,135,125,260,10,10,20,1,2:52
13257,565637,2019-06-08,2019,HOU,BAL,1,4,4-1,BAL,9,0,32,37,69,116,120,236,6,10,16,1,2:27
13258,566501,2019-06-09,2019,SFN,LAN,0,1,1-0,LAN,9,0,34,32,66,124,129,253,7,8,15,0,2:31
13259,567505,2019-07-14,2019,NYA,TOR,4,2,4-2,NYA,9,1,34,36,70,121,136,257,12,7,19,2,2:50
13260,566892,2019-06-04,2019,TOR,NYA,4,3,4-3,TOR,9,1,34,41,75,167,129,296,11,15,26,4,3:00
13261,567391,2019-06-10,2019,MIA,SLN,1,4,4-1,SLN,9,0,33,35,68,151,117,268,9,8,17,1,2:49
13262,565347,2019-06-06,2019,CLE,MIN,4,5,5-4,MIN,9,0,35,39,74,138,155,293,6,11,17,3,3:02
13263,566792,2019-06-02,2019,TEX,KCA,5,1,5-1,TEX,9,1,36,38,74,133,134,267,13,12,25,2,2:38
13264,566311,2019-06-08,2019,SDN,WAS,1,4,4-1,WAS,9,0,36,36,72,128,136,264,10,10,20,1,2:39
13265,566322,2019-07-12,2019,SDN,ATL,3,5,5-3,ATL,9,0,39,35,74,123,146,269,15,11,26,1,3:03
13266,566717,2019-07-24,2019,TBA,BOS,3,2,3-2,TBA,9,1,33,32,65,122,143,265,11,5,16,3,3:11
13267,566019,2019-06-08,2019,NYN,COL,5,3,5-3,NYN,9,1,36,38,74,156,125,281,14,11,25,2,2:59
13268,566802,2019-06-20,2019,TEX,CLE,4,2,4-2,TEX,9,1,32,34,66,133,137,270,9,8,17,1,2:35
13269,566018,2019-06-07,2019,NYN,COL,1,5,5-1,COL,9,0,34,39,73,163,134,297,8,12,20,1,3:03
13270,566207,2019-06-02,2019,PIT,MIL,2,4,4-2,MIL,9,0,37,37,74,147,120,267,9,10,19,2,2:41
13271,565075,2019-07-18,2019,BOS,TOR,5,0,5-0,BOS,9,1,36,31,67,136,145,281,12,5,17,2,2:50
13272,565177,2019-07-21,2019,CHN,SDN,1,5,5-1,SDN,9,0,32,38,70,150,124,274,6,12,18,2,2:49 (:32 delay)
13273,567509,2019-07-18,2019,NYA,TBA,6,2,6-2,NYA,9,1,37,33,70,131,147,278,12,8,20,0,2:56 (1:26 delay)
13274,564972,2019-06-30,2019,BAL,CLE,0,2,2-0,CLE,9,0,32,39,71,137,140,277,6,12,18,3,2:51
13275,566700,2019-06-15,2019,TBA,ANA,3,5,5-3,ANA,9,0,34,37,71,145,129,274,7,9,16,1,2:40
13276,565364,2019-07-17,2019,CLE,DET,7,2,7-2,CLE,9,1,36,36,72,140,133,273,14,9,23,4,2:59
13277,567407,2019-07-17,2019,MIA,SDN,2,3,3-2,SDN,9,0,33,38,71,142,130,272,4,14,18,1,2:46
13278,566597,2019-06-02,2019,SLN,CHN,2,1,2-1,SLN,9,1,28,35,63,152,103,255,6,11,17,2,2:38
13279,565844,2019-07-04,2019,LAN,SDN,5,1,5-1,LAN,9,1,34,34,68,141,131,272,10,8,18,1,3:02
13280,565658,2019-07-24,2019,HOU,OAK,4,2,4-2,HOU,9,1,31,35,66,133,114,247,7,8,15,0,2:42
13281,567595,2019-06-29,2019,MIL,PIT,3,1,3-1,MIL,9,1,33,32,65,128,137,265,9,7,16,1,2:52
13282,566609,2019-06-26,2019,SLN,OAK,0,2,2-0,OAK,9,0,33,37,70,142,141,283,6,10,16,1,2:46 (:26 delay)
13283,566017,2019-06-06,2019,NYN,SFN,7,3,7-3,NYN,9,1,39,32,71,131,124,255,18,5,23,2,2:43
13284,567583,2019-06-06,2019,MIL,MIA,5,1,5-1,MIL,9,1,34,35,69,141,128,269,11,8,19,1,2:47
13285,566310,2019-06-07,2019,SDN,WAS,5,4,5-4,SDN,9,0,34,36,70,141,135,276,9,11,20,2,2:46
13286,565154,2019-06-05,2019,CHN,COL,9,8,9-8,CHN,9,1,36,42,78,174,110,284,14,15,29,5,3:22
13287,566309,2019-06-06,2019,SDN,WAS,5,4,5-4,SDN,9,1,35,35,70,141,143,284,13,7,20,2,3:07
13288,565730,2019-06-04,2019,KCA,BOS,3,8,8-3,BOS,9,0,34,41,75,149,138,287,8,14,22,2,3:08
13289,567396,2019-06-16,2019,MIA,PIT,4,5,5-4,PIT,9,0,38,40,78,129,148,277,13,14,27,1,3:09
13290,565037,2019-06-08,2019,BOS,TBA,5,1,5-1,BOS,9,1,36,36,72,159,146,305,13,8,21,2,3:21
13291,565545,2019-06-15,2019,DET,CLE,2,4,4-2,CLE,9,0,33,42,75,153,127,280,7,14,21,1,2:43
13292,565651,2019-07-06,2019,HOU,ANA,4,0,4-0,HOU,9,1,36,34,70,149,134,283,14,8,22,0,2:44
13293,564763,2019-06-04,2019,ANA,OAK,2,4,4-2,OAK,9,0,34,38,72,151,142,293,8,11,19,0,3:04
13294,565249,2019-06-02,2019,CIN,WAS,1,4,4-1,WAS,9,0,32,40,72,166,133,299,5,15,20,2,3:07
13295,566312,2019-06-09,2019,SDN,WAS,2,5,5-2,WAS,9,0,33,36,69,117,149,266,7,10,17,3,2:56
13296,566894,2019-06-06,2019,TOR,NYA,2,6,6-2,NYA,9,0,34,40,74,163,133,296,8,12,20,2,3:07
13297,565731,2019-06-05,2019,KCA,BOS,0,8,8-0,BOS,9,0,29,43,72,169,102,271,3,16,19,1,2:39
13298,567414,2019-07-31,2019,MIA,MIN,4,7,7-4,MIN,9,0,33,39,72,154,116,270,6,14,20,2,2:41
13299,567313,2019-07-26,2019,CHA,MIN,2,6,6-2,MIN,9,0,35,40,75,143,125,268,9,13,22,0,2:50
13300,566810,2019-07-11,2019,TEX,HOU,5,0,5-0,TEX,9,1,38,35,73,139,134,273,15,9,24,1,3:02
13301,565848,2019-07-19,2019,LAN,MIA,2,1,2-1,LAN,9,1,35,35,70,129,146,275,10,8,18,1,3:00
13302,567393,2019-06-12,2019,MIA,SLN,9,0,9-0,MIA,9,1,38,30,68,118,137,255,14,6,20,1,2:34
13303,565737,2019-06-12,2019,KCA,DET,2,3,3-2,DET,9,0,40,36,76,143,142,285,13,9,22,0,2:46 (:24 delay)
13304,565539,2019-06-05,2019,DET,TBA,0,4,4-0,TBA,9,0,32,43,75,170,110,280,5,17,22,0,2:44
13305,566416,2019-07-04,2019,SEA,SLN,4,5,5-4,SLN,9,0,36,37,73,126,123,249,13,14,27,4,2:45
13306,566307,2019-06-04,2019,SDN,PHI,6,9,9-6,PHI,9,0,39,41,80,162,156,318,12,14,26,3,3:03
13307,566915,2019-07-26,2019,TOR,TBA,1,3,3-1,TBA,9,0,33,37,70,144,112,256,7,12,19,4,2:56
13308,566405,2019-06-05,2019,SEA,HOU,14,1,14-1,SEA,9,1,43,35,78,119,182,301,20,8,28,2,2:49
13309,565346,2019-06-05,2019,CLE,MIN,9,7,9-7,CLE,9,1,40,37,77,136,160,296,15,11,26,4,3:26 (1:43 delay)
13310,565363,2019-07-16,2019,CLE,DET,8,0,8-0,CLE,9,1,35,28,63,110,121,231,11,2,13,0,2:23 (2:07 delay)
13311,565735,2019-06-09,2019,KCA,CHA,2,5,5-2,CHA,9,0,35,42,77,140,145,285,9,15,24,1,3:02
13312,566518,2019-07-19,2019,SFN,NYN,1,0,1-0,SFN,10,0,39,35,74,113,165,278,10,5,15,0,2:51
13313,566896,2019-06-08,2019,TOR,ARI,0,6,6-0,ARI,9,0,34,40,74,138,146,284,8,14,22,3,3:09
13314,567582,2019-06-05,2019,MIL,MIA,3,8,8-3,MIA,9,0,34,43,77,177,137,314,10,16,26,0,3:04
13315,566694,2019-06-02,2019,TBA,MIN,7,9,9-7,MIN,9,0,39,39,78,112,181,293,13,16,29,2,3:24
13316,566600,2019-06-06,2019,SLN,CIN,3,1,3-1,SLN,9,1,34,36,70,122,143,265,11,10,21,3,2:58
13317,565054,2019-06-07,2019,BOS,TBA,1,5,5-1,TBA,9,0,33,37,70,150,115,265,6,11,17,0,2:43
13318,567586,2019-06-09,2019,MIL,PIT,5,2,5-2,MIL,9,1,37,35,72,154,121,275,14,8,22,2,2:52
13319,566125,2019-06-22,2019,OAK,TBA,4,2,4-2,OAK,9,1,36,38,74,139,120,259,16,12,28,1,3:02
13320,566021,2019-06-13,2019,NYN,SLN,4,5,5-4,SLN,10,0,37,39,76,172,149,321,8,12,20,1,3:02 (:59 delay)
13321,565355,2019-06-23,2019,CLE,DET,8,3,8-3,CLE,9,1,36,35,71,137,132,269,12,10,22,1,2:33
13322,566304,2019-06-01,2019,SDN,MIA,3,9,9-3,MIA,9,0,33,42,75,167,128,295,7,15,22,1,2:43
13323,565831,2019-06-13,2019,LAN,CHN,7,3,7-3,LAN,9,1,36,36,72,134,148,282,14,11,25,0,2:48
13324,566035,2019-07-25,2019,NYN,SDN,4,0,4-0,NYN,9,1,42,34,76,140,134,274,21,7,28,2,2:49
13325,566791,2019-06-01,2019,TEX,KCA,6,2,6-2,TEX,9,1,40,36,76,142,160,302,15,9,24,2,3:08
13326,565733,2019-06-07,2019,KCA,CHA,6,4,6-4,KCA,9,1,36,38,74,156,127,283,12,12,24,3,3:22
13327,566990,2019-06-11,2019,MIN,SEA,6,5,6-5,MIN,9,1,34,41,75,177,118,295,11,14,25,1,3:02
13328,565655,2019-07-21,2019,HOU,TEX,5,3,5-3,HOU,9,1,34,36,70,161,138,299,11,9,20,2,3:08
13329,565944,2019-07-24,2019,WAS,COL,2,0,2-0,WAS,9,1,32,34,66,153,137,290,8,8,16,2,3:07 (1:41 delay)
13330,565129,2019-06-03,2019,CHN,ANA,8,1,8-1,CHN,9,1,38,33,71,133,144,277,14,8,22,2,3:00
13331,565348,2019-06-07,2019,CLE,NYA,5,2,5-2,CLE,9,1,32,32,64,135,117,252,10,7,17,0,2:23
13332,566306,2019-06-03,2019,SDN,PHI,8,2,8-2,SDN,9,1,40,34,74,130,141,271,17,10,27,1,2:54
13333,564767,2019-06-08,2019,ANA,SEA,12,3,12-3,ANA,9,1,46,35,81,133,154,287,23,9,32,2,3:08
13334,567503,2019-07-12,2019,NYA,TOR,4,0,4-0,NYA,9,1,36,32,68,117,142,259,13,6,19,0,2:41
13335,566139,2019-07-30,2019,OAK,MIL,3,2,3-2,OAK,10,0,39,38,77,141,141,282,11,9,20,3,3:16
13336,565263,2019-07-06,2019,CIN,CLE,2,7,7-2,CLE,9,0,32,43,75,156,120,276,5,18,23,0,2:50
13337,567389,2019-06-08,2019,MIA,ATL,0,1,1-0,ATL,9,0,34,33,67,113,144,257,7,8,15,2,2:57
13338,564862,2019-06-05,2019,ARI,LAN,3,2,3-2,ARI,11,0,40,42,82,154,154,308,11,10,21,0,3:27
13339,567489,2019-06-01,2019,NYA,BOS,5,3,5-3,NYA,9,1,37,40,77,166,151,317,13,15,28,3,3:18
13340,565352,2019-06-12,2019,CLE,CIN,2,7,7-2,CIN,9,0,36,40,76,155,151,306,9,13,22,5,3:07
13341,567092,2019-06-09,2019,PHI,CIN,3,4,4-3,CIN,9,0,34,39,73,149,137,286,8,14,22,5,3:14
13342,565161,2019-06-20,2019,CHN,NYN,7,4,7-4,CHN,9,1,36,36,72,140,152,292,13,11,24,2,2:59
13343,564790,2019-07-31,2019,ANA,DET,1,9,9-1,DET,9,0,36,41,77,157,148,305,11,15,26,1,2:56
13344,567112,2019-07-28,2019,PHI,ATL,9,4,9-4,PHI,9,1,39,37,76,133,157,290,16,11,27,2,3:13
13345,566519,2019-07-20,2019,SFN,NYN,4,11,11-4,NYN,9,0,35,44,79,164,114,278,10,19,29,0,2:50
13346,565356,2019-06-24,2019,CLE,KCA,3,2,3-2,CLE,10,0,40,37,77,130,153,283,14,9,23,2,3:05 (2:23 delay)
13347,567315,2019-07-28,2019,CHA,MIN,1,11,11-1,MIN,9,0,34,43,77,162,124,286,8,15,23,4,3:14
13348,564771,2019-06-25,2019,ANA,CIN,5,1,5-1,ANA,9,1,35,34,69,148,145,293,11,11,22,1,2:56
13349,567412,2019-07-29,2019,MIA,ARI,11,6,11-6,MIA,9,1,38,39,77,151,135,286,14,13,27,2,2:59
13350,564788,2019-07-29,2019,ANA,DET,2,7,7-2,DET,9,0,35,38,73,155,128,283,9,11,20,1,2:53
13351,567608,2019-07-28,2019,MIL,CHN,4,11,11-4,CHN,9,0,35,39,74,141,132,273,7,12,19,2,2:56
13352,567411,2019-07-28,2019,MIA,ARI,5,1,5-1,MIA,9,1,33,35,68,145,142,287,10,10,20,1,3:11
13353,565754,2019-07-26,2019,KCA,CLE,3,8,8-3,CLE,9,0,38,43,81,151,134,285,12,19,31,1,2:56
13354,566403,2019-06-03,2019,SEA,HOU,2,4,4-2,HOU,9,0,39,34,73,118,167,285,12,8,20,0,2:49
13355,565749,2019-07-15,2019,KCA,CHA,5,2,5-2,KCA,9,1,37,39,76,158,132,290,13,13,26,1,3:04
13356,567409,2019-07-26,2019,MIA,ARI,3,2,3-2,MIA,9,0,34,35,69,148,144,292,9,10,19,1,3:10
13357,565538,2019-06-04,2019,DET,TBA,9,6,9-6,DET,9,1,40,37,77,137,156,293,16,12,28,2,3:03
13358,566521,2019-07-22,2019,SFN,CHN,5,4,5-4,SFN,9,1,36,37,73,141,141,282,14,11,25,2,2:50
13359,565638,2019-06-09,2019,HOU,BAL,4,0,4-0,HOU,9,1,33,34,67,148,131,279,9,10,19,3,2:46
13360,566219,2019-07-04,2019,PIT,CHN,3,11,11-3,CHN,9,0,34,44,78,158,124,282,7,18,25,1,3:04
13361,564860,2019-06-03,2019,ARI,LAN,1,3,3-1,LAN,9,0,30,34,64,130,114,244,3,8,11,1,2:26
13362,564961,2019-06-02,2019,BAL,SFN,1,8,8-1,SFN,9,0,34,43,77,156,168,324,6,16,22,0,3:01
13363,566401,2019-06-01,2019,SEA,ANA,3,6,6-3,ANA,9,0,34,42,76,175,130,305,7,17,24,2,3:16
13364,565540,2019-06-06,2019,DET,TBA,1,6,6-1,TBA,9,0,35,41,76,156,145,301,10,16,26,5,3:08
13365,565942,2019-07-24,2019,WAS,COL,3,2,3-2,WAS,9,1,38,39,77,148,149,297,15,12,27,0,3:03
13366,567587,2019-06-20,2019,MIL,CIN,1,7,7-1,CIN,9,0,34,43,77,165,141,306,9,18,27,0,2:58
13367,566904,2019-06-30,2019,TOR,KCA,6,7,7-6,KCA,9,0,38,41,79,153,142,295,11,16,27,2,3:09
13368,567201,2019-06-13,2019,ATL,PIT,6,5,6-5,ATL,9,1,39,40,79,148,137,285,15,15,30,2,3:30
13369,565557,2019-07-20,2019,DET,TOR,5,7,7-5,TOR,9,0,36,39,75,148,136,284,8,14,22,1,2:45 (:59 delay)
13370,566326,2019-07-27,2019,SDN,SFN,5,1,5-1,SDN,9,1,35,37,72,144,152,296,15,10,25,3,3:11
13371,565947,2019-07-27,2019,WAS,LAN,3,9,9-3,LAN,9,0,35,41,76,151,151,302,10,15,25,2,3:06
13372,564778,2019-07-13,2019,ANA,SEA,9,2,9-2,ANA,9,1,37,35,72,159,144,303,15,10,25,2,3:07
13373,566210,2019-06-06,2019,PIT,ATL,6,1,6-1,PIT,9,1,33,38,71,137,141,278,10,11,21,3,2:58
13374,567296,2019-06-11,2019,CHA,WAS,7,5,7-5,CHA,9,1,33,43,76,171,125,296,9,16,25,3,3:19
13375,566118,2019-06-15,2019,OAK,SEA,11,2,11-2,OAK,9,1,42,35,77,125,164,289,19,8,27,3,2:58
13376,565830,2019-06-02,2019,LAN,PHI,8,0,8-0,LAN,9,1,38,33,71,127,151,278,14,8,22,2,2:58
13377,565948,2019-07-28,2019,WAS,LAN,11,4,11-4,WAS,9,1,42,35,77,137,150,287,19,9,28,1,3:09
13378,565251,2019-06-15,2019,CIN,TEX,3,4,4-3,TEX,9,0,34,37,71,144,126,270,8,9,17,1,2:39
13379,566426,2019-07-25,2019,SEA,DET,10,2,10-2,SEA,9,1,41,35,76,138,165,303,17,7,24,0,2:47
13380,565841,2019-06-23,2019,LAN,COL,6,3,6-3,LAN,9,0,37,39,76,119,140,259,11,12,23,2,3:10
13381,565170,2019-07-13,2019,CHN,PIT,10,4,10-4,CHN,9,1,42,37,79,129,158,287,19,11,30,3,3:12
13382,566424,2019-07-23,2019,SEA,TEX,2,7,7-2,TEX,9,0,35,37,72,130,140,270,8,10,18,0,2:39
13383,567392,2019-06-11,2019,MIA,SLN,1,7,7-1,SLN,9,0,35,45,80,187,119,306,8,19,27,2,3:12
13384,565639,2019-06-11,2019,HOU,MIL,10,8,10-8,HOU,9,1,40,42,82,148,156,304,16,16,32,3,2:58
13385,564879,2019-07-22,2019,ARI,BAL,6,3,6-3,ARI,9,1,40,37,77,136,142,278,16,10,26,2,2:55
13386,565926,2019-06-14,2019,WAS,ARI,7,3,7-3,WAS,9,1,35,38,73,150,135,285,10,10,20,2,2:57
13387,566140,2019-07-31,2019,OAK,MIL,2,4,4-2,MIL,9,0,37,38,75,141,160,301,10,12,22,1,2:56
13388,566701,2019-06-16,2019,TBA,ANA,6,5,6-5,TBA,9,1,34,41,75,157,136,293,11,15,26,3,3:07
13389,566596,2019-06-01,2019,SLN,CHN,7,4,7-4,SLN,9,1,36,36,72,155,143,298,13,9,22,2,3:04 (3:37 delay)
13390,566135,2019-07-25,2019,OAK,TEX,3,11,11-3,TEX,9,0,34,43,77,149,141,290,8,17,25,2,2:45
13391,567299,2019-06-15,2019,CHA,NYA,4,8,8-4,NYA,9,0,36,42,78,168,148,316,10,18,28,3,3:27 (:32 delay)
13392,566805,2019-06-23,2019,TEX,CHA,7,4,7-4,TEX,9,1,35,38,73,149,134,283,12,13,25,3,3:07
13393,567298,2019-06-14,2019,CHA,NYA,10,2,10-2,CHA,9,1,41,37,78,153,134,287,19,12,31,4,3:02
13394,566429,2019-07-28,2019,SEA,DET,3,2,3-2,SEA,10,0,38,37,75,125,167,292,10,8,18,2,2:58
13395,564873,2019-07-06,2019,ARI,COL,4,2,4-2,ARI,9,1,38,36,74,137,148,285,17,11,28,1,3:11
13396,565169,2019-07-12,2019,CHN,PIT,4,3,4-3,CHN,9,1,34,34,68,147,143,290,11,7,18,3,3:25
13397,564769,2019-06-10,2019,ANA,LAN,5,3,5-3,ANA,9,1,37,37,74,135,154,289,14,11,25,1,3:19
13398,567011,2019-07-22,2019,MIN,NYA,8,6,8-6,MIN,9,1,36,41,77,149,145,294,11,18,29,2,3:08
13399,565942,2019-07-24,2019,WAS,COL,3,2,3-2,WAS,9,1,38,39,77,148,149,297,15,12,27,0,3:03
13400,565370,2019-07-31,2019,CLE,HOU,10,4,10-4,CLE,9,1,39,39,78,144,154,298,14,13,27,3,3:10
13401,567606,2019-07-26,2019,MIL,CHN,3,2,3-2,MIL,9,1,37,31,68,126,163,289,13,5,18,5,3:09
13402,567091,2019-06-08,2019,PHI,CIN,4,1,4-1,PHI,9,1,33,31,64,105,136,241,11,6,17,0,2:17
13403,565732,2019-06-06,2019,KCA,BOS,5,7,7-5,BOS,9,0,42,41,83,153,157,310,15,17,32,5,3:26
13404,567584,2019-06-07,2019,MIL,PIT,10,4,10-4,MIL,9,1,44,34,78,144,183,327,20,9,29,1,3:33
13405,565541,2019-06-07,2019,DET,MIN,3,6,6-3,MIN,9,0,40,42,82,157,147,304,14,17,31,1,3:24
13406,565923,2019-06-04,2019,WAS,CHA,9,5,9-5,WAS,9,1,39,39,78,167,154,321,16,12,28,3,3:33
13407,564766,2019-06-07,2019,ANA,SEA,2,6,6-2,SEA,9,0,36,41,77,167,160,327,9,14,23,2,3:21
13408,567212,2019-07-06,2019,ATL,MIA,4,5,5-4,MIA,9,0,35,43,78,156,150,306,10,16,26,0,3:19
13409,564978,2019-07-19,2019,BAL,BOS,11,2,11-2,BAL,9,1,43,36,79,138,159,297,18,9,27,1,3:07
13410,564765,2019-06-06,2019,ANA,OAK,4,7,7-4,OAK,9,0,38,43,81,184,144,328,11,15,26,2,3:26
13411,566024,2019-06-16,2019,NYN,SLN,3,4,4-3,SLN,9,0,36,35,71,162,146,308,13,7,20,0,3:09
13412,567094,2019-06-11,2019,PHI,ARI,7,4,7-4,PHI,9,1,39,40,79,155,148,303,16,13,29,1,3:16
13413,565272,2019-07-29,2019,CIN,PIT,11,6,11-6,CIN,9,1,42,37,79,144,150,294,17,12,29,4,3:13
13414,565748,2019-07-14,2019,KCA,DET,8,12,12-8,DET,9,0,38,48,86,172,119,291,12,22,34,3,3:05
13415,564871,2019-06-26,2019,ARI,LAN,8,2,8-2,ARI,9,1,37,35,72,157,140,297,10,9,19,1,3:01
13416,567490,2019-06-02,2019,NYA,BOS,5,8,8-5,BOS,9,0,37,39,76,153,157,310,11,14,25,2,3:30
13417,566796,2019-06-07,2019,TEX,OAK,3,5,5-3,OAK,9,0,39,38,77,160,137,297,13,11,24,1,3:09
13418,567504,2019-07-13,2019,NYA,TOR,1,2,2-1,TOR,9,0,39,37,76,148,158,306,13,10,23,5,3:32
13419,565444,2019-06-02,2019,COL,TOR,5,1,5-1,COL,9,1,36,37,73,146,118,264,14,10,24,1,2:43
13420,567199,2019-06-11,2019,ATL,PIT,7,5,7-5,ATL,9,1,36,36,72,140,148,288,13,14,27,2,3:15 (1:48 delay)
13421,566119,2019-06-16,2019,OAK,SEA,3,6,6-3,SEA,9,0,36,38,74,157,135,292,9,11,20,2,2:56
13422,567508,2019-07-18,2019,NYA,TBA,5,1,5-1,NYA,9,1,34,38,72,166,122,288,12,11,23,3,2:46
13423,567513,2019-07-30,2019,NYA,ARI,2,4,4-2,ARI,9,0,36,38,74,144,154,298,9,12,21,4,3:10
13424,565636,2019-06-07,2019,HOU,BAL,4,3,4-3,HOU,11,0,42,40,82,169,165,334,11,6,17,1,3:13
13425,565351,2019-06-11,2019,CLE,CIN,2,1,2-1,CLE,10,0,38,40,78,151,161,312,11,13,24,2,3:15
13426,565164,2019-06-23,2019,CHN,NYN,5,3,5-3,CHN,9,1,35,34,69,121,161,282,14,10,24,1,2:49
13427,565850,2019-07-21,2019,LAN,MIA,9,0,9-0,LAN,9,1,37,33,70,125,167,292,12,6,18,0,2:41
13428,566505,2019-06-15,2019,SFN,MIL,8,7,8-7,SFN,9,1,42,40,82,159,150,309,19,12,31,2,3:06
13429,566599,2019-08-31,2019,SLN,CIN,10,6,10-6,SLN,9,1,39,38,77,139,161,300,16,11,27,3,3:10
13430,565755,2019-07-27,2019,KCA,CLE,1,9,9-1,CLE,9,0,34,42,76,168,151,319,9,16,25,0,3:04
13431,566305,2019-06-02,2019,SDN,MIA,3,9,9-3,MIA,9,0,33,41,74,168,154,322,6,15,21,1,3:04 (:28 delay)
13432,567192,2019-06-02,2019,ATL,DET,7,4,7-4,ATL,9,1,35,40,75,161,150,311,9,13,22,3,3:18
13433,567405,2019-07-14,2019,MIA,NYN,2,6,6-2,NYN,9,0,41,43,84,145,164,309,16,16,32,1,3:16
13434,567114,2019-07-31,2019,PHI,SFN,1,5,5-1,SFN,9,0,33,39,72,165,130,295,7,13,20,2,3:02
13435,566423,2019-07-22,2019,SEA,TEX,7,3,7-3,SEA,9,1,37,38,75,138,129,267,14,11,25,3,2:50
13436,564962,2019-06-11,2019,BAL,TOR,4,2,4-2,BAL,9,1,37,35,72,169,148,317,15,9,24,2,2:55
13437,567581,2019-06-04,2019,MIL,MIA,0,16,16-0,MIA,9,0,36,50,86,184,150,334,9,23,32,1,3:12
13438,564768,2019-06-09,2019,ANA,SEA,3,9,9-3,SEA,9,0,36,43,79,187,145,332,10,17,27,3,3:17
13439,566798,2019-06-09,2019,TEX,OAK,8,9,9-8,OAK,9,0,44,41,85,152,156,308,17,15,32,1,3:25 (1:05 delay)
13440,567398,2019-06-26,2019,MIA,WAS,5,7,7-5,WAS,9,0,36,42,78,176,147,323,9,15,24,4,3:19
13441,564969,2019-06-26,2019,BAL,SDN,5,10,10-5,SDN,9,0,39,42,81,167,159,326,11,16,27,2,3:18
13442,566598,2019-06-04,2019,SLN,CIN,1,4,4-1,CIN,9,0,36,40,76,150,156,306,10,12,22,2,2:56 (1:20 delay)
13443,566023,2019-06-15,2019,NYN,SLN,8,7,8-7,NYN,9,1,41,42,83,157,140,297,16,17,33,3,3:33
13444,565447,2019-06-12,2019,COL,CHN,1,10,10-1,CHN,9,0,37,45,82,163,126,289,10,20,30,1,2:57
13445,566317,2019-06-29,2019,SDN,SLN,12,2,12-2,SDN,9,1,41,36,77,154,167,321,17,7,24,2,3:05
13446,566616,2019-07-26,2019,SLN,HOU,5,3,5-3,SLN,9,1,36,36,72,157,143,300,12,9,21,2,3:09
13447,565248,2019-06-01,2019,CIN,WAS,2,5,5-2,WAS,9,0,38,37,75,134,161,295,12,10,22,3,2:59
13448,566619,2019-07-30,2019,SLN,CHN,2,1,2-1,SLN,9,1,32,38,70,150,125,275,8,13,21,3,3:05
13449,565155,2019-06-06,2019,CHN,COL,1,3,3-1,COL,9,0,34,34,68,124,121,245,7,7,14,1,2:40
13450,565542,2019-06-08,2019,DET,MIN,9,3,9-3,DET,9,1,44,36,80,148,172,320,21,10,31,0,3:14
13451,565657,2019-07-23,2019,HOU,OAK,3,4,4-3,OAK,11,0,42,43,85,171,139,310,10,11,21,3,3:14
13452,565543,2019-06-09,2019,DET,MIN,2,12,12-2,MIN,9,0,36,49,85,178,147,325,12,22,34,1,3:20
13453,566422,2019-07-21,2019,SEA,ANA,3,9,9-3,ANA,9,0,42,39,81,131,186,317,17,13,30,1,3:15
13454,567218,2019-07-23,2019,ATL,KCA,4,5,5-4,KCA,9,0,43,37,80,166,163,329,16,11,27,3,3:30
13455,566770,2019-06-08,2019,TEX,OAK,10,5,10-5,TEX,9,1,43,38,81,138,188,326,18,13,31,0,3:12
13456,565078,2019-07-27,2019,BOS,NYA,9,5,9-5,BOS,9,1,39,40,79,186,136,322,16,14,30,3,3:34
13457,566308,2019-06-05,2019,SDN,PHI,5,7,7-5,PHI,9,0,42,40,82,158,164,322,16,13,29,4,3:30
13458,566223,2019-07-19,2019,PIT,PHI,1,6,6-1,PHI,9,0,35,46,81,192,134,326,10,20,30,3,3:36
13459,566034,2019-07-24,2019,NYN,SDN,2,7,7-2,SDN,9,0,36,43,79,145,169,314,10,21,31,2,3:20
13460,566117,2019-06-14,2019,OAK,SEA,2,9,9-2,SEA,9,0,38,44,82,160,151,311,12,16,28,1,3:00
13461,565464,2019-07-29,2019,COL,LAN,9,1,9-1,COL,9,1,41,33,74,124,145,269,16,7,23,1,2:51
13462,567507,2019-07-16,2019,NYA,TBA,8,3,8-3,NYA,9,1,34,36,70,132,129,261,13,10,23,4,2:50
13463,567491,2019-06-11,2019,NYA,NYN,12,5,12-5,NYA,9,1,43,38,81,140,167,307,18,9,27,2,3:09
13464,567193,2019-06-10,2019,ATL,PIT,13,7,13-7,ATL,9,1,43,41,84,168,166,334,19,13,32,4,3:35
13465,564858,2019-06-01,2019,ARI,NYN,6,5,6-5,ARI,11,0,45,42,87,163,159,322,16,11,27,3,3:42
13466,565852,2019-07-24,2019,LAN,ANA,2,3,3-2,ANA,9,0,35,35,70,135,153,288,10,9,19,2,3:15
13467,567300,2019-06-16,2019,CHA,NYA,3,10,10-3,NYA,9,0,38,45,83,173,153,326,12,19,31,1,3:06
13468,565463,2019-07-17,2019,COL,SFN,8,11,11-8,SFN,9,0,40,48,88,167,143,310,14,21,35,4,3:28
13469,565448,2019-06-13,2019,COL,SDN,9,6,9-6,COL,9,1,42,40,82,137,176,313,20,13,33,2,3:26
13470,566325,2019-07-26,2019,SDN,SFN,1,2,2-1,SFN,11,0,40,44,84,164,149,313,8,10,18,0,3:32
13471,564782,2019-07-17,2019,ANA,HOU,2,11,11-2,HOU,9,0,37,42,79,161,139,300,11,15,26,2,2:57
13472,566697,2019-06-12,2019,TBA,OAK,2,6,6-2,OAK,9,0,40,41,81,170,145,315,16,16,32,3,3:22
13473,565949,2019-07-29,2019,WAS,ATL,6,3,6-3,WAS,9,1,41,36,77,156,170,326,18,8,26,1,3:23
13474,567307,2019-07-06,2019,CHA,CHN,3,6,6-3,CHN,9,0,39,41,80,175,144,319,11,17,28,6,3:26
13475,565270,2019-07-27,2019,CIN,COL,3,1,3-1,CIN,9,1,31,34,65,124,124,248,10,9,19,3,2:41
13476,565162,2019-06-21,2019,CHN,NYN,4,5,5-4,NYN,9,0,35,37,72,137,150,287,8,12,20,2,3:11
13477,565560,2019-07-24,2019,DET,PHI,0,4,4-0,PHI,9,0,36,39,75,172,167,339,9,13,22,2,3:26
13478,565158,2019-06-09,2019,CHN,SLN,5,1,5-1,CHN,9,1,33,37,70,129,124,253,10,11,21,3,2:48
13479,566696,2019-06-11,2019,TBA,OAK,3,4,4-3,OAK,9,0,34,35,69,133,143,276,7,9,16,0,2:47
13480,564859,2019-06-02,2019,ARI,NYN,7,1,7-1,ARI,9,1,38,32,70,118,137,255,15,6,21,2,2:37
13481,566511,2019-06-29,2019,SFN,ARI,3,4,4-3,ARI,9,0,35,41,76,164,131,295,10,15,25,3,3:18
13482,565055,2019-06-08,2019,BOS,TBA,2,9,9-2,TBA,9,0,33,44,77,201,131,332,6,20,26,1,3:33
13483,566908,2019-07-04,2019,TOR,BOS,7,8,8-7,BOS,9,0,43,39,82,168,161,329,16,12,28,3,3:35
13484,565943,2019-07-23,2019,WAS,COL,11,1,11-1,WAS,9,1,43,37,80,157,165,322,20,11,31,2,3:37
13485,567009,2019-07-20,2019,MIN,OAK,4,5,5-4,OAK,9,0,37,44,81,170,149,319,14,18,32,5,3:30
13486,566618,2019-07-28,2019,SLN,HOU,2,6,6-2,HOU,9,0,40,44,84,171,159,330,12,18,30,1,3:24
13487,566897,2019-06-09,2019,TOR,ARI,2,8,8-2,ARI,9,0,35,44,79,194,135,329,8,17,25,2,3:04
13488,565843,2019-07-03,2019,LAN,ARI,5,4,5-4,LAN,10,0,40,40,80,143,153,296,13,10,23,2,3:19
13489,566031,2019-07-06,2019,NYN,PHI,6,5,6-5,NYN,9,1,38,42,80,154,129,283,16,16,32,4,3:22 (:46 delay)
13490,567191,2019-06-01,2019,ATL,DET,10,5,10-5,ATL,9,1,38,38,76,146,136,282,12,11,23,3,2:51
13491,566136,2019-07-26,2019,OAK,TEX,2,5,5-2,TEX,9,0,35,39,74,162,161,323,8,12,20,2,3:24
13492,564974,2019-07-13,2019,BAL,TBA,4,12,12-4,TBA,9,0,39,44,83,158,156,314,12,17,29,1,3:02
13493,564966,2019-06-15,2019,BAL,BOS,2,7,7-2,BOS,9,0,38,43,81,164,158,322,11,16,27,3,3:19
13494,565924,2019-06-05,2019,WAS,CHA,6,4,6-4,WAS,9,0,37,38,75,136,133,269,12,12,24,3,3:07
13495,566328,2019-07-29,2019,SDN,BAL,8,1,8-1,SDN,9,1,38,40,78,160,133,293,14,11,25,2,2:50
13496,567395,2019-06-15,2019,MIA,PIT,4,3,4-3,MIA,9,1,37,34,71,117,123,240,14,11,25,0,2:46
13497,566015,2019-06-04,2019,NYN,SFN,3,9,9-3,SFN,10,0,41,48,89,186,158,344,13,20,33,2,3:35
13498,566893,2019-06-05,2019,TOR,NYA,11,7,11-7,TOR,9,1,42,40,82,161,179,340,17,13,30,4,3:22
13499,564876,2019-07-19,2019,ARI,MIL,10,7,10-7,ARI,9,1,41,39,80,164,161,325,19,15,34,3,3:44
13500,565081,2019-07-31,2019,BOS,TBA,5,8,8-5,TBA,9,0,41,41,82,167,169,336,13,14,27,4,3:50
13501,565066,2019-06-26,2019,BOS,CHA,7,8,8-7,CHA,9,0,44,41,85,170,160,330,17,16,33,3,3:39
13502,564861,2019-06-04,2019,ARI,LAN,0,9,9-0,LAN,9,0,32,43,75,169,139,308,4,18,22,1,3:07
13503,566817,2019-07-31,2019,TEX,SEA,9,7,9-7,TEX,9,1,43,42,85,173,152,325,20,16,36,3,3:26
13504,567388,2019-06-07,2019,MIA,ATL,1,7,7-1,ATL,9,0,33,44,77,158,115,273,7,18,25,2,2:42
13505,565157,2019-06-08,2019,CHN,SLN,9,4,9-4,CHN,9,1,40,35,75,140,192,332,16,7,23,3,3:27
13506,566327,2019-07-28,2019,SDN,SFN,6,7,7-6,SFN,9,0,35,44,79,152,116,268,10,20,30,1,3:00
13507,565544,2019-06-14,2019,DET,CLE,4,13,13-4,CLE,9,0,37,50,87,194,165,359,10,22,32,1,3:08
13508,564878,2019-07-21,2019,ARI,MIL,4,7,7-4,MIL,9,0,40,39,79,169,165,334,15,13,28,1,3:39
13509,565851,2019-07-23,2019,LAN,ANA,4,5,5-4,ANA,9,0,42,42,84,160,181,341,16,15,31,3,3:54
13510,566225,2019-07-21,2019,PIT,PHI,1,2,2-1,PHI,11,0,43,42,85,172,176,348,13,10,23,0,3:41 (:25 delay)
13511,565465,2019-07-30,2019,COL,LAN,4,9,9-4,LAN,9,0,37,40,77,167,138,305,12,14,26,3,3:12
13512,567408,2019-07-18,2019,MIA,SDN,4,3,4-3,MIA,9,0,40,38,78,168,167,335,14,11,25,1,3:30
13513,567101,2019-06-26,2019,PHI,NYN,5,4,5-4,PHI,10,0,42,43,85,151,146,297,16,14,30,3,3:21
13514,567293,2019-06-01,2019,CHA,CLE,2,5,5-2,CLE,9,0,34,36,70,130,139,269,9,10,19,3,2:50
13515,566021,2019-06-13,2019,NYN,SLN,4,5,5-4,SLN,10,0,37,39,76,172,149,321,8,12,20,1,3:02 (:59 delay)
13516,566613,2019-07-15,2019,SLN,PIT,7,0,7-0,SLN,9,1,37,32,69,100,163,263,14,8,22,2,3:00
13517,567492,2019-06-11,2019,NYA,NYN,4,10,10-4,NYN,9,0,39,44,83,190,144,334,12,17,29,1,3:20
13518,566402,2019-06-02,2019,SEA,ANA,3,13,13-3,ANA,9,0,38,49,87,194,154,348,13,22,35,2,3:22
13519,566221,2019-07-06,2019,PIT,MIL,12,2,12-2,PIT,9,1,44,36,80,140,194,334,22,10,32,0,3:26 (2:30 delay)
13520,565466,2019-07-31,2019,COL,LAN,1,5,5-1,LAN,9,0,32,39,71,163,121,284,7,12,19,2,3:05
13521,566695,2019-06-10,2019,TBA,OAK,6,2,6-2,TBA,9,1,35,35,70,121,138,259,11,8,19,3,2:35
13522,566323,2019-07-13,2019,SDN,ATL,5,7,7-5,ATL,10,0,44,46,90,183,174,357,17,16,33,1,4:05
13523,565758,2019-07-30,2019,KCA,TOR,2,9,9-2,TOR,9,0,43,44,87,178,171,349,16,16,32,1,3:37
13524,566991,2019-06-12,2019,MIN,SEA,6,9,9-6,SEA,10,0,42,50,92,200,158,358,12,19,31,6,3:50
13525,565057,2019-06-10,2019,BOS,TEX,3,4,4-3,TEX,11,0,43,41,84,170,165,335,13,11,24,1,3:25
13526,566504,2019-06-14,2019,SFN,MIL,5,3,5-3,SFN,9,1,33,41,74,162,115,277,11,15,26,2,3:01
13527,565838,2019-06-20,2019,LAN,SFN,9,8,9-8,LAN,9,1,43,40,83,167,155,322,20,12,32,2,3:25
13528,566500,2019-06-08,2019,SFN,LAN,2,7,7-2,LAN,9,0,40,47,87,173,163,336,13,21,34,3,3:41
13529,564770,2019-06-11,2019,ANA,LAN,5,3,5-3,ANA,9,1,35,45,80,189,161,350,12,18,30,3,3:51
13530,566994,2019-06-15,2019,MIN,KCA,5,4,5-4,MIN,9,1,34,40,74,151,126,277,11,11,22,2,3:09
13531,564785,2019-07-26,2019,ANA,BAL,3,9,9-3,BAL,9,0,34,41,75,156,138,294,7,15,22,0,3:00
13532,567219,2019-07-24,2019,ATL,KCA,0,2,2-0,KCA,9,0,32,34,66,151,121,272,6,7,13,0,2:43
13533,566229,2019-07-25,2019,PIT,SLN,3,6,6-3,SLN,9,0,36,38,74,144,115,259,10,10,20,2,2:45
13534,565546,2019-06-16,2019,DET,CLE,0,8,8-0,CLE,9,0,31,45,76,170,117,287,4,21,25,1,2:45
13535,566793,2019-06-04,2019,TEX,BAL,11,12,12-11,BAL,9,0,48,43,91,168,197,365,20,19,39,5,3:42
13536,567108,2019-07-17,2019,PHI,LAN,2,7,7-2,LAN,9,0,36,46,82,203,163,366,9,19,28,3,3:58 (2:37 delay)
13537,566404,2019-06-04,2019,SEA,HOU,5,11,11-5,HOU,9,0,37,44,81,169,180,349,11,19,30,3,3:21
13538,566607,2019-06-23,2019,SLN,ANA,4,6,6-4,ANA,9,0,38,47,85,194,149,343,11,22,33,3,3:42
13539,565950,2019-07-30,2019,WAS,ATL,8,11,11-8,ATL,9,0,44,48,92,181,168,349,17,20,37,3,3:47
13540,566520,2019-07-21,2019,SFN,NYN,3,2,3-2,SFN,12,0,44,44,88,186,164,350,12,9,21,1,3:28
13541,566138,2019-07-28,2019,OAK,TEX,6,5,6-5,OAK,9,0,41,39,80,175,170,345,19,15,34,3,3:38
13542,566698,2019-06-13,2019,TBA,ANA,3,5,5-3,ANA,9,0,38,37,75,139,154,293,12,9,21,1,2:55 (:36 delay)
13543,565350,2019-06-09,2019,CLE,NYA,6,7,7-6,NYA,10,0,41,48,89,200,170,370,10,21,31,4,3:56
13544,565369,2019-07-30,2019,CLE,HOU,0,2,2-0,HOU,9,0,29,35,64,124,130,254,2,10,12,0,2:44
13545,565752,2019-07-18,2019,KCA,CHA,6,5,6-5,KCA,9,1,40,40,80,151,134,285,17,14,31,3,3:03
13546,566427,2019-07-26,2019,SEA,DET,3,2,3-2,SEA,9,0,37,33,70,120,141,261,13,8,21,3,2:51
13547,565060,2019-06-13,2019,BOS,TEX,7,6,7-6,BOS,9,1,36,47,83,212,139,351,11,22,33,3,4:06
13548,567093,2019-06-10,2019,PHI,ARI,8,13,13-8,ARI,9,0,44,46,90,188,176,364,17,20,37,2,3:50 (:30 delay)
13549,565058,2019-06-11,2019,BOS,TEX,5,9,9-5,TEX,9,0,40,44,84,195,171,366,13,17,30,1,3:40
13550,566816,2019-07-30,2019,TEX,SEA,5,8,8-5,SEA,9,0,40,46,86,188,140,328,15,17,32,3,3:16
13551,567510,2019-07-19,2019,NYA,COL,8,2,8-2,NYA,9,1,40,37,77,154,168,322,16,11,27,0,3:15
13552,566428,2019-07-27,2019,SEA,DET,8,1,8-1,SEA,9,1,44,34,78,138,175,313,22,8,30,2,3:02
13553,565450,2019-06-15,2019,COL,SDN,14,8,14-8,COL,9,1,47,44,91,158,174,332,25,18,43,3,3:39
13554,565934,2019-06-22,2019,WAS,ATL,9,13,13-9,ATL,9,0,42,47,89,172,167,339,18,20,38,2,3:42
13555,567491,2019-06-11,2019,NYA,NYN,12,5,12-5,NYA,9,1,43,38,81,140,167,307,18,9,27,2,3:09
13556,564867,2019-06-22,2019,ARI,SFN,4,7,7-4,SFN,9,0,39,39,78,139,177,316,13,13,26,1,3:20
13557,567604,2019-07-23,2019,MIL,CIN,6,14,14-6,CIN,9,0,40,47,87,207,171,378,13,22,35,1,3:28
13558,567603,2019-07-22,2019,MIL,CIN,5,6,6-5,CIN,9,0,42,40,82,142,183,325,16,15,31,5,3:33
13559,567316,2019-07-30,2019,CHA,NYN,2,5,5-2,NYN,11,0,42,49,91,187,158,345,11,17,28,4,3:51
13560,564865,2019-06-20,2019,ARI,COL,4,6,6-4,COL,10,0,48,42,90,173,207,380,20,16,36,2,4:08
13561,565459,2019-07-13,2019,COL,CIN,9,17,17-9,CIN,9,0,42,53,95,202,170,372,18,28,46,4,3:53 (3:08 delay)
13562,566699,2019-06-14,2019,TBA,ANA,9,4,9-4,TBA,9,1,43,41,84,174,188,362,19,15,34,6,3:56
13563,566812,2019-07-13,2019,TEX,HOU,6,7,7-6,HOU,11,0,45,50,95,193,197,390,10,20,30,3,4:09
13564,567600,2019-07-15,2019,MIL,ATL,2,4,4-2,ATL,9,0,36,38,74,142,150,292,9,12,21,1,3:02
13565,566208,2019-06-04,2019,PIT,ATL,5,12,12-5,ATL,9,0,44,49,93,192,170,362,17,21,38,3,3:46
13566,565927,2019-06-15,2019,WAS,ARI,3,10,10-3,ARI,9,0,37,45,82,192,149,341,10,20,30,3,3:30
13567,567205,2019-06-17,2019,ATL,NYN,12,3,12-3,ATL,9,1,47,36,83,116,177,293,23,11,34,3,3:05 (:15 delay)
13568,566522,2019-07-23,2019,SFN,CHN,5,4,5-4,SFN,13,0,48,49,97,173,161,334,14,12,26,2,3:45
13569,565946,2019-07-26,2019,WAS,LAN,2,4,4-2,LAN,9,0,41,35,76,126,159,285,14,8,22,3,3:20
13570,564960,2019-06-01,2019,BAL,SFN,2,8,8-2,SFN,9,0,33,39,72,152,131,283,7,12,19,1,2:48
13571,564880,2019-07-23,2019,ARI,BAL,2,7,7-2,BAL,9,0,32,37,69,152,134,286,8,11,19,1,2:57
13572,564775,2019-06-29,2019,ANA,OAK,0,4,4-0,OAK,9,0,31,37,68,165,121,286,5,12,17,2,2:45
13573,565641,2019-06-14,2019,HOU,TOR,15,2,15-2,HOU,9,1,44,35,79,145,158,303,20,8,28,1,2:53
13574,565362,2019-07-15,2019,CLE,DET,8,6,8-6,CLE,9,1,39,40,79,136,132,268,16,15,31,7,2:55 (:54 delay)
13575,565077,2019-07-26,2019,BOS,NYA,10,5,10-5,BOS,9,1,38,41,79,156,165,321,14,16,30,3,3:16
13576,566502,2019-06-11,2019,SFN,SDN,6,5,6-5,SFN,9,1,36,37,73,155,149,304,13,10,23,2,3:01
13577,565176,2019-07-20,2019,CHN,SDN,6,5,6-5,CHN,9,1,36,39,75,150,140,290,14,12,26,1,3:25
13578,567008,2019-07-19,2019,MIN,OAK,3,5,5-3,OAK,9,0,39,38,77,154,145,299,12,14,26,2,3:21
13579,567203,2019-06-15,2019,ATL,PHI,5,6,6-5,PHI,9,0,39,38,77,168,159,327,13,12,25,4,3:55
13580,564764,2019-06-05,2019,ANA,OAK,10,9,10-9,ANA,9,0,44,45,89,197,183,380,19,20,39,5,4:13
13581,566226,2019-07-22,2019,PIT,SLN,5,6,6-5,SLN,10,0,46,44,90,170,211,381,18,15,33,3,4:05
13582,565839,2019-06-21,2019,LAN,COL,4,2,4-2,LAN,9,0,33,30,63,111,108,219,7,3,10,0,2:12
13583,566413,2019-06-23,2019,SEA,BAL,13,3,13-3,SEA,9,1,44,38,82,141,178,319,20,12,32,1,3:07
13584,566514,2019-07-05,2019,SFN,SLN,4,9,9-4,SLN,9,0,36,45,81,190,148,338,10,20,30,1,3:23
13585,566693,2019-06-01,2019,TBA,MIN,2,6,6-2,MIN,9,0,39,43,82,171,144,315,12,16,28,3,3:39
13586,565938,2019-07-04,2019,WAS,MIA,5,2,5-2,WAS,9,1,36,42,78,167,146,313,13,14,27,3,3:17
13587,567390,2019-06-09,2019,MIA,ATL,6,7,7-6,ATL,12,0,51,55,106,215,189,404,17,20,37,3,4:26
13588,566916,2019-07-27,2019,TOR,TBA,10,9,10-9,TOR,12,0,54,53,107,195,210,405,21,18,39,3,4:07
13589,567585,2019-06-08,2019,MIL,PIT,5,3,5-3,MIL,9,1,42,35,77,144,208,352,19,9,28,2,3:29
13590,564780,2019-07-15,2019,ANA,HOU,9,6,9-6,ANA,9,1,39,44,83,170,145,315,14,19,33,3,3:25
13591,566116,2019-06-02,2019,OAK,HOU,4,6,6-4,HOU,12,0,47,51,98,203,226,429,12,17,29,2,4:24
13592,565736,2019-06-11,2019,KCA,DET,3,2,3-2,KCA,9,1,35,33,68,116,137,253,11,6,17,1,2:35
13593,564964,2019-06-13,2019,BAL,TOR,3,12,12-3,TOR,9,0,37,47,84,201,160,361,10,21,31,2,3:23 (:32 delay)
13594,567010,2019-07-21,2019,MIN,OAK,7,6,7-6,MIN,9,0,46,42,88,195,168,363,20,16,36,3,4:02
13595,567013,2019-07-24,2019,MIN,NYA,7,10,10-7,NYA,9,0,39,43,82,165,158,323,14,17,31,2,3:24
13596,567200,2019-06-12,2019,ATL,PIT,8,7,8-7,ATL,11,0,52,50,102,203,204,407,25,19,44,0,4:17 (:55 delay)
13597,565738,2019-06-13,2019,KCA,DET,7,3,7-3,KCA,9,1,39,41,80,161,166,327,14,13,27,1,3:17
13598,566794,2019-06-05,2019,TEX,BAL,2,1,2-1,TEX,12,0,47,48,95,207,203,410,13,13,26,1,4:18
13599,565445,2019-06-10,2019,COL,CHN,6,5,6-5,COL,9,1,34,37,71,139,118,257,11,10,21,1,2:51
13600,566899,2019-06-18,2019,TOR,ANA,1,3,3-1,ANA,9,0,29,34,63,129,109,238,3,8,11,3,2:30
13601,566120,2019-06-17,2019,OAK,BAL,3,2,3-2,OAK,9,1,33,32,65,117,129,246,9,6,15,1,2:32
13602,565173,2019-07-16,2019,CHN,CIN,4,3,4-3,CHN,10,0,37,42,79,149,166,315,10,14,24,4,3:31
13603,565255,2019-06-19,2019,CIN,HOU,3,2,3-2,CIN,9,0,38,33,71,127,124,251,14,8,22,0,2:38 (:31 delay)
13604,565548,2019-06-26,2019,DET,TEX,1,4,4-1,TEX,9,0,32,36,68,122,108,230,7,12,19,1,2:19
13605,567397,2019-06-25,2019,MIA,WAS,1,6,6-1,WAS,9,0,32,37,69,140,105,245,7,10,17,0,2:27
13606,566516,2019-07-07,2019,SFN,SLN,1,0,1-0,SFN,9,1,27,32,59,120,96,216,4,7,11,0,2:19
13607,564963,2019-06-12,2019,BAL,TOR,6,8,8-6,TOR,9,0,40,44,84,194,180,374,16,16,32,5,4:05
13608,565640,2019-06-12,2019,HOU,MIL,3,6,6-3,MIL,14,0,51,53,104,203,205,408,14,11,25,1,4:16
13609,565739,2019-06-20,2019,KCA,MIN,4,1,4-1,KCA,9,1,33,33,66,111,122,233,11,6,17,0,2:37
13610,565559,2019-07-23,2019,DET,PHI,2,3,3-2,PHI,15,0,56,59,115,222,208,430,15,14,29,2,4:29 (:38 delay)
13611,567590,2019-06-23,2019,MIL,CIN,7,5,7-5,MIL,9,1,38,36,74,126,156,282,15,12,27,2,2:50
13612,567493,2019-06-17,2019,NYA,TBA,3,0,3-0,NYA,9,1,33,29,62,111,139,250,10,3,13,1,2:34
13613,564967,2019-06-16,2019,BAL,BOS,6,8,8-6,BOS,10,0,48,48,96,194,236,430,17,19,36,7,4:44
13614,567209,2019-07-03,2019,ATL,PHI,9,2,9-2,ATL,9,1,36,34,70,140,130,270,11,9,20,1,2:36
13615,566126,2019-06-23,2019,OAK,TBA,2,8,8-2,TBA,9,0,35,43,78,134,148,282,8,19,27,2,2:58
13616,565837,2019-06-19,2019,LAN,SFN,9,2,9-2,LAN,9,1,37,31,68,110,165,275,14,5,19,1,2:47
13617,566213,2019-06-21,2019,PIT,SDN,2,1,2-1,PIT,9,1,30,36,66,140,91,231,7,9,16,0,2:35
13618,565747,2019-07-13,2019,KCA,DET,4,1,4-1,KCA,9,1,33,31,64,116,122,238,12,4,16,0,2:23
13619,566037,2019-07-27,2019,NYN,PIT,3,0,3-0,NYN,9,1,30,31,61,99,115,214,6,5,11,0,2:10
13620,565076,2019-07-25,2019,BOS,NYA,19,3,19-3,BOS,9,1,51,35,86,156,174,330,28,8,36,2,3:28
13621,565833,2019-06-15,2019,LAN,CHN,1,2,2-1,CHN,9,0,33,33,66,125,141,266,7,6,13,1,2:49
13622,565059,2019-06-12,2019,BOS,TEX,4,3,4-3,BOS,9,0,37,36,73,136,143,279,15,9,24,2,2:54
13623,565159,2019-06-18,2019,CHN,CHA,1,3,3-1,CHA,9,0,33,35,68,131,124,255,8,10,18,3,2:44
13624,566601,2019-06-17,2019,SLN,MIA,5,0,5-0,SLN,9,1,33,33,66,127,136,263,8,8,16,1,2:39
13625,567593,2019-06-27,2019,MIL,SEA,4,2,4-2,MIL,9,1,33,35,68,145,117,262,11,6,17,1,2:34
13626,567012,2019-07-23,2019,MIN,NYA,12,14,14-12,NYA,10,0,55,54,109,214,218,432,25,26,51,4,5:03
13627,565744,2019-07-03,2019,KCA,CLE,0,4,4-0,CLE,9,0,32,38,70,138,119,257,6,15,21,2,2:46
13628,566508,2019-06-25,2019,SFN,COL,4,2,4-2,SFN,9,1,35,33,68,132,126,258,13,7,20,0,2:43
13629,567202,2019-06-14,2019,ATL,PHI,9,8,9-8,ATL,9,0,43,41,84,168,177,345,18,14,32,3,3:30
13630,565834,2019-06-16,2019,LAN,CHN,3,2,3-2,LAN,9,1,36,37,73,130,146,276,13,10,23,3,3:05
13631,566215,2019-06-23,2019,PIT,SDN,11,10,11-10,PIT,11,0,55,54,109,229,205,434,23,22,45,2,4:58
13632,566313,2019-06-17,2019,SDN,MIL,2,0,2-0,SDN,9,1,35,32,67,129,152,281,11,7,18,1,2:55
13633,566602,2019-06-18,2019,SLN,MIA,0,6,6-0,MIA,9,0,33,35,68,134,135,269,7,9,16,2,2:43
13634,565929,2019-06-19,2019,WAS,PHI,6,2,6-2,WAS,9,1,36,37,73,142,124,266,13,11,24,1,2:46
13635,566711,2019-07-07,2019,TBA,NYA,2,1,2-1,TBA,9,1,34,33,67,139,139,278,10,6,16,4,2:59
13636,566902,2019-06-28,2019,TOR,KCA,6,2,6-2,TOR,9,1,35,37,72,135,130,265,11,12,23,4,2:47
13637,564874,2019-07-07,2019,ARI,COL,5,3,5-3,ARI,9,1,34,32,66,123,127,250,9,5,14,0,2:36
13638,565261,2019-07-03,2019,CIN,MIL,3,0,3-0,CIN,9,1,34,32,66,125,137,262,11,6,17,1,2:40
13639,567096,2019-06-21,2019,PHI,MIA,1,2,2-1,MIA,9,0,39,35,74,125,128,253,14,8,22,1,2:56
13640,565254,2019-06-18,2019,CIN,HOU,4,3,4-3,CIN,9,1,31,35,66,136,126,262,8,11,19,3,2:55 (:28 delay)
13641,566036,2019-07-26,2019,NYN,PIT,6,3,6-3,NYN,9,1,31,35,66,117,108,225,7,8,15,2,2:21
13642,566507,2019-06-24,2019,SFN,COL,0,2,2-0,COL,9,0,34,35,69,141,141,282,8,8,16,0,2:45
13643,565644,2019-06-25,2019,HOU,PIT,5,1,5-1,HOU,9,1,36,36,72,134,132,266,11,10,21,1,2:57
13644,566418,2019-07-06,2019,SEA,OAK,6,3,6-3,SEA,9,1,34,35,69,121,125,246,10,7,17,1,2:31
13645,565354,2019-06-22,2019,CLE,DET,2,0,2-0,CLE,9,1,31,36,67,144,135,279,9,9,18,1,2:47
13646,564864,2019-06-19,2019,ARI,COL,4,6,6-4,COL,9,0,39,37,76,114,122,236,13,14,27,2,2:55
13647,566217,2019-07-02,2019,PIT,CHN,5,1,5-1,PIT,9,1,33,33,66,132,119,251,10,8,18,1,2:43 (2:05 delay)
13648,564980,2019-07-21,2019,BAL,BOS,5,0,5-0,BAL,9,1,32,31,63,128,133,261,11,5,16,1,2:44
13649,566420,2019-07-19,2019,SEA,ANA,10,0,10-0,SEA,9,1,39,29,68,98,154,252,17,2,19,1,2:32
13650,565174,2019-07-17,2019,CHN,CIN,5,2,5-2,CHN,9,1,32,35,67,123,138,261,8,10,18,2,3:07
13651,565063,2019-06-23,2019,BOS,TOR,1,6,6-1,TOR,9,0,36,41,77,146,145,291,9,16,25,0,3:04
13652,567297,2019-06-13,2019,CHA,NYA,5,4,5-4,CHA,9,1,37,37,74,157,153,310,14,11,25,2,3:14
13653,566799,2019-06-17,2019,TEX,CLE,7,2,7-2,TEX,9,1,36,34,70,135,153,288,12,8,20,1,2:52
13654,567295,2019-06-10,2019,CHA,WAS,1,12,12-1,WAS,9,0,31,46,77,188,104,292,6,21,27,4,3:06
13655,567394,2019-06-14,2019,MIA,PIT,0,11,11-0,PIT,9,0,37,44,81,153,133,286,11,20,31,0,2:56
13656,567097,2019-06-22,2019,PHI,MIA,3,5,5-3,MIA,9,0,36,35,71,111,140,251,11,9,20,2,2:43
13657,567501,2019-06-25,2019,NYA,TOR,4,3,4-3,NYA,9,1,34,35,69,159,115,274,14,7,21,1,2:47
13658,565931,2019-06-19,2019,WAS,PHI,2,0,2-0,WAS,9,1,30,33,63,142,138,280,7,6,13,1,3:05
13659,565929,2019-06-19,2019,WAS,PHI,6,2,6-2,WAS,9,1,36,37,73,142,124,266,13,11,24,1,2:46
13660,565367,2019-07-20,2019,CLE,KCA,0,1,1-0,KCA,9,0,33,34,67,138,135,273,6,8,14,0,2:41
13661,566706,2019-07-02,2019,TBA,BAL,6,3,6-3,TBA,9,1,36,34,70,136,151,287,12,7,19,2,2:43
13662,567303,2019-06-30,2019,CHA,MIN,4,3,4-3,CHA,9,1,33,34,67,131,126,257,12,6,18,3,2:47 (2:54 delay)
13663,565759,2019-07-31,2019,KCA,TOR,1,4,4-1,TOR,9,0,32,39,71,126,114,240,6,13,19,1,2:23
13664,565836,2019-06-18,2019,LAN,SFN,9,0,9-0,LAN,9,1,43,33,76,137,142,279,20,7,27,2,2:59
13665,565446,2019-06-11,2019,COL,CHN,10,3,10-3,COL,9,1,40,37,77,138,157,295,20,11,31,2,3:10
13666,567594,2019-06-28,2019,MIL,PIT,2,3,3-2,PIT,9,0,33,38,71,136,134,270,9,14,23,0,3:00
13667,567301,2019-06-28,2019,CHA,MIN,6,4,6-4,CHA,9,1,35,38,73,150,108,258,9,14,23,4,2:56
13668,566512,2019-06-27,2019,SFN,ARI,1,5,5-1,ARI,9,0,33,37,70,143,118,261,6,12,18,3,2:42
13669,566910,2019-07-06,2019,TOR,BAL,1,8,8-1,BAL,9,0,31,40,71,149,115,264,4,14,18,1,2:30
13670,566606,2019-06-22,2019,SLN,ANA,4,2,4-2,SLN,9,1,32,35,67,157,119,276,7,8,15,2,2:59 (:16 delay)
13671,566914,2019-07-24,2019,TOR,CLE,0,4,4-0,CLE,9,0,29,36,65,137,102,239,3,10,13,0,2:24
13672,566702,2019-06-28,2019,TBA,TEX,0,5,5-0,TEX,9,0,32,38,70,148,125,273,5,13,18,0,2:48
13673,566406,2019-06-06,2019,SEA,HOU,7,8,8-7,HOU,14,0,62,61,123,226,258,484,20,23,43,4,5:06
13674,567498,2019-06-22,2019,NYA,HOU,7,5,7-5,NYA,9,1,35,43,78,162,145,307,11,18,29,1,3:08
13675,565835,2019-06-17,2019,LAN,SFN,2,3,3-2,SFN,9,0,37,35,72,155,133,288,10,8,18,0,3:11
13676,566121,2019-06-18,2019,OAK,BAL,16,2,16-2,OAK,9,1,44,32,76,122,169,291,19,5,24,2,2:28
13677,567400,2019-06-28,2019,MIA,PHI,6,2,6-2,MIA,9,1,34,34,68,137,146,283,11,7,18,2,2:56
13678,564968,2019-06-25,2019,BAL,SDN,3,8,8-3,SDN,9,0,38,41,79,133,135,268,13,16,29,1,2:47
13679,565549,2019-06-27,2019,DET,TEX,1,3,3-1,TEX,9,0,36,35,71,151,138,289,11,8,19,0,2:52
13680,565547,2019-06-25,2019,DET,TEX,3,5,5-3,TEX,9,0,36,41,77,145,133,278,9,14,23,1,2:47
13681,565166,2019-06-25,2019,CHN,ATL,2,3,3-2,ATL,9,0,33,35,68,168,129,297,10,8,18,2,2:59
13682,565650,2019-07-05,2019,HOU,ANA,4,5,5-4,ANA,9,0,37,35,72,133,137,270,10,10,20,1,2:54
13683,565646,2019-06-27,2019,HOU,PIT,0,10,10-0,PIT,9,0,35,41,76,151,121,272,9,16,25,0,2:51
13684,566907,2019-07-03,2019,TOR,BOS,6,3,6-3,TOR,9,1,39,35,74,125,149,274,17,9,26,3,3:01
13685,565461,2019-07-15,2019,COL,SFN,1,2,2-1,SFN,9,0,32,35,67,145,120,265,7,9,16,1,2:42 (:21 delay)
13686,566909,2019-07-05,2019,TOR,BAL,1,4,4-1,BAL,9,0,33,36,69,149,129,278,6,11,17,2,2:48
13687,565847,2019-07-07,2019,LAN,SDN,3,5,5-3,SDN,9,0,33,34,67,138,126,264,7,8,15,2,2:58
13688,566905,2019-07-01,2019,TOR,KCA,11,4,11-4,TOR,9,1,43,35,78,110,157,267,22,10,32,0,2:32
13689,565449,2019-06-14,2019,COL,SDN,12,16,16-12,SDN,12,0,58,62,120,240,220,460,22,27,49,3,5:04
13690,565932,2019-06-20,2019,WAS,PHI,7,4,7-4,WAS,9,1,36,38,74,162,136,298,15,14,29,2,3:05 (:30 delay)
13691,566022,2019-06-14,2019,NYN,SLN,5,9,9-5,SLN,9,0,41,39,80,177,140,317,14,12,26,2,3:05
13692,565832,2019-06-14,2019,LAN,CHN,5,3,5-3,LAN,9,1,37,36,73,133,165,298,13,8,21,3,3:06
13693,566999,2019-06-25,2019,MIN,TBA,9,4,9-4,MIN,9,1,40,35,75,121,154,275,18,9,27,1,3:03
13694,564868,2019-06-23,2019,ARI,SFN,3,2,3-2,ARI,10,0,37,36,73,152,143,295,11,7,18,2,3:13
13695,566212,2019-06-19,2019,PIT,DET,8,7,8-7,PIT,9,1,37,38,75,125,143,268,13,12,25,1,2:52
13696,567499,2019-06-23,2019,NYA,HOU,4,9,9-4,HOU,9,0,34,40,74,133,152,285,8,16,24,1,2:48
13697,567105,2019-07-14,2019,PHI,WAS,4,3,4-3,PHI,9,0,34,36,70,147,112,259,10,12,22,1,2:54
13698,564772,2019-06-26,2019,ANA,CIN,5,1,5-1,ANA,9,1,35,34,69,134,152,286,11,6,17,1,2:42
13699,566133,2019-07-16,2019,OAK,SEA,9,2,9-2,OAK,9,1,37,33,70,124,138,262,14,6,20,0,2:43
13700,565940,2019-07-06,2019,WAS,KCA,6,0,6-0,WAS,9,1,35,34,69,135,130,265,14,8,22,0,2:44
13701,565654,2019-07-20,2019,HOU,TEX,6,1,6-1,HOU,9,1,37,29,66,127,134,261,13,2,15,1,2:25
13702,567508,2019-07-18,2019,NYA,TBA,5,1,5-1,NYA,9,1,34,38,72,166,122,288,12,11,23,3,2:46
13703,567207,2019-06-19,2019,ATL,NYN,7,2,7-2,ATL,9,1,37,36,73,144,153,297,14,11,25,3,3:03
13704,567399,2019-06-27,2019,MIA,WAS,5,8,8-5,WAS,9,0,37,39,76,128,139,267,10,12,22,1,2:51
13705,565358,2019-06-26,2019,CLE,KCA,5,3,5-3,CLE,9,1,36,37,73,166,135,301,13,11,24,1,2:49
13706,564870,2019-06-25,2019,ARI,LAN,2,3,3-2,LAN,9,0,35,36,71,134,150,284,8,11,19,1,3:07
13707,565163,2019-06-22,2019,CHN,NYN,2,10,10-2,NYN,9,0,36,42,78,148,134,282,10,16,26,1,3:01
13708,566804,2019-06-22,2019,TEX,CHA,6,5,6-5,TEX,9,1,38,35,73,138,151,289,17,8,25,3,3:04
13709,567211,2019-07-05,2019,ATL,MIA,1,0,1-0,ATL,9,0,34,36,70,157,129,286,13,10,23,0,3:00 (2:28 delay)
13710,565558,2019-07-21,2019,DET,TOR,4,3,4-3,DET,10,0,39,36,75,136,149,285,15,7,22,1,2:58
13711,565165,2019-06-24,2019,CHN,ATL,8,3,8-3,CHN,9,1,35,35,70,148,133,281,14,8,22,2,3:01
13712,566417,2019-07-05,2019,SEA,OAK,2,5,5-2,OAK,9,0,31,35,66,141,121,262,5,9,14,2,2:51
13713,565056,2019-06-09,2019,BOS,TBA,1,6,6-1,TBA,9,0,37,43,80,165,156,321,10,17,27,2,3:32
13714,565250,2019-06-14,2019,CIN,TEX,1,7,7-1,TEX,9,0,33,43,76,197,143,340,6,16,22,2,3:08
13715,567494,2019-06-18,2019,NYA,TBA,6,3,6-3,NYA,9,1,37,37,74,152,150,302,13,11,24,3,3:09 (1:16 delay)
13716,566222,2019-07-07,2019,PIT,MIL,6,5,6-5,PIT,9,1,37,37,74,147,134,281,15,11,26,3,3:04 (:40 delay)
13717,565649,2019-06-30,2019,HOU,SEA,6,1,6-1,HOU,9,1,39,33,72,146,154,300,16,8,24,1,2:52
13718,567497,2019-06-21,2019,NYA,HOU,4,1,4-1,NYA,9,1,31,40,71,176,125,301,8,14,22,2,3:06
13719,567206,2019-06-18,2019,ATL,NYN,2,10,10-2,NYN,9,0,33,48,81,170,123,293,6,24,30,1,3:04 (:10 delay)
13720,565065,2019-06-25,2019,BOS,CHA,6,3,6-3,BOS,9,1,35,38,73,153,145,298,12,11,23,0,3:24 (:24 delay)
13721,564773,2019-06-27,2019,ANA,OAK,8,3,8-3,ANA,9,1,37,32,69,125,150,275,16,7,23,1,2:46
13722,567100,2019-06-25,2019,PHI,NYN,7,5,7-5,PHI,9,1,37,43,80,148,134,282,12,16,28,3,3:07
13723,565935,2019-06-23,2019,WAS,ATL,3,4,4-3,ATL,10,0,40,39,79,144,135,279,12,10,22,2,3:09
13724,566324,2019-07-14,2019,SDN,ATL,1,4,4-1,ATL,9,0,38,38,76,147,130,277,12,10,22,3,3:15
13725,566610,2019-07-12,2019,SLN,ARI,2,4,4-2,ARI,9,0,35,34,69,137,145,282,7,9,16,3,2:56
13726,567217,2019-07-21,2019,ATL,WAS,7,1,7-1,ATL,9,1,39,32,71,105,165,270,17,6,23,4,3:02
13727,566911,2019-07-07,2019,TOR,BAL,6,1,6-1,TOR,9,1,36,34,70,147,134,281,13,7,20,3,2:44
13728,565845,2019-07-05,2019,LAN,SDN,2,3,3-2,SDN,9,0,37,36,73,123,141,264,8,8,16,1,2:58
13729,567208,2019-07-02,2019,ATL,PHI,0,2,2-0,PHI,9,0,33,36,69,124,132,256,7,10,17,1,2:48
13730,567113,2019-07-30,2019,PHI,SFN,4,2,4-2,PHI,9,1,38,31,69,135,134,269,14,7,21,0,2:47
13731,566614,2019-07-16,2019,SLN,PIT,1,3,3-1,PIT,9,0,33,35,68,135,126,261,8,11,19,1,3:04
13732,565751,2019-07-17,2019,KCA,CHA,7,5,7-5,KCA,9,1,38,35,73,152,134,286,19,11,30,3,3:11
13733,564872,2019-07-05,2019,ARI,COL,8,0,8-0,ARI,9,1,35,34,69,141,124,265,13,6,19,1,2:52
13734,565643,2019-06-16,2019,HOU,TOR,0,12,12-0,TOR,9,0,37,45,82,174,141,315,13,18,31,1,3:02
13735,565160,2019-06-19,2019,CHN,CHA,7,3,7-3,CHN,9,1,37,38,75,172,142,314,14,12,26,3,3:18
13736,565930,2019-09-24,2019,WAS,PHI,4,1,4-1,WAS,9,1,35,33,68,133,150,283,11,7,18,2,3:07
13737,564869,2019-06-24,2019,ARI,LAN,8,5,8-5,ARI,9,1,37,42,79,150,137,287,14,17,31,4,3:12
13738,567204,2019-06-16,2019,ATL,PHI,15,1,15-1,ATL,9,1,46,36,82,142,157,299,24,11,35,1,3:09
13739,567098,2019-06-23,2019,PHI,MIA,4,6,6-4,MIA,9,0,36,43,79,146,147,293,9,22,31,0,2:59
13740,566025,2019-06-28,2019,NYN,ATL,2,6,6-2,ATL,9,0,36,39,75,149,138,287,9,13,22,1,2:55
13741,565550,2019-06-28,2019,DET,WAS,1,3,3-1,WAS,9,0,37,36,73,140,158,298,9,10,19,1,3:04
13742,567213,2019-07-07,2019,ATL,MIA,4,3,4-3,ATL,9,1,38,37,75,139,141,280,16,11,27,2,3:02 (:26 delay)
13743,565353,2019-06-21,2019,CLE,DET,7,6,7-6,CLE,9,1,38,40,78,160,138,298,14,14,28,4,3:16
13744,565936,2019-07-02,2019,WAS,MIA,3,2,3-2,WAS,9,0,37,33,70,118,161,279,10,8,18,0,3:01 (1:16 delay)
13745,566130,2019-07-12,2019,OAK,CHA,5,1,5-1,OAK,9,1,37,38,75,144,146,290,15,12,27,4,3:10
13746,566611,2019-07-13,2019,SLN,ARI,4,2,4-2,SLN,9,1,37,37,74,135,132,267,11,10,21,3,3:04
13747,567314,2019-07-27,2019,CHA,MIN,5,1,5-1,CHA,9,1,37,32,69,126,135,261,11,6,17,2,3:04
13748,564789,2019-07-30,2019,ANA,DET,6,1,6-1,ANA,9,1,38,38,76,139,130,269,14,10,24,1,2:52
13749,566409,2019-06-19,2019,SEA,KCA,8,2,8-2,SEA,9,1,38,37,75,144,155,299,15,11,26,1,2:51
13750,565551,2019-06-29,2019,DET,WAS,7,5,7-5,DET,9,1,40,37,77,156,146,302,18,11,29,4,3:13
13751,566129,2019-07-04,2019,OAK,MIN,7,2,7-2,OAK,9,1,40,40,80,156,147,303,17,14,31,1,3:20
13752,565742,2019-06-23,2019,KCA,MIN,6,1,6-1,KCA,9,1,34,39,73,176,132,308,11,12,23,2,3:09
13753,565168,2019-06-27,2019,CHN,ATL,9,7,9-7,CHN,9,1,36,39,75,157,137,294,11,14,25,1,3:02
13754,565274,2019-07-31,2019,CIN,PIT,4,1,4-1,CIN,9,1,36,34,70,129,120,249,14,7,21,2,2:45
13755,566803,2019-06-21,2019,TEX,CHA,4,5,5-4,CHA,10,0,39,44,83,149,161,310,11,15,26,4,3:23
13756,564971,2019-06-29,2019,BAL,CLE,13,0,13-0,BAL,9,1,45,32,77,124,174,298,22,6,28,3,2:57 (1:05 delay)
13757,566415,2019-07-03,2019,SEA,SLN,2,5,5-2,SLN,9,0,34,36,70,132,154,286,8,10,18,5,2:58
13758,566704,2019-06-30,2019,TBA,TEX,6,2,6-2,TBA,9,1,36,30,66,112,134,246,11,4,15,2,2:28
13759,566806,2019-08-20,2019,TEX,ANA,1,5,5-1,ANA,9,0,32,39,71,163,118,281,5,13,18,1,2:48
13760,567000,2019-06-26,2019,MIN,TBA,6,4,6-4,MIN,9,1,35,36,71,142,129,271,11,10,21,4,2:57
13761,565756,2019-07-28,2019,KCA,CLE,9,6,9-6,KCA,9,1,40,38,78,125,151,276,16,11,27,3,2:55
13762,567308,2019-07-07,2019,CHA,CHN,3,1,3-1,CHA,9,1,34,34,68,131,150,281,11,9,20,3,2:54
13763,565928,2019-06-16,2019,WAS,ARI,15,5,15-5,WAS,9,1,43,42,85,151,167,318,21,14,35,2,3:14
13764,566408,2019-06-18,2019,SEA,KCA,0,9,9-0,KCA,9,0,35,42,77,169,140,309,8,16,24,1,3:06
13765,567495,2019-06-19,2019,NYA,TBA,12,1,12-1,NYA,9,1,40,35,75,141,187,328,17,7,24,3,3:21
13766,566124,2019-06-21,2019,OAK,TBA,3,5,5-3,TBA,9,0,37,38,75,152,155,307,12,12,24,4,3:20
13767,566316,2019-06-28,2019,SDN,SLN,3,1,3-1,SDN,9,1,30,38,68,171,97,268,9,12,21,1,2:49
13768,566127,2019-07-02,2019,OAK,MIN,8,6,8-6,OAK,9,1,37,37,74,143,159,302,14,11,25,4,3:20
13769,565257,2019-06-29,2019,CIN,CHN,0,6,6-0,CHN,9,0,36,39,75,142,145,287,10,13,23,2,3:00
13770,566710,2019-07-06,2019,TBA,NYA,4,3,4-3,TBA,9,0,35,40,75,180,109,289,11,15,26,3,3:28
13771,566122,2019-06-19,2019,OAK,BAL,8,3,8-3,OAK,9,1,39,38,77,155,150,305,15,11,26,5,3:08
13772,566134,2019-07-17,2019,OAK,SEA,10,2,10-2,OAK,9,1,37,36,73,143,152,295,14,10,24,1,2:49
13773,567633,2019-07-09,2019,AAS,NAS,4,3,4-3,AAS,9,1,31,35,66,152,104,256,9,8,17,1,2:48
13774,565171,2019-07-14,2019,CHN,PIT,8,3,8-3,CHN,9,1,40,36,76,131,130,261,20,11,31,1,2:52
13775,565552,2019-06-30,2019,DET,WAS,1,2,2-1,WAS,9,0,33,39,72,153,138,291,6,12,18,2,2:53
13776,564965,2019-06-14,2019,BAL,BOS,2,13,13-2,BOS,9,0,36,50,86,203,149,352,10,25,35,2,3:24
13777,566211,2019-06-18,2019,PIT,DET,4,5,5-4,DET,9,0,40,37,77,154,161,315,13,11,24,2,3:09
13778,566214,2019-06-22,2019,PIT,SDN,6,3,6-3,PIT,9,1,37,40,77,167,149,316,17,14,31,1,3:18
13779,565256,2019-06-28,2019,CIN,CHN,6,3,6-3,CIN,9,1,40,36,76,145,158,303,18,9,27,4,3:12
13780,566319,2019-07-01,2019,SDN,SFN,2,13,13-2,SFN,9,0,36,46,82,182,128,310,7,18,25,2,3:12
13781,566605,2019-06-21,2019,SLN,ANA,5,1,5-1,SLN,9,1,38,34,72,148,154,302,14,10,24,3,3:24
13782,564875,2019-07-18,2019,ARI,MIL,1,5,5-1,MIL,9,0,34,35,69,135,132,267,10,10,20,1,2:59
13783,566421,2019-07-20,2019,SEA,ANA,2,6,6-2,ANA,9,0,34,40,74,184,134,318,8,13,21,1,3:23
13784,566320,2019-07-02,2019,SDN,SFN,4,10,10-4,SFN,9,0,35,48,83,162,147,309,9,22,31,0,3:12
13785,567003,2019-07-06,2019,MIN,TEX,7,4,7-4,MIN,9,1,37,36,73,155,153,308,13,9,22,1,3:12
13786,566712,2019-07-19,2019,TBA,CHA,2,9,9-2,CHA,9,0,36,45,81,178,136,314,9,18,27,1,3:20
13787,564787,2019-07-28,2019,ANA,BAL,5,4,5-4,ANA,9,0,35,35,70,140,149,289,11,9,20,3,3:02
13788,565167,2019-06-26,2019,CHN,ATL,3,5,5-3,ATL,9,0,38,35,73,141,138,279,14,9,23,3,3:02 (:48 delay)
13789,564977,2019-07-17,2019,BAL,WAS,9,2,9-2,BAL,9,1,37,36,73,158,122,280,17,9,26,5,2:51 (1:32 delay)
13790,566027,2019-06-30,2019,NYN,ATL,8,5,8-5,NYN,9,1,39,39,78,159,132,291,16,13,29,4,3:27
13791,564945,2019-07-13,2019,BAL,TBA,2,1,2-1,BAL,9,1,31,33,64,149,156,305,7,8,15,4,3:02
13792,565750,2019-07-16,2019,KCA,CHA,11,0,11-0,KCA,9,1,41,32,73,116,159,275,17,6,23,0,2:44
13793,566992,2019-06-13,2019,MIN,SEA,10,5,10-5,MIN,9,1,46,40,86,171,182,353,21,13,34,6,3:49
13794,566801,2019-06-19,2019,TEX,CLE,4,10,10-4,CLE,9,0,41,41,82,155,162,317,14,18,32,4,3:17
13795,566412,2019-06-22,2019,SEA,BAL,4,8,8-4,BAL,9,0,38,41,79,168,157,325,10,16,26,0,3:05
13796,564970,2019-06-28,2019,BAL,CLE,13,0,13-0,BAL,9,1,43,34,77,147,174,321,20,8,28,2,2:56
13797,566903,2019-06-29,2019,TOR,KCA,7,5,7-5,TOR,9,0,36,40,76,154,162,316,13,13,26,1,3:22
13798,565746,2019-07-12,2019,KCA,DET,8,5,8-5,KCA,9,1,36,39,75,159,137,296,13,13,26,2,3:07
13799,567273,2019-07-03,2019,CHA,DET,7,5,7-5,CHA,9,1,37,39,76,162,152,314,16,12,28,3,3:05
13800,567107,2019-07-16,2019,PHI,LAN,9,8,9-8,PHI,9,0,39,37,76,145,146,291,12,10,22,3,3:10 (:22 delay)
13801,564863,2019-06-18,2019,ARI,COL,1,8,8-1,COL,9,0,38,42,80,143,126,269,11,15,26,1,2:51
13802,566218,2019-07-03,2019,PIT,CHN,6,5,6-5,PIT,9,0,38,40,78,153,116,269,13,13,26,2,3:19
13803,566998,2019-06-19,2019,MIN,BOS,4,9,9-4,BOS,9,0,39,46,85,176,145,321,13,22,35,1,3:22
13804,566705,2019-07-01,2019,TBA,BAL,6,3,6-3,TBA,9,1,36,38,74,157,142,299,14,12,26,2,3:11
13805,566032,2019-07-07,2019,NYN,PHI,3,8,8-3,PHI,9,0,37,41,78,166,134,300,9,17,26,2,3:20
13806,567410,2019-07-27,2019,MIA,ARI,2,9,9-2,ARI,9,0,35,38,73,151,126,277,10,12,22,1,2:49
13807,565553,2019-07-05,2019,DET,BOS,6,9,9-6,BOS,9,0,38,45,83,177,153,330,11,18,29,1,3:22 (2:04 delay)
13808,566603,2019-06-19,2019,SLN,MIA,2,1,2-1,SLN,11,0,43,38,81,154,178,332,13,6,19,3,3:34
13809,566707,2019-07-03,2019,TBA,BAL,6,9,9-6,BAL,9,0,38,44,82,168,145,313,12,15,27,2,3:11
13810,566407,2019-06-17,2019,SEA,KCA,4,6,6-4,KCA,9,0,40,37,77,130,188,318,15,10,25,2,3:22
13811,565357,2019-06-25,2019,CLE,KCA,6,8,8-6,KCA,9,0,39,43,82,161,160,321,13,17,30,5,3:27
13812,567401,2019-06-29,2019,MIA,PHI,9,6,9-6,MIA,9,1,41,40,81,160,143,303,17,12,29,2,3:19
13813,565743,2019-07-02,2019,KCA,CLE,5,9,9-5,CLE,9,0,38,45,83,185,137,322,13,18,31,3,3:22
13814,567102,2019-06-27,2019,PHI,NYN,6,3,6-3,PHI,9,0,38,35,73,140,177,317,12,7,19,1,3:24
13815,567404,2019-07-13,2019,MIA,NYN,2,4,4-2,NYN,9,0,34,39,73,161,132,293,7,14,21,0,3:05
13816,566515,2019-07-06,2019,SFN,SLN,8,4,8-4,SFN,9,1,38,38,76,136,153,289,13,12,25,1,3:13
13817,564774,2019-06-28,2019,ANA,OAK,2,7,7-2,OAK,9,0,37,38,75,158,141,299,10,12,22,2,3:15
13818,565653,2019-07-19,2019,HOU,TEX,4,3,4-3,HOU,9,1,32,41,73,167,130,297,10,13,23,0,2:59
13819,565260,2019-07-02,2019,CIN,MIL,5,4,5-4,CIN,11,0,42,40,82,151,153,304,12,9,21,3,3:19
13820,564777,2019-07-12,2019,ANA,SEA,13,0,13-0,ANA,9,1,47,28,75,103,196,299,21,1,22,2,2:54
13821,566030,2019-07-05,2019,NYN,PHI,2,7,7-2,PHI,9,0,35,41,76,156,127,283,9,14,23,3,3:15
13822,565937,2019-07-03,2019,WAS,MIA,3,1,3-1,WAS,9,1,35,36,71,148,152,300,13,10,23,2,3:07
13823,567110,2019-07-26,2019,PHI,ATL,2,9,9-2,ATL,9,0,38,40,78,155,144,299,13,15,28,1,3:02
13824,566608,2019-06-25,2019,SLN,OAK,3,7,7-3,OAK,9,0,42,38,80,138,197,335,15,11,26,2,3:28
13825,565451,2019-06-16,2019,COL,SDN,13,14,14-13,SDN,9,0,48,46,94,186,156,342,22,23,45,2,3:31 (1:03 delay)
13826,565252,2019-06-16,2019,CIN,TEX,11,3,11-3,CIN,9,1,45,35,80,155,193,348,21,9,30,2,3:21 (1:34 delay)
13827,567592,2019-06-26,2019,MIL,SEA,2,4,4-2,SEA,9,0,35,39,74,182,150,332,8,13,21,0,3:11
13828,567210,2019-07-04,2019,ATL,PHI,12,6,12-6,ATL,9,1,40,42,82,166,171,337,18,17,35,2,3:32
13829,567099,2019-06-24,2019,PHI,NYN,13,7,13-7,PHI,9,1,47,44,91,156,162,318,24,19,43,1,3:18
13830,567512,2019-07-21,2019,NYA,COL,4,8,8-4,COL,9,0,34,44,78,171,129,300,7,18,25,3,3:13
13831,565846,2019-07-06,2019,LAN,SDN,1,3,3-1,SDN,9,0,35,32,67,110,145,255,8,6,14,2,2:52
13832,565740,2019-06-21,2019,KCA,MIN,7,8,8-7,MIN,9,0,38,44,82,172,137,309,11,17,28,3,3:27
13833,565842,2019-07-02,2019,LAN,ARI,5,4,5-4,LAN,9,0,40,39,79,131,166,297,15,14,29,4,3:26
13834,567601,2019-07-16,2019,MIL,ATL,13,1,13-1,MIL,9,1,47,34,81,129,188,317,24,7,31,2,3:29
13835,564779,2019-07-14,2019,ANA,SEA,6,3,6-3,ANA,9,1,37,37,74,162,164,326,13,12,25,3,3:28
13836,566506,2019-06-16,2019,SFN,MIL,3,5,5-3,MIL,9,0,38,41,79,176,161,337,12,15,27,1,3:18
13837,565068,2019-06-30,2019,BOS,NYA,8,12,12-8,NYA,9,0,42,50,92,229,145,374,16,23,39,4,4:24
13838,567413,2019-07-30,2019,MIA,MIN,1,2,2-1,MIN,9,0,33,34,67,142,151,293,6,10,16,1,3:11
13839,565360,2019-07-13,2019,CLE,MIN,2,6,6-2,MIN,9,0,33,42,75,166,137,303,8,14,22,4,3:24
13840,564975,2019-07-14,2019,BAL,TBA,1,4,4-1,TBA,9,0,30,35,65,157,122,279,3,9,12,4,2:45
13841,566227,2019-07-23,2019,PIT,SLN,3,4,4-3,SLN,9,0,35,36,71,127,122,249,9,9,18,1,2:46
13842,566224,2019-07-20,2019,PIT,PHI,5,1,5-1,PIT,9,1,39,33,72,136,131,267,16,7,23,0,2:57 (:28 delay)
13843,565079,2019-07-28,2019,BOS,NYA,6,9,9-6,NYA,9,0,42,41,83,156,154,310,14,15,29,3,3:28
13844,566028,2019-07-02,2019,NYN,NYA,4,2,4-2,NYN,9,1,36,35,71,166,139,305,15,8,23,2,3:11
13845,567216,2019-07-20,2019,ATL,WAS,3,5,5-3,WAS,9,0,40,41,81,132,165,297,13,18,31,3,3:14
13846,565951,2019-07-31,2019,WAS,ATL,4,5,5-4,ATL,10,0,39,42,81,152,145,297,13,14,27,2,3:14
13847,567109,2019-07-18,2019,PHI,LAN,7,6,7-6,PHI,9,1,37,39,76,162,148,310,13,14,27,3,3:27
13848,565258,2019-06-30,2019,CIN,CHN,8,6,8-6,CIN,9,1,38,42,80,146,171,317,15,15,30,4,3:20
13849,565757,2019-07-29,2019,KCA,TOR,3,7,7-3,TOR,9,0,36,41,77,151,148,299,9,14,23,3,2:55
13850,567607,2019-07-27,2019,MIL,CHN,5,3,5-3,MIL,10,0,40,39,79,158,149,307,16,9,25,4,3:32
13851,567006,2019-07-17,2019,MIN,NYN,4,14,14-4,NYN,9,0,36,48,84,166,136,302,10,20,30,0,3:16
13852,565366,2019-07-19,2019,CLE,KCA,10,5,10-5,CLE,9,1,43,38,81,144,160,304,22,15,37,2,3:20
13853,565271,2019-07-28,2019,CIN,COL,3,2,3-2,CIN,9,1,36,41,77,161,159,320,13,14,27,2,3:32
13854,566206,2019-06-01,2019,PIT,MIL,10,12,12-10,MIL,13,0,61,63,124,276,237,513,27,24,51,3,5:23
13855,567306,2019-07-04,2019,CHA,DET,5,11,11-5,DET,9,0,41,44,85,166,163,329,14,16,30,4,3:27
13856,566901,2019-06-20,2019,TOR,ANA,7,5,7-5,TOR,10,0,43,44,87,173,159,332,18,15,33,5,3:34
13857,567403,2019-07-12,2019,MIA,NYN,8,4,8-4,MIA,9,1,34,36,70,154,130,284,12,10,22,2,2:57
13858,566419,2019-07-07,2019,SEA,OAK,4,7,7-4,OAK,9,0,37,38,75,148,161,309,11,11,22,3,3:15
13859,566132,2019-07-14,2019,OAK,CHA,3,2,3-2,OAK,9,0,34,33,67,131,140,271,9,8,17,1,2:47
13860,565458,2019-07-12,2019,COL,CIN,3,2,3-2,COL,9,1,34,32,66,122,127,249,11,6,17,1,2:40
13861,567005,2019-07-16,2019,MIN,NYN,2,3,3-2,NYN,9,0,39,35,74,123,163,286,15,9,24,3,3:13
13862,566809,2019-07-04,2019,TEX,ANA,9,3,9-3,TEX,9,1,43,39,82,148,175,323,19,12,31,1,3:27
13863,566510,2019-06-28,2019,SFN,ARI,6,3,6-3,SFN,9,1,38,40,78,155,113,268,16,13,29,2,3:07
13864,565070,2019-07-13,2019,BOS,LAN,2,11,11-2,LAN,9,0,33,46,79,198,124,322,7,20,27,2,3:40
13865,565074,2019-07-17,2019,BOS,TOR,5,4,5-4,BOS,9,1,40,40,80,173,150,323,19,13,32,2,3:35 (:33 delay)
13866,565265,2019-07-18,2019,CIN,SLN,4,7,7-4,SLN,9,0,40,38,78,161,149,310,15,15,30,2,3:17
13867,566509,2019-06-26,2019,SFN,COL,3,6,6-3,COL,9,0,36,36,72,148,151,299,11,9,20,1,2:54
13868,567496,2019-06-20,2019,NYA,HOU,10,6,10-6,NYA,9,1,41,42,83,177,188,365,17,15,32,2,3:31 (:37 delay)
13869,567502,2019-06-26,2019,NYA,TOR,8,7,8-7,NYA,9,0,44,40,84,161,193,354,19,17,36,3,3:43
13870,565645,2019-06-26,2019,HOU,PIT,2,14,14-2,PIT,9,0,37,49,86,194,153,347,12,22,34,1,3:17
13871,565253,2019-06-17,2019,CIN,HOU,3,2,3-2,CIN,9,1,34,39,73,161,139,300,11,13,24,5,2:55 (:52 delay)
13872,567591,2019-06-25,2019,MIL,SEA,3,8,8-3,SEA,9,0,39,46,85,196,158,354,10,20,30,1,3:38
13873,565368,2019-07-21,2019,CLE,KCA,5,4,5-4,CLE,9,1,36,37,73,151,119,270,11,10,21,1,2:47
13874,566137,2019-07-27,2019,OAK,TEX,5,4,5-4,OAK,9,1,33,38,71,144,124,268,9,12,21,3,2:51
13875,565656,2019-07-22,2019,HOU,OAK,11,1,11-1,HOU,9,1,47,31,78,129,184,313,23,3,26,1,2:56
13876,566329,2019-07-30,2019,SDN,BAL,5,8,8-5,BAL,9,0,39,43,82,171,146,317,12,16,28,1,3:22
13877,566026,2019-06-29,2019,NYN,ATL,4,5,5-4,ATL,9,0,42,41,83,143,166,309,14,16,30,3,3:39 (1:33 delay)
13878,567596,2019-06-30,2019,MIL,PIT,2,1,2-1,MIL,9,1,39,32,71,145,167,312,17,9,26,3,3:40
13879,566811,2019-07-12,2019,TEX,HOU,9,8,9-8,TEX,9,0,42,38,80,142,170,312,15,12,27,3,3:07
13880,566995,2019-06-16,2019,MIN,KCA,6,8,8-6,KCA,9,0,48,42,90,152,202,354,22,12,34,4,4:00
13881,565648,2019-06-29,2019,HOU,SEA,6,5,6-5,HOU,10,0,41,42,83,185,161,346,13,13,26,1,3:38
13882,565452,2019-06-27,2019,COL,LAN,8,12,12-8,LAN,9,0,45,46,91,184,155,339,19,19,38,2,3:32
13883,565365,2019-07-18,2019,CLE,DET,6,3,6-3,CLE,9,1,33,36,69,158,137,295,10,10,20,4,3:06
13884,565269,2019-07-26,2019,CIN,COL,2,12,12-2,COL,9,0,33,44,77,161,115,276,8,19,27,0,2:47
13885,567312,2019-07-25,2019,CHA,MIN,3,10,10-3,MIN,9,0,36,41,77,162,139,301,9,15,24,0,3:01
13886,565457,2019-07-03,2019,COL,HOU,2,4,4-2,HOU,9,0,36,35,71,113,156,269,9,10,19,1,2:41
13887,566414,2019-07-02,2019,SEA,SLN,5,4,5-4,SEA,9,1,38,36,74,157,161,318,15,11,26,6,3:18
13888,564976,2019-07-16,2019,BAL,WAS,1,8,8-1,WAS,9,0,35,43,78,190,129,319,9,16,25,1,3:10
13889,565069,2019-07-12,2019,BOS,LAN,8,1,8-1,BOS,9,1,35,34,69,126,131,257,12,7,19,2,2:52 (1:00 delay)
13890,566716,2019-07-23,2019,TBA,BOS,4,5,5-4,BOS,9,0,39,39,78,138,175,313,12,14,26,3,3:19
13891,565273,2019-07-30,2019,CIN,PIT,4,11,11-4,PIT,9,0,38,44,82,183,136,319,10,18,28,3,3:35
13892,567103,2019-07-12,2019,PHI,WAS,0,4,4-0,WAS,9,0,36,41,77,160,153,313,10,14,24,0,3:15
13893,565840,2019-06-22,2019,LAN,COL,5,4,5-4,LAN,11,0,47,43,90,177,195,372,17,10,27,2,4:15
13894,565062,2019-06-22,2019,BOS,TOR,7,8,8-7,TOR,9,0,40,42,82,197,172,369,14,15,29,3,3:50 (:25 delay)
13895,566314,2019-06-18,2019,SDN,MIL,4,1,4-1,SDN,9,1,36,32,68,121,130,251,12,8,20,0,2:43
13896,567007,2019-07-18,2019,MIN,OAK,6,3,6-3,MIN,9,1,34,37,71,132,128,260,14,8,22,2,3:18
13897,564973,2019-07-12,2019,BAL,TBA,4,16,16-4,TBA,9,0,35,49,84,163,128,291,7,21,28,1,2:49
13898,566714,2019-07-21,2019,TBA,CHA,4,2,4-2,TBA,9,1,30,34,64,167,137,304,8,8,16,1,3:07
13899,565462,2019-07-16,2019,COL,SFN,4,8,8-4,SFN,10,0,39,44,83,173,149,322,10,17,27,3,3:33
13900,564786,2019-07-27,2019,ANA,BAL,7,8,8-7,BAL,9,0,40,42,82,154,162,316,13,18,31,3,3:24
13901,565555,2019-07-07,2019,DET,BOS,3,6,6-3,BOS,9,0,37,38,75,152,187,339,10,12,22,1,3:30
13902,565456,2019-07-02,2019,COL,HOU,8,9,9-8,HOU,9,0,44,42,86,145,174,319,17,15,32,2,3:27
13903,565647,2019-06-28,2019,HOU,SEA,2,1,2-1,HOU,10,0,41,39,80,164,181,345,14,9,23,1,3:27
13904,566814,2019-07-16,2019,TEX,ARI,2,9,9-2,ARI,9,0,34,40,74,160,135,295,9,12,21,4,3:23
13905,567317,2019-07-31,2019,CHA,NYN,2,4,4-2,NYN,9,0,38,39,77,144,159,303,11,11,22,1,3:27
13906,566425,2019-07-24,2019,SEA,TEX,5,3,5-3,SEA,9,1,33,35,68,117,135,252,10,9,19,0,2:25
13907,567500,2019-06-24,2019,NYA,TOR,10,8,10-8,NYA,9,1,44,43,87,175,167,342,20,16,36,5,3:42
13908,565072,2019-07-15,2019,BOS,TOR,10,8,10-8,BOS,9,1,44,42,86,160,161,321,21,14,35,3,3:28
13909,566913,2019-07-23,2019,TOR,CLE,2,1,2-1,TOR,10,0,39,38,77,151,162,313,12,9,21,3,3:19
13910,565941,2019-07-07,2019,WAS,KCA,5,2,5-2,WAS,9,1,34,35,69,142,123,265,11,9,20,2,2:37
13911,565359,2019-07-12,2019,CLE,MIN,3,5,5-3,MIN,9,0,35,39,74,174,161,335,9,13,22,4,3:44
13912,566708,2019-07-04,2019,TBA,NYA,4,8,8-4,NYA,10,0,46,41,87,168,200,368,16,12,28,4,4:14
13913,565172,2019-07-15,2019,CHN,CIN,3,6,6-3,CIN,9,0,39,41,80,160,159,319,14,13,27,2,3:17
13914,566912,2019-07-22,2019,TOR,CLE,3,7,7-3,CLE,9,0,31,46,77,169,124,293,8,19,27,2,2:55
13915,566620,2019-07-31,2019,SLN,CHN,0,2,2-0,CHN,9,0,36,37,73,148,132,280,9,11,20,3,3:14
13916,565430,2019-07-15,2019,COL,SFN,2,19,19-2,SFN,9,0,36,52,88,199,145,344,9,25,34,3,3:15
13917,566703,2019-06-29,2019,TBA,TEX,5,2,5-2,TBA,9,1,34,34,68,151,141,292,10,7,17,0,2:56
13918,566615,2019-07-17,2019,SLN,PIT,6,5,6-5,SLN,9,1,35,39,74,144,148,292,10,14,24,2,3:11
13919,567104,2019-07-13,2019,PHI,WAS,3,4,4-3,WAS,9,0,36,41,77,166,161,327,10,14,24,3,3:43
13920,566900,2019-06-19,2019,TOR,ANA,6,11,11-6,ANA,9,0,40,48,88,184,177,361,13,20,33,4,3:46
13921,564776,2019-06-30,2019,ANA,OAK,3,12,12-3,OAK,9,0,38,42,80,165,144,309,11,16,27,5,3:18
13922,565061,2019-06-21,2019,BOS,TOR,7,5,7-5,BOS,10,0,45,46,91,190,177,367,17,18,35,4,3:58
13923,567004,2019-07-07,2019,MIN,TEX,1,4,4-1,TEX,11,0,44,46,90,192,173,365,11,15,26,3,4:15
13924,564881,2019-07-24,2019,ARI,BAL,5,2,5-2,ARI,9,1,43,39,82,162,174,336,19,12,31,3,3:24
13925,565268,2019-07-21,2019,CIN,SLN,1,3,3-1,SLN,9,0,38,35,73,165,164,329,11,8,19,2,3:22
13926,565175,2019-07-19,2019,CHN,SDN,6,5,6-5,CHN,9,1,35,43,78,165,123,288,12,16,28,1,3:12
13927,566906,2019-07-02,2019,TOR,BOS,6,10,10-6,BOS,9,0,40,43,83,158,164,322,14,17,31,1,3:18
13928,564783,2019-07-18,2019,ANA,HOU,2,6,6-2,HOU,9,0,36,38,74,125,151,276,9,13,22,1,2:35
13929,567602,2019-07-17,2019,MIL,ATL,5,4,5-4,MIL,9,1,32,41,73,174,123,297,9,13,22,2,3:07
13930,566709,2019-07-05,2019,TBA,NYA,4,8,8-4,NYA,11,0,47,44,91,166,178,344,15,14,29,2,3:46
13931,566808,2019-07-03,2019,TEX,ANA,2,6,6-2,ANA,9,0,34,38,72,149,148,297,6,13,19,1,2:55
13932,566715,2019-07-22,2019,TBA,BOS,4,9,9-4,BOS,9,0,40,42,82,152,165,317,14,15,29,2,3:20
13933,566523,2019-07-24,2019,SFN,CHN,1,4,4-1,CHN,9,0,37,38,75,144,134,278,10,12,22,2,2:58
13934,566228,2019-07-24,2019,PIT,SLN,8,14,14-8,SLN,9,0,43,47,90,169,162,331,16,21,37,2,3:17
13935,565455,2019-06-30,2019,COL,LAN,5,10,10-5,LAN,9,0,38,47,85,186,177,363,12,20,32,4,4:01
13936,566411,2019-06-21,2019,SEA,BAL,10,9,10-9,SEA,9,1,45,39,84,144,179,323,21,14,35,4,3:18
13937,566216,2019-07-01,2019,PIT,CHN,18,5,18-5,PIT,9,1,50,42,92,141,154,295,27,17,44,2,3:15
13938,566029,2019-07-03,2019,NYN,NYA,1,5,5-1,NYA,9,0,34,40,74,181,137,318,7,14,21,2,3:17
13939,566321,2019-07-03,2019,SDN,SFN,5,7,7-5,SFN,9,0,38,39,77,148,138,286,12,13,25,2,3:00
13940,566815,2019-07-17,2019,TEX,ARI,4,19,19-4,ARI,9,0,35,59,94,213,142,355,8,32,40,2,3:14
13941,567406,2019-07-16,2019,MIA,SDN,12,7,12-7,MIA,9,1,42,41,83,179,161,340,19,15,34,2,3:14
13942,567605,2019-07-24,2019,MIL,CIN,5,4,5-4,MIL,9,1,35,38,73,162,146,308,13,11,24,3,3:15
13943,567305,2019-07-03,2019,CHA,DET,9,6,9-6,CHA,12,0,48,49,97,170,192,362,13,17,30,2,3:48
13944,567302,2019-06-29,2019,CHA,MIN,3,10,10-3,MIN,9,0,37,42,79,163,153,316,9,16,25,1,3:14
13945,565361,2019-07-14,2019,CLE,MIN,4,3,4-3,CLE,9,1,34,38,72,151,131,282,10,10,20,2,3:00
13946,567111,2019-07-27,2019,PHI,ATL,7,15,15-7,ATL,9,0,42,50,92,195,158,353,16,23,39,3,3:34
13947,566220,2019-07-05,2019,PIT,MIL,6,7,7-6,MIL,10,0,47,48,95,182,185,367,17,21,38,4,4:13
13948,566807,2019-07-02,2019,TEX,ANA,4,9,9-4,ANA,9,0,36,50,86,249,160,409,10,21,31,4,4:12
13949,564877,2019-07-20,2019,ARI,MIL,3,8,8-3,MIL,9,0,35,42,77,158,143,301,9,17,26,3,3:17
13950,566128,2019-07-03,2019,OAK,MIN,3,4,4-3,MIN,12,0,50,49,99,198,195,393,16,14,30,3,4:40
13951,566033,2019-07-23,2019,NYN,SDN,5,2,5-2,NYN,9,1,35,38,73,171,123,294,12,12,24,3,3:02
13952,566315,2019-06-19,2019,SDN,MIL,8,7,8-7,SDN,9,1,39,41,80,162,141,303,17,14,31,3,3:24
13953,565453,2019-06-28,2019,COL,LAN,13,9,13-9,COL,9,1,44,45,89,159,159,318,21,17,38,3,3:31 (:19 delay)
13954,566617,2019-07-27,2019,SLN,HOU,2,8,8-2,HOU,9,0,36,42,78,169,131,300,10,17,27,1,3:07
13955,565266,2019-07-19,2019,CIN,SLN,11,12,12-11,SLN,9,0,47,41,88,172,182,354,22,14,36,5,3:49
13956,567588,2019-06-21,2019,MIL,CIN,7,11,11-7,CIN,9,0,46,47,93,208,207,415,20,20,40,4,4:08
13957,566604,2019-06-20,2019,SLN,MIA,6,7,7-6,MIA,11,0,51,47,98,174,206,380,19,17,36,4,4:31
13958,567402,2019-06-30,2019,MIA,PHI,6,13,13-6,PHI,9,0,39,47,86,186,144,330,12,21,33,1,3:36
13959,564866,2019-06-21,2019,ARI,SFN,5,11,11-5,SFN,9,0,40,43,83,150,149,299,14,18,32,3,3:09
13960,567506,2019-07-15,2019,NYA,TBA,4,5,5-4,TBA,9,0,39,38,77,162,187,349,13,14,27,2,3:42
13961,564979,2019-07-20,2019,BAL,BOS,6,17,17-6,BOS,9,0,43,50,93,179,173,352,16,23,39,2,3:29
13962,566038,2019-07-28,2019,NYN,PIT,8,7,8-7,NYN,9,1,40,42,82,166,153,319,15,14,29,2,3:21
13963,567511,2019-07-20,2019,NYA,COL,11,5,11-5,NYA,9,1,44,35,79,124,202,326,20,8,28,3,3:33
13964,565849,2019-07-20,2019,LAN,MIA,10,6,10-6,LAN,9,1,41,38,79,165,175,340,19,10,29,4,3:27
13965,565259,2019-07-01,2019,CIN,MIL,6,8,8-6,MIL,9,0,37,42,79,177,129,306,11,16,27,2,3:10
13966,566898,2019-06-17,2019,TOR,ANA,5,10,10-5,ANA,9,0,37,45,82,169,129,298,11,19,30,3,3:06
13967,565073,2019-07-16,2019,BOS,TOR,4,10,10-4,TOR,9,0,41,42,83,158,166,324,16,18,34,5,3:45
13968,565945,2019-07-25,2019,WAS,COL,7,8,8-7,COL,9,0,42,41,83,177,171,348,16,15,31,3,3:46
13969,566513,2019-06-30,2019,SFN,ARI,10,4,10-4,SFN,9,1,42,37,79,154,154,308,19,10,29,2,3:09
13970,565933,2019-06-21,2019,WAS,ATL,4,3,4-3,WAS,9,1,37,38,75,146,143,289,13,12,25,1,3:01
13971,566612,2019-07-14,2019,SLN,ARI,5,2,5-2,SLN,9,1,33,39,72,146,115,261,10,13,23,2,2:52
13972,565745,2019-07-04,2019,KCA,CLE,4,8,8-4,CLE,9,0,38,41,79,183,156,339,10,18,28,4,3:30 (2:30 delay)
13973,566813,2019-07-14,2019,TEX,HOU,4,12,12-4,HOU,9,0,36,49,85,219,163,382,10,21,31,2,3:40
13974,566713,2019-07-20,2019,TBA,CHA,1,2,2-1,CHA,11,0,44,41,85,154,166,320,12,10,22,3,3:38
13975,567599,2019-07-14,2019,MIL,SFN,3,8,8-3,SFN,9,0,37,43,80,181,142,323,10,18,28,3,3:26
13976,564781,2019-07-16,2019,ANA,HOU,7,2,7-2,ANA,9,1,37,43,80,169,155,324,14,18,32,4,3:33
13977,565556,2019-07-19,2019,DET,TOR,1,12,12-1,TOR,9,0,35,47,82,198,135,333,8,20,28,2,3:20
13978,567514,2019-07-31,2019,NYA,ARI,7,5,7-5,NYA,9,1,35,42,77,189,143,332,11,15,26,5,3:43 (:36 delay)
13979,565460,2019-07-14,2019,COL,CIN,10,9,10-9,COL,9,1,39,38,77,143,141,284,14,12,26,2,3:05
13980,565652,2019-07-07,2019,HOU,ANA,11,10,11-10,HOU,10,0,55,50,105,197,223,420,28,20,48,4,4:49
13981,565741,2019-06-22,2019,KCA,MIN,3,5,5-3,MIN,10,0,42,41,83,127,142,269,15,12,27,1,2:56
13982,567589,2019-06-22,2019,MIL,CIN,6,5,6-5,MIL,9,1,36,35,71,136,159,295,11,8,19,3,3:00
13983,567597,2019-07-12,2019,MIL,SFN,7,10,10-7,SFN,10,0,46,41,87,169,164,333,19,11,30,1,3:33
13984,566123,2019-06-20,2019,OAK,TBA,5,4,5-4,OAK,9,0,38,36,74,127,164,291,14,8,22,3,3:01
13985,567002,2019-07-05,2019,MIN,TEX,15,6,15-6,MIN,9,1,45,37,82,139,160,299,23,12,35,3,3:02 (1:12 delay)
13986,566917,2019-07-28,2019,TOR,TBA,9,10,10-9,TBA,9,0,45,45,90,200,182,382,18,20,38,6,4:10
13987,566318,2019-06-30,2019,SDN,SLN,3,5,5-3,SLN,11,0,45,45,90,177,189,366,14,14,28,5,4:07
13988,567106,2019-07-15,2019,PHI,LAN,2,16,16-2,LAN,9,0,39,53,92,191,143,334,10,25,35,2,3:25
13989,567214,2019-07-18,2019,ATL,WAS,4,13,13-4,WAS,9,0,38,49,87,202,156,358,12,23,35,2,3:44
13990,566800,2019-06-18,2019,TEX,CLE,3,10,10-3,CLE,9,0,35,47,82,172,146,318,10,19,29,2,3:13
13991,567215,2019-07-19,2019,ATL,WAS,4,3,4-3,ATL,9,0,40,35,75,140,177,317,19,8,27,2,3:30
13992,565264,2019-07-07,2019,CIN,CLE,1,11,11-1,CLE,9,0,36,48,84,184,144,328,9,21,30,3,3:24
13993,565939,2019-07-05,2019,WAS,KCA,4,7,7-4,KCA,11,0,56,51,107,195,221,416,27,19,46,4,4:40
13994,565080,2019-07-30,2019,BOS,TBA,5,6,6-5,TBA,9,0,43,44,87,177,169,346,17,17,34,7,4:05
13995,566410,2019-06-20,2019,SEA,BAL,5,2,5-2,SEA,9,1,37,35,72,144,169,313,13,10,23,3,3:16
13996,565554,2019-07-06,2019,DET,BOS,6,10,10-6,BOS,9,0,43,49,92,189,183,372,16,21,37,4,3:51 (4:05 delay)
13997,565067,2019-06-29,2019,BOS,NYA,13,17,17-13,NYA,9,0,50,51,101,208,214,422,24,25,49,8,4:42
13998,565064,2019-06-24,2019,BOS,CHA,6,5,6-5,BOS,9,0,43,38,81,153,165,318,22,13,35,6,3:36
13999,567598,2019-07-13,2019,MIL,SFN,5,4,5-4,MIL,9,0,43,39,82,182,183,365,18,12,30,2,3:54
14000,566131,2019-07-13,2019,OAK,CHA,13,2,13-2,OAK,9,1,44,37,81,140,199,339,22,10,32,2,3:25
14001,566997,2019-06-18,2019,MIN,BOS,4,3,4-3,MIN,17,0,69,68,137,228,259,487,23,21,44,0,5:45
14002,567001,2019-06-27,2019,MIN,TBA,2,5,5-2,TBA,18,0,65,70,135,268,233,501,15,16,31,2,5:42 (:57 delay)
14003,566517,2019-07-18,2019,SFN,NYN,3,2,3-2,SFN,16,0,62,60,122,211,242,453,20,17,37,1,4:47
14004,565753,2019-07-25,2019,KCA,CLE,4,5,5-4,CLE,14,0,60,64,124,210,251,461,19,27,46,6,4:51
14005,565071,2019-07-14,2019,BOS,LAN,4,7,7-4,LAN,12,0,53,55,108,261,196,457,19,19,38,3,5:40
14006,564784,2019-07-25,2019,ANA,BAL,8,10,10-8,BAL,16,0,69,70,139,291,280,571,23,22,45,5,6:19
14007,566238,2019-08-18,2019,PIT,CHN,1,7,7-1,CHN,9,0,36,42,78,179,131,310,9,16,25,2,3:20
14008,567220,2019-08-01,2019,ATL,CIN,4,1,4-1,ATL,7,1,28,21,49,76,115,191,10,4,14,1,2:08 (1:46 delay)
14009,565376,2019-08-07,2019,CLE,TEX,5,1,5-1,CLE,9,1,34,29,63,111,153,264,13,4,17,3,2:55
14010,565086,2019-08-08,2019,BOS,ANA,3,0,3-0,BOS,9,1,29,29,58,115,118,233,6,2,8,0,2:16
14011,566047,2019-08-22,2019,NYN,CLE,2,0,2-0,NYN,8,0,28,27,55,102,101,203,7,3,10,1,2:08 (3:04 delay)
14012,567318,2019-08-01,2019,CHA,NYN,0,4,4-0,NYN,9,0,31,35,66,140,115,255,5,11,16,1,2:32
14013,566434,2019-08-11,2019,SEA,TBA,0,1,1-0,TBA,9,0,30,32,62,120,101,221,3,6,9,1,2:23
14014,566623,2019-08-10,2019,SLN,PIT,3,1,3-1,SLN,9,1,30,35,65,123,119,242,10,8,18,2,2:40
14015,564882,2019-08-02,2019,ARI,WAS,0,3,3-0,WAS,9,0,32,35,67,129,126,255,6,9,15,1,2:43
14016,566529,2019-08-10,2019,SFN,PHI,3,1,3-1,SFN,9,1,31,30,61,122,117,239,8,4,12,0,2:32
14017,565473,2019-08-16,2019,COL,MIA,3,0,3-0,COL,9,1,32,32,64,112,107,219,9,6,15,0,2:12 (:20 delay)
14018,565666,2019-08-21,2019,HOU,DET,1,2,2-1,DET,9,0,33,29,62,99,143,242,8,2,10,0,2:12
14019,565186,2019-08-22,2019,CHN,SFN,1,0,1-0,CHN,9,1,26,30,56,132,108,240,3,4,7,2,2:29
14020,564992,2019-08-20,2019,BAL,KCA,4,1,4-1,BAL,9,1,34,33,67,116,121,237,11,8,19,0,2:19 (:13 delay)
14021,566927,2019-08-18,2019,TOR,SEA,0,7,7-0,SEA,9,0,29,39,68,151,96,247,3,16,19,1,2:25
14022,567522,2019-08-16,2019,NYA,CLE,3,2,3-2,NYA,9,1,36,33,69,117,119,236,13,5,18,3,2:39
14023,565855,2019-08-03,2019,LAN,SDN,4,1,4-1,LAN,9,1,33,31,64,110,118,228,9,5,14,0,2:18
14024,566041,2019-08-07,2019,NYN,MIA,7,2,7-2,NYN,9,1,36,35,71,137,116,253,12,11,23,2,2:26
14025,565371,2019-08-01,2019,CLE,HOU,1,7,7-1,HOU,9,0,34,45,79,167,121,288,9,20,29,3,3:10
14026,566621,2019-08-01,2019,SLN,CHN,8,0,8-0,SLN,9,1,40,30,70,122,155,277,16,3,19,2,2:53
14027,566237,2019-08-17,2019,PIT,CHN,0,2,2-0,CHN,9,0,38,33,71,114,139,253,11,8,19,2,2:45
14028,567325,2019-08-22,2019,CHA,TEX,6,1,6-1,CHA,9,1,34,30,64,136,112,248,11,4,15,0,2:29
14029,565377,2019-08-07,2019,CLE,TEX,2,0,2-0,CLE,9,1,28,34,62,147,113,260,5,8,13,0,2:32
14030,567425,2019-08-25,2019,MIA,PHI,3,2,3-2,MIA,9,1,29,31,60,123,117,240,7,5,12,1,2:38
14031,566625,2019-08-19,2019,SLN,MIL,3,0,3-0,SLN,9,1,31,34,65,145,113,258,8,7,15,2,2:43
14032,567515,2019-08-02,2019,NYA,BOS,4,2,4-2,NYA,9,1,32,33,65,132,129,261,11,6,17,1,2:41
14033,565573,2019-08-29,2019,DET,CLE,0,2,2-0,CLE,9,0,30,36,66,152,122,274,4,11,15,0,2:34
14034,567231,2019-08-21,2019,ATL,MIA,5,0,5-0,ATL,9,1,30,36,66,125,131,256,8,11,19,0,2:44
14035,567516,2019-08-03,2019,NYA,BOS,9,2,9-2,NYA,9,1,40,32,72,123,137,260,17,5,22,1,2:40
14036,566720,2019-08-05,2019,TBA,TOR,0,2,2-0,TOR,9,0,34,36,70,136,130,266,7,9,16,2,2:45
14037,566527,2019-08-08,2019,SFN,PHI,5,0,5-0,SFN,9,1,37,29,66,113,154,267,16,3,19,0,2:49
14038,565375,2019-08-05,2019,CLE,TEX,0,1,1-0,TEX,9,0,35,33,68,135,136,271,9,8,17,0,2:49
14039,565565,2019-08-09,2019,DET,KCA,5,2,5-2,DET,9,1,37,36,73,129,141,270,15,10,25,2,2:27
14040,566925,2019-08-16,2019,TOR,SEA,7,3,7-3,TOR,9,1,34,33,67,153,108,261,12,10,22,3,2:37
14041,564996,2019-08-24,2019,BAL,TBA,7,1,7-1,BAL,9,1,35,34,69,128,135,263,13,6,19,1,2:38
14042,566240,2019-08-20,2019,PIT,WAS,4,1,4-1,PIT,9,1,33,36,69,136,115,251,11,12,23,3,3:00
14043,567322,2019-08-13,2019,CHA,HOU,4,1,4-1,CHA,9,1,35,31,66,104,114,218,12,5,17,0,2:21
14044,566723,2019-08-16,2019,TBA,DET,0,2,2-0,DET,9,0,33,33,66,119,136,255,9,6,15,0,2:29
14045,567221,2019-08-02,2019,ATL,CIN,2,5,5-2,CIN,9,0,31,41,72,158,131,289,5,14,19,2,3:01
14046,565373,2019-08-03,2019,CLE,ANA,7,2,7-2,CLE,9,1,34,36,70,144,136,280,10,10,20,6,2:59
14047,565467,2019-08-02,2019,COL,SFN,5,4,5-4,COL,9,1,37,38,75,123,124,247,16,13,29,2,2:50
14048,567015,2019-08-03,2019,MIN,KCA,11,3,11-3,MIN,9,1,38,35,73,132,141,273,14,7,21,2,2:53
14049,567232,2019-08-22,2019,ATL,MIA,3,2,3-2,ATL,9,0,37,33,70,127,133,260,10,6,16,0,2:40
14050,565572,2019-08-28,2019,DET,CLE,2,4,4-2,CLE,9,0,32,37,69,158,118,276,7,12,19,0,2:33
14051,565763,2019-08-17,2019,KCA,NYN,1,4,4-1,NYN,9,0,32,41,73,131,133,264,6,17,23,2,2:35
14052,565865,2019-08-22,2019,LAN,TOR,3,2,3-2,LAN,9,0,33,32,65,124,128,252,8,6,14,1,2:46
14053,567322,2019-08-13,2019,CHA,HOU,4,1,4-1,CHA,9,1,35,31,66,104,114,218,12,5,17,0,2:21
14054,566236,2019-08-16,2019,PIT,CHN,3,2,3-2,PIT,9,0,34,33,67,121,127,248,10,7,17,2,2:49
14055,566141,2019-08-01,2019,OAK,MIL,5,3,5-3,OAK,9,1,35,40,75,148,157,305,12,12,24,1,3:13
14056,566818,2019-08-02,2019,TEX,DET,5,4,5-4,TEX,9,1,36,40,76,164,113,277,12,13,25,1,2:52
14057,565376,2019-08-07,2019,CLE,TEX,5,1,5-1,CLE,9,1,34,29,63,111,153,264,13,4,17,3,2:55
14058,567120,2019-08-14,2019,PHI,CHN,11,1,11-1,PHI,9,1,40,31,71,131,133,264,18,5,23,1,2:45
14059,566622,2019-08-09,2019,SLN,PIT,6,2,6-2,SLN,9,1,34,36,70,120,139,259,11,12,23,3,2:52
14060,565281,2019-08-15,2019,CIN,SLN,2,1,2-1,CIN,9,1,34,35,69,155,119,274,11,8,19,2,3:01
14061,565862,2019-08-11,2019,LAN,ARI,9,3,9-3,LAN,9,1,40,37,77,130,126,256,19,11,30,0,2:40
14062,566535,2019-08-29,2019,SFN,SDN,3,5,5-3,SDN,9,0,36,34,70,111,139,250,10,9,19,0,2:28
14063,566051,2019-08-27,2019,NYN,CHN,2,5,5-2,CHN,9,0,34,37,71,146,119,265,7,13,20,0,2:54
14064,565767,2019-08-28,2019,KCA,OAK,6,4,6-4,KCA,9,1,36,38,74,141,120,261,14,11,25,1,2:33
14065,566045,2019-08-20,2019,NYN,CLE,9,2,9-2,NYN,9,1,37,36,73,129,134,263,12,8,20,2,2:41
14066,567117,2019-08-03,2019,PHI,CHA,3,2,3-2,PHI,9,1,33,35,68,136,130,266,9,7,16,2,3:05
14067,565278,2019-08-09,2019,CIN,CHN,5,2,5-2,CIN,9,1,30,38,68,144,116,260,6,11,17,1,2:44
14068,566040,2019-08-06,2019,NYN,MIA,5,0,5-0,NYN,9,1,34,35,69,113,136,249,11,11,22,0,2:38
14069,566150,2019-08-22,2019,OAK,NYA,5,3,5-3,OAK,9,1,34,35,69,132,136,268,12,9,21,1,2:51
14070,566053,2019-08-29,2019,NYN,CHN,1,4,4-1,CHN,9,0,35,33,68,127,136,263,8,7,15,0,2:35
14071,564995,2019-08-23,2019,BAL,TBA,1,7,7-1,TBA,9,0,33,38,71,150,125,275,7,14,21,0,2:25
14072,566333,2019-08-11,2019,SDN,COL,3,8,8-3,COL,9,0,35,46,81,165,117,282,9,19,28,2,3:03
14073,565179,2019-08-03,2019,CHN,MIL,4,1,4-1,CHN,9,1,36,35,71,140,128,268,13,9,22,4,3:08
14074,566531,2019-08-13,2019,SFN,OAK,3,2,3-2,SFN,9,1,32,32,64,151,132,283,9,6,15,1,2:45
14075,567022,2019-08-10,2019,MIN,CLE,4,1,4-1,MIN,9,1,34,38,72,158,122,280,12,12,24,2,3:07 (1:51 delay)
14076,565287,2019-08-21,2019,CIN,SDN,4,2,4-2,CIN,9,1,38,32,70,148,136,284,13,6,19,1,2:52
14077,566923,2019-08-13,2019,TOR,TEX,3,0,3-0,TOR,9,1,34,37,71,144,145,289,10,10,20,0,2:48
14078,566806,2019-08-20,2019,TEX,ANA,1,5,5-1,ANA,9,0,32,39,71,163,118,281,5,13,18,1,2:48
14079,565958,2019-08-27,2019,WAS,BAL,0,2,2-0,BAL,9,0,35,32,67,126,160,286,8,6,14,1,2:52
14080,566039,2019-08-05,2019,NYN,MIA,6,2,6-2,NYN,9,1,38,35,73,135,133,268,14,9,23,0,2:51
14081,564799,2019-08-28,2019,ANA,TEX,0,3,3-0,TEX,9,0,31,40,71,171,110,281,6,13,19,2,2:55
14082,565661,2019-08-04,2019,HOU,SEA,3,1,3-1,HOU,9,1,32,33,65,146,139,285,8,6,14,2,2:56
14083,566243,2019-08-23,2019,PIT,CIN,3,2,3-2,PIT,9,0,36,36,72,145,120,265,11,10,21,1,2:53
14084,567611,2019-08-11,2019,MIL,TEX,0,1,1-0,TEX,9,0,32,34,66,131,121,252,5,9,14,0,2:28
14085,564887,2019-08-07,2019,ARI,PHI,6,1,6-1,ARI,9,1,39,33,72,158,140,298,18,9,27,1,3:10
14086,566431,2019-08-07,2019,SEA,SDN,3,2,3-2,SEA,9,1,32,37,69,157,138,295,8,11,19,1,3:05
14087,567517,2019-08-04,2019,NYA,BOS,7,4,7-4,NYA,9,1,38,36,74,157,144,301,14,11,25,2,3:18 (1:09 delay)
14088,564797,2019-08-18,2019,ANA,CHA,9,2,9-2,ANA,9,1,40,34,74,135,144,279,18,10,28,1,2:55
14089,566330,2019-08-08,2019,SDN,COL,9,3,9-3,SDN,9,1,38,38,76,142,128,270,12,15,27,3,3:14
14090,564794,2019-08-15,2019,ANA,CHA,8,7,8-7,ANA,9,1,39,36,75,130,148,278,14,9,23,3,2:56
14091,565668,2019-08-23,2019,HOU,ANA,5,4,5-4,HOU,9,1,36,37,73,124,150,274,15,11,26,3,3:07
14092,565372,2019-08-02,2019,CLE,ANA,7,3,7-3,CLE,9,1,36,38,74,156,128,284,13,12,25,2,2:55
14093,567230,2019-08-20,2019,ATL,MIA,5,1,5-1,ATL,9,1,37,36,73,143,135,278,12,10,22,0,3:00
14094,564793,2019-08-14,2019,ANA,PIT,7,4,7-4,ANA,9,1,35,36,71,130,149,279,12,11,23,0,3:06
14095,565469,2019-08-04,2019,COL,SFN,6,2,6-2,COL,9,1,37,33,70,133,145,278,16,8,24,1,2:52
14096,567328,2019-08-25,2019,CHA,TEX,2,0,2-0,CHA,9,1,36,34,70,139,136,275,12,7,19,1,2:57
14097,565858,2019-08-06,2019,LAN,SLN,3,1,3-1,LAN,9,1,33,36,69,145,128,273,9,9,18,2,2:55
14098,566433,2019-08-10,2019,SEA,TBA,4,5,5-4,TBA,9,0,36,35,71,130,145,275,10,8,18,0,2:39
14099,567025,2019-08-20,2019,MIN,CHA,14,4,14-4,MIN,9,1,41,32,73,115,141,256,17,6,23,2,2:55
14100,566926,2019-08-17,2019,TOR,SEA,3,4,4-3,SEA,9,0,37,35,72,122,148,270,12,11,23,3,2:48
14101,566628,2019-08-22,2019,SLN,COL,6,5,6-5,SLN,9,1,36,37,73,129,142,271,14,10,24,1,2:52 (:52 delay)
14102,567326,2019-08-23,2019,CHA,TEX,8,3,8-3,CHA,9,1,38,33,71,134,151,285,14,6,20,2,2:50
14103,566144,2019-08-15,2019,OAK,HOU,7,6,7-6,OAK,9,1,33,35,68,128,120,248,10,9,19,3,2:35
14104,565854,2019-08-02,2019,LAN,SDN,2,5,5-2,SDN,9,0,31,39,70,163,140,303,4,15,19,1,3:06
14105,564983,2019-08-03,2019,BAL,TOR,6,4,6-4,BAL,9,1,35,37,72,154,137,291,10,13,23,4,2:59
14106,564884,2019-08-04,2019,ARI,WAS,7,5,7-5,ARI,9,1,37,40,77,137,134,271,14,15,29,3,3:07
14107,565183,2019-08-07,2019,CHN,OAK,10,1,10-1,CHN,9,1,36,31,67,123,122,245,13,4,17,1,2:36
14108,566332,2019-08-10,2019,SDN,COL,8,5,8-5,SDN,9,1,38,39,77,147,141,288,14,11,25,1,2:55
14109,567118,2019-08-04,2019,PHI,CHA,5,10,10-5,CHA,9,0,38,39,77,148,147,295,13,12,25,1,3:08
14110,565566,2019-08-10,2019,DET,KCA,0,7,7-0,KCA,9,0,32,38,70,163,137,300,6,10,16,1,2:47
14111,564893,2019-08-20,2019,ARI,COL,8,7,8-7,ARI,9,1,38,39,77,129,143,272,14,14,28,4,3:13
14112,567229,2019-08-18,2019,ATL,LAN,5,3,5-3,ATL,9,1,35,37,72,139,144,283,11,13,24,0,3:11
14113,565864,2019-08-21,2019,LAN,TOR,2,1,2-1,LAN,10,0,38,37,75,140,143,283,14,7,21,1,3:10
14114,566147,2019-08-18,2019,OAK,HOU,1,4,4-1,HOU,9,0,34,41,75,154,114,268,9,15,24,1,2:50
14115,567327,2019-08-24,2019,CHA,TEX,0,4,4-0,TEX,9,0,36,38,74,151,135,286,8,10,18,4,3:06
14116,564795,2019-08-16,2019,ANA,CHA,2,7,7-2,CHA,9,0,38,39,77,140,148,288,10,12,22,4,3:11
14117,567319,2019-08-09,2019,CHA,OAK,0,7,7-0,OAK,9,0,32,42,74,155,121,276,6,17,23,2,2:50
14118,566331,2019-08-09,2019,SDN,COL,7,1,7-1,SDN,9,1,37,35,72,137,142,279,15,8,23,1,3:02
14119,567115,2019-08-01,2019,PHI,SFN,10,2,10-2,PHI,9,1,41,39,80,146,154,300,17,12,29,2,3:04
14120,566043,2019-08-10,2019,NYN,WAS,4,3,4-3,NYN,9,1,32,35,67,129,126,255,8,10,18,1,2:34
14121,564981,2019-08-01,2019,BAL,TOR,2,11,11-2,TOR,9,0,35,47,82,182,143,325,10,20,30,3,3:17
14122,565761,2019-08-14,2019,KCA,SLN,0,6,6-0,SLN,9,0,32,38,70,152,128,280,7,11,18,2,2:38
14123,565853,2019-08-01,2019,LAN,SDN,8,2,8-2,LAN,9,1,37,40,77,144,157,301,15,15,30,1,3:25
14124,564982,2019-08-02,2019,BAL,TOR,2,5,5-2,TOR,9,0,38,38,76,155,152,307,11,12,23,4,3:04
14125,565374,2019-08-04,2019,CLE,ANA,6,2,6-2,CLE,9,1,38,31,69,107,162,269,14,5,19,3,3:00
14126,566630,2019-08-24,2019,SLN,COL,6,0,6-0,SLN,9,1,37,32,69,144,146,290,14,7,21,2,2:59
14127,565570,2019-08-15,2019,DET,SEA,2,7,7-2,SEA,9,0,33,43,76,168,118,286,8,19,27,2,2:51
14128,567124,2019-08-18,2019,PHI,SDN,2,3,3-2,SDN,9,0,33,36,69,141,163,304,6,11,17,2,3:21
14129,567026,2019-08-21,2019,MIN,CHA,0,4,4-0,CHA,9,0,30,40,70,177,115,292,3,13,16,0,3:16
14130,565184,2019-08-20,2019,CHN,SFN,5,3,5-3,CHN,9,1,39,35,74,140,151,291,17,8,25,1,2:57
14131,565091,2019-08-17,2019,BOS,BAL,4,0,4-0,BOS,9,1,34,34,68,140,152,292,11,8,19,2,3:11
14132,566928,2019-08-27,2019,TOR,ATL,3,1,3-1,TOR,9,1,34,39,73,154,131,285,14,13,27,2,2:57
14133,565672,2019-08-28,2019,HOU,TBA,8,6,8-6,HOU,9,1,38,36,74,153,149,302,15,9,24,1,3:09
14134,566627,2019-08-21,2019,SLN,MIL,3,5,5-3,MIL,8,1,30,39,69,158,121,279,9,16,25,3,2:54 (1:06 delay)
14135,566050,2019-08-25,2019,NYN,ATL,1,2,2-1,ATL,9,0,35,32,67,146,146,292,11,5,16,0,2:45
14136,565084,2019-08-06,2019,BOS,KCA,2,6,6-2,KCA,9,0,37,35,72,144,142,286,10,11,21,1,2:48
14137,565762,2019-08-16,2019,KCA,NYN,4,1,4-1,KCA,9,1,35,37,72,133,134,267,12,12,24,2,3:01
14138,567428,2019-08-28,2019,MIA,CIN,0,5,5-0,CIN,9,0,31,34,65,143,141,284,5,8,13,0,2:41
14139,565093,2019-08-20,2019,BOS,PHI,2,3,3-2,PHI,9,0,32,37,69,150,122,272,7,10,17,2,3:17
14140,564894,2019-08-21,2019,ARI,COL,2,7,7-2,COL,9,0,34,39,73,129,142,271,7,15,22,1,2:50
14141,566719,2019-08-04,2019,TBA,MIA,7,2,7-2,TBA,9,1,40,33,73,115,181,296,16,8,24,2,2:53
14142,566148,2019-08-20,2019,OAK,NYA,6,2,6-2,OAK,9,1,34,37,71,144,139,283,13,11,24,2,2:49
14143,567479,2019-08-12,2019,NYA,BAL,8,5,8-5,NYA,9,1,35,38,73,166,138,304,11,12,23,1,2:50
14144,565659,2019-08-02,2019,HOU,SEA,10,2,10-2,HOU,9,1,39,38,77,165,156,321,16,11,27,0,2:57
14145,567227,2019-08-16,2019,ATL,LAN,3,8,8-3,LAN,9,0,37,39,76,138,148,286,11,15,26,2,3:06
14146,566430,2019-08-06,2019,SEA,SDN,4,9,9-4,SDN,9,0,37,39,76,152,149,301,11,12,23,1,2:55
14147,565283,2019-08-17,2019,CIN,SLN,6,1,6-1,CIN,9,1,37,38,75,157,137,294,14,12,26,0,2:59
14148,566827,2019-08-16,2019,TEX,MIN,3,4,4-3,MIN,9,0,38,37,75,148,157,305,13,11,24,1,3:12
14149,566726,2019-08-19,2019,TBA,SEA,3,9,9-3,SEA,9,0,37,40,77,157,141,298,10,14,24,0,3:04
14150,565286,2019-08-20,2019,CIN,SDN,3,2,3-2,CIN,9,1,31,35,66,149,149,298,6,9,15,1,2:56 (:11 delay)
14151,567225,2019-08-14,2019,ATL,NYN,6,4,6-4,ATL,9,1,35,41,76,157,136,293,12,15,27,3,3:15 (1:12 delay)
14152,567520,2019-08-14,2019,NYA,BAL,6,5,6-5,NYA,9,1,34,41,75,167,128,295,10,15,25,3,2:56
14153,565180,2019-08-04,2019,CHN,MIL,7,2,7-2,CHN,9,1,40,36,76,155,142,297,17,9,26,0,3:04
14154,565867,2019-08-24,2019,LAN,NYA,2,1,2-1,LAN,9,1,32,35,67,143,138,281,8,8,16,3,3:19
14155,567017,2019-08-05,2019,MIN,ATL,5,3,5-3,MIN,9,0,34,39,73,153,126,279,9,13,22,1,3:01
14156,565181,2019-08-05,2019,CHN,OAK,6,5,6-5,CHN,9,1,36,37,73,170,115,285,14,11,25,4,3:17
14157,566725,2019-08-18,2019,TBA,DET,5,4,5-4,TBA,9,0,35,39,74,151,150,301,9,13,22,1,3:04
14158,564892,2019-08-19,2019,ARI,COL,5,3,5-3,ARI,9,1,32,39,71,149,127,276,8,15,23,3,2:51
14159,566232,2019-08-04,2019,PIT,NYN,2,13,13-2,NYN,9,0,32,46,78,151,110,261,5,19,24,1,2:51
14160,565859,2019-08-07,2019,LAN,SLN,2,1,2-1,LAN,9,0,35,36,71,141,133,274,9,10,19,3,3:01
14161,566149,2019-08-21,2019,OAK,NYA,6,4,6-4,OAK,9,1,33,41,74,136,124,260,9,15,24,5,3:02
14162,565082,2019-08-01,2019,BOS,TBA,4,9,9-4,TBA,9,0,38,44,82,184,144,328,11,20,31,2,3:20
14163,565663,2019-08-07,2019,HOU,COL,14,3,14-3,HOU,9,1,45,33,78,142,176,318,21,8,29,2,3:05
14164,564791,2019-08-12,2019,ANA,PIT,2,10,10-2,PIT,9,0,39,43,82,150,153,303,12,14,26,0,3:08
14165,567119,2019-08-13,2019,PHI,CHN,4,2,4-2,PHI,9,1,36,37,73,143,140,283,11,11,22,2,3:16
14166,565660,2019-08-03,2019,HOU,SEA,9,0,9-0,HOU,9,1,42,31,73,138,180,318,17,5,22,0,3:02
14167,565857,2019-08-05,2019,LAN,SLN,8,0,8-0,LAN,9,1,41,31,72,122,178,300,18,5,23,1,2:59
14168,567610,2019-08-10,2019,MIL,TEX,3,2,3-2,MIL,9,1,37,34,71,143,164,307,16,8,24,2,3:09
14169,567228,2019-08-17,2019,ATL,LAN,4,3,4-3,ATL,9,1,32,40,72,178,141,319,8,13,21,3,3:17
14170,564891,2019-08-18,2019,ARI,SFN,6,1,6-1,ARI,9,1,37,37,74,154,150,304,13,11,24,3,3:19
14171,566526,2019-08-07,2019,SFN,WAS,1,4,4-1,WAS,9,0,36,38,74,145,158,303,9,14,23,0,2:59
14172,566728,2019-08-21,2019,TBA,SEA,7,6,7-6,TBA,9,0,36,39,75,170,130,300,15,12,27,1,2:58
14173,567330,2019-08-28,2019,CHA,MIN,2,8,8-2,MIN,9,0,37,43,80,152,140,292,11,18,29,1,3:14
14174,566241,2019-08-21,2019,PIT,WAS,1,11,11-1,WAS,9,0,33,47,80,169,106,275,7,19,26,2,2:54
14175,564991,2019-08-19,2019,BAL,KCA,4,5,5-4,KCA,9,0,38,37,75,144,164,308,14,9,23,2,3:05
14176,564985,2019-08-05,2019,BAL,NYA,6,9,9-6,NYA,9,0,40,40,80,148,143,291,15,14,29,3,3:14
14177,565182,2019-08-06,2019,CHN,OAK,4,11,11-4,OAK,9,0,40,43,83,151,130,281,14,17,31,0,2:37
14178,565764,2019-08-18,2019,KCA,NYN,5,11,11-5,NYN,9,0,36,42,78,154,147,301,7,19,26,2,3:01
14179,567021,2019-08-09,2019,MIN,CLE,2,6,6-2,CLE,9,0,37,43,80,160,132,292,10,17,27,2,3:09
14180,565667,2019-08-22,2019,HOU,DET,6,3,6-3,HOU,9,1,38,35,73,138,159,297,15,8,23,2,2:50
14181,566337,2019-08-23,2019,SDN,BOS,0,11,11-0,BOS,9,0,30,45,75,178,114,292,6,16,22,2,3:04
14182,566718,2019-08-03,2019,TBA,MIA,8,6,8-6,TBA,9,1,42,39,81,129,186,315,19,14,33,1,3:19
14183,567416,2019-08-08,2019,MIA,ATL,9,2,9-2,MIA,9,1,40,35,75,158,157,315,17,10,27,2,3:04
14184,566629,2019-08-23,2019,SLN,COL,8,3,8-3,SLN,9,1,43,36,79,146,147,293,19,9,28,1,3:02
14185,565381,2019-08-23,2019,CLE,KCA,4,1,4-1,CLE,9,1,33,33,66,139,139,278,12,9,21,1,2:50
14186,567020,2019-08-08,2019,MIN,CLE,5,7,7-5,CLE,9,0,40,40,80,150,171,321,15,15,30,4,3:39
14187,565178,2019-08-02,2019,CHN,MIL,6,2,6-2,CHN,9,1,43,34,77,127,174,301,18,9,27,2,3:18
14188,565279,2019-08-10,2019,CIN,CHN,10,1,10-1,CIN,9,1,45,38,83,147,157,304,22,12,34,1,3:05
14189,567417,2019-08-09,2019,MIA,ATL,4,8,8-4,ATL,9,0,37,41,78,149,148,297,11,16,27,2,3:19
14190,565665,2019-08-20,2019,HOU,DET,6,3,6-3,HOU,9,1,40,39,79,153,169,322,17,13,30,1,3:03
14191,567614,2019-08-23,2019,MIL,ARI,6,1,6-1,MIL,9,1,40,31,71,143,172,315,17,5,22,1,3:06
14192,567014,2019-08-02,2019,MIN,KCA,11,9,11-9,MIN,9,1,40,41,81,142,149,291,16,15,31,5,3:14
14193,566525,2019-08-06,2019,SFN,WAS,3,5,5-3,WAS,9,0,36,36,72,136,134,270,9,11,20,0,2:45
14194,565378,2019-08-12,2019,CLE,BOS,6,5,6-5,CLE,9,0,39,41,80,149,148,297,16,17,33,3,3:34
14195,567224,2019-08-13,2019,ATL,NYN,5,3,5-3,ATL,9,1,38,39,77,150,138,288,16,14,30,3,3:18
14196,565284,2019-08-18,2019,CIN,SLN,4,5,5-4,SLN,9,0,39,37,76,145,153,298,14,10,24,3,3:03
14197,566007,2019-08-05,2019,NYN,MIA,5,4,5-4,NYN,9,1,35,36,71,134,162,296,12,12,24,2,3:09
14198,566918,2019-08-08,2019,TOR,NYA,6,12,12-6,NYA,9,0,42,44,86,167,154,321,14,17,31,2,3:06
14199,564885,2019-08-05,2019,ARI,PHI,3,7,7-3,PHI,9,0,35,43,78,137,133,270,11,18,29,3,3:05
14200,566230,2019-08-02,2019,PIT,NYN,8,4,8-4,PIT,9,1,39,39,78,155,151,306,16,12,28,2,3:11
14201,565285,2019-08-19,2019,CIN,SDN,2,3,3-2,SDN,9,0,39,34,73,127,169,296,13,6,19,0,3:00
14202,564886,2019-08-06,2019,ARI,PHI,8,4,8-4,ARI,9,1,38,43,81,153,147,300,16,16,32,4,3:19
14203,564988,2019-08-09,2019,BAL,HOU,2,3,3-2,HOU,9,0,36,37,73,149,157,306,11,10,21,3,2:58
14204,567518,2019-08-12,2019,NYA,BAL,11,8,11-8,NYA,9,1,41,38,79,150,154,304,19,12,31,5,2:51
14205,567323,2019-08-13,2019,CHA,HOU,2,6,6-2,HOU,9,0,34,44,78,173,139,312,10,21,31,3,3:17
14206,566336,2019-08-14,2019,SDN,TBA,7,2,7-2,SDN,9,1,40,33,73,164,157,321,17,8,25,2,3:10
14207,565959,2019-08-28,2019,WAS,BAL,8,4,8-4,WAS,9,1,38,37,75,170,136,306,15,11,26,2,3:12
14208,564796,2019-08-17,2019,ANA,CHA,6,5,6-5,ANA,9,1,37,38,75,163,145,308,15,12,27,6,3:37
14209,565768,2019-08-29,2019,KCA,OAK,8,9,9-8,OAK,9,0,43,45,88,151,140,291,15,18,33,4,3:17
14210,567028,2019-08-24,2019,MIN,DET,8,5,8-5,MIN,9,1,37,41,78,157,140,297,13,15,28,2,3:23
14211,565382,2019-08-24,2019,CLE,KCA,4,2,4-2,CLE,9,1,34,38,72,150,146,296,11,10,21,3,3:07
14212,566244,2019-08-24,2019,PIT,CIN,14,0,14-0,PIT,9,1,40,34,74,141,152,293,16,10,26,2,2:45
14213,564989,2019-08-10,2019,BAL,HOU,2,23,23-2,HOU,9,0,36,52,88,169,145,314,9,27,36,2,3:03
14214,567519,2019-08-13,2019,NYA,BAL,8,3,8-3,NYA,9,1,42,33,75,125,171,296,20,7,27,1,2:38
14215,565090,2019-08-16,2019,BOS,BAL,9,1,9-1,BOS,9,1,38,34,72,129,131,260,17,8,25,2,2:41
14216,567019,2019-08-07,2019,MIN,ATL,7,11,11-7,ATL,9,0,43,44,87,148,173,321,15,20,35,2,3:33
14217,566046,2019-08-21,2019,NYN,CLE,4,3,4-3,NYN,10,0,42,40,82,144,159,303,14,11,25,1,3:22 (:06 delay)
14218,567418,2019-08-10,2019,MIA,ATL,7,6,7-6,MIA,10,0,42,42,84,161,154,315,16,14,30,5,3:34
14219,565088,2019-08-10,2019,BOS,ANA,4,12,12-4,ANA,9,0,42,43,85,164,163,327,14,16,30,5,3:28
14220,565952,2019-08-12,2019,WAS,CIN,7,6,7-6,WAS,9,1,37,40,77,166,160,326,15,16,31,0,3:11
14221,565471,2019-08-13,2019,COL,ARI,3,9,9-3,ARI,9,0,42,41,83,149,171,320,15,17,32,0,3:32
14222,565563,2019-08-07,2019,DET,CHA,1,8,8-1,CHA,9,0,35,46,81,203,127,330,10,19,29,2,3:17
14223,567024,2019-08-19,2019,MIN,CHA,4,6,6-4,CHA,9,0,41,37,78,144,169,313,16,10,26,2,3:27
14224,565187,2019-08-23,2019,CHN,WAS,3,9,9-3,WAS,9,0,32,44,76,189,125,314,5,18,23,2,3:10
14225,565474,2019-08-17,2019,COL,MIA,11,4,11-4,COL,9,1,40,37,77,174,147,321,20,11,31,2,3:08
14226,567027,2019-08-23,2019,MIN,DET,6,9,9-6,DET,9,0,39,44,83,157,155,312,13,20,33,4,3:26
14227,566234,2019-08-06,2019,PIT,MIL,3,4,4-3,MIL,9,0,37,37,74,163,146,309,11,11,22,2,3:19
14228,566049,2019-08-24,2019,NYN,ATL,5,9,9-5,ATL,9,0,37,44,81,166,144,310,11,17,28,1,3:14
14229,565478,2019-08-29,2019,COL,PIT,8,11,11-8,PIT,9,0,40,45,85,152,150,302,14,19,33,3,3:14
14230,566042,2019-08-09,2019,NYN,WAS,7,6,7-6,NYN,9,0,39,41,80,164,139,303,13,17,30,2,3:20
14231,567126,2019-08-27,2019,PHI,PIT,4,5,5-4,PIT,9,0,39,39,78,141,155,296,13,14,27,3,3:19
14232,566235,2019-08-07,2019,PIT,MIL,3,8,8-3,MIL,9,0,37,43,80,161,145,306,9,14,23,1,3:09
14233,565083,2019-08-05,2019,BOS,KCA,7,5,7-5,BOS,9,1,37,39,76,158,147,305,14,11,25,1,2:56
14234,565760,2019-08-13,2019,KCA,SLN,0,2,2-0,SLN,9,0,32,34,66,149,147,296,8,9,17,2,2:54
14235,565561,2019-08-05,2019,DET,CHA,4,7,7-4,CHA,9,0,39,46,85,192,156,348,15,20,35,1,3:41
14236,565087,2019-08-09,2019,BOS,ANA,16,4,16-4,BOS,9,1,44,33,77,139,195,334,19,9,28,3,3:33
14237,565470,2019-08-12,2019,COL,ARI,6,8,8-6,ARI,9,0,42,41,83,135,170,305,16,17,33,3,3:30
14238,565185,2019-08-21,2019,CHN,SFN,12,11,12-11,CHN,9,1,43,43,86,151,153,304,20,16,36,3,3:31
14239,564984,2019-08-04,2019,BAL,TOR,6,5,6-5,BAL,9,1,38,43,81,158,153,311,15,17,32,3,3:08
14240,566239,2019-08-19,2019,PIT,WAS,0,13,13-0,WAS,9,0,32,45,77,181,143,324,6,20,26,1,3:16
14241,565282,2019-08-16,2019,CIN,SLN,4,13,13-4,SLN,9,0,35,46,81,193,123,316,8,20,28,2,3:03
14242,567128,2019-08-30,2019,PHI,NYN,5,11,11-5,NYN,9,0,41,44,85,158,145,303,17,17,34,3,3:28
14243,566432,2019-08-09,2019,SEA,TBA,3,5,5-3,TBA,9,0,38,40,78,137,174,311,13,14,27,2,3:21
14244,567525,2019-08-30,2019,NYA,OAK,2,8,8-2,OAK,9,0,35,43,78,188,118,306,8,17,25,0,3:02
14245,567523,2019-08-17,2019,NYA,CLE,6,5,6-5,NYA,9,1,32,38,70,143,138,281,9,14,23,1,2:54
14246,566919,2019-08-09,2019,TOR,NYA,8,2,8-2,TOR,9,1,34,35,69,150,157,307,11,9,20,2,2:56
14247,566722,2019-08-07,2019,TBA,TOR,3,4,4-3,TOR,9,0,38,36,74,158,145,303,12,9,21,5,3:15
14248,565562,2019-08-06,2019,DET,CHA,10,6,10-6,DET,9,1,44,44,88,175,165,340,19,18,37,3,3:23 (1:01 delay)
14249,566233,2019-08-05,2019,PIT,MIL,7,9,9-7,MIL,9,0,40,43,83,157,180,337,13,16,29,3,3:32
14250,565662,2019-08-06,2019,HOU,COL,11,6,11-6,HOU,9,1,39,38,77,160,151,311,15,11,26,2,3:09
14251,566242,2019-08-22,2019,PIT,WAS,1,7,7-1,WAS,9,0,35,44,79,174,152,326,8,17,25,0,3:19 (:10 delay)
14252,566143,2019-08-04,2019,OAK,SLN,4,2,4-2,OAK,9,1,39,37,76,167,165,332,16,9,25,3,3:14
14253,566528,2019-08-09,2019,SFN,PHI,6,9,9-6,PHI,9,0,40,42,82,155,149,304,14,16,30,2,3:05
14254,565472,2019-08-14,2019,COL,ARI,7,6,7-6,COL,9,0,39,39,78,148,155,303,13,14,27,0,3:25
14255,565569,2019-08-14,2019,DET,SEA,3,2,3-2,DET,9,1,36,35,71,164,123,287,14,10,24,1,2:48
14256,566146,2019-08-17,2019,OAK,HOU,8,4,8-4,OAK,9,1,40,38,78,143,152,295,17,12,29,0,3:04
14257,564994,2019-08-22,2019,BAL,TBA,2,5,5-2,TBA,9,0,37,41,78,184,156,340,9,14,23,3,3:29 (2:16 delay)
14258,565664,2019-08-19,2019,HOU,DET,5,4,5-4,HOU,9,1,37,42,79,174,166,340,13,15,28,1,3:13
14259,566231,2019-08-03,2019,PIT,NYN,5,7,7-5,NYN,9,0,41,42,83,148,163,311,16,16,32,3,3:21
14260,567122,2019-08-16,2019,PHI,SDN,8,4,8-4,PHI,9,1,39,35,74,159,164,323,15,9,24,3,3:20
14261,567331,2019-08-29,2019,CHA,MIN,5,10,10-5,MIN,9,0,40,46,86,185,154,339,14,21,35,2,3:20
14262,566922,2019-08-12,2019,TOR,TEX,19,4,19-4,TOR,9,1,47,37,84,120,171,291,25,10,35,3,3:02
14263,564993,2019-08-21,2019,BAL,KCA,8,1,8-1,BAL,9,1,39,36,75,154,162,316,18,8,26,0,2:52
14264,564987,2019-08-07,2019,BAL,NYA,2,14,14-2,NYA,9,0,35,46,81,194,142,336,8,19,27,4,3:08
14265,565856,2019-08-04,2019,LAN,SDN,11,10,11-10,LAN,9,0,40,42,82,178,163,341,15,15,30,4,3:54
14266,566920,2019-08-10,2019,TOR,NYA,5,4,5-4,TOR,9,1,37,37,74,185,176,361,13,11,24,4,3:27
14267,566828,2019-08-17,2019,TEX,MIN,7,12,12-7,MIN,9,0,40,49,89,185,144,329,13,22,35,2,3:30
14268,565085,2019-08-07,2019,BOS,KCA,5,4,5-4,BOS,10,0,44,45,89,180,169,349,18,16,34,2,3:48 (1:49 delay)
14269,565477,2019-08-28,2019,COL,BOS,4,7,7-4,BOS,9,0,40,42,82,173,168,341,15,15,30,2,3:48
14270,565669,2019-08-24,2019,HOU,ANA,5,2,5-2,HOU,9,1,37,39,76,177,145,322,13,14,27,2,3:03
14271,567419,2019-08-11,2019,MIA,ATL,4,5,5-4,ATL,9,0,42,36,78,160,171,331,16,11,27,2,3:23
14272,566524,2019-08-05,2019,SFN,WAS,0,4,4-0,WAS,9,0,33,41,74,214,113,327,7,14,21,0,3:12
14273,567222,2019-08-03,2019,ATL,CIN,5,4,5-4,ATL,10,0,46,40,86,140,209,349,18,11,29,3,3:47
14274,566721,2019-08-06,2019,TBA,TOR,7,6,7-6,TBA,10,0,47,41,88,153,205,358,17,10,27,2,3:50
14275,567223,2019-08-04,2019,ATL,CIN,4,6,6-4,CIN,10,0,45,45,90,159,174,333,16,19,35,2,3:54
14276,566924,2019-08-14,2019,TOR,TEX,3,7,7-3,TEX,9,0,39,45,84,198,155,353,11,18,29,4,3:22
14277,566826,2019-08-15,2019,TEX,MIN,6,13,13-6,MIN,9,0,39,48,87,175,157,332,15,20,35,1,3:18
14278,565863,2019-08-20,2019,LAN,TOR,16,3,16-3,LAN,9,1,47,34,81,128,202,330,26,11,37,3,3:20
14279,567427,2019-08-27,2019,MIA,CIN,5,8,8-5,CIN,9,0,40,45,85,189,165,354,14,17,31,2,3:24
14280,566824,2019-08-03,2019,TEX,DET,5,4,5-4,TEX,10,0,42,43,85,168,171,339,13,15,28,2,3:35
14281,566626,2019-08-20,2019,SLN,MIL,9,4,9-4,SLN,9,1,43,40,83,170,179,349,20,14,34,5,3:42
14282,565571,2019-08-27,2019,DET,CLE,1,10,10-1,CLE,9,0,32,45,77,189,157,346,5,20,25,2,3:12
14283,566245,2019-08-25,2019,PIT,CIN,9,8,9-8,PIT,9,1,40,42,82,163,167,330,16,15,31,1,3:25
14284,566632,2019-09-01,2019,SLN,CIN,3,5,5-3,CIN,9,0,35,41,76,166,154,320,9,13,22,2,3:04
14285,567121,2019-08-15,2019,PHI,CHN,7,5,7-5,PHI,9,0,38,40,78,146,139,285,14,14,28,3,3:13
14286,565380,2019-08-14,2019,CLE,BOS,1,5,5-1,BOS,9,0,35,40,75,166,142,308,9,15,24,3,3:18
14287,565468,2019-08-03,2019,COL,SFN,5,6,6-5,SFN,9,0,40,46,86,194,157,351,14,20,34,4,3:42
14288,566142,2019-08-03,2019,OAK,SLN,8,3,8-3,OAK,9,1,42,37,79,160,186,346,20,11,31,5,3:37
14289,567123,2019-08-17,2019,PHI,SDN,3,5,5-3,SDN,9,0,35,41,76,152,140,292,8,15,23,1,3:16
14290,567016,2019-08-04,2019,MIN,KCA,3,0,3-0,MIN,9,1,32,28,60,126,121,247,9,3,12,2,2:28 (:28 delay)
14291,565085,2019-08-07,2019,BOS,KCA,5,4,5-4,BOS,10,0,44,45,89,180,169,349,18,16,34,2,3:48 (1:49 delay)
14292,566829,2019-08-18,2019,TEX,MIN,3,6,6-3,MIN,9,0,42,44,86,181,181,362,14,15,29,0,3:49
14293,564986,2019-08-06,2019,BAL,NYA,4,9,9-4,NYA,9,0,38,44,82,167,156,323,13,19,32,4,3:22 (1:12 delay)
14294,566334,2019-08-12,2019,SDN,TBA,4,10,10-4,TBA,9,0,38,49,87,204,132,336,11,23,34,2,3:47
14295,565520,2019-08-06,2019,DET,CHA,3,5,5-3,CHA,9,0,39,41,80,165,165,330,12,17,29,3,3:19
14296,567018,2019-08-06,2019,MIN,ATL,7,12,12-7,ATL,9,0,41,47,88,166,173,339,14,20,34,3,3:27
14297,567023,2019-08-11,2019,MIN,CLE,3,7,7-3,CLE,10,0,39,42,81,159,157,316,10,12,22,5,3:29
14298,565275,2019-08-05,2019,CIN,ANA,7,4,7-4,CIN,9,1,35,36,71,179,144,323,11,9,20,3,3:07
14299,566825,2019-08-04,2019,TEX,DET,9,4,9-4,TEX,9,1,39,41,80,170,149,319,14,14,28,4,3:27
14300,565866,2019-08-23,2019,LAN,NYA,2,10,10-2,NYA,9,0,34,44,78,161,147,308,7,18,25,2,3:16
14301,567415,2019-08-01,2019,MIA,MIN,5,4,5-4,MIA,12,0,51,47,98,193,187,380,19,12,31,1,4:14
14302,565277,2019-08-08,2019,CIN,CHN,5,12,12-5,CHN,9,0,43,50,93,193,170,363,15,24,39,2,3:45
14303,567226,2019-08-15,2019,ATL,NYN,8,10,10-8,NYN,9,0,42,51,93,180,159,339,16,27,43,4,3:33
14304,565860,2019-08-09,2019,LAN,ARI,2,3,3-2,ARI,11,0,39,48,87,178,156,334,7,17,24,3,3:49
14305,564792,2019-08-13,2019,ANA,PIT,7,10,10-7,PIT,9,0,41,48,89,188,158,346,17,23,40,2,3:46
14306,565957,2019-08-18,2019,WAS,MIL,16,8,16-8,WAS,9,1,46,46,92,169,167,336,23,20,43,2,3:24
14307,566338,2019-08-24,2019,SDN,BOS,4,5,5-4,BOS,9,0,40,41,81,155,180,335,14,16,30,2,3:48
14308,567615,2019-08-24,2019,MIL,ARI,4,0,4-0,MIL,9,1,39,34,73,154,170,324,15,7,22,3,3:29
14309,564990,2019-08-11,2019,BAL,HOU,8,7,8-7,BAL,9,0,45,43,88,172,191,363,20,17,37,3,3:51
14310,566727,2019-08-20,2019,TBA,SEA,4,7,7-4,SEA,9,0,39,42,81,184,180,364,13,15,28,0,3:25
14311,566832,2019-08-21,2019,TEX,ANA,8,7,8-7,TEX,9,0,40,45,85,167,173,340,16,17,33,5,3:46
14312,564890,2019-08-17,2019,ARI,SFN,6,11,11-6,SFN,9,0,39,47,86,192,154,346,14,20,34,3,3:40
14313,566724,2019-08-17,2019,TBA,DET,1,0,1-0,TBA,13,0,48,42,90,166,192,358,13,4,17,2,3:39
14314,565276,2019-08-06,2019,CIN,ANA,8,4,8-4,CIN,9,1,39,37,76,158,157,315,17,12,29,3,3:08 (:54 delay)
14315,565383,2019-08-25,2019,CLE,KCA,8,9,9-8,KCA,10,0,45,44,89,186,166,352,16,15,31,4,3:39
14316,565564,2019-08-08,2019,DET,KCA,10,8,10-8,DET,9,0,45,39,84,164,192,356,18,12,30,4,3:37
14317,565094,2019-08-21,2019,BOS,PHI,2,5,5-2,PHI,9,0,38,41,79,180,160,340,12,14,26,3,3:39
14318,567618,2019-08-27,2019,MIL,SLN,3,6,6-3,SLN,9,0,36,40,76,167,163,330,9,17,26,4,3:27 (:09 delay)
14319,565960,2019-08-30,2019,WAS,MIA,7,6,7-6,WAS,9,0,39,42,81,160,151,311,15,15,30,3,3:35
14320,567424,2019-08-24,2019,MIA,PHI,3,9,9-3,PHI,9,0,38,48,86,213,132,345,12,23,35,1,3:37
14321,567524,2019-08-18,2019,NYA,CLE,4,8,8-4,CLE,9,0,40,43,83,174,181,355,13,16,29,2,3:40
14322,566831,2019-08-20,2019,TEX,ANA,3,2,3-2,TEX,11,0,43,41,84,179,150,329,13,9,22,2,3:36
14323,566921,2019-08-11,2019,TOR,NYA,0,1,1-0,NYA,9,0,29,32,61,136,121,257,4,7,11,1,2:42
14324,566437,2019-08-25,2019,SEA,TOR,3,1,3-1,SEA,9,1,27,35,62,135,92,227,4,8,12,0,2:28
14325,567487,2019-08-03,2019,NYA,BOS,6,4,6-4,NYA,9,1,40,42,82,198,184,382,18,16,34,3,4:02
14326,566530,2019-08-11,2019,SFN,PHI,9,6,9-6,SFN,9,1,38,48,86,190,142,332,16,22,38,6,3:31
14327,566435,2019-08-23,2019,SEA,TOR,7,4,7-4,SEA,9,1,44,41,85,151,185,336,20,14,34,5,3:51
14328,565673,2019-08-29,2019,HOU,TBA,8,9,9-8,TBA,9,0,46,43,89,155,206,361,18,16,34,7,4:06
14329,565092,2019-08-18,2019,BOS,BAL,13,7,13-7,BOS,9,1,45,41,86,168,173,341,21,15,36,3,3:38
14330,564883,2019-08-03,2019,ARI,WAS,18,7,18-7,ARI,9,1,50,42,92,159,211,370,26,16,42,4,3:46
14331,565188,2019-08-24,2019,CHN,WAS,2,7,7-2,WAS,9,0,38,45,83,177,166,343,13,20,33,2,3:56
14332,565475,2019-08-18,2019,COL,MIA,7,6,7-6,COL,10,0,44,44,88,166,195,361,15,14,29,3,3:57
14333,566044,2019-08-11,2019,NYN,WAS,4,7,7-4,WAS,9,0,39,41,80,176,156,332,12,14,26,5,3:35
14334,566532,2019-08-14,2019,SFN,OAK,5,9,9-5,OAK,9,0,37,44,81,183,142,325,10,19,29,4,3:15
14335,566624,2019-08-11,2019,SLN,PIT,11,9,11-9,SLN,9,1,44,39,83,149,172,321,20,15,35,4,3:40
14336,565961,2019-08-31,2019,WAS,MIA,7,0,7-0,WAS,9,1,33,29,62,128,123,251,10,3,13,0,2:31
14337,565953,2019-08-13,2019,WAS,CIN,3,1,3-1,WAS,9,1,30,36,66,128,121,249,8,11,19,2,2:38
14338,566930,2019-08-30,2019,TOR,HOU,4,7,7-4,HOU,9,0,41,44,85,173,193,366,15,17,32,1,3:22
14339,567609,2019-08-09,2019,MIL,TEX,6,5,6-5,MIL,9,0,40,43,83,211,178,389,17,16,33,5,4:01
14340,567429,2019-08-29,2019,MIA,CIN,4,3,4-3,MIA,12,0,41,45,86,183,160,343,11,10,21,2,3:35
14341,566335,2019-08-13,2019,SDN,TBA,5,7,7-5,TBA,9,0,41,44,85,175,172,347,16,16,32,2,3:44
14342,565089,2019-08-11,2019,BOS,ANA,4,5,5-4,ANA,10,0,43,45,88,180,174,354,15,17,32,5,4:02
14343,567612,2019-08-13,2019,MIL,MIN,5,7,7-5,MIN,9,0,44,41,85,186,155,341,16,16,32,3,3:47
14344,566729,2019-08-30,2019,TBA,CLE,4,0,4-0,TBA,9,1,32,32,64,134,133,267,10,7,17,2,2:52
14345,566340,2019-08-26,2019,SDN,LAN,4,3,4-3,SDN,9,1,29,39,68,141,116,257,5,13,18,2,2:52
14346,567521,2019-08-15,2019,NYA,CLE,5,19,19-5,CLE,9,0,39,54,93,219,153,372,11,29,40,2,3:28
14347,565568,2019-08-13,2019,DET,SEA,6,11,11-6,SEA,9,0,43,44,87,184,185,369,17,17,34,3,3:42
14348,567321,2019-08-11,2019,CHA,OAK,0,2,2-0,OAK,9,0,32,36,68,145,127,272,7,9,16,2,2:52 (:28 delay)
14349,565955,2019-08-16,2019,WAS,MIL,2,1,2-1,WAS,9,1,32,41,73,154,113,267,8,14,22,1,3:00
14350,564889,2019-08-16,2019,ARI,SFN,9,10,10-9,SFN,11,0,49,50,99,197,189,386,16,19,35,4,4:05
14351,566633,2019-08-31,2019,SLN,CIN,3,2,3-2,SLN,9,0,36,33,69,122,135,257,11,8,19,4,2:53
14352,567619,2019-08-28,2019,MIL,SLN,4,1,4-1,MIL,9,1,33,34,67,141,137,278,10,8,18,2,2:50
14353,564798,2019-08-27,2019,ANA,TEX,5,2,5-2,ANA,9,1,31,36,67,147,121,268,8,9,17,2,2:48
14354,565567,2019-08-11,2019,DET,KCA,2,10,10-2,KCA,9,0,33,42,75,178,119,297,8,14,22,1,2:35
14355,565868,2019-08-25,2019,LAN,NYA,1,5,5-1,NYA,9,0,35,36,71,130,121,251,9,10,19,1,2:51
14356,566834,2019-08-30,2019,TEX,SEA,6,3,6-3,TEX,9,1,35,37,72,139,127,266,9,11,20,3,2:45
14357,567423,2019-08-23,2019,MIA,PHI,19,11,19-11,MIA,9,1,48,48,96,207,186,393,24,23,47,6,4:10
14358,565861,2019-08-10,2019,LAN,ARI,4,0,4-0,LAN,9,1,36,31,67,127,150,277,12,5,17,3,3:18
14359,566835,2019-08-31,2019,TEX,SEA,3,2,3-2,TEX,9,0,34,36,70,144,116,260,9,11,20,1,2:49
14360,567421,2019-08-14,2019,MIA,LAN,1,9,9-1,LAN,9,0,31,43,74,154,120,274,4,17,21,0,2:45
14361,565280,2019-08-11,2019,CIN,CHN,3,6,6-3,CHN,9,0,37,39,76,134,151,285,10,12,22,2,2:55
14362,564897,2019-08-31,2019,ARI,LAN,6,5,6-5,ARI,9,1,33,37,70,140,140,280,9,14,23,2,3:11
14363,565191,2019-08-31,2019,CHN,MIL,0,2,2-0,MIL,9,0,35,39,74,145,134,279,8,12,20,3,2:57
14364,566537,2019-08-31,2019,SFN,SDN,1,4,4-1,SDN,9,0,36,39,75,136,146,282,11,13,24,1,2:58
14365,566534,2019-08-27,2019,SFN,ARI,2,3,3-2,ARI,9,0,34,39,73,161,113,274,8,12,20,4,2:46
14366,564888,2019-08-15,2019,ARI,SFN,0,7,7-0,SFN,9,0,31,44,75,164,115,279,4,21,25,0,2:44
14367,566438,2019-08-26,2019,SEA,NYA,4,5,5-4,NYA,9,0,35,37,72,127,165,292,8,11,19,1,2:57
14368,566152,2019-08-25,2019,OAK,SFN,4,5,5-4,SFN,9,0,37,39,76,151,129,280,12,13,25,4,3:02
14369,564997,2019-08-25,2019,BAL,TBA,8,3,8-3,BAL,9,1,41,36,77,133,154,287,19,12,31,1,2:54
14370,565770,2019-08-31,2019,KCA,BAL,7,5,7-5,KCA,9,1,40,35,75,149,142,291,14,9,23,3,2:54
14371,566536,2019-08-30,2019,SFN,SDN,8,3,8-3,SFN,9,1,41,33,74,133,161,294,16,8,24,0,2:54
14372,567329,2019-08-27,2019,CHA,MIN,1,3,3-1,MIN,9,0,34,36,70,145,148,293,8,11,19,2,3:16
14373,567320,2019-08-10,2019,CHA,OAK,3,2,3-2,CHA,9,1,32,42,74,179,122,301,9,18,27,4,3:19
14374,567426,2019-08-26,2019,MIA,CIN,3,6,6-3,CIN,9,0,37,40,77,158,147,305,10,14,24,1,3:03
14375,566931,2019-08-31,2019,TOR,HOU,6,4,6-4,TOR,9,1,37,39,76,154,139,293,14,16,30,4,3:04
14376,565190,2019-08-30,2019,CHN,MIL,7,1,7-1,CHN,9,1,36,37,73,150,140,290,14,10,24,1,3:07
14377,566833,2019-08-29,2019,TEX,SEA,3,5,5-3,SEA,9,0,34,42,76,162,142,304,8,14,22,0,3:09
14378,566145,2019-08-16,2019,OAK,HOU,3,2,3-2,OAK,13,0,47,53,100,225,181,406,9,15,24,0,4:13
14379,564896,2019-08-30,2019,ARI,LAN,5,4,5-4,ARI,9,1,36,39,75,153,145,298,11,12,23,4,3:41
14380,566730,2019-08-31,2019,TBA,CLE,9,6,9-6,TBA,9,1,40,37,77,143,155,298,16,13,29,6,3:18
14381,567127,2019-08-28,2019,PHI,PIT,12,3,12-3,PHI,9,1,44,35,79,122,189,311,20,9,29,1,3:20
14382,566599,2019-08-31,2019,SLN,CIN,10,6,10-6,SLN,9,1,39,38,77,139,161,300,16,11,27,3,3:10
14383,566439,2019-08-27,2019,SEA,NYA,0,7,7-0,NYA,9,0,31,45,76,176,136,312,4,17,21,0,2:59
14384,567324,2019-08-14,2019,CHA,HOU,13,9,13-9,CHA,9,1,41,46,87,168,157,325,18,21,39,6,3:30
14385,566048,2019-08-23,2019,NYN,ATL,1,2,2-1,ATL,14,0,52,56,108,220,219,439,12,15,27,1,4:37
14386,564895,2019-08-29,2019,ARI,LAN,11,5,11-5,ARI,9,1,43,40,83,157,149,306,20,15,35,2,3:23
14387,565479,2019-08-30,2019,COL,PIT,4,9,9-4,PIT,9,0,38,42,80,153,155,308,11,18,29,1,3:18 (:16 delay)
14388,566830,2019-08-19,2019,TEX,ANA,8,7,8-7,TEX,11,0,56,52,108,204,235,439,24,20,44,2,4:35
14389,565769,2019-08-30,2019,KCA,BAL,2,14,14-2,BAL,9,0,34,51,85,202,111,313,7,27,34,1,3:07
14390,567613,2019-08-14,2019,MIL,MIN,6,5,6-5,MIL,9,1,40,41,81,170,163,333,15,15,30,3,3:48
14391,566436,2019-08-24,2019,SEA,TOR,5,7,7-5,TOR,9,0,42,41,83,171,165,336,14,16,30,5,3:38
14392,564801,2019-08-31,2019,ANA,BOS,10,4,10-4,ANA,9,1,41,41,82,151,152,303,18,13,31,2,3:37
14393,565480,2019-08-31,2019,COL,PIT,4,11,11-4,PIT,9,0,37,49,86,184,139,323,11,21,32,0,3:26
14394,566052,2019-08-28,2019,NYN,CHN,7,10,10-7,CHN,9,0,45,42,87,153,164,317,19,15,34,3,3:24 (:12 delay)
14395,567233,2019-08-30,2019,ATL,CHA,10,7,10-7,ATL,9,1,42,38,80,142,168,310,20,10,30,4,3:28
14396,565575,2019-08-31,2019,DET,MIN,10,7,10-7,DET,9,1,42,41,83,173,161,334,18,14,32,2,3:20
14397,567420,2019-08-13,2019,MIA,LAN,1,15,15-1,LAN,9,0,33,48,81,208,134,342,8,20,28,3,3:22
14398,566440,2019-08-28,2019,SEA,NYA,3,7,7-3,NYA,9,0,35,40,75,179,164,343,10,14,24,1,3:11
14399,567129,2019-08-31,2019,PHI,NYN,3,6,6-3,NYN,9,0,38,45,83,182,156,338,11,17,28,4,3:41
14400,567616,2019-08-25,2019,MIL,ARI,2,5,5-2,ARI,9,0,39,40,79,169,177,346,13,13,26,2,3:44
14401,566533,2019-08-26,2019,SFN,ARI,4,6,6-4,ARI,9,0,42,40,82,163,174,337,12,13,25,5,3:30
14402,565476,2019-08-27,2019,COL,BOS,6,10,10-6,BOS,9,0,42,43,85,160,168,328,16,18,34,2,3:32
14403,566151,2019-08-24,2019,OAK,SFN,5,10,10-5,SFN,9,0,42,43,85,167,179,346,16,15,31,8,3:50
14404,567125,2019-08-26,2019,PHI,PIT,6,5,6-5,PHI,11,0,44,46,90,156,174,330,15,18,33,2,3:57
14405,565574,2019-08-30,2019,DET,MIN,5,13,13-5,MIN,9,0,37,46,83,184,161,345,12,19,31,1,3:31
14406,566929,2019-08-28,2019,TOR,ATL,4,9,9-4,ATL,9,0,40,43,83,175,164,339,13,17,30,3,3:33
14407,567234,2019-08-31,2019,ATL,CHA,11,5,11-5,ATL,9,1,43,42,85,156,185,341,21,15,36,3,3:52
14408,566631,2019-08-25,2019,SLN,COL,11,4,11-4,SLN,9,1,43,40,83,200,162,362,21,12,33,2,3:31 (2:35 delay)
14409,564800,2019-08-30,2019,ANA,BOS,6,7,7-6,BOS,15,0,67,56,123,218,278,496,24,14,38,4,5:23
14410,567617,2019-08-26,2019,MIL,SLN,2,12,12-2,SLN,9,0,38,48,86,179,170,349,13,20,33,4,3:34
14411,567116,2019-08-02,2019,PHI,CHA,3,4,4-3,CHA,15,0,63,58,121,239,245,484,21,17,38,4,5:28
14412,565379,2019-08-13,2019,CLE,BOS,6,7,7-6,BOS,10,0,42,48,90,203,172,375,12,23,35,4,4:07
14413,565954,2019-08-14,2019,WAS,CIN,17,7,17-7,WAS,9,1,44,44,88,167,184,351,21,17,38,3,3:38
14414,566342,2019-08-28,2019,SDN,LAN,4,6,6-4,LAN,10,0,41,47,88,194,155,349,11,19,30,4,4:05
14415,567526,2019-08-31,2019,NYA,OAK,4,3,4-3,NYA,11,0,37,51,88,217,160,377,8,21,29,3,3:58
14416,567422,2019-08-15,2019,MIA,LAN,13,7,13-7,MIA,9,1,44,43,87,206,177,383,22,16,38,4,4:07
14417,565956,2019-08-17,2019,WAS,MIL,14,15,15-14,MIL,14,0,69,65,134,247,260,507,30,29,59,5,5:40
14418,565765,2019-08-26,2019,KCA,OAK,4,19,19-4,OAK,9,0,39,55,94,215,158,373,13,28,41,3,3:37
14419,565189,2019-08-25,2019,CHN,WAS,5,7,7-5,WAS,11,0,43,49,92,215,200,415,11,18,29,3,4:35
14420,565766,2019-08-27,2019,KCA,OAK,1,2,2-1,OAK,9,0,35,35,70,133,142,275,11,11,22,2,2:56
14421,567029,2019-08-25,2019,MIN,DET,7,4,7-4,MIN,9,1,36,37,73,154,139,293,12,10,22,0,2:50
14422,565670,2019-08-25,2019,HOU,ANA,11,2,11-2,HOU,9,1,39,35,74,127,151,278,17,11,28,2,2:59
14423,566339,2019-08-25,2019,SDN,BOS,3,1,3-1,SDN,9,1,32,34,66,138,138,276,10,7,17,0,2:54
14424,566341,2019-08-27,2019,SDN,LAN,0,9,9-0,LAN,9,0,33,42,75,159,132,291,8,17,25,1,3:02
14425,565418,2019-08-26,2019,COL,ATL,3,1,3-1,COL,9,0,32,37,69,165,144,309,10,12,22,1,3:27
14426,565671,2019-08-27,2019,HOU,TBA,15,1,15-1,HOU,9,1,47,38,85,152,162,314,23,12,35,1,3:10
14427,566634,2019-09-01,2019,SLN,CIN,4,3,4-3,SLN,9,0,34,32,66,132,139,271,9,5,14,2,2:58
14428,565300,2019-09-26,2019,CIN,MIL,3,5,5-3,MIL,9,0,40,35,75,141,146,287,14,9,23,1,2:50
14429,565780,2019-09-27,2019,KCA,MIN,2,6,6-2,MIN,7,1,26,33,59,110,99,209,8,13,21,0,1:54 (:56 delay)
14430,566932,2019-09-01,2019,TOR,HOU,0,2,2-0,HOU,9,0,28,34,62,128,120,248,1,7,8,0,2:29
14431,565577,2019-09-02,2019,DET,MIN,3,4,4-3,MIN,9,0,35,41,76,145,146,291,9,15,24,1,3:07
14432,567130,2019-09-01,2019,PHI,NYN,5,2,5-2,PHI,9,1,36,33,69,118,130,248,14,7,21,4,2:52
14433,565299,2019-09-25,2019,CIN,MIL,2,9,9-2,MIL,9,0,37,45,82,166,146,312,10,19,29,1,3:01
14434,565962,2019-09-01,2019,WAS,MIA,9,3,9-3,WAS,9,1,37,34,71,127,133,260,12,7,19,1,2:46
14435,565193,2019-09-02,2019,CHN,SEA,5,1,5-1,CHN,9,1,38,32,70,137,150,287,16,6,22,1,2:56
14436,567235,2019-09-01,2019,ATL,CHA,5,3,5-3,ATL,9,1,31,36,67,156,124,280,8,10,18,1,3:08
14437,567236,2019-09-02,2019,ATL,TOR,6,3,6-3,ATL,9,1,35,34,69,135,158,293,10,7,17,0,2:52
14438,564903,2019-09-14,2019,ARI,CIN,1,0,1-0,ARI,9,1,25,30,55,111,90,201,1,5,6,0,2:15
14439,565683,2019-09-18,2019,HOU,TEX,3,2,3-2,HOU,9,1,36,34,70,116,134,250,11,9,20,0,2:35
14440,567036,2019-09-16,2019,MIN,CHA,5,3,5-3,MIN,9,1,35,34,69,113,126,239,12,8,20,3,2:42
14441,565682,2019-09-17,2019,HOU,TEX,4,1,4-1,HOU,9,1,34,32,66,130,122,252,10,8,18,0,2:45
14442,566635,2019-09-02,2019,SLN,SFN,3,1,3-1,SLN,9,1,33,33,66,139,126,265,9,6,15,3,2:43
14443,565771,2019-09-01,2019,KCA,BAL,6,4,6-4,KCA,9,1,39,36,75,120,137,257,16,9,25,5,2:45
14444,566160,2019-09-17,2019,OAK,KCA,2,1,2-1,OAK,9,1,32,32,64,114,134,248,8,6,14,1,2:32
14445,566344,2019-09-07,2019,SDN,COL,3,0,3-0,SDN,9,1,33,34,67,128,128,256,10,8,18,1,2:49
14446,566062,2019-09-14,2019,NYN,LAN,3,0,3-0,NYN,9,1,30,31,61,130,120,250,6,4,10,2,2:40
14447,565676,2019-09-07,2019,HOU,SEA,2,1,2-1,HOU,9,1,32,32,64,133,133,266,9,7,16,1,2:56
14448,565385,2019-09-03,2019,CLE,CHA,5,6,6-5,CHA,9,0,34,38,72,156,145,301,8,11,19,1,3:05
14449,567245,2019-09-20,2019,ATL,SFN,6,0,6-0,ATL,9,1,35,33,68,105,125,230,12,5,17,1,2:21
14450,565392,2019-09-18,2019,CLE,DET,2,1,2-1,CLE,10,0,40,34,74,121,140,261,14,5,19,2,2:45
14451,565773,2019-09-04,2019,KCA,DET,5,4,5-4,KCA,9,1,37,34,71,131,131,262,14,10,24,4,2:44
14452,564998,2019-09-05,2019,BAL,TEX,1,3,3-1,TEX,9,0,37,36,73,132,124,256,13,9,22,3,2:35
14453,565288,2019-09-02,2019,CIN,PHI,1,7,7-1,PHI,9,0,34,36,70,142,137,279,10,8,18,1,2:40
14454,567528,2019-09-02,2019,NYA,TEX,0,7,7-0,TEX,9,0,33,40,73,150,133,283,7,15,22,1,3:04 (2:52 delay)
14455,566544,2019-09-14,2019,SFN,MIA,2,4,4-2,MIA,9,0,37,33,70,107,126,233,11,8,19,5,2:56
14456,565008,2019-09-20,2019,BAL,SEA,5,3,5-3,BAL,9,1,35,33,68,113,145,258,12,5,17,0,2:27
14457,565576,2019-09-01,2019,DET,MIN,3,8,8-3,MIN,9,0,36,44,80,169,129,298,10,17,27,2,3:07 (:21 delay)
14458,567238,2019-09-05,2019,ATL,WAS,4,2,4-2,ATL,9,1,33,32,65,134,147,281,10,5,15,1,2:57
14459,565489,2019-09-17,2019,COL,NYN,1,6,6-1,NYN,9,0,32,36,68,133,130,263,7,14,21,2,2:50
14460,567626,2019-09-16,2019,MIL,SDN,5,1,5-1,MIL,9,1,33,32,65,132,126,258,9,5,14,1,2:35
14461,565293,2019-09-07,2019,CIN,ARI,0,2,2-0,ARI,9,0,31,37,68,151,128,279,5,9,14,3,2:39
14462,565584,2019-09-16,2019,DET,BAL,5,2,5-2,DET,9,1,34,38,72,153,109,262,11,11,22,2,2:35
14463,565387,2019-09-05,2019,CLE,CHA,1,7,7-1,CHA,9,0,31,42,73,153,109,262,4,16,20,1,2:38
14464,567628,2019-09-18,2019,MIL,SDN,1,2,2-1,SDN,9,0,35,34,69,126,138,264,8,9,17,1,3:01
14465,564907,2019-09-18,2019,ARI,MIA,5,4,5-4,ARI,9,1,36,38,74,117,138,255,11,11,22,5,2:55
14466,565483,2019-09-11,2019,COL,SLN,2,1,2-1,COL,9,1,36,36,72,137,128,265,13,10,23,2,3:01
14467,565098,2019-09-06,2019,BOS,NYA,6,1,6-1,BOS,9,1,35,32,67,153,150,303,14,6,20,1,3:08
14468,564808,2019-09-15,2019,ANA,TBA,6,4,6-4,ANA,9,1,34,35,69,141,133,274,13,8,21,1,2:54
14469,566736,2019-09-06,2019,TBA,TOR,5,0,5-0,TBA,9,1,32,31,63,122,127,249,9,4,13,2,2:35
14470,566545,2019-09-15,2019,SFN,MIA,2,1,2-1,SFN,9,1,33,34,67,129,137,266,11,8,19,3,2:51
14471,565388,2019-09-14,2019,CLE,MIN,0,2,2-0,MIN,9,0,36,35,71,129,146,275,8,8,16,2,2:53
14472,566636,2019-09-03,2019,SLN,SFN,1,0,1-0,SLN,9,1,29,30,59,123,106,229,6,3,9,0,2:11
14473,567625,2019-09-08,2019,MIL,CHN,8,5,8-5,MIL,9,1,37,37,74,132,152,284,15,11,26,3,3:09
14474,565388,2019-09-14,2019,CLE,MIN,0,2,2-0,MIN,9,0,36,35,71,129,146,275,8,8,16,2,2:53
14475,566732,2019-09-02,2019,TBA,BAL,5,4,5-4,TBA,10,0,39,38,77,149,151,300,10,10,20,1,3:16
14476,567031,2019-09-07,2019,MIN,CLE,5,3,5-3,MIN,9,1,36,36,72,156,131,287,12,9,21,4,3:16
14477,565774,2019-09-05,2019,KCA,DET,4,6,6-4,DET,9,0,39,39,78,148,135,283,15,13,28,2,2:59
14478,567530,2019-09-04,2019,NYA,TEX,4,1,4-1,NYA,9,1,35,35,70,133,162,295,11,9,20,1,3:05
14479,567627,2019-09-17,2019,MIL,SDN,3,1,3-1,MIL,9,1,29,32,61,155,137,292,5,6,11,1,2:37
14480,566154,2019-09-04,2019,OAK,ANA,4,0,4-0,OAK,9,1,33,35,68,136,135,271,9,7,16,2,2:31
14481,566162,2019-09-20,2019,OAK,TEX,8,0,8-0,OAK,9,1,40,27,67,109,175,284,17,2,19,0,2:38
14482,566253,2019-09-18,2019,PIT,SEA,1,4,4-1,SEA,9,0,34,36,70,151,117,268,9,11,20,1,2:47
14483,565192,2019-09-01,2019,CHN,MIL,0,4,4-0,MIL,9,0,36,40,76,167,131,298,11,13,24,5,3:29
14484,567244,2019-09-19,2019,ATL,PHI,5,4,5-4,ATL,9,1,35,38,73,152,119,271,12,12,24,1,3:10
14485,565296,2019-09-21,2019,CIN,NYN,3,2,3-2,CIN,9,1,36,33,69,122,136,258,12,5,17,2,2:48
14486,564802,2019-09-01,2019,ANA,BOS,3,4,4-3,BOS,9,0,39,37,76,154,168,322,13,13,26,1,3:21
14487,565970,2019-09-24,2019,WAS,PHI,6,5,6-5,WAS,9,1,35,34,69,136,151,287,12,7,19,2,3:06
14488,565199,2019-09-17,2019,CHN,CIN,2,4,4-2,CIN,9,0,36,36,72,133,138,271,9,9,18,2,3:08
14489,566058,2019-09-10,2019,NYN,ARI,3,2,3-2,NYN,9,1,31,38,69,147,115,262,7,13,20,2,3:02
14490,565588,2019-09-24,2019,DET,MIN,2,4,4-2,MIN,9,0,34,38,72,129,148,277,7,13,20,2,2:53
14491,566057,2019-09-09,2019,NYN,ARI,3,1,3-1,NYN,9,1,32,30,62,129,122,251,13,4,17,3,2:45
14492,566848,2019-09-29,2019,TEX,NYA,6,1,6-1,TEX,9,1,37,31,68,126,128,254,15,4,19,1,2:47
14493,566441,2019-09-10,2019,SEA,CIN,4,3,4-3,SEA,9,1,31,36,67,142,149,291,8,13,21,3,2:49
14494,565870,2019-09-03,2019,LAN,COL,5,3,5-3,LAN,9,1,32,36,68,149,135,284,9,10,19,3,3:14
14495,565389,2019-09-14,2019,CLE,MIN,5,9,9-5,MIN,9,0,38,39,77,132,148,280,12,12,24,4,3:02
14496,565003,2019-09-11,2019,BAL,LAN,7,3,7-3,BAL,9,1,36,34,70,141,142,283,12,8,20,3,2:59
14497,565099,2019-09-07,2019,BOS,NYA,1,5,5-1,NYA,9,0,32,43,75,171,141,312,6,17,23,3,3:29
14498,567135,2019-09-14,2019,PHI,BOS,1,2,2-1,BOS,9,0,36,37,73,140,143,283,10,11,21,2,3:21
14499,566640,2019-09-14,2019,SLN,MIL,2,5,5-2,MIL,9,0,34,37,71,156,135,291,7,11,18,3,2:59
14500,565930,2019-09-24,2019,WAS,PHI,4,1,4-1,WAS,9,1,35,33,68,133,150,283,11,7,18,2,3:07
14501,565391,2019-09-17,2019,CLE,DET,7,2,7-2,CLE,9,1,42,33,75,133,179,312,17,9,26,2,2:56
14502,566737,2019-09-07,2019,TBA,TOR,5,3,5-3,TBA,9,1,37,38,75,145,151,296,15,11,26,4,3:06
14503,565481,2019-09-01,2019,COL,PIT,2,6,6-2,PIT,9,0,36,42,78,147,127,274,9,16,25,2,3:19
14504,566540,2019-09-10,2019,SFN,PIT,5,4,5-4,SFN,9,1,33,36,69,149,128,277,9,10,19,3,2:57
14505,564807,2019-09-14,2019,ANA,TBA,1,3,3-1,TBA,9,0,35,35,70,151,129,280,8,9,17,3,3:13
14506,566351,2019-09-21,2019,SDN,ARI,2,4,4-2,ARI,9,0,37,36,73,134,135,269,9,9,18,4,3:12
14507,567341,2019-09-28,2019,CHA,DET,3,4,4-3,DET,9,0,36,38,74,151,130,281,11,11,22,2,2:58
14508,567332,2019-09-06,2019,CHA,ANA,4,5,5-4,ANA,9,0,35,34,69,145,141,286,10,7,17,1,3:02
14509,565390,2019-09-15,2019,CLE,MIN,7,5,7-5,CLE,9,1,37,40,77,144,140,284,14,15,29,4,3:09
14510,567529,2019-09-03,2019,NYA,TEX,10,1,10-1,NYA,9,1,37,31,68,131,147,278,14,5,19,1,2:36
14511,567437,2019-09-20,2019,MIA,WAS,4,6,6-4,WAS,9,0,38,36,74,144,141,285,13,10,23,3,3:13
14512,564898,2019-09-01,2019,ARI,LAN,3,4,4-3,LAN,11,0,40,41,81,170,157,327,11,9,20,5,3:56
14513,566642,2019-09-16,2019,SLN,WAS,4,2,4-2,SLN,9,1,35,33,68,113,159,272,11,7,18,3,3:04
14514,564905,2019-09-16,2019,ARI,MIA,7,5,7-5,ARI,9,1,38,38,76,147,149,296,15,13,28,6,3:24
14515,566731,2019-09-01,2019,TBA,CLE,8,2,8-2,TBA,9,1,39,39,78,158,139,297,18,12,30,3,3:01
14516,567527,2019-09-01,2019,NYA,OAK,5,4,5-4,NYA,9,0,35,36,71,164,160,324,12,11,23,2,3:17
14517,567621,2019-09-03,2019,MIL,HOU,4,2,4-2,MIL,9,1,34,31,65,123,133,256,11,6,17,2,2:41
14518,566938,2019-09-15,2019,TOR,NYA,6,4,6-4,TOR,9,1,35,38,73,148,143,291,11,11,22,2,2:47
14519,567340,2019-09-26,2019,CHA,CLE,8,0,8-0,CHA,9,1,39,32,71,132,164,296,17,4,21,3,2:57
14520,567040,2019-09-20,2019,MIN,KCA,4,3,4-3,MIN,9,1,32,38,70,134,143,277,8,12,20,4,3:00
14521,565194,2019-09-03,2019,CHN,SEA,6,1,6-1,CHN,9,1,36,39,75,152,158,310,13,14,27,2,3:14
14522,567240,2019-09-07,2019,ATL,WAS,5,4,5-4,ATL,9,1,34,35,69,164,147,311,13,11,24,2,3:29
14523,566252,2019-09-17,2019,PIT,SEA,0,6,6-0,SEA,9,0,34,40,74,163,127,290,9,15,24,1,2:58
14524,567630,2019-09-20,2019,MIL,PIT,10,1,10-1,MIL,9,1,39,35,74,134,144,278,17,8,25,3,2:59
14525,566060,2019-09-12,2019,NYN,ARI,11,1,11-1,NYN,9,1,38,37,75,142,164,306,14,10,24,6,3:25
14526,565007,2019-09-19,2019,BAL,TOR,4,8,8-4,TOR,9,0,40,39,79,143,146,289,12,14,26,2,2:53
14527,565968,2019-09-15,2019,WAS,ATL,7,0,7-0,WAS,9,1,37,32,69,142,157,299,17,5,22,1,3:03
14528,567136,2019-09-15,2019,PHI,BOS,3,6,6-3,BOS,9,0,36,38,74,152,135,287,11,10,21,0,2:57
14529,565874,2019-09-08,2019,LAN,SFN,5,0,5-0,LAN,9,1,33,32,65,129,125,254,8,5,13,3,2:46
14530,566153,2019-09-03,2019,OAK,ANA,7,5,7-5,OAK,9,1,34,37,71,151,132,283,11,13,24,2,3:04
14531,565396,2019-09-22,2019,CLE,PHI,10,1,10-1,CLE,9,1,38,33,71,127,136,263,12,8,20,5,3:04
14532,566734,2019-09-03,2019,TBA,BAL,2,0,2-0,TBA,9,1,31,30,61,120,93,213,9,5,14,3,2:27
14533,565290,2019-09-04,2019,CIN,PHI,8,5,8-5,CIN,9,1,37,35,72,143,138,281,14,9,23,3,3:02
14534,566250,2019-09-07,2019,PIT,SLN,1,10,10-1,SLN,9,0,33,46,79,181,129,310,8,18,26,1,3:24
14535,567431,2019-09-07,2019,MIA,KCA,2,7,7-2,KCA,9,0,38,42,80,158,157,315,12,16,28,3,3:24
14536,566155,2019-09-05,2019,OAK,ANA,10,6,10-6,OAK,9,1,42,37,79,120,162,282,20,11,31,5,3:08
14537,565488,2019-09-16,2019,COL,NYN,9,4,9-4,COL,9,1,40,39,79,152,148,300,16,13,29,2,3:09
14538,565297,2019-09-22,2019,CIN,NYN,3,6,6-3,NYN,9,0,39,40,79,140,161,301,12,15,27,1,3:08
14539,565482,2019-09-10,2019,COL,SLN,2,1,2-1,COL,9,1,31,34,65,143,106,249,8,8,16,1,2:36
14540,564902,2019-09-13,2019,ARI,CIN,3,4,4-3,CIN,9,0,38,33,71,121,153,274,11,6,17,1,2:48
14541,564899,2019-09-02,2019,ARI,SDN,14,7,14-7,ARI,9,1,46,43,89,162,165,327,21,18,39,4,3:26
14542,567536,2019-09-22,2019,NYA,TOR,8,3,8-3,NYA,9,1,33,40,73,170,138,308,9,13,22,0,2:45 (:33 delay)
14543,566842,2019-09-15,2019,TEX,OAK,1,6,6-1,OAK,9,0,36,40,76,186,142,328,9,13,22,1,3:10
14544,567032,2019-09-08,2019,MIN,CLE,2,5,5-2,CLE,9,0,37,40,77,151,160,311,10,16,26,3,3:07
14545,565966,2019-09-13,2019,WAS,ATL,0,5,5-0,ATL,9,0,32,43,75,169,135,304,6,18,24,1,3:16
14546,565871,2019-09-04,2019,LAN,COL,7,3,7-3,LAN,9,1,34,38,72,165,141,306,10,12,22,3,3:12
14547,565579,2019-09-12,2019,DET,NYA,4,6,6-4,NYA,9,0,37,39,76,173,134,307,10,15,25,4,3:02
14548,567432,2019-09-08,2019,MIA,KCA,9,0,9-0,MIA,9,1,40,32,72,102,158,260,18,6,24,0,2:40
14549,564900,2019-09-03,2019,ARI,SDN,2,1,2-1,ARI,9,1,35,38,73,160,135,295,12,11,23,3,3:08
14550,567033,2019-09-10,2019,MIN,WAS,5,0,5-0,MIN,9,1,34,29,63,124,124,248,11,3,14,1,2:32
14551,565675,2019-09-06,2019,HOU,SEA,7,4,7-4,HOU,9,1,39,39,78,159,161,320,15,12,27,3,3:31
14552,566738,2019-09-08,2019,TBA,TOR,8,3,8-3,TBA,9,1,36,35,71,137,119,256,13,8,21,2,2:36
14553,566246,2019-09-03,2019,PIT,MIA,4,5,5-4,MIA,10,0,40,43,83,172,145,317,14,13,27,4,3:24
14554,566247,2019-09-04,2019,PIT,MIA,6,5,6-5,PIT,9,0,38,40,78,150,105,255,16,12,28,1,2:59
14555,567620,2019-09-02,2019,MIL,HOU,2,3,3-2,HOU,10,0,40,41,81,184,171,355,10,12,22,2,3:35
14556,566445,2019-09-14,2019,SEA,CHA,2,1,2-1,SEA,10,0,41,37,78,135,193,328,12,8,20,2,3:28
14557,565289,2019-09-03,2019,CIN,PHI,2,6,6-2,PHI,9,0,37,41,78,155,167,322,10,16,26,2,3:16
14558,567034,2019-09-11,2019,MIN,WAS,2,6,6-2,WAS,9,0,38,39,77,158,160,318,11,12,23,1,3:12
14559,565875,2019-09-17,2019,LAN,TBA,7,5,7-5,LAN,9,1,35,37,72,159,154,313,10,9,19,8,3:43
14560,565969,2019-09-23,2019,WAS,PHI,7,2,7-2,WAS,9,1,41,36,77,144,172,316,19,9,28,1,3:19
14561,564810,2019-09-25,2019,ANA,OAK,2,3,3-2,OAK,9,0,36,42,78,169,135,304,11,16,27,5,3:29
14562,566632,2019-09-01,2019,SLN,CIN,3,5,5-3,CIN,9,0,35,41,76,166,154,320,9,13,22,2,3:04
14563,566638,2019-09-05,2019,SLN,SFN,10,0,10-0,SLN,9,1,43,33,76,136,159,295,18,6,24,1,2:54
14564,566735,2019-09-05,2019,TBA,TOR,6,4,6-4,TBA,9,1,39,38,77,163,150,313,15,12,27,4,3:32
14565,567439,2019-09-22,2019,MIA,WAS,5,3,5-3,MIA,9,1,35,39,74,161,134,295,12,14,26,2,3:13
14566,567632,2019-09-22,2019,MIL,PIT,4,3,4-3,MIL,9,1,35,32,67,144,134,278,11,4,15,2,2:54
14567,567623,2019-09-06,2019,MIL,CHN,7,1,7-1,MIL,9,1,42,31,73,124,167,291,19,5,24,1,2:51
14568,566733,2019-09-03,2019,TBA,BAL,2,4,4-2,BAL,9,0,34,36,70,139,143,282,9,11,20,1,2:41
14569,565294,2019-09-08,2019,CIN,ARI,4,3,4-3,CIN,9,0,37,37,74,144,143,287,13,11,24,4,3:12
14570,566249,2019-09-06,2019,PIT,SLN,9,4,9-4,PIT,9,1,41,39,80,168,163,331,20,13,33,4,3:28
14571,565583,2019-09-15,2019,DET,BAL,2,8,8-2,BAL,9,0,40,44,84,161,155,316,13,18,31,2,3:11 (:39 delay)
14572,565878,2019-09-21,2019,LAN,COL,2,4,4-2,COL,9,0,34,36,70,130,139,269,7,11,18,2,3:01
14573,566061,2019-09-13,2019,NYN,LAN,2,9,9-2,LAN,9,0,36,41,77,174,151,325,9,14,23,2,3:22
14574,565967,2019-09-14,2019,WAS,ATL,1,10,10-1,ATL,9,0,34,46,80,174,136,310,9,23,32,2,3:29
14575,565196,2019-09-14,2019,CHN,PIT,14,1,14-1,CHN,9,1,43,38,81,145,162,307,20,11,31,2,3:23
14576,565585,2019-09-20,2019,DET,CHA,1,10,10-1,CHA,9,0,34,48,82,188,147,335,9,22,31,1,3:14
14577,565002,2019-09-10,2019,BAL,LAN,3,7,7-3,LAN,9,0,35,44,79,151,135,286,8,19,27,1,2:46
14578,565095,2019-09-03,2019,BOS,MIN,5,6,6-5,MIN,9,0,38,41,79,162,149,311,11,14,25,5,3:28
14579,564904,2019-09-15,2019,ARI,CIN,1,3,3-1,CIN,9,0,32,35,67,138,130,268,5,9,14,2,2:55
14580,564901,2019-09-04,2019,ARI,SDN,4,1,4-1,ARI,9,1,37,32,69,142,138,280,14,6,20,3,2:55
14581,567038,2019-09-18,2019,MIN,CHA,1,3,3-1,CHA,9,0,34,36,70,137,132,269,8,11,19,6,3:09
14582,565869,2019-09-02,2019,LAN,COL,16,9,16-9,LAN,9,1,48,40,88,147,202,349,26,13,39,3,4:06
14583,567134,2019-09-12,2019,PHI,ATL,9,5,9-5,PHI,9,1,40,38,78,171,163,334,16,11,27,5,3:35
14584,565104,2019-09-19,2019,BOS,SFN,5,4,5-4,BOS,9,1,39,40,79,177,140,317,13,13,26,1,3:17
14585,566161,2019-09-18,2019,OAK,KCA,1,0,1-0,OAK,11,0,40,39,79,158,166,324,10,9,19,3,3:09 (:28 delay)
14586,567242,2019-09-17,2019,ATL,PHI,4,5,5-4,PHI,9,0,41,37,78,152,175,327,14,10,24,4,3:26
14587,565395,2019-09-21,2019,CLE,PHI,4,9,9-4,PHI,9,0,34,40,74,181,133,314,7,12,19,5,3:17
14588,566163,2019-09-21,2019,OAK,TEX,12,3,12-3,OAK,9,1,48,36,84,137,202,339,23,11,34,3,3:17
14589,567430,2019-09-06,2019,MIA,KCA,0,3,3-0,KCA,9,0,33,38,71,141,141,282,7,13,20,1,2:52
14590,566943,2019-09-28,2019,TOR,TBA,4,1,4-1,TOR,9,1,36,35,71,160,148,308,16,9,25,3,3:17
14591,567333,2019-09-07,2019,CHA,ANA,7,8,8-7,ANA,9,0,37,47,84,196,151,347,10,21,31,2,3:32
14592,566251,2019-09-08,2019,PIT,SLN,0,2,2-0,SLN,9,0,32,35,67,143,120,263,7,9,16,1,2:50
14593,567624,2019-09-07,2019,MIL,CHN,3,2,3-2,MIL,9,0,39,35,74,151,156,307,13,9,22,5,3:35
14594,565107,2019-09-29,2019,BOS,BAL,5,4,5-4,BOS,9,0,38,36,74,164,144,308,16,8,24,3,3:22
14595,566067,2019-09-26,2019,NYN,MIA,2,4,4-2,MIA,9,0,35,33,68,123,140,263,10,6,16,3,2:45
14596,565004,2019-09-12,2019,BAL,LAN,2,4,4-2,LAN,9,0,35,37,72,134,148,282,9,9,18,4,3:09
14597,566354,2019-09-25,2019,SDN,LAN,4,6,6-4,LAN,9,0,39,38,77,148,151,299,12,13,25,2,3:20
14598,565964,2019-09-03,2019,WAS,NYN,11,10,11-10,WAS,9,0,42,39,81,147,142,289,19,14,33,5,3:17
14599,566744,2019-09-25,2019,TBA,NYA,4,0,4-0,TBA,9,1,34,32,66,142,139,281,11,6,17,5,3:10
14600,565963,2019-09-02,2019,WAS,NYN,3,7,7-3,NYN,9,0,33,43,76,170,123,293,6,16,22,2,3:08
14601,565684,2019-09-20,2019,HOU,ANA,6,4,6-4,HOU,9,1,36,35,71,139,138,277,12,9,21,1,2:49
14602,566157,2019-09-07,2019,OAK,DET,10,2,10-2,OAK,9,1,41,37,78,157,153,310,17,11,28,1,3:06
14603,567339,2019-09-25,2019,CHA,CLE,8,3,8-3,CHA,9,1,40,37,77,151,150,301,16,11,27,6,3:17
14604,566641,2019-09-15,2019,SLN,MIL,6,7,7-6,MIL,9,0,36,43,79,170,139,309,9,17,26,6,3:26
14605,565587,2019-09-22,2019,DET,CHA,6,3,6-3,DET,9,1,35,39,74,152,127,279,13,13,26,2,2:58
14606,566055,2019-09-07,2019,NYN,PHI,0,5,5-0,PHI,9,0,36,39,75,146,136,282,9,11,20,0,2:59
14607,565877,2019-09-20,2019,LAN,COL,12,5,12-5,LAN,9,1,43,37,80,141,182,323,20,12,32,3,3:39
14608,565198,2019-09-16,2019,CHN,CIN,8,2,8-2,CHN,9,1,39,40,79,164,158,322,16,14,30,4,3:27
14609,566841,2019-09-14,2019,TEX,OAK,6,8,8-6,OAK,9,0,42,43,85,151,189,340,17,15,32,2,3:47
14610,565971,2019-09-25,2019,WAS,PHI,5,2,5-2,WAS,9,1,34,34,68,119,135,254,9,8,17,3,2:45
14611,565298,2019-09-24,2019,CIN,MIL,2,4,4-2,MIL,9,0,36,37,73,150,142,292,9,11,20,2,2:52
14612,566348,2019-09-11,2019,SDN,CHN,4,0,4-0,SDN,9,1,36,31,67,127,160,287,14,5,19,2,3:00
14613,566059,2019-09-11,2019,NYN,ARI,9,0,9-0,NYN,9,1,39,38,77,163,141,304,16,12,28,1,3:06
14614,565197,2019-09-15,2019,CHN,PIT,16,6,16-6,CHN,9,1,46,41,87,163,158,321,22,16,38,3,3:28
14615,565490,2019-09-18,2019,COL,NYN,4,7,7-4,NYN,9,0,39,42,81,163,160,323,13,17,30,5,3:43
14616,567246,2019-09-21,2019,ATL,SFN,8,1,8-1,ATL,9,1,36,33,69,124,145,269,12,7,19,1,2:35
14617,564804,2019-09-10,2019,ANA,CLE,0,8,8-0,CLE,9,0,32,43,75,166,114,280,6,18,24,1,2:46
14618,567338,2019-09-24,2019,CHA,CLE,0,11,11-0,CLE,9,0,34,45,79,193,116,309,7,18,25,1,3:02
14619,565001,2019-09-08,2019,BAL,TEX,4,10,10-4,TEX,9,0,37,52,89,219,133,352,11,27,38,2,3:20
14620,565534,2019-05-19,2019,DET,OAK,3,7,7-3,OAK,9,0,34,42,76,162,133,295,8,17,25,3,2:58 (1:41 delay)
14621,565781,2019-09-28,2019,KCA,MIN,3,4,4-3,MIN,9,0,36,37,73,159,144,303,10,10,20,0,3:04
14622,565872,2019-09-06,2019,LAN,SFN,4,5,5-4,SFN,9,0,35,40,75,168,132,300,8,16,24,3,3:22
14623,567434,2019-09-10,2019,MIA,MIL,3,4,4-3,MIL,9,0,38,35,73,147,145,292,12,9,21,3,3:20
14624,565965,2019-09-04,2019,WAS,NYN,4,8,8-4,NYN,9,0,43,43,86,143,170,313,16,20,36,2,3:24
14625,566538,2019-09-01,2019,SFN,SDN,4,8,8-4,SDN,9,0,34,40,74,164,158,322,7,15,22,2,3:02
14626,567139,2019-09-29,2019,PHI,MIA,3,4,4-3,MIA,9,0,43,33,76,120,164,284,16,7,23,3,2:50
14627,565096,2019-09-04,2019,BOS,MIN,6,2,6-2,BOS,9,1,37,39,76,162,138,300,13,15,28,4,3:22 (:47 delay)
14628,567335,2019-09-10,2019,CHA,KCA,7,3,7-3,CHA,9,1,38,36,74,137,147,284,13,10,23,6,3:02
14629,566539,2019-09-09,2019,SFN,PIT,4,6,6-4,PIT,9,0,38,41,79,141,137,278,13,13,26,3,3:09
14630,565384,2019-09-02,2019,CLE,CHA,11,3,11-3,CLE,9,1,45,42,87,172,211,383,21,18,39,4,4:07
14631,566158,2019-09-08,2019,OAK,DET,3,1,3-1,OAK,9,1,32,32,64,126,114,240,9,5,14,1,2:14
14632,565291,2019-09-05,2019,CIN,PHI,4,3,4-3,CIN,11,0,41,42,83,175,167,342,13,9,22,4,3:36
14633,566940,2019-09-24,2019,TOR,BAL,4,11,11-4,BAL,9,0,36,47,83,184,127,311,9,20,29,2,3:12
14634,564999,2019-09-06,2019,BAL,TEX,6,7,7-6,TEX,9,0,39,39,78,159,127,286,13,16,29,3,3:03
14635,564809,2019-09-24,2019,ANA,OAK,3,2,3-2,ANA,9,1,34,33,67,142,131,273,11,7,18,2,2:52
14636,566547,2019-09-25,2019,SFN,COL,2,1,2-1,SFN,9,0,34,38,72,170,124,294,9,10,19,3,3:13
14637,565010,2019-09-22,2019,BAL,SEA,2,1,2-1,BAL,9,1,30,33,63,122,98,220,5,8,13,0,2:11
14638,565772,2019-09-03,2019,KCA,DET,6,5,6-5,KCA,9,0,36,40,76,146,156,302,14,15,29,4,3:09
14639,566448,2019-09-25,2019,SEA,HOU,0,3,3-0,HOU,9,0,29,36,65,136,118,254,3,8,11,1,2:33
14640,565386,2019-09-04,2019,CLE,CHA,8,6,8-6,CLE,9,1,40,43,83,190,148,338,18,17,35,4,3:54
14641,566836,2019-09-01,2019,TEX,SEA,3,11,11-3,SEA,9,0,38,50,88,204,154,358,13,25,38,2,3:39
14642,566343,2019-09-06,2019,SDN,COL,2,3,3-2,COL,9,0,36,35,71,144,146,290,10,9,19,3,3:05
14643,565974,2019-09-28,2019,WAS,CLE,10,7,10-7,WAS,9,1,40,40,80,164,136,300,18,14,32,2,3:10
14644,565873,2019-09-07,2019,LAN,SFN,0,1,1-0,SFN,9,0,34,39,73,168,125,293,9,13,22,4,3:21
14645,565487,2019-09-15,2019,COL,SDN,10,5,10-5,COL,9,1,44,41,85,179,179,358,21,15,36,3,3:44
14646,565100,2019-09-08,2019,BOS,NYA,5,10,10-5,NYA,9,0,34,44,78,192,139,331,9,15,24,3,3:48
14647,565677,2019-09-08,2019,HOU,SEA,21,1,21-1,HOU,9,1,55,28,83,107,206,313,30,1,31,1,2:50
14648,565491,2019-09-27,2019,COL,MIL,11,7,11-7,COL,9,1,41,45,86,164,159,323,18,21,39,3,3:33
14649,566345,2019-09-08,2019,SDN,COL,2,1,2-1,SDN,10,0,41,34,75,134,158,292,15,7,22,3,3:15
14650,566444,2019-09-13,2019,SEA,CHA,7,9,9-7,CHA,9,0,43,43,86,163,174,337,19,18,37,4,3:47
14651,565579,2019-09-12,2019,DET,NYA,4,6,6-4,NYA,9,0,37,39,76,173,134,307,10,15,25,4,3:02
14652,567535,2019-09-21,2019,NYA,TOR,7,2,7-2,NYA,9,1,38,33,71,134,163,297,15,6,21,0,3:01
14653,565590,2019-09-26,2019,DET,MIN,4,10,10-4,MIN,9,0,41,44,85,163,139,302,14,16,30,1,3:07
14654,567239,2019-09-06,2019,ATL,WAS,4,3,4-3,ATL,9,1,37,37,74,140,162,302,15,11,26,2,3:20
14655,566350,2019-09-20,2019,SDN,ARI,0,9,9-0,ARI,9,0,32,45,77,184,123,307,6,15,21,2,3:11
14656,566349,2019-09-12,2019,SDN,CHN,1,4,4-1,CHN,9,0,35,37,72,142,168,310,10,11,21,1,3:29
14657,566941,2019-09-25,2019,TOR,BAL,3,2,3-2,TOR,9,1,32,38,70,147,155,302,9,13,22,2,2:54
14658,567533,2019-09-19,2019,NYA,ANA,9,1,9-1,NYA,9,1,36,31,67,117,146,263,12,5,17,2,2:39
14659,565394,2019-09-20,2019,CLE,PHI,5,2,5-2,CLE,9,1,34,34,68,121,138,259,13,8,21,5,3:01
14660,566355,2019-09-26,2019,SDN,LAN,0,1,1-0,LAN,9,0,32,33,65,119,138,257,5,7,12,2,2:55
14661,567030,2019-09-06,2019,MIN,CLE,2,6,6-2,CLE,11,0,43,49,92,211,166,377,11,18,29,4,4:16
14662,567534,2019-09-20,2019,NYA,TOR,3,4,4-3,TOR,9,0,34,35,69,144,150,294,8,10,18,4,3:08
14663,566352,2019-09-22,2019,SDN,ARI,6,4,6-4,SDN,10,0,44,42,86,167,159,326,17,12,29,3,3:42
14664,566068,2019-09-27,2019,NYN,ATL,4,2,4-2,NYN,9,1,36,39,75,165,134,299,14,12,26,0,3:09
14665,566839,2019-09-12,2019,TEX,TBA,6,4,6-4,TEX,9,1,38,41,79,169,150,319,14,15,29,3,3:16
14666,566159,2019-09-16,2019,OAK,KCA,5,6,6-5,KCA,9,0,40,40,80,181,165,346,15,14,29,5,3:35
14667,565776,2019-09-14,2019,KCA,HOU,1,6,6-1,HOU,9,0,34,45,79,166,147,313,8,19,27,2,3:17
14668,564911,2019-09-27,2019,ARI,SDN,6,3,6-3,ARI,9,1,39,36,75,130,143,273,13,9,22,1,3:03
14669,567334,2019-09-08,2019,CHA,ANA,5,1,5-1,CHA,9,1,40,35,75,161,147,308,17,11,28,5,3:19
14670,567237,2019-09-03,2019,ATL,TOR,7,2,7-2,ATL,9,1,37,33,70,124,153,277,14,9,23,3,2:46
14671,567241,2019-09-08,2019,ATL,WAS,4,9,9-4,WAS,9,0,37,44,81,168,153,321,10,19,29,2,3:16
14672,566447,2019-09-24,2019,SEA,HOU,0,3,3-0,HOU,9,0,32,36,68,140,145,285,5,10,15,1,2:51
14673,566449,2019-09-26,2019,SEA,OAK,1,3,3-1,OAK,9,0,29,39,68,162,117,279,4,12,16,1,2:39
14674,566942,2019-09-27,2019,TOR,TBA,2,6,6-2,TBA,9,0,33,41,74,166,130,296,6,14,20,5,3:04
14675,566837,2019-09-10,2019,TEX,TBA,3,5,5-3,TBA,11,0,41,45,86,182,169,351,9,13,22,1,3:45
14676,566550,2019-09-28,2019,SFN,LAN,0,2,2-0,LAN,9,0,35,33,68,133,135,268,8,8,16,0,2:40
14677,567622,2019-09-05,2019,MIL,CHN,5,10,10-5,CHN,9,0,40,47,87,166,179,345,11,24,35,4,3:59
14678,565680,2019-09-11,2019,HOU,OAK,3,5,5-3,OAK,9,0,36,38,74,173,140,313,12,11,23,1,2:57
14679,566347,2019-09-10,2019,SDN,CHN,9,8,9-8,SDN,10,0,46,45,91,173,170,343,17,15,32,4,3:50
14680,566063,2019-09-15,2019,NYN,LAN,2,3,3-2,LAN,9,0,33,38,71,140,128,268,7,12,19,2,3:12
14681,566066,2019-09-25,2019,NYN,MIA,10,3,10-3,NYN,9,1,41,33,74,125,146,271,17,6,23,1,2:48
14682,564805,2019-09-11,2019,ANA,CLE,3,4,4-3,CLE,9,0,40,39,79,141,164,305,13,13,26,6,3:24
14683,565582,2019-09-14,2019,DET,BAL,8,4,8-4,DET,12,0,52,46,98,181,179,360,23,14,37,7,4:07
14684,566937,2019-09-14,2019,TOR,NYA,3,13,13-3,NYA,9,0,40,50,90,195,181,376,13,25,38,3,3:47
14685,566346,2019-09-09,2019,SDN,CHN,2,10,10-2,CHN,9,0,38,46,84,165,147,312,10,18,28,2,3:13
14686,566548,2019-09-26,2019,SFN,COL,8,3,8-3,SFN,9,1,36,38,74,165,138,303,16,9,25,5,3:21
14687,566164,2019-09-22,2019,OAK,TEX,3,8,8-3,TEX,9,0,39,39,78,140,169,309,13,13,26,1,3:15
14688,566646,2019-09-28,2019,SLN,CHN,6,8,8-6,CHN,9,0,41,44,85,158,184,342,15,17,32,4,3:46
14689,565879,2019-09-22,2019,LAN,COL,7,4,7-4,LAN,9,1,39,35,74,132,172,304,16,10,26,5,3:13
14690,566054,2019-09-06,2019,NYN,PHI,5,4,5-4,NYN,9,0,38,40,78,177,159,336,14,14,28,4,3:32
14691,564803,2019-09-09,2019,ANA,CLE,2,6,6-2,CLE,9,0,35,39,74,155,155,310,8,14,22,3,3:11
14692,566541,2019-09-11,2019,SFN,PIT,3,6,6-3,PIT,9,0,34,41,75,157,128,285,6,13,19,3,2:51
14693,567531,2019-09-17,2019,NYA,ANA,8,0,8-0,NYA,9,1,39,36,75,161,148,309,16,11,27,4,3:03
14694,566258,2019-09-27,2019,PIT,CIN,6,5,6-5,PIT,9,0,37,42,79,173,147,320,12,15,27,1,3:13
14695,565201,2019-09-19,2019,CHN,SLN,4,5,5-4,SLN,10,0,38,40,78,156,158,314,8,12,20,3,3:40
14696,566248,2019-09-05,2019,PIT,MIA,7,10,10-7,MIA,9,0,42,47,89,171,159,330,14,24,38,2,3:38
14697,566933,2019-09-10,2019,TOR,BOS,4,3,4-3,TOR,9,1,38,38,76,179,165,344,14,12,26,5,3:37
14698,566256,2019-09-25,2019,PIT,CHN,4,2,4-2,PIT,9,1,35,35,70,118,160,278,12,10,22,3,2:54
14699,567336,2019-09-11,2019,CHA,KCA,6,8,8-6,KCA,9,0,37,43,80,164,139,303,10,16,26,6,3:16
14700,566254,2019-09-19,2019,PIT,SEA,5,6,6-5,SEA,11,0,46,49,95,212,160,372,14,18,32,0,4:16
14701,566840,2019-09-13,2019,TEX,OAK,9,14,14-9,OAK,9,0,39,47,86,198,152,350,10,21,31,0,3:28
14702,565005,2019-09-17,2019,BAL,TOR,5,8,8-5,TOR,9,0,39,41,80,173,159,332,12,15,27,4,3:27
14703,566739,2019-09-20,2019,TBA,BOS,5,4,5-4,TBA,11,0,45,43,88,173,180,353,13,10,23,4,3:58
14704,565578,2019-09-10,2019,DET,NYA,12,11,12-11,DET,9,0,45,40,85,169,172,341,20,13,33,5,3:33
14705,565972,2019-09-26,2019,WAS,PHI,6,3,6-3,WAS,9,1,39,33,72,162,169,331,17,9,26,2,3:26
14706,566643,2019-09-17,2019,SLN,WAS,2,6,6-2,WAS,9,0,38,42,80,151,154,305,10,18,28,2,3:21
14707,567131,2019-09-09,2019,PHI,ATL,2,7,7-2,ATL,9,0,32,39,71,148,130,278,5,14,19,0,2:47
14708,565292,2019-09-06,2019,CIN,ARI,5,7,7-5,ARI,9,0,43,42,85,174,192,366,16,16,32,7,4:10
14709,565484,2019-09-12,2019,COL,SLN,3,10,10-3,SLN,9,0,39,47,86,182,172,354,13,21,34,6,3:56
14710,566845,2019-09-26,2019,TEX,BOS,7,5,7-5,TEX,9,1,37,37,74,131,160,291,13,12,25,4,3:02
14711,567433,2019-09-09,2019,MIA,MIL,3,8,8-3,MIL,9,0,44,47,91,204,171,375,17,21,38,6,4:08
14712,565679,2019-09-10,2019,HOU,OAK,7,21,21-7,OAK,9,0,39,56,95,200,154,354,15,29,44,3,3:20
14713,566645,2019-09-27,2019,SLN,CHN,2,8,8-2,CHN,9,0,42,46,88,191,186,377,14,20,34,4,4:04
14714,566637,2019-09-04,2019,SLN,SFN,8,9,9-8,SFN,9,0,44,48,92,196,169,365,16,20,36,7,4:05
14715,566843,2019-09-24,2019,TEX,BOS,10,12,12-10,BOS,9,0,48,45,93,158,194,352,22,19,41,3,3:59
14716,565202,2019-09-20,2019,CHN,SLN,1,2,2-1,SLN,9,0,37,41,78,187,152,339,13,14,27,7,3:55
14717,565674,2019-09-05,2019,HOU,SEA,11,9,11-9,HOU,13,0,56,54,110,230,217,447,20,15,35,5,4:40
14718,567436,2019-09-12,2019,MIA,MIL,2,3,3-2,MIL,9,0,34,35,69,146,140,286,7,8,15,1,2:59
14719,565678,2019-09-09,2019,HOU,OAK,15,0,15-0,HOU,9,1,41,30,71,119,148,267,19,4,23,2,2:42
14720,566844,2019-09-25,2019,TEX,BOS,3,10,10-3,BOS,9,0,36,43,79,182,151,333,10,16,26,2,3:18
14721,567435,2019-09-11,2019,MIA,MIL,5,7,7-5,MIL,9,0,37,40,77,156,155,311,10,14,24,3,3:02
14722,565393,2019-09-19,2019,CLE,DET,7,0,7-0,CLE,9,1,38,37,75,149,166,315,15,10,25,1,3:17
14723,567039,2019-09-19,2019,MIN,KCA,8,5,8-5,MIN,9,1,38,42,80,179,181,360,15,16,31,3,3:37
14724,565973,2019-09-27,2019,WAS,CLE,8,2,8-2,WAS,9,1,38,30,68,111,130,241,15,3,18,1,2:44
14725,566542,2019-09-12,2019,SFN,PIT,2,4,4-2,PIT,9,0,38,35,73,121,149,270,11,9,20,1,2:57
14726,567041,2019-09-21,2019,MIN,KCA,5,12,12-5,KCA,9,0,40,46,86,178,139,317,12,20,32,4,3:25
14727,566255,2019-09-24,2019,PIT,CHN,9,2,9-2,PIT,9,1,38,40,78,150,149,299,11,13,24,4,3:10
14728,565295,2019-09-20,2019,CIN,NYN,1,8,8-1,NYN,9,0,34,43,77,167,137,304,8,17,25,2,3:06
14729,565777,2019-09-15,2019,KCA,HOU,3,12,12-3,HOU,9,0,41,48,89,184,147,331,15,21,36,1,3:17
14730,565000,2019-09-07,2019,BAL,TEX,4,9,9-4,TEX,9,0,39,41,80,143,153,296,10,15,25,3,3:11
14731,566740,2019-09-21,2019,TBA,BOS,5,4,5-4,TBA,11,0,41,42,83,167,167,334,14,9,23,4,3:57
14732,565485,2019-09-13,2019,COL,SDN,10,8,10-8,COL,9,1,42,43,85,184,134,318,19,20,39,4,3:28
14733,567438,2019-09-21,2019,MIA,WAS,4,10,10-4,WAS,10,0,42,51,93,197,174,371,12,23,35,4,4:20
14734,566156,2019-09-06,2019,OAK,DET,4,5,5-4,DET,11,0,46,46,92,183,186,369,14,14,28,4,3:44
14735,566056,2019-09-08,2019,NYN,PHI,7,10,10-7,PHI,9,0,48,44,92,183,207,390,22,18,40,6,4:29
14736,567132,2019-09-10,2019,PHI,ATL,6,5,6-5,PHI,9,1,35,38,73,146,136,282,12,13,25,3,3:06
14737,567631,2019-09-21,2019,MIL,PIT,10,1,10-1,MIL,9,1,42,34,76,120,167,287,18,7,25,2,3:10
14738,565581,2019-09-13,2019,DET,BAL,2,6,6-2,BAL,9,0,39,39,78,161,143,304,14,15,29,1,3:02
14739,566260,2019-09-29,2019,PIT,CIN,1,3,3-1,CIN,9,0,34,37,71,129,129,258,8,12,20,1,2:43
14740,566443,2019-09-12,2019,SEA,CIN,5,11,11-5,CIN,9,0,41,45,86,177,166,343,14,18,32,5,3:21
14741,566446,2019-09-15,2019,SEA,CHA,11,10,11-10,SEA,9,0,51,39,90,138,205,343,29,13,42,6,3:44
14742,564811,2019-09-26,2019,ANA,HOU,4,3,4-3,ANA,12,0,47,56,103,230,203,433,11,22,33,6,4:32
14743,566741,2019-09-22,2019,TBA,BOS,4,7,7-4,BOS,9,0,38,45,83,173,158,331,14,17,31,3,3:32
14744,566442,2019-09-11,2019,SEA,CIN,5,3,5-3,SEA,9,1,31,38,69,154,136,290,9,10,19,2,2:58
14745,565103,2019-09-18,2019,BOS,SFN,3,11,11-3,SFN,9,0,35,45,80,206,146,352,10,17,27,4,3:34
14746,566065,2019-09-24,2019,NYN,MIA,5,4,5-4,NYN,11,0,46,46,92,187,172,359,15,14,29,2,3:51
14747,564806,2019-09-13,2019,ANA,TBA,4,11,11-4,TBA,9,0,35,42,77,173,133,306,10,17,27,1,3:07
14748,565105,2019-09-27,2019,BOS,BAL,1,4,4-1,BAL,9,0,32,42,74,180,140,320,8,15,23,0,3:02
14749,566743,2019-09-24,2019,TBA,NYA,2,1,2-1,TBA,12,0,41,45,86,167,192,359,10,9,19,3,4:00
14750,564910,2019-09-25,2019,ARI,SLN,9,7,9-7,ARI,9,1,40,41,81,152,169,321,15,15,30,5,3:52
14751,565586,2019-09-21,2019,DET,CHA,3,5,5-3,CHA,9,0,37,44,81,171,132,303,12,18,30,2,3:25
14752,565589,2019-09-25,2019,DET,MIN,1,5,5-1,MIN,9,0,31,38,69,142,113,255,2,12,14,2,2:32
14753,565778,2019-09-24,2019,KCA,ATL,9,6,9-6,KCA,9,1,41,41,82,153,164,317,17,15,32,3,3:28
14754,567247,2019-09-22,2019,ATL,SFN,1,4,4-1,SFN,9,0,34,41,75,159,144,303,7,13,20,1,3:07
14755,565876,2019-09-18,2019,LAN,TBA,7,8,8-7,TBA,11,0,47,50,97,214,164,378,15,18,33,4,4:40
14756,564908,2019-09-23,2019,ARI,SLN,7,9,9-7,SLN,9,0,39,44,83,176,156,332,14,16,30,2,3:29
14757,565200,2019-09-18,2019,CHN,CIN,2,3,3-2,CIN,10,0,35,44,79,186,132,318,6,16,22,5,3:40
14758,567133,2019-09-11,2019,PHI,ATL,1,3,3-1,ATL,9,0,36,38,74,162,159,321,10,14,24,1,3:31
14759,567042,2019-09-22,2019,MIN,KCA,12,8,12-8,MIN,9,1,46,44,90,193,180,373,23,18,41,6,4:05
14760,567532,2019-09-18,2019,NYA,ANA,2,3,3-2,ANA,9,0,35,43,78,186,131,317,9,16,25,2,3:20
14761,565097,2019-09-05,2019,BOS,MIN,1,2,2-1,MIN,9,0,31,35,66,146,115,261,6,11,17,2,2:58
14762,566639,2019-09-13,2019,SLN,MIL,10,0,10-0,SLN,9,1,39,34,73,147,180,327,16,8,24,1,3:12
14763,566644,2019-09-18,2019,SLN,WAS,5,1,5-1,SLN,9,1,32,37,69,129,128,257,9,11,20,3,2:55
14764,566543,2019-09-13,2019,SFN,MIA,1,0,1-0,SFN,9,1,33,29,62,120,106,226,10,5,15,1,2:22
14765,565101,2019-09-09,2019,BOS,NYA,0,5,5-0,NYA,9,0,37,42,79,194,140,334,10,15,25,3,3:25
14766,566742,2019-09-23,2019,TBA,BOS,7,4,7-4,TBA,9,1,34,42,76,171,135,306,11,15,26,3,3:29
14767,565006,2019-09-18,2019,BAL,TOR,10,11,11-10,TOR,9,0,47,51,98,201,192,393,19,24,43,5,4:08
14768,565779,2019-09-25,2019,KCA,ATL,2,10,10-2,ATL,9,0,35,48,83,204,140,344,8,21,29,4,3:31
14769,567243,2019-09-18,2019,ATL,PHI,1,4,4-1,PHI,9,0,35,36,71,146,132,278,7,8,15,1,2:59
14770,565685,2019-09-21,2019,HOU,ANA,4,8,8-4,ANA,9,0,35,44,79,179,143,322,10,17,27,3,3:23
14771,565009,2019-09-21,2019,BAL,SEA,6,7,7-6,SEA,13,0,52,55,107,226,188,414,13,16,29,4,4:42
14772,567629,2019-09-19,2019,MIL,SDN,5,1,5-1,MIL,9,1,35,36,71,161,138,299,10,9,19,2,3:05
14773,567137,2019-09-27,2019,PHI,MIA,5,4,5-4,PHI,15,0,62,61,123,203,227,430,21,19,40,4,5:13
14774,566069,2019-09-28,2019,NYN,ATL,3,0,3-0,NYN,9,1,28,37,65,134,107,241,6,11,17,1,2:33
14775,565486,2019-09-14,2019,COL,SDN,11,10,11-10,COL,9,1,42,43,85,157,147,304,17,18,35,6,3:29
14776,566353,2019-09-24,2019,SDN,LAN,3,6,6-3,LAN,9,0,36,39,75,141,139,280,9,13,22,3,2:58
14777,567343,2019-09-29,2019,CHA,DET,5,3,5-3,CHA,9,1,32,34,66,122,135,257,8,10,18,3,2:37
14778,566546,2019-09-24,2019,SFN,COL,5,8,8-5,COL,16,0,60,71,131,283,224,507,15,24,39,9,5:31
14779,566838,2019-09-11,2019,TEX,TBA,10,9,10-9,TEX,9,1,38,44,82,181,204,385,13,21,34,6,4:09
14780,567341,2019-09-28,2019,CHA,DET,3,4,4-3,DET,9,0,36,38,74,151,130,281,11,11,22,2,2:58
14781,565580,2019-09-12,2019,DET,NYA,4,10,10-4,NYA,9,0,43,46,89,196,173,369,16,18,34,3,3:36
14782,565204,2019-09-22,2019,CHN,SLN,2,3,3-2,SLN,9,0,35,33,68,127,125,252,11,8,19,2,3:03
14783,565782,2019-09-29,2019,KCA,MIN,5,4,5-4,KCA,9,0,37,33,70,112,147,259,12,7,19,3,2:40
14784,565775,2019-09-13,2019,KCA,HOU,1,4,4-1,HOU,9,0,33,41,74,180,114,294,7,15,22,1,2:58
14785,565681,2019-09-12,2019,HOU,OAK,2,3,3-2,OAK,9,0,39,35,74,144,176,320,13,8,21,4,3:39
14786,564913,2019-09-29,2019,ARI,SDN,1,0,1-0,ARI,9,0,33,34,67,135,120,255,8,9,17,1,2:46
14787,564906,2019-09-17,2019,ARI,MIA,6,12,12-6,MIA,9,0,41,50,91,183,161,344,16,25,41,1,3:49
14788,566647,2019-09-29,2019,SLN,CHN,9,0,9-0,SLN,9,1,41,28,69,91,170,261,18,4,22,1,2:30
14789,565975,2019-09-29,2019,WAS,CLE,8,2,8-2,WAS,9,1,39,36,75,131,142,273,16,10,26,1,2:50
14790,567037,2019-09-17,2019,MIN,CHA,9,8,9-8,MIN,12,0,54,58,112,191,209,400,23,23,46,4,4:51
14791,565203,2019-09-21,2019,CHN,SLN,8,9,9-8,SLN,9,0,42,45,87,195,168,363,16,21,37,5,4:24
14792,564813,2019-09-28,2019,ANA,HOU,3,6,6-3,HOU,9,0,34,39,73,159,112,271,7,12,19,2,2:55
14793,566452,2019-09-29,2019,SEA,OAK,3,1,3-1,SEA,9,1,36,34,70,141,149,290,12,7,19,2,2:52
14794,567337,2019-09-12,2019,CHA,KCA,3,6,6-3,KCA,9,0,42,36,78,144,150,294,17,8,25,2,3:08
14795,566451,2019-09-28,2019,SEA,OAK,0,1,1-0,OAK,9,0,35,35,70,149,129,278,8,10,18,2,2:41
14796,567138,2019-09-28,2019,PHI,MIA,9,3,9-3,PHI,9,1,39,36,75,132,152,284,16,10,26,2,3:06
14797,566257,2019-09-26,2019,PIT,CHN,9,5,9-5,PIT,9,1,40,36,76,148,149,297,17,9,26,2,3:15
14798,566259,2019-09-28,2019,PIT,CIN,2,4,4-2,CIN,12,0,45,55,100,231,168,399,11,22,33,5,4:27 (1:05 delay)
14799,566064,2019-09-23,2019,NYN,MIA,4,8,8-4,MIA,9,0,42,40,82,138,168,306,15,16,31,4,3:25
14800,564912,2019-09-28,2019,ARI,SDN,6,5,6-5,ARI,9,1,35,38,73,144,134,278,12,14,26,2,3:05
14801,565492,2019-09-28,2019,COL,MIL,3,2,3-2,COL,10,0,39,37,76,142,138,280,12,10,22,3,3:00
14802,566935,2019-09-12,2019,TOR,BOS,4,7,7-4,BOS,9,0,41,40,81,166,167,333,14,14,28,4,3:32
14803,565195,2019-09-13,2019,CHN,PIT,17,8,17-8,CHN,9,1,51,42,93,160,206,366,27,15,42,2,3:52
14804,566944,2019-09-29,2019,TOR,TBA,8,3,8-3,TOR,9,1,39,37,76,146,152,298,15,10,25,3,3:07
14805,567035,2019-09-12,2019,MIN,WAS,6,12,12-6,WAS,9,0,43,47,90,171,175,346,16,22,38,2,3:45 (:50 delay)
14806,566847,2019-09-28,2019,TEX,NYA,9,4,9-4,TEX,9,1,44,34,78,134,198,332,22,10,32,2,3:17
14807,564814,2019-09-29,2019,ANA,HOU,5,8,8-5,HOU,9,0,40,45,85,155,172,327,13,18,31,4,3:30
14808,567342,2019-09-28,2019,CHA,DET,7,1,7-1,CHA,9,1,38,31,69,116,151,267,14,6,20,1,2:41
14809,564909,2019-09-24,2019,ARI,SLN,3,2,3-2,ARI,19,0,74,73,147,321,273,594,25,17,42,4,6:53
14810,566939,2019-09-23,2019,TOR,BAL,11,10,11-10,TOR,15,0,64,66,130,259,271,530,23,23,46,4,5:21
14811,565686,2019-09-22,2019,HOU,ANA,13,5,13-5,HOU,9,1,44,41,85,170,160,330,21,14,35,3,3:32
14812,566551,2019-09-29,2019,SFN,LAN,0,9,9-0,LAN,9,0,31,48,79,198,132,330,6,23,29,4,3:23
14813,566450,2019-09-27,2019,SEA,OAK,4,3,4-3,SEA,9,0,38,39,77,154,183,337,13,13,26,2,3:34
14814,564812,2019-09-27,2019,ANA,HOU,0,4,4-0,HOU,9,0,29,34,63,142,111,253,4,10,14,1,2:37
14815,566846,2019-09-27,2019,TEX,NYA,7,14,14-7,NYA,9,0,39,47,86,175,161,336,12,23,35,3,3:37
14816,566070,2019-09-29,2019,NYN,ATL,7,6,7-6,NYN,11,0,47,45,92,172,161,333,17,14,31,6,3:44
14817,566936,2019-09-13,2019,TOR,NYA,6,5,6-5,TOR,12,0,46,49,95,210,167,377,16,14,30,3,4:08
14818,566934,2019-09-11,2019,TOR,BOS,8,0,8-0,TOR,9,1,36,31,67,127,144,271,14,3,17,3,2:49
14819,565106,2019-09-28,2019,BOS,BAL,4,9,9-4,BAL,9,0,40,42,82,189,172,361,14,16,30,6,3:37
14820,566549,2019-09-27,2019,SFN,LAN,2,9,9-2,LAN,9,0,46,39,85,154,209,363,17,14,31,4,3:42
14821,565493,2019-09-29,2019,COL,MIL,4,3,4-3,COL,13,0,48,54,102,211,175,386,14,15,29,1,4:02
14822,565102,2019-09-17,2019,BOS,SFN,6,7,7-6,SFN,15,0,68,64,132,253,294,547,25,22,47,8,5:54
14823,630851,2020-07-23,2020,WAS,NYA,1,4,4-1,NYA,6,1,18,26,44,99,75,174,3,10,13,0,1:43 (1:58 delay)
14824,631377,2020-07-23,2020,LAN,SFN,8,1,8-1,LAN,9,1,43,33,76,108,149,257,18,8,26,3,2:56
14825,631641,2020-07-24,2020,CHN,MIL,3,0,3-0,CHN,9,1,30,30,60,103,129,232,7,3,10,1,2:30
14826,631242,2020-07-24,2020,NYN,ATL,1,0,1-0,NYN,9,1,29,32,61,132,93,225,7,5,12,0,2:25
14827,630989,2020-07-24,2020,SLN,PIT,5,4,5-4,SLN,9,1,34,35,69,123,139,262,12,8,20,1,2:52
14828,630941,2020-07-24,2020,TEX,COL,1,0,1-0,TEX,9,1,31,36,67,161,116,277,6,9,15,1,2:57
14829,631438,2020-07-24,2020,HOU,SEA,8,2,8-2,HOU,9,1,39,32,71,120,150,270,14,6,20,1,2:49
14830,631563,2020-07-24,2020,CLE,KCA,2,0,2-0,CLE,9,1,33,35,68,151,127,278,10,9,19,1,2:58
14831,631589,2020-07-24,2020,CIN,DET,7,1,7-1,CIN,9,1,37,31,68,133,148,281,15,6,21,1,2:45
14832,631378,2020-07-24,2020,LAN,SFN,9,1,9-1,LAN,9,1,46,32,78,122,151,273,21,5,26,2,2:55
14833,631121,2020-07-24,2020,PHI,MIA,2,5,5-2,MIA,9,0,34,38,72,160,124,284,8,12,20,5,3:10
14834,631091,2020-07-24,2020,SDN,ARI,7,2,7-2,SDN,9,1,37,33,70,127,168,295,15,8,23,2,3:05
14835,631664,2020-07-24,2020,BOS,BAL,13,2,13-2,BOS,9,1,47,34,81,135,191,326,24,9,33,1,3:18
14836,631514,2020-07-24,2020,CHA,MIN,5,10,10-5,MIN,9,0,38,43,81,175,152,327,12,16,28,6,3:31
14837,630966,2020-07-24,2020,TBA,TOR,4,6,6-4,TOR,9,0,42,39,81,162,182,344,14,12,26,3,3:27
14838,631182,2020-07-24,2020,OAK,ANA,7,3,7-3,OAK,10,0,41,44,85,173,169,342,15,15,30,3,3:46
14839,630967,2020-07-25,2020,TBA,TOR,4,1,4-1,TBA,9,1,32,37,69,128,122,250,9,10,19,3,2:47
14840,630992,2020-07-25,2020,SLN,PIT,9,1,9-1,SLN,9,1,39,33,72,118,135,253,14,6,20,4,2:55
14841,631181,2020-07-25,2020,OAK,ANA,1,4,4-1,ANA,9,0,34,33,67,112,139,251,8,7,15,2,2:27
14842,630899,2020-07-25,2020,WAS,NYA,9,2,9-2,WAS,9,1,38,38,76,137,138,275,14,9,23,3,3:13
14843,631666,2020-07-25,2020,BOS,BAL,2,7,7-2,BAL,9,0,39,39,78,127,140,267,11,12,23,3,3:01
14844,631453,2020-07-25,2020,HOU,SEA,7,2,7-2,HOU,9,1,36,36,72,142,146,288,15,11,26,2,2:53
14845,631565,2020-07-25,2020,CLE,KCA,2,3,3-2,KCA,10,0,39,35,74,129,147,276,10,6,16,0,2:52
14846,631108,2020-07-25,2020,PHI,MIA,7,1,7-1,PHI,9,1,38,32,70,121,165,286,16,9,25,1,2:54
14847,631092,2020-07-25,2020,SDN,ARI,5,1,5-1,SDN,9,1,36,33,69,125,184,309,14,6,20,4,3:18
14848,631603,2020-07-25,2020,CIN,DET,4,6,6-4,DET,9,0,39,40,79,145,150,295,13,13,26,2,3:01
14849,631515,2020-07-25,2020,CHA,MIN,10,3,10-3,CHA,9,1,42,35,77,144,171,315,18,8,26,2,3:17
14850,631382,2020-07-25,2020,LAN,SFN,4,5,5-4,SFN,9,0,39,38,77,158,148,306,14,12,26,2,3:16
14851,630942,2020-07-25,2020,TEX,COL,2,3,3-2,COL,9,0,41,38,79,167,170,337,15,9,24,2,3:34
14852,631642,2020-07-25,2020,CHN,MIL,3,8,8-3,MIL,9,0,39,42,81,158,174,332,13,15,28,1,3:36
14853,631241,2020-07-25,2020,NYN,ATL,3,5,5-3,ATL,10,0,42,38,80,166,148,314,12,9,21,3,3:21
14854,630993,2020-07-26,2020,SLN,PIT,1,5,5-1,PIT,9,0,32,36,68,123,144,267,8,11,19,1,2:56
14855,630856,2020-07-26,2020,WAS,NYA,2,3,3-2,NYA,9,0,36,35,71,128,143,271,14,9,23,3,3:07
14856,631165,2020-07-26,2020,OAK,ANA,6,4,6-4,OAK,9,1,33,36,69,131,131,262,12,9,21,4,3:02
14857,630943,2020-07-26,2020,TEX,COL,2,5,5-2,COL,9,0,33,37,70,159,122,281,8,12,20,2,3:05
14858,631591,2020-07-26,2020,CIN,DET,2,3,3-2,DET,9,0,38,34,72,157,136,293,12,7,19,1,3:04
14859,631566,2020-07-26,2020,CLE,KCA,9,2,9-2,CLE,9,1,39,35,74,128,147,275,18,8,26,3,3:04
14860,631384,2020-07-26,2020,LAN,SFN,1,3,3-1,SFN,9,0,38,39,77,148,141,289,11,14,25,4,3:28
14861,631643,2020-07-26,2020,CHN,MIL,9,1,9-1,CHN,9,1,40,35,75,125,177,302,16,9,25,3,3:04
14862,631668,2020-07-26,2020,BOS,BAL,4,7,7-4,BAL,9,0,34,43,77,167,124,291,7,18,25,4,3:13
14863,631441,2020-07-26,2020,HOU,SEA,6,7,7-6,SEA,9,0,40,44,84,164,150,314,15,18,33,3,3:41
14864,631126,2020-07-26,2020,PHI,MIA,6,11,11-6,MIA,9,0,47,44,91,147,179,326,19,18,37,5,3:44
14865,631517,2020-07-26,2020,CHA,MIN,2,14,14-2,MIN,9,0,37,46,83,172,165,337,11,19,30,3,3:38
14866,631240,2020-07-26,2020,NYN,ATL,1,14,14-1,ATL,9,0,38,48,86,179,168,347,11,22,33,2,3:20
14867,630968,2020-07-26,2020,TBA,TOR,6,5,6-5,TBA,10,0,41,46,87,175,173,348,14,17,31,4,3:55
14868,631097,2020-07-26,2020,SDN,ARI,3,4,4-3,ARI,9,0,42,39,81,170,170,340,16,14,30,4,3:44
14869,631098,2020-07-27,2020,SDN,ARI,6,2,6-2,SDN,9,1,34,37,71,132,131,263,13,10,23,2,3:03
14870,631168,2020-07-27,2020,OAK,ANA,3,0,3-0,OAK,9,1,33,38,71,154,141,295,9,12,21,2,2:59
14871,630861,2020-07-27,2020,WAS,TOR,1,4,4-1,TOR,9,0,38,37,75,137,158,295,15,11,26,2,2:59
14872,631669,2020-07-27,2020,BOS,NYN,4,7,7-4,NYN,9,0,36,40,76,131,136,267,10,13,23,2,3:11
14873,630969,2020-07-27,2020,TBA,ATL,14,5,14-5,TBA,9,1,42,36,78,145,182,327,20,6,26,2,3:03
14874,631442,2020-07-27,2020,HOU,SEA,8,5,8-5,HOU,9,1,37,42,79,176,153,329,13,16,29,2,3:04
14875,631489,2020-07-27,2020,DET,KCA,6,14,14-6,KCA,9,0,41,47,88,177,163,340,13,20,33,3,3:20
14876,631592,2020-07-27,2020,CIN,CHN,7,8,8-7,CHN,9,0,47,44,91,173,205,378,18,16,34,5,3:46 (1:47 delay)
14877,631130,2020-07-27,2020,PIT,MIL,5,6,6-5,MIL,11,0,41,49,90,196,164,360,10,18,28,3,3:54 (1:42 delay)
14878,631490,2020-07-28,2020,DET,KCA,4,3,4-3,DET,9,1,34,31,65,99,122,221,13,5,18,1,2:25
14879,631567,2020-07-28,2020,CLE,CHA,5,3,5-3,CLE,9,1,32,35,67,135,125,260,10,8,18,1,2:43
14880,631567,2020-07-28,2020,CLE,CHA,5,3,5-3,CLE,9,1,32,35,67,135,125,260,10,8,18,1,2:43
14881,631269,2020-07-28,2020,MIN,SLN,6,3,6-3,MIN,9,1,33,36,69,151,117,268,9,10,19,2,2:42
14882,631014,2020-07-28,2020,SFN,SDN,3,5,5-3,SDN,9,0,33,35,68,141,128,269,9,7,16,1,2:54
14883,630944,2020-07-28,2020,TEX,ARI,1,4,4-1,ARI,9,0,31,40,71,168,124,292,4,14,18,1,3:10
14884,631132,2020-07-28,2020,PIT,MIL,8,6,8-6,PIT,9,1,39,37,76,153,140,293,14,16,30,6,3:22
14885,631443,2020-07-28,2020,HOU,LAN,2,5,5-2,LAN,9,0,35,43,78,155,143,298,8,16,24,3,3:19
14886,630970,2020-07-28,2020,TBA,ATL,5,2,5-2,TBA,9,1,33,36,69,157,120,277,10,10,20,3,3:03
14887,631171,2020-07-28,2020,OAK,COL,3,8,8-3,COL,9,0,38,44,82,164,134,298,11,16,27,0,2:58
14888,630866,2020-07-28,2020,WAS,TOR,1,5,5-1,TOR,9,0,31,38,69,140,141,281,5,9,14,3,3:00
14889,631663,2020-07-28,2020,BOS,NYN,3,8,8-3,NYN,9,0,36,43,79,141,132,273,11,16,27,3,2:58
14890,631387,2020-07-28,2020,ANA,SEA,10,2,10-2,ANA,9,1,43,36,79,144,173,317,20,9,29,2,3:15
14891,631593,2020-07-28,2020,CIN,CHN,5,8,8-5,CHN,9,0,36,41,77,165,133,298,9,15,24,3,3:02
14892,631573,2020-07-28,2020,CLE,CHA,4,3,4-3,CLE,9,1,36,41,77,163,159,322,13,14,27,2,3:15
14893,631270,2020-07-29,2020,MIN,SLN,3,0,3-0,MIN,9,1,33,30,63,125,156,281,9,4,13,3,2:53
14894,631137,2020-07-29,2020,PIT,MIL,0,3,3-0,MIL,9,0,29,38,67,157,126,283,2,13,15,2,3:02
14895,631492,2020-07-29,2020,DET,KCA,5,4,5-4,DET,9,1,32,36,68,133,126,259,7,9,16,0,2:40
14896,631569,2020-07-29,2020,CLE,CHA,0,4,4-0,CHA,9,0,34,35,69,130,143,273,9,7,16,1,2:57
14897,631172,2020-07-29,2020,OAK,COL,1,5,5-1,COL,9,0,36,40,76,148,151,299,9,15,24,1,2:55
14898,630495,2020-07-29,2020,BAL,NYA,3,9,9-3,NYA,9,0,36,42,78,163,152,315,9,14,23,2,3:12
14899,631594,2020-07-29,2020,CIN,CHN,12,7,12-7,CIN,9,1,40,41,81,161,168,329,19,13,32,5,3:23
14900,631239,2020-07-29,2020,NYN,BOS,5,6,6-5,BOS,9,0,43,38,81,151,179,330,20,13,33,2,3:44
14901,631033,2020-07-29,2020,SFN,SDN,7,6,7-6,SFN,9,0,37,40,77,159,147,306,13,17,30,4,3:02
14902,630940,2020-07-29,2020,TEX,ARI,7,4,7-4,TEX,9,1,40,36,76,158,167,325,17,9,26,3,3:27
14903,630272,2020-07-29,2020,ATL,TBA,7,4,7-4,ATL,9,1,41,37,78,147,165,312,17,10,27,3,3:22
14904,630916,2020-07-29,2020,TOR,WAS,0,4,4-0,WAS,10,0,35,40,75,173,156,329,6,10,16,2,3:33
14905,631389,2020-07-29,2020,ANA,SEA,7,10,10-7,SEA,9,0,40,43,83,178,160,338,13,18,31,5,3:47
14906,631444,2020-07-29,2020,HOU,LAN,2,4,4-2,LAN,13,0,52,47,99,167,222,389,16,9,25,5,4:44
14907,630346,2020-07-30,2020,ATL,TBA,2,1,2-1,ATL,9,1,33,31,64,117,117,234,11,6,17,3,2:40
14908,631271,2020-07-30,2020,MIN,CLE,0,2,2-0,CLE,9,0,30,37,67,156,108,264,3,13,16,0,2:52
14909,631494,2020-07-30,2020,DET,KCA,3,5,5-3,KCA,9,0,36,41,77,134,141,275,11,14,25,2,2:49
14910,630496,2020-07-30,2020,BAL,NYA,6,8,8-6,NYA,9,0,37,40,77,158,138,296,11,15,26,2,3:06 (1:34 delay)
14911,630917,2020-07-30,2020,TOR,WAS,4,6,6-4,WAS,9,0,38,41,79,162,139,301,13,15,28,4,3:35
14912,631390,2020-07-30,2020,ANA,SEA,5,8,8-5,SEA,9,0,34,41,75,153,143,296,7,15,22,3,2:59
14913,630145,2020-07-30,2020,ARI,LAN,3,6,6-3,LAN,9,0,36,41,77,170,143,313,9,15,24,4,3:19
14914,631238,2020-07-30,2020,NYN,BOS,2,4,4-2,BOS,9,0,38,39,77,179,164,343,12,14,26,3,3:49
14915,631018,2020-07-30,2020,SFN,SDN,7,12,12-7,SDN,10,0,49,48,97,171,187,358,19,17,36,4,4:04
14916,631480,2020-07-31,2020,DET,CIN,7,2,7-2,DET,9,1,36,31,67,118,132,250,12,4,16,1,2:31
14917,631066,2020-07-31,2020,SEA,OAK,5,3,5-3,SEA,9,1,35,34,69,129,141,270,11,7,18,1,2:34
14918,631222,2020-07-31,2020,NYA,BOS,5,1,5-1,NYA,9,1,38,33,71,141,156,297,15,8,23,3,3:08
14919,631019,2020-07-31,2020,SFN,TEX,9,2,9-2,SFN,9,1,38,39,77,150,142,292,16,11,27,2,3:04
14920,631272,2020-07-31,2020,MIN,CLE,4,1,4-1,MIN,9,1,36,34,70,152,158,310,16,8,24,0,3:06
14921,631410,2020-07-31,2020,KCA,CHA,2,3,3-2,CHA,9,0,38,35,73,145,141,286,10,8,18,1,2:56
14922,630201,2020-07-31,2020,ARI,LAN,5,3,5-3,ARI,9,1,36,39,75,153,150,303,15,12,27,4,3:15
14923,631647,2020-07-31,2020,CHN,PIT,6,3,6-3,CHN,9,1,41,34,75,138,183,321,19,8,27,4,3:46
14924,631539,2020-07-31,2020,COL,SDN,7,8,8-7,SDN,9,0,43,41,84,166,151,317,17,14,31,5,3:37 (:37 delay)
14925,630592,2020-07-31,2020,BAL,TBA,6,3,6-3,BAL,9,1,39,38,77,189,142,331,14,12,26,5,3:36 (:58 delay)
14926,630275,2020-07-31,2020,ATL,NYN,11,10,11-10,ATL,9,1,43,44,87,172,169,341,18,17,35,4,3:35
14927,631391,2020-07-31,2020,ANA,HOU,6,9,9-6,HOU,9,0,45,48,93,175,203,378,20,20,40,7,4:21
14928,631273,2020-08-01,2020,MIN,CLE,3,0,3-0,MIN,9,1,31,32,63,135,111,246,9,5,14,0,2:40
14929,631224,2020-08-01,2020,NYA,BOS,5,2,5-2,NYA,9,1,36,37,73,144,147,291,12,10,22,2,3:07
14930,631540,2020-08-01,2020,COL,SDN,6,1,6-1,COL,9,1,36,32,68,140,146,286,14,6,20,1,2:50
14931,630100,2020-08-01,2020,ARI,LAN,2,11,11-2,LAN,9,0,32,43,75,157,129,286,6,15,21,1,2:49
14932,631622,2020-08-01,2020,CHN,PIT,4,3,4-3,CHN,9,1,35,35,70,147,135,282,13,9,22,4,3:11
14933,631067,2020-08-01,2020,SEA,OAK,2,3,3-2,OAK,10,0,37,38,75,160,145,305,9,10,19,0,3:11
14934,630278,2020-08-01,2020,ATL,NYN,7,1,7-1,ATL,9,1,37,39,76,167,159,326,13,13,26,1,3:21
14935,631020,2020-08-01,2020,SFN,TEX,7,3,7-3,SFN,9,1,41,36,77,151,159,310,20,11,31,3,3:29
14936,631392,2020-08-01,2020,ANA,HOU,5,4,5-4,ANA,10,0,40,44,84,162,162,324,12,16,28,5,3:58
14937,631413,2020-08-01,2020,KCA,CHA,5,11,11-5,CHA,9,0,44,53,97,169,173,342,18,25,43,7,3:44
14938,630492,2020-08-01,2020,BAL,TBA,5,4,5-4,BAL,11,0,45,44,89,179,173,352,14,12,26,6,3:50
14939,631470,2020-08-02,2020,DET,CIN,3,4,4-3,CIN,7,0,28,30,58,127,104,231,6,11,17,3,2:25 (2:06 delay)
14940,631469,2020-08-02,2020,DET,CIN,0,4,4-0,CIN,7,0,25,36,61,145,111,256,4,15,19,1,2:36
14941,631469,2020-08-02,2020,DET,CIN,0,4,4-0,CIN,7,0,25,36,61,145,111,256,4,15,19,1,2:36
14942,630493,2020-08-02,2020,BAL,TBA,5,1,5-1,BAL,9,1,39,33,72,129,134,263,16,6,22,3,2:56
14943,631274,2020-08-02,2020,MIN,CLE,3,1,3-1,MIN,9,1,30,31,61,130,146,276,7,4,11,1,2:54
14944,631541,2020-08-02,2020,COL,SDN,9,6,9-6,COL,9,1,36,39,75,146,130,276,14,12,26,4,2:52
14945,630280,2020-08-02,2020,ATL,NYN,4,0,4-0,ATL,9,1,32,40,72,171,111,282,9,15,24,3,3:06
14946,630101,2020-08-02,2020,ARI,LAN,0,3,3-0,LAN,9,0,32,36,68,127,147,274,5,9,14,2,2:56
14947,631415,2020-08-02,2020,KCA,CHA,2,9,9-2,CHA,9,0,32,45,77,169,111,280,7,20,27,3,3:01
14948,631068,2020-08-02,2020,SEA,OAK,2,3,3-2,OAK,9,0,35,37,72,178,152,330,8,11,19,2,3:20
14949,631606,2020-08-02,2020,CHN,PIT,2,1,2-1,CHN,11,0,39,41,80,156,161,317,8,9,17,2,3:37 (1:04 delay)
14950,631210,2020-08-02,2020,NYA,BOS,9,7,9-7,NYA,9,1,39,38,77,157,158,315,15,11,26,1,3:12
14951,631021,2020-08-02,2020,SFN,TEX,5,9,9-5,TEX,9,0,39,43,82,148,153,301,11,16,27,3,3:04
14952,631393,2020-08-02,2020,ANA,HOU,5,6,6-5,HOU,11,0,50,50,100,205,186,391,19,19,38,7,4:37
14953,631645,2020-08-03,2020,CHN,KCA,2,0,2-0,CHN,9,1,32,34,66,133,138,271,8,8,16,1,2:43 (:16 delay)
14954,631219,2020-08-03,2020,NYA,PHI,6,3,6-3,NYA,9,1,33,37,70,159,137,296,11,11,22,2,3:00 (1:07 delay)
14955,631542,2020-08-03,2020,COL,SFN,7,6,7-6,COL,9,1,36,38,74,135,139,274,12,12,24,3,2:48
14956,631596,2020-08-03,2020,CIN,CLE,3,2,3-2,CIN,9,1,29,33,62,143,117,260,5,8,13,0,2:33 (1:53 delay)
14957,631275,2020-08-03,2020,MIN,PIT,5,4,5-4,MIN,9,0,39,37,76,138,163,301,14,13,27,2,3:13
14958,631219,2020-08-03,2020,NYA,PHI,6,3,6-3,NYA,9,1,33,37,70,159,137,296,11,11,22,2,3:00 (1:07 delay)
14959,631090,2020-08-03,2020,SDN,LAN,5,4,5-4,SDN,9,1,34,34,68,133,134,267,13,8,21,1,2:44
14960,630281,2020-08-03,2020,ATL,NYN,2,7,7-2,NYN,9,0,37,42,79,155,162,317,11,17,28,3,3:16
14961,631070,2020-08-03,2020,SEA,OAK,1,11,11-1,OAK,9,0,36,51,87,212,121,333,8,26,34,1,3:04
14962,631293,2020-08-03,2020,MIL,CHA,4,6,6-4,CHA,9,0,39,43,82,181,146,327,14,17,31,5,3:43
14963,631543,2020-08-04,2020,COL,SFN,5,2,5-2,COL,9,1,34,33,67,119,130,249,8,8,16,2,2:36
14964,630575,2020-08-04,2020,BAL,MIA,0,4,4-0,MIA,9,0,31,35,66,139,120,259,4,8,12,3,2:38
14965,630575,2020-08-04,2020,BAL,MIA,0,4,4-0,MIA,9,0,31,35,66,139,120,259,4,8,12,3,2:38
14966,631173,2020-08-04,2020,OAK,TEX,5,1,5-1,OAK,9,0,34,32,66,122,148,270,11,7,18,2,2:52
14967,631608,2020-08-04,2020,CHN,KCA,5,4,5-4,CHN,9,1,35,36,71,130,143,273,13,10,23,2,2:51
14968,630874,2020-08-04,2020,WAS,NYN,5,3,5-3,WAS,9,1,35,40,75,162,151,313,12,14,26,3,3:13 (1:07 delay)
14969,631597,2020-08-04,2020,CIN,CLE,2,4,4-2,CLE,9,0,33,39,72,172,125,297,7,11,18,3,2:59
14970,631057,2020-08-04,2020,SEA,ANA,3,5,5-3,ANA,9,0,36,36,72,144,148,292,10,10,20,3,2:55
14971,630284,2020-08-04,2020,ATL,TOR,10,1,10-1,ATL,9,1,44,34,78,130,161,291,21,9,30,3,3:06
14972,631276,2020-08-04,2020,MIN,PIT,7,3,7-3,MIN,9,1,38,40,78,154,154,308,16,14,30,2,3:30 (:09 delay)
14973,631069,2020-08-04,2020,SDN,LAN,2,5,5-2,LAN,9,0,33,41,74,148,129,277,7,13,20,4,3:04
14974,630971,2020-08-04,2020,TBA,BOS,5,1,5-1,TBA,9,1,35,37,72,150,136,286,12,9,21,4,3:14
14975,630109,2020-08-04,2020,ARI,HOU,2,8,8-2,HOU,9,0,38,46,84,165,136,301,12,19,31,2,3:09
14976,631294,2020-08-04,2020,MIL,CHA,2,3,3-2,CHA,9,0,35,39,74,144,158,302,11,12,23,0,3:14
14977,631339,2020-08-05,2020,MIA,BAL,2,1,2-1,MIA,7,1,23,28,51,108,75,183,5,8,13,3,2:06
14978,631127,2020-08-05,2020,PHI,NYA,1,3,3-1,NYA,7,0,26,28,54,116,101,217,5,8,13,4,2:38
14979,630591,2020-08-05,2020,BAL,MIA,0,1,1-0,MIA,7,0,27,29,56,121,93,214,7,6,13,2,2:19
14980,631339,2020-08-05,2020,MIA,BAL,2,1,2-1,MIA,7,1,23,28,51,108,75,183,5,8,13,3,2:06
14981,630591,2020-08-05,2020,BAL,MIA,0,1,1-0,MIA,7,0,27,29,56,121,93,214,7,6,13,2,2:19
14982,631127,2020-08-05,2020,PHI,NYA,1,3,3-1,NYA,7,0,26,28,54,116,101,217,5,8,13,4,2:38
14983,631518,2020-08-05,2020,CHA,MIL,0,1,1-0,MIL,9,0,32,33,65,117,113,230,9,6,15,0,2:21
14984,631544,2020-08-05,2020,COL,SFN,3,4,4-3,SFN,9,0,34,34,68,122,132,254,8,7,15,1,2:48
14985,631174,2020-08-05,2020,OAK,TEX,6,4,6-4,OAK,9,1,35,35,70,141,149,290,11,8,19,3,2:55
14986,631140,2020-08-05,2020,PIT,MIN,2,5,5-2,MIN,9,0,31,38,69,147,122,269,5,12,17,1,2:52
14987,630307,2020-08-05,2020,ATL,TOR,1,2,2-1,TOR,9,0,32,33,65,149,142,291,7,6,13,2,3:00
14988,631220,2020-08-05,2020,NYA,PHI,7,11,11-7,PHI,7,0,33,40,73,131,125,256,14,18,32,3,2:44
14989,630972,2020-08-05,2020,TBA,BOS,0,5,5-0,BOS,9,0,34,39,73,140,150,290,9,13,22,1,3:05
14990,630878,2020-08-05,2020,WAS,NYN,1,3,3-1,NYN,9,0,31,39,70,165,100,265,5,15,20,1,2:46
14991,631220,2020-08-05,2020,NYA,PHI,7,11,11-7,PHI,7,0,33,40,73,131,125,256,14,18,32,3,2:44
14992,631417,2020-08-05,2020,KCA,CHN,1,6,6-1,CHN,9,0,32,38,70,156,124,280,6,12,18,2,3:09
14993,631570,2020-08-05,2020,CLE,CIN,2,0,2-0,CLE,9,1,32,34,66,140,141,281,10,9,19,2,2:56
14994,631085,2020-08-05,2020,SDN,LAN,6,7,7-6,LAN,9,0,40,36,76,142,159,301,14,10,24,1,3:11
14995,631043,2020-08-05,2020,SEA,ANA,7,6,7-6,SEA,9,1,40,34,74,138,159,297,18,7,25,3,3:09
14996,630110,2020-08-05,2020,ARI,HOU,14,7,14-7,ARI,9,1,44,38,82,149,153,302,21,12,33,2,3:14
14997,631175,2020-08-06,2020,OAK,TEX,6,4,6-4,OAK,9,1,35,39,74,121,125,246,11,14,25,2,2:39
14998,631042,2020-08-06,2020,SEA,ANA,1,6,6-1,ANA,9,0,32,39,71,142,107,249,5,12,17,1,2:23
14999,630313,2020-08-06,2020,ATL,TOR,4,3,4-3,ATL,9,0,32,32,64,111,121,232,7,5,12,2,2:37
15000,631148,2020-08-06,2020,PIT,MIN,6,5,6-5,PIT,9,0,34,39,73,151,122,273,9,12,21,1,3:07
15001,631340,2020-08-06,2020,MIA,BAL,8,7,8-7,MIA,9,1,38,39,77,139,125,264,14,12,26,3,2:58
15002,631340,2020-08-06,2020,MIA,BAL,8,7,8-7,MIA,9,1,38,39,77,139,125,264,14,12,26,3,2:58
15003,630111,2020-08-06,2020,ARI,HOU,5,4,5-4,ARI,9,0,38,35,73,134,154,288,16,9,25,3,3:15
15004,631425,2020-08-06,2020,KCA,CHN,13,2,13-2,KCA,9,1,45,36,81,132,161,293,22,10,32,2,3:02
15005,631545,2020-08-06,2020,COL,SFN,6,4,6-4,COL,9,1,37,37,74,139,143,282,14,14,28,5,3:06 (:31 delay)
15006,631571,2020-08-06,2020,CLE,CIN,13,0,13-0,CLE,9,1,44,33,77,128,182,310,21,7,28,1,2:53
15007,631129,2020-08-06,2020,PHI,NYA,5,4,5-4,PHI,9,1,35,38,73,157,178,335,12,11,23,2,3:22
15008,631129,2020-08-06,2020,PHI,NYA,5,4,5-4,PHI,9,1,35,38,73,157,178,335,12,11,23,2,3:22
15009,631513,2020-08-06,2020,CHA,MIL,3,8,8-3,MIL,9,0,36,50,86,212,166,378,10,22,32,2,3:41
15010,631073,2020-08-07,2020,SDN,ARI,3,0,3-0,SDN,9,1,29,32,61,131,106,237,6,5,11,1,2:27
15011,631419,2020-08-07,2020,KCA,MIN,3,2,3-2,KCA,9,1,33,35,68,133,115,248,10,9,19,3,2:53 (:09 delay)
15012,630974,2020-08-07,2020,TBA,NYA,1,0,1-0,TBA,9,1,28,33,61,159,107,266,4,7,11,1,2:52
15013,631504,2020-08-07,2020,CHA,CLE,2,0,2-0,CHA,9,1,30,37,67,164,114,278,7,13,20,1,2:48
15014,631295,2020-08-07,2020,MIL,CIN,3,8,8-3,CIN,9,0,34,41,75,163,162,325,9,15,24,1,2:59
15015,631237,2020-08-07,2020,NYN,MIA,3,4,4-3,MIA,9,0,37,37,74,154,151,305,9,11,20,6,3:34
15016,630879,2020-08-07,2020,WAS,BAL,0,11,11-0,BAL,9,0,32,52,84,181,120,301,6,24,30,1,3:00
15017,631045,2020-08-07,2020,SEA,COL,4,8,8-4,COL,9,0,38,41,79,165,136,301,10,15,25,1,3:13
15018,630920,2020-08-07,2020,TEX,ANA,4,3,4-3,TEX,9,1,35,38,73,159,150,309,12,11,23,6,3:38
15019,631623,2020-08-07,2020,BOS,TOR,5,3,5-3,BOS,9,1,38,37,75,154,175,329,15,14,29,2,3:33
15020,631358,2020-08-07,2020,LAN,SFN,7,2,7-2,LAN,9,1,39,36,75,159,156,315,15,10,25,2,3:16
15021,631176,2020-08-07,2020,OAK,HOU,3,2,3-2,OAK,13,0,55,50,105,161,201,362,20,11,31,0,4:13
15022,631105,2020-08-07,2020,PIT,DET,13,17,17-13,DET,11,0,52,56,108,223,202,425,20,23,43,4,4:33
15023,631177,2020-08-08,2020,OAK,HOU,3,1,3-1,OAK,9,1,32,32,64,110,118,228,10,5,15,0,2:24
15024,630935,2020-08-08,2020,TEX,ANA,2,0,2-0,TEX,9,1,29,33,62,156,120,276,5,6,11,1,2:46
15025,631133,2020-08-08,2020,PHI,ATL,5,0,5-0,PHI,9,1,35,31,66,127,119,246,12,5,17,2,2:31
15026,631046,2020-08-08,2020,SEA,COL,0,5,5-0,COL,9,0,30,41,71,164,122,286,4,15,19,4,2:49
15027,631296,2020-08-08,2020,MIL,CIN,1,4,4-1,CIN,9,0,31,39,70,145,139,284,5,12,17,1,2:40
15028,630973,2020-08-08,2020,TBA,NYA,5,3,5-3,TBA,7,1,33,29,62,115,138,253,15,11,26,3,2:47
15029,631074,2020-08-08,2020,SDN,ARI,2,3,3-2,ARI,9,0,33,35,68,139,128,267,8,8,16,2,2:51
15030,631343,2020-08-08,2020,LAN,SFN,4,5,5-4,SFN,9,0,33,39,72,151,130,281,6,12,18,2,2:54
15031,631658,2020-08-08,2020,BOS,TOR,1,2,2-1,TOR,9,0,35,40,75,153,129,282,8,15,23,2,3:18
15032,631236,2020-08-08,2020,NYN,MIA,8,4,8-4,NYN,9,1,36,40,76,162,127,289,12,15,27,3,3:03
15033,631106,2020-08-08,2020,PIT,DET,5,11,11-5,DET,9,0,40,47,87,180,141,321,13,20,33,1,3:22
15034,630962,2020-08-08,2020,TBA,NYA,4,8,8-4,NYA,7,0,30,37,67,160,153,313,9,16,25,2,2:52
15035,630880,2020-08-08,2020,WAS,BAL,3,5,5-3,BAL,9,0,37,35,72,153,172,325,11,8,19,3,3:27
15036,631503,2020-08-08,2020,CHA,CLE,1,7,7-1,CLE,9,0,37,40,77,176,144,320,10,15,25,1,3:11
15037,631420,2020-08-08,2020,KCA,MIN,9,6,9-6,KCA,9,1,41,39,80,169,185,354,18,13,31,3,3:55
15038,631373,2020-08-09,2020,LAN,SFN,6,2,6-2,LAN,9,1,31,34,65,124,115,239,8,7,15,6,2:41
15039,631630,2020-08-09,2020,BOS,TOR,5,3,5-3,BOS,9,0,32,35,67,130,136,266,5,7,12,1,2:46
15040,631131,2020-08-09,2020,PHI,ATL,0,8,8-0,ATL,7,0,27,36,63,130,111,241,6,15,21,2,2:29
15041,631136,2020-08-09,2020,PHI,ATL,2,5,5-2,ATL,7,0,30,33,63,132,118,250,9,15,24,5,2:59
15042,631131,2020-08-09,2020,PHI,ATL,0,8,8-0,ATL,7,0,27,36,63,130,111,241,6,15,21,2,2:29
15043,631110,2020-08-09,2020,PIT,DET,1,2,2-1,DET,9,0,35,35,70,134,121,255,10,9,19,0,2:45
15044,631047,2020-08-09,2020,SEA,COL,5,3,5-3,SEA,9,1,33,36,69,143,115,258,10,9,19,1,2:45
15045,631235,2020-08-09,2020,NYN,MIA,4,2,4-2,NYN,9,1,37,39,76,166,126,292,14,13,27,1,3:09
15046,630946,2020-08-09,2020,TBA,NYA,4,3,4-3,TBA,9,0,36,39,75,165,134,299,13,12,25,2,3:08
15047,630882,2020-08-09,2020,WAS,BAL,2,6,6-2,BAL,9,0,38,37,75,130,151,281,13,11,24,5,3:11 (2:08 delay)
15048,631075,2020-08-09,2020,SDN,ARI,9,5,9-5,SDN,9,1,40,37,77,150,155,305,16,10,26,2,2:59
15049,631178,2020-08-09,2020,OAK,HOU,7,2,7-2,OAK,9,1,37,34,71,139,150,289,13,9,22,2,2:58
15050,630882,2020-08-09,2020,WAS,BAL,2,6,6-2,BAL,9,0,38,37,75,130,151,281,13,11,24,5,3:11 (2:08 delay)
15051,631421,2020-08-09,2020,KCA,MIN,4,2,4-2,KCA,9,1,36,36,72,155,137,292,13,9,22,1,3:16 (:25 delay)
15052,630922,2020-08-09,2020,TEX,ANA,7,3,7-3,TEX,9,1,35,39,74,197,133,330,10,13,23,4,3:36
15053,631297,2020-08-09,2020,MIL,CIN,9,3,9-3,MIL,9,1,43,38,81,171,170,341,18,12,30,2,3:14
15054,631506,2020-08-09,2020,CHA,CLE,4,5,5-4,CLE,10,0,38,44,82,151,164,315,10,14,24,1,3:20 (:46 delay)
15055,631298,2020-08-10,2020,MIL,MIN,2,4,4-2,MIN,9,0,36,37,73,138,151,289,9,10,19,0,2:57
15056,631346,2020-08-10,2020,LAN,SDN,1,2,2-1,SDN,9,0,34,34,68,124,145,269,8,10,18,1,2:56
15057,631445,2020-08-10,2020,HOU,SFN,6,4,6-4,HOU,9,1,37,35,72,135,151,286,11,8,19,2,3:07
15058,631473,2020-08-10,2020,DET,CHA,5,1,5-1,DET,9,1,32,37,69,155,129,284,11,10,21,2,2:47
15059,631138,2020-08-10,2020,PHI,ATL,13,8,13-8,PHI,9,1,43,36,79,133,158,291,19,10,29,2,2:54
15060,630923,2020-08-10,2020,TEX,SEA,2,10,10-2,SEA,9,0,39,48,87,190,125,315,12,22,34,3,3:18
15061,631233,2020-08-10,2020,NYN,WAS,4,16,16-4,WAS,9,0,37,49,86,178,121,299,11,21,32,2,2:59
15062,631546,2020-08-10,2020,COL,ARI,8,12,12-8,ARI,9,0,43,48,91,166,161,327,18,21,39,3,3:43
15063,631395,2020-08-10,2020,ANA,OAK,10,9,10-9,ANA,9,1,41,43,84,185,166,351,20,17,37,4,3:41
15064,631631,2020-08-10,2020,BOS,TBA,7,8,8-7,TBA,9,0,41,48,89,199,162,361,16,24,40,7,4:24
15065,631396,2020-08-11,2020,ANA,OAK,6,0,6-0,ANA,9,1,41,34,75,139,154,293,17,8,25,1,2:56
15066,631243,2020-08-11,2020,NYN,WAS,1,2,2-1,WAS,9,0,35,33,68,125,142,267,10,10,20,1,2:55
15067,631347,2020-08-11,2020,LAN,SDN,2,6,6-2,SDN,9,0,37,38,75,129,144,273,12,12,24,4,3:02
15068,631474,2020-08-11,2020,DET,CHA,4,8,8-4,CHA,9,0,36,38,74,138,142,280,10,12,22,3,2:51
15069,631299,2020-08-11,2020,MIL,MIN,6,4,6-4,MIL,9,1,33,40,73,165,114,279,9,14,23,1,2:56
15070,631646,2020-08-11,2020,BOS,TBA,2,8,8-2,TBA,9,0,35,42,77,172,134,306,12,15,27,4,3:25
15071,631547,2020-08-11,2020,COL,ARI,8,7,8-7,COL,9,1,38,43,81,135,139,274,16,17,33,4,3:16
15072,630924,2020-08-11,2020,TEX,SEA,4,2,4-2,TEX,9,1,35,35,70,157,128,285,11,8,19,1,2:56
15073,630901,2020-08-11,2020,TOR,MIA,5,4,5-4,TOR,10,0,39,38,77,162,148,310,13,9,22,2,3:20
15074,631572,2020-08-11,2020,CLE,CHN,1,7,7-1,CHN,9,0,35,41,76,193,136,329,7,17,24,1,3:14
15075,631192,2020-08-11,2020,NYA,ATL,9,6,9-6,NYA,9,1,38,40,78,131,186,317,15,10,25,3,3:18
15076,631598,2020-08-11,2020,CIN,KCA,6,5,6-5,CIN,10,0,39,44,83,170,173,343,14,15,29,1,3:33
15077,631446,2020-08-11,2020,HOU,SFN,6,7,7-6,SFN,10,0,43,46,89,185,171,356,17,17,34,4,3:52
15078,631139,2020-08-11,2020,PHI,BAL,9,10,10-9,BAL,10,0,47,46,93,181,171,352,16,20,36,4,4:00
15079,631648,2020-08-12,2020,BOS,TBA,5,9,9-5,TBA,9,0,38,41,79,132,140,272,12,17,29,2,2:58
15080,631350,2020-08-12,2020,LAN,SDN,6,0,6-0,LAN,9,1,33,36,69,156,105,261,10,10,20,3,2:52
15081,631397,2020-08-12,2020,ANA,OAK,4,8,8-4,OAK,9,0,34,42,76,174,134,308,7,15,22,5,3:20
15082,631447,2020-08-12,2020,HOU,SFN,5,1,5-1,HOU,9,1,37,35,72,133,174,307,15,8,23,4,3:25
15083,631141,2020-08-12,2020,PHI,BAL,4,5,5-4,BAL,9,0,40,40,80,149,160,309,15,13,28,2,3:28
15084,631300,2020-08-12,2020,MIL,MIN,2,12,12-2,MIN,9,0,35,49,84,192,123,315,8,22,30,3,3:08
15085,630926,2020-08-12,2020,TEX,SEA,7,4,7-4,TEX,9,1,41,41,82,157,157,314,18,14,32,2,3:09
15086,631232,2020-08-12,2020,NYN,WAS,11,6,11-6,NYN,9,1,43,37,80,144,169,313,19,12,31,2,3:19
15087,631475,2020-08-12,2020,DET,CHA,5,7,7-5,CHA,9,0,37,42,79,157,155,312,10,14,24,2,3:12
15088,631568,2020-08-12,2020,CLE,CHN,2,7,7-2,CHN,9,0,37,43,80,191,146,337,11,18,29,4,3:32
15089,631599,2020-08-12,2020,CIN,KCA,4,5,5-4,KCA,9,0,39,41,80,167,165,332,15,14,29,2,3:40
15090,631208,2020-08-12,2020,NYA,ATL,6,3,6-3,NYA,9,1,43,41,84,157,178,335,20,14,34,6,3:40
15091,631535,2020-08-12,2020,COL,ARI,7,13,13-7,ARI,9,0,47,46,93,162,185,347,22,20,42,5,3:56
15092,630902,2020-08-12,2020,TOR,MIA,11,14,14-11,MIA,10,0,50,50,100,200,184,384,22,20,42,8,4:20
15093,631609,2020-08-13,2020,CHN,MIL,4,2,4-2,CHN,9,1,35,33,68,132,156,288,13,7,20,1,3:06
15094,631351,2020-08-13,2020,LAN,SDN,11,2,11-2,LAN,9,1,41,34,75,137,151,288,18,7,25,2,2:45
15095,631142,2020-08-13,2020,PHI,BAL,4,11,11-4,BAL,9,0,35,44,79,189,123,312,8,20,28,5,3:29 (1:39 delay)
15096,631231,2020-08-13,2020,NYN,WAS,8,2,8-2,NYN,9,1,42,39,81,153,169,322,19,10,29,1,3:25
15097,631600,2020-08-13,2020,CIN,PIT,6,9,9-6,PIT,9,0,40,40,80,153,177,330,14,14,28,3,3:21
15098,631650,2020-08-13,2020,BOS,TBA,8,17,17-8,TBA,9,0,43,53,96,204,171,375,17,24,41,3,3:44 (:06 delay)
15099,631516,2020-08-14,2020,COL,TEX,2,3,3-2,TEX,9,0,31,33,64,142,110,252,2,9,11,1,2:33
15100,631322,2020-08-14,2020,MIA,ATL,8,2,8-2,MIA,9,1,42,35,77,120,165,285,18,9,27,1,2:59
15101,631610,2020-08-14,2020,CHN,MIL,3,4,4-3,MIL,9,0,39,34,73,127,183,310,11,8,19,4,3:13
15102,631381,2020-08-14,2020,ANA,LAN,4,7,7-4,LAN,9,0,35,38,73,133,144,277,9,11,20,3,2:58
15103,631601,2020-08-14,2020,CIN,PIT,8,1,8-1,CIN,9,1,36,33,69,145,141,286,13,6,19,2,2:50
15104,630115,2020-08-14,2020,ARI,SDN,5,1,5-1,ARI,9,1,35,36,71,139,123,262,11,9,20,3,3:03
15105,631150,2020-08-14,2020,PHI,NYN,6,5,6-5,PHI,9,0,39,42,81,152,138,290,15,17,32,4,3:24
15106,631476,2020-08-14,2020,DET,CLE,5,10,10-5,CLE,9,0,37,42,79,165,142,307,10,14,24,2,2:55
15107,631683,2020-08-14,2020,BAL,WAS,3,15,15-3,WAS,9,0,37,50,87,177,130,307,10,22,32,3,3:10 (1:57 delay)
15108,630903,2020-08-14,2020,TOR,TBA,12,4,12-4,TOR,9,1,43,37,80,174,149,323,17,12,29,4,3:09
15109,631196,2020-08-14,2020,NYA,BOS,10,3,10-3,NYA,9,1,43,35,78,144,198,342,19,9,28,3,3:35
15110,631448,2020-08-14,2020,HOU,SEA,11,1,11-1,HOU,9,1,43,35,78,139,197,336,18,11,29,1,3:10
15111,631022,2020-08-14,2020,SFN,OAK,7,8,8-7,OAK,10,0,46,42,88,166,164,330,16,12,28,2,3:23
15112,631508,2020-08-15,2020,CHA,SLN,1,5,5-1,SLN,7,0,26,32,58,126,95,221,6,12,18,0,2:19
15113,631280,2020-08-15,2020,MIN,KCA,4,2,4-2,MIN,7,1,27,25,52,117,113,230,9,5,14,3,2:30
15114,631279,2020-08-15,2020,MIN,KCA,2,4,4-2,KCA,7,0,27,31,58,127,120,247,5,13,18,0,2:42
15115,631507,2020-08-15,2020,CHA,SLN,3,6,6-3,SLN,7,0,26,33,59,147,108,255,5,12,17,2,2:30
15116,631279,2020-08-15,2020,MIN,KCA,2,4,4-2,KCA,7,0,27,31,58,127,120,247,5,13,18,0,2:42
15117,631507,2020-08-15,2020,CHA,SLN,3,6,6-3,SLN,7,0,26,33,59,147,108,255,5,12,17,2,2:30
15118,631449,2020-08-15,2020,HOU,SEA,2,1,2-1,HOU,9,1,31,30,61,131,130,261,7,6,13,0,2:30
15119,631330,2020-08-15,2020,MIA,ATL,1,2,2-1,ATL,9,0,34,35,69,138,138,276,9,10,19,2,2:59
15120,631151,2020-08-15,2020,PHI,NYN,6,2,6-2,PHI,9,1,34,33,67,132,141,273,10,8,18,1,2:45
15121,631197,2020-08-15,2020,NYA,BOS,11,5,11-5,NYA,9,1,40,38,78,140,144,284,15,12,27,1,3:05
15122,630568,2020-08-15,2020,BAL,WAS,7,3,7-3,BAL,9,1,40,32,72,135,163,298,16,7,23,4,3:10
15123,631533,2020-08-15,2020,COL,TEX,4,6,6-4,TEX,9,0,38,39,77,163,130,293,11,15,26,1,3:22
15124,631477,2020-08-15,2020,DET,CLE,1,3,3-1,CLE,9,0,34,40,74,188,132,320,6,14,20,1,3:12
15125,631363,2020-08-15,2020,ANA,LAN,5,6,6-5,LAN,10,0,39,45,84,170,138,308,9,17,26,4,3:17
15126,630116,2020-08-15,2020,ARI,SDN,7,6,7-6,ARI,9,1,41,42,83,157,138,295,19,16,35,4,3:23
15127,630905,2020-08-15,2020,TOR,TBA,2,3,3-2,TBA,9,0,38,43,81,181,144,325,11,17,28,6,3:37 (1:57 delay)
15128,631611,2020-08-15,2020,CHN,MIL,5,6,6-5,MIL,10,0,43,45,88,152,174,326,14,14,28,2,3:24
15129,631023,2020-08-15,2020,SFN,OAK,6,7,7-6,OAK,9,0,36,42,78,189,156,345,10,15,25,4,3:38
15130,630905,2020-08-15,2020,TOR,TBA,2,3,3-2,TBA,9,0,38,43,81,181,144,325,11,17,28,6,3:37 (1:57 delay)
15131,631252,2020-08-16,2020,MIN,KCA,4,2,4-2,MIN,9,1,35,31,66,123,130,253,12,6,18,2,2:37
15132,631491,2020-08-16,2020,CHA,SLN,7,2,7-2,CHA,9,1,33,36,69,135,118,253,10,9,19,2,2:52
15133,630872,2020-08-16,2020,TOR,TBA,5,7,7-5,TBA,8,0,33,35,68,130,119,249,11,13,24,4,2:54
15134,631124,2020-08-16,2020,PHI,NYN,6,2,6-2,PHI,9,1,38,34,72,124,129,253,16,9,25,1,2:57
15135,631324,2020-08-16,2020,MIA,ATL,0,4,4-0,ATL,9,0,28,38,66,168,115,283,3,11,14,3,2:58
15136,630117,2020-08-16,2020,ARI,SDN,5,4,5-4,ARI,9,1,34,41,75,169,116,285,11,14,25,1,3:13
15137,631364,2020-08-16,2020,ANA,LAN,3,8,8-3,LAN,9,0,37,37,74,142,153,295,13,11,24,2,3:10
15138,631198,2020-08-16,2020,NYA,BOS,4,2,4-2,NYA,9,1,36,35,71,145,143,288,13,9,22,2,3:06
15139,631612,2020-08-16,2020,CHN,MIL,5,6,6-5,MIL,9,0,36,37,73,142,172,314,10,12,22,1,3:11
15140,631450,2020-08-16,2020,HOU,SEA,3,2,3-2,HOU,9,0,34,36,70,157,128,285,8,11,19,3,2:56
15141,631521,2020-08-16,2020,COL,TEX,10,6,10-6,COL,9,1,40,38,78,145,164,309,17,12,29,1,3:00
15142,631024,2020-08-16,2020,SFN,OAK,3,15,15-3,OAK,9,0,39,48,87,191,149,340,13,24,37,2,3:31
15143,631479,2020-08-16,2020,DET,CLE,5,8,8-5,CLE,9,0,40,43,83,163,154,317,15,17,32,5,3:26
15144,631679,2020-08-16,2020,BAL,WAS,5,6,6-5,WAS,9,0,37,45,82,190,152,342,10,18,28,4,3:38
15145,631613,2020-08-17,2020,CHN,SLN,1,3,3-1,SLN,7,0,26,26,52,103,91,194,7,5,12,2,2:03
15146,630996,2020-08-17,2020,SLN,CHN,4,5,5-4,CHN,7,0,29,33,62,132,118,250,9,14,23,2,2:33
15147,630996,2020-08-17,2020,SLN,CHN,4,5,5-4,CHN,7,0,29,33,62,132,118,250,9,14,23,2,2:33
15148,630118,2020-08-17,2020,ARI,OAK,4,3,4-3,ARI,9,0,40,35,75,125,135,260,16,8,24,5,3:06
15149,631678,2020-08-17,2020,BAL,TOR,2,7,7-2,TOR,9,0,31,38,69,127,141,268,6,11,17,1,2:45
15150,631258,2020-08-17,2020,MIN,KCA,4,1,4-1,MIN,9,1,35,35,70,137,158,295,13,10,23,2,3:06
15151,631199,2020-08-17,2020,NYA,BOS,6,3,6-3,NYA,9,1,34,38,72,141,134,275,11,11,22,1,2:46 (1:23 delay)
15152,631451,2020-08-17,2020,HOU,COL,2,1,2-1,HOU,9,1,33,33,66,133,128,261,9,7,16,1,2:50
15153,631365,2020-08-17,2020,ANA,SFN,7,6,7-6,ANA,9,0,38,38,76,159,140,299,14,12,26,3,3:12
15154,631493,2020-08-17,2020,CHA,DET,7,2,7-2,CHA,9,1,38,37,75,160,173,333,13,10,23,2,3:12
15155,631352,2020-08-17,2020,LAN,SEA,11,9,11-9,LAN,9,1,41,42,83,169,170,339,20,15,35,2,3:32
15156,630927,2020-08-17,2020,TEX,SDN,4,14,14-4,SDN,9,0,37,43,80,169,162,331,10,17,27,3,3:07
15157,630316,2020-08-17,2020,ATL,WAS,7,6,7-6,ATL,9,0,46,42,88,173,192,365,21,17,38,3,3:35
15158,631325,2020-08-17,2020,MIA,NYN,4,11,11-4,NYN,9,0,46,50,96,199,167,366,19,25,44,3,3:55
15159,631353,2020-08-18,2020,LAN,SEA,2,1,2-1,LAN,9,1,31,33,64,132,131,263,8,6,14,2,2:38
15160,631452,2020-08-18,2020,HOU,COL,2,1,2-1,HOU,11,0,37,38,75,143,136,279,8,7,15,0,3:03
15161,631496,2020-08-18,2020,CHA,DET,10,4,10-4,CHA,9,1,39,38,77,152,152,304,17,11,28,2,3:00
15162,631200,2020-08-18,2020,NYA,TBA,3,6,6-3,TBA,9,0,36,35,71,141,158,299,11,10,21,1,3:15
15163,630928,2020-08-18,2020,TEX,SDN,4,6,6-4,SDN,9,0,39,42,81,166,168,334,12,16,28,5,3:36
15164,630174,2020-08-18,2020,ARI,OAK,10,1,10-1,ARI,9,1,41,33,74,153,168,321,18,7,25,1,3:04
15165,631366,2020-08-18,2020,ANA,SFN,2,8,8-2,SFN,9,0,34,43,77,159,143,302,9,17,26,1,3:06
15166,631326,2020-08-18,2020,MIA,NYN,3,8,8-3,NYN,9,0,38,44,82,147,148,295,12,19,31,5,3:20
15167,630322,2020-08-18,2020,ATL,WAS,5,8,8-5,WAS,9,0,43,46,89,152,171,323,18,22,40,4,3:44
15168,631114,2020-08-18,2020,PIT,CLE,3,6,6-3,CLE,10,0,43,42,85,164,183,347,13,11,24,4,4:02
15169,631620,2020-08-18,2020,CHN,SLN,6,3,6-3,CHN,9,1,41,39,80,165,207,372,18,15,33,6,4:09
15170,631681,2020-08-18,2020,BAL,TOR,7,8,8-7,TOR,10,0,45,44,89,178,185,363,17,16,33,6,3:57
15171,631260,2020-08-18,2020,MIN,MIL,4,3,4-3,MIN,12,0,47,44,91,176,195,371,13,8,21,2,4:28
15172,631651,2020-08-18,2020,BOS,PHI,6,13,13-6,PHI,9,0,43,49,92,206,174,380,18,21,39,5,4:06
15173,631497,2020-08-19,2020,CHA,DET,5,3,5-3,CHA,9,1,33,33,66,131,117,248,9,7,16,2,2:31
15174,630997,2020-08-19,2020,SLN,CHN,2,4,4-2,CHN,7,0,28,27,55,121,113,234,7,8,15,1,2:26
15175,630997,2020-08-19,2020,SLN,CHN,2,4,4-2,CHN,7,0,28,27,55,121,113,234,7,8,15,1,2:26
15176,631422,2020-08-19,2020,KCA,CIN,0,5,5-0,CIN,7,0,25,34,59,143,97,240,4,13,17,2,2:22
15177,631418,2020-08-19,2020,KCA,CIN,4,0,4-0,KCA,7,1,28,25,53,99,129,228,9,6,15,2,2:11
15178,631422,2020-08-19,2020,KCA,CIN,0,5,5-0,CIN,7,0,25,34,59,143,97,240,4,13,17,2,2:22
15179,631201,2020-08-19,2020,NYA,TBA,2,4,4-2,TBA,9,0,36,38,74,150,138,288,9,11,20,5,3:12
15180,631179,2020-08-19,2020,OAK,ARI,4,1,4-1,OAK,9,1,37,34,71,140,156,296,13,9,22,1,2:57
15181,631120,2020-08-19,2020,PIT,CLE,1,6,6-1,CLE,9,0,31,39,70,177,109,286,5,14,19,1,2:56
15182,631327,2020-08-19,2020,MIA,NYN,3,5,5-3,NYN,9,0,39,39,78,142,154,296,11,15,26,4,3:14
15183,631621,2020-08-19,2020,CHN,SLN,3,9,9-3,SLN,7,0,31,37,68,159,144,303,10,17,27,5,3:01
15184,631025,2020-08-19,2020,SFN,ANA,7,2,7-2,SFN,9,1,36,36,72,168,127,295,12,9,21,2,3:05
15185,631682,2020-08-19,2020,BAL,TOR,2,5,5-2,TOR,9,0,39,39,78,150,152,302,13,12,25,1,3:00
15186,631249,2020-08-19,2020,MIN,MIL,3,9,9-3,MIL,9,0,37,43,80,159,151,310,11,19,30,2,2:59
15187,631652,2020-08-19,2020,BOS,PHI,6,3,6-3,BOS,9,1,38,37,75,165,157,322,17,9,26,4,3:36
15188,631522,2020-08-19,2020,COL,HOU,6,13,13-6,HOU,9,0,39,44,83,154,141,295,14,21,35,4,3:09
15189,631076,2020-08-19,2020,SDN,TEX,6,3,6-3,SDN,10,0,39,40,79,155,165,320,11,10,21,2,3:23
15190,631048,2020-08-19,2020,SEA,LAN,6,4,6-4,SEA,9,1,38,38,76,150,162,312,14,10,24,3,3:15
15191,630919,2020-08-20,2020,TOR,PHI,3,2,3-2,TOR,7,0,33,28,61,137,123,260,14,8,22,3,2:43
15192,631049,2020-08-20,2020,SEA,LAN,1,6,6-1,LAN,9,0,33,39,72,152,125,277,5,12,17,1,2:42
15193,631180,2020-08-20,2020,OAK,ARI,5,1,5-1,OAK,9,1,35,34,69,138,147,285,13,8,21,3,2:49
15194,630918,2020-08-20,2020,TOR,PHI,9,8,9-8,TOR,7,1,33,34,67,162,129,291,13,13,26,6,3:06
15195,631248,2020-08-20,2020,MIN,MIL,7,1,7-1,MIN,9,1,41,32,73,128,151,279,19,6,25,1,2:58 (:11 delay)
15196,630919,2020-08-20,2020,TOR,PHI,3,2,3-2,TOR,7,0,33,28,61,137,123,260,14,8,22,3,2:43
15197,630986,2020-08-20,2020,SLN,CIN,5,4,5-4,SLN,9,0,37,40,77,149,155,304,13,12,25,2,3:12
15198,631684,2020-08-20,2020,BAL,BOS,1,7,7-1,BOS,9,0,33,43,76,198,123,321,6,16,22,3,3:26
15199,631118,2020-08-20,2020,PIT,CLE,0,2,2-0,CLE,9,0,35,41,76,180,145,325,8,13,21,1,3:24
15200,630918,2020-08-20,2020,TOR,PHI,9,8,9-8,TOR,7,1,33,34,67,162,129,291,13,13,26,6,3:06
15201,631523,2020-08-20,2020,COL,HOU,8,10,10-8,HOU,9,0,47,39,86,134,181,315,20,13,33,4,3:31
15202,631077,2020-08-20,2020,SDN,TEX,8,7,8-7,SDN,10,0,42,44,86,193,169,362,16,14,30,4,3:59
15203,631202,2020-08-20,2020,NYA,TBA,5,10,10-5,TBA,9,0,39,41,80,161,172,333,12,14,26,4,3:25
15204,631026,2020-08-20,2020,SFN,ANA,10,5,10-5,SFN,9,1,43,42,85,183,166,349,19,15,34,3,3:40
15205,631498,2020-08-20,2020,CHA,DET,9,0,9-0,CHA,9,1,42,33,75,140,166,306,19,6,25,1,2:56
15206,631348,2020-08-21,2020,LAN,COL,5,1,5-1,LAN,9,1,36,31,67,122,125,247,14,4,18,2,2:35
15207,631409,2020-08-21,2020,KCA,MIN,7,2,7-2,KCA,9,1,36,37,73,152,141,293,12,11,23,2,3:14
15208,630886,2020-08-21,2020,WAS,MIA,2,3,3-2,MIA,9,0,33,38,71,153,148,301,6,12,18,2,3:06
15209,631027,2020-08-21,2020,SFN,ARI,6,2,6-2,SFN,9,1,39,33,72,134,158,292,18,7,25,0,2:58
15210,631050,2020-08-21,2020,SEA,TEX,7,4,7-4,SEA,9,1,37,34,71,119,150,269,13,7,20,4,2:41
15211,631633,2020-08-21,2020,CHN,CHA,1,10,10-1,CHA,9,0,35,41,76,170,129,299,8,13,21,1,2:54
15212,631665,2020-08-21,2020,BAL,BOS,5,8,8-5,BOS,9,0,39,38,77,126,175,301,13,12,25,2,3:04
15213,631103,2020-08-21,2020,PIT,MIL,7,2,7-2,PIT,9,1,37,36,73,152,131,283,15,10,25,2,2:53
15214,630324,2020-08-21,2020,ATL,PHI,11,2,11-2,ATL,9,1,43,37,80,146,173,319,18,12,30,3,3:18 (1:00 delay)
15215,631548,2020-08-21,2020,CLE,DET,5,10,10-5,DET,9,0,41,43,84,155,177,332,15,16,31,3,3:18
15216,630990,2020-08-21,2020,SLN,CIN,2,4,4-2,CIN,9,0,36,36,72,156,144,300,9,8,17,3,3:10
15217,631186,2020-08-21,2020,OAK,ANA,5,3,5-3,OAK,9,1,37,43,80,150,153,303,13,17,30,3,3:07
15218,631078,2020-08-21,2020,SDN,HOU,4,3,4-3,SDN,9,1,37,41,78,187,142,329,17,15,32,3,3:41
15219,630960,2020-08-21,2020,TBA,TOR,5,6,6-5,TOR,10,0,43,39,82,135,176,311,15,12,27,2,3:31
15220,631341,2020-08-22,2020,MIA,WAS,5,3,5-3,MIA,7,1,31,31,62,103,119,222,12,10,22,3,2:31
15221,630991,2020-08-22,2020,SLN,CIN,3,0,3-0,SLN,9,1,33,32,65,118,134,252,12,6,18,3,2:15
15222,631341,2020-08-22,2020,MIA,WAS,5,3,5-3,MIA,7,1,31,31,62,103,119,222,12,10,22,3,2:31
15223,631079,2020-08-22,2020,SDN,HOU,13,2,13-2,SDN,9,1,41,34,75,118,140,258,17,7,24,2,2:41
15224,630890,2020-08-22,2020,WAS,MIA,5,4,5-4,WAS,7,1,26,31,57,133,121,254,10,10,20,3,2:58
15225,631028,2020-08-22,2020,SFN,ARI,5,1,5-1,SFN,9,1,37,32,69,103,148,251,14,4,18,2,2:43
15226,631349,2020-08-22,2020,LAN,COL,4,3,4-3,LAN,9,0,32,36,68,153,133,286,12,8,20,4,3:05
15227,631564,2020-08-22,2020,CLE,DET,6,1,6-1,CLE,9,1,37,30,67,112,141,253,14,4,18,3,2:37
15228,631051,2020-08-22,2020,SEA,TEX,10,1,10-1,SEA,9,1,43,38,81,132,175,307,18,10,28,0,2:51
15229,631154,2020-08-22,2020,OAK,ANA,3,4,4-3,ANA,9,0,35,40,75,151,132,283,9,11,20,3,3:06
15230,630338,2020-08-22,2020,ATL,PHI,6,5,6-5,ATL,9,0,40,40,80,152,143,295,15,13,28,2,3:18
15231,631638,2020-08-22,2020,CHN,CHA,4,7,7-4,CHA,9,0,38,42,80,167,150,317,13,17,30,3,3:33
15232,630948,2020-08-22,2020,TBA,TOR,2,1,2-1,TBA,10,0,37,39,76,156,165,321,10,11,21,3,3:21
15233,631403,2020-08-22,2020,KCA,MIN,2,7,7-2,MIN,9,0,40,42,82,154,143,297,14,17,31,3,3:23
15234,631667,2020-08-22,2020,BAL,BOS,5,4,5-4,BAL,10,0,40,43,83,171,154,325,15,14,29,4,3:36
15235,631104,2020-08-22,2020,PIT,MIL,12,5,12-5,PIT,9,1,42,41,83,181,170,351,18,16,34,1,3:30
15236,631052,2020-08-23,2020,SEA,TEX,4,1,4-1,SEA,9,1,30,32,62,117,115,232,6,4,10,0,2:14
15237,631029,2020-08-23,2020,SFN,ARI,6,1,6-1,SFN,9,1,35,36,71,147,127,274,12,9,21,2,2:52
15238,631639,2020-08-23,2020,CHN,CHA,2,1,2-1,CHN,9,1,31,38,69,153,123,276,8,12,20,1,3:15
15239,631080,2020-08-23,2020,SDN,HOU,5,3,5-3,SDN,9,1,33,32,65,127,138,265,9,6,15,4,3:04
15240,631354,2020-08-23,2020,LAN,COL,11,3,11-3,LAN,9,1,40,38,78,134,141,275,18,11,29,4,2:58
15241,630897,2020-08-23,2020,WAS,MIA,9,3,9-3,WAS,9,1,41,34,75,129,171,300,18,9,27,2,3:12
15242,631107,2020-08-23,2020,PIT,MIL,5,4,5-4,PIT,9,1,34,37,71,152,127,279,11,10,21,3,3:11 (1:25 delay)
15243,630273,2020-08-23,2020,ATL,PHI,4,5,5-4,PHI,9,0,38,41,79,152,147,299,13,14,27,2,3:17
15244,630976,2020-08-23,2020,SLN,CIN,6,2,6-2,SLN,9,1,42,35,77,132,179,311,18,10,28,2,3:03
15245,630949,2020-08-23,2020,TBA,TOR,5,4,5-4,TBA,9,1,36,38,74,138,159,297,13,11,24,5,3:14
15246,631670,2020-08-23,2020,BAL,BOS,5,4,5-4,BAL,9,1,39,37,76,134,160,294,16,10,26,5,3:17
15247,631551,2020-08-23,2020,CLE,DET,4,7,7-4,DET,9,0,38,43,81,155,180,335,10,18,28,3,3:22
15248,631412,2020-08-23,2020,KCA,MIN,4,5,5-4,MIN,9,0,42,43,85,173,151,324,14,19,33,3,3:35
15249,631170,2020-08-23,2020,OAK,ANA,5,4,5-4,OAK,10,0,41,46,87,187,167,354,12,17,29,3,3:40
15250,631301,2020-08-24,2020,MIL,CIN,4,2,4-2,MIL,9,1,34,31,65,125,136,261,11,7,18,2,2:35
15251,630929,2020-08-24,2020,TEX,OAK,3,2,3-2,TEX,9,1,33,40,73,161,115,276,10,13,23,2,2:52
15252,631552,2020-08-24,2020,CLE,MIN,2,3,3-2,MIN,9,0,40,35,75,131,154,285,13,9,22,0,3:14
15253,630193,2020-08-24,2020,ARI,COL,2,3,3-2,COL,9,0,35,37,72,158,124,282,10,15,25,1,3:19
15254,631468,2020-08-24,2020,DET,CHN,3,9,9-3,CHN,9,0,35,45,80,187,125,312,8,20,28,2,3:01
15255,630950,2020-08-24,2020,TBA,TOR,4,6,6-4,TOR,9,0,39,39,78,160,170,330,16,11,27,2,3:29
15256,630977,2020-08-24,2020,SLN,KCA,9,3,9-3,SLN,9,1,45,36,81,143,181,324,22,6,28,3,3:10
15257,631439,2020-08-24,2020,HOU,ANA,11,4,11-4,HOU,9,1,42,38,80,151,160,311,18,10,28,3,3:25
15258,630898,2020-08-24,2020,WAS,MIA,8,11,11-8,MIA,9,0,44,50,94,196,169,365,17,24,41,6,4:02
15259,631499,2020-08-25,2020,CHA,PIT,4,0,4-0,CHA,9,1,36,28,64,101,123,224,14,1,15,0,2:23
15260,631323,2020-08-25,2020,MIA,NYN,3,0,3-0,MIA,7,1,23,29,52,133,100,233,5,10,15,1,2:24
15261,631302,2020-08-25,2020,MIL,CIN,3,2,3-2,MIL,9,1,32,33,65,128,141,269,9,6,15,0,2:47
15262,631423,2020-08-25,2020,HOU,ANA,6,3,6-3,HOU,7,1,30,27,57,112,114,226,13,6,19,2,2:26
15263,631323,2020-08-25,2020,MIA,NYN,3,0,3-0,MIA,7,1,23,29,52,133,100,233,5,10,15,1,2:24
15264,630951,2020-08-25,2020,TBA,BAL,4,2,4-2,TBA,9,1,37,35,72,129,138,267,12,8,20,3,2:41
15265,631227,2020-08-25,2020,NYN,MIA,0,4,4-0,MIA,7,0,32,29,61,123,125,248,11,8,19,1,2:37 (1:05 delay)
15266,631553,2020-08-25,2020,CLE,MIN,4,2,4-2,CLE,9,1,33,36,69,143,137,280,12,10,22,0,2:52
15267,630978,2020-08-25,2020,SLN,KCA,4,5,5-4,KCA,9,0,39,37,76,132,159,291,15,13,28,1,3:07
15268,631081,2020-08-25,2020,SDN,SEA,3,8,8-3,SEA,9,0,41,43,84,162,163,325,14,16,30,3,3:08
15269,630930,2020-08-25,2020,TEX,OAK,3,10,10-3,OAK,9,0,35,42,77,170,142,312,9,16,25,2,3:15
15270,631467,2020-08-25,2020,DET,CHN,7,1,7-1,DET,9,1,39,35,74,137,163,300,17,7,24,3,3:13
15271,631426,2020-08-25,2020,HOU,ANA,5,12,12-5,ANA,7,0,28,43,71,191,112,303,8,22,30,9,3:24
15272,630855,2020-08-25,2020,WAS,PHI,3,8,8-3,PHI,9,0,35,43,78,165,134,299,10,20,30,4,3:13 (1:12 delay)
15273,630862,2020-08-25,2020,TOR,BOS,7,9,9-7,BOS,9,0,43,43,86,165,171,336,18,17,35,4,3:42
15274,630194,2020-08-25,2020,ARI,COL,4,5,5-4,COL,9,0,43,43,86,178,175,353,16,17,33,2,3:52
15275,631015,2020-08-25,2020,SFN,LAN,10,8,10-8,SFN,11,0,50,50,100,199,168,367,17,18,35,9,4:22
15276,630361,2020-08-26,2020,ATL,NYA,5,1,5-1,ATL,7,1,26,26,52,100,117,217,8,5,13,1,2:05
15277,630360,2020-08-26,2020,ATL,NYA,2,1,2-1,ATL,7,1,22,26,48,110,87,197,5,6,11,0,1:58
15278,630360,2020-08-26,2020,ATL,NYA,2,1,2-1,ATL,7,1,22,26,48,110,87,197,5,6,11,0,1:58
15279,631500,2020-08-26,2020,CHA,PIT,10,3,10-3,CHA,9,1,36,36,72,150,116,266,14,9,23,0,2:41
15280,631226,2020-08-26,2020,NYN,MIA,5,4,5-4,NYN,9,1,36,36,72,150,146,296,14,11,25,3,3:16
15281,631554,2020-08-26,2020,CLE,MIN,6,3,6-3,CLE,9,1,39,35,74,117,155,272,17,11,28,3,3:14
15282,630863,2020-08-26,2020,TOR,BOS,9,1,9-1,TOR,9,1,38,32,70,133,152,285,15,6,21,2,2:58
15283,630853,2020-08-26,2020,WAS,PHI,2,3,3-2,PHI,9,0,36,40,76,135,148,283,9,15,24,1,3:19
15284,630931,2020-08-26,2020,TEX,OAK,1,3,3-1,OAK,9,0,33,40,73,162,136,298,6,13,19,2,3:08
15285,631455,2020-08-26,2020,DET,CHN,7,6,7-6,DET,9,1,44,40,84,139,170,309,20,15,35,2,3:23
15286,630952,2020-08-26,2020,TBA,BAL,4,3,4-3,TBA,9,1,37,37,74,151,175,326,13,10,23,5,3:26
15287,630099,2020-08-26,2020,ARI,COL,7,8,8-7,COL,9,0,43,45,88,186,156,342,17,20,37,6,3:43
15288,630979,2020-08-26,2020,SLN,KCA,6,5,6-5,SLN,9,0,46,38,84,134,195,329,20,14,34,4,3:37
15289,631000,2020-08-27,2020,SLN,PIT,0,2,2-0,PIT,7,0,26,29,55,102,91,193,7,8,15,1,2:02
15290,631000,2020-08-27,2020,SLN,PIT,0,2,2-0,PIT,7,0,26,29,55,102,91,193,7,8,15,1,2:02
15291,631001,2020-08-27,2020,SFN,LAN,0,2,2-0,LAN,7,0,26,27,53,122,104,226,5,7,12,5,2:30
15292,631017,2020-08-27,2020,SFN,LAN,0,7,7-0,LAN,7,0,25,35,60,130,93,223,4,16,20,1,2:17
15293,631001,2020-08-27,2020,SFN,LAN,0,2,2-0,LAN,7,0,26,27,53,122,104,226,5,7,12,5,2:30
15294,630999,2020-08-27,2020,SLN,PIT,3,4,4-3,PIT,8,0,32,34,66,126,120,246,11,8,19,1,2:48
15295,631082,2020-08-27,2020,SDN,SEA,3,8,8-3,SEA,7,0,31,35,66,137,117,254,12,14,26,2,2:39
15296,631082,2020-08-27,2020,SDN,SEA,3,8,8-3,SEA,7,0,31,35,66,137,117,254,12,14,26,2,2:39
15297,630999,2020-08-27,2020,SLN,PIT,3,4,4-3,PIT,8,0,32,34,66,126,120,246,11,8,19,1,2:48
15298,631303,2020-08-27,2020,MIL,CIN,0,6,6-0,CIN,7,0,25,35,60,150,120,270,4,14,18,0,2:33
15299,631083,2020-08-27,2020,SDN,SEA,10,7,10-7,SDN,7,0,33,34,67,127,127,254,13,13,26,4,2:49
15300,631303,2020-08-27,2020,MIL,CIN,0,6,6-0,CIN,7,0,25,35,60,150,120,270,4,14,18,0,2:33
15301,631290,2020-08-27,2020,MIL,CIN,1,6,6-1,CIN,7,0,31,34,65,141,147,288,10,17,27,3,2:51
15302,631230,2020-08-28,2020,NYN,NYA,4,3,4-3,NYN,7,0,26,30,56,119,98,217,10,11,21,0,2:23
15303,631230,2020-08-28,2020,NYN,NYA,4,3,4-3,NYN,7,0,26,30,56,119,98,217,10,11,21,0,2:23
15304,631304,2020-08-28,2020,MIA,TBA,0,2,2-0,TBA,9,0,33,38,71,135,112,247,7,13,20,3,2:55
15305,631203,2020-08-28,2020,NYA,NYN,4,6,6-4,NYN,7,0,34,31,65,108,130,238,13,10,23,1,2:30
15306,631394,2020-08-28,2020,ANA,SEA,3,2,3-2,ANA,9,1,35,35,70,117,153,270,15,10,25,1,2:50
15307,630216,2020-08-28,2020,ARI,SFN,7,4,7-4,ARI,9,1,37,36,73,121,151,272,15,11,26,1,2:49
15308,630933,2020-08-28,2020,TEX,LAN,6,2,6-2,TEX,9,1,37,37,74,150,133,283,16,10,26,1,3:10
15309,631582,2020-08-28,2020,CIN,CHN,6,5,6-5,CIN,9,1,37,35,72,146,132,278,12,8,20,2,2:57
15310,631291,2020-08-28,2020,MIL,PIT,9,1,9-1,MIL,9,1,37,33,70,143,148,291,13,6,19,1,2:55
15311,631524,2020-08-28,2020,COL,SDN,4,10,10-4,SDN,9,0,40,47,87,157,157,314,13,22,35,5,3:29
15312,631653,2020-08-28,2020,BOS,WAS,2,10,10-2,WAS,9,0,37,43,80,180,152,332,11,19,30,1,3:21
15313,630871,2020-08-28,2020,TOR,BAL,5,4,5-4,TOR,10,0,38,39,77,158,160,318,10,12,22,2,3:19
15314,631501,2020-08-28,2020,CHA,KCA,6,5,6-5,CHA,9,0,39,43,82,168,173,341,15,17,32,4,3:59
15315,631125,2020-08-28,2020,PHI,ATL,7,4,7-4,PHI,11,0,44,45,89,184,169,353,14,15,29,3,4:07 (:12 delay)
15316,630980,2020-08-28,2020,SLN,CLE,2,14,14-2,CLE,9,0,37,53,90,232,180,412,12,28,40,2,3:51
15317,631457,2020-08-29,2020,DET,MIN,4,2,4-2,DET,7,1,28,24,52,99,116,215,11,5,16,3,2:12
15318,631428,2020-08-29,2020,HOU,OAK,4,2,4-2,HOU,7,1,28,26,54,101,99,200,11,7,18,1,2:07
15319,631457,2020-08-29,2020,DET,MIN,4,2,4-2,DET,7,1,28,24,52,99,116,215,11,5,16,3,2:12
15320,631458,2020-08-29,2020,DET,MIN,8,2,8-2,DET,7,1,33,26,59,96,108,204,19,4,23,1,2:11
15321,631427,2020-08-29,2020,HOU,OAK,6,3,6-3,HOU,7,1,32,27,59,119,129,248,14,7,21,2,2:33
15322,631134,2020-08-29,2020,PHI,ATL,4,1,4-1,PHI,9,1,34,32,66,112,112,224,11,6,17,2,2:33 (37:00 delay)
15323,631581,2020-08-29,2020,CIN,CHN,0,3,3-0,CHN,7,0,31,27,58,135,120,255,10,6,16,1,2:47
15324,631427,2020-08-29,2020,HOU,OAK,6,3,6-3,HOU,7,1,32,27,59,119,129,248,14,7,21,2,2:33
15325,631595,2020-08-29,2020,CIN,CHN,6,5,6-5,CIN,7,0,32,34,66,135,137,272,14,13,27,1,2:53
15326,630906,2020-08-29,2020,TOR,BAL,5,0,5-0,TOR,9,1,38,35,73,138,140,278,13,8,21,1,2:44
15327,631319,2020-08-29,2020,MIA,TBA,0,4,4-0,TBA,9,0,30,37,67,137,125,262,4,10,14,2,2:47
15328,631204,2020-08-29,2020,NYA,NYN,2,1,2-1,NYA,9,0,34,30,64,116,159,275,10,5,15,2,3:00
15329,631525,2020-08-29,2020,COL,SDN,4,3,4-3,COL,9,0,36,37,73,138,137,275,13,13,26,4,3:08
15330,631595,2020-08-29,2020,CIN,CHN,6,5,6-5,CIN,7,0,32,34,66,135,137,272,14,13,27,1,2:53
15331,630217,2020-08-29,2020,ARI,SFN,2,5,5-2,SFN,9,0,33,43,76,167,138,305,7,18,25,3,3:12
15332,630934,2020-08-29,2020,TEX,LAN,4,7,7-4,LAN,9,0,38,42,80,181,150,331,13,15,28,5,3:36
15333,631654,2020-08-29,2020,BOS,WAS,5,3,5-3,BOS,9,1,32,44,76,182,125,307,9,18,27,4,3:25
15334,631277,2020-08-29,2020,MIL,PIT,7,6,7-6,MIL,9,0,36,44,80,174,149,323,12,18,30,2,3:19
15335,631502,2020-08-29,2020,CHA,KCA,6,9,9-6,KCA,9,0,40,43,83,188,165,353,14,18,32,5,3:33
15336,630981,2020-08-29,2020,SLN,CLE,1,2,2-1,CLE,12,0,43,45,88,204,165,369,12,12,24,2,4:06
15337,631369,2020-08-29,2020,ANA,SEA,16,3,16-3,ANA,9,1,49,36,85,140,203,343,26,12,38,3,3:26
15338,631229,2020-08-30,2020,NYN,NYA,2,5,5-2,NYA,8,0,31,36,67,128,109,237,7,15,22,2,2:45
15339,631229,2020-08-30,2020,NYN,NYA,2,5,5-2,NYA,8,0,31,36,67,128,109,237,7,15,22,2,2:45
15340,630982,2020-08-30,2020,SLN,CLE,7,2,7-2,SLN,9,1,34,32,66,122,133,255,13,6,19,1,2:24
15341,631459,2020-08-30,2020,DET,MIN,3,2,3-2,DET,9,1,30,37,67,154,118,272,6,10,16,1,2:41
15342,630852,2020-08-30,2020,TOR,BAL,6,5,6-5,TOR,9,0,40,40,80,141,133,274,15,17,32,3,2:58
15343,630219,2020-08-30,2020,ARI,SFN,1,4,4-1,SFN,9,0,32,36,68,146,134,280,6,9,15,2,2:55
15344,631371,2020-08-30,2020,ANA,SEA,1,2,2-1,SEA,10,0,40,36,76,142,168,310,14,9,23,1,3:27
15345,631205,2020-08-30,2020,NYA,NYN,8,7,8-7,NYA,8,0,35,42,77,167,135,302,13,18,31,3,3:22
15346,631278,2020-08-30,2020,MIL,PIT,1,5,5-1,PIT,9,0,41,36,77,139,158,297,13,10,23,2,3:13
15347,631526,2020-08-30,2020,COL,SDN,2,13,13-2,SDN,9,0,36,45,81,181,142,323,9,20,29,1,3:07
15348,631306,2020-08-30,2020,MIA,TBA,7,12,12-7,TBA,9,0,40,47,87,178,147,325,15,19,34,2,3:26
15349,631655,2020-08-30,2020,BOS,WAS,9,5,9-5,BOS,9,1,43,42,85,157,173,330,19,15,34,3,3:26
15350,631505,2020-08-30,2020,CHA,KCA,5,2,5-2,CHA,10,0,42,38,80,170,165,335,14,10,24,3,3:38
15351,631584,2020-08-30,2020,CIN,CHN,1,10,10-1,CHN,9,0,35,43,78,184,163,347,8,17,25,2,3:26
15352,630921,2020-08-30,2020,TEX,LAN,2,7,7-2,LAN,9,0,37,44,81,199,147,346,11,18,29,4,3:40
15353,631135,2020-08-30,2020,PHI,ATL,10,12,12-10,ATL,9,0,42,52,94,194,174,368,16,26,42,6,4:13
15354,631374,2020-08-31,2020,ANA,SEA,1,2,2-1,SEA,9,0,31,36,67,131,102,233,5,11,16,1,2:30
15355,631143,2020-08-31,2020,PHI,WAS,8,6,8-6,PHI,9,1,34,40,74,156,123,279,11,13,24,2,2:48
15356,631527,2020-08-31,2020,COL,SDN,0,6,6-0,SDN,9,0,34,38,72,132,133,265,9,12,21,2,2:49
15357,631585,2020-08-31,2020,CIN,SLN,5,7,7-5,SLN,9,0,33,43,76,168,131,299,7,16,23,4,3:09
15358,631223,2020-08-31,2020,NYN,MIA,3,5,5-3,MIA,9,0,35,38,73,150,146,296,10,11,21,0,3:03
15359,631223,2020-08-31,2020,NYN,MIA,3,5,5-3,MIA,9,0,35,38,73,150,146,296,10,11,21,0,3:03
15360,631656,2020-08-31,2020,BOS,ATL,3,6,6-3,ATL,9,0,36,42,78,161,146,307,10,16,26,1,3:19
15361,631414,2020-08-31,2020,KCA,CLE,2,1,2-1,KCA,9,1,35,34,69,147,165,312,11,7,18,3,3:11
15362,631281,2020-08-31,2020,MIL,PIT,6,5,6-5,MIL,9,1,37,38,75,173,152,325,16,11,27,3,3:25
15363,631206,2020-08-31,2020,NYA,TBA,3,5,5-3,TBA,9,0,37,45,82,179,143,322,9,19,28,1,3:21
15364,630900,2020-08-31,2020,TOR,BAL,3,4,4-3,BAL,11,0,42,43,85,175,167,342,11,11,22,3,3:38
15365,631247,2020-08-31,2020,MIN,CHA,5,8,8-5,CHA,9,0,38,45,83,185,157,342,10,17,27,2,3:43
15366,631307,2020-09-01,2020,MIA,TOR,3,2,3-2,MIA,9,1,32,33,65,103,109,212,9,9,18,2,2:40
15367,631207,2020-09-01,2020,NYA,TBA,5,3,5-3,NYA,9,1,32,32,64,136,112,248,9,6,15,1,2:39
15368,631261,2020-09-01,2020,MIN,CHA,3,2,3-2,MIN,9,1,38,34,72,133,141,274,14,8,22,2,3:12
15369,631671,2020-09-01,2020,BAL,NYN,9,5,9-5,BAL,9,1,41,38,79,142,148,290,17,12,29,0,2:59
15370,631355,2020-09-01,2020,LAN,ARI,6,3,6-3,LAN,9,1,41,35,76,134,146,280,17,8,25,1,2:46
15371,631153,2020-09-01,2020,PHI,WAS,6,0,6-0,PHI,9,1,42,33,75,133,167,300,17,7,24,2,3:14
15372,631430,2020-09-01,2020,HOU,TEX,5,6,6-5,TEX,10,0,41,41,82,154,155,309,12,13,25,2,3:28
15373,631657,2020-09-01,2020,BOS,ATL,3,10,10-3,ATL,9,0,37,44,81,154,144,298,11,17,28,1,3:05
15374,631416,2020-09-01,2020,KCA,CLE,1,10,10-1,CLE,9,0,34,46,80,179,134,313,7,21,28,2,3:10 (:16 delay)
15375,631287,2020-09-01,2020,MIL,DET,1,12,12-1,DET,9,0,40,46,86,176,186,362,14,20,34,1,3:34
15376,631109,2020-09-01,2020,PIT,CHN,7,8,8-7,CHN,11,0,50,49,99,191,173,364,19,17,36,7,4:10 (1:11 delay)
15377,631528,2020-09-01,2020,COL,SFN,5,23,23-5,SFN,9,0,38,59,97,227,162,389,10,33,43,4,3:48
15378,631586,2020-09-01,2020,CIN,SLN,2,16,16-2,SLN,9,0,39,56,95,208,170,378,15,30,45,2,3:27
15379,631431,2020-09-02,2020,HOU,TEX,2,1,2-1,HOU,9,1,29,31,60,120,92,212,6,5,11,1,2:27
15380,631404,2020-09-02,2020,KCA,CLE,0,5,5-0,CLE,9,0,28,35,63,122,119,241,4,10,14,1,2:29
15381,631145,2020-09-02,2020,PHI,WAS,3,0,3-0,PHI,9,1,34,35,69,144,134,278,11,9,20,1,2:50
15382,631587,2020-09-02,2020,CIN,SLN,4,3,4-3,CIN,9,0,37,36,73,133,150,283,12,11,23,4,2:55
15383,631379,2020-09-02,2020,ANA,SDN,4,11,11-4,SDN,9,0,35,44,79,161,116,277,10,18,28,4,3:13
15384,631624,2020-09-02,2020,BOS,ATL,5,7,7-5,ATL,9,0,37,40,77,145,142,287,10,12,22,2,3:01
15385,631308,2020-09-02,2020,MIA,TOR,1,2,2-1,TOR,9,0,37,32,69,104,138,242,10,7,17,0,2:37
15386,631111,2020-09-02,2020,PIT,CHN,2,8,8-2,CHN,9,0,36,43,79,157,145,302,10,13,23,1,3:15 (1:11 delay)
15387,631253,2020-09-02,2020,MIN,CHA,8,1,8-1,MIN,9,1,42,35,77,136,181,317,15,7,22,2,3:23
15388,631356,2020-09-02,2020,LAN,ARI,3,2,3-2,LAN,10,0,34,41,75,152,137,289,6,10,16,2,3:11
15389,631673,2020-09-02,2020,BAL,NYN,4,9,9-4,NYN,9,0,40,43,83,145,165,310,14,18,32,3,3:12
15390,631283,2020-09-02,2020,MIL,DET,8,5,8-5,MIL,9,1,42,37,79,137,192,329,18,11,29,2,3:20
15391,631194,2020-09-02,2020,NYA,TBA,2,5,5-2,TBA,9,0,38,42,80,168,151,319,11,14,25,8,3:45 (:05 delay)
15392,631529,2020-09-02,2020,COL,SFN,9,6,9-6,COL,9,1,41,45,86,177,165,342,18,18,36,2,3:35
15393,631368,2020-09-03,2020,ANA,SDN,2,0,2-0,ANA,9,1,31,31,62,141,122,263,11,5,16,0,2:40
15394,631370,2020-09-03,2020,LAN,ARI,5,1,5-1,LAN,9,1,37,36,73,150,143,293,12,9,21,2,2:58
15395,631432,2020-09-03,2020,HOU,TEX,8,4,8-4,HOU,9,1,40,38,78,159,144,303,16,11,27,2,3:11
15396,631112,2020-09-03,2020,PIT,CHN,6,2,6-2,PIT,9,1,38,38,76,156,137,293,13,13,26,2,3:16
15397,631405,2020-09-03,2020,KCA,CHA,6,11,11-6,CHA,9,0,42,44,86,160,168,328,14,19,33,2,3:18
15398,631614,2020-09-03,2020,BOS,TOR,2,6,6-2,TOR,10,0,43,44,87,168,168,336,14,15,29,6,4:02
15399,631146,2020-09-03,2020,PHI,WAS,6,5,6-5,PHI,10,0,44,42,86,158,174,332,18,14,32,4,3:50
15400,631234,2020-09-03,2020,NYN,NYA,9,7,9-7,NYN,10,0,42,47,89,208,151,359,17,17,34,1,4:00
15401,631234,2020-09-03,2020,NYN,NYA,9,7,9-7,NYN,10,0,42,47,89,208,151,359,17,17,34,1,4:00
15402,631262,2020-09-04,2020,MIN,DET,2,0,2-0,MIN,7,1,22,25,47,92,89,181,6,6,12,0,1:45
15403,630371,2020-09-04,2020,ATL,WAS,7,1,7-1,ATL,7,1,31,29,60,118,113,231,13,9,22,1,2:30
15404,630497,2020-09-04,2020,BAL,NYA,6,3,6-3,BAL,7,1,31,29,60,121,127,248,13,7,20,1,2:31
15405,631602,2020-09-04,2020,CIN,PIT,3,4,4-3,PIT,7,0,27,28,55,110,127,237,6,8,14,1,2:25
15406,630865,2020-09-04,2020,TOR,BOS,2,3,3-2,BOS,7,0,28,31,59,127,131,258,9,12,21,1,2:49
15407,630497,2020-09-04,2020,BAL,NYA,6,3,6-3,BAL,7,1,31,29,60,121,127,248,13,7,20,1,2:31
15408,631602,2020-09-04,2020,CIN,PIT,3,4,4-3,PIT,7,0,27,28,55,110,127,237,6,8,14,1,2:25
15409,631113,2020-09-04,2020,PIT,CIN,2,4,4-2,CIN,7,0,30,32,62,139,111,250,10,12,22,1,2:31
15410,631456,2020-09-04,2020,DET,MIN,2,3,3-2,MIN,8,0,32,35,67,125,140,265,8,13,21,2,2:57
15411,631156,2020-09-04,2020,OAK,SDN,0,7,7-0,SDN,9,0,33,41,74,159,121,280,8,12,20,1,2:41
15412,631649,2020-09-04,2020,BOS,TOR,7,8,8-7,TOR,7,0,33,34,67,129,123,252,13,14,27,3,2:42
15413,630954,2020-09-04,2020,TBA,MIA,5,4,5-4,TBA,9,1,36,37,73,136,150,286,12,10,22,1,2:57
15414,631644,2020-09-04,2020,CHN,SLN,4,1,4-1,CHN,9,1,37,29,66,136,154,290,13,3,16,3,3:05
15415,630865,2020-09-04,2020,TOR,BOS,2,3,3-2,BOS,7,0,28,31,59,127,131,258,9,12,21,1,2:49
15416,631555,2020-09-04,2020,CLE,MIL,1,7,7-1,MIL,9,0,32,43,75,156,131,287,6,19,25,2,2:55
15417,631456,2020-09-04,2020,DET,MIN,2,3,3-2,MIN,8,0,32,35,67,125,140,265,8,13,21,2,2:57
15418,631456,2020-09-04,2020,DET,MIN,2,3,3-2,MIN,8,0,32,35,67,125,140,265,8,13,21,2,2:57
15419,631221,2020-09-04,2020,NYN,PHI,3,5,5-3,PHI,9,0,36,39,75,161,144,305,11,13,24,2,3:11
15420,630323,2020-09-04,2020,ATL,WAS,9,10,10-9,WAS,7,0,36,38,74,157,146,303,14,17,31,4,3:12
15421,631041,2020-09-04,2020,SEA,TEX,6,3,6-3,SEA,9,1,38,32,70,152,149,301,15,6,21,0,2:56
15422,631406,2020-09-04,2020,KCA,CHA,4,7,7-4,CHA,9,0,43,44,87,166,161,327,15,18,33,3,3:42
15423,631003,2020-09-04,2020,SFN,ARI,5,6,6-5,ARI,9,0,43,41,84,146,177,323,19,14,33,3,3:32
15424,631345,2020-09-04,2020,LAN,COL,10,6,10-6,LAN,9,1,39,38,77,148,166,314,16,11,27,5,3:26 (:04 delay)
15425,630323,2020-09-04,2020,ATL,WAS,9,10,10-9,WAS,7,0,36,38,74,157,146,303,14,17,31,4,3:12
15426,631674,2020-09-04,2020,BAL,NYA,5,6,6-5,NYA,9,0,41,41,82,162,167,329,15,15,30,1,3:37
15427,631357,2020-09-04,2020,ANA,HOU,6,5,6-5,ANA,11,0,49,48,97,175,198,373,19,15,34,5,4:27
15428,630998,2020-09-05,2020,SLN,CHN,5,1,5-1,SLN,7,1,25,29,54,137,86,223,8,9,17,4,2:16
15429,630998,2020-09-05,2020,SLN,CHN,5,1,5-1,SLN,7,1,25,29,54,137,86,223,8,9,17,4,2:16
15430,631440,2020-09-05,2020,HOU,ANA,6,7,7-6,ANA,7,0,29,33,62,134,106,240,6,13,19,2,2:44
15431,631607,2020-09-05,2020,CHN,SLN,2,4,4-2,SLN,7,0,30,33,63,153,111,264,8,11,19,2,2:40
15432,631440,2020-09-05,2020,HOU,ANA,6,7,7-6,ANA,7,0,29,33,62,134,106,240,6,13,19,2,2:44
15433,631675,2020-09-05,2020,BAL,NYA,6,1,6-1,BAL,9,1,33,38,71,152,136,288,9,12,21,3,2:47
15434,631328,2020-09-05,2020,LAN,COL,2,5,5-2,COL,9,0,35,35,70,125,126,251,9,9,18,2,2:45
15435,631264,2020-09-05,2020,MIN,DET,4,3,4-3,MIN,9,0,34,34,68,135,132,267,10,8,18,2,2:52
15436,631044,2020-09-05,2020,SEA,TEX,5,3,5-3,SEA,9,1,38,35,73,116,141,257,16,11,27,2,3:04
15437,631408,2020-09-05,2020,KCA,CHA,3,5,5-3,CHA,9,0,34,34,68,134,150,284,8,6,14,2,3:10
15438,631388,2020-09-05,2020,ANA,HOU,10,9,10-9,ANA,7,0,34,35,69,135,132,267,16,14,30,4,3:01
15439,631157,2020-09-05,2020,OAK,SDN,8,4,8-4,OAK,9,1,39,39,78,136,152,288,16,12,28,2,3:00
15440,630955,2020-09-05,2020,TBA,MIA,3,7,7-3,MIA,9,0,37,40,77,148,158,306,11,13,24,2,3:16
15441,631556,2020-09-05,2020,CLE,MIL,4,3,4-3,CLE,9,0,37,41,78,153,169,322,12,14,26,2,3:21
15442,631228,2020-09-05,2020,NYN,PHI,5,1,5-1,NYN,9,1,37,38,75,155,139,294,14,11,25,1,3:08
15443,631004,2020-09-05,2020,SFN,ARI,4,3,4-3,SFN,9,1,37,36,73,142,143,285,13,10,23,4,3:06
15444,631115,2020-09-05,2020,PIT,CIN,2,6,6-2,CIN,9,0,40,37,77,163,166,329,13,10,23,2,3:23
15445,631625,2020-09-05,2020,BOS,TOR,9,8,9-8,BOS,9,0,42,48,90,167,166,333,18,23,41,2,3:41
15446,630383,2020-09-05,2020,ATL,WAS,4,10,10-4,WAS,9,0,38,46,84,193,161,354,12,19,31,3,3:31
15447,631359,2020-09-06,2020,ANA,HOU,9,5,9-5,ANA,9,1,40,36,76,155,137,292,17,9,26,3,3:28
15448,631676,2020-09-06,2020,BAL,NYA,5,1,5-1,BAL,9,1,35,35,70,142,158,300,11,7,18,2,3:02
15449,631116,2020-09-06,2020,PIT,CIN,3,2,3-2,PIT,9,0,37,36,73,158,147,305,13,10,23,1,3:02
15450,631030,2020-09-06,2020,SEA,TEX,4,3,4-3,SEA,9,1,32,36,68,152,124,276,9,12,21,1,2:45
15451,631209,2020-09-06,2020,NYN,PHI,14,1,14-1,NYN,9,1,46,33,79,134,166,300,22,7,29,2,3:18
15452,630491,2020-09-06,2020,ATL,WAS,10,3,10-3,ATL,9,1,45,35,80,135,175,310,24,8,32,3,3:26
15453,631158,2020-09-06,2020,OAK,SDN,3,5,5-3,SDN,9,0,36,40,76,138,126,264,10,13,23,1,3:04
15454,631005,2020-09-06,2020,SFN,ARI,4,2,4-2,SFN,9,1,34,37,71,163,128,291,13,11,24,2,2:52
15455,631557,2020-09-06,2020,CLE,MIL,4,1,4-1,CLE,9,1,35,36,71,174,153,327,13,10,23,2,3:13
15456,630956,2020-09-06,2020,TBA,MIA,5,4,5-4,TBA,10,0,37,41,78,175,155,330,8,13,21,2,3:18
15457,631604,2020-09-06,2020,CHN,SLN,3,7,7-3,SLN,9,0,35,42,77,146,159,305,8,15,23,3,3:17
15458,631407,2020-09-06,2020,KCA,CHA,2,8,8-2,CHA,9,0,35,46,81,176,116,292,8,20,28,6,3:34
15459,631344,2020-09-06,2020,LAN,COL,6,7,7-6,COL,9,0,38,42,80,169,164,333,15,16,31,4,3:43
15460,631254,2020-09-06,2020,MIN,DET,8,10,10-8,DET,9,0,45,44,89,181,191,372,19,19,38,4,3:43
15461,631626,2020-09-06,2020,BOS,TOR,8,10,10-8,TOR,9,0,44,51,95,225,193,418,18,24,42,4,4:23
15462,631159,2020-09-07,2020,OAK,HOU,6,0,6-0,OAK,9,1,38,34,72,104,169,273,15,8,23,1,2:55
15463,631006,2020-09-07,2020,SFN,ARI,4,2,4-2,SFN,9,1,32,36,68,157,127,284,9,8,17,2,2:56
15464,630857,2020-09-07,2020,WAS,TBA,6,1,6-1,WAS,9,1,35,38,73,151,107,258,12,11,23,1,2:41
15465,631605,2020-09-07,2020,CHN,SLN,5,1,5-1,CHN,9,1,39,31,70,108,162,270,15,8,23,1,2:51
15466,631558,2020-09-07,2020,CLE,KCA,5,2,5-2,CLE,9,1,35,35,70,127,135,262,11,9,20,2,2:52
15467,631255,2020-09-07,2020,MIN,DET,6,2,6-2,MIN,9,1,34,33,67,137,137,274,11,6,17,1,2:44
15468,631084,2020-09-07,2020,SDN,COL,1,0,1-0,SDN,9,0,35,32,67,128,142,270,11,7,18,1,3:02
15469,631031,2020-09-07,2020,SEA,TEX,8,4,8-4,SEA,9,1,38,35,73,148,179,327,14,9,23,2,3:00
15470,631225,2020-09-07,2020,NYN,PHI,8,9,9-8,PHI,10,0,48,44,92,177,158,335,17,16,33,1,3:40
15471,630415,2020-09-07,2020,ATL,MIA,4,5,5-4,MIA,10,0,44,47,91,178,170,348,19,18,37,1,3:52
15472,630859,2020-09-07,2020,TOR,NYA,12,7,12-7,TOR,9,1,46,43,89,188,215,403,21,15,36,3,4:02
15473,631152,2020-09-08,2020,PHI,BOS,2,5,5-2,BOS,7,0,29,34,63,128,95,223,10,13,23,3,2:36
15474,631429,2020-09-08,2020,HOU,OAK,2,4,4-2,OAK,7,0,29,31,60,116,106,222,8,10,18,0,2:23
15475,631429,2020-09-08,2020,HOU,OAK,2,4,4-2,OAK,7,0,29,31,60,116,106,222,8,10,18,0,2:23
15476,631160,2020-09-08,2020,OAK,HOU,4,5,5-4,HOU,7,0,32,33,65,121,124,245,11,12,23,4,2:52
15477,631149,2020-09-08,2020,PHI,BOS,6,5,6-5,PHI,7,0,35,34,69,124,129,253,16,14,30,1,2:49
15478,630984,2020-09-08,2020,SLN,MIN,6,4,6-4,SLN,7,1,32,32,64,121,135,256,13,11,24,3,2:48
15479,631615,2020-09-08,2020,CHN,CIN,3,0,3-0,CHN,9,1,30,35,65,147,120,267,5,10,15,0,2:36
15480,630983,2020-09-08,2020,SLN,MIN,3,7,7-3,MIN,7,0,27,34,61,127,136,263,6,13,19,2,2:31
15481,630904,2020-09-08,2020,TEX,ANA,7,1,7-1,TEX,9,1,37,36,73,141,138,279,12,11,23,1,2:52
15482,631096,2020-09-08,2020,PIT,CHA,5,4,5-4,PIT,9,0,35,38,73,147,145,292,12,13,25,3,3:19
15483,630860,2020-09-08,2020,TOR,NYA,2,1,2-1,TOR,9,1,29,38,67,169,133,302,6,12,18,1,3:00
15484,631211,2020-09-08,2020,NYN,BAL,2,11,11-2,BAL,9,0,33,43,76,169,133,302,7,16,23,1,3:01
15485,631460,2020-09-08,2020,DET,MIL,8,3,8-3,DET,9,1,37,37,74,156,143,299,13,14,27,3,3:05
15486,630438,2020-09-08,2020,ATL,MIA,0,8,8-0,MIA,9,0,34,43,77,164,144,308,7,17,24,2,3:12
15487,630867,2020-09-08,2020,WAS,TBA,5,3,5-3,WAS,9,1,39,37,76,153,160,313,17,10,27,2,3:20
15488,631559,2020-09-08,2020,CLE,KCA,6,8,8-6,KCA,9,0,36,41,77,164,138,302,10,13,23,3,3:13
15489,631071,2020-09-08,2020,SDN,COL,14,5,14-5,SDN,9,1,42,36,78,148,152,300,21,10,31,3,3:16
15490,631007,2020-09-08,2020,SFN,SEA,6,5,6-5,SFN,9,1,35,40,75,166,142,308,11,16,27,1,3:04
15491,630220,2020-09-08,2020,ARI,LAN,9,10,10-9,LAN,10,0,43,54,97,217,181,398,13,24,37,7,4:25
15492,631616,2020-09-09,2020,CHN,CIN,0,3,3-0,CIN,9,0,31,33,64,140,123,263,4,7,11,2,2:54
15493,631560,2020-09-09,2020,CLE,KCA,0,3,3-0,KCA,9,0,37,36,73,136,146,282,10,10,20,1,3:03
15494,631161,2020-09-09,2020,OAK,HOU,3,2,3-2,OAK,9,0,39,32,71,126,158,284,13,5,18,2,2:53
15495,631461,2020-09-09,2020,DET,MIL,0,19,19-0,MIL,9,0,28,54,82,199,109,308,2,30,32,2,3:04
15496,631056,2020-09-09,2020,SDN,COL,5,3,5-3,SDN,9,1,35,37,72,152,125,277,13,10,23,1,2:54
15497,630864,2020-09-09,2020,TOR,NYA,2,7,7-2,NYA,9,0,32,42,74,168,114,282,6,14,20,1,3:04
15498,631100,2020-09-09,2020,PIT,CHA,1,8,8-1,CHA,9,0,37,41,78,163,137,300,9,14,23,2,3:08
15499,630221,2020-09-09,2020,ARI,LAN,4,6,6-4,LAN,10,0,40,45,85,148,153,301,10,15,25,2,3:20
15500,631212,2020-09-09,2020,NYN,BAL,7,6,7-6,NYN,9,1,36,46,82,164,137,301,13,20,33,4,3:25
15501,631008,2020-09-09,2020,SFN,SEA,10,1,10-1,SFN,9,1,41,35,76,161,161,322,18,8,26,1,3:05
15502,630925,2020-09-09,2020,TEX,ANA,7,3,7-3,TEX,9,1,37,39,76,163,155,318,13,11,24,3,3:38
15503,630439,2020-09-09,2020,ATL,MIA,29,9,29-9,ATL,9,1,58,43,101,197,240,437,33,17,50,4,4:14
15504,631162,2020-09-10,2020,OAK,HOU,3,1,3-1,OAK,9,1,34,29,63,85,135,220,11,3,14,1,2:18
15505,630995,2020-09-10,2020,SLN,DET,3,6,6-3,DET,7,0,30,34,64,127,113,240,11,16,27,4,2:40
15506,630995,2020-09-10,2020,SLN,DET,3,6,6-3,DET,7,0,30,34,64,127,113,240,11,16,27,4,2:40
15507,631072,2020-09-10,2020,SDN,SFN,6,1,6-1,SDN,9,1,33,33,66,148,121,269,8,9,17,1,2:48
15508,630994,2020-09-10,2020,SLN,DET,12,2,12-2,SLN,7,1,35,27,62,121,158,279,17,7,24,2,2:34
15509,630994,2020-09-10,2020,SLN,DET,12,2,12-2,SLN,7,1,35,27,62,121,158,279,17,7,24,2,2:34
15510,631561,2020-09-10,2020,CLE,KCA,1,11,11-1,KCA,9,0,32,43,75,168,142,310,5,16,21,1,2:48
15511,631309,2020-09-10,2020,MIA,PHI,7,6,7-6,MIA,9,0,45,39,84,138,178,316,20,14,34,2,3:26
15512,630957,2020-09-10,2020,TBA,BOS,3,4,4-3,BOS,9,0,39,37,76,140,166,306,12,11,23,3,3:22
15513,630908,2020-09-10,2020,TEX,ANA,2,6,6-2,ANA,9,0,33,40,73,162,144,306,6,15,21,2,3:04
15514,630869,2020-09-10,2020,WAS,ATL,6,7,7-6,ATL,9,0,42,37,79,143,164,307,16,13,29,4,3:40
15515,630223,2020-09-10,2020,ARI,LAN,5,2,5-2,ARI,9,1,37,41,78,173,138,311,12,17,29,1,3:31
15516,631634,2020-09-10,2020,CHN,CIN,8,5,8-5,CHN,9,1,43,39,82,177,189,366,21,14,35,5,4:07 (1:15 delay)
15517,630985,2020-09-11,2020,SLN,CIN,1,3,3-1,CIN,9,0,31,35,66,143,112,255,5,10,15,0,2:24
15518,631256,2020-09-11,2020,MIN,CLE,3,1,3-1,MIN,9,1,31,33,64,123,123,246,7,8,15,0,2:43 (:42 delay)
15519,631184,2020-09-11,2020,NYA,BAL,6,0,6-0,NYA,7,1,28,25,53,114,101,215,12,3,15,0,2:02
15520,631284,2020-09-11,2020,MIL,CHN,1,0,1-0,MIL,9,0,32,33,65,124,137,261,7,4,11,1,2:50
15521,631318,2020-09-11,2020,MIA,PHI,5,3,5-3,MIA,7,1,30,32,62,104,121,225,12,13,25,4,2:41
15522,631318,2020-09-11,2020,MIA,PHI,5,3,5-3,MIA,7,1,30,32,62,104,121,225,12,13,25,4,2:41
15523,631478,2020-09-11,2020,CHA,DET,4,3,4-3,CHA,9,1,30,37,67,163,119,282,7,9,16,4,3:02
15524,631310,2020-09-11,2020,MIA,PHI,0,11,11-0,PHI,7,0,25,36,61,133,106,239,5,14,19,1,2:33
15525,630224,2020-09-11,2020,ARI,SEA,4,3,4-3,ARI,9,1,32,33,65,127,123,250,8,6,14,1,2:32
15526,631183,2020-09-11,2020,NYA,BAL,10,1,10-1,NYA,7,1,33,26,59,131,144,275,15,6,21,2,2:40
15527,631530,2020-09-11,2020,COL,ANA,8,4,8-4,COL,9,0,39,37,76,128,154,282,15,10,25,2,3:08
15528,631183,2020-09-11,2020,NYA,BAL,10,1,10-1,NYA,7,1,33,26,59,131,144,275,15,6,21,2,2:40
15529,630909,2020-09-11,2020,TEX,OAK,6,10,10-6,OAK,9,0,38,47,85,176,154,330,13,19,32,2,3:22
15530,631399,2020-09-11,2020,KCA,PIT,4,3,4-3,KCA,9,1,36,38,74,165,169,334,11,11,22,1,3:10
15531,630958,2020-09-11,2020,TBA,BOS,11,1,11-1,TBA,9,1,42,37,79,163,174,337,19,13,32,3,3:37
15532,630868,2020-09-11,2020,TOR,NYN,1,18,18-1,NYN,9,0,34,55,89,231,132,363,8,27,35,3,3:30
15533,630873,2020-09-11,2020,WAS,ATL,8,7,8-7,WAS,12,0,50,62,112,236,192,428,18,28,46,1,4:48
15534,630910,2020-09-12,2020,TEX,OAK,5,2,5-2,TEX,7,1,25,26,51,99,96,195,7,5,12,1,1:58
15535,631257,2020-09-12,2020,MIN,CLE,8,4,8-4,MIN,9,1,33,37,70,167,108,275,11,10,21,2,2:56
15536,630225,2020-09-12,2020,ARI,SEA,3,7,7-3,SEA,9,0,37,40,77,146,117,263,11,16,27,0,2:45
15537,630959,2020-09-12,2020,TBA,BOS,5,4,5-4,TBA,9,1,33,35,68,123,126,249,10,8,18,0,2:37
15538,631331,2020-09-12,2020,LAN,HOU,5,7,7-5,HOU,9,0,36,41,77,148,142,290,11,16,27,2,3:15
15539,631285,2020-09-12,2020,MIL,CHN,2,4,4-2,CHN,9,0,34,37,71,145,128,273,8,10,18,2,2:42
15540,630877,2020-09-12,2020,WAS,ATL,1,2,2-1,ATL,9,0,36,36,72,138,149,287,10,9,19,1,3:04
15541,630988,2020-09-12,2020,SLN,CIN,7,1,7-1,SLN,9,1,39,33,72,129,162,291,16,7,23,3,3:08
15542,630932,2020-09-12,2020,TEX,OAK,1,10,10-1,OAK,7,0,30,39,69,170,126,296,12,17,29,1,2:59
15543,630870,2020-09-12,2020,TOR,NYN,3,2,3-2,TOR,9,1,37,36,73,149,141,290,13,10,23,2,3:22
15544,631185,2020-09-12,2020,NYA,BAL,2,1,2-1,NYA,10,0,38,37,75,126,174,300,10,5,15,2,3:11
15545,630932,2020-09-12,2020,TEX,OAK,1,10,10-1,OAK,7,0,30,39,69,170,126,296,12,17,29,1,2:59
15546,631495,2020-09-12,2020,CHA,DET,14,0,14-0,CHA,9,1,47,32,79,117,178,295,23,6,29,1,3:02
15547,631400,2020-09-12,2020,KCA,PIT,7,4,7-4,KCA,9,1,41,34,75,136,160,296,18,9,27,2,3:06 (:32 delay)
15548,631531,2020-09-12,2020,COL,ANA,2,5,5-2,ANA,11,0,43,48,91,181,152,333,11,13,24,3,3:44
15549,631311,2020-09-12,2020,MIA,PHI,6,12,12-6,PHI,9,0,37,49,86,175,152,327,13,23,36,5,3:43
15550,631058,2020-09-13,2020,SDN,SFN,3,1,3-1,SDN,7,1,24,27,51,98,102,200,9,6,15,2,2:12
15551,631060,2020-09-13,2020,SDN,SFN,6,0,6-0,SDN,7,1,28,23,51,99,115,214,11,3,14,1,2:08
15552,631312,2020-09-13,2020,MIA,PHI,2,1,2-1,MIA,7,1,26,26,52,90,104,194,8,7,15,2,2:01
15553,631058,2020-09-13,2020,SDN,SFN,3,1,3-1,SDN,7,1,24,27,51,98,102,200,9,6,15,2,2:12
15554,631320,2020-09-13,2020,MIA,PHI,8,1,8-1,MIA,7,1,31,25,56,103,124,227,15,6,21,1,2:22
15555,631320,2020-09-13,2020,MIA,PHI,8,1,8-1,MIA,7,1,31,25,56,103,124,227,15,6,21,1,2:22
15556,631332,2020-09-13,2020,LAN,HOU,8,1,8-1,LAN,9,1,35,33,68,136,131,267,12,6,18,1,2:52
15557,631481,2020-09-13,2020,CHA,DET,5,2,5-2,CHA,9,1,35,35,70,155,145,300,12,9,21,2,3:08
15558,631401,2020-09-13,2020,KCA,PIT,11,0,11-0,KCA,9,1,45,32,77,111,185,296,21,6,27,2,3:02
15559,630911,2020-09-13,2020,TEX,OAK,6,3,6-3,TEX,9,1,33,36,69,144,131,275,10,9,19,1,2:57
15560,630947,2020-09-13,2020,TBA,BOS,3,6,6-3,BOS,9,0,40,40,80,150,162,312,11,14,25,2,3:11
15561,631286,2020-09-13,2020,MIL,CHN,0,12,12-0,CHN,9,0,29,47,76,182,114,296,3,18,21,1,2:50
15562,631187,2020-09-13,2020,NYA,BAL,3,1,3-1,NYA,9,1,33,33,66,137,130,267,9,7,16,2,2:44
15563,631532,2020-09-13,2020,COL,ANA,3,5,5-3,ANA,9,0,34,43,77,179,123,302,8,17,25,3,3:04
15564,631259,2020-09-13,2020,MIN,CLE,7,5,7-5,MIN,9,1,35,42,77,188,149,337,11,16,27,5,3:43
15565,630875,2020-09-13,2020,TOR,NYN,7,3,7-3,TOR,9,1,37,39,76,153,150,303,13,14,27,2,3:12
15566,630883,2020-09-13,2020,WAS,ATL,4,8,8-4,ATL,9,0,39,41,80,175,155,330,14,15,29,3,3:37
15567,630226,2020-09-13,2020,ARI,SEA,3,7,7-3,SEA,9,0,39,41,80,172,172,344,13,15,28,2,3:32
15568,630961,2020-09-13,2020,SLN,CIN,5,10,10-5,CIN,9,0,41,46,87,216,169,385,15,20,35,5,3:42
15569,631588,2020-09-14,2020,CIN,PIT,3,1,3-1,CIN,7,0,28,27,55,116,119,235,9,6,15,1,2:25
15570,631053,2020-09-14,2020,SEA,OAK,6,5,6-5,SEA,7,1,31,32,63,121,115,236,13,10,23,2,2:18
15571,631053,2020-09-14,2020,SEA,OAK,6,5,6-5,SEA,7,1,31,32,63,121,115,236,13,10,23,2,2:18
15572,631054,2020-09-14,2020,SEA,OAK,0,9,9-0,OAK,7,0,23,38,61,142,102,244,4,17,21,1,2:24
15573,631054,2020-09-14,2020,SEA,OAK,0,9,9-0,OAK,7,0,23,38,61,142,102,244,4,17,21,1,2:24
15574,631282,2020-09-14,2020,MIL,SLN,2,1,2-1,MIL,8,0,32,30,62,132,112,244,10,7,17,1,2:37
15575,631321,2020-09-14,2020,MIA,PHI,6,2,6-2,MIA,9,1,35,31,66,125,144,269,11,4,15,3,2:47
15576,631321,2020-09-14,2020,MIA,PHI,6,2,6-2,MIA,9,1,35,31,66,125,144,269,11,4,15,3,2:47
15577,631590,2020-09-14,2020,CIN,PIT,9,4,9-4,CIN,7,1,32,32,64,140,155,295,15,12,27,4,2:58
15578,631590,2020-09-14,2020,CIN,PIT,9,4,9-4,CIN,7,1,32,32,64,140,155,295,15,12,27,4,2:58
15579,631061,2020-09-14,2020,SDN,LAN,7,2,7-2,SDN,9,1,35,34,69,141,139,280,10,8,18,2,2:59
15580,631288,2020-09-14,2020,MIL,SLN,2,3,3-2,SLN,9,0,35,42,77,183,156,339,9,14,23,4,3:42
15581,631677,2020-09-14,2020,BAL,ATL,14,1,14-1,BAL,9,1,47,35,82,140,175,315,24,10,34,1,2:54
15582,631288,2020-09-14,2020,MIL,SLN,2,3,3-2,SLN,9,0,35,42,77,183,156,339,9,14,23,4,3:42
15583,631482,2020-09-14,2020,CHA,MIN,3,1,3-1,CHA,9,1,39,43,82,187,166,353,15,19,34,4,3:51
15584,631520,2020-09-15,2020,COL,OAK,3,1,3-1,COL,9,1,33,33,66,109,127,236,11,7,18,1,2:41
15585,631574,2020-09-15,2020,CIN,PIT,4,1,4-1,CIN,9,1,32,35,67,151,121,272,8,8,16,0,2:40
15586,631314,2020-09-15,2020,MIA,BOS,0,2,2-0,BOS,9,0,33,37,70,144,135,279,7,12,19,2,3:05
15587,631360,2020-09-15,2020,ANA,ARI,8,9,9-8,ARI,9,0,41,40,81,151,135,286,16,13,29,2,3:06
15588,631062,2020-09-15,2020,SDN,LAN,1,3,3-1,LAN,9,0,34,35,69,151,125,276,7,10,17,1,2:59
15589,631144,2020-09-15,2020,PHI,NYN,4,1,4-1,PHI,9,1,32,40,72,154,126,280,8,15,23,2,2:58
15590,631680,2020-09-15,2020,BAL,ATL,1,5,5-1,ATL,9,0,30,43,73,167,120,287,4,17,21,1,2:57
15591,631433,2020-09-15,2020,HOU,TEX,4,1,4-1,HOU,9,1,37,31,68,117,176,293,14,4,18,2,3:00
15592,631483,2020-09-15,2020,CHA,MIN,6,2,6-2,CHA,9,1,38,35,73,136,164,300,15,8,23,2,3:04
15593,631618,2020-09-15,2020,CHN,CLE,6,5,6-5,CHN,9,0,41,39,80,139,143,282,18,16,34,1,3:17
15594,631462,2020-09-15,2020,DET,KCA,6,0,6-0,DET,9,1,41,37,78,155,174,329,19,10,29,3,3:27
15595,631195,2020-09-15,2020,NYA,TOR,20,6,20-6,NYA,9,1,50,41,91,127,190,317,25,15,40,2,3:12
15596,630936,2020-09-15,2020,TBA,WAS,6,1,6-1,TBA,9,1,39,36,75,140,155,295,16,10,26,4,3:08
15597,631263,2020-09-15,2020,MIL,SLN,18,3,18-3,MIL,9,1,46,38,84,161,190,351,22,11,33,2,3:09
15598,631265,2020-09-16,2020,MIL,SLN,2,4,4-2,SLN,7,0,26,27,53,88,102,190,5,7,12,0,2:01
15599,631289,2020-09-16,2020,MIL,SLN,6,0,6-0,MIL,7,1,30,25,55,106,104,210,13,4,17,1,2:01
15600,631289,2020-09-16,2020,MIL,SLN,6,0,6-0,MIL,7,1,30,25,55,106,104,210,13,4,17,1,2:01
15601,631434,2020-09-16,2020,HOU,TEX,0,1,1-0,TEX,9,0,32,33,65,126,114,240,7,5,12,1,2:36
15602,631289,2020-09-16,2020,MIL,SLN,6,0,6-0,MIL,7,1,30,25,55,106,104,210,13,4,17,1,2:01
15603,631575,2020-09-16,2020,CIN,PIT,1,0,1-0,CIN,9,1,29,30,59,114,141,255,6,4,10,2,2:34
15604,631463,2020-09-16,2020,DET,KCA,0,4,4-0,KCA,9,0,30,37,67,146,118,264,3,8,11,0,2:33
15605,631659,2020-09-16,2020,BAL,ATL,5,1,5-1,BAL,9,1,32,33,65,152,119,271,9,7,16,1,2:35
15606,631484,2020-09-16,2020,CHA,MIN,1,5,5-1,MIN,9,0,30,36,66,140,138,278,3,11,14,2,3:05
15607,631509,2020-09-16,2020,COL,OAK,1,3,3-1,OAK,9,0,36,35,71,140,131,271,9,10,19,2,2:57
15608,631063,2020-09-16,2020,SDN,LAN,5,7,7-5,LAN,9,0,37,39,76,162,138,300,11,11,22,6,3:25
15609,631361,2020-09-16,2020,ANA,ARI,6,9,9-6,ARI,9,0,40,41,81,150,156,306,14,14,28,1,3:10
15610,631119,2020-09-16,2020,PHI,NYN,4,5,5-4,NYN,9,0,40,36,76,130,158,288,13,13,26,1,3:17
15611,631619,2020-09-16,2020,CHN,CLE,3,2,3-2,CHN,10,0,42,37,79,140,159,299,18,9,27,1,3:13 (:07 delay)
15612,631315,2020-09-16,2020,MIA,BOS,8,4,8-4,MIA,9,1,36,42,78,173,148,321,12,15,27,2,3:35
15613,631189,2020-09-16,2020,NYA,TOR,13,2,13-2,NYA,9,1,43,35,78,127,179,306,20,8,28,1,3:02
15614,630937,2020-09-16,2020,TBA,WAS,2,4,4-2,WAS,10,0,42,38,80,153,171,324,14,9,23,1,3:31
15615,631032,2020-09-16,2020,SEA,SFN,3,9,9-3,SFN,9,0,41,44,85,172,182,354,16,18,34,4,3:29
15616,631032,2020-09-16,2020,SEA,SFN,3,9,9-3,SFN,9,0,41,44,85,172,182,354,16,18,34,4,3:29
15617,631660,2020-09-17,2020,BAL,TBA,1,3,3-1,TBA,7,0,27,30,57,129,107,236,7,9,16,1,2:28
15618,631435,2020-09-17,2020,HOU,TEX,2,1,2-1,HOU,9,1,30,33,63,126,113,239,5,6,11,1,2:33
15619,630953,2020-09-17,2020,TBA,BAL,10,6,10-6,TBA,7,1,32,34,66,126,124,250,15,13,28,5,2:38
15620,631101,2020-09-17,2020,PIT,SLN,5,1,5-1,PIT,9,1,35,30,65,110,145,255,15,4,19,2,2:25
15621,630953,2020-09-17,2020,TBA,BAL,10,6,10-6,TBA,7,1,32,34,66,126,124,250,15,13,28,5,2:38
15622,631510,2020-09-17,2020,COL,LAN,3,9,9-3,LAN,9,0,34,43,77,161,117,278,5,18,23,5,3:07
15623,631485,2020-09-17,2020,CHA,MIN,4,3,4-3,CHA,9,1,35,36,71,129,160,289,12,9,21,4,3:20
15624,631313,2020-09-17,2020,MIA,BOS,3,5,5-3,BOS,9,0,37,37,74,154,136,290,9,13,22,3,3:09
15625,631362,2020-09-17,2020,ANA,ARI,7,3,7-3,ANA,9,1,37,39,76,175,128,303,15,12,27,2,3:07
15626,631464,2020-09-17,2020,DET,CLE,3,10,10-3,CLE,9,0,33,44,77,188,136,324,6,16,22,3,3:04
15627,631190,2020-09-17,2020,NYA,TOR,10,7,10-7,NYA,9,1,43,40,83,144,172,316,20,14,34,2,3:19
15628,631034,2020-09-17,2020,SEA,SFN,4,6,6-4,SFN,9,0,40,42,82,164,181,345,13,18,31,3,3:34
15629,631034,2020-09-17,2020,SEA,SFN,4,6,6-4,SFN,9,0,40,42,82,164,181,345,13,18,31,3,3:34
15630,631117,2020-09-17,2020,PHI,NYN,6,10,10-6,NYN,9,0,46,44,90,180,191,371,19,18,37,6,4:12
15631,631316,2020-09-18,2020,MIA,WAS,0,5,5-0,WAS,7,0,26,32,58,102,109,211,5,15,20,0,2:15
15632,630987,2020-09-18,2020,SLN,PIT,7,2,7-2,SLN,7,1,28,27,55,117,109,226,8,6,14,1,2:19
15633,630987,2020-09-18,2020,SLN,PIT,7,2,7-2,SLN,7,1,28,27,55,117,109,226,8,6,14,1,2:19
15634,630907,2020-09-18,2020,TOR,PHI,0,7,7-0,PHI,7,0,25,36,61,144,92,236,6,15,21,2,2:33
15635,630907,2020-09-18,2020,TOR,PHI,0,7,7-0,PHI,7,0,25,36,61,144,92,236,6,15,21,2,2:33
15636,631122,2020-09-18,2020,PHI,TOR,8,7,8-7,PHI,7,1,32,37,69,136,131,267,15,16,31,8,3:14
15637,631342,2020-09-18,2020,MIA,WAS,14,3,14-3,MIA,7,1,38,28,66,115,149,264,19,8,27,4,2:54
15638,631629,2020-09-18,2020,CHN,MIN,1,0,1-0,CHN,9,1,31,31,62,130,118,248,7,6,13,0,2:34
15639,631661,2020-09-18,2020,BAL,TBA,1,2,2-1,TBA,9,0,34,39,73,147,145,292,7,12,19,1,2:59
15640,631102,2020-09-18,2020,PIT,SLN,5,6,6-5,SLN,7,0,36,33,69,130,154,284,12,11,23,5,3:08
15641,631342,2020-09-18,2020,MIA,WAS,14,3,14-3,MIA,7,1,38,28,66,115,149,264,19,8,27,4,2:54
15642,631576,2020-09-18,2020,CIN,CHA,7,1,7-1,CIN,9,1,35,34,69,150,153,303,12,8,20,2,2:51
15643,631367,2020-09-18,2020,ANA,TEX,6,2,6-2,ANA,9,1,41,33,74,130,155,285,18,6,24,1,2:55
15644,631436,2020-09-18,2020,HOU,ARI,3,6,6-3,ARI,9,0,36,37,73,153,133,286,8,11,19,2,3:08
15645,631465,2020-09-18,2020,DET,CLE,0,1,1-0,CLE,9,0,34,38,72,171,143,314,8,12,20,2,3:33
15646,631163,2020-09-18,2020,OAK,SFN,6,0,6-0,OAK,9,1,35,35,70,146,155,301,10,8,18,2,2:53
15647,631040,2020-09-18,2020,SEA,SDN,1,6,6-1,SDN,9,0,31,40,71,151,148,299,5,14,19,0,3:01
15648,631266,2020-09-18,2020,MIL,KCA,9,5,9-5,MIL,9,1,42,42,84,181,159,340,19,16,35,2,3:20
15649,631511,2020-09-18,2020,COL,LAN,6,15,15-6,LAN,9,0,36,48,84,192,121,313,11,22,33,7,3:24
15650,631213,2020-09-18,2020,NYN,ATL,2,15,15-2,ATL,9,0,39,52,91,218,162,380,13,26,39,2,3:39
15651,631627,2020-09-18,2020,BOS,NYA,5,6,6-5,NYA,12,0,53,47,100,184,228,412,16,15,31,2,4:55
15652,631437,2020-09-19,2020,HOU,ARI,3,2,3-2,HOU,9,1,31,34,65,140,113,253,7,8,15,1,2:37
15653,631267,2020-09-19,2020,MIL,KCA,5,0,5-0,MIL,9,1,31,31,62,141,141,282,10,5,15,1,2:55
15654,631512,2020-09-19,2020,COL,LAN,1,6,6-1,LAN,9,0,29,37,66,144,114,258,5,11,16,0,2:32
15655,631164,2020-09-19,2020,OAK,SFN,6,0,6-0,OAK,9,1,34,32,66,122,134,256,11,6,17,1,2:34
15656,631372,2020-09-19,2020,ANA,TEX,4,3,4-3,ANA,9,1,32,35,67,136,121,257,9,8,17,1,2:35
15657,631628,2020-09-19,2020,BOS,NYA,0,8,8-0,NYA,9,0,32,41,73,167,124,291,5,17,22,0,2:59
15658,631466,2020-09-19,2020,DET,CLE,5,2,5-2,DET,9,1,39,34,73,127,159,286,17,8,25,3,3:00
15659,631036,2020-09-19,2020,SEA,SDN,4,1,4-1,SEA,9,1,35,35,70,137,146,283,12,12,24,1,2:59
15660,631147,2020-09-19,2020,PIT,SLN,4,5,5-4,SLN,9,0,35,38,73,152,157,309,9,11,20,4,3:06
15661,631577,2020-09-19,2020,CIN,CHA,0,5,5-0,CHA,9,0,36,37,73,148,138,286,11,10,21,0,2:57
15662,631123,2020-09-19,2020,PHI,TOR,3,1,3-1,PHI,9,1,37,31,68,144,152,296,13,5,18,2,3:16
15663,631662,2020-09-19,2020,BAL,TBA,1,3,3-1,TBA,9,0,37,37,74,140,154,294,11,11,22,2,3:04
15664,631317,2020-09-19,2020,MIA,WAS,7,3,7-3,MIA,9,1,40,36,76,156,134,290,18,11,29,2,3:06
15665,631632,2020-09-19,2020,CHN,MIN,1,8,8-1,MIN,9,0,33,36,69,148,148,296,6,12,18,2,3:10
15666,631214,2020-09-19,2020,NYN,ATL,7,2,7-2,NYN,9,1,39,38,77,157,168,325,15,13,28,3,3:32
15667,631305,2020-09-20,2020,MIA,WAS,2,1,2-1,MIA,7,1,27,30,57,122,122,244,8,11,19,1,2:37
15668,631086,2020-09-20,2020,PIT,SLN,1,2,2-1,SLN,9,0,30,37,67,151,133,284,4,9,13,0,2:50
15669,631329,2020-09-20,2020,MIA,WAS,0,15,15-0,WAS,7,0,26,43,69,160,107,267,5,22,27,3,2:54
15670,631672,2020-09-20,2020,BAL,TBA,2,1,2-1,BAL,9,1,31,34,65,141,109,250,7,6,13,3,2:31
15671,631375,2020-09-20,2020,ANA,TEX,2,7,7-2,TEX,9,0,33,39,72,154,124,278,7,13,20,4,3:00
15672,631454,2020-09-20,2020,DET,CLE,4,7,7-4,CLE,9,0,36,38,74,156,157,313,9,11,20,1,2:59
15673,631215,2020-09-20,2020,NYN,ATL,0,7,7-0,ATL,9,0,30,41,71,163,137,300,5,14,19,2,3:09
15674,631635,2020-09-20,2020,BOS,NYA,10,2,10-2,BOS,9,1,42,34,76,142,164,306,19,9,28,0,3:22
15675,631329,2020-09-20,2020,MIA,WAS,0,15,15-0,WAS,7,0,26,43,69,160,107,267,5,22,27,3,2:54
15676,631617,2020-09-20,2020,CHN,MIN,0,4,4-0,MIN,9,0,36,39,75,131,143,274,8,13,21,1,3:07
15677,631519,2020-09-20,2020,COL,LAN,6,3,6-3,COL,9,1,35,39,74,168,141,309,11,14,25,4,3:15
15678,631268,2020-09-20,2020,MIL,KCA,5,3,5-3,MIL,9,1,35,32,67,127,151,278,12,6,18,3,2:43
15679,631424,2020-09-20,2020,HOU,ARI,3,2,3-2,HOU,9,1,35,33,68,134,160,294,11,9,20,2,3:04
15680,631128,2020-09-20,2020,PHI,TOR,3,6,6-3,TOR,9,0,39,40,79,167,166,333,11,12,23,2,3:28
15681,631578,2020-09-20,2020,CIN,CHA,7,3,7-3,CIN,9,1,43,37,80,171,186,357,20,11,31,3,3:36
15682,631166,2020-09-20,2020,OAK,SFN,2,14,14-2,SFN,9,0,37,49,86,193,142,335,10,23,33,2,3:21
15683,631037,2020-09-20,2020,SEA,SDN,4,7,7-4,SDN,11,0,42,47,89,207,178,385,10,14,24,1,4:02
15684,631038,2020-09-21,2020,SEA,HOU,6,1,6-1,SEA,9,1,34,36,70,114,130,244,10,10,20,1,2:34
15685,631402,2020-09-21,2020,KCA,SLN,4,1,4-1,KCA,9,1,34,35,69,144,125,269,11,9,20,3,2:55
15686,631579,2020-09-21,2020,CIN,MIL,6,3,6-3,CIN,9,1,34,35,69,137,145,282,11,10,21,4,2:56
15687,631087,2020-09-21,2020,PIT,CHN,0,5,5-0,CHN,9,0,31,37,68,139,135,274,6,11,17,3,2:58
15688,631562,2020-09-21,2020,CLE,CHA,7,4,7-4,CLE,9,1,37,40,77,162,148,310,15,13,28,0,3:14
15689,631216,2020-09-21,2020,NYN,TBA,1,2,2-1,TBA,9,0,34,35,69,149,119,268,8,9,17,3,3:00
15690,631376,2020-09-21,2020,ANA,TEX,8,5,8-5,ANA,9,1,37,36,73,150,140,290,14,9,23,1,3:00
15691,630440,2020-09-21,2020,ATL,MIA,5,4,5-4,ATL,9,1,34,41,75,176,140,316,11,16,27,1,3:30
15692,630884,2020-09-21,2020,WAS,PHI,5,1,5-1,WAS,9,1,37,36,73,171,172,343,13,13,26,2,3:48
15693,631009,2020-09-21,2020,SFN,COL,2,7,7-2,COL,9,0,40,41,81,180,167,347,12,14,26,2,3:33
15694,630876,2020-09-21,2020,TOR,NYA,11,5,11-5,TOR,9,1,41,39,80,175,190,365,17,13,30,5,3:56
15695,630888,2020-09-22,2020,WAS,PHI,5,1,5-1,WAS,7,1,27,26,53,105,94,199,9,4,13,0,2:09
15696,631088,2020-09-22,2020,PIT,CHN,3,2,3-2,PIT,9,0,32,34,66,122,132,254,8,10,18,2,2:45
15697,631580,2020-09-22,2020,CIN,MIL,2,3,3-2,MIL,9,0,35,33,68,136,124,260,6,7,13,0,2:27
15698,630385,2020-09-22,2020,ATL,MIA,11,1,11-1,ATL,9,1,41,36,77,135,134,269,17,12,29,1,2:50
15699,631217,2020-09-22,2020,NYN,TBA,5,2,5-2,NYN,9,1,34,33,67,135,151,286,14,6,20,2,3:03
15700,630243,2020-09-22,2020,ARI,TEX,7,0,7-0,ARI,9,1,39,36,75,137,153,290,13,9,22,1,2:56
15701,631333,2020-09-22,2020,LAN,OAK,7,2,7-2,LAN,9,1,37,36,73,154,141,295,15,8,23,3,3:18
15702,631064,2020-09-22,2020,SDN,ANA,2,4,4-2,ANA,9,0,36,42,78,149,153,302,11,14,25,2,3:10
15703,631039,2020-09-22,2020,SEA,HOU,1,6,6-1,HOU,9,0,33,42,75,160,140,300,7,15,22,2,3:06
15704,631550,2020-09-22,2020,CLE,CHA,5,3,5-3,CLE,10,0,39,38,77,135,171,306,10,10,20,1,3:21
15705,631411,2020-09-22,2020,KCA,SLN,0,5,5-0,SLN,9,0,35,40,75,169,144,313,8,15,23,1,3:09
15706,630896,2020-09-22,2020,WAS,PHI,8,7,8-7,WAS,8,0,35,41,76,164,131,295,13,18,31,5,3:25
15707,630896,2020-09-22,2020,WAS,PHI,8,7,8-7,WAS,8,0,35,41,76,164,131,295,13,18,31,5,3:25
15708,631010,2020-09-22,2020,SFN,COL,5,2,5-2,SFN,9,1,38,37,75,165,154,319,16,11,27,3,3:26
15709,631251,2020-09-22,2020,MIN,DET,5,4,5-4,MIN,10,0,42,42,84,161,175,336,14,14,28,4,3:43
15710,631636,2020-09-22,2020,BOS,BAL,8,3,8-3,BOS,9,1,42,42,84,166,182,348,18,15,33,4,3:31
15711,630881,2020-09-22,2020,TOR,NYA,1,12,12-1,NYA,9,0,30,43,73,182,142,324,5,18,23,3,3:29
15712,631089,2020-09-23,2020,PIT,CHN,2,1,2-1,PIT,9,1,30,37,67,165,103,268,8,10,18,2,2:57
15713,631218,2020-09-23,2020,NYN,TBA,5,8,8-5,TBA,9,0,35,40,75,140,124,264,8,15,23,2,2:53
15714,631583,2020-09-23,2020,CIN,MIL,6,1,6-1,CIN,9,1,34,32,66,113,142,255,9,6,15,1,2:38
15715,631334,2020-09-23,2020,LAN,OAK,4,6,6-4,OAK,9,0,35,36,71,139,141,280,8,9,17,1,2:52
15716,630554,2020-09-23,2020,ATL,MIA,9,4,9-4,ATL,9,1,39,34,73,136,154,290,16,8,24,0,3:01
15717,631035,2020-09-23,2020,SEA,HOU,3,2,3-2,SEA,9,1,37,38,75,146,151,297,13,12,25,2,3:09
15718,630263,2020-09-23,2020,ARI,TEX,7,3,7-3,ARI,9,1,38,35,73,140,145,285,14,9,23,2,2:57
15719,630892,2020-09-23,2020,WAS,PHI,3,12,12-3,PHI,9,0,33,47,80,168,106,274,7,22,29,2,2:48
15720,631534,2020-09-23,2020,CLE,CHA,3,2,3-2,CLE,9,0,34,36,70,158,161,319,9,7,16,0,3:14
15721,631011,2020-09-23,2020,SFN,COL,7,2,7-2,SFN,9,1,41,36,77,128,169,297,17,10,27,3,3:10
15722,631250,2020-09-23,2020,MIN,DET,7,6,7-6,MIN,9,1,34,40,74,162,133,295,10,12,22,3,3:16
15723,631637,2020-09-23,2020,BOS,BAL,9,1,9-1,BOS,9,1,40,38,78,153,142,295,15,14,29,2,3:04
15724,631065,2020-09-23,2020,SDN,ANA,2,5,5-2,ANA,9,0,35,40,75,152,149,301,8,14,22,4,3:24
15725,631380,2020-09-23,2020,KCA,SLN,12,3,12-3,KCA,9,1,40,37,77,146,139,285,17,11,28,2,2:50
15726,630885,2020-09-23,2020,TOR,NYA,14,1,14-1,TOR,9,1,47,36,83,157,176,333,22,9,31,2,3:39
15727,631099,2020-09-24,2020,PIT,CHN,7,0,7-0,PIT,9,1,37,32,69,117,133,250,17,6,23,1,2:36
15728,631549,2020-09-24,2020,CLE,CHA,5,4,5-4,CLE,9,1,35,32,67,126,136,262,12,6,18,2,2:48
15729,631335,2020-09-24,2020,LAN,OAK,5,1,5-1,LAN,9,1,37,32,69,140,134,274,13,6,19,0,2:50
15730,630887,2020-09-24,2020,TOR,NYA,4,1,4-1,TOR,9,1,35,39,74,149,136,285,11,12,23,2,3:11
15731,631685,2020-09-24,2020,ATL,MIA,2,4,4-2,MIA,9,0,40,40,80,153,166,319,13,11,24,4,3:35 (1:39 delay)
15732,630893,2020-09-24,2020,WAS,NYN,2,3,3-2,NYN,9,0,35,42,77,152,153,305,9,15,24,0,3:15
15733,630912,2020-09-24,2020,TEX,HOU,4,12,12-4,HOU,9,0,37,45,82,165,147,312,10,18,28,2,3:11
15734,631640,2020-09-24,2020,BOS,BAL,1,13,13-1,BAL,9,0,33,47,80,176,118,294,10,21,31,1,3:14
15735,631398,2020-09-24,2020,KCA,DET,8,7,8-7,KCA,9,1,37,44,81,180,135,315,15,18,33,6,3:22
15736,630975,2020-09-24,2020,SLN,MIL,4,2,4-2,SLN,9,1,39,38,77,180,166,346,15,12,27,4,3:43
15737,631012,2020-09-24,2020,SFN,COL,4,5,5-4,COL,11,0,46,48,94,201,156,357,17,16,33,4,4:13
15738,631013,2020-09-25,2020,SFN,SDN,5,4,5-4,SFN,7,1,27,32,59,120,117,237,10,11,21,3,2:27
15739,631059,2020-09-25,2020,SDN,SFN,6,5,6-5,SDN,7,0,28,29,57,119,108,227,9,7,16,3,2:37
15740,630270,2020-09-25,2020,ARI,COL,4,0,4-0,ARI,7,1,31,29,60,105,127,232,15,9,24,2,2:36
15741,630963,2020-09-25,2020,SLN,MIL,0,3,3-0,MIL,7,0,24,29,53,121,103,224,6,10,16,1,2:12
15742,631292,2020-09-25,2020,MIL,SLN,1,9,9-1,SLN,7,0,26,35,61,153,120,273,5,14,19,3,2:36
15743,631059,2020-09-25,2020,SDN,SFN,6,5,6-5,SDN,7,0,28,29,57,119,108,227,9,7,16,3,2:37
15744,631292,2020-09-25,2020,MIL,SLN,1,9,9-1,SLN,7,0,26,35,61,153,120,273,5,14,19,3,2:36
15745,630889,2020-09-25,2020,TOR,BAL,10,5,10-5,TOR,9,1,40,37,77,134,145,279,18,10,28,4,2:41
15746,631383,2020-09-25,2020,KCA,DET,3,2,3-2,KCA,9,1,35,34,69,139,134,273,12,9,21,1,2:50
15747,630203,2020-09-25,2020,ARI,COL,11,5,11-5,ARI,7,1,40,31,71,122,158,280,21,12,33,2,2:58
15748,631486,2020-09-25,2020,CHA,CHN,0,10,10-0,CHN,9,0,31,42,73,168,117,285,4,16,20,2,3:04
15749,631167,2020-09-25,2020,OAK,SEA,3,1,3-1,OAK,10,0,40,35,75,123,162,285,15,6,21,0,3:08
15750,631536,2020-09-25,2020,CLE,PIT,4,3,4-3,CLE,9,0,38,36,74,148,162,310,14,11,25,1,3:18
15751,630203,2020-09-25,2020,ARI,COL,11,5,11-5,ARI,7,1,40,31,71,122,158,280,21,12,33,2,2:58
15752,630938,2020-09-25,2020,TBA,PHI,6,4,6-4,TBA,9,1,38,36,74,150,162,312,14,10,24,2,3:08
15753,630913,2020-09-25,2020,TEX,HOU,5,4,5-4,TEX,10,0,40,42,82,152,146,298,10,13,23,2,3:15
15754,631191,2020-09-25,2020,NYA,MIA,3,4,4-3,MIA,10,0,37,40,77,167,142,309,12,6,18,1,3:20
15755,631336,2020-09-25,2020,LAN,ANA,9,5,9-5,LAN,9,1,41,38,79,165,163,328,17,12,29,6,3:42
15756,631246,2020-09-25,2020,MIN,CIN,2,7,7-2,CIN,9,0,40,40,80,151,185,336,13,13,26,4,3:38
15757,630569,2020-09-25,2020,ATL,BOS,8,7,8-7,ATL,11,0,53,47,100,144,200,344,24,16,40,1,3:59
15758,631055,2020-09-26,2020,SEA,OAK,12,3,12-3,SEA,7,1,35,30,65,105,124,229,17,11,28,1,2:15
15759,630894,2020-09-26,2020,WAS,NYN,5,3,5-3,WAS,7,1,32,29,61,118,124,242,13,8,21,1,2:35
15760,631055,2020-09-26,2020,SEA,OAK,12,3,12-3,SEA,7,1,35,30,65,105,124,229,17,11,28,1,2:15
15761,630894,2020-09-26,2020,WAS,NYN,5,3,5-3,WAS,7,1,32,29,61,118,124,242,13,8,21,1,2:35
15762,631169,2020-09-26,2020,OAK,SEA,1,5,5-1,SEA,8,0,30,32,62,120,122,242,10,9,19,2,2:39
15763,630895,2020-09-26,2020,WAS,NYN,4,3,4-3,WAS,7,1,27,30,57,124,135,259,9,9,18,1,2:39
15764,630964,2020-09-26,2020,SLN,MIL,0,3,3-0,MIL,9,0,30,38,68,116,129,245,3,12,15,2,2:38
15765,630891,2020-09-26,2020,TOR,BAL,5,2,5-2,TOR,9,1,33,35,68,133,151,284,7,9,16,3,2:58
15766,630939,2020-09-26,2020,TBA,PHI,4,3,4-3,TBA,9,1,34,38,72,129,133,262,13,13,26,2,2:53
15767,631016,2020-09-26,2020,SFN,SDN,2,6,6-2,SDN,9,0,36,37,73,137,145,282,10,10,20,3,2:47
15768,630914,2020-09-26,2020,TEX,HOU,6,1,6-1,TEX,9,1,37,35,72,124,143,267,14,9,23,1,2:44
15769,630271,2020-09-26,2020,ARI,COL,3,10,10-3,COL,9,0,36,43,79,180,110,290,7,15,22,0,3:03
15770,631385,2020-09-26,2020,KCA,DET,3,4,4-3,DET,9,0,37,35,72,140,137,277,11,12,23,1,3:00
15771,631245,2020-09-26,2020,MIN,CIN,7,3,7-3,MIN,9,1,34,37,71,156,137,293,12,11,23,2,3:06
15772,631537,2020-09-26,2020,CLE,PIT,0,8,8-0,PIT,9,0,33,41,74,156,146,302,7,14,21,0,2:56
15773,630570,2020-09-26,2020,ATL,BOS,2,8,8-2,BOS,9,0,36,42,78,175,149,324,10,14,24,3,3:22
15774,631337,2020-09-26,2020,LAN,ANA,7,6,7-6,LAN,9,1,36,40,76,150,163,313,12,13,25,1,3:19 (:25 delay)
15775,631193,2020-09-26,2020,NYA,MIA,11,4,11-4,NYA,9,1,41,41,82,153,167,320,18,13,31,3,3:20
15776,631487,2020-09-26,2020,CHA,CHN,9,5,9-5,CHA,9,1,40,36,76,135,168,303,17,10,27,2,3:20
15777,631386,2020-09-27,2020,KCA,DET,3,1,3-1,KCA,9,1,31,30,61,125,139,264,7,4,11,1,2:27 (1:35 delay)
15778,631338,2020-09-27,2020,LAN,ANA,5,0,5-0,LAN,9,1,34,31,65,122,142,264,10,6,16,2,2:54
15779,630202,2020-09-27,2020,ARI,COL,11,3,11-3,ARI,9,1,42,35,77,115,149,264,21,7,28,3,2:54
15780,631538,2020-09-27,2020,CLE,PIT,8,6,8-6,CLE,9,1,37,40,77,129,136,265,15,14,29,3,3:00
15781,630965,2020-09-27,2020,SLN,MIL,5,2,5-2,SLN,9,1,32,37,69,157,137,294,9,11,20,3,2:58
15782,631188,2020-09-27,2020,NYA,MIA,0,5,5-0,MIA,9,0,35,40,75,157,138,295,10,14,24,2,3:05
15783,630945,2020-09-27,2020,TBA,PHI,5,0,5-0,TBA,9,1,37,33,70,131,160,291,14,7,21,3,2:59
15784,630858,2020-09-27,2020,TOR,BAL,5,7,7-5,BAL,9,0,38,40,78,160,144,304,10,14,24,1,2:52
15785,631002,2020-09-27,2020,SFN,SDN,4,5,5-4,SDN,9,0,37,40,77,166,151,317,11,12,23,7,3:22
15786,631155,2020-09-27,2020,OAK,SEA,6,2,6-2,OAK,9,1,41,35,76,155,167,322,18,7,25,1,3:06
15787,630573,2020-09-27,2020,ATL,BOS,1,9,9-1,BOS,9,0,38,47,85,186,153,339,11,20,31,0,3:23
15788,631488,2020-09-27,2020,CHA,CHN,8,10,10-8,CHN,9,0,43,43,86,163,178,341,17,16,33,6,3:37
15789,631244,2020-09-27,2020,MIN,CIN,3,5,5-3,CIN,10,0,38,41,79,182,161,343,9,13,22,7,3:53
15790,630915,2020-09-27,2020,TEX,HOU,8,4,8-4,TEX,9,1,40,40,80,177,167,344,18,13,31,2,3:28
15791,630854,2020-09-27,2020,WAS,NYN,15,5,15-5,WAS,9,1,47,40,87,169,205,374,23,14,37,3,3:35
15792,634532,2021-04-18,2021,BOS,CHA,2,3,3-2,CHA,7,0,26,28,54,93,91,184,8,8,16,2,2:04
15793,633922,2021-05-27,2021,NYN,COL,1,0,1-0,NYN,7,1,21,26,47,102,62,164,4,5,9,0,1:54
15794,634465,2021-05-20,2021,ANA,MIN,7,1,7-1,ANA,7,1,29,25,54,80,107,187,12,5,17,0,1:55
15795,634561,2021-04-17,2021,COL,NYN,7,2,7-2,COL,7,1,29,25,54,87,107,194,11,4,15,0,2:11
15796,634222,2021-07-17,2021,DET,MIN,1,0,1-0,DET,7,1,25,23,48,85,100,185,7,2,9,1,1:55
15797,634465,2021-05-20,2021,ANA,MIN,7,1,7-1,ANA,7,1,29,25,54,80,107,187,12,5,17,0,1:55
15798,634040,2021-05-28,2021,BOS,MIA,5,2,5-2,BOS,6,1,23,25,48,95,90,185,7,8,15,1,2:07 (1:25 delay)
15799,634595,2021-04-07,2021,WAS,ATL,0,2,2-0,ATL,7,0,25,27,52,113,105,218,6,6,12,0,2:08
15800,634595,2021-04-07,2021,WAS,ATL,0,2,2-0,ATL,7,0,25,27,52,113,105,218,6,6,12,0,2:08
15801,634561,2021-04-17,2021,COL,NYN,7,2,7-2,COL,7,1,29,25,54,87,107,194,11,4,15,0,2:11
15802,634434,2021-04-23,2021,MIN,PIT,2,0,2-0,MIN,9,1,28,31,59,123,92,215,5,4,9,2,2:17
15803,634466,2021-04-20,2021,OAK,MIN,1,0,1-0,OAK,7,1,22,25,47,103,102,205,6,4,10,1,2:08 (:25 delay)
15804,634477,2021-04-17,2021,KCA,TOR,1,5,5-1,TOR,7,0,25,29,54,129,94,223,6,8,14,1,2:10
15805,634380,2021-04-25,2021,ATL,ARI,0,7,7-0,ARI,7,0,21,33,54,129,98,227,0,12,12,1,2:11
15806,634472,2021-04-15,2021,BAL,SEA,1,2,2-1,SEA,7,0,26,29,55,119,92,211,6,10,16,1,2:01
15807,634518,2021-04-18,2021,BOS,CHA,1,5,5-1,CHA,7,0,26,32,58,116,98,214,5,13,18,3,2:24
15808,634466,2021-04-20,2021,OAK,MIN,1,0,1-0,OAK,7,1,22,25,47,103,102,205,6,4,10,1,2:08 (:25 delay)
15809,634423,2021-04-21,2021,DET,PIT,5,2,5-2,DET,7,1,25,26,51,86,88,174,9,5,14,1,1:55
15810,634468,2021-04-18,2021,COL,NYN,1,2,2-1,NYN,9,0,30,34,64,119,100,219,5,7,12,0,2:38
15811,634520,2021-04-17,2021,KCA,TOR,3,2,3-2,KCA,7,0,30,27,57,95,106,201,9,6,15,4,2:21
15812,632226,2021-04-13,2021,NYN,PHI,4,0,4-0,NYN,7,1,30,25,55,99,124,223,12,6,18,0,2:30
15813,632226,2021-04-13,2021,NYN,PHI,4,0,4-0,NYN,7,1,30,25,55,99,124,223,12,6,18,0,2:30
15814,634518,2021-04-18,2021,BOS,CHA,1,5,5-1,CHA,7,0,26,32,58,116,98,214,5,13,18,3,2:24
15815,634485,2021-04-17,2021,COL,NYN,3,4,4-3,NYN,7,0,26,32,58,117,112,229,4,12,16,0,2:27
15816,632201,2021-04-10,2021,NYN,MIA,0,3,3-0,MIA,9,0,31,35,66,113,112,225,5,9,14,1,2:36
15817,633974,2021-05-27,2021,NYA,TOR,0,2,2-0,TOR,7,0,25,28,53,123,96,219,4,7,11,1,2:11
15818,633910,2021-05-27,2021,NYA,TOR,5,3,5-3,NYA,7,1,26,28,54,115,96,211,9,10,19,3,2:16
15819,633935,2021-05-30,2021,CLE,TOR,1,4,4-1,TOR,7,0,26,31,57,102,97,199,5,12,17,1,2:05
15820,632213,2021-04-13,2021,BAL,SEA,3,4,4-3,SEA,8,0,30,32,62,132,109,241,8,9,17,1,2:26
15821,634390,2021-04-21,2021,DET,PIT,2,3,3-2,PIT,7,0,26,31,57,122,117,239,5,11,16,0,2:16
15822,634533,2021-04-09,2021,LAN,WAS,1,0,1-0,LAN,9,1,29,34,63,125,104,229,6,10,16,0,2:31
15823,634490,2021-04-20,2021,OAK,MIN,7,0,7-0,OAK,7,1,31,28,59,95,128,223,12,7,19,1,2:15
15824,634520,2021-04-17,2021,KCA,TOR,3,2,3-2,KCA,7,0,30,27,57,95,106,201,9,6,15,4,2:21
15825,632214,2021-04-11,2021,LAN,WAS,3,0,3-0,LAN,9,1,29,34,63,124,119,243,6,7,13,0,2:29
15826,634498,2021-04-18,2021,PHI,SLN,2,0,2-0,PHI,9,1,35,30,65,109,130,239,13,2,15,0,2:34
15827,634263,2021-05-07,2021,OAK,TBA,2,1,2-1,OAK,9,0,34,31,65,100,127,227,10,4,14,2,2:28
15828,634156,2021-05-11,2021,HOU,ANA,5,1,5-1,HOU,9,1,35,30,65,108,122,230,11,5,16,2,2:33
15829,634042,2021-05-30,2021,CLE,TOR,6,5,6-5,CLE,7,0,30,29,59,112,107,219,11,10,21,3,2:08
15830,634647,2021-06-19,2021,WAS,NYN,1,5,5-1,NYN,7,0,32,29,61,84,157,241,12,8,20,2,2:47
15831,634580,2021-04-03,2021,PHI,ATL,4,0,4-0,PHI,9,1,36,28,64,113,144,257,15,1,16,1,2:30
15832,634655,2021-04-01,2021,ANA,CHA,4,3,4-3,ANA,9,1,34,35,69,125,140,265,10,9,19,2,2:51
15833,634380,2021-04-25,2021,ATL,ARI,0,7,7-0,ARI,7,0,21,33,54,129,98,227,0,12,12,1,2:11
15834,633910,2021-05-27,2021,NYA,TOR,5,3,5-3,NYA,7,1,26,28,54,115,96,211,9,10,19,3,2:16
15835,634472,2021-04-15,2021,BAL,SEA,1,2,2-1,SEA,7,0,26,29,55,119,92,211,6,10,16,1,2:01
15836,634478,2021-04-09,2021,TEX,SDN,0,3,3-0,SDN,9,0,28,35,63,141,112,253,1,10,11,0,2:46
15837,634166,2021-05-14,2021,CHA,KCA,3,1,3-1,CHA,7,1,30,27,57,101,130,231,11,6,17,2,2:30
15838,634525,2021-04-16,2021,OAK,DET,3,0,3-0,OAK,9,1,34,31,65,146,107,253,10,5,15,0,2:31
15839,634575,2021-04-03,2021,MIL,MIN,0,2,2-0,MIN,9,0,30,32,62,129,127,256,3,5,8,1,2:46
15840,633986,2021-05-26,2021,DET,CLE,1,0,1-0,DET,9,1,29,33,62,133,115,248,6,10,16,1,2:39
15841,633899,2021-06-21,2021,NYN,ATL,0,1,1-0,ATL,7,0,26,28,54,120,112,232,7,7,14,1,2:33
15842,633887,2021-05-29,2021,CHA,BAL,3,1,3-1,CHA,7,1,26,29,55,127,98,225,8,7,15,1,2:12
15843,634031,2021-05-19,2021,SDN,COL,3,0,3-0,SDN,9,1,32,29,61,119,117,236,8,2,10,1,2:52
15844,634617,2021-04-04,2021,PHI,ATL,2,1,2-1,PHI,9,1,34,32,66,113,135,248,12,7,19,1,2:40
15845,634497,2021-04-21,2021,MIA,BAL,3,0,3-0,MIA,9,1,34,31,65,99,145,244,12,5,17,2,2:42
15846,634057,2021-05-17,2021,SDN,COL,7,0,7-0,SDN,9,1,37,31,68,99,141,240,14,4,18,1,2:55
15847,634206,2021-05-14,2021,DET,CHN,2,4,4-2,CHN,9,0,29,37,66,137,107,244,5,13,18,0,2:31
15848,634107,2021-05-18,2021,ATL,NYN,3,4,4-3,NYN,9,0,34,34,68,109,133,242,8,9,17,1,2:36
15849,633969,2021-05-25,2021,MIA,PHI,0,2,2-0,PHI,9,0,33,29,62,106,136,242,9,3,12,0,2:49
15850,634598,2021-04-07,2021,DET,MIN,2,3,3-2,MIN,9,0,33,33,66,118,120,238,9,8,17,0,2:46
15851,632204,2021-04-12,2021,TBA,TEX,1,0,1-0,TBA,9,1,31,31,62,126,127,253,8,5,13,1,2:42
15852,634529,2021-04-06,2021,SDN,SFN,3,1,3-1,SDN,9,1,31,30,61,133,124,257,10,4,14,1,2:53
15853,634616,2021-04-05,2021,CLE,KCA,0,3,3-0,KCA,9,0,32,38,70,133,133,266,7,13,20,1,2:52
15854,632224,2021-04-13,2021,BAL,SEA,7,6,7-6,BAL,7,0,34,31,65,115,134,249,13,10,23,2,2:38
15855,634409,2021-04-20,2021,BOS,TOR,4,2,4-2,BOS,9,1,33,33,66,133,121,254,9,6,15,2,2:42
15856,634656,2021-05-14,2021,CHA,KCA,2,6,6-2,KCA,7,0,28,32,60,131,122,253,9,11,20,0,2:28
15857,634357,2021-04-29,2021,CHA,DET,11,0,11-0,CHA,7,1,37,24,61,91,154,245,19,3,22,2,2:42 (1:06 delay)
15858,634429,2021-04-23,2021,NYN,WAS,6,0,6-0,NYN,9,1,38,29,67,109,145,254,15,2,17,0,2:37
15859,634175,2021-05-09,2021,ATL,PHI,6,1,6-1,ATL,9,1,32,34,66,138,121,259,11,8,19,0,2:44
15860,633934,2021-05-27,2021,SEA,TEX,5,0,5-0,SEA,9,1,33,33,66,121,131,252,11,7,18,1,2:35
15861,634176,2021-05-10,2021,BAL,BOS,4,1,4-1,BAL,9,1,34,32,66,113,131,244,11,5,16,2,2:45
15862,634043,2021-05-18,2021,KCA,MIL,2,0,2-0,KCA,9,1,32,31,63,132,107,239,8,5,13,2,2:48 (:21 delay)
15863,632223,2021-04-14,2021,MIN,BOS,1,7,7-1,BOS,7,0,28,32,60,133,110,243,8,13,21,2,2:31
15864,634390,2021-04-21,2021,DET,PIT,2,3,3-2,PIT,7,0,26,31,57,122,117,239,5,11,16,0,2:16
15865,634648,2021-04-12,2021,SFN,CIN,0,3,3-0,CIN,9,0,31,35,66,129,138,267,5,8,13,2,2:35
15866,634607,2021-04-04,2021,NYA,TOR,1,3,3-1,TOR,9,0,33,36,69,136,141,277,7,7,14,1,2:41
15867,634641,2021-04-07,2021,BOS,TBA,9,2,9-2,BOS,9,1,37,35,72,121,134,255,15,9,24,0,2:51
15868,634505,2021-04-09,2021,CLE,DET,4,1,4-1,CLE,9,1,32,31,63,132,136,268,7,5,12,1,2:40
15869,634463,2021-04-16,2021,TEX,BAL,2,5,5-2,BAL,9,0,34,35,69,134,133,267,6,8,14,1,2:32
15870,634344,2021-04-25,2021,NYN,WAS,4,0,4-0,NYN,9,1,34,34,68,125,131,256,13,9,22,1,2:42
15871,634066,2021-05-19,2021,ATL,NYN,5,4,5-4,ATL,9,0,37,33,70,127,120,247,16,5,21,3,2:50
15872,634519,2021-04-16,2021,MIA,SFN,4,1,4-1,MIA,9,1,32,34,66,133,115,248,8,8,16,1,2:44
15873,634565,2021-04-08,2021,CHA,KCA,6,0,6-0,CHA,9,1,38,32,70,111,153,264,16,5,21,2,2:48 (2:12 delay)
15874,634381,2021-04-30,2021,OAK,BAL,2,3,3-2,BAL,9,0,35,35,70,120,136,256,8,10,18,1,2:40
15875,634516,2021-04-14,2021,CHA,CLE,8,0,8-0,CHA,9,1,41,28,69,114,148,262,17,1,18,2,2:40
15876,634656,2021-05-14,2021,CHA,KCA,2,6,6-2,KCA,7,0,28,32,60,131,122,253,9,11,20,0,2:28
15877,634652,2021-04-01,2021,MIA,TBA,0,1,1-0,TBA,9,0,31,36,67,138,121,259,4,9,13,1,2:44
15878,632223,2021-04-14,2021,MIN,BOS,1,7,7-1,BOS,7,0,28,32,60,133,110,243,8,13,21,2,2:31
15879,634515,2021-06-25,2021,NYN,PHI,1,2,2-1,PHI,8,0,31,29,60,107,118,225,8,6,14,0,2:32
15880,634432,2021-04-22,2021,SFN,MIA,3,0,3-0,SFN,9,1,30,29,59,124,116,240,7,4,11,0,2:26
15881,634587,2021-04-05,2021,NYA,BAL,7,0,7-0,NYA,9,1,38,33,71,120,153,273,14,6,20,2,2:58
15882,634566,2021-04-05,2021,CHN,MIL,5,3,5-3,CHN,9,1,33,33,66,135,131,266,10,7,17,3,2:49
15883,634623,2021-04-03,2021,SDN,ARI,7,0,7-0,SDN,9,1,42,30,72,116,169,285,17,4,21,0,2:58
15884,634557,2021-04-04,2021,COL,LAN,2,4,4-2,LAN,9,0,33,38,71,162,106,268,6,13,19,1,2:51
15885,632210,2021-04-13,2021,KCA,ANA,3,2,3-2,KCA,9,1,31,40,71,161,112,273,7,14,21,1,2:57
15886,634355,2021-04-25,2021,BOS,SEA,5,3,5-3,BOS,9,1,34,33,67,126,144,270,13,7,20,1,2:44 (:07 delay)
15887,634513,2021-04-14,2021,TOR,NYA,5,4,5-4,TOR,9,0,38,34,72,122,143,265,16,9,25,0,2:54
15888,634564,2021-04-08,2021,COL,ARI,7,3,7-3,COL,9,1,35,37,72,140,120,260,10,11,21,2,2:51
15889,634276,2021-05-01,2021,PHI,NYN,4,5,5-4,NYN,9,0,36,35,71,117,133,250,10,10,20,0,2:56
15890,634527,2021-04-07,2021,WAS,ATL,6,7,7-6,ATL,7,0,34,33,67,122,129,251,14,14,28,1,2:49
15891,634458,2021-04-18,2021,NYA,TBA,2,4,4-2,TBA,9,0,34,34,68,143,140,283,7,8,15,4,2:56
15892,634441,2021-05-20,2021,ANA,MIN,3,6,6-3,MIN,7,0,26,35,61,150,120,270,5,14,19,1,2:49
15893,634509,2021-04-20,2021,WAS,SLN,3,2,3-2,WAS,9,1,35,33,68,131,129,260,13,7,20,1,2:51
15894,634589,2021-04-07,2021,CLE,KCA,4,2,4-2,CLE,9,1,34,35,69,139,137,276,11,8,19,2,2:53
15895,634480,2021-04-18,2021,OAK,DET,3,2,3-2,OAK,9,0,34,36,70,137,125,262,10,9,19,1,2:42
15896,634611,2021-04-04,2021,DET,CLE,3,9,9-3,CLE,9,0,30,39,69,144,119,263,5,13,18,1,2:38
15897,634417,2021-04-20,2021,SEA,LAN,0,1,1-0,LAN,9,0,30,32,62,130,112,242,3,6,9,0,2:28
15898,634571,2021-04-15,2021,BAL,SEA,2,4,4-2,SEA,7,0,26,30,56,141,103,244,6,8,14,2,2:23
15899,634627,2021-04-02,2021,BOS,BAL,0,3,3-0,BAL,9,0,31,36,67,164,136,300,4,11,15,2,3:10
15900,634645,2021-04-01,2021,DET,CLE,3,2,3-2,DET,9,1,35,38,73,154,125,279,10,12,22,2,3:03
15901,634586,2021-04-06,2021,ANA,HOU,2,4,4-2,HOU,9,0,33,36,69,150,125,275,8,9,17,0,2:47
15902,634593,2021-04-04,2021,KCA,TEX,3,7,7-3,TEX,9,0,36,39,75,143,130,273,8,13,21,2,2:53
15903,634489,2021-04-13,2021,TBA,TEX,3,8,8-3,TEX,9,0,36,41,77,142,120,262,10,15,25,0,2:43
15904,634340,2021-05-02,2021,SEA,ANA,2,0,2-0,SEA,9,1,33,35,68,138,139,277,9,10,19,1,3:05
15905,634033,2021-05-19,2021,LAN,ARI,4,2,4-2,LAN,9,1,35,32,67,119,150,269,11,5,16,3,2:56
15906,634474,2021-04-16,2021,PHI,SLN,9,2,9-2,PHI,9,1,38,32,70,120,147,267,16,6,22,2,2:34
15907,633929,2021-05-29,2021,OAK,ANA,0,4,4-0,ANA,9,0,29,38,67,148,125,273,5,11,16,2,2:57
15908,634524,2021-04-10,2021,ATL,PHI,5,4,5-4,ATL,9,1,35,35,70,146,113,259,11,8,19,2,2:50
15909,634406,2021-04-20,2021,COL,HOU,6,2,6-2,COL,9,1,34,35,69,132,133,265,13,9,22,4,3:08
15910,633947,2021-05-29,2021,SEA,TEX,3,2,3-2,SEA,9,1,31,34,65,151,112,263,8,7,15,1,2:43
15911,634415,2021-04-23,2021,ATL,ARI,5,4,5-4,ATL,9,1,35,35,70,136,133,269,12,8,20,2,2:47
15912,633996,2021-05-23,2021,SDN,SEA,9,2,9-2,SDN,9,1,38,35,73,123,133,256,13,10,23,1,2:55
15913,634469,2021-04-16,2021,WAS,ARI,1,0,1-0,WAS,9,0,31,32,63,137,124,261,7,5,12,0,2:54
15914,634239,2021-05-05,2021,SLN,NYN,2,7,7-2,NYN,7,0,33,34,67,112,108,220,13,13,26,3,2:40
15915,634399,2021-04-19,2021,SDN,MIL,1,3,3-1,MIL,9,0,32,34,66,127,130,257,7,7,14,0,2:49
15916,634646,2021-04-03,2021,ANA,CHA,5,3,5-3,ANA,9,1,35,39,74,144,144,288,11,13,24,2,3:04
15917,634530,2021-04-06,2021,CIN,PIT,14,1,14-1,CIN,9,1,43,33,76,113,151,264,20,6,26,2,2:35
15918,634573,2021-04-03,2021,DET,CLE,5,2,5-2,DET,9,1,39,36,75,145,154,299,15,11,26,2,3:17
15919,634542,2021-04-07,2021,COL,ARI,8,0,8-0,COL,9,1,39,33,72,111,149,260,15,7,22,0,2:57
15920,634405,2021-04-21,2021,WAS,SLN,1,0,1-0,WAS,9,1,30,36,66,168,123,291,6,11,17,0,3:01
15921,634487,2021-04-18,2021,CIN,CLE,3,6,6-3,CLE,9,0,37,36,73,147,123,270,9,10,19,1,2:42
15922,634268,2021-05-02,2021,TEX,BOS,5,3,5-3,TEX,9,1,36,35,71,116,149,265,12,11,23,1,2:57
15923,634486,2021-04-24,2021,CLE,NYA,1,2,2-1,NYA,9,0,31,36,67,160,141,301,4,9,13,1,3:05
15924,634398,2021-04-20,2021,ANA,TEX,6,2,6-2,ANA,9,1,34,38,72,150,133,283,11,13,24,2,2:52
15925,634479,2021-04-17,2021,OAK,DET,7,0,7-0,OAK,9,1,36,33,69,135,153,288,14,6,20,1,2:49
15926,634202,2021-05-11,2021,BOS,OAK,2,3,3-2,OAK,9,0,33,36,69,161,119,280,6,10,16,1,3:01
15927,634316,2021-05-01,2021,SDN,SFN,6,2,6-2,SDN,9,1,33,35,68,143,129,272,12,9,21,2,2:56
15928,634136,2021-05-13,2021,ARI,MIA,1,5,5-1,MIA,9,0,35,39,74,127,131,258,8,14,22,1,2:55
15929,634396,2021-04-19,2021,KCA,TBA,1,4,4-1,TBA,9,0,32,39,71,162,118,280,6,11,17,2,3:00
15930,633997,2021-05-28,2021,SEA,TEX,3,2,3-2,SEA,9,1,30,36,66,153,119,272,8,13,21,1,2:46
15931,632208,2021-08-10,2021,TOR,ANA,3,6,6-3,ANA,7,0,31,35,66,144,111,255,12,14,26,2,2:43
15932,634583,2021-04-07,2021,TEX,TOR,2,1,2-1,TEX,9,1,33,36,69,132,102,234,9,10,19,1,2:33
15933,634452,2021-05-31,2021,CLE,CHA,3,1,3-1,CLE,7,1,26,28,54,122,99,221,8,8,16,3,2:21
15934,634447,2021-04-17,2021,SEA,HOU,0,1,1-0,HOU,9,0,30,36,66,135,99,234,4,11,15,1,2:36
15935,634572,2021-04-04,2021,SDN,ARI,1,3,3-1,ARI,9,0,38,38,76,155,136,291,13,13,26,2,3:19
15936,634620,2021-06-28,2021,WAS,NYN,8,4,8-4,WAS,9,1,38,38,76,155,116,271,16,12,28,3,3:03
15937,634643,2021-04-03,2021,CHN,PIT,5,1,5-1,CHN,9,1,36,33,69,126,160,286,11,7,18,1,3:08
15938,634613,2021-04-04,2021,CHN,PIT,4,3,4-3,CHN,9,1,34,36,70,139,144,283,10,11,21,3,3:09
15939,634599,2021-04-06,2021,NYA,BAL,7,2,7-2,NYA,9,1,39,34,73,131,158,289,16,7,23,1,2:58
15940,634475,2021-04-15,2021,KCA,TOR,7,5,7-5,KCA,9,1,34,39,73,145,126,271,10,13,23,3,2:51
15941,632212,2021-04-13,2021,LAN,COL,7,0,7-0,LAN,9,1,39,30,69,123,169,292,14,4,18,1,3:08
15942,634157,2021-05-10,2021,ARI,MIA,5,2,5-2,ARI,9,1,35,34,69,121,142,263,12,8,20,2,2:47
15943,634496,2021-04-14,2021,TBA,TEX,1,5,5-1,TEX,9,0,34,38,72,149,140,289,8,15,23,3,2:58
15944,632202,2021-04-10,2021,HOU,OAK,3,7,7-3,OAK,9,0,36,39,75,146,145,291,11,13,24,2,3:14
15945,634639,2021-04-03,2021,SEA,SFN,4,0,4-0,SEA,9,1,34,35,69,157,127,284,11,9,20,2,2:59
15946,634091,2021-05-17,2021,LAN,ARI,3,1,3-1,LAN,9,1,36,36,72,133,143,276,14,10,24,1,3:05
15947,634153,2021-05-10,2021,SFN,TEX,3,1,3-1,SFN,9,1,35,34,69,121,156,277,10,9,19,1,2:47
15948,634553,2021-04-14,2021,MIL,CHN,7,0,7-0,MIL,9,1,39,34,73,122,162,284,16,6,22,1,3:06
15949,633942,2021-05-30,2021,HOU,SDN,7,4,7-4,HOU,9,1,33,36,69,131,140,271,9,11,20,0,2:47
15950,634169,2021-05-11,2021,TBA,NYA,1,3,3-1,NYA,9,0,33,36,69,147,136,283,6,11,17,0,2:50
15951,632233,2021-04-11,2021,TEX,SDN,0,2,2-0,SDN,9,0,37,35,72,123,150,273,11,8,19,2,3:16
15952,634012,2021-05-21,2021,WAS,BAL,4,2,4-2,WAS,9,1,40,33,73,123,139,262,17,8,25,1,2:56
15953,634102,2021-05-18,2021,ANA,CLE,5,6,6-5,CLE,9,0,35,38,73,147,129,276,10,11,21,1,2:48
15954,634574,2021-04-14,2021,MIN,BOS,2,3,3-2,BOS,7,0,28,36,64,132,107,239,7,14,21,1,2:40
15955,632225,2021-04-11,2021,PIT,CHN,7,1,7-1,PIT,9,1,42,34,76,123,140,263,18,8,26,3,3:02
15956,634042,2021-05-30,2021,CLE,TOR,6,5,6-5,CLE,7,0,30,29,59,112,107,219,11,10,21,3,2:08
15957,634138,2021-05-14,2021,BOS,ANA,4,3,4-3,BOS,9,1,33,33,66,136,134,270,11,6,17,1,2:45
15958,634570,2021-04-07,2021,CIN,PIT,11,4,11-4,CIN,9,1,38,35,73,116,133,249,16,9,25,0,2:35
15959,633912,2021-05-27,2021,NYN,COL,4,2,4-2,NYN,7,1,28,30,58,124,113,237,12,10,22,3,2:48
15960,634313,2021-05-04,2021,SDN,PIT,1,2,2-1,PIT,9,0,34,37,71,113,138,251,7,12,19,1,2:59
15961,634528,2021-04-14,2021,NYN,PHI,5,1,5-1,NYN,9,1,39,31,70,117,135,252,16,5,21,3,2:50
15962,634059,2021-05-20,2021,LAN,ARI,3,2,3-2,LAN,9,1,30,34,64,147,115,262,8,8,16,1,2:54
15963,632217,2021-04-10,2021,TBA,NYA,4,0,4-0,TBA,9,1,39,33,72,126,155,281,14,7,21,1,3:04
15964,634560,2021-04-04,2021,CIN,SLN,12,1,12-1,CIN,9,1,40,33,73,144,153,297,14,8,22,2,3:00
15965,634577,2021-04-03,2021,BOS,BAL,2,4,4-2,BAL,9,0,37,36,73,136,152,288,10,9,19,1,2:51
15966,634559,2021-04-06,2021,CHN,MIL,0,4,4-0,MIL,9,0,31,36,67,149,145,294,7,10,17,0,3:06
15967,632198,2021-04-12,2021,PIT,SDN,2,6,6-2,SDN,9,0,34,41,75,165,126,291,7,14,21,1,3:04 (:20 delay)
15968,634602,2021-04-02,2021,MIA,TBA,4,6,6-4,TBA,9,0,39,36,75,143,140,283,13,11,24,2,3:22
15969,632199,2021-04-13,2021,CHA,CLE,0,2,2-0,CLE,10,0,34,38,72,154,129,283,5,7,12,2,3:02
15970,634578,2021-04-02,2021,SEA,SFN,3,6,6-3,SFN,9,0,35,39,74,149,152,301,10,12,22,2,3:16
15971,634555,2021-04-08,2021,PIT,CHN,2,4,4-2,CHN,9,0,39,36,75,122,144,266,13,12,25,5,3:15
15972,634534,2021-04-09,2021,ATL,PHI,8,1,8-1,ATL,9,1,40,34,74,127,161,288,17,8,25,1,3:03
15973,634422,2021-04-20,2021,NYA,ATL,3,1,3-1,NYA,9,1,34,36,70,152,135,287,11,11,22,3,3:06
15974,634473,2021-04-17,2021,MIL,PIT,7,1,7-1,MIL,9,1,36,36,72,130,146,276,13,8,21,0,2:42
15975,634546,2021-04-08,2021,HOU,OAK,6,2,6-2,HOU,9,1,34,37,71,160,124,284,9,10,19,3,3:10
15976,634420,2021-04-22,2021,LAN,SDN,2,3,3-2,SDN,9,0,37,33,70,126,154,280,12,7,19,3,3:02
15977,634358,2021-04-24,2021,TBA,TOR,5,3,5-3,TBA,9,1,34,39,73,161,125,286,8,13,21,2,3:10
15978,633965,2021-05-25,2021,WAS,CIN,1,2,2-1,CIN,9,0,32,33,65,143,146,289,6,9,15,2,2:52
15979,634499,2021-04-09,2021,TBA,NYA,10,5,10-5,TBA,9,1,40,34,74,128,159,287,17,8,25,1,2:53
15980,634058,2021-05-18,2021,CIN,SFN,2,4,4-2,SFN,9,0,36,39,75,157,129,286,10,13,23,1,2:52
15981,634568,2021-04-08,2021,SLN,MIL,3,1,3-1,SLN,9,1,32,37,69,153,138,291,9,10,19,0,3:05
15982,634543,2021-04-17,2021,TEX,BAL,1,6,6-1,BAL,9,0,35,41,76,134,146,280,10,13,23,3,3:05
15983,634606,2021-04-05,2021,PHI,NYN,5,3,5-3,PHI,9,1,34,40,74,164,120,284,11,14,25,2,3:15
15984,633870,2021-05-31,2021,CHN,SDN,7,2,7-2,CHN,9,1,35,34,69,121,155,276,12,8,20,2,2:53
15985,634023,2021-05-25,2021,NYN,COL,3,1,3-1,NYN,9,1,36,33,69,131,153,284,15,6,21,1,3:04
15986,634424,2021-04-21,2021,COL,HOU,6,3,6-3,COL,9,1,38,34,72,113,143,256,15,7,22,0,2:34
15987,634492,2021-04-22,2021,DET,PIT,2,4,4-2,PIT,9,0,36,37,73,137,135,272,9,11,20,3,2:54
15988,634047,2021-05-20,2021,TEX,NYA,0,2,2-0,NYA,9,0,33,36,69,138,117,255,7,13,20,1,2:49
15989,634014,2021-05-21,2021,NYA,CHA,2,1,2-1,NYA,9,0,32,34,66,122,140,262,8,8,16,1,2:53
15990,634311,2021-05-02,2021,NYA,DET,2,0,2-0,NYA,9,1,28,30,58,113,117,230,4,3,7,0,2:14
15991,634264,2021-05-04,2021,CHN,LAN,7,1,7-1,CHN,7,1,28,30,58,92,115,207,10,9,19,0,2:17
15992,633916,2021-05-29,2021,WAS,MIL,1,4,4-1,MIL,7,0,25,26,51,101,100,201,5,6,11,0,2:06
15993,634622,2021-04-01,2021,PHI,ATL,3,2,3-2,PHI,10,0,43,40,83,134,151,285,15,10,25,1,3:33
15994,634640,2021-04-01,2021,OAK,HOU,1,8,8-1,HOU,9,0,35,43,78,152,155,307,10,17,27,3,3:28
15995,634563,2021-04-07,2021,SDN,SFN,2,3,3-2,SFN,10,0,36,40,76,162,129,291,7,11,18,0,3:21
15996,634584,2021-04-08,2021,NYN,MIA,3,2,3-2,NYN,9,0,39,34,73,136,155,291,17,8,25,1,3:18
15997,634403,2021-04-25,2021,HOU,ANA,2,4,4-2,ANA,9,0,34,38,72,153,139,292,9,11,20,2,3:04
15998,634352,2021-04-29,2021,SLN,PHI,4,3,4-3,SLN,10,0,34,39,73,164,113,277,9,11,20,1,3:10
15999,634526,2021-04-16,2021,ANA,MIN,10,3,10-3,ANA,9,1,37,37,74,145,140,285,15,14,29,3,3:08
16000,632189,2021-04-13,2021,NYN,PHI,4,3,4-3,NYN,8,0,35,33,68,146,139,285,14,12,26,1,3:11
16001,634000,2021-05-22,2021,ANA,OAK,2,6,6-2,OAK,9,0,33,40,73,144,114,258,6,15,21,3,3:02
16002,633982,2021-05-24,2021,MIN,BAL,8,3,8-3,MIN,9,1,37,37,74,134,146,280,14,11,25,2,3:09 (:45 delay)
16003,634562,2021-04-05,2021,MIA,SLN,1,4,4-1,SLN,9,0,35,35,70,152,145,297,8,9,17,0,3:09
16004,633966,2021-05-28,2021,CLE,TOR,2,11,11-2,TOR,7,0,24,41,65,184,111,295,6,21,27,2,2:55 (:36 delay)
16005,632221,2021-04-12,2021,MIL,CHN,6,3,6-3,MIL,9,1,37,35,72,141,132,273,15,9,24,3,3:04
16006,634569,2021-04-13,2021,TOR,NYA,7,3,7-3,TOR,9,1,39,34,73,132,155,287,15,10,25,4,3:04
16007,633933,2021-05-30,2021,WAS,MIL,0,3,3-0,MIL,9,0,32,35,67,158,134,292,6,8,14,0,3:01
16008,634142,2021-05-11,2021,LAN,SEA,6,4,6-4,LAN,9,1,36,31,67,121,149,270,12,5,17,2,2:54
16009,634035,2021-05-22,2021,NYA,CHA,7,0,7-0,NYA,9,1,40,32,72,129,160,289,16,8,24,2,3:06
16010,633887,2021-05-29,2021,CHA,BAL,3,1,3-1,CHA,7,1,26,29,55,127,98,225,8,7,15,1,2:12
16011,634582,2021-04-14,2021,SFN,CIN,3,0,3-0,SFN,9,1,31,31,62,106,134,240,9,5,14,1,2:30
16012,634283,2021-05-06,2021,PHI,MIL,2,0,2-0,PHI,9,1,31,29,60,118,128,246,7,3,10,1,2:41
16013,634375,2021-04-24,2021,DET,KCA,1,2,2-1,KCA,9,0,30,30,60,105,118,223,3,3,6,0,2:10
16014,634501,2021-04-15,2021,CHA,CLE,2,4,4-2,CLE,9,0,38,37,75,150,148,298,11,9,20,1,3:17
16015,634558,2021-04-05,2021,CIN,PIT,5,3,5-3,CIN,9,1,38,35,73,147,159,306,13,8,21,1,3:18
16016,634495,2021-04-14,2021,KCA,ANA,6,1,6-1,KCA,9,1,38,37,75,144,143,287,13,9,22,3,3:10
16017,634265,2021-05-04,2021,SEA,BAL,5,2,5-2,SEA,9,1,33,41,74,156,136,292,10,14,24,5,3:15
16018,634544,2021-04-08,2021,BAL,BOS,3,7,7-3,BOS,9,0,34,42,76,165,131,296,6,16,22,4,3:08
16019,634190,2021-05-08,2021,NYN,ARI,4,2,4-2,NYN,9,1,34,40,74,149,144,293,10,11,21,2,3:30
16020,634304,2021-05-01,2021,WAS,MIA,7,2,7-2,WAS,9,1,39,35,74,129,155,284,15,11,26,1,2:59
16021,634341,2021-05-02,2021,MIN,KCA,13,4,13-4,MIN,9,1,42,37,79,148,139,287,19,11,30,2,3:02
16022,634273,2021-05-01,2021,CIN,CHN,2,3,3-2,CHN,9,0,38,36,74,146,139,285,11,11,22,3,3:17
16023,633995,2021-05-23,2021,COL,ARI,4,3,4-3,COL,9,0,38,34,72,132,146,278,13,7,20,2,3:20
16024,634095,2021-05-15,2021,BOS,ANA,9,0,9-0,BOS,9,1,37,36,73,159,136,295,14,11,25,1,2:52
16025,634081,2021-05-22,2021,TOR,TBA,1,3,3-1,TBA,9,0,35,37,72,154,130,284,10,10,20,1,2:51
16026,633993,2021-05-26,2021,BOS,ATL,9,5,9-5,BOS,9,1,36,38,74,147,138,285,10,12,22,3,2:56 (2:53 delay)
16027,632203,2021-04-12,2021,TOR,NYA,1,3,3-1,NYA,9,0,34,33,67,153,144,297,7,9,16,3,3:04
16028,632228,2021-04-11,2021,CLE,DET,5,2,5-2,CLE,9,1,36,35,71,154,136,290,14,10,24,2,3:04
16029,634421,2021-04-19,2021,SEA,LAN,4,3,4-3,SEA,9,1,31,38,69,152,131,283,7,12,19,2,3:11
16030,634076,2021-05-17,2021,CHN,WAS,7,3,7-3,CHN,9,1,34,35,69,128,127,255,12,9,21,3,2:53
16031,634345,2021-04-26,2021,SLN,PHI,1,2,2-1,PHI,9,0,31,31,62,107,125,232,5,6,11,1,2:22
16032,634250,2021-05-05,2021,SLN,NYN,4,1,4-1,SLN,7,1,29,27,56,101,111,212,9,6,15,0,2:28
16033,634629,2021-04-03,2021,OAK,HOU,1,9,9-1,HOU,9,0,35,43,78,172,150,322,9,17,26,2,3:24
16034,634504,2021-04-21,2021,NYA,ATL,1,4,4-1,ATL,9,0,37,40,77,163,143,306,11,14,25,2,3:16
16035,634651,2021-04-04,2021,OAK,HOU,2,9,9-2,HOU,9,0,33,40,73,173,145,318,6,15,21,3,3:15
16036,634500,2021-04-17,2021,NYA,TBA,3,6,6-3,TBA,9,0,37,35,72,139,173,312,9,8,17,3,3:28
16037,634624,2021-04-06,2021,WAS,ATL,6,5,6-5,WAS,9,0,39,37,76,149,154,303,15,10,25,2,3:10
16038,634224,2021-05-06,2021,NYA,HOU,4,7,7-4,HOU,9,0,38,37,75,156,153,309,13,12,25,1,3:14
16039,634126,2021-05-13,2021,TBA,NYA,9,1,9-1,TBA,9,1,40,35,75,138,170,308,15,10,25,2,3:05
16040,634173,2021-08-09,2021,CLE,CIN,9,3,9-3,CLE,9,1,41,38,79,146,153,299,17,12,29,2,3:09
16041,634551,2021-04-05,2021,SEA,CHA,0,6,6-0,CHA,9,0,36,42,78,158,151,309,9,15,24,0,3:23
16042,634612,2021-04-05,2021,TEX,TOR,2,6,6-2,TOR,9,0,35,39,74,160,138,298,8,15,23,3,3:04
16043,634233,2021-05-06,2021,KCA,CLE,0,4,4-0,CLE,9,0,34,37,71,154,152,306,9,12,21,2,3:10
16044,634064,2021-05-26,2021,TBA,KCA,2,1,2-1,TBA,10,0,40,36,76,133,156,289,13,6,19,0,2:55
16045,632169,2021-04-10,2021,SFN,COL,4,3,4-3,SFN,9,1,34,36,70,160,144,304,12,12,24,1,3:13
16046,634096,2021-05-15,2021,LAN,MIA,7,0,7-0,LAN,9,1,38,31,69,143,159,302,15,3,18,3,3:11
16047,633967,2021-05-26,2021,PIT,CHN,1,4,4-1,CHN,9,0,32,40,72,157,120,277,6,15,21,2,2:54 (:26 delay)
16048,634168,2021-05-19,2021,TEX,NYA,0,2,2-0,NYA,9,0,28,31,59,118,101,219,1,9,10,1,2:22
16049,634452,2021-05-31,2021,CLE,CHA,3,1,3-1,CLE,7,1,26,28,54,122,99,221,8,8,16,3,2:21
16050,633925,2021-07-26,2021,NYN,ATL,1,0,1-0,NYN,7,1,26,25,51,108,93,201,9,5,14,1,2:11
16051,634428,2021-04-21,2021,PHI,SFN,6,5,6-5,PHI,9,0,42,38,80,152,146,298,17,13,30,2,3:15 (:44 delay)
16052,634464,2021-04-16,2021,NYA,TBA,2,8,8-2,TBA,9,0,31,46,77,184,144,328,5,19,24,0,3:22
16053,634378,2021-04-23,2021,SLN,CIN,5,4,5-4,SLN,9,1,34,39,73,154,144,298,10,12,22,5,3:15
16054,634178,2021-05-08,2021,SFN,SDN,7,1,7-1,SFN,9,1,39,35,74,149,139,288,17,8,25,0,3:02
16055,634088,2021-05-21,2021,KCA,DET,5,7,7-5,DET,9,0,37,40,77,167,138,305,11,15,26,2,3:19
16056,634271,2021-05-01,2021,TEX,BOS,8,6,8-6,TEX,9,1,37,43,80,174,119,293,15,17,32,2,3:19
16057,633903,2021-05-29,2021,BOS,MIA,3,1,3-1,BOS,9,1,35,40,75,176,118,294,12,13,25,4,3:17 (:16 delay)
16058,634618,2021-04-01,2021,SDN,ARI,8,7,8-7,SDN,9,1,39,41,80,169,149,318,16,13,29,2,3:26
16059,634628,2021-04-06,2021,OAK,LAN,1,5,5-1,LAN,9,0,34,39,73,147,127,274,7,14,21,1,2:45
16060,634297,2021-05-04,2021,WAS,ATL,1,6,6-1,ATL,9,0,33,39,72,150,132,282,8,14,22,1,2:55
16061,634384,2021-04-24,2021,CHA,TEX,2,1,2-1,CHA,9,0,36,36,72,137,134,271,13,11,24,1,2:58
16062,633964,2021-05-27,2021,OAK,ANA,5,0,5-0,OAK,9,1,38,30,68,114,159,273,16,3,19,2,2:59
16063,634547,2021-04-15,2021,LAN,COL,7,5,7-5,LAN,9,1,37,38,75,127,144,271,14,12,26,2,3:01
16064,633991,2021-05-22,2021,SDN,SEA,6,4,6-4,SDN,9,1,39,39,78,134,155,289,18,12,30,1,3:06
16065,634239,2021-05-05,2021,SLN,NYN,2,7,7-2,NYN,7,0,33,34,67,112,108,220,13,13,26,3,2:40
16066,632224,2021-04-13,2021,BAL,SEA,7,6,7-6,BAL,7,0,34,31,65,115,134,249,13,10,23,2,2:38
16067,634346,2021-04-29,2021,MIL,LAN,2,1,2-1,MIL,9,1,29,37,66,141,113,254,6,12,18,0,2:45
16068,632220,2021-04-12,2021,HOU,DET,2,6,6-2,DET,9,0,36,43,79,152,128,280,10,16,26,2,3:04
16069,633916,2021-05-29,2021,WAS,MIL,1,4,4-1,MIL,7,0,25,26,51,101,100,201,5,6,11,0,2:06
16070,632193,2021-04-10,2021,TEX,SDN,4,7,7-4,SDN,9,0,36,42,78,162,150,312,9,19,28,3,3:15
16071,634654,2021-04-03,2021,CIN,SLN,9,6,9-6,CIN,9,1,41,40,81,170,152,322,18,12,30,4,3:24
16072,634633,2021-04-03,2021,COL,LAN,5,6,6-5,LAN,9,0,37,45,82,170,146,316,10,18,28,2,3:35
16073,632215,2021-04-11,2021,MIN,SEA,6,8,8-6,SEA,9,0,41,43,84,162,146,308,13,17,30,3,3:28
16074,634482,2021-04-16,2021,CIN,CLE,10,3,10-3,CIN,9,1,40,40,80,135,167,302,16,16,32,1,3:11
16075,634596,2021-04-03,2021,MIA,TBA,12,7,12-7,MIA,9,1,42,37,79,124,171,295,19,10,29,4,3:32
16076,634383,2021-04-23,2021,HOU,ANA,5,4,5-4,HOU,10,0,38,42,80,147,161,308,9,15,24,3,3:33
16077,634037,2021-05-19,2021,KCA,MIL,6,4,6-4,KCA,9,1,36,40,76,157,145,302,10,12,22,2,3:10
16078,634446,2021-04-21,2021,KCA,TBA,9,8,9-8,KCA,9,0,39,41,80,147,129,276,13,16,29,4,3:13
16079,634549,2021-04-07,2021,CHN,MIL,2,4,4-2,MIL,10,0,37,40,77,149,147,296,7,9,16,2,3:32
16080,634457,2021-04-19,2021,PHI,SFN,0,2,2-0,SFN,9,0,38,36,74,150,144,294,11,9,20,0,3:10
16081,634029,2021-05-19,2021,ANA,CLE,2,3,3-2,CLE,9,0,33,36,69,142,140,282,7,12,19,3,3:05
16082,632205,2021-04-10,2021,MIN,SEA,3,4,4-3,SEA,10,0,40,38,78,134,152,286,12,8,20,0,3:14
16083,633927,2021-05-26,2021,MIL,SDN,1,2,2-1,SDN,10,0,37,37,74,151,144,295,7,7,14,0,3:04
16084,634653,2021-04-02,2021,COL,LAN,6,11,11-6,LAN,9,0,37,47,84,169,133,302,10,19,29,3,3:19
16085,634554,2021-04-15,2021,MIN,BOS,4,3,4-3,MIN,9,0,40,35,75,132,151,283,13,10,23,2,3:25 (:04 delay)
16086,634135,2021-05-13,2021,SEA,CLE,2,4,4-2,CLE,9,0,34,33,67,119,118,237,8,6,14,1,2:36
16087,634032,2021-05-22,2021,SLN,CHN,2,1,2-1,SLN,9,1,30,36,66,130,99,229,6,9,15,1,2:47
16088,634003,2021-05-27,2021,WAS,CIN,0,3,3-0,CIN,7,0,24,30,54,113,101,214,3,8,11,0,2:07
16089,634264,2021-05-04,2021,CHN,LAN,7,1,7-1,CHN,7,1,28,30,58,92,115,207,10,9,19,0,2:17
16090,634594,2021-04-06,2021,MIA,SLN,2,4,4-2,SLN,9,0,40,38,78,158,165,323,14,11,25,2,3:43
16091,634295,2021-05-01,2021,NYA,DET,6,4,6-4,NYA,9,1,39,40,79,137,162,299,15,13,28,3,3:25
16092,634448,2021-04-25,2021,DET,KCA,0,4,4-0,KCA,9,0,32,41,73,173,146,319,6,13,19,2,3:23
16093,634101,2021-05-17,2021,ANA,CLE,7,4,7-4,ANA,9,1,38,38,76,153,151,304,14,13,27,4,3:23
16094,634439,2021-04-20,2021,PHI,SFN,7,10,10-7,SFN,9,0,39,40,79,164,150,314,13,15,28,2,3:16
16095,634116,2021-05-19,2021,TOR,BOS,3,7,7-3,BOS,9,0,37,39,76,163,140,303,14,13,27,2,3:07
16096,633901,2021-05-26,2021,MIA,PHI,4,2,4-2,MIA,9,1,36,38,74,151,144,295,12,10,22,0,3:29
16097,634484,2021-04-10,2021,ARI,CIN,8,3,8-3,ARI,9,1,39,38,77,125,164,289,14,13,27,1,3:09
16098,634299,2021-05-02,2021,ARI,COL,8,4,8-4,ARI,9,1,36,45,81,142,148,290,12,17,29,3,3:29
16099,634604,2021-04-03,2021,KCA,TEX,11,4,11-4,KCA,9,1,40,36,76,146,148,294,17,10,27,2,2:53
16100,634061,2021-05-19,2021,CIN,SFN,0,4,4-0,SFN,9,0,32,39,71,155,138,293,6,12,18,2,3:07
16101,632188,2021-04-11,2021,SFN,COL,4,0,4-0,SFN,9,1,37,39,76,146,139,285,13,12,25,2,3:00
16102,634538,2021-04-18,2021,SEA,HOU,7,2,7-2,SEA,9,1,35,34,69,153,154,307,11,4,15,2,3:19
16103,634494,2021-04-09,2021,SFN,COL,3,1,3-1,SFN,9,1,35,31,66,121,158,279,12,5,17,4,2:54
16104,634437,2021-04-23,2021,CLE,NYA,3,5,5-3,NYA,9,0,35,36,71,146,144,290,9,10,19,2,3:17
16105,634517,2021-04-16,2021,SEA,HOU,6,5,6-5,SEA,9,0,38,36,74,114,141,255,15,11,26,4,3:04
16106,634071,2021-05-16,2021,TBA,NYN,7,1,7-1,TBA,9,1,33,30,63,113,121,234,12,3,15,0,2:32
16107,634290,2021-04-30,2021,MIL,LAN,3,1,3-1,MIL,9,1,31,31,62,129,107,236,9,4,13,1,2:44
16108,634523,2021-04-14,2021,PIT,SDN,5,1,5-1,PIT,9,1,39,33,72,135,167,302,15,9,24,2,3:27
16109,634259,2021-05-02,2021,WAS,MIA,3,1,3-1,WAS,9,1,34,31,65,106,124,230,13,6,19,1,2:37
16110,633936,2021-05-29,2021,PIT,COL,4,0,4-0,PIT,7,1,26,28,54,117,88,205,8,7,15,0,2:03
16111,634601,2021-04-05,2021,BOS,TBA,11,2,11-2,BOS,9,1,41,38,79,168,158,326,19,13,32,3,3:26
16112,634591,2021-04-05,2021,SDN,SFN,2,3,3-2,SFN,9,0,41,37,78,152,158,310,13,11,24,2,3:35
16113,634626,2021-04-07,2021,PHI,NYN,8,2,8-2,PHI,9,1,38,43,81,167,154,321,14,15,29,2,3:35
16114,634460,2021-04-17,2021,CIN,CLE,3,2,3-2,CIN,10,0,43,41,84,144,155,299,17,15,32,1,3:25
16115,634592,2021-04-07,2021,SEA,CHA,8,4,8-4,SEA,9,1,38,40,78,169,150,319,13,16,29,3,3:49
16116,634445,2021-04-19,2021,BOS,CHA,11,4,11-4,BOS,9,1,46,36,82,129,189,318,23,9,32,2,3:15
16117,634411,2021-04-20,2021,CHN,NYN,3,1,3-1,CHN,9,1,35,38,73,158,154,312,10,11,21,2,3:32
16118,632197,2021-04-12,2021,KCA,ANA,3,10,10-3,ANA,9,0,37,42,79,167,152,319,10,18,28,5,3:28
16119,634576,2021-04-02,2021,SDN,ARI,4,2,4-2,SDN,9,1,36,38,74,160,159,319,16,10,26,3,3:53
16120,634632,2021-04-15,2021,OAK,DET,8,4,8-4,OAK,9,1,46,37,83,137,192,329,20,10,30,2,3:17
16121,634430,2021-04-21,2021,ANA,TEX,4,7,7-4,TEX,9,0,37,41,78,188,127,315,11,15,26,2,3:20
16122,633976,2021-05-24,2021,MIA,PHI,9,6,9-6,MIA,9,1,38,40,78,157,138,295,15,13,28,2,3:23
16123,634010,2021-05-22,2021,COL,ARI,7,6,7-6,COL,9,1,35,43,78,160,134,294,11,17,28,3,3:19
16124,633924,2021-05-27,2021,CHA,BAL,5,1,5-1,CHA,9,1,39,36,75,158,153,311,16,9,25,2,3:18 (:19 delay)
16125,632229,2021-04-13,2021,HOU,DET,2,8,8-2,DET,9,0,37,41,78,184,134,318,11,16,27,2,3:27
16126,633892,2021-05-30,2021,TBA,PHI,6,2,6-2,TBA,9,1,35,37,72,152,145,297,13,11,24,5,3:12
16127,634055,2021-05-19,2021,BAL,TBA,7,9,9-7,TBA,9,0,41,41,82,152,147,299,14,14,28,3,3:12
16128,633914,2021-05-27,2021,ARI,SLN,4,5,5-4,SLN,10,0,40,43,83,145,165,310,11,12,23,3,3:28
16129,634537,2021-04-09,2021,HOU,OAK,2,6,6-2,OAK,9,0,38,39,77,159,142,301,11,12,23,1,3:14
16130,633940,2021-05-26,2021,ANA,TEX,9,8,9-8,ANA,9,1,37,42,79,165,140,305,15,15,30,3,3:14
16131,634051,2021-05-18,2021,PHI,MIA,8,3,8-3,PHI,9,1,41,34,75,134,159,293,18,6,24,4,3:34
16132,634511,2021-04-18,2021,TEX,BAL,1,0,1-0,TEX,10,0,39,34,73,122,148,270,10,5,15,2,3:00
16133,634536,2021-04-19,2021,ANA,TEX,4,6,6-4,TEX,9,0,36,38,74,147,154,301,11,10,21,5,3:15
16134,634635,2021-04-06,2021,TEX,TOR,7,4,7-4,TEX,9,1,35,34,69,123,135,258,13,7,20,0,2:33
16135,634260,2021-05-02,2021,PIT,SLN,0,3,3-0,SLN,9,0,33,37,70,140,112,252,9,12,21,0,2:41
16136,633912,2021-05-27,2021,NYN,COL,4,2,4-2,NYN,7,1,28,30,58,124,113,237,12,10,22,3,2:48
16137,634306,2021-05-02,2021,OAK,BAL,7,5,7-5,OAK,9,1,40,40,80,159,139,298,17,12,29,3,3:03
16138,634627,2021-04-02,2021,BOS,BAL,0,3,3-0,BAL,9,0,31,36,67,164,136,300,4,11,15,2,3:10
16139,634030,2021-05-19,2021,MIN,CHA,1,2,2-1,CHA,9,0,31,37,68,119,120,239,5,10,15,0,2:35
16140,634431,2021-04-19,2021,WAS,SLN,5,12,12-5,SLN,9,0,39,43,82,157,147,304,11,18,29,1,3:11
16141,634060,2021-05-23,2021,ATL,PIT,7,1,7-1,ATL,9,1,32,33,65,112,115,227,9,7,16,1,2:30
16142,634005,2021-05-29,2021,PIT,COL,7,0,7-0,PIT,7,1,32,28,60,106,126,232,13,6,19,0,2:33
16143,633930,2021-05-27,2021,LAN,SFN,4,3,4-3,LAN,9,1,31,32,63,119,102,221,7,5,12,4,2:26
16144,634082,2021-05-17,2021,SEA,DET,1,4,4-1,DET,9,0,32,36,68,139,114,253,7,10,17,1,2:34
16145,634631,2021-04-02,2021,ANA,CHA,8,12,12-8,CHA,9,0,40,45,85,173,161,334,14,18,32,8,3:44
16146,634506,2021-04-18,2021,CHN,ATL,4,13,13-4,ATL,9,0,38,50,88,178,139,317,13,25,38,1,3:26
16147,634493,2021-04-18,2021,WAS,ARI,2,5,5-2,ARI,9,0,36,43,79,167,155,322,10,19,29,1,3:20
16148,634054,2021-05-21,2021,PHI,BOS,3,11,11-3,BOS,9,0,37,43,80,175,143,318,11,16,27,2,3:35
16149,634022,2021-05-21,2021,SLN,CHN,3,12,12-3,CHN,9,0,37,46,83,166,119,285,11,22,33,3,3:17
16150,634104,2021-05-15,2021,BAL,NYA,2,8,8-2,NYA,9,0,33,42,75,190,126,316,9,17,26,1,3:03
16151,634067,2021-05-18,2021,TEX,NYA,4,7,7-4,NYA,9,0,36,42,78,173,134,307,10,16,26,5,3:31
16152,634161,2021-05-15,2021,HOU,TEX,6,5,6-5,HOU,9,1,41,39,80,164,155,319,18,13,31,2,3:26
16153,634261,2021-05-06,2021,MIN,TEX,3,4,4-3,TEX,10,0,42,39,81,145,163,308,12,11,23,2,3:25
16154,634392,2021-04-20,2021,SDN,MIL,0,6,6-0,MIL,9,0,35,39,74,143,134,277,7,12,19,0,2:50
16155,634441,2021-05-20,2021,ANA,MIN,3,6,6-3,MIN,7,0,26,35,61,150,120,270,5,14,19,1,2:49
16156,632209,2021-04-11,2021,ARI,CIN,7,0,7-0,ARI,9,1,41,32,73,122,141,263,19,5,24,1,2:39
16157,634433,2021-04-26,2021,BAL,NYA,4,2,4-2,BAL,9,1,35,35,70,127,123,250,12,11,23,1,2:41
16158,634210,2021-05-12,2021,TBA,NYA,0,1,1-0,NYA,9,0,30,32,62,138,121,259,4,7,11,3,2:36
16159,633990,2021-05-25,2021,TBA,KCA,1,2,2-1,KCA,9,0,34,35,69,117,122,239,9,8,17,1,2:29
16160,634080,2021-05-15,2021,MIN,OAK,5,4,5-4,MIN,9,1,35,36,71,127,111,238,12,9,21,2,2:51
16161,634099,2021-05-17,2021,TEX,NYA,5,2,5-2,TEX,9,1,34,33,67,118,131,249,11,8,19,2,2:38
16162,634005,2021-05-29,2021,PIT,COL,7,0,7-0,PIT,7,1,32,28,60,106,126,232,13,6,19,0,2:33
16163,634614,2021-04-14,2021,LAN,COL,4,2,4-2,LAN,9,1,39,38,77,130,177,307,15,11,26,3,3:36
16164,634615,2021-04-01,2021,COL,LAN,8,5,8-5,COL,9,1,39,46,85,190,131,321,14,24,38,2,3:46
16165,632196,2021-04-11,2021,SLN,MIL,3,9,9-3,MIL,9,0,38,44,82,168,157,325,13,18,31,2,3:04
16166,634608,2021-04-06,2021,PHI,NYN,4,8,8-4,NYN,9,0,41,41,82,168,160,328,14,14,28,1,3:40
16167,634642,2021-04-01,2021,NYA,TOR,2,3,3-2,TOR,10,0,41,38,79,159,181,340,12,10,22,2,3:44
16168,634471,2021-04-17,2021,BOS,CHA,7,4,7-4,BOS,9,1,42,39,81,173,164,337,20,13,33,3,3:36
16169,634625,2021-04-01,2021,SEA,SFN,8,7,8-7,SEA,10,0,43,43,86,174,171,345,15,15,30,3,3:45
16170,634462,2021-04-17,2021,CHN,ATL,13,4,13-4,CHN,9,1,42,38,80,161,163,324,18,13,31,3,3:23
16171,634491,2021-04-10,2021,BAL,BOS,4,6,6-4,BOS,10,0,44,42,86,157,169,326,13,14,27,3,3:34
16172,634481,2021-04-15,2021,WAS,ARI,6,11,11-6,ARI,9,0,40,49,89,179,138,317,13,20,33,3,3:26
16173,634416,2021-04-24,2021,CHN,MIL,3,4,4-3,MIL,9,0,38,41,79,176,156,332,12,13,25,2,3:32
16174,634152,2021-05-10,2021,PIT,CIN,1,14,14-1,CIN,9,0,36,45,81,187,140,327,10,21,31,3,3:19
16175,634309,2021-04-28,2021,SFN,COL,7,3,7-3,SFN,9,1,40,37,77,140,189,329,18,11,29,2,3:20
16176,634048,2021-05-25,2021,MIN,BAL,7,4,7-4,MIN,9,1,38,42,80,160,166,326,14,14,28,2,3:23
16177,633981,2021-05-24,2021,DET,CLE,5,6,6-5,CLE,9,0,41,38,79,140,178,318,16,14,30,1,3:31
16178,634015,2021-05-21,2021,CLE,MIN,0,10,10-0,MIN,9,0,35,44,79,181,141,322,7,18,25,2,3:10
16179,633854,2021-05-30,2021,DET,NYA,6,2,6-2,DET,9,1,41,39,80,156,169,325,16,14,30,2,3:06
16180,634585,2021-04-07,2021,MIA,SLN,0,7,7-0,SLN,9,0,34,39,73,158,148,306,8,13,21,2,3:10
16181,634272,2021-05-01,2021,SEA,ANA,5,10,10-5,ANA,9,0,39,42,81,147,166,313,11,17,28,3,3:16
16182,632227,2021-04-10,2021,TOR,ANA,15,1,15-1,TOR,9,1,48,34,82,132,194,326,23,9,32,2,3:21 (2:38 delay)
16183,634324,2021-05-04,2021,PHI,MIL,6,5,6-5,PHI,9,1,32,41,73,175,121,296,8,14,22,2,3:21
16184,634488,2021-04-18,2021,SDN,LAN,5,2,5-2,SDN,9,1,34,32,66,148,143,291,10,5,15,2,3:12
16185,634644,2021-04-03,2021,NYA,TOR,5,3,5-3,NYA,9,1,41,37,78,150,170,320,17,12,29,5,3:38
16186,634442,2021-04-18,2021,KCA,TOR,2,0,2-0,KCA,9,1,39,33,72,128,150,278,16,5,21,1,2:54
16187,634115,2021-05-18,2021,SEA,DET,0,5,5-0,DET,9,0,29,39,68,142,117,259,2,12,14,1,2:44
16188,634289,2021-04-29,2021,TEX,BOS,4,1,4-1,TEX,9,1,32,34,66,141,124,265,8,6,14,1,2:49
16189,634353,2021-04-29,2021,HOU,SEA,0,1,1-0,SEA,9,0,30,32,62,126,121,247,4,5,9,0,2:43
16190,634638,2021-04-01,2021,MIL,MIN,6,5,6-5,MIL,10,0,44,47,91,189,151,340,15,17,32,1,4:14
16191,634507,2021-04-17,2021,WAS,ARI,6,2,6-2,WAS,9,1,39,37,76,174,163,337,15,8,23,1,3:23
16192,634476,2021-04-21,2021,SDN,MIL,2,4,4-2,MIL,9,0,40,40,80,166,179,345,13,13,26,3,3:40
16193,634141,2021-05-13,2021,HOU,TEX,4,3,4-3,HOU,11,0,48,42,90,166,161,327,22,10,32,0,3:44
16194,634579,2021-04-15,2021,ATL,MIA,7,6,7-6,ATL,9,0,41,41,82,166,170,336,16,14,30,0,3:24
16195,633959,2021-05-29,2021,NYN,ATL,13,2,13-2,NYN,9,1,42,34,76,161,170,331,17,10,27,3,3:27
16196,634041,2021-05-20,2021,ATL,PIT,4,6,6-4,PIT,10,0,40,42,82,178,160,338,11,13,24,3,3:43
16197,634027,2021-05-21,2021,CIN,MIL,9,4,9-4,CIN,9,1,40,38,78,168,170,338,17,11,28,2,3:29
16198,634502,2021-04-13,2021,SLN,WAS,14,3,14-3,SLN,9,1,46,36,82,153,158,311,24,9,33,1,3:24
16199,634636,2021-04-01,2021,CIN,SLN,6,11,11-6,SLN,9,0,42,41,83,146,176,322,16,14,30,2,3:31
16200,634597,2021-04-04,2021,MIL,MIN,2,8,8-2,MIN,9,0,36,41,77,178,141,319,8,16,24,0,3:29
16201,634581,2021-04-14,2021,ATL,MIA,5,6,6-5,MIA,10,0,39,42,81,172,134,306,13,15,28,1,3:26
16202,634512,2021-04-09,2021,TOR,ANA,1,7,7-1,ANA,9,0,37,42,79,164,158,322,10,15,25,2,3:06
16203,632195,2021-04-10,2021,PIT,CHN,8,2,8-2,PIT,9,1,40,37,77,142,152,294,17,11,28,1,3:07
16204,634171,2021-05-08,2021,TEX,SEA,9,8,9-8,TEX,9,1,39,41,80,153,140,293,17,15,32,6,3:25
16205,634389,2021-04-23,2021,BAL,OAK,1,3,3-1,OAK,9,0,38,36,74,153,133,286,11,9,20,2,2:53
16206,632218,2021-04-10,2021,CLE,DET,11,3,11-3,CLE,9,1,39,32,71,128,157,285,15,5,20,1,2:53
16207,632194,2021-04-13,2021,MIL,CHN,2,3,3-2,CHN,9,0,35,34,69,143,127,270,9,8,17,1,3:07
16208,632207,2021-04-11,2021,ATL,PHI,6,7,7-6,PHI,9,0,38,35,73,150,133,283,11,8,19,0,3:03
16209,632216,2021-04-12,2021,CHA,CLE,4,3,4-3,CHA,9,0,34,35,69,128,149,277,10,9,19,3,3:05
16210,634483,2021-04-16,2021,MIL,PIT,1,6,6-1,PIT,9,0,37,38,75,153,140,293,12,11,23,2,3:09
16211,634351,2021-04-27,2021,ATL,CHN,5,0,5-0,ATL,9,1,39,30,69,126,150,276,14,3,17,1,2:46
16212,634328,2021-04-30,2021,ARI,COL,7,2,7-2,ARI,9,1,38,36,74,133,119,252,15,10,25,1,2:58
16213,634155,2021-05-12,2021,COL,SDN,3,2,3-2,COL,8,0,34,33,67,128,131,259,13,9,22,1,2:55
16214,634103,2021-05-13,2021,WAS,PHI,5,1,5-1,WAS,9,1,32,34,66,142,118,260,10,7,17,1,2:38
16215,634198,2021-05-12,2021,MIL,SLN,4,1,4-1,MIL,9,1,34,33,67,131,140,271,11,6,17,3,3:07
16216,633998,2021-05-23,2021,MIA,NYN,5,1,5-1,MIA,9,1,35,32,67,122,129,251,11,6,17,0,2:37
16217,634350,2021-04-28,2021,TEX,ANA,3,4,4-3,ANA,9,0,35,35,70,124,135,259,10,9,19,2,2:48
16218,634610,2021-04-04,2021,BOS,BAL,3,11,11-3,BAL,9,0,35,52,87,217,133,350,8,25,33,2,3:28
16219,634241,2021-05-04,2021,BOS,DET,11,7,11-7,BOS,9,1,41,42,83,187,150,337,17,16,33,5,3:38
16220,634097,2021-05-15,2021,ARI,WAS,11,4,11-4,ARI,9,1,40,42,82,176,149,325,17,15,32,4,3:27
16221,634026,2021-05-19,2021,SLN,PIT,8,5,8-5,SLN,9,1,43,41,84,167,164,331,19,15,34,4,3:46
16222,634366,2021-04-24,2021,HOU,ANA,16,2,16-2,HOU,9,1,48,31,79,95,204,299,25,6,31,5,3:20
16223,632206,2021-04-13,2021,ARI,OAK,5,7,7-5,OAK,9,0,38,41,79,168,159,327,12,13,25,3,3:39
16224,634028,2021-05-21,2021,ANA,OAK,4,8,8-4,OAK,9,0,36,43,79,150,151,301,10,19,29,4,3:15
16225,634360,2021-04-28,2021,HOU,SEA,7,5,7-5,HOU,9,1,38,36,74,154,155,309,13,10,23,3,3:29
16226,634221,2021-05-08,2021,NYA,WAS,4,3,4-3,NYA,11,0,40,43,83,168,174,342,10,13,23,3,3:50 (2:25 delay)
16227,634326,2021-05-01,2021,CHA,CLE,7,3,7-3,CHA,9,1,36,33,69,126,161,287,13,7,20,1,3:02
16228,634372,2021-04-25,2021,CLE,NYA,7,3,7-3,CLE,9,1,34,39,73,167,146,313,10,12,22,1,3:07
16229,634336,2021-04-30,2021,PHI,NYN,2,1,2-1,PHI,9,1,32,38,70,149,119,268,7,13,20,1,3:20
16230,632231,2021-04-12,2021,ARI,OAK,5,9,9-5,OAK,9,0,39,43,82,177,143,320,12,19,31,3,3:29
16231,634140,2021-05-12,2021,LAN,SEA,7,1,7-1,LAN,9,1,40,30,70,113,166,279,15,3,18,2,2:57
16232,634362,2021-04-28,2021,BAL,NYA,0,7,7-0,NYA,9,0,31,39,70,149,120,269,5,13,18,1,2:33
16233,634503,2021-04-24,2021,SFN,MIA,2,5,5-2,MIA,9,0,32,36,68,129,139,268,6,8,14,1,2:46
16234,634024,2021-05-28,2021,CHN,CIN,1,0,1-0,CHN,9,1,29,37,66,146,122,268,6,11,17,3,2:57
16235,634291,2021-05-06,2021,MIA,ARI,3,1,3-1,MIA,9,1,29,38,67,145,114,259,6,10,16,0,2:44
16236,633999,2021-05-22,2021,MIA,NYN,3,1,3-1,MIA,9,0,33,36,69,135,122,257,9,9,18,2,3:02
16237,634333,2021-04-27,2021,HOU,SEA,2,0,2-0,HOU,9,1,32,30,62,132,125,257,9,5,14,0,2:40
16238,634605,2021-04-02,2021,OAK,HOU,5,9,9-5,HOU,9,0,39,45,84,182,164,346,13,20,33,3,3:34
16239,634267,2021-05-04,2021,ANA,TBA,3,8,8-3,TBA,9,0,35,44,79,201,144,345,9,17,26,1,3:29
16240,634257,2021-05-02,2021,PHI,NYN,7,8,8-7,NYN,9,0,39,47,86,169,161,330,12,19,31,3,3:54
16241,634438,2021-04-22,2021,HOU,ANA,8,2,8-2,HOU,9,1,42,39,81,176,163,339,17,12,29,5,3:43
16242,634214,2021-05-08,2021,DET,MIN,7,3,7-3,DET,9,1,43,46,89,182,167,349,22,19,41,2,3:38
16243,632219,2021-04-12,2021,ATL,MIA,3,5,5-3,MIA,10,0,41,43,84,184,148,332,12,14,26,3,3:45
16244,634036,2021-05-21,2021,ATL,PIT,20,1,20-1,ATL,9,1,49,38,87,136,184,320,25,12,37,0,3:09
16245,634191,2021-05-13,2021,COL,CIN,13,8,13-8,COL,9,1,46,40,86,146,169,315,22,14,36,4,3:36
16246,634550,2021-04-08,2021,MIN,SEA,10,2,10-2,MIN,9,1,44,36,80,155,173,328,20,11,31,3,3:27 (:16 delay)
16247,634418,2021-04-24,2021,COL,PHI,5,7,7-5,PHI,9,0,36,41,77,157,130,287,10,16,26,1,3:11
16248,634282,2021-05-02,2021,MIL,LAN,4,16,16-4,LAN,9,0,36,52,88,180,135,315,11,25,36,1,3:11
16249,634419,2021-04-22,2021,CHN,NYN,4,3,4-3,CHN,10,0,36,39,75,146,149,295,11,10,21,3,3:41
16250,634303,2021-04-30,2021,SDN,SFN,3,2,3-2,SDN,9,1,35,37,72,149,126,275,12,11,23,1,3:15
16251,634016,2021-05-21,2021,COL,ARI,7,1,7-1,COL,9,1,36,37,73,141,129,270,12,11,23,0,2:45
16252,634242,2021-05-03,2021,SEA,BAL,3,5,5-3,BAL,9,0,33,38,71,146,128,274,6,11,17,3,2:55
16253,634130,2021-05-16,2021,ARI,WAS,0,3,3-0,WAS,9,0,32,35,67,149,125,274,6,10,16,0,2:49
16254,634183,2021-05-12,2021,ARI,MIA,2,3,3-2,MIA,9,0,33,39,72,127,125,252,7,14,21,1,2:41
16255,634307,2021-05-01,2021,TBA,HOU,1,3,3-1,HOU,9,0,34,35,69,143,129,272,7,10,17,0,2:40
16256,634056,2021-05-24,2021,NYN,COL,2,3,3-2,COL,9,0,30,35,65,133,115,248,4,11,15,1,2:43
16257,634600,2021-04-05,2021,OAK,LAN,3,10,10-3,LAN,9,0,38,51,89,223,144,367,10,23,33,2,3:35
16258,634521,2021-04-14,2021,HOU,DET,4,6,6-4,DET,9,0,41,41,82,182,173,355,14,15,29,4,4:00
16259,634286,2021-05-01,2021,ARI,COL,6,14,14-6,COL,9,0,38,50,88,213,123,336,11,23,34,2,3:41
16260,634284,2021-05-01,2021,PIT,SLN,5,12,12-5,SLN,9,0,38,47,85,176,159,335,11,19,30,3,3:43
16261,632232,2021-04-11,2021,TBA,NYA,4,8,8-4,NYA,10,0,39,45,84,172,151,323,10,18,28,4,3:42
16262,634361,2021-04-24,2021,LAN,SDN,5,4,5-4,LAN,9,1,39,38,77,177,134,311,16,11,27,5,3:53
16263,634621,2021-04-15,2021,PIT,SDN,3,8,8-3,SDN,9,0,37,42,79,173,151,324,10,15,25,1,3:15
16264,634427,2021-04-20,2021,MIA,BAL,5,7,7-5,BAL,9,0,42,41,83,148,161,309,14,15,29,5,3:26
16265,634459,2021-04-21,2021,BOS,TOR,3,6,6-3,TOR,9,0,39,44,83,173,154,327,13,19,32,3,3:45 (:31 delay)
16266,634112,2021-05-20,2021,CHN,WAS,5,2,5-2,CHN,9,1,38,34,72,128,142,270,13,9,22,3,3:07
16267,634002,2021-05-23,2021,KCA,DET,3,2,3-2,KCA,9,0,29,38,67,147,113,260,7,12,19,1,2:50
16268,633898,2021-05-31,2021,NYA,TBA,1,3,3-1,TBA,9,0,34,36,70,135,119,254,8,9,17,2,2:43
16269,634006,2021-05-28,2021,OAK,ANA,3,1,3-1,OAK,9,1,33,34,67,116,128,244,11,9,20,2,2:51
16270,634450,2021-04-17,2021,MIA,SFN,7,6,7-6,MIA,10,0,53,40,93,145,200,345,24,11,35,4,3:56
16271,632211,2021-04-13,2021,ATL,MIA,8,14,14-8,MIA,9,0,44,49,93,180,169,349,16,22,38,3,3:51
16272,634634,2021-04-01,2021,CHN,PIT,3,5,5-3,PIT,9,0,34,47,81,214,151,365,6,21,27,4,4:00
16273,634120,2021-05-20,2021,BAL,TBA,1,10,10-1,TBA,9,0,35,53,88,211,142,353,9,25,34,0,3:14
16274,634007,2021-05-23,2021,CLE,MIN,5,8,8-5,MIN,10,0,46,43,89,172,174,346,16,13,29,2,3:44
16275,634196,2021-05-08,2021,BAL,BOS,6,11,11-6,BOS,9,0,39,47,86,184,149,333,14,19,33,2,3:25
16276,634367,2021-04-24,2021,BAL,OAK,2,7,7-2,OAK,9,0,37,42,79,169,143,312,11,15,26,3,3:19
16277,632230,2021-04-12,2021,SLN,WAS,2,5,5-2,WAS,9,0,36,41,77,147,146,293,9,16,25,4,3:20
16278,633994,2021-05-24,2021,CHA,SLN,5,1,5-1,CHA,9,1,36,35,71,132,152,284,12,8,20,2,3:14
16279,633955,2021-05-24,2021,OAK,SEA,2,4,4-2,SEA,9,0,34,37,71,136,141,277,9,10,19,2,3:04
16280,632190,2021-04-13,2021,MIN,BOS,2,4,4-2,BOS,9,0,39,34,73,146,152,298,12,9,21,1,3:17
16281,633960,2021-05-29,2021,CHA,BAL,7,4,7-4,CHA,7,1,33,29,62,115,159,274,14,9,23,2,2:44
16282,634172,2021-05-12,2021,HOU,ANA,9,1,9-1,HOU,9,1,37,34,71,125,148,273,13,7,20,3,2:52
16283,634150,2021-05-13,2021,BOS,OAK,8,1,8-1,BOS,9,1,38,37,75,143,132,275,16,13,29,1,2:54
16284,634044,2021-05-19,2021,PHI,MIA,1,3,3-1,MIA,9,0,33,38,71,138,120,258,9,12,21,2,3:02
16285,634083,2021-05-16,2021,DET,CHN,1,5,5-1,CHN,9,0,33,42,75,141,118,259,8,13,21,1,2:52
16286,633928,2021-05-26,2021,MIN,BAL,3,2,3-2,MIN,9,1,31,34,65,152,116,268,8,8,16,0,2:39
16287,634539,2021-04-07,2021,NYA,BAL,3,4,4-3,BAL,11,0,46,40,86,172,189,361,15,6,21,5,3:54
16288,634137,2021-05-12,2021,PIT,CIN,1,5,5-1,CIN,10,0,39,44,83,170,172,342,9,14,23,5,3:55
16289,634552,2021-04-05,2021,ANA,HOU,7,6,7-6,ANA,9,1,41,44,85,190,165,355,17,16,33,5,4:01
16290,634143,2021-05-15,2021,SDN,SLN,13,3,13-3,SDN,9,1,46,37,83,168,192,360,24,11,35,2,3:31
16291,632170,2021-04-11,2021,CHA,KCA,3,4,4-3,KCA,10,0,44,40,84,172,184,356,14,13,27,3,3:54
16292,634508,2021-04-22,2021,BOS,SEA,3,7,7-3,SEA,10,0,41,39,80,156,176,332,11,11,22,0,3:28
16293,632191,2021-04-10,2021,LAN,WAS,9,5,9-5,LAN,9,1,39,41,80,159,133,292,18,17,35,3,3:11
16294,634314,2021-04-28,2021,SLN,PHI,3,5,5-3,PHI,9,0,36,39,75,151,130,281,12,12,24,4,3:19
16295,634371,2021-04-28,2021,CLE,MIN,2,10,10-2,MIN,9,0,33,42,75,171,126,297,6,15,21,2,3:00
16296,634084,2021-05-15,2021,SEA,CLE,7,3,7-3,SEA,9,1,37,36,73,139,155,294,13,9,22,1,3:09
16297,634373,2021-04-24,2021,BOS,SEA,2,8,8-2,SEA,9,0,33,45,78,169,121,290,8,18,26,2,3:05
16298,634456,2021-04-25,2021,SLN,CIN,5,2,5-2,SLN,9,1,33,34,67,147,134,281,10,9,19,0,2:49
16299,634113,2021-05-13,2021,PIT,SFN,1,3,3-1,SFN,9,0,33,38,71,159,128,287,6,12,18,0,2:52
16300,633962,2021-05-25,2021,MIL,SDN,1,7,7-1,SDN,9,0,32,37,69,148,136,284,4,10,14,1,3:06
16301,633894,2021-05-29,2021,TBA,PHI,5,3,5-3,TBA,9,1,35,36,71,142,128,270,12,10,22,4,3:06
16302,633970,2021-05-25,2021,DET,CLE,1,4,4-1,CLE,9,0,36,36,72,146,124,270,9,9,18,2,2:47
16303,633949,2021-05-29,2021,DET,NYA,6,1,6-1,DET,9,1,33,34,67,157,131,288,9,8,17,2,2:54
16304,634049,2021-05-22,2021,ATL,PIT,6,1,6-1,ATL,9,1,37,36,73,135,142,277,14,11,25,1,2:51
16305,634408,2021-04-20,2021,CIN,ARI,4,5,5-4,ARI,9,0,39,46,85,190,173,363,12,20,32,4,3:54 (1:06 delay)
16306,634455,2021-04-18,2021,MIL,PIT,5,6,6-5,PIT,10,0,40,44,84,179,171,350,10,14,24,2,3:47
16307,634588,2021-04-05,2021,DET,MIN,6,15,15-6,MIN,9,0,37,51,88,215,144,359,9,25,34,1,3:32 (:52 delay)
16308,633989,2021-05-23,2021,CIN,MIL,4,9,9-4,MIL,9,0,40,41,81,169,183,352,12,14,26,3,3:30
16309,634317,2021-04-28,2021,MIL,MIA,2,6,6-2,MIA,9,0,33,43,76,165,124,289,7,17,24,1,3:04
16310,634379,2021-04-27,2021,LAN,CIN,5,6,6-5,CIN,9,0,40,38,78,144,155,299,13,12,25,3,3:14
16311,634285,2021-05-03,2021,MIN,TEX,6,5,6-5,MIN,9,1,34,41,75,173,126,299,10,14,24,3,3:05
16312,634108,2021-05-14,2021,PIT,SFN,3,2,3-2,PIT,11,0,41,38,79,145,136,281,11,6,17,1,3:20
16313,634329,2021-05-01,2021,MIN,KCA,3,11,11-3,KCA,9,0,37,41,78,141,143,284,9,15,24,1,2:59
16314,634225,2021-05-05,2021,COL,SFN,6,5,6-5,COL,9,1,35,36,71,152,137,289,12,10,22,2,3:08 (1:26 delay)
16315,634254,2021-05-04,2021,COL,SFN,8,6,8-6,COL,7,0,33,36,69,146,121,267,13,17,30,4,3:04
16316,634249,2021-05-05,2021,MIA,ARI,8,0,8-0,MIA,9,1,36,35,71,150,140,290,12,8,20,0,2:57
16317,634074,2021-05-26,2021,OAK,SEA,6,3,6-3,OAK,9,1,36,37,73,151,133,284,15,10,25,2,3:01
16318,634131,2021-05-14,2021,MIN,OAK,1,6,6-1,OAK,9,0,35,38,73,156,134,290,9,11,20,0,3:00
16319,633926,2021-05-31,2021,ARI,NYN,2,6,6-2,NYN,9,0,35,41,76,119,135,254,8,16,24,3,2:58
16320,634211,2021-05-09,2021,OAK,TBA,3,4,4-3,TBA,9,0,36,33,69,120,157,277,11,5,16,2,2:40
16321,633992,2021-05-24,2021,MIL,SDN,5,3,5-3,MIL,9,1,34,35,69,141,147,288,11,8,19,2,3:12
16322,634293,2021-05-03,2021,OAK,TOR,5,4,5-4,OAK,9,1,36,37,73,132,150,282,14,10,24,1,2:45
16323,633968,2021-05-30,2021,SEA,TEX,4,2,4-2,SEA,9,1,35,32,67,128,148,276,11,5,16,1,3:00
16324,632192,2021-04-11,2021,NYN,MIA,6,5,6-5,NYN,9,0,42,43,85,199,161,360,16,16,32,4,4:05 (2:10 delay)
16325,634407,2021-04-20,2021,KCA,TBA,7,14,14-7,TBA,9,0,40,49,89,187,160,347,13,23,36,4,3:35
16326,634590,2021-04-06,2021,BOS,TBA,6,5,6-5,BOS,12,0,48,48,96,187,170,357,15,15,30,3,4:25
16327,634540,2021-04-09,2021,ARI,CIN,5,6,6-5,CIN,10,0,45,45,90,156,198,354,16,16,32,2,3:47
16328,634397,2021-04-20,2021,CLE,CHA,5,8,8-5,CHA,9,0,45,39,84,158,184,342,16,12,28,3,3:39
16329,632200,2021-04-11,2021,BAL,BOS,9,14,14-9,BOS,9,0,43,50,93,179,181,360,18,23,41,4,3:46
16330,634510,2021-04-13,2021,SFN,CIN,7,6,7-6,SFN,9,1,38,36,74,139,174,313,15,10,25,2,3:11
16331,634567,2021-04-07,2021,OAK,LAN,4,3,4-3,OAK,10,0,40,46,86,169,170,339,12,17,29,4,3:46
16332,634436,2021-04-22,2021,CLE,NYA,3,6,6-3,NYA,9,0,38,46,84,175,134,309,10,20,30,2,3:31
16333,634454,2021-04-25,2021,BAL,OAK,8,1,8-1,BAL,9,1,40,32,72,143,157,300,16,6,22,3,2:56
16334,634182,2021-05-09,2021,TEX,SEA,10,2,10-2,TEX,9,1,39,41,80,150,136,286,16,15,31,1,3:03
16335,634217,2021-05-05,2021,NYA,HOU,6,3,6-3,NYA,9,1,39,33,72,126,168,294,16,9,25,3,3:35
16336,634342,2021-04-25,2021,SFN,MIA,4,3,4-3,SFN,9,1,35,37,72,142,149,291,11,13,24,0,3:10
16337,634244,2021-05-03,2021,PHI,MIL,4,3,4-3,PHI,9,1,32,38,70,172,139,311,8,12,20,1,3:18
16338,633975,2021-05-23,2021,TOR,TBA,4,6,6-4,TBA,9,0,38,42,80,170,117,287,11,17,28,2,3:03
16339,633941,2021-05-25,2021,PIT,CHN,3,4,4-3,CHN,9,0,37,38,75,145,138,283,11,13,24,2,2:59
16340,634063,2021-05-17,2021,ATL,NYN,1,3,3-1,NYN,9,0,31,42,73,160,118,278,4,16,20,2,3:14
16341,634637,2021-04-04,2021,ANA,CHA,7,4,7-4,ANA,9,0,41,41,82,163,165,328,16,12,28,4,3:56
16342,633923,2021-05-30,2021,LAN,SFN,4,5,5-4,SFN,9,0,35,40,75,157,118,275,6,14,20,1,3:07
16343,634139,2021-05-15,2021,TOR,PHI,4,0,4-0,TOR,9,1,35,38,73,167,120,287,11,11,22,2,3:13
16344,633917,2021-05-31,2021,ATL,WAS,5,3,5-3,ATL,9,1,35,37,72,135,151,286,11,10,21,0,3:05
16345,634068,2021-05-16,2021,HOU,TEX,6,2,6-2,HOU,9,1,36,35,71,143,135,278,12,10,22,1,3:03
16346,633872,2021-05-30,2021,CHA,BAL,3,1,3-1,CHA,9,1,36,33,69,130,153,283,12,6,18,2,2:41
16347,634092,2021-05-18,2021,LAN,ARI,9,1,9-1,LAN,9,1,41,31,72,109,159,268,17,4,21,2,2:50
16348,634281,2021-05-05,2021,ANA,TBA,1,3,3-1,TBA,9,0,37,39,76,136,135,271,14,13,27,4,3:16
16349,634109,2021-05-18,2021,SLN,PIT,5,2,5-2,SLN,9,1,38,35,73,139,120,259,14,8,22,2,2:53
16350,634232,2021-05-06,2021,WAS,ATL,2,3,3-2,ATL,9,0,39,31,70,130,145,275,14,6,20,3,2:53
16351,633915,2021-05-27,2021,TBA,KCA,7,2,7-2,TBA,9,1,38,34,72,115,163,278,15,9,24,1,2:38
16352,634556,2021-09-04,2021,WAS,NYN,9,11,11-9,NYN,9,0,45,43,88,180,174,354,19,15,34,1,4:05
16353,633884,2021-05-31,2021,CLE,CHA,6,8,8-6,CHA,8,0,34,35,69,157,104,261,13,11,24,1,2:45
16354,634408,2021-04-20,2021,CIN,ARI,4,5,5-4,ARI,9,0,39,46,85,190,173,363,12,20,32,4,3:54 (1:06 delay)
16355,634122,2021-05-16,2021,LAN,MIA,2,3,3-2,MIA,9,0,37,37,74,165,146,311,11,9,20,2,3:23
16356,634124,2021-05-16,2021,CHA,KCA,4,3,4-3,CHA,9,0,41,36,77,135,165,300,17,10,27,3,3:21
16357,634125,2021-05-13,2021,CHA,MIN,4,2,4-2,CHA,9,1,35,41,76,175,144,319,11,11,22,2,3:31
16358,634320,2021-04-27,2021,MIL,MIA,5,4,5-4,MIL,9,1,36,36,72,153,130,283,13,10,23,3,3:15
16359,634270,2021-05-05,2021,CIN,CHA,1,0,1-0,CIN,10,0,38,35,73,133,156,289,14,7,21,1,3:10
16360,633956,2021-05-25,2021,NYA,TOR,2,6,6-2,TOR,9,0,36,44,80,152,146,298,10,17,27,1,3:02
16361,634294,2021-05-05,2021,PHI,MIL,5,4,5-4,PHI,9,1,30,40,70,175,135,310,7,16,23,2,3:07
16362,633943,2021-05-27,2021,DET,CLE,2,5,5-2,CLE,9,0,36,42,78,166,146,312,9,15,24,1,3:06
16363,634231,2021-05-06,2021,OAK,TOR,4,10,10-4,TOR,9,0,35,46,81,150,144,294,11,19,30,2,3:10
16364,633932,2021-05-28,2021,MIN,KCA,3,8,8-3,KCA,9,0,38,41,79,140,163,303,12,15,27,2,3:12
16365,634133,2021-05-18,2021,TOR,BOS,8,0,8-0,TOR,9,1,43,35,78,142,151,293,20,7,27,1,3:16
16366,634184,2021-05-09,2021,NYN,ARI,4,2,4-2,NYN,9,1,37,35,72,163,137,300,13,10,23,2,3:27
16367,634034,2021-05-19,2021,OAK,HOU,1,8,8-1,HOU,9,0,31,46,77,198,111,309,4,20,24,1,3:18
16368,633972,2021-05-25,2021,ANA,TEX,11,5,11-5,ANA,9,1,39,38,77,148,142,290,16,10,26,2,2:59
16369,633958,2021-05-25,2021,BOS,ATL,1,3,3-1,ATL,9,0,33,40,73,159,135,294,8,14,22,1,3:06
16370,633971,2021-05-26,2021,CHA,SLN,0,4,4-0,SLN,9,0,40,36,76,148,147,295,12,9,21,2,3:19
16371,634050,2021-05-18,2021,OAK,HOU,6,5,6-5,OAK,9,0,39,38,77,139,149,288,15,13,28,2,3:09
16372,634011,2021-05-22,2021,SFN,LAN,3,6,6-3,LAN,9,0,34,37,71,140,138,278,9,10,19,0,2:54
16373,634017,2021-05-22,2021,CIN,MIL,3,4,4-3,MIL,9,0,33,37,70,148,141,289,7,11,18,1,3:07
16374,634302,2021-05-02,2021,CHA,CLE,0,5,5-0,CLE,9,0,36,40,76,149,153,302,9,13,22,2,3:19
16375,633897,2021-05-31,2021,SFN,ANA,6,1,6-1,SFN,9,1,37,34,71,126,147,273,14,9,23,2,2:58
16376,634013,2021-05-21,2021,SFN,LAN,1,2,2-1,LAN,9,0,34,37,71,132,151,283,6,13,19,1,2:55
16377,634630,2021-04-01,2021,KCA,TEX,14,10,14-10,KCA,9,1,51,50,101,202,200,402,25,25,50,6,4:26
16378,634535,2021-04-13,2021,PIT,SDN,8,4,8-4,PIT,9,1,44,46,90,190,169,359,20,22,42,5,4:07
16379,634603,2021-04-06,2021,DET,MIN,4,3,4-3,DET,10,0,43,42,85,186,197,383,17,11,28,0,4:00
16380,633963,2021-05-24,2021,TOR,TBA,8,14,14-8,TBA,11,0,44,51,95,182,169,351,11,19,30,2,3:52
16381,634522,2021-04-15,2021,TBA,TEX,4,6,6-4,TEX,10,0,45,44,89,164,196,360,15,15,30,4,3:44
16382,634075,2021-05-18,2021,BAL,TBA,6,13,13-6,TBA,9,0,43,47,90,190,188,378,16,20,36,4,3:42
16383,634165,2021-05-08,2021,SLN,COL,9,8,9-8,SLN,9,1,41,44,85,170,157,327,20,17,37,2,3:39
16384,634117,2021-05-13,2021,DET,KCA,4,3,4-3,DET,9,1,36,41,77,153,152,305,14,14,28,4,3:11
16385,634322,2021-04-28,2021,ARI,SDN,3,12,12-3,SDN,9,0,35,45,80,140,149,289,10,18,28,4,3:05
16386,634094,2021-05-16,2021,PIT,SFN,1,4,4-1,SFN,9,0,37,41,78,154,139,293,11,14,25,1,3:13
16387,634334,2021-05-03,2021,ANA,TBA,3,7,7-3,TBA,9,0,34,42,76,172,139,311,11,15,26,4,3:31
16388,634292,2021-05-03,2021,SLN,NYN,6,5,6-5,SLN,9,1,33,41,74,155,144,299,11,16,27,3,3:20
16389,634004,2021-05-23,2021,PHI,BOS,6,2,6-2,PHI,9,1,38,34,72,129,163,292,16,7,23,2,3:19
16390,634256,2021-05-02,2021,TOR,ATL,7,2,7-2,TOR,9,1,38,37,75,141,157,298,14,11,25,3,3:09
16391,634377,2021-04-26,2021,TEX,ANA,4,9,9-4,ANA,9,0,36,46,82,166,129,295,9,19,28,2,3:06
16392,634021,2021-05-26,2021,HOU,LAN,5,2,5-2,HOU,9,1,36,34,70,149,135,284,13,7,20,0,3:05
16393,634541,2021-04-14,2021,SLN,WAS,0,6,6-0,WAS,9,0,34,42,76,157,137,294,8,17,25,1,3:11
16394,634105,2021-05-15,2021,TBA,NYN,12,5,12-5,TBA,9,1,45,37,82,127,148,275,21,10,31,3,3:01
16395,634338,2021-05-01,2021,MIL,LAN,6,5,6-5,MIL,11,0,49,47,96,179,194,373,18,18,36,3,4:48
16396,632222,2021-04-10,2021,SLN,MIL,5,9,9-5,MIL,9,0,42,45,87,191,174,365,17,19,36,3,3:43
16397,634453,2021-04-21,2021,CHN,NYN,16,4,16-4,CHN,9,1,46,39,85,147,175,322,22,13,35,4,3:27
16398,634444,2021-04-21,2021,CIN,ARI,5,8,8-5,ARI,10,0,40,46,86,184,153,337,14,17,31,4,3:40
16399,634440,2021-04-21,2021,OAK,MIN,13,12,13-12,OAK,10,0,47,51,98,186,175,361,18,20,38,4,4:16
16400,634323,2021-05-02,2021,TBA,HOU,5,4,5-4,TBA,9,1,36,37,73,139,156,295,12,11,23,4,3:21
16401,634287,2021-04-30,2021,SEA,ANA,7,4,7-4,SEA,9,1,41,34,75,142,180,322,16,7,23,2,3:20
16402,634046,2021-05-19,2021,SEA,DET,2,6,6-2,DET,9,0,35,40,75,158,145,303,8,15,23,1,3:11
16403,634079,2021-05-22,2021,TEX,HOU,8,4,8-4,TEX,9,1,42,39,81,132,170,302,16,12,28,3,3:24
16404,633980,2021-05-23,2021,SFN,LAN,5,11,11-5,LAN,9,0,39,41,80,138,160,298,12,16,28,2,3:06
16405,634086,2021-05-16,2021,BAL,NYA,10,6,10-6,BAL,9,1,41,38,79,147,169,316,17,13,30,2,3:13
16406,634070,2021-05-17,2021,CIN,SFN,3,6,6-3,SFN,9,0,39,38,77,149,148,297,13,13,26,1,3:02
16407,634052,2021-05-18,2021,CHN,WAS,6,3,6-3,CHN,9,1,37,41,78,148,151,299,16,13,29,3,3:22
16408,633888,2021-05-27,2021,PIT,CHN,3,5,5-3,CHN,9,0,36,38,74,159,118,277,10,11,21,1,3:01
16409,633957,2021-05-27,2021,MIA,PHI,2,3,3-2,PHI,9,0,35,35,70,138,144,282,11,10,21,1,3:11
16410,633919,2021-05-31,2021,BAL,MIN,2,3,3-2,MIN,10,0,36,39,75,151,123,274,7,10,17,1,2:53
16411,634548,2021-04-16,2021,CHN,ATL,2,5,5-2,ATL,9,0,41,43,84,186,181,367,16,18,34,2,4:02
16412,634545,2021-04-08,2021,TOR,ANA,5,7,7-5,ANA,11,0,42,47,89,166,187,353,10,14,24,3,3:57
16413,634388,2021-04-25,2021,COL,PHI,12,2,12-2,COL,9,1,44,36,80,135,183,318,21,9,30,1,3:16
16414,634127,2021-05-15,2021,CHA,KCA,1,5,5-1,KCA,9,0,34,40,74,167,153,320,7,14,21,1,3:21
16415,633953,2021-05-25,2021,HOU,LAN,2,9,9-2,LAN,9,0,33,44,77,191,115,306,6,17,23,4,3:27
16416,634100,2021-05-16,2021,BOS,ANA,5,6,6-5,ANA,9,0,37,40,77,149,158,307,11,13,24,4,3:19
16417,633977,2021-05-23,2021,WAS,BAL,6,5,6-5,WAS,9,1,38,40,78,134,154,288,14,17,31,3,3:14
16418,633851,2021-05-31,2021,LAN,SLN,9,4,9-4,LAN,9,1,38,33,71,119,165,284,16,6,22,3,3:17
16419,633881,2021-05-30,2021,MIN,KCA,3,6,6-3,KCA,9,0,40,38,78,127,172,299,13,12,25,2,3:19
16420,633875,2021-05-29,2021,CHN,CIN,10,2,10-2,CHN,9,1,43,36,79,126,147,273,20,9,29,4,3:13
16421,633948,2021-05-31,2021,MIL,DET,3,2,3-2,MIL,10,0,35,38,73,149,138,287,9,10,19,1,3:09
16422,633890,2021-05-26,2021,WAS,CIN,5,3,5-3,WAS,9,1,39,39,78,163,144,307,15,13,28,3,3:26 (3:04 delay)
16423,634065,2021-05-18,2021,SDN,COL,2,1,2-1,SDN,10,0,36,40,76,160,155,315,7,12,19,0,3:40
16424,633983,2021-05-31,2021,CIN,PHI,11,1,11-1,CIN,9,1,40,38,78,150,148,298,15,12,27,1,2:53
16425,634167,2021-05-09,2021,KCA,CHA,3,9,9-3,CHA,9,0,36,42,78,172,157,329,10,14,24,3,3:29
16426,633900,2021-05-31,2021,KCA,PIT,7,3,7-3,KCA,9,1,37,35,72,156,153,309,15,8,23,0,3:09
16427,633939,2021-05-26,2021,ARI,SFN,4,5,5-4,SFN,9,0,39,36,75,134,153,287,13,10,23,1,3:03
16428,633950,2021-05-29,2021,WAS,MIL,2,6,6-2,MIL,7,0,34,35,69,140,143,283,13,16,29,3,3:00
16429,634247,2021-05-06,2021,ANA,TBA,3,8,8-3,TBA,9,0,33,42,75,182,120,302,8,15,23,3,3:03
16430,633896,2021-05-31,2021,HOU,BOS,11,2,11-2,HOU,9,1,41,33,74,128,172,300,20,6,26,2,3:15
16431,634514,2021-04-22,2021,CIN,ARI,11,14,14-11,ARI,10,0,48,52,100,215,179,394,17,22,39,7,4:26
16432,634087,2021-05-16,2021,SEA,CLE,3,2,3-2,SEA,9,1,37,38,75,169,167,336,14,12,26,2,3:36
16433,634045,2021-05-20,2021,OAK,HOU,4,8,8-4,HOU,9,0,39,42,81,143,171,314,13,16,29,1,3:26
16434,634039,2021-05-20,2021,PHI,MIA,0,6,6-0,MIA,9,0,33,39,72,159,151,310,7,14,21,1,3:08
16435,633973,2021-05-23,2021,SLN,CHN,1,2,2-1,CHN,10,0,42,36,78,144,172,316,12,6,18,2,3:38
16436,634106,2021-05-15,2021,MIL,ATL,1,5,5-1,ATL,9,0,34,42,76,158,149,307,8,16,24,2,2:54
16437,634330,2021-04-29,2021,CHA,DET,3,1,3-1,CHA,7,1,24,24,48,108,87,195,7,3,10,0,1:50
16438,633945,2021-05-25,2021,OAK,SEA,3,4,4-3,SEA,9,0,38,39,77,136,164,300,11,13,24,2,3:09
16439,633931,2021-05-30,2021,CHN,CIN,1,5,5-1,CIN,9,0,33,42,75,168,166,334,8,14,22,2,3:27
16440,633944,2021-05-29,2021,MIN,KCA,6,5,6-5,MIN,9,1,38,35,73,156,137,293,14,10,24,2,3:04
16441,633889,2021-05-30,2021,OAK,ANA,2,4,4-2,ANA,9,0,37,38,75,140,171,311,9,10,19,2,3:20
16442,634188,2021-05-16,2021,MIN,OAK,6,7,7-6,OAK,9,0,42,42,84,166,147,313,16,16,32,3,3:33
16443,633984,2021-05-22,2021,PHI,BOS,3,4,4-3,BOS,9,0,40,40,80,163,154,317,13,13,26,4,3:40
16444,634470,2021-04-17,2021,PHI,SLN,4,9,9-4,SLN,9,0,42,45,87,186,194,380,15,20,35,5,3:54
16445,633890,2021-05-26,2021,WAS,CIN,5,3,5-3,WAS,9,1,39,39,78,163,144,307,15,13,28,3,3:26 (3:04 delay)
16446,634119,2021-05-14,2021,TOR,PHI,1,5,5-1,PHI,9,0,36,42,78,198,144,342,10,17,27,3,3:38
16447,633985,2021-05-23,2021,ANA,OAK,6,5,6-5,ANA,9,1,38,39,77,157,165,322,15,13,28,5,3:21
16448,634145,2021-05-14,2021,LAN,MIA,9,6,9-6,LAN,9,1,39,39,78,149,159,308,15,12,27,3,3:18
16449,634404,2021-04-25,2021,ATL,ARI,0,5,5-0,ARI,7,0,24,31,55,107,83,190,4,11,15,0,2:10
16450,634123,2021-05-14,2021,HOU,TEX,10,4,10-4,HOU,9,1,42,35,77,130,174,304,18,10,28,2,3:01
16451,634038,2021-05-22,2021,CLE,MIN,5,3,5-3,CLE,10,0,37,40,77,169,141,310,13,12,25,2,3:34
16452,634073,2021-05-18,2021,MIN,CHA,5,4,5-4,MIN,9,0,39,42,81,185,160,345,13,13,26,2,3:48
16453,634025,2021-05-23,2021,TEX,HOU,3,2,3-2,TEX,10,0,40,40,80,166,162,328,14,11,25,2,3:39
16454,634018,2021-05-20,2021,TOR,BOS,7,8,8-7,BOS,9,0,44,42,86,153,169,322,16,18,34,2,3:25
16455,633913,2021-05-29,2021,ARI,SLN,4,7,7-4,SLN,9,0,41,42,83,144,168,312,14,17,31,1,3:24
16456,634053,2021-05-19,2021,CHN,WAS,3,4,4-3,WAS,9,0,39,39,78,156,170,326,13,13,26,2,3:48
16457,633987,2021-05-28,2021,ARI,SLN,6,8,8-6,SLN,9,0,46,41,87,140,174,314,19,13,32,2,3:28
16458,634009,2021-05-23,2021,NYA,CHA,5,4,5-4,NYA,9,0,39,36,75,153,174,327,16,11,27,3,3:37
16459,634300,2021-04-29,2021,BAL,NYA,4,3,4-3,BAL,10,0,37,44,81,177,144,321,9,17,26,3,3:30
16460,634449,2021-04-17,2021,SDN,LAN,0,2,2-0,LAN,9,0,34,33,67,144,141,285,7,6,13,1,3:12
16461,634158,2021-05-13,2021,MIL,SLN,0,2,2-0,SLN,9,0,36,41,77,169,147,316,9,17,26,0,3:31
16462,633946,2021-05-30,2021,ARI,SLN,9,2,9-2,ARI,9,1,42,36,78,138,146,284,19,11,30,1,2:59
16463,634312,2021-05-01,2021,TOR,ATL,6,5,6-5,TOR,10,0,42,44,86,165,166,331,17,16,33,3,3:34
16464,633979,2021-05-25,2021,ARI,SFN,0,8,8-0,SFN,9,0,38,43,81,180,161,341,11,16,27,0,3:16
16465,634090,2021-05-16,2021,SDN,SLN,5,3,5-3,SDN,9,1,38,37,75,151,177,328,15,10,25,3,3:32
16466,634072,2021-06-07,2021,BOS,MIA,5,3,5-3,BOS,9,1,36,44,80,168,143,311,13,18,31,3,3:38
16467,634077,2021-05-17,2021,MIN,CHA,4,16,16-4,CHA,9,0,37,50,87,196,147,343,11,26,37,1,3:11
16468,634001,2021-05-22,2021,KCA,DET,7,5,7-5,KCA,9,1,38,43,81,172,151,323,14,15,29,1,3:28 (1:21 delay)
16469,634121,2021-05-14,2021,COL,CIN,9,6,9-6,COL,9,1,43,38,81,135,175,310,21,15,36,2,3:20
16470,633951,2021-05-25,2021,CHA,SLN,8,3,8-3,CHA,9,1,40,37,77,153,152,305,15,12,27,3,3:23
16471,633874,2021-05-29,2021,HOU,SDN,8,11,11-8,SDN,12,0,52,54,106,230,197,427,19,20,39,3,5:08
16472,634162,2021-05-14,2021,ARI,WAS,2,17,17-2,WAS,9,0,33,59,92,207,133,340,7,29,36,0,3:14
16473,634298,2021-05-02,2021,CIN,CHN,13,12,13-12,CIN,10,0,47,45,92,159,182,341,23,18,41,4,3:57
16474,633978,2021-05-30,2021,PIT,COL,3,4,4-3,COL,9,0,36,43,79,180,146,326,10,17,27,4,3:36
16475,633961,2021-05-28,2021,DET,NYA,3,2,3-2,DET,10,0,37,43,80,186,159,345,10,13,23,0,3:34
16476,633849,2021-05-31,2021,SEA,OAK,6,5,6-5,SEA,10,0,43,42,85,147,169,316,15,13,28,2,3:31
16477,634181,2021-05-10,2021,HOU,ANA,4,5,5-4,ANA,9,0,42,42,84,163,163,326,16,14,30,5,3:57
16478,634118,2021-05-14,2021,MIL,ATL,3,6,6-3,ATL,9,0,38,41,79,159,157,316,11,14,25,3,3:23
16479,634609,2021-04-06,2021,SEA,CHA,4,10,10-4,CHA,9,0,40,44,84,189,164,353,12,17,29,4,3:45
16480,633938,2021-05-29,2021,LAN,SFN,6,11,11-6,SFN,9,0,40,48,88,169,156,325,11,25,36,3,3:38
16481,634363,2021-04-26,2021,LAN,CIN,3,5,5-3,CIN,10,0,42,42,84,171,187,358,14,12,26,2,3:49
16482,634019,2021-05-21,2021,SDN,SEA,16,1,16-1,SDN,9,1,46,36,82,162,197,359,23,10,33,1,3:34
16483,634148,2021-05-15,2021,COL,CIN,5,6,6-5,CIN,12,0,47,50,97,169,152,321,13,17,30,2,4:10 (:10 delay)
16484,634228,2021-05-05,2021,BOS,DET,5,6,6-5,DET,10,0,46,42,88,170,167,337,17,13,30,3,3:47 (:37 delay)
16485,634619,2021-04-06,2021,COL,ARI,8,10,10-8,ARI,13,0,52,57,109,214,198,412,16,17,33,2,4:29
16486,634098,2021-05-16,2021,COL,CIN,6,7,7-6,CIN,9,0,41,41,82,171,158,329,14,17,31,3,3:56
16487,634069,2021-05-16,2021,TOR,PHI,10,8,10-8,TOR,9,1,44,44,88,194,164,358,20,17,37,5,3:45
16488,634085,2021-05-15,2021,PIT,SFN,8,6,8-6,PIT,9,0,40,42,82,184,159,343,20,16,36,3,3:36
16489,634008,2021-05-21,2021,TEX,HOU,7,5,7-5,TEX,10,0,41,48,89,211,150,361,13,17,30,4,4:08
16490,634357,2021-04-29,2021,CHA,DET,11,0,11-0,CHA,7,1,37,24,61,91,154,245,19,3,22,2,2:42 (1:06 delay)
16491,634331,2021-04-27,2021,PIT,KCA,2,1,2-1,PIT,9,1,32,33,65,120,110,230,9,6,15,1,2:20
16492,634370,2021-04-23,2021,LAN,SDN,1,6,6-1,SDN,9,0,34,37,71,130,118,248,9,13,22,1,2:52
16493,634220,2021-05-05,2021,SEA,BAL,0,6,6-0,BAL,9,0,27,35,62,136,113,249,0,9,9,0,2:25
16494,634134,2021-05-16,2021,MIL,ATL,10,9,10-9,MIL,9,1,45,43,88,170,184,354,21,13,34,3,3:45
16495,634230,2021-05-05,2021,CHN,LAN,6,5,6-5,CHN,11,0,45,46,91,183,180,363,15,14,29,1,4:23
16496,634318,2021-04-27,2021,SLN,PHI,5,2,5-2,SLN,9,1,36,32,68,118,131,249,12,5,17,2,2:42
16497,634410,2021-04-27,2021,NYN,BOS,1,2,2-1,BOS,9,0,32,31,63,124,119,243,7,7,14,0,2:38
16498,634194,2021-05-09,2021,SLN,COL,2,0,2-0,SLN,9,1,35,33,68,122,116,238,13,7,20,1,2:48
16499,634062,2021-05-22,2021,WAS,BAL,12,9,12-9,WAS,9,1,43,42,85,169,194,363,18,16,34,1,3:41
16500,634531,2021-04-16,2021,SDN,LAN,6,11,11-6,LAN,12,0,54,55,109,216,204,420,20,18,38,5,4:57
16501,634111,2021-05-15,2021,DET,CHN,9,8,9-8,DET,10,0,51,44,95,162,209,371,22,14,36,4,4:06
16502,634089,2021-05-21,2021,MIA,NYN,5,6,6-5,NYN,12,0,49,45,94,166,199,365,17,12,29,2,4:38
16503,634467,2021-04-24,2021,MIN,PIT,2,6,6-2,PIT,9,0,33,38,71,142,124,266,5,11,16,2,2:43
16504,634243,2021-05-03,2021,SDN,PIT,2,0,2-0,SDN,9,1,30,34,64,134,106,240,6,7,13,1,2:41
16505,634132,2021-05-14,2021,SDN,SLN,5,4,5-4,SDN,9,1,41,41,82,171,184,355,19,17,36,3,4:08
16506,633937,2021-05-27,2021,MIL,SDN,6,5,6-5,MIL,10,0,43,41,84,170,186,356,14,12,26,1,3:51
16507,634238,2021-05-12,2021,ATL,TOR,1,4,4-1,TOR,9,0,34,33,67,133,121,254,7,8,15,0,2:42
16508,634395,2021-04-24,2021,SLN,CIN,2,0,2-0,SLN,9,1,34,32,66,120,124,244,9,6,15,0,2:33 (2:20 delay)
16509,633921,2021-05-28,2021,LAN,SFN,5,8,8-5,SFN,10,0,46,42,88,167,172,339,15,14,29,3,3:43
16510,634020,2021-05-20,2021,CIN,SFN,4,19,19-4,SFN,9,0,38,51,89,205,185,390,12,24,36,3,3:47
16511,634369,2021-04-23,2021,SFN,MIA,5,3,5-3,SFN,9,1,37,31,68,127,146,273,16,4,20,2,2:41
16512,634301,2021-05-02,2021,SDN,SFN,1,7,7-1,SFN,9,0,36,39,75,159,143,302,9,12,21,0,3:10
16513,634374,2021-04-26,2021,SFN,COL,12,0,12-0,SFN,9,1,42,31,73,100,155,255,20,4,24,1,2:27
16514,634203,2021-05-07,2021,CLE,CIN,0,3,3-0,CIN,9,0,29,34,63,145,114,259,1,6,7,1,2:34
16515,634339,2021-04-27,2021,CLE,MIN,7,4,7-4,CLE,9,1,39,34,73,115,144,259,15,8,23,4,3:07
16516,634078,2021-05-21,2021,TOR,TBA,7,9,9-7,TBA,12,0,50,53,103,209,175,384,18,22,40,4,4:26
16517,634254,2021-05-04,2021,COL,SFN,8,6,8-6,COL,7,0,33,36,69,146,121,267,13,17,30,4,3:04
16518,634155,2021-05-12,2021,COL,SDN,3,2,3-2,COL,8,0,34,33,67,128,131,259,13,9,22,1,2:55
16519,634368,2021-04-27,2021,TBA,OAK,4,3,4-3,TBA,9,1,38,36,74,128,130,258,12,9,21,0,2:56
16520,634310,2021-04-28,2021,NYN,BOS,0,1,1-0,BOS,9,0,33,31,64,127,147,274,7,5,12,0,2:56
16521,634278,2021-05-04,2021,OAK,TOR,4,1,4-1,OAK,9,1,34,30,64,119,131,250,11,4,15,1,2:18
16522,634343,2021-04-26,2021,TBA,OAK,1,2,2-1,OAK,9,0,36,33,69,124,165,289,10,9,19,0,2:51
16523,634288,2021-04-30,2021,CHA,CLE,3,5,5-3,CLE,9,0,37,35,72,123,138,261,9,9,18,0,2:55
16524,634246,2021-05-04,2021,COL,SFN,4,12,12-4,SFN,7,0,33,36,69,119,130,249,11,16,27,2,2:38
16525,634308,2021-04-28,2021,TBA,OAK,2,0,2-0,TBA,9,1,33,35,68,136,128,264,12,9,21,1,2:45
16526,634200,2021-05-07,2021,SLN,COL,5,0,5-0,SLN,9,1,34,31,65,132,130,262,9,5,14,0,2:42
16527,634128,2021-05-12,2021,NYN,BAL,7,1,7-1,NYN,9,1,36,36,72,129,125,254,12,10,22,1,2:39
16528,634364,2021-04-27,2021,ARI,SDN,5,1,5-1,ARI,9,1,31,33,64,144,127,271,7,7,14,1,2:53
16529,634274,2021-04-30,2021,WAS,MIA,2,1,2-1,WAS,10,0,33,40,73,139,109,248,11,15,26,1,3:02
16530,634093,2021-05-14,2021,TBA,NYN,3,2,3-2,TBA,9,0,36,35,71,119,140,259,11,7,18,2,2:54
16531,634359,2021-04-27,2021,TEX,ANA,6,1,6-1,TEX,9,1,34,37,71,139,138,277,12,11,23,2,2:50
16532,634451,2021-04-26,2021,DET,KCA,2,3,3-2,KCA,9,0,40,35,75,134,153,287,14,8,22,0,2:56
16533,634337,2021-04-30,2021,TEX,BOS,1,6,6-1,BOS,9,0,37,38,75,127,140,267,11,10,21,1,2:45
16534,634387,2021-04-27,2021,BAL,NYA,1,5,5-1,NYA,9,0,37,39,76,141,130,271,11,15,26,4,2:53
16535,634189,2021-05-11,2021,CLE,CHN,3,2,3-2,CLE,9,1,29,39,68,152,126,278,6,16,22,1,2:56
16536,634218,2021-05-09,2021,NYA,WAS,3,2,3-2,NYA,9,0,38,34,72,105,165,270,16,9,25,3,3:04
16537,634154,2021-05-12,2021,BOS,OAK,1,4,4-1,OAK,9,0,36,35,71,137,149,286,9,9,18,0,2:59
16538,634146,2021-05-14,2021,BAL,NYA,4,5,5-4,NYA,9,0,35,35,70,152,117,269,11,9,20,2,2:55
16539,634394,2021-04-26,2021,CLE,MIN,5,3,5-3,CLE,10,0,38,36,74,121,152,273,11,6,17,2,3:10
16540,634253,2021-05-07,2021,TEX,SEA,4,5,5-4,SEA,9,0,35,39,74,158,121,279,13,13,26,2,2:57
16541,634215,2021-05-08,2021,MIA,MIL,2,6,6-2,MIL,9,0,33,41,74,135,135,270,6,14,20,0,3:02
16542,634195,2021-05-07,2021,MIA,MIL,6,1,6-1,MIA,9,1,34,35,69,151,134,285,13,8,21,1,2:59
16543,634110,2021-05-14,2021,SEA,CLE,7,3,7-3,SEA,9,1,35,37,72,142,147,289,12,11,23,3,3:06
16544,634170,2021-05-11,2021,NYN,BAL,3,2,3-2,NYN,9,0,36,38,74,139,122,261,13,12,25,2,3:13
16545,634212,2021-05-08,2021,CHN,PIT,3,2,3-2,CHN,9,1,31,40,71,149,134,283,8,12,20,1,3:13
16546,634266,2021-05-05,2021,WAS,ATL,3,5,5-3,ATL,9,0,37,34,71,121,145,266,11,8,19,1,2:49
16547,634335,2021-04-27,2021,TOR,WAS,9,5,9-5,TOR,9,1,35,38,73,150,131,281,13,13,26,4,2:56
16548,634332,2021-04-27,2021,CHA,DET,2,5,5-2,DET,9,0,38,37,75,154,135,289,12,9,21,1,3:10
16549,634382,2021-04-26,2021,HOU,SEA,5,2,5-2,HOU,9,1,37,36,73,161,130,291,15,9,24,1,3:07
16550,634216,2021-05-07,2021,CHN,PIT,3,2,3-2,CHN,9,1,32,38,70,132,142,274,10,13,23,2,3:07
16551,634193,2021-05-08,2021,HOU,TOR,4,8,8-4,TOR,9,0,36,38,74,157,137,294,9,10,19,2,3:09
16552,634208,2021-05-12,2021,COL,SDN,3,5,5-3,SDN,7,0,34,30,64,115,156,271,13,9,22,2,3:09
16553,634201,2021-05-07,2021,HOU,TOR,10,4,10-4,HOU,9,1,42,34,76,114,172,286,20,8,28,3,3:14
16554,634279,2021-05-05,2021,MIN,TEX,1,3,3-1,TEX,9,0,36,36,72,149,142,291,10,11,21,2,3:04 (:31 delay)
16555,634365,2021-04-28,2021,LAN,CIN,8,0,8-0,LAN,9,1,39,35,74,134,157,291,17,9,26,3,3:15
16556,634391,2021-04-30,2021,MIN,KCA,9,1,9-1,MIN,9,1,41,32,73,121,170,291,18,7,25,0,3:09
16557,634376,2021-04-25,2021,TBA,TOR,0,1,1-0,TOR,9,0,36,36,72,141,142,283,9,9,18,6,3:13
16558,634426,2021-04-23,2021,CHN,MIL,15,2,15-2,CHN,9,1,46,36,82,143,163,306,23,11,34,1,3:06
16559,634461,2021-04-26,2021,MIL,MIA,0,8,8-0,MIA,9,0,32,41,73,181,127,308,8,14,22,1,3:20
16560,634149,2021-05-11,2021,COL,SDN,1,8,8-1,SDN,9,0,30,44,74,164,115,279,4,16,20,2,3:04
16561,634213,2021-05-07,2021,ANA,LAN,9,2,9-2,ANA,9,1,38,39,77,137,130,267,15,13,28,2,3:05
16562,634180,2021-05-11,2021,ARI,MIA,11,3,11-3,ARI,9,1,41,36,77,139,154,293,19,9,28,2,3:02
16563,634400,2021-04-25,2021,CHN,MIL,0,6,6-0,MIL,9,0,32,43,75,181,128,309,6,15,21,1,3:23
16564,634197,2021-05-08,2021,KCA,CHA,1,9,9-1,CHA,9,0,36,43,79,152,139,291,10,17,27,3,3:04
16565,634227,2021-05-05,2021,SDN,PIT,4,2,4-2,SDN,9,1,38,36,74,143,144,287,13,9,22,1,3:21
16566,634248,2021-05-05,2021,OAK,TOR,4,9,9-4,TOR,9,0,36,41,77,145,154,299,9,15,24,1,3:04
16567,634164,2021-05-11,2021,SFN,TEX,4,2,4-2,SFN,9,1,35,35,70,138,144,282,11,8,19,3,3:00
16568,633918,2021-05-28,2021,HOU,SDN,3,10,10-3,SDN,11,0,49,53,102,199,214,413,20,19,39,2,4:43
16569,634385,2021-04-29,2021,ARI,COL,5,3,5-3,ARI,9,1,40,35,75,144,157,301,15,12,27,1,3:01
16570,634443,2021-04-24,2021,NYN,WAS,1,7,7-1,WAS,9,0,35,42,77,161,136,297,9,16,25,1,3:20
16571,634327,2021-04-30,2021,NYA,DET,10,0,10-0,NYA,9,1,43,31,74,124,197,321,20,5,25,1,3:03
16572,634401,2021-04-23,2021,COL,PHI,5,4,5-4,COL,9,0,37,39,76,150,151,301,12,14,26,2,3:22
16573,634236,2021-05-08,2021,OAK,TBA,6,3,6-3,OAK,9,1,37,41,78,155,151,306,12,14,26,6,3:12
16574,634163,2021-05-11,2021,ATL,TOR,3,5,5-3,TOR,9,0,35,39,74,152,153,305,9,13,22,1,3:15
16575,634237,2021-05-09,2021,CHN,PIT,5,6,6-5,PIT,9,0,36,42,78,145,138,283,9,13,22,1,3:03
16576,634187,2021-05-08,2021,CLE,CIN,9,2,9-2,CLE,9,1,42,36,78,138,167,305,16,10,26,1,3:08
16577,634349,2021-04-25,2021,MIN,PIT,2,6,6-2,PIT,9,0,36,39,75,165,162,327,10,13,23,3,3:31
16578,634235,2021-05-07,2021,KCA,CHA,0,3,3-0,CHA,9,0,36,38,74,167,137,304,8,12,20,0,3:06
16579,634269,2021-05-04,2021,NYA,HOU,7,3,7-3,NYA,9,1,41,33,74,149,179,328,18,9,27,1,3:27
16580,634296,2021-04-29,2021,TBA,OAK,2,3,3-2,OAK,9,0,37,33,70,144,150,294,10,8,18,0,3:04
16581,634354,2021-04-27,2021,SFN,COL,5,7,7-5,COL,10,0,41,44,85,154,140,294,12,14,26,2,3:30
16582,634325,2021-04-30,2021,PIT,SLN,3,7,7-3,SLN,9,0,38,40,78,131,176,307,13,13,26,1,3:19
16583,634229,2021-05-04,2021,MIN,TEX,3,6,6-3,TEX,10,0,35,44,79,187,126,313,6,14,20,3,3:24
16584,634245,2021-05-04,2021,MIA,ARI,9,3,9-3,MIA,9,1,38,40,78,154,149,303,16,12,28,2,3:17
16585,634205,2021-05-09,2021,ANA,LAN,2,1,2-1,ANA,9,1,32,40,72,173,146,319,10,13,23,2,3:26
16586,634348,2021-04-28,2021,TOR,WAS,2,8,8-2,WAS,9,0,36,41,77,160,144,304,10,15,25,1,2:53
16587,634174,2021-05-11,2021,PIT,CIN,7,2,7-2,PIT,9,1,38,35,73,138,150,288,14,10,24,3,3:08
16588,634234,2021-05-07,2021,NYA,WAS,4,11,11-4,WAS,9,0,35,43,78,170,140,310,8,14,22,2,3:01
16589,634435,2021-04-23,2021,CHA,TEX,9,7,9-7,CHA,9,1,41,42,83,190,161,351,18,15,33,5,3:44
16590,634414,2021-04-28,2021,ATL,CHN,10,0,10-0,ATL,9,1,45,36,81,154,168,322,21,8,29,3,2:56
16591,634393,2021-04-25,2021,CHA,TEX,8,4,8-4,CHA,9,1,41,38,79,168,182,350,17,14,31,1,3:32
16592,634275,2021-04-30,2021,TBA,HOU,2,9,9-2,HOU,9,0,37,45,82,174,150,324,11,18,29,0,3:10
16593,634177,2021-05-09,2021,BAL,BOS,3,4,4-3,BOS,9,0,36,38,74,155,148,303,10,11,21,2,2:57
16594,634319,2021-05-01,2021,OAK,BAL,4,8,8-4,BAL,9,0,40,40,80,157,160,317,13,14,27,3,3:10
16595,634192,2021-05-09,2021,HOU,TOR,7,4,7-4,HOU,9,1,39,36,75,150,168,318,17,11,28,3,3:30
16596,634258,2021-05-03,2021,KCA,CLE,6,8,8-6,CLE,9,0,43,44,87,175,159,334,16,19,35,5,3:40
16597,634147,2021-05-11,2021,CHA,MIN,9,3,9-3,CHA,9,1,37,40,77,149,159,308,16,13,29,3,3:23
16598,634251,2021-05-04,2021,CIN,CHA,0,9,9-0,CHA,9,0,33,45,78,193,138,331,6,18,24,1,3:17 (1:06 delay)
16599,634209,2021-05-07,2021,BAL,BOS,2,6,6-2,BOS,9,0,39,39,78,154,162,316,14,11,25,2,3:25 (1:38 delay)
16600,634321,2021-05-04,2021,CHN,LAN,4,3,4-3,CHN,9,0,40,34,74,142,158,300,15,10,25,2,3:46
16601,634347,2021-04-29,2021,ATL,CHN,3,9,9-3,CHN,9,0,37,48,85,168,144,312,11,23,34,2,3:15
16602,634223,2021-05-06,2021,SLN,NYN,1,4,4-1,NYN,9,0,31,48,79,192,128,320,3,20,23,2,3:19 (:32 delay)
16603,634280,2021-04-30,2021,TOR,ATL,13,5,13-5,TOR,9,1,46,36,82,155,170,325,21,11,32,4,3:17
16604,634114,2021-05-13,2021,ATL,TOR,4,8,8-4,TOR,9,0,35,43,78,158,148,306,8,17,25,3,3:14
16605,634240,2021-05-07,2021,SFN,SDN,5,4,5-4,SFN,9,1,36,36,72,169,162,331,12,9,21,4,3:34
16606,634305,2021-04-30,2021,CIN,CHN,8,6,8-6,CIN,9,1,36,43,79,194,144,338,11,17,28,3,3:21
16607,634204,2021-05-07,2021,DET,MIN,3,7,7-3,MIN,9,0,37,43,80,185,159,344,11,16,27,0,3:21 (1:44 delay)
16608,634402,2021-04-26,2021,ATL,CHN,8,7,8-7,ATL,9,1,42,41,83,153,172,325,18,13,31,3,3:29
16609,634129,2021-05-12,2021,CLE,CHN,2,1,2-1,CLE,10,0,38,45,83,190,134,324,14,17,31,3,3:50
16610,634151,2021-05-12,2021,WAS,PHI,2,5,5-2,PHI,10,0,43,44,87,169,162,331,14,17,31,2,3:46
16611,634277,2021-05-04,2021,KCA,CLE,3,7,7-3,CLE,9,0,39,40,79,178,155,333,14,13,27,5,3:39
16612,634219,2021-05-07,2021,ATL,PHI,2,12,12-2,PHI,9,0,32,49,81,215,134,349,6,22,28,3,3:23
16613,634160,2021-05-12,2021,CHA,MIN,13,8,13-8,CHA,9,1,43,41,84,154,187,341,19,16,35,4,3:45
16614,634252,2021-05-07,2021,NYN,ARI,5,4,5-4,NYN,10,0,44,46,90,171,158,329,17,16,33,1,3:52
16615,634226,2021-05-05,2021,KCA,CLE,4,5,5-4,CLE,9,0,37,36,73,144,149,293,11,9,20,1,3:09
16616,634179,2021-05-11,2021,DET,KCA,8,7,8-7,DET,9,0,46,42,88,158,186,344,21,16,37,4,3:40
16617,634315,2021-04-28,2021,PIT,KCA,6,9,9-6,KCA,9,0,42,45,87,195,171,366,15,19,34,4,3:55
16618,634144,2021-05-11,2021,WAS,PHI,2,6,6-2,PHI,9,0,39,45,84,190,180,370,12,18,30,4,3:58
16619,634262,2021-05-08,2021,ANA,LAN,11,14,14-11,LAN,9,0,42,52,94,206,161,367,15,26,41,3,4:03
16620,634159,2021-05-11,2021,MIL,SLN,1,6,6-1,SLN,11,0,44,44,88,166,170,336,13,10,23,1,3:55
16621,634255,2021-05-06,2021,BOS,DET,12,9,12-9,BOS,9,1,48,47,95,182,194,376,21,18,39,5,4:13
16622,634199,2021-05-08,2021,ATL,PHI,8,7,8-7,ATL,12,0,54,51,105,207,199,406,23,16,39,3,4:47
16623,634356,2021-04-25,2021,LAN,SDN,7,8,8-7,SDN,11,0,56,50,106,200,222,422,25,17,42,1,4:59
16624,634425,2021-04-18,2021,MIA,SFN,0,1,1-0,SFN,9,0,29,39,68,148,111,259,4,11,15,1,2:53
16625,634186,2021-05-12,2021,DET,KCA,4,2,4-2,DET,9,1,35,34,69,136,137,273,11,8,19,0,2:42
16626,634413,2021-04-23,2021,TBA,TOR,3,5,5-3,TOR,9,0,37,35,72,128,144,272,8,8,16,1,2:46
16627,634412,2021-04-23,2021,DET,KCA,2,6,6-2,KCA,9,0,34,40,74,154,145,299,8,14,22,2,3:02
16628,634386,2021-04-23,2021,BOS,SEA,6,5,6-5,BOS,9,1,38,41,79,179,159,338,14,15,29,3,3:28
16629,634207,2021-05-09,2021,MIA,MIL,1,2,2-1,MIL,10,0,37,40,77,152,147,299,9,12,21,0,3:15
16630,634185,2021-05-09,2021,SFN,SDN,1,11,11-1,SDN,9,0,37,47,84,162,151,313,11,20,31,0,3:08
16631,633256,2021-07-18,2021,TOR,TEX,5,0,5-0,TOR,7,1,27,25,52,83,98,181,9,4,13,1,1:48
16632,633745,2021-06-12,2021,WAS,SFN,2,0,2-0,WAS,7,1,22,25,47,108,85,193,6,5,11,0,2:10
16633,633745,2021-06-12,2021,WAS,SFN,2,0,2-0,WAS,7,1,22,25,47,108,85,193,6,5,11,0,2:10
16634,633760,2021-06-21,2021,NYN,ATL,4,2,4-2,NYN,7,1,27,26,53,103,94,197,9,5,14,1,2:12
16635,633292,2021-07-18,2021,TOR,TEX,10,0,10-0,TOR,7,1,29,24,53,91,98,189,11,4,15,1,1:51
16636,633360,2021-07-07,2021,TBA,CLE,4,0,4-0,TBA,7,1,29,23,52,97,117,214,11,2,13,2,2:04
16637,633565,2021-06-20,2021,ATL,SLN,1,0,1-0,ATL,7,1,22,26,48,109,81,190,5,5,10,1,1:58
16638,633530,2021-06-26,2021,DET,HOU,3,1,3-1,DET,7,1,24,29,53,124,86,210,6,8,14,0,2:06
16639,633435,2021-06-30,2021,CIN,SDN,5,7,7-5,SDN,6,1,22,26,48,96,94,190,8,11,19,1,2:03 (2:10 delay)
16640,633188,2021-07-24,2021,LAN,COL,1,0,1-0,LAN,9,1,28,33,61,122,98,220,5,6,11,2,2:38
16641,633476,2021-07-19,2021,CHA,MIN,5,3,5-3,CHA,7,0,24,25,49,94,94,188,6,6,12,0,1:54
16642,633899,2021-06-21,2021,NYN,ATL,0,1,1-0,ATL,7,0,26,28,54,120,112,232,7,7,14,1,2:33
16643,633794,2021-06-06,2021,PIT,MIA,1,3,3-1,MIA,9,0,34,34,68,122,115,237,9,8,17,0,2:40
16644,633859,2021-06-03,2021,CHA,DET,4,1,4-1,CHA,9,1,30,34,64,129,106,235,6,7,13,0,2:29
16645,633862,2021-06-04,2021,PHI,WAS,1,2,2-1,WAS,9,0,32,33,65,122,128,250,8,9,17,3,2:56
16646,633709,2021-06-16,2021,SLN,MIA,1,0,1-0,SLN,9,0,32,34,66,117,108,225,8,8,16,1,2:40
16647,633192,2021-07-25,2021,PHI,ATL,2,1,2-1,PHI,9,1,29,32,61,120,107,227,6,4,10,1,2:30
16648,633162,2021-07-28,2021,BOS,TOR,1,4,4-1,TOR,7,0,29,29,58,102,122,224,8,9,17,1,2:36
16649,633739,2021-06-09,2021,SDN,CHN,1,3,3-1,CHN,9,0,32,30,62,126,134,260,5,6,11,0,2:58
16650,633837,2021-06-04,2021,ANA,SEA,3,2,3-2,ANA,9,1,31,34,65,124,120,244,11,7,18,2,2:42
16651,633774,2021-06-06,2021,CHA,DET,3,0,3-0,CHA,9,1,34,33,67,124,121,245,10,6,16,0,2:36
16652,633523,2021-06-25,2021,SFN,OAK,2,0,2-0,SFN,9,1,31,36,67,127,116,243,8,8,16,1,2:23
16653,633394,2021-09-20,2021,CLE,KCA,2,4,4-2,KCA,7,0,24,29,53,135,103,238,4,10,14,3,2:37
16654,633209,2021-07-24,2021,MIN,ANA,1,2,2-1,ANA,9,0,32,33,65,127,115,242,5,5,10,2,2:34
16655,633799,2021-06-05,2021,KCA,MIN,4,5,5-4,MIN,9,0,35,34,69,112,128,240,9,8,17,0,2:37
16656,633247,2021-07-18,2021,CHA,HOU,4,0,4-0,CHA,9,1,34,28,62,119,108,227,11,1,12,1,2:28
16657,633880,2021-06-01,2021,CHN,SDN,4,3,4-3,CHN,9,1,34,35,69,117,136,253,10,8,18,0,2:52
16658,633813,2021-06-08,2021,MIA,COL,6,2,6-2,MIA,9,1,37,31,68,104,137,241,14,6,20,1,2:45
16659,633836,2021-06-03,2021,ATL,WAS,5,1,5-1,ATL,9,1,34,36,70,137,121,258,10,9,19,2,2:47
16660,633798,2021-06-06,2021,MIL,ARI,2,0,2-0,MIL,9,1,34,33,67,135,124,259,11,6,17,0,3:04
16661,633373,2021-07-09,2021,CLE,KCA,2,1,2-1,CLE,9,0,32,32,64,123,122,245,9,5,14,1,2:26
16662,633818,2021-06-04,2021,BAL,CLE,3,1,3-1,BAL,9,1,32,36,68,138,129,267,11,9,20,0,2:50
16663,633704,2021-06-12,2021,MIA,ATL,4,2,4-2,MIA,9,1,33,34,67,121,127,248,11,8,19,1,2:47
16664,633842,2021-06-02,2021,HOU,BOS,2,1,2-1,HOU,9,1,30,36,66,127,136,263,7,9,16,1,2:57
16665,633846,2021-06-04,2021,MIL,ARI,5,1,5-1,MIL,9,1,33,31,64,132,140,272,10,4,14,2,2:40
16666,633220,2021-07-22,2021,MIN,ANA,2,3,3-2,ANA,9,0,33,33,66,127,117,244,9,7,16,0,2:38
16667,633689,2021-06-13,2021,CHN,SLN,2,0,2-0,CHN,9,1,31,32,63,130,113,243,6,5,11,1,2:34
16668,633203,2021-07-21,2021,DET,TEX,4,2,4-2,DET,9,1,31,35,66,123,123,246,8,9,17,0,2:27
16669,633283,2021-07-16,2021,PHI,MIA,5,2,5-2,PHI,7,1,29,28,57,117,125,242,11,8,19,1,2:35
16670,633065,2021-07-29,2021,SDN,COL,3,0,3-0,SDN,9,1,32,33,65,120,118,238,11,6,17,0,2:53
16671,633746,2021-06-11,2021,WAS,SFN,0,1,1-0,SFN,9,0,28,31,59,130,103,233,3,4,7,2,2:30
16672,633848,2021-06-02,2021,COL,TEX,6,3,6-3,COL,9,1,39,35,74,110,137,247,15,8,23,2,2:49
16673,633610,2021-06-20,2021,ATL,SLN,1,9,9-1,SLN,7,0,26,36,62,113,111,224,6,15,21,1,2:16
16674,633342,2021-07-07,2021,NYN,MIL,0,5,5-0,MIL,7,0,25,31,56,127,103,230,6,11,17,1,2:26
16675,633700,2021-06-14,2021,BOS,TOR,2,1,2-1,BOS,9,0,32,31,63,111,134,245,8,5,13,1,2:42
16676,633676,2021-06-15,2021,CHA,TBA,3,0,3-0,CHA,9,1,33,34,67,136,132,268,10,8,18,0,2:42
16677,633179,2021-07-25,2021,MIN,ANA,2,6,6-2,ANA,9,0,34,37,71,120,121,241,7,12,19,2,2:42
16678,633198,2021-07-25,2021,BOS,NYA,5,4,5-4,BOS,9,1,31,39,70,128,112,240,6,15,21,3,2:50
16679,633692,2021-06-17,2021,NYN,CHN,0,2,2-0,CHN,9,0,30,32,62,115,132,247,4,5,9,0,2:48
16680,633610,2021-06-20,2021,ATL,SLN,1,9,9-1,SLN,7,0,26,36,62,113,111,224,6,15,21,1,2:16
16681,633781,2021-06-11,2021,TBA,BAL,4,2,4-2,TBA,9,1,35,33,68,118,158,276,13,6,19,1,2:54
16682,633772,2021-06-08,2021,PIT,LAN,3,5,5-3,LAN,9,0,34,38,72,128,135,263,7,12,19,2,2:55 (:30 delay)
16683,633835,2021-06-03,2021,PIT,MIA,5,3,5-3,PIT,9,1,33,36,69,118,128,246,9,9,18,4,3:01
16684,633673,2021-06-14,2021,CHA,TBA,2,5,5-2,TBA,9,0,33,37,70,150,112,262,7,12,19,0,2:46
16685,633816,2021-06-04,2021,SDN,NYN,2,0,2-0,SDN,9,1,33,32,65,137,120,257,10,5,15,2,3:07
16686,633824,2021-06-04,2021,NYA,BOS,2,5,5-2,BOS,9,0,35,36,71,120,133,253,9,9,18,1,2:49
16687,633367,2021-07-09,2021,SDN,COL,4,2,4-2,SDN,9,1,35,37,72,138,107,245,14,11,25,3,3:00
16688,633715,2021-06-13,2021,PHI,NYA,7,0,7-0,PHI,9,1,37,31,68,121,132,253,14,5,19,2,2:57
16689,633703,2021-06-14,2021,COL,SDN,3,2,3-2,COL,9,1,34,31,65,118,141,259,11,5,16,0,2:37
16690,633176,2021-07-23,2021,BAL,WAS,6,1,6-1,BAL,9,1,32,35,67,149,121,270,7,8,15,3,2:47
16691,633629,2021-06-20,2021,CHN,MIA,2,0,2-0,CHN,9,1,30,33,63,115,129,244,9,6,15,1,2:52
16692,633136,2021-07-25,2021,HOU,TEX,3,1,3-1,HOU,9,1,31,34,65,121,134,255,10,8,18,4,2:59
16693,633183,2021-07-25,2021,KCA,DET,6,1,6-1,KCA,9,1,32,33,65,117,138,255,9,8,17,1,2:22
16694,633094,2021-07-30,2021,WAS,CHN,4,3,4-3,WAS,9,1,35,35,70,127,114,241,12,9,21,2,2:47
16695,633465,2021-06-28,2021,COL,PIT,2,0,2-0,COL,9,1,34,35,69,125,119,244,9,8,17,1,3:02
16696,633212,2021-07-20,2021,DET,TEX,4,1,4-1,DET,9,1,33,30,63,130,120,250,10,4,14,1,2:33
16697,633853,2021-06-02,2021,BAL,MIN,6,3,6-3,BAL,9,1,38,35,73,136,120,256,16,9,25,3,2:54
16698,634647,2021-06-19,2021,WAS,NYN,1,5,5-1,NYN,7,0,32,29,61,84,157,241,12,8,20,2,2:47
16699,633857,2021-06-01,2021,TOR,MIA,5,1,5-1,TOR,9,1,35,36,71,141,127,268,11,11,22,0,2:45
16700,633743,2021-06-11,2021,CLE,SEA,7,0,7-0,CLE,9,1,42,31,73,108,170,278,20,4,24,0,2:56
16701,633737,2021-06-13,2021,TBA,BAL,7,1,7-1,TBA,9,1,38,30,68,127,139,266,16,5,21,2,2:48
16702,633847,2021-06-06,2021,COL,OAK,3,1,3-1,COL,9,1,36,36,72,132,134,266,13,9,22,0,2:59
16703,633566,2021-06-20,2021,SDN,CIN,3,2,3-2,SDN,9,1,34,38,72,144,129,273,12,12,24,0,3:00
16704,633744,2021-06-10,2021,PIT,LAN,3,6,6-3,LAN,8,1,26,40,66,164,99,263,6,20,26,3,2:50 (1:15 delay)
16705,633866,2021-09-23,2021,CLE,CHA,2,7,7-2,CHA,7,0,28,34,62,136,133,269,9,15,24,2,2:46
16706,633705,2021-06-14,2021,CLE,BAL,4,3,4-3,CLE,9,1,29,34,63,143,106,249,6,9,15,3,2:46 (:56 delay)
16707,633194,2021-07-25,2021,CLE,TBA,3,2,3-2,CLE,9,1,33,35,68,136,121,257,9,8,17,1,2:46
16708,633240,2021-07-20,2021,ATL,SDN,2,1,2-1,ATL,9,1,32,35,67,111,132,243,8,8,16,2,2:50
16709,633618,2021-06-18,2021,WAS,NYN,1,0,1-0,WAS,9,0,32,31,63,117,142,259,10,7,17,2,3:04
16710,633839,2021-06-05,2021,TEX,TBA,0,3,3-0,TBA,9,0,29,33,62,136,127,263,5,6,11,1,2:43
16711,633702,2021-06-18,2021,HOU,CHA,2,1,2-1,HOU,9,0,32,36,68,127,131,258,8,10,18,0,2:46
16712,633278,2021-07-19,2021,CHA,MIN,2,3,3-2,MIN,8,0,32,33,65,107,145,252,7,8,15,1,2:45
16713,633232,2021-07-23,2021,KCA,DET,5,3,5-3,KCA,9,1,33,36,69,138,125,263,9,11,20,2,2:50
16714,633080,2021-07-31,2021,ANA,OAK,1,0,1-0,ANA,9,1,31,35,66,138,112,250,6,8,14,3,2:43
16715,633292,2021-07-18,2021,TOR,TEX,10,0,10-0,TOR,7,1,29,24,53,91,98,189,11,4,15,1,1:51
16716,633733,2021-06-10,2021,CHA,TOR,5,2,5-2,CHA,9,1,32,36,68,150,137,287,9,10,19,0,2:43
16717,633776,2021-06-09,2021,ANA,KCA,6,1,6-1,ANA,9,1,36,36,72,126,146,272,14,9,23,2,2:53
16718,633698,2021-06-12,2021,WAS,SFN,1,2,2-1,SFN,8,0,28,34,62,143,127,270,6,10,16,1,3:05
16719,633800,2021-06-05,2021,TOR,HOU,6,2,6-2,TOR,9,1,36,36,72,132,139,271,14,12,26,1,2:50
16720,633441,2021-07-03,2021,CIN,CHN,3,2,3-2,CIN,9,1,30,38,68,161,103,264,7,11,18,3,2:58
16721,633765,2021-06-08,2021,OAK,ARI,5,2,5-2,OAK,9,1,35,33,68,113,150,263,11,6,17,1,2:44
16722,633594,2021-06-19,2021,TEX,MIN,2,3,3-2,MIN,9,0,34,34,68,113,127,240,8,7,15,0,2:42
16723,633797,2021-06-05,2021,SLN,CIN,2,5,5-2,CIN,9,0,35,41,76,154,120,274,8,14,22,1,3:06
16724,633831,2021-06-03,2021,HOU,BOS,1,5,5-1,BOS,9,0,34,41,75,185,105,290,8,16,24,1,3:07
16725,633864,2021-06-01,2021,SFN,ANA,1,8,8-1,ANA,9,0,33,40,73,150,128,278,7,14,21,2,2:52
16726,633833,2021-06-03,2021,KCA,MIN,6,5,6-5,KCA,9,1,36,38,74,149,119,268,12,13,25,1,3:02
16727,633830,2021-06-04,2021,TEX,TBA,5,4,5-4,TEX,9,1,34,37,71,141,108,249,10,12,22,1,2:47
16728,633403,2021-07-03,2021,TOR,TBA,6,3,6-3,TOR,9,1,33,37,70,154,115,269,8,10,18,3,2:45
16729,633217,2021-07-21,2021,LAN,SFN,2,4,4-2,SFN,9,0,33,36,69,143,130,273,6,10,16,1,2:58
16730,633337,2021-09-24,2021,CHN,SLN,4,12,12-4,SLN,7,0,30,39,69,150,103,253,9,19,28,3,2:41
16731,633261,2021-07-17,2021,COL,LAN,2,9,9-2,LAN,9,0,33,40,73,142,113,255,6,13,19,1,2:56
16732,633628,2021-06-16,2021,WAS,PIT,3,1,3-1,WAS,9,1,35,37,72,123,142,265,12,10,22,2,2:59
16733,633314,2021-07-11,2021,SDN,COL,1,3,3-1,COL,9,0,34,38,72,125,138,263,8,12,20,2,3:13
16734,633121,2021-07-26,2021,KCA,CHA,4,3,4-3,KCA,9,1,34,34,68,134,130,264,11,8,19,0,2:36
16735,633687,2021-06-17,2021,HOU,CHA,10,2,10-2,HOU,9,1,39,32,71,113,153,266,14,5,19,1,2:45
16736,633681,2021-06-15,2021,NYN,CHN,3,2,3-2,NYN,9,1,37,35,72,129,130,259,14,9,23,1,3:05
16737,633467,2021-06-30,2021,BOS,KCA,6,2,6-2,BOS,9,1,35,33,68,134,126,260,11,9,20,2,2:55 (2:21 delay)
16738,633291,2021-08-17,2021,NYA,BOS,5,3,5-3,NYA,7,1,33,29,62,118,127,245,15,10,25,4,2:56
16739,633395,2021-07-07,2021,NYN,MIL,4,3,4-3,NYN,8,0,32,30,62,111,124,235,11,7,18,1,2:45
16740,633390,2021-07-03,2021,PHI,SDN,4,2,4-2,PHI,9,1,34,31,65,123,137,260,11,6,17,0,2:50 (2:46 delay)
16741,633166,2021-07-27,2021,KCA,CHA,3,5,5-3,CHA,9,0,33,35,68,129,127,256,8,11,19,1,2:35
16742,633581,2021-09-14,2021,MIN,CLE,1,3,3-1,CLE,7,0,24,29,53,99,83,182,4,8,12,1,2:06
16743,633877,2021-06-01,2021,CLE,CHA,6,5,6-5,CLE,9,1,35,40,75,145,144,289,10,14,24,1,3:00
16744,633615,2021-06-18,2021,SEA,TBA,5,1,5-1,SEA,9,1,36,35,71,126,124,250,15,8,23,1,2:48
16745,633748,2021-06-10,2021,MIA,COL,11,4,11-4,MIA,9,1,42,36,78,124,155,279,19,8,27,1,3:03
16746,633472,2021-06-27,2021,LAN,CHN,7,1,7-1,LAN,9,1,36,31,67,114,133,247,12,5,17,0,2:42
16747,633481,2021-07-01,2021,WAS,LAN,2,6,6-2,LAN,5,0,21,26,47,103,74,177,8,10,18,2,1:56 (1:17 delay)
16748,633819,2021-06-03,2021,NYA,TBA,2,9,9-2,TBA,9,0,33,42,75,170,113,283,6,15,21,1,2:58
16749,633736,2021-06-12,2021,MIN,HOU,5,2,5-2,MIN,9,1,36,33,69,123,156,279,13,7,20,2,3:20
16750,633611,2021-06-20,2021,SFN,PHI,11,2,11-2,SFN,9,1,43,32,75,108,169,277,18,5,23,2,2:51
16751,633652,2021-06-14,2021,LAN,PHI,3,1,3-1,LAN,9,1,28,38,66,157,122,279,4,11,15,4,3:09
16752,633091,2021-07-30,2021,TOR,KCA,6,4,6-4,TOR,9,1,36,35,71,125,149,274,14,8,22,1,2:50 (:21 delay)
16753,633810,2021-06-06,2021,ATL,LAN,4,2,4-2,ATL,9,1,37,34,71,126,147,273,13,7,20,2,3:21
16754,633280,2021-07-18,2021,DET,MIN,7,0,7-0,DET,9,1,36,34,70,128,113,241,12,11,23,0,2:30
16755,633665,2021-06-16,2021,MIL,CIN,1,2,2-1,CIN,9,0,36,33,69,132,159,291,9,9,18,1,2:56
16756,633771,2021-06-11,2021,NYN,SDN,3,2,3-2,NYN,9,1,32,32,64,132,114,246,11,6,17,3,3:00
16757,633550,2021-06-20,2021,PIT,CLE,1,2,2-1,CLE,9,0,35,33,68,112,120,232,9,6,15,1,2:31
16758,633557,2021-06-20,2021,WAS,NYN,5,2,5-2,WAS,9,1,36,31,67,123,116,239,14,5,19,2,2:49
16759,633693,2021-06-14,2021,WAS,PIT,3,2,3-2,WAS,9,1,34,36,70,136,122,258,10,10,20,2,2:55
16760,633796,2021-06-07,2021,ANA,KCA,8,3,8-3,ANA,9,1,36,36,72,124,160,284,14,11,25,3,3:02
16761,633691,2021-06-17,2021,ATL,SLN,4,0,4-0,ATL,9,1,36,31,67,128,143,271,13,5,18,3,2:54
16762,633815,2021-06-04,2021,TOR,HOU,1,13,13-1,HOU,9,0,32,48,80,179,102,281,7,21,28,2,2:58
16763,633407,2021-07-09,2021,MIL,CIN,0,2,2-0,CIN,9,0,34,38,72,137,116,253,10,14,24,1,2:50
16764,633886,2021-06-05,2021,SFN,CHN,4,3,4-3,SFN,9,1,36,33,69,132,164,296,14,4,18,1,3:04
16765,633809,2021-06-03,2021,SLN,CIN,2,4,4-2,CIN,9,0,37,41,78,148,140,288,11,15,26,0,3:07
16766,633954,2021-06-02,2021,SEA,OAK,0,6,6-0,OAK,9,0,31,38,69,146,111,257,6,11,17,0,2:37
16767,633711,2021-06-13,2021,CIN,COL,6,2,6-2,CIN,9,1,35,41,76,162,125,287,12,14,26,3,3:11
16768,633521,2021-06-25,2021,CIN,ATL,2,3,3-2,ATL,9,0,36,38,74,144,125,269,11,11,22,1,3:03
16769,633228,2021-07-18,2021,SLN,SFN,2,1,2-1,SLN,9,1,31,38,69,160,117,277,7,12,19,1,3:02
16770,633107,2021-07-30,2021,DET,BAL,3,4,4-3,BAL,9,0,37,36,73,129,142,271,11,10,21,3,2:52
16771,633764,2021-06-09,2021,PHI,ATL,2,1,2-1,PHI,9,0,34,35,69,131,127,258,7,10,17,0,2:51
16772,633823,2021-06-03,2021,SFN,CHN,7,2,7-2,SFN,9,1,39,31,70,115,175,290,16,5,21,2,3:05
16773,633883,2021-06-02,2021,ATL,WAS,3,5,5-3,WAS,9,0,37,38,75,142,145,287,10,12,22,3,3:24
16774,633677,2021-06-16,2021,LAN,PHI,0,2,2-0,PHI,9,0,37,38,75,146,130,276,11,13,24,0,3:15
16775,633607,2021-06-18,2021,ATL,SLN,9,1,9-1,ATL,9,1,42,31,73,123,149,272,20,6,26,1,2:51
16776,633170,2021-07-23,2021,CHN,ARI,8,3,8-3,CHN,9,1,35,39,74,164,130,294,13,12,25,1,3:11
16777,633501,2021-06-26,2021,CHA,SEA,2,3,3-2,SEA,9,0,34,37,71,149,142,291,10,10,20,3,3:17 (1:38 delay)
16778,633600,2021-06-18,2021,SFN,PHI,5,3,5-3,SFN,9,1,35,32,67,128,149,277,10,7,17,0,3:02
16779,633225,2021-07-21,2021,TBA,BAL,5,4,5-4,TBA,9,0,39,36,75,118,164,282,13,11,24,2,2:51
16780,633366,2021-07-09,2021,MIN,DET,4,2,4-2,MIN,9,1,32,35,67,151,116,267,8,10,18,4,2:57
16781,633678,2021-06-14,2021,NYN,CHN,5,2,5-2,NYN,9,1,35,30,65,130,135,265,15,5,20,3,3:10
16782,633575,2021-06-20,2021,NYA,OAK,2,1,2-1,NYA,9,1,29,34,63,146,133,279,5,9,14,2,3:01
16783,633710,2021-06-13,2021,WAS,SFN,5,0,5-0,WAS,9,1,38,32,70,118,135,253,14,5,19,1,2:49
16784,633791,2021-06-09,2021,CIN,MIL,7,3,7-3,CIN,9,1,39,41,80,142,151,293,15,14,29,1,3:17
16785,633171,2021-07-25,2021,SFN,PIT,6,1,6-1,SFN,9,1,37,34,71,126,159,285,13,7,20,2,2:54
16786,633856,2021-06-01,2021,BAL,MIN,7,4,7-4,BAL,9,1,36,42,78,167,139,306,14,16,30,3,3:21
16787,633730,2021-06-12,2021,CIN,COL,10,3,10-3,CIN,9,1,42,35,77,143,148,291,20,9,29,1,3:02
16788,633806,2021-06-06,2021,SDN,NYN,2,6,6-2,NYN,9,0,38,37,75,140,141,281,11,13,24,1,3:17
16789,633722,2021-06-13,2021,NYN,SDN,3,7,7-3,SDN,9,0,37,38,75,157,132,289,10,15,25,2,3:24
16790,633920,2021-06-05,2021,CHA,DET,3,4,4-3,DET,9,0,38,34,72,130,177,307,12,8,20,1,3:05
16791,633251,2021-07-18,2021,ARI,CHN,6,4,6-4,ARI,9,1,41,34,75,99,156,255,22,7,29,4,3:09
16792,633499,2021-06-27,2021,CHA,SEA,7,5,7-5,CHA,7,1,33,31,64,151,127,278,15,11,26,4,2:53
16793,633590,2021-06-19,2021,PIT,CLE,6,3,6-3,PIT,9,1,37,35,72,143,159,302,13,8,21,3,3:14
16794,633626,2021-06-15,2021,SEA,MIN,10,0,10-0,SEA,9,1,43,29,72,118,177,295,19,4,23,0,2:53
16795,633233,2021-07-19,2021,WAS,MIA,18,1,18-1,WAS,9,1,44,34,78,112,154,266,21,9,30,2,2:53
16796,633174,2021-07-25,2021,NYN,TOR,5,4,5-4,NYN,9,1,33,40,73,127,144,271,12,15,27,5,3:18
16797,633533,2021-06-21,2021,ARI,MIL,5,1,5-1,ARI,9,1,38,33,71,116,161,277,16,7,23,1,2:55
16798,633172,2021-07-25,2021,LAN,COL,3,2,3-2,LAN,9,1,34,35,69,142,147,289,10,11,21,0,3:19
16799,633632,2021-06-16,2021,OAK,ANA,8,4,8-4,OAK,9,1,38,37,75,130,134,264,15,11,26,3,2:56
16800,633638,2021-06-18,2021,CHN,MIA,2,10,10-2,MIA,9,0,36,42,78,143,151,294,9,16,25,2,3:21
16801,633336,2021-07-09,2021,MIA,ATL,0,5,5-0,ATL,9,0,32,43,75,162,126,288,5,16,21,0,3:01
16802,633542,2021-06-21,2021,CHN,CLE,0,4,4-0,CLE,9,0,34,35,69,136,145,281,10,8,18,2,3:12
16803,633178,2021-07-22,2021,SLN,CHN,3,2,3-2,SLN,9,1,34,32,66,123,139,262,11,6,17,1,2:49
16804,633893,2021-06-06,2021,KCA,MIN,1,2,2-1,MIN,9,0,32,39,71,148,116,264,8,14,22,2,2:59
16805,633784,2021-06-09,2021,OAK,ARI,4,0,4-0,OAK,9,1,34,34,68,144,151,295,11,6,17,1,2:59
16806,633119,2021-07-30,2021,SLN,MIN,5,1,5-1,SLN,9,1,33,37,70,120,138,258,11,11,22,1,2:45
16807,633196,2021-07-21,2021,CIN,NYN,0,7,7-0,NYN,9,0,29,44,73,170,108,278,3,16,19,1,2:59
16808,633352,2021-07-06,2021,MIN,CHA,1,4,4-1,CHA,9,0,34,34,68,132,146,278,8,6,14,0,2:57
16809,633506,2021-06-30,2021,CLE,DET,1,7,7-1,DET,7,0,27,34,61,139,110,249,4,14,18,1,2:27
16810,634072,2021-06-07,2021,BOS,MIA,5,3,5-3,BOS,9,1,36,44,80,168,143,311,13,18,31,3,3:38
16811,633157,2021-07-26,2021,ANA,COL,6,2,6-2,ANA,9,1,35,36,71,135,141,276,12,9,21,3,3:16
16812,633720,2021-06-11,2021,MIN,HOU,4,6,6-4,HOU,9,0,35,40,75,148,139,287,7,14,21,1,2:58
16813,633803,2021-06-09,2021,BOS,HOU,3,8,8-3,HOU,9,0,32,47,79,169,124,293,5,21,26,1,3:07
16814,634222,2021-07-17,2021,DET,MIN,1,0,1-0,DET,7,1,25,23,48,85,100,185,7,2,9,1,1:55
16815,633751,2021-06-12,2021,BOS,TOR,2,7,7-2,TOR,9,0,36,38,74,152,158,310,10,14,24,2,3:09
16816,633773,2021-06-08,2021,BAL,NYN,10,3,10-3,BAL,9,1,42,32,74,128,176,304,19,6,25,1,3:14
16817,633841,2021-06-03,2021,SDN,NYN,4,3,4-3,SDN,9,1,36,37,73,154,141,295,12,11,23,1,3:35
16818,633619,2021-06-16,2021,HOU,TEX,8,4,8-4,HOU,9,1,39,35,74,149,143,292,16,10,26,2,3:01
16819,633161,2021-07-27,2021,PIT,MIL,0,9,9-0,MIL,9,0,32,43,75,175,117,292,6,17,23,1,2:54
16820,633135,2021-07-25,2021,MIA,SDN,9,3,9-3,MIA,9,1,41,33,74,129,155,284,17,9,26,1,3:04
16821,633204,2021-07-25,2021,CHN,ARI,5,1,5-1,CHN,9,1,34,38,72,155,140,295,11,11,22,4,3:13
16822,633585,2021-06-19,2021,KCA,BOS,1,7,7-1,BOS,9,0,36,38,74,143,147,290,9,12,21,0,2:59
16823,633482,2021-06-27,2021,SLN,PIT,2,7,7-2,PIT,9,0,32,42,74,164,115,279,5,17,22,0,2:53 (1:04 delay)
16824,633244,2021-07-22,2021,LAN,SFN,3,5,5-3,SFN,9,0,36,38,74,140,128,268,9,12,21,3,3:07
16825,633811,2021-06-09,2021,BAL,NYN,1,14,14-1,NYN,9,0,33,43,76,151,115,266,7,19,26,0,2:43
16826,633187,2021-07-21,2021,TOR,BOS,4,7,7-4,BOS,9,0,34,38,72,149,128,277,7,11,18,1,2:54
16827,633777,2021-06-08,2021,SDN,CHN,1,7,7-1,CHN,9,0,33,38,71,138,140,278,8,11,19,1,2:51
16828,633795,2021-06-05,2021,PHI,WAS,5,2,5-2,PHI,9,1,33,39,72,157,125,282,9,11,20,4,3:11
16829,633606,2021-06-19,2021,NYA,OAK,7,5,7-5,NYA,9,1,38,41,79,147,141,288,16,14,30,3,3:14
16830,633189,2021-07-27,2021,CLE,SLN,2,4,4-2,SLN,9,0,33,38,71,161,105,266,8,12,20,1,2:51
16831,633517,2021-06-24,2021,TBA,BOS,1,0,1-0,TBA,9,0,34,34,68,132,137,269,10,9,19,3,3:02
16832,633688,2021-06-13,2021,DET,CHA,1,4,4-1,CHA,9,0,30,43,73,144,128,272,3,16,19,1,2:47
16833,633867,2021-06-28,2021,CIN,PHI,12,4,12-4,CIN,9,1,41,39,80,136,167,303,17,12,29,3,3:18
16834,633895,2021-06-01,2021,COL,TEX,3,2,3-2,COL,11,0,43,38,81,147,159,306,14,6,20,2,3:21
16835,633728,2021-06-13,2021,BOS,TOR,4,18,18-4,TOR,9,0,36,49,85,160,142,302,10,24,34,1,2:54
16836,633741,2021-06-11,2021,CIN,COL,11,5,11-5,CIN,9,1,42,35,77,145,157,302,16,8,24,2,3:09
16837,633081,2021-07-29,2021,PHI,WAS,1,3,3-1,WAS,7,0,26,28,54,100,100,200,7,9,16,0,2:06
16838,633855,2021-06-02,2021,CHN,SDN,6,1,6-1,CHN,9,1,38,35,73,150,156,306,13,9,22,2,3:16
16839,633696,2021-06-13,2021,ARI,ANA,3,10,10-3,ANA,9,0,38,42,80,146,136,282,12,15,27,2,3:05
16840,633793,2021-06-08,2021,BOS,HOU,1,7,7-1,HOU,9,0,36,43,79,177,128,305,9,20,29,1,3:28
16841,633832,2021-06-03,2021,ANA,SEA,2,6,6-2,SEA,9,0,36,39,75,171,139,310,9,14,23,2,3:26
16842,633197,2021-07-24,2021,HOU,TEX,4,1,4-1,HOU,9,1,35,36,71,166,137,303,14,9,23,0,3:10
16843,633313,2021-07-10,2021,MIL,CIN,3,4,4-3,CIN,9,0,37,36,73,164,144,308,14,10,24,2,3:18
16844,633205,2021-07-21,2021,CHA,MIN,2,7,7-2,MIN,9,0,37,40,77,155,149,304,12,14,26,1,3:15
16845,633349,2021-07-07,2021,TEX,DET,3,5,5-3,DET,9,0,37,40,77,153,137,290,11,15,26,2,3:11
16846,633073,2021-07-30,2021,MIA,NYA,1,3,3-1,NYA,9,0,37,38,75,139,152,291,11,14,25,3,3:17
16847,633860,2021-06-03,2021,COL,TEX,11,6,11-6,COL,9,1,43,36,79,140,158,298,19,10,29,1,3:01
16848,633762,2021-06-10,2021,PHI,ATL,4,3,4-3,PHI,10,0,38,38,76,162,140,302,11,9,20,1,3:30
16849,633822,2021-06-08,2021,DET,SEA,5,3,5-3,DET,9,1,35,39,74,149,144,293,12,14,26,1,3:09 (:36 delay)
16850,633828,2021-06-05,2021,ATL,LAN,6,4,6-4,ATL,9,1,36,38,74,155,130,285,14,9,23,1,3:16 (:20 delay)
16851,633826,2021-06-08,2021,ANA,KCA,8,1,8-1,ANA,9,1,35,36,71,142,159,301,12,11,23,1,2:58
16852,633651,2021-06-21,2021,SDN,LAN,6,2,6-2,SDN,9,1,39,35,74,155,155,310,16,7,23,2,3:38
16853,633236,2021-07-19,2021,TBA,BAL,1,6,6-1,BAL,9,0,34,39,73,156,133,289,9,12,21,2,3:09
16854,633223,2021-07-20,2021,MIL,KCA,2,5,5-2,KCA,9,0,37,39,76,155,126,281,11,12,23,2,3:11
16855,633707,2021-06-13,2021,OAK,KCA,6,3,6-3,OAK,9,1,36,38,74,143,145,288,13,12,25,2,3:08
16856,633118,2021-07-30,2021,ANA,OAK,0,2,2-0,OAK,9,0,34,39,73,156,129,285,8,12,20,1,3:18
16857,633609,2021-06-18,2021,NYA,OAK,3,5,5-3,OAK,9,0,32,39,71,145,129,274,6,12,18,2,3:03
16858,633742,2021-06-11,2021,CHN,SLN,8,5,8-5,CHN,9,1,34,38,72,130,138,268,11,13,24,3,3:04
16859,633885,2021-06-01,2021,ARI,NYN,6,5,6-5,ARI,10,0,42,38,80,139,147,286,13,10,23,1,3:27
16860,633656,2021-06-15,2021,OAK,ANA,6,4,6-4,OAK,9,1,36,34,70,130,161,291,12,8,20,2,2:54
16861,633821,2021-06-05,2021,SDN,NYN,0,4,4-0,NYN,9,0,34,44,78,187,126,313,6,17,23,1,3:25
16862,633817,2021-06-04,2021,SFN,CHN,8,5,8-5,SFN,9,1,39,36,75,150,167,317,16,8,24,0,3:14
16863,633560,2021-06-24,2021,TOR,BAL,9,0,9-0,TOR,9,1,39,37,76,151,153,304,15,10,25,1,3:01
16864,633789,2021-06-11,2021,DET,CHA,4,5,5-4,CHA,10,0,39,40,79,142,173,315,10,13,23,0,3:12 (:49 delay)
16865,633659,2021-06-16,2021,CLE,BAL,8,7,8-7,CLE,9,1,38,42,80,166,140,306,15,16,31,1,3:05
16866,633191,2021-07-21,2021,WAS,MIA,1,3,3-1,MIA,10,0,37,38,75,156,137,293,10,8,18,1,3:22
16867,633675,2021-06-15,2021,LAN,PHI,5,3,5-3,LAN,9,1,38,39,77,156,135,291,16,11,27,2,3:23
16868,633286,2021-07-17,2021,ANA,SEA,9,4,9-4,ANA,9,1,39,42,81,172,136,308,15,16,31,3,3:20
16869,633697,2021-06-17,2021,SEA,TBA,6,5,6-5,SEA,9,0,36,37,73,150,137,287,12,11,23,2,3:08
16870,633140,2021-07-24,2021,SEA,OAK,5,4,5-4,SEA,9,0,37,35,72,155,159,314,12,8,20,2,3:26
16871,633277,2021-07-19,2021,HOU,CLE,4,3,4-3,HOU,9,1,36,38,74,151,150,301,12,13,25,2,3:25
16872,633381,2021-07-06,2021,ARI,COL,4,3,4-3,ARI,9,0,38,36,74,149,142,291,13,9,22,2,3:17
16873,633093,2021-07-29,2021,PIT,MIL,0,12,12-0,MIL,9,0,29,46,75,185,96,281,4,19,23,2,3:07
16874,633214,2021-07-23,2021,PHI,ATL,5,1,5-1,PHI,9,1,36,38,74,150,143,293,13,12,25,0,3:10
16875,633716,2021-06-14,2021,SEA,MIN,4,3,4-3,SEA,9,1,36,39,75,140,146,286,14,12,26,0,3:10
16876,633576,2021-06-19,2021,HOU,CHA,7,3,7-3,HOU,9,1,36,37,73,141,137,278,13,10,23,1,3:10
16877,633452,2021-07-02,2021,OAK,BOS,2,3,3-2,BOS,10,0,35,39,74,137,147,284,6,11,17,1,3:04
16878,633208,2021-07-23,2021,HOU,TEX,7,3,7-3,HOU,9,1,37,36,73,147,159,306,11,9,20,3,3:15
16879,633242,2021-07-20,2021,WAS,MIA,6,3,6-3,WAS,9,1,39,34,73,123,131,254,17,7,24,1,2:56
16880,633617,2021-06-17,2021,SDN,CIN,6,4,6-4,SDN,9,0,35,38,73,140,140,280,10,12,22,3,3:07
16881,633699,2021-06-12,2021,TBA,BAL,5,4,5-4,TBA,9,1,38,34,72,126,151,277,14,9,23,4,3:00
16882,633630,2021-06-16,2021,NYN,CHN,6,3,6-3,NYN,9,1,35,36,71,160,116,276,12,7,19,1,3:01
16883,633790,2021-06-10,2021,MIN,NYA,7,5,7-5,MIN,9,0,40,40,80,162,152,314,16,14,30,3,3:31
16884,633584,2021-06-18,2021,PIT,CLE,11,10,11-10,PIT,9,1,37,41,78,153,146,299,14,18,32,3,3:07
16885,633827,2021-06-05,2021,MIL,ARI,7,5,7-5,MIL,9,1,34,39,73,180,123,303,10,13,23,0,3:12
16886,633788,2021-06-08,2021,CHA,TOR,6,1,6-1,CHA,9,1,39,37,76,169,154,323,14,12,26,2,3:34
16887,633258,2021-07-22,2021,DET,TEX,7,5,7-5,DET,9,1,35,41,76,161,132,293,10,14,24,3,3:02
16888,633181,2021-07-23,2021,BOS,NYA,6,2,6-2,BOS,9,1,36,40,76,159,156,315,12,14,26,1,3:26
16889,633858,2021-06-04,2021,PIT,MIA,9,2,9-2,PIT,9,1,39,36,75,148,161,309,17,9,26,2,3:22
16890,633548,2021-06-24,2021,MIA,WAS,3,7,7-3,WAS,9,0,35,41,76,164,140,304,10,14,24,0,3:14
16891,633335,2021-07-07,2021,MIN,CHA,1,6,6-1,CHA,9,0,36,40,76,152,140,292,9,17,26,2,3:09
16892,633718,2021-06-12,2021,OAK,KCA,11,2,11-2,OAK,9,1,44,37,81,146,166,312,20,10,30,3,3:18
16893,633679,2021-06-15,2021,SFN,ARI,9,8,9-8,SFN,9,1,39,41,80,141,143,284,15,15,30,2,3:03
16894,633778,2021-06-08,2021,SLN,CLE,1,10,10-1,CLE,9,0,37,45,82,169,134,303,10,19,29,0,3:10
16895,633364,2021-07-06,2021,TEX,DET,10,5,10-5,TEX,9,1,40,36,76,147,145,292,17,9,26,2,2:50
16896,633088,2021-07-31,2021,SFN,HOU,8,6,8-6,SFN,9,1,41,37,78,114,174,288,18,8,26,2,3:11
16897,633200,2021-07-20,2021,HOU,CLE,9,3,9-3,HOU,9,1,40,38,78,137,160,297,18,11,29,2,3:13
16898,633100,2021-07-30,2021,NYN,CIN,2,6,6-2,CIN,9,0,36,40,76,131,150,281,11,13,24,0,3:02
16899,633254,2021-07-20,2021,ARI,PIT,11,6,11-6,ARI,9,1,41,40,81,135,145,280,18,14,32,2,3:11
16900,633150,2021-07-27,2021,TEX,ARI,5,4,5-4,TEX,9,1,37,35,72,141,141,282,14,12,26,3,3:08
16901,633701,2021-06-15,2021,COL,SDN,8,4,8-4,COL,9,1,39,33,72,128,162,290,15,10,25,3,3:26
16902,633661,2021-06-19,2021,SEA,TBA,6,5,6-5,SEA,10,0,38,38,76,153,154,307,11,8,19,2,3:02
16903,633845,2021-06-05,2021,ANA,SEA,12,5,12-5,ANA,9,1,41,34,75,132,145,277,17,6,23,3,3:00
16904,633152,2021-07-27,2021,PHI,WAS,4,6,6-4,WAS,9,0,40,36,76,126,149,275,12,11,23,2,3:14
16905,633252,2021-07-18,2021,CIN,MIL,0,8,8-0,MIL,9,0,33,44,77,179,118,297,6,18,24,2,3:21
16906,633284,2021-07-18,2021,ANA,SEA,4,7,7-4,SEA,9,0,40,40,80,145,150,295,13,13,26,3,3:20
16907,633165,2021-07-30,2021,TBA,BOS,7,3,7-3,TBA,9,1,38,39,77,161,144,305,15,13,28,0,3:11
16908,633455,2021-06-29,2021,COL,PIT,8,0,8-0,COL,9,1,38,28,66,92,113,205,15,3,18,0,2:18
16909,633162,2021-07-28,2021,BOS,TOR,1,4,4-1,TOR,7,0,29,29,58,102,122,224,8,9,17,1,2:36
16910,633583,2021-06-19,2021,WAS,NYN,6,2,6-2,WAS,7,1,28,30,58,114,96,210,11,9,20,3,2:26
16911,633775,2021-06-09,2021,SLN,CLE,8,2,8-2,SLN,9,1,40,31,71,120,166,286,16,4,20,1,2:59
16912,633299,2021-07-17,2021,PHI,MIA,4,2,4-2,PHI,10,0,38,37,75,154,135,289,10,9,19,0,3:30 (1:15 delay)
16913,633865,2021-06-04,2021,COL,OAK,5,9,9-5,OAK,9,0,40,44,84,163,141,304,14,18,32,4,3:43
16914,633834,2021-06-02,2021,ARI,NYN,6,7,7-6,NYN,9,0,36,42,78,151,143,294,12,17,29,2,3:12
16915,633105,2021-07-31,2021,DET,BAL,2,5,5-2,BAL,9,0,38,42,80,148,144,292,9,14,23,3,2:59
16916,633160,2021-07-27,2021,CHN,CIN,4,7,7-4,CIN,9,0,41,39,80,140,161,301,15,12,27,2,3:12
16917,633227,2021-07-21,2021,MIL,KCA,3,6,6-3,KCA,9,0,35,42,77,170,126,296,9,14,23,1,3:06
16918,633241,2021-07-21,2021,SLN,CHN,3,2,3-2,SLN,10,0,41,43,84,138,159,297,14,16,30,6,4:09
16919,633838,2021-06-04,2021,KCA,MIN,14,5,14-5,KCA,9,1,45,40,85,157,153,310,18,14,32,2,3:16
16920,633494,2021-06-27,2021,DET,HOU,2,1,2-1,DET,10,0,39,38,77,149,166,315,10,10,20,2,3:29
16921,633346,2021-07-16,2021,PIT,NYN,4,1,4-1,PIT,9,1,36,37,73,150,154,304,13,11,24,1,3:30 (:39 delay)
16922,633624,2021-06-17,2021,ANA,DET,7,5,7-5,ANA,9,1,38,39,77,136,128,264,14,15,29,2,2:59
16923,633245,2021-07-20,2021,COL,SEA,4,6,6-4,SEA,9,0,39,40,79,151,146,297,15,14,29,1,3:16
16924,633573,2021-06-19,2021,BAL,TOR,7,10,10-7,TOR,9,0,39,41,80,160,145,305,12,16,28,3,3:10
16925,633531,2021-06-26,2021,BOS,NYA,4,2,4-2,BOS,9,1,35,38,73,162,129,291,12,13,25,2,3:22
16926,633852,2021-06-05,2021,NYA,BOS,3,7,7-3,BOS,9,0,35,40,75,146,142,288,9,15,24,4,3:14
16927,633257,2021-07-20,2021,TBA,BAL,9,3,9-3,TBA,9,1,36,38,74,168,125,293,11,9,20,1,3:00
16928,633462,2021-07-02,2021,CIN,CHN,2,1,2-1,CIN,9,1,30,36,66,162,132,294,6,9,15,3,3:12
16929,633879,2021-06-01,2021,LAN,SLN,2,3,3-2,SLN,9,0,37,37,74,148,150,298,12,9,21,2,3:33
16930,633348,2021-07-09,2021,HOU,NYA,0,4,4-0,NYA,9,0,32,39,71,167,128,295,5,13,18,2,3:14
16931,633604,2021-06-18,2021,ARI,LAN,0,3,3-0,LAN,9,0,33,35,68,158,138,296,6,10,16,1,3:09
16932,633658,2021-06-16,2021,SEA,MIN,2,7,7-2,MIN,9,0,31,39,70,139,146,285,5,14,19,0,2:54
16933,633891,2021-06-01,2021,KCA,PIT,10,5,10-5,KCA,9,1,39,41,80,158,147,305,16,13,29,3,3:28
16934,633840,2021-06-04,2021,CHA,DET,9,8,9-8,CHA,9,0,41,42,83,155,171,326,16,15,31,4,3:27
16935,633766,2021-06-08,2021,TBA,WAS,3,1,3-1,TBA,9,1,39,35,74,156,182,338,16,10,26,4,3:21
16936,633988,2021-06-02,2021,LAN,SLN,14,3,14-3,LAN,9,1,45,37,82,143,190,333,20,10,30,1,3:16
16937,633116,2021-07-30,2021,TEX,SEA,5,9,9-5,SEA,9,0,35,44,79,172,135,307,8,17,25,2,3:17
16938,633417,2021-07-04,2021,NYA,NYN,4,2,4-2,NYA,7,1,24,26,50,115,101,216,7,5,12,2,2:14
16939,633623,2021-06-17,2021,COL,MIL,7,3,7-3,COL,9,1,38,38,76,149,141,290,12,11,23,3,3:29
16940,633684,2021-06-15,2021,WAS,PIT,8,1,8-1,WAS,9,1,38,36,74,116,143,259,15,9,24,1,2:42
16941,633754,2021-06-10,2021,DET,SEA,8,3,8-3,DET,9,1,41,37,78,152,175,327,17,10,27,1,3:21
16942,633612,2021-06-16,2021,KCA,DET,5,6,6-5,DET,9,0,39,44,83,187,132,319,12,19,31,1,3:17
16943,633801,2021-06-08,2021,CIN,MIL,1,5,5-1,MIL,9,0,38,43,81,166,148,314,12,19,31,2,3:39
16944,633295,2021-07-10,2021,NYN,PIT,2,6,6-2,PIT,7,0,28,32,60,117,87,204,7,13,20,0,2:22
16945,633814,2021-06-06,2021,BAL,CLE,18,5,18-5,BAL,9,1,47,37,84,127,182,309,25,12,37,2,3:10
16946,633749,2021-06-13,2021,MIN,HOU,3,14,14-3,HOU,9,0,35,51,86,171,122,293,10,24,34,0,3:11
16947,633396,2021-07-06,2021,SDN,WAS,7,4,7-4,SDN,9,1,38,38,76,148,160,308,15,13,28,3,3:25
16948,633255,2021-07-18,2021,COL,LAN,6,5,6-5,COL,10,0,40,41,81,144,149,293,10,12,22,1,3:32
16949,633753,2021-06-09,2021,PIT,LAN,1,2,2-1,LAN,9,0,38,39,77,140,170,310,12,12,24,3,3:32 (1:10 delay)
16950,633485,2021-06-30,2021,HOU,BAL,2,5,5-2,BAL,9,0,34,40,74,201,139,340,8,13,21,3,3:34
16951,633231,2021-07-22,2021,SEA,OAK,1,4,4-1,OAK,9,0,35,45,80,195,127,322,8,18,26,1,3:23
16952,633464,2021-07-02,2021,TOR,TBA,11,1,11-1,TOR,9,1,41,33,74,139,166,305,16,6,22,2,2:59
16953,634675,2021-07-13,2021,NAS,AAS,2,5,5-2,AAS,9,0,37,38,75,137,141,278,12,11,23,2,3:00
16954,633735,2021-06-11,2021,BOS,TOR,6,5,6-5,BOS,9,0,38,45,83,162,130,292,13,20,33,5,3:31
16955,633717,2021-06-11,2021,OAK,KCA,4,3,4-3,OAK,9,0,35,37,72,122,146,268,11,10,21,2,3:00
16956,633522,2021-07-04,2021,NYA,NYN,5,10,10-5,NYN,7,0,29,40,69,162,111,273,9,20,29,3,3:16
16957,633613,2021-06-19,2021,CHN,MIA,1,11,11-1,MIA,9,0,30,43,73,167,110,277,4,15,19,0,3:07
16958,633395,2021-07-07,2021,NYN,MIL,4,3,4-3,NYN,8,0,32,30,62,111,124,235,11,7,18,1,2:45
16959,633725,2021-06-12,2021,CLE,SEA,5,4,5-4,CLE,10,0,40,44,84,189,145,334,15,15,30,2,3:41
16960,633425,2021-07-04,2021,SEA,TEX,4,1,4-1,SEA,9,1,30,32,62,120,106,226,7,5,12,0,2:22
16961,633712,2021-06-12,2021,ARI,ANA,7,8,8-7,ANA,9,0,38,44,82,167,136,303,11,18,29,1,3:23
16962,633882,2021-06-02,2021,NYA,TBA,4,3,4-3,NYA,9,1,37,39,76,150,181,331,15,11,26,2,3:38
16963,633602,2021-06-20,2021,HOU,CHA,8,2,8-2,HOU,9,1,44,33,77,149,169,318,22,9,31,1,3:18
16964,633844,2021-06-02,2021,TOR,MIA,6,5,6-5,TOR,9,0,42,39,81,159,186,345,17,13,30,3,3:41
16965,633706,2021-06-16,2021,COL,SDN,8,7,8-7,COL,9,0,40,42,82,153,147,300,16,16,32,2,3:27
16966,633133,2021-07-26,2021,MIN,DET,6,5,6-5,MIN,10,0,46,38,84,143,165,308,20,9,29,2,3:46
16967,633738,2021-06-09,2021,MIA,COL,3,4,4-3,COL,9,0,40,39,79,159,168,327,15,14,29,1,3:53
16968,633184,2021-07-23,2021,CIN,SLN,6,5,6-5,CIN,9,1,40,41,81,173,139,312,16,15,31,3,3:43
16969,633768,2021-06-11,2021,MIL,PIT,7,4,7-4,MIL,9,1,40,34,74,143,162,305,18,6,24,2,3:22
16970,633792,2021-06-09,2021,MIN,NYA,6,9,9-6,NYA,9,0,38,44,82,163,141,304,11,18,29,1,3:08 (:11 delay)
16971,633153,2021-07-27,2021,BAL,MIA,3,7,7-3,MIA,9,0,35,44,79,175,122,297,9,17,26,1,3:06
16972,633514,2021-06-24,2021,CIN,ATL,5,3,5-3,CIN,9,1,39,40,79,153,146,299,17,13,30,2,3:12
16973,633268,2021-07-20,2021,CHA,MIN,9,5,9-5,CHA,9,1,40,40,80,168,145,313,15,13,28,3,3:34
16974,633327,2021-07-11,2021,BOS,PHI,4,5,5-4,PHI,9,0,41,37,78,151,155,306,15,10,25,6,3:35
16975,633222,2021-07-21,2021,HOU,CLE,4,5,5-4,CLE,9,0,33,40,73,165,124,289,6,12,18,3,3:07
16976,633783,2021-06-09,2021,CHA,TOR,2,6,6-2,TOR,9,0,35,38,73,153,155,308,8,10,18,1,3:26
16977,633820,2021-06-04,2021,ATL,LAN,5,9,9-5,LAN,9,0,39,40,79,189,162,351,12,12,24,3,3:45
16978,633690,2021-06-13,2021,CLE,SEA,2,6,6-2,SEA,9,0,34,43,77,171,136,307,8,16,24,2,3:17
16979,633593,2021-06-18,2021,BAL,TOR,7,1,7-1,BAL,9,1,39,33,72,128,186,314,16,6,22,3,3:10
16980,633596,2021-06-18,2021,SDN,CIN,8,2,8-2,SDN,9,1,41,36,77,154,160,314,18,9,27,0,3:33
16981,633571,2021-06-22,2021,MIA,TOR,1,2,2-1,TOR,9,0,31,36,67,104,121,225,4,9,13,0,2:34
16982,633339,2021-07-07,2021,TBA,CLE,8,1,8-1,TBA,7,1,28,27,55,106,133,239,10,6,16,2,2:13
16983,633732,2021-06-12,2021,NYN,SDN,4,1,4-1,NYN,9,1,31,33,64,117,113,230,8,8,16,2,2:43
16984,633779,2021-06-07,2021,SDN,CHN,9,4,9-4,SDN,9,1,44,33,77,136,191,327,20,9,29,2,3:42
16985,633723,2021-06-12,2021,LAN,TEX,1,12,12-1,TEX,9,0,34,47,81,185,153,338,8,21,29,2,3:35
16986,633876,2021-06-03,2021,MIL,ARI,7,4,7-4,MIL,9,1,36,45,81,180,137,317,12,18,30,2,3:09
16987,633180,2021-07-22,2021,CLE,TBA,4,5,5-4,TBA,10,0,41,43,84,164,165,329,11,14,25,1,3:39
16988,633634,2021-06-16,2021,CHA,TBA,8,7,8-7,CHA,10,0,41,42,83,178,133,311,13,11,24,2,3:24
16989,633108,2021-07-30,2021,PIT,PHI,7,0,7-0,PIT,9,1,43,34,77,142,187,329,19,7,26,0,3:33
16990,633873,2021-06-01,2021,HOU,BOS,5,1,5-1,HOU,9,1,38,33,71,131,152,283,17,6,23,1,3:23
16991,633211,2021-07-23,2021,CLE,TBA,5,10,10-5,TBA,9,0,38,43,81,151,152,303,12,18,30,2,3:05
16992,633559,2021-06-24,2021,NYA,KCA,8,1,8-1,NYA,9,1,42,37,79,133,180,313,19,11,30,1,3:03
16993,633740,2021-06-12,2021,CHN,SLN,7,2,7-2,CHN,9,1,35,36,71,147,152,299,14,9,23,3,3:19
16994,633622,2021-06-17,2021,SFN,ARI,10,3,10-3,SFN,9,1,42,33,75,109,162,271,19,6,25,1,2:54
16995,633650,2021-06-19,2021,ANA,DET,8,3,8-3,ANA,9,1,41,36,77,132,138,270,18,10,28,4,3:02
16996,633641,2021-06-17,2021,CLE,BAL,10,3,10-3,CLE,9,1,40,38,78,152,154,306,16,10,26,4,3:03
16997,633147,2021-07-27,2021,NYN,ATL,5,12,12-5,ATL,9,0,39,45,84,172,143,315,12,18,30,1,3:10
16998,633193,2021-07-22,2021,BOS,NYA,5,4,5-4,BOS,10,0,41,39,80,174,150,324,12,10,22,3,3:48 (:55 delay)
16999,633577,2021-06-19,2021,COL,MIL,5,6,6-5,MIL,9,0,42,41,83,155,150,305,17,15,32,0,3:40
17000,633756,2021-06-09,2021,TEX,SFN,4,3,4-3,TEX,11,0,38,40,78,150,156,306,10,8,18,1,3:28
17001,633276,2021-07-22,2021,PHI,ATL,2,7,7-2,ATL,9,0,37,41,78,150,150,300,11,15,26,2,3:09
17002,633871,2021-06-01,2021,SEA,OAK,6,12,12-6,OAK,9,0,41,46,87,174,172,346,14,20,34,3,3:33
17003,633758,2021-06-10,2021,BOS,HOU,12,8,12-8,BOS,9,1,45,39,84,173,164,337,20,14,34,3,3:47
17004,633111,2021-07-29,2021,ANA,OAK,0,4,4-0,OAK,9,0,34,38,72,156,139,295,7,11,18,2,3:14
17005,633769,2021-06-15,2021,CLE,BAL,7,2,7-2,CLE,9,1,40,35,75,166,156,322,13,8,21,2,3:21
17006,633300,2021-07-18,2021,WAS,SDN,8,7,8-7,WAS,9,0,46,40,86,155,156,311,23,13,36,0,3:40
17007,633239,2021-07-18,2021,PHI,MIA,7,4,7-4,PHI,9,1,39,39,78,146,139,285,17,13,30,2,3:28
17008,633567,2021-06-20,2021,COL,MIL,6,7,7-6,MIL,9,0,40,40,80,141,163,304,13,15,28,3,3:35
17009,633325,2021-07-11,2021,NYN,PIT,5,6,6-5,PIT,9,0,38,43,81,160,149,309,13,18,31,3,3:27
17010,633558,2021-06-20,2021,KCA,BOS,7,3,7-3,KCA,9,1,42,40,82,140,166,306,18,14,32,3,3:35
17011,633520,2021-06-26,2021,TOR,BAL,12,4,12-4,TOR,9,1,43,35,78,125,171,296,19,9,28,2,2:51
17012,633543,2021-06-25,2021,BOS,NYA,5,3,5-3,BOS,9,1,37,37,74,152,157,309,11,12,23,3,3:37 (:07 delay)
17013,633168,2021-07-26,2021,PHI,WAS,6,5,6-5,PHI,9,0,40,42,82,147,152,299,17,17,34,2,3:37
17014,633505,2021-06-24,2021,LAN,CHN,0,4,4-0,CHN,9,0,33,38,71,152,139,291,8,14,22,1,3:12
17015,633269,2021-07-22,2021,MIA,SDN,2,3,3-2,SDN,9,0,36,44,80,189,137,326,10,17,27,6,3:58
17016,633868,2021-06-01,2021,CIN,PHI,3,17,17-3,PHI,9,0,34,51,85,204,139,343,12,24,36,5,3:36
17017,633861,2021-06-01,2021,NYA,TBA,5,3,5-3,NYA,11,0,45,42,87,186,165,351,14,9,23,1,3:45
17018,633461,2021-06-30,2021,OAK,TEX,3,1,3-1,OAK,9,1,30,35,65,138,110,248,6,8,14,0,2:34
17019,633759,2021-06-09,2021,DET,SEA,6,9,9-6,SEA,11,0,41,47,88,180,160,340,11,19,30,2,3:43
17020,633145,2021-07-26,2021,NYN,ATL,0,2,2-0,ATL,7,0,26,32,58,97,96,193,7,13,20,0,2:12
17021,633382,2021-07-06,2021,SEA,NYA,1,12,12-1,NYA,9,0,36,51,87,210,136,346,9,24,33,1,3:37
17022,633620,2021-06-25,2021,CHA,SEA,3,9,9-3,SEA,9,0,36,48,84,191,145,336,12,22,34,1,3:31
17023,633451,2021-07-02,2021,CLE,HOU,3,6,6-3,HOU,9,0,45,39,84,157,176,333,18,12,30,2,3:29
17024,633287,2021-07-18,2021,KCA,BAL,0,5,5-0,BAL,9,0,36,41,77,166,135,301,9,12,21,1,3:06
17025,633752,2021-06-08,2021,TEX,SFN,4,9,9-4,SFN,9,0,36,44,80,182,145,327,13,19,32,4,3:28
17026,633502,2021-06-24,2021,SLN,PIT,2,8,8-2,PIT,9,0,35,45,80,157,147,304,10,21,31,2,3:10
17027,633780,2021-06-06,2021,TOR,HOU,3,6,6-3,HOU,9,0,37,46,83,177,134,311,10,19,29,4,3:32
17028,633608,2021-06-25,2021,LAN,CHN,6,2,6-2,LAN,9,1,39,37,76,152,148,300,14,10,24,5,3:42
17029,633522,2021-07-04,2021,NYA,NYN,5,10,10-5,NYN,7,0,29,40,69,162,111,273,9,20,29,3,3:16
17030,633683,2021-06-18,2021,KCA,BOS,5,3,5-3,KCA,9,1,37,38,75,152,149,301,15,13,28,1,3:20
17031,633850,2021-06-05,2021,COL,OAK,3,6,6-3,OAK,9,0,37,40,77,119,124,243,12,16,28,1,2:46
17032,633863,2021-06-01,2021,ATL,WAS,6,11,11-6,WAS,9,0,41,45,86,174,170,344,12,18,30,4,3:54
17033,633085,2021-07-31,2021,TOR,KCA,4,0,4-0,TOR,9,1,30,32,62,121,109,230,6,5,11,1,2:19
17034,633315,2021-07-08,2021,SEA,NYA,4,0,4-0,SEA,9,1,31,29,60,124,127,251,7,3,10,1,2:27
17035,633377,2021-07-09,2021,BAL,CHA,1,12,12-1,CHA,9,0,35,52,87,205,127,332,8,24,32,3,3:30
17036,633802,2021-06-06,2021,TEX,TBA,1,7,7-1,TBA,9,0,39,42,81,182,156,338,14,15,29,3,3:45
17037,633655,2021-06-14,2021,KCA,DET,3,10,10-3,DET,9,0,43,41,84,149,184,333,18,14,32,3,3:32
17038,633597,2021-06-19,2021,SDN,CIN,7,5,7-5,SDN,9,1,39,38,77,146,157,303,15,13,28,2,3:24
17039,633812,2021-06-06,2021,NYA,BOS,5,6,6-5,BOS,10,0,46,40,86,151,185,336,20,10,30,1,3:49
17040,633158,2021-07-27,2021,SEA,HOU,6,8,8-6,HOU,9,0,40,43,83,169,159,328,13,17,30,0,3:26
17041,633384,2021-07-06,2021,PIT,ATL,2,1,2-1,PIT,9,0,39,33,72,148,156,304,16,8,24,0,3:20
17042,633843,2021-06-06,2021,ANA,SEA,5,9,9-5,SEA,9,0,42,43,85,173,188,361,15,16,31,4,3:57
17043,633714,2021-06-15,2021,MIL,CIN,1,2,2-1,CIN,10,0,38,35,73,145,178,323,9,7,16,1,3:15
17044,633471,2021-06-29,2021,LAN,SFN,3,1,3-1,LAN,9,1,33,33,66,142,121,263,9,6,15,1,3:00
17045,633770,2021-06-10,2021,OAK,KCA,1,6,6-1,KCA,9,0,30,37,67,136,128,264,4,10,14,1,2:41
17046,633878,2021-06-01,2021,MIL,DET,7,10,10-7,DET,9,0,39,47,86,203,166,369,12,20,32,2,3:37
17047,633109,2021-07-29,2021,SFN,LAN,5,0,5-0,SFN,9,1,39,31,70,118,121,239,18,6,24,2,2:45
17048,633097,2021-07-28,2021,TEX,ARI,2,3,3-2,ARI,9,0,35,32,67,131,115,246,8,5,13,0,2:42
17049,633270,2021-07-11,2021,TBA,TOR,1,3,3-1,TOR,9,0,31,35,66,119,131,250,4,9,13,0,2:32
17050,633582,2021-06-20,2021,ARI,LAN,8,9,9-8,LAN,9,0,42,48,90,196,139,335,15,22,37,4,3:39
17051,633359,2021-07-08,2021,MIN,DET,5,3,5-3,MIN,9,1,33,34,67,123,120,243,8,9,17,1,2:23
17052,633282,2021-07-11,2021,BAL,CHA,5,7,7-5,CHA,10,0,40,42,82,188,167,355,10,14,24,5,3:47
17053,633235,2021-07-18,2021,PIT,NYN,6,7,7-6,NYN,9,0,43,45,88,170,166,336,17,18,35,3,3:49 (3:48 delay)
17054,633128,2021-07-30,2021,CHA,CLE,6,4,6-4,CHA,9,1,42,39,81,174,168,342,19,13,32,3,3:42
17055,633808,2021-06-06,2021,SLN,CIN,7,8,8-7,CIN,9,0,43,41,84,162,184,346,18,15,33,2,3:50
17056,633358,2021-07-06,2021,SFN,SLN,5,6,6-5,SLN,9,0,45,40,85,152,166,318,19,14,33,4,3:28
17057,633869,2021-06-06,2021,SFN,CHN,3,4,4-3,CHN,9,0,37,37,74,135,129,264,12,10,22,4,3:01
17058,633726,2021-06-12,2021,MIL,PIT,7,4,7-4,MIL,9,1,37,41,78,161,151,312,13,15,28,2,3:34
17059,633274,2021-07-11,2021,MIL,CIN,1,3,3-1,CIN,9,0,36,40,76,166,164,330,11,15,26,4,3:48
17060,633250,2021-07-21,2021,ATL,SDN,2,3,3-2,SDN,7,0,27,31,58,136,112,248,5,11,16,0,2:36
17061,633807,2021-06-05,2021,BAL,CLE,4,10,10-4,CLE,9,0,39,41,80,181,153,334,12,14,26,4,3:28
17062,633297,2021-07-11,2021,TEX,OAK,1,4,4-1,OAK,9,0,34,33,67,120,130,250,8,6,14,0,2:39
17063,633419,2021-06-30,2021,PHI,MIA,6,11,11-6,MIA,9,0,40,48,88,190,154,344,14,19,33,3,4:06 (:38 delay)
17064,633288,2021-07-10,2021,SEA,ANA,2,0,2-0,SEA,9,1,34,31,65,119,137,256,11,5,16,1,2:50
17065,633224,2021-07-21,2021,ATL,SDN,5,6,6-5,SDN,7,0,31,33,64,156,162,318,11,14,25,3,3:17 (4:08 delay)
17066,633143,2021-07-27,2021,TBA,NYA,3,4,4-3,NYA,9,0,39,42,81,147,194,341,15,18,33,1,3:38
17067,633420,2021-07-02,2021,DET,CHA,2,8,8-2,CHA,9,0,41,40,81,154,184,338,15,13,28,2,3:31
17068,633218,2021-07-19,2021,TOR,BOS,4,13,13-4,BOS,9,0,39,48,87,200,140,340,14,21,35,3,3:32
17069,633440,2021-07-03,2021,NYA,NYN,3,8,8-3,NYN,9,0,35,47,82,177,162,339,7,19,26,4,3:40
17070,633729,2021-06-14,2021,OAK,ANA,8,5,8-5,OAK,9,1,42,45,87,163,164,327,19,18,37,4,3:23
17071,633694,2021-06-15,2021,SLN,MIA,2,1,2-1,SLN,9,0,29,36,65,142,123,265,7,9,16,0,2:54
17072,633535,2021-06-25,2021,TBA,ANA,4,3,4-3,TBA,9,1,37,34,71,123,138,261,15,6,21,2,2:53
17073,633370,2021-07-06,2021,ANA,BOS,5,3,5-3,ANA,9,1,35,34,69,119,136,255,13,7,20,1,2:54
17074,633141,2021-07-29,2021,KCA,CHA,5,0,5-0,KCA,9,1,35,31,66,132,138,270,11,6,17,0,2:46
17075,633412,2021-07-05,2021,NYN,MIL,4,2,4-2,NYN,9,1,31,35,66,147,106,253,8,9,17,2,2:58
17076,633221,2021-07-23,2021,NYN,TOR,3,0,3-0,NYN,9,1,32,31,63,114,130,244,9,4,13,1,2:33
17077,633185,2021-07-24,2021,CLE,TBA,2,8,8-2,TBA,9,0,34,42,76,134,123,257,6,15,21,2,2:59
17078,633592,2021-06-19,2021,SFN,PHI,6,13,13-6,PHI,9,0,37,50,87,182,161,343,12,22,34,2,3:47
17079,633529,2021-07-01,2021,CHA,MIN,8,5,8-5,CHA,9,1,41,42,83,180,174,354,18,15,33,2,3:49
17080,633511,2021-07-02,2021,SEA,TEX,5,4,5-4,SEA,10,0,44,39,83,172,189,361,17,9,26,4,4:19
17081,633206,2021-07-26,2021,SEA,HOU,11,8,11-8,SEA,9,1,37,42,79,171,168,339,14,15,29,4,3:54
17082,633338,2021-07-09,2021,TBA,TOR,7,1,7-1,TBA,9,1,40,35,75,163,183,346,15,8,23,3,3:31
17083,633785,2021-06-08,2021,PHI,ATL,5,9,9-5,ATL,9,0,42,41,83,154,161,315,17,16,33,3,3:45 (:42 delay)
17084,633633,2021-06-17,2021,TOR,NYA,4,8,8-4,NYA,9,0,36,46,82,192,125,317,13,17,30,7,3:43
17085,633456,2021-07-01,2021,TOR,SEA,2,7,7-2,SEA,9,0,35,43,78,187,141,328,10,16,26,3,3:23
17086,633598,2021-06-19,2021,ARI,LAN,3,9,9-3,LAN,9,0,34,46,80,178,146,324,8,18,26,1,3:06
17087,633804,2021-06-08,2021,MIN,NYA,4,8,8-4,NYA,9,0,37,46,83,168,134,302,10,16,26,3,3:32
17088,633829,2021-06-15,2021,HOU,TEX,6,3,6-3,HOU,10,0,37,42,79,157,155,312,12,10,22,2,3:34
17089,633304,2021-07-10,2021,HOU,NYA,0,1,1-0,NYA,9,0,31,35,66,144,129,273,5,9,14,0,3:00
17090,633468,2021-07-02,2021,ATL,MIA,1,0,1-0,ATL,9,1,29,36,65,143,124,267,5,12,17,3,3:24
17091,633601,2021-06-28,2021,NYA,ANA,3,5,5-3,ANA,9,0,33,40,73,149,122,271,7,13,20,3,3:06
17092,633782,2021-06-11,2021,MIA,ATL,4,3,4-3,MIA,9,1,36,40,76,153,152,305,13,13,26,1,3:23
17093,633275,2021-07-17,2021,DET,MIN,5,4,5-4,DET,8,0,31,33,64,124,129,253,8,10,18,2,2:56
17094,633326,2021-07-10,2021,NYN,PIT,4,2,4-2,NYN,7,1,31,30,61,119,137,256,14,9,23,1,2:54
17095,633645,2021-06-16,2021,SFN,ARI,13,7,13-7,SFN,9,1,46,41,87,163,194,357,23,12,35,1,3:36
17096,633273,2021-07-18,2021,NYA,BOS,9,1,9-1,NYA,9,1,38,37,75,168,160,328,15,10,25,4,3:44
17097,633680,2021-06-14,2021,MIL,CIN,2,10,10-2,CIN,9,0,33,45,78,172,148,320,6,18,24,0,3:18
17098,633713,2021-06-13,2021,MIL,PIT,5,2,5-2,MIL,9,1,30,39,69,144,130,274,6,14,20,2,3:09
17099,633415,2021-07-02,2021,COL,SLN,3,9,9-3,SLN,10,0,43,45,88,170,151,321,13,18,31,4,3:50
17100,633825,2021-06-04,2021,SLN,CIN,4,6,6-4,CIN,9,0,39,42,81,146,159,305,11,18,29,5,3:26
17101,633418,2021-07-01,2021,ATL,NYN,4,3,4-3,ATL,9,0,38,36,74,130,147,277,13,9,22,0,3:05
17102,633562,2021-06-26,2021,LAN,CHN,3,2,3-2,LAN,9,0,36,34,70,125,138,263,13,8,21,4,3:12
17103,633438,2021-07-01,2021,ARI,SFN,5,3,5-3,ARI,9,1,34,36,70,126,135,261,12,10,22,0,2:37
17104,633400,2021-07-05,2021,TEX,DET,3,7,7-3,DET,9,0,33,41,74,153,116,269,7,12,19,2,2:55
17105,633516,2021-06-27,2021,TEX,KCA,4,1,4-1,TEX,9,1,34,35,69,124,141,265,10,9,19,0,2:49
17106,633761,2021-06-11,2021,LAN,TEX,12,1,12-1,LAN,9,1,45,37,82,155,160,315,21,8,29,1,3:05
17107,633131,2021-07-30,2021,ATL,MIL,5,9,9-5,MIL,9,0,39,45,84,174,162,336,14,18,32,2,3:37
17108,633563,2021-06-20,2021,ANA,DET,3,5,5-3,DET,10,0,39,46,85,222,151,373,12,18,30,3,4:03
17109,633177,2021-07-25,2021,CIN,SLN,6,10,10-6,SLN,9,0,46,45,91,187,182,369,20,19,39,4,4:04
17110,633404,2021-07-02,2021,WAS,LAN,5,10,10-5,LAN,9,0,38,42,80,178,140,318,9,16,25,3,3:16
17111,633301,2021-07-10,2021,SDN,COL,0,3,3-0,COL,9,0,31,40,71,163,111,274,6,13,19,1,3:06
17112,633510,2021-06-26,2021,CIN,ATL,4,1,4-1,CIN,9,1,30,38,68,145,126,271,7,12,19,0,2:35
17113,633322,2021-07-09,2021,SFN,WAS,5,3,5-3,SFN,9,1,35,40,75,135,123,258,12,15,27,2,2:57
17114,633345,2021-07-09,2021,TEX,OAK,3,2,3-2,TEX,9,1,32,36,68,144,138,282,10,11,21,2,3:03
17115,633210,2021-07-24,2021,MIA,SDN,3,2,3-2,MIA,9,1,36,32,68,108,151,259,13,7,20,1,2:58
17116,633372,2021-08-30,2021,DET,MIN,2,3,3-2,MIN,9,0,34,34,68,119,125,244,8,8,16,1,2:42
17117,633115,2021-07-29,2021,DET,BAL,6,2,6-2,DET,9,1,38,35,73,122,130,252,15,10,25,0,2:35
17118,633207,2021-07-20,2021,OAK,ANA,6,0,6-0,OAK,9,1,34,37,71,143,121,264,11,10,21,1,3:01
17119,633139,2021-07-27,2021,ANA,COL,3,12,12-3,COL,9,0,41,51,92,211,155,366,14,22,36,2,3:53
17120,633763,2021-06-12,2021,PHI,NYA,8,7,8-7,PHI,10,0,47,42,89,168,187,355,20,14,34,1,4:02
17121,633599,2021-06-25,2021,MIL,COL,5,4,5-4,MIL,11,0,44,42,86,179,176,355,14,9,23,3,4:21
17122,633492,2021-06-25,2021,SDN,ARI,11,5,11-5,SDN,9,1,42,45,87,180,154,334,19,18,37,2,3:31
17123,633867,2021-06-28,2021,CIN,PHI,12,4,12-4,CIN,9,1,41,39,80,136,167,303,17,12,29,3,3:18
17124,633605,2021-06-21,2021,TEX,OAK,8,3,8-3,TEX,9,1,37,39,76,157,125,282,14,12,26,2,3:12
17125,633787,2021-06-05,2021,PIT,MIA,8,7,8-7,PIT,12,0,49,49,98,208,172,380,14,15,29,1,4:20
17126,633246,2021-08-07,2021,TOR,BOS,1,2,2-1,BOS,8,0,32,31,63,130,140,270,9,9,18,2,2:59
17127,633414,2021-07-04,2021,CLE,HOU,3,4,4-3,HOU,10,0,35,42,77,159,119,278,6,11,17,3,3:16
17128,633654,2021-06-18,2021,ANA,DET,11,3,11-3,ANA,9,1,40,38,78,176,161,337,17,11,28,2,3:32
17129,633538,2021-06-24,2021,MIN,CLE,1,4,4-1,CLE,9,0,34,37,71,129,134,263,8,12,20,2,2:58
17130,633439,2021-07-03,2021,KCA,MIN,6,3,6-3,KCA,9,1,36,39,75,138,129,267,13,14,27,0,2:57
17131,633428,2021-07-04,2021,CIN,CHN,3,2,3-2,CIN,9,1,34,37,71,127,127,254,11,13,24,4,2:59
17132,633330,2021-07-07,2021,PIT,ATL,3,14,14-3,ATL,9,0,44,52,96,206,163,369,19,26,45,3,4:08 (1:18 delay)
17133,633484,2021-06-30,2021,NYA,ANA,8,11,11-8,ANA,9,0,42,45,87,181,158,339,19,17,36,4,3:44 (2:13 delay)
17134,633653,2021-06-15,2021,TOR,NYA,5,6,6-5,NYA,9,0,41,42,83,164,158,322,15,15,30,4,3:31
17135,633424,2021-07-03,2021,COL,SLN,3,2,3-2,COL,9,1,34,38,72,172,116,288,12,12,24,3,3:23
17136,633755,2021-06-15,2021,KCA,DET,3,4,4-3,DET,9,0,35,36,71,145,145,290,10,10,20,2,2:49
17137,633466,2021-06-28,2021,CLE,DET,13,5,13-5,CLE,9,1,44,35,79,133,161,294,21,8,29,2,2:58
17138,633429,2021-07-03,2021,CLE,HOU,2,3,3-2,HOU,9,0,32,39,71,167,128,295,6,15,21,3,3:24
17139,633409,2021-07-08,2021,CLE,KCA,7,4,7-4,CLE,9,0,40,35,75,138,141,279,16,9,25,0,3:10 (:12 delay)
17140,633504,2021-06-27,2021,NYN,PHI,2,4,4-2,PHI,9,0,36,40,76,141,137,278,9,13,22,0,3:21
17141,633266,2021-07-16,2021,TOR,TEX,10,2,10-2,TOR,9,1,38,37,75,143,146,289,14,10,24,1,2:58
17142,633363,2021-07-05,2021,KCA,CIN,2,6,6-2,CIN,9,0,37,38,75,147,130,277,10,13,23,1,3:00
17143,633507,2021-07-02,2021,PIT,MIL,2,7,7-2,MIL,9,0,36,37,73,136,143,279,9,12,21,1,2:52
17144,633368,2021-07-07,2021,HOU,OAK,4,3,4-3,HOU,9,1,29,36,65,163,112,275,4,9,13,1,2:58
17145,633123,2021-07-28,2021,CLE,SLN,7,2,7-2,CLE,9,1,36,36,72,143,142,285,14,9,23,1,3:08
17146,633434,2021-07-04,2021,COL,SLN,3,2,3-2,COL,9,0,35,36,71,141,126,267,11,10,21,3,3:16
17147,633445,2021-06-30,2021,TOR,SEA,7,9,9-7,SEA,10,0,46,46,92,172,190,362,18,15,33,4,4:12
17148,633408,2021-07-04,2021,TOR,TBA,1,5,5-1,TBA,9,0,32,37,69,144,126,270,6,11,17,1,2:53
17149,633731,2021-06-11,2021,ARI,ANA,5,6,6-5,ANA,10,0,45,46,91,168,181,349,14,18,32,4,4:09
17150,633376,2021-07-06,2021,MIA,LAN,2,1,2-1,MIA,10,0,40,44,84,186,177,363,13,16,29,3,4:34
17151,633303,2021-07-17,2021,ATL,TBA,9,0,9-0,ATL,9,1,38,33,71,121,127,248,15,6,21,1,2:33
17152,633354,2021-07-08,2021,HOU,OAK,1,2,2-1,OAK,9,0,33,38,71,130,120,250,8,10,18,1,2:52
17153,633299,2021-07-17,2021,PHI,MIA,4,2,4-2,PHI,10,0,38,37,75,154,135,289,10,9,19,0,3:30 (1:15 delay)
17154,633477,2021-06-27,2021,BOS,NYA,9,2,9-2,BOS,9,1,39,36,75,151,146,297,16,10,26,1,3:09
17155,633380,2021-07-05,2021,SFN,SLN,3,5,5-3,SLN,9,0,35,38,73,156,127,283,9,12,21,0,3:04
17156,633371,2021-07-07,2021,SEA,NYA,4,5,5-4,NYA,9,0,34,40,74,140,151,291,8,13,21,1,3:02
17157,633473,2021-06-27,2021,MIN,CLE,8,2,8-2,MIN,9,1,38,36,74,155,142,297,15,9,24,2,2:58
17158,633385,2021-07-07,2021,ANA,BOS,5,4,5-4,ANA,9,1,34,37,71,162,129,291,11,11,22,1,2:55
17159,633310,2021-07-16,2021,NYA,BOS,0,4,4-0,BOS,9,0,33,35,68,149,149,298,6,8,14,1,3:03
17160,633249,2021-07-19,2021,OAK,ANA,4,1,4-1,OAK,9,1,34,35,69,116,144,260,10,10,20,3,2:51
17161,633495,2021-06-29,2021,PHI,MIA,4,3,4-3,PHI,9,1,35,34,69,149,146,295,11,7,18,3,3:25
17162,633347,2021-07-07,2021,SFN,SLN,5,2,5-2,SFN,9,1,41,35,76,129,166,295,18,9,27,3,3:07
17163,633453,2021-07-03,2021,ANA,BAL,4,1,4-1,ANA,9,1,39,31,70,131,149,280,18,6,24,3,2:52
17164,633264,2021-07-16,2021,OAK,CLE,5,4,5-4,OAK,9,0,40,35,75,144,149,293,15,9,24,1,2:58
17165,633470,2021-07-02,2021,ARI,SFN,4,11,11-4,SFN,9,0,37,45,82,181,152,333,11,20,31,2,3:40
17166,633126,2021-07-29,2021,BOS,TOR,1,13,13-1,TOR,9,0,38,50,88,192,148,340,8,23,31,1,3:24
17167,633727,2021-06-14,2021,SLN,MIA,4,2,4-2,SLN,9,1,35,33,68,139,119,258,14,8,22,1,3:02
17168,633556,2021-06-25,2021,TEX,KCA,9,4,9-4,TEX,9,1,38,36,74,146,127,273,16,10,26,2,2:51
17169,633279,2021-07-11,2021,SFN,WAS,3,1,3-1,SFN,9,1,35,33,68,138,135,273,13,8,21,1,2:53
17170,633324,2021-07-11,2021,MIA,ATL,7,4,7-4,MIA,9,1,40,35,75,119,173,292,18,8,26,1,3:05
17171,633430,2021-07-03,2021,WAS,LAN,3,5,5-3,LAN,9,0,35,38,73,153,128,281,10,11,21,3,3:21 (1:44 delay)
17172,633114,2021-07-28,2021,KCA,CHA,3,2,3-2,KCA,10,0,35,35,70,150,120,270,7,7,14,2,3:06
17173,633213,2021-07-21,2021,NYA,PHI,6,5,6-5,NYA,10,0,42,46,88,207,165,372,14,16,30,3,4:17
17174,633190,2021-07-21,2021,COL,SEA,6,3,6-3,COL,9,1,34,32,66,119,125,244,11,6,17,0,2:35
17175,633708,2021-06-16,2021,ATL,BOS,8,10,10-8,BOS,9,0,47,44,91,179,181,360,19,17,36,4,4:10
17176,633406,2021-07-06,2021,HOU,OAK,9,6,9-6,HOU,9,1,39,38,77,134,167,301,16,13,29,2,3:15
17177,633479,2021-06-30,2021,CHA,MIN,13,3,13-3,CHA,9,1,41,34,75,130,179,309,17,8,25,1,3:04
17178,633734,2021-06-14,2021,SFN,ARI,5,2,5-2,SFN,9,1,41,36,77,141,156,297,19,9,28,1,2:59
17179,633405,2021-07-01,2021,OAK,TEX,3,8,8-3,TEX,9,0,38,43,81,164,137,301,11,18,29,1,2:52
17180,633616,2021-06-18,2021,COL,MIL,6,5,6-5,COL,10,0,42,41,83,128,153,281,15,14,29,3,3:30
17181,633334,2021-07-08,2021,MIA,LAN,1,6,6-1,LAN,9,0,36,43,79,177,127,304,10,14,24,1,3:05
17182,633122,2021-07-28,2021,TBA,NYA,1,3,3-1,NYA,10,0,35,38,73,147,146,293,6,9,15,2,3:25
17183,633238,2021-07-18,2021,OAK,CLE,2,4,4-2,CLE,9,0,32,39,71,140,127,267,6,12,18,1,2:55
17184,633478,2021-06-29,2021,CHA,MIN,7,6,7-6,CHA,9,1,38,34,72,148,150,298,15,11,26,4,3:20 (:10 delay)
17185,633226,2021-07-19,2021,SLN,CHN,8,3,8-3,SLN,9,1,38,36,74,131,138,269,13,10,23,2,3:00
17186,633398,2021-07-04,2021,WAS,LAN,1,5,5-1,LAN,9,0,35,41,76,150,147,297,11,14,25,3,3:37
17187,633151,2021-07-25,2021,MIL,CHA,1,3,3-1,CHA,9,0,37,34,71,137,149,286,10,9,19,1,3:13
17188,633579,2021-06-18,2021,TEX,MIN,5,7,7-5,MIN,10,0,43,44,87,180,173,353,12,17,29,1,3:44
17189,633515,2021-06-27,2021,TOR,BAL,5,2,5-2,TOR,9,1,36,37,73,166,145,311,16,10,26,3,3:15
17190,633431,2021-07-04,2021,KCA,MIN,2,6,6-2,MIN,9,0,35,40,75,150,154,304,8,14,22,1,3:11
17191,633328,2021-07-16,2021,KCA,BAL,9,2,9-2,KCA,9,1,42,34,76,134,151,285,19,9,28,0,3:01
17192,633312,2021-07-10,2021,MIA,ATL,4,5,5-4,ATL,9,0,39,37,76,147,150,297,12,10,22,1,3:37
17193,633323,2021-07-16,2021,ANA,SEA,5,6,6-5,SEA,9,0,40,38,78,158,128,286,13,13,26,3,3:07
17194,633498,2021-06-25,2021,SLN,PIT,4,5,5-4,PIT,9,0,43,38,81,146,163,309,16,13,29,5,3:46
17195,633106,2021-07-31,2021,TEX,SEA,5,4,5-4,TEX,10,0,33,39,72,150,128,278,7,12,19,3,3:19
17196,633083,2021-07-29,2021,NYN,ATL,3,6,6-3,ATL,9,0,37,38,75,136,136,272,13,11,24,1,2:53
17197,633296,2021-07-16,2021,ARI,CHN,1,5,5-1,CHN,9,0,36,36,72,131,153,284,11,12,23,0,3:09
17198,633767,2021-06-09,2021,TBA,WAS,7,9,9-7,WAS,11,0,48,48,96,191,209,400,16,16,32,2,4:19
17199,633426,2021-06-30,2021,SLN,ARI,7,4,7-4,SLN,9,1,38,41,79,168,131,299,13,14,27,2,3:20
17200,633148,2021-07-28,2021,NYN,ATL,2,1,2-1,NYN,9,1,31,36,67,141,116,257,9,10,19,2,3:01
17201,633383,2021-07-07,2021,KCA,CIN,2,5,5-2,CIN,9,0,37,42,79,163,132,295,12,16,28,2,3:09 (1:12 delay)
17202,633318,2021-07-11,2021,SEA,ANA,1,7,7-1,ANA,9,0,35,43,78,159,148,307,8,16,24,4,3:32
17203,633719,2021-06-13,2021,LAN,TEX,5,3,5-3,LAN,9,1,36,42,78,152,146,298,15,15,30,2,3:15
17204,633248,2021-07-17,2021,KCA,BAL,4,8,8-4,BAL,9,0,38,42,80,153,147,300,12,15,27,2,3:03
17205,633433,2021-07-02,2021,KCA,MIN,7,4,7-4,KCA,9,1,39,39,78,151,157,308,16,12,28,2,3:18
17206,633113,2021-07-28,2021,PIT,MIL,3,7,7-3,MIL,9,0,36,41,77,132,144,276,9,16,25,1,3:01
17207,633476,2021-07-19,2021,CHA,MIN,5,3,5-3,CHA,7,0,24,25,49,94,94,188,6,6,12,0,1:54
17208,633524,2021-06-23,2021,TBA,BOS,8,2,8-2,TBA,9,1,42,39,81,159,169,328,17,13,30,2,3:31
17209,633379,2021-07-03,2021,SEA,TEX,3,7,7-3,TEX,9,0,38,41,79,156,173,329,11,14,25,1,3:12
17210,633391,2021-07-04,2021,ANA,BAL,6,5,6-5,ANA,9,0,36,37,73,155,138,293,12,12,24,3,3:04
17211,633410,2021-07-04,2021,DET,CHA,6,5,6-5,DET,9,1,36,42,78,167,154,321,13,17,30,4,3:25
17212,633293,2021-07-10,2021,TBA,TOR,5,2,5-2,TBA,9,1,35,36,71,173,154,327,12,10,22,4,3:19
17213,633117,2021-07-31,2021,ATL,MIL,8,1,8-1,ATL,9,1,40,39,79,143,153,296,16,12,28,2,3:27
17214,633092,2021-07-31,2021,MIA,NYA,2,4,4-2,NYA,9,0,33,41,74,163,125,288,6,15,21,2,3:25
17215,633397,2021-07-08,2021,CHN,PHI,0,8,8-0,PHI,9,0,33,42,75,158,144,302,8,15,23,0,3:15
17216,633463,2021-07-01,2021,PIT,MIL,2,7,7-2,MIL,9,0,33,43,76,176,126,302,7,17,24,3,3:37
17217,633375,2021-07-07,2021,CHN,PHI,8,3,8-3,CHN,9,1,36,35,71,143,121,264,11,8,19,2,2:54 (:12 delay)
17218,633805,2021-06-13,2021,MIA,ATL,4,6,6-4,ATL,9,0,37,43,80,174,149,323,10,19,29,1,3:45
17219,633411,2021-07-05,2021,PIT,ATL,11,1,11-1,PIT,9,1,42,37,79,159,164,323,19,12,31,2,3:31
17220,633333,2021-07-07,2021,MIA,LAN,9,6,9-6,MIA,9,0,40,38,78,156,155,311,14,11,25,3,3:46
17221,633413,2021-07-06,2021,BAL,TOR,7,5,7-5,BAL,9,1,39,37,76,145,159,304,14,11,25,3,3:03
17222,633063,2021-07-31,2021,NYN,CIN,5,4,5-4,NYN,10,0,35,41,76,161,146,307,10,13,23,2,3:22
17223,633167,2021-07-24,2021,MIL,CHA,6,1,6-1,MIL,9,1,36,33,69,137,143,280,10,8,18,0,3:10
17224,633285,2021-07-16,2021,SLN,SFN,2,7,7-2,SFN,9,0,42,39,81,140,164,304,15,13,28,3,3:22
17225,633500,2021-06-26,2021,SFN,OAK,6,5,6-5,SFN,10,0,44,39,83,171,203,374,17,9,26,4,4:05
17226,633437,2021-06-30,2021,ATL,NYN,20,2,20-2,ATL,9,1,50,33,83,119,195,314,27,7,34,3,3:21
17227,633201,2021-07-24,2021,KCA,DET,9,8,9-8,KCA,9,1,40,41,81,148,158,306,15,14,29,5,3:23
17228,633392,2021-07-08,2021,ARI,COL,3,9,9-3,COL,9,0,37,46,83,176,134,310,10,19,29,0,3:23
17229,633356,2021-07-10,2021,CHN,SLN,0,6,6-0,SLN,9,0,34,42,76,193,140,333,8,14,22,2,3:32
17230,633090,2021-07-31,2021,TBA,BOS,9,5,9-5,TBA,9,1,38,39,77,161,164,325,12,14,26,4,3:34
17231,633272,2021-07-24,2021,NYN,TOR,3,10,10-3,TOR,9,0,39,46,85,160,143,303,16,20,36,4,3:33
17232,634222,2021-07-17,2021,DET,MIN,1,0,1-0,DET,7,1,25,23,48,85,100,185,7,2,9,1,1:55
17233,633076,2021-07-31,2021,PIT,PHI,3,2,3-2,PIT,9,0,33,38,71,132,140,272,8,12,20,1,2:59
17234,633104,2021-07-29,2021,TBA,NYA,14,0,14-0,TBA,9,1,41,33,74,143,170,313,16,7,23,3,2:59
17235,633378,2021-07-05,2021,SDN,WAS,5,7,7-5,WAS,9,0,41,43,84,179,158,337,15,14,29,1,3:44
17236,633361,2021-07-05,2021,MIA,LAN,5,4,5-4,MIA,9,1,36,42,78,184,148,332,13,13,26,2,3:48
17237,633374,2021-07-04,2021,PHI,SDN,1,11,11-1,SDN,9,0,35,45,80,180,139,319,12,23,35,2,3:45
17238,633112,2021-07-30,2021,SDN,COL,4,9,9-4,COL,9,0,35,43,78,169,141,310,10,18,28,1,3:17
17239,633442,2021-07-03,2021,DET,CHA,11,5,11-5,DET,9,1,40,36,76,150,180,330,18,11,29,2,3:07
17240,633341,2021-07-09,2021,SEA,ANA,7,3,7-3,SEA,9,1,39,37,76,151,163,314,14,11,25,6,3:31
17241,633164,2021-07-23,2021,MIA,SDN,2,5,5-2,SDN,9,0,36,38,74,153,156,309,11,10,21,2,3:25
17242,633320,2021-07-09,2021,LAN,ARI,2,5,5-2,ARI,9,0,35,46,81,187,115,302,8,17,25,2,3:34
17243,633389,2021-07-05,2021,ANA,BOS,4,5,5-4,BOS,9,0,38,42,80,185,140,325,13,14,27,4,3:46
17244,633343,2021-07-08,2021,SDN,WAS,9,8,9-8,SDN,9,0,41,40,81,151,173,324,16,13,29,2,3:40
17245,633636,2021-06-20,2021,BAL,TOR,4,7,7-4,TOR,9,0,34,46,80,169,131,300,8,19,27,1,3:05
17246,633512,2021-06-26,2021,SDN,ARI,1,10,10-1,ARI,9,0,40,44,84,153,162,315,14,19,33,2,3:35
17247,633444,2021-06-29,2021,NYA,ANA,11,5,11-5,NYA,9,1,43,38,81,140,196,336,20,13,33,3,3:31
17248,633134,2021-07-29,2021,PHI,WAS,11,8,11-8,PHI,8,0,39,44,83,148,146,294,18,23,41,2,3:18
17249,633580,2021-06-22,2021,MIN,CIN,7,10,10-7,CIN,9,0,40,43,83,177,149,326,13,17,30,3,3:29
17250,633369,2021-07-06,2021,KCA,CIN,7,6,7-6,KCA,9,0,39,40,79,182,153,335,11,15,26,5,3:32
17251,633134,2021-07-29,2021,PHI,WAS,11,8,11-8,PHI,8,0,39,44,83,148,146,294,18,23,41,2,3:18
17252,633271,2021-07-19,2021,CIN,NYN,11,15,15-11,NYN,11,0,57,52,109,190,209,399,22,21,43,6,4:45
17253,633530,2021-06-26,2021,DET,HOU,3,1,3-1,DET,7,1,24,29,53,124,86,210,6,8,14,0,2:06
17254,633344,2021-07-10,2021,BOS,PHI,2,11,11-2,PHI,9,0,36,45,81,181,129,310,10,20,30,5,3:27
17255,633302,2021-07-11,2021,LAN,ARI,7,4,7-4,LAN,9,0,38,38,76,156,143,299,15,13,28,3,3:40
17256,633263,2021-07-16,2021,CIN,MIL,6,11,11-6,MIL,9,0,40,44,84,173,157,330,15,16,31,2,3:29
17257,633536,2021-06-25,2021,TOR,BAL,5,6,6-5,BAL,10,0,40,45,85,186,149,335,11,15,26,3,3:36
17258,633130,2021-07-28,2021,ANA,COL,8,7,8-7,ANA,9,1,41,42,83,170,157,327,18,15,33,3,3:38
17259,633518,2021-06-26,2021,MIL,COL,10,4,10-4,MIL,9,1,43,39,82,161,175,336,19,14,33,1,3:40
17260,633454,2021-06-29,2021,CIN,SDN,4,5,5-4,SDN,9,0,37,48,85,182,150,332,11,20,31,3,3:50 (:52 delay)
17261,633786,2021-06-06,2021,PHI,WAS,12,6,12-6,PHI,9,1,40,41,81,183,154,337,14,15,29,4,4:06 (:20 delay)
17262,633387,2021-07-03,2021,PIT,MIL,2,11,11-2,MIL,9,0,38,53,91,209,139,348,11,25,36,2,3:45
17263,633216,2021-07-20,2021,NYA,PHI,6,4,6-4,NYA,9,1,37,42,79,174,156,330,14,16,30,3,3:46
17264,633308,2021-07-09,2021,NYN,PIT,13,4,13-4,NYN,9,1,39,42,81,171,162,333,15,17,32,2,3:27 (:41 delay)
17265,633724,2021-06-15,2021,ATL,BOS,8,10,10-8,BOS,9,0,41,42,83,155,162,317,12,16,28,2,3:32
17266,633155,2021-07-27,2021,SDN,OAK,7,4,7-4,SDN,9,1,37,37,74,143,132,275,14,12,26,2,3:08
17267,633416,2021-07-03,2021,ATL,MIA,2,3,3-2,MIA,9,0,39,36,75,148,149,297,13,10,23,1,3:14
17268,633757,2021-06-10,2021,CIN,MIL,2,7,7-2,MIL,9,0,35,41,76,171,153,324,8,15,23,1,3:16 (:37 delay)
17269,633125,2021-07-28,2021,SFN,LAN,0,8,8-0,LAN,9,0,33,47,80,183,132,315,7,18,25,1,3:10
17270,633353,2021-07-05,2021,TBA,CLE,9,8,9-8,TBA,9,0,41,44,85,183,153,336,18,18,36,5,3:39
17271,633487,2021-07-05,2021,MIN,CHA,8,5,8-5,MIN,9,1,39,40,79,182,168,350,16,13,29,3,3:38
17272,633332,2021-07-07,2021,BAL,TOR,2,10,10-2,TOR,9,0,38,45,83,187,153,340,13,19,32,2,3:23
17273,633388,2021-07-03,2021,ARI,SFN,5,6,6-5,SFN,9,0,41,46,87,178,167,345,12,21,33,2,3:47
17274,633393,2021-07-06,2021,CHN,PHI,10,15,15-10,PHI,9,0,43,50,93,189,156,345,16,21,37,3,3:45
17275,633316,2021-07-10,2021,TEX,OAK,4,8,8-4,OAK,11,0,46,44,90,168,175,343,16,11,27,3,3:55
17276,633480,2021-07-01,2021,CIN,SDN,5,4,5-4,CIN,9,0,49,37,86,147,183,330,27,10,37,2,3:52 (:52 delay)
17277,633365,2021-07-09,2021,CHN,SLN,10,5,10-5,CHN,9,1,46,42,88,153,182,335,22,14,36,5,3:57
17278,633294,2021-07-10,2021,SFN,WAS,10,4,10-4,SFN,9,1,46,38,84,140,185,325,20,11,31,2,3:27
17279,633096,2021-07-28,2021,SDN,OAK,4,10,10-4,OAK,9,0,38,43,81,181,155,336,11,16,27,1,3:28
17280,633422,2021-07-04,2021,PIT,MIL,2,0,2-0,PIT,9,1,34,33,67,116,117,233,9,7,16,0,2:41
17281,633925,2021-07-26,2021,NYN,ATL,1,0,1-0,NYN,7,1,26,25,51,108,93,201,9,5,14,1,2:11
17282,633360,2021-07-07,2021,TBA,CLE,4,0,4-0,TBA,7,1,29,23,52,97,117,214,11,2,13,2,2:04
17283,633340,2021-07-11,2021,HOU,NYA,8,7,8-7,HOU,9,0,37,48,85,212,131,343,13,22,35,3,3:38
17284,633215,2021-07-23,2021,SFN,PIT,4,6,6-4,PIT,9,0,38,39,77,164,168,332,13,10,23,2,3:28
17285,633427,2021-06-30,2021,WAS,TBA,15,6,15-6,WAS,9,1,48,40,88,165,179,344,25,13,38,3,3:37
17286,633721,2021-06-12,2021,DET,CHA,2,15,15-2,CHA,9,0,37,52,89,223,151,374,11,25,36,2,3:47
17287,633350,2021-07-10,2021,BAL,CHA,3,8,8-3,CHA,9,0,39,43,82,185,187,372,13,18,31,4,3:24
17288,633058,2021-07-31,2021,CHA,CLE,11,12,12-11,CLE,9,0,43,43,86,171,176,347,16,16,32,4,3:37
17289,633447,2021-07-16,2021,PHI,MIA,0,7,7-0,MIA,7,0,27,34,61,127,96,223,5,12,17,1,2:21
17290,633289,2021-07-10,2021,MIN,DET,9,4,9-4,MIN,9,1,39,35,74,160,169,329,15,9,24,5,3:26
17291,633357,2021-07-09,2021,BOS,PHI,11,5,11-5,BOS,9,1,45,37,82,145,185,330,21,11,32,2,3:44
17292,633267,2021-07-17,2021,WAS,SDN,4,10,10-4,SDN,9,0,40,45,85,170,154,324,15,23,38,2,3:37
17293,633528,2021-06-22,2021,SEA,COL,2,1,2-1,SEA,9,1,29,32,61,132,116,248,7,7,14,1,2:39
17294,633509,2021-06-26,2021,DET,HOU,2,3,3-2,HOU,7,0,28,27,55,121,109,230,7,8,15,2,2:21
17295,634515,2021-06-25,2021,NYN,PHI,1,2,2-1,PHI,8,0,31,29,60,107,118,225,8,6,14,0,2:32
17296,633447,2021-07-16,2021,PHI,MIA,0,7,7-0,MIA,7,0,27,34,61,127,96,223,5,12,17,1,2:21
17297,633311,2021-07-10,2021,LAN,ARI,22,1,22-1,LAN,9,1,53,33,86,133,192,325,30,6,36,2,3:19
17298,633421,2021-08-16,2021,NYA,ANA,2,1,2-1,NYA,9,1,31,32,63,131,125,256,10,4,14,4,2:49
17299,633443,2021-06-29,2021,WAS,TBA,4,3,4-3,WAS,9,1,30,37,67,122,108,230,9,10,19,1,2:34
17300,633298,2021-07-17,2021,NYA,BOS,3,1,3-1,NYA,6,0,27,25,52,96,121,217,9,7,16,1,2:43 (1:42 delay)
17301,633362,2021-07-07,2021,SDN,WAS,5,15,15-5,WAS,9,0,44,51,95,194,168,362,17,23,40,2,3:32
17302,633265,2021-07-16,2021,ATL,TBA,6,7,7-6,TBA,10,0,43,50,93,192,176,368,13,20,33,2,3:46
17303,633103,2021-07-28,2021,CHN,CIN,2,8,8-2,CIN,9,0,37,46,83,175,167,342,11,21,32,0,3:37
17304,633506,2021-06-30,2021,CLE,DET,1,7,7-1,DET,7,0,27,34,61,139,110,249,4,14,18,1,2:27
17305,633552,2021-06-26,2021,MIA,WAS,3,2,3-2,MIA,9,1,31,38,69,146,105,251,7,11,18,0,2:44
17306,633137,2021-07-27,2021,MIN,DET,5,6,6-5,DET,11,0,45,41,86,164,142,306,15,12,27,4,3:52
17307,633182,2021-07-26,2021,CHN,CIN,6,5,6-5,CHN,9,0,45,42,87,171,183,354,21,15,36,4,4:00
17308,633436,2021-07-04,2021,ARI,SFN,2,5,5-2,SFN,9,0,33,34,67,133,124,257,9,7,16,1,2:43
17309,633537,2021-06-22,2021,CHN,CLE,7,1,7-1,CHN,9,1,33,34,67,132,124,256,9,7,16,2,2:51
17310,633326,2021-07-10,2021,NYN,PIT,4,2,4-2,NYN,7,1,31,30,61,119,137,256,14,9,23,1,2:54
17311,633553,2021-06-23,2021,TEX,OAK,5,3,5-3,TEX,9,1,33,38,71,123,117,240,13,11,24,2,2:43
17312,633401,2021-07-03,2021,OAK,BOS,7,6,7-6,OAK,12,0,55,47,102,173,191,364,25,12,37,3,4:24
17313,633695,2021-06-16,2021,TOR,NYA,2,3,3-2,NYA,9,0,34,36,70,142,125,267,7,7,14,2,3:01
17314,633555,2021-06-25,2021,MIN,CLE,8,7,8-7,MIN,9,1,35,36,71,133,110,243,12,9,21,2,2:46
17315,633545,2021-06-25,2021,NYN,PHI,2,1,2-1,NYN,8,0,32,32,64,114,136,250,10,9,19,3,3:03
17316,633110,2021-07-28,2021,BOS,TOR,4,1,4-1,BOS,7,1,31,26,57,116,111,227,14,7,21,2,2:27
17317,633589,2021-06-26,2021,SLN,PIT,3,1,3-1,SLN,9,1,33,34,67,134,120,254,10,8,18,1,2:56
17318,633120,2021-07-30,2021,SFN,HOU,6,9,9-6,HOU,9,0,43,46,89,187,169,356,15,18,33,3,3:58
17319,633195,2021-07-24,2021,BAL,WAS,5,3,5-3,BAL,9,1,33,34,67,129,125,254,10,7,17,2,2:41
17320,633307,2021-07-11,2021,MIN,DET,12,9,12-9,MIN,10,0,51,43,94,158,233,391,26,15,41,5,4:09
17321,633102,2021-07-30,2021,ARI,LAN,6,5,6-5,ARI,10,0,47,44,91,176,194,370,19,14,33,4,4:33
17322,633525,2021-06-26,2021,TBA,ANA,13,3,13-3,TBA,9,1,43,35,78,115,181,296,20,8,28,1,2:52
17323,633458,2021-06-28,2021,LAN,SFN,3,2,3-2,LAN,9,1,30,40,70,147,116,263,7,14,21,1,3:10
17324,633281,2021-07-17,2021,SLN,SFN,3,1,3-1,SLN,9,1,31,36,67,139,106,245,7,11,18,1,2:36
17325,633149,2021-07-27,2021,SFN,LAN,2,1,2-1,SFN,9,1,33,33,66,128,130,258,10,7,17,2,2:49
17326,633588,2021-06-21,2021,MIN,CIN,7,5,7-5,MIN,12,0,56,51,107,221,217,438,25,19,44,7,5:14
17327,633554,2021-06-20,2021,SEA,TBA,6,2,6-2,SEA,10,0,36,37,73,144,133,277,9,10,19,1,3:08
17328,633614,2021-06-23,2021,SEA,COL,2,5,5-2,COL,9,0,32,37,69,156,122,278,5,10,15,2,3:00
17329,633527,2021-06-27,2021,SFN,OAK,2,6,6-2,OAK,9,0,35,42,77,156,121,277,10,13,23,2,2:57
17330,633488,2021-06-29,2021,OAK,TEX,4,5,5-4,TEX,9,0,36,37,73,150,131,281,9,11,20,0,2:41
17331,633154,2021-07-24,2021,BOS,NYA,3,4,4-3,NYA,9,0,37,37,74,124,144,268,11,12,23,1,3:02
17332,633489,2021-06-27,2021,MIA,WAS,1,5,5-1,WAS,9,0,36,35,71,130,141,271,10,12,22,1,3:06
17333,633331,2021-09-11,2021,BAL,TOR,2,11,11-2,TOR,7,0,29,36,65,146,111,257,7,15,22,2,2:28
17334,633432,2021-06-30,2021,CLE,DET,4,9,9-4,DET,7,0,28,40,68,169,113,282,7,20,27,2,2:55
17335,633572,2021-06-22,2021,PIT,CHA,6,3,6-3,PIT,9,1,35,35,70,125,152,277,12,8,20,2,2:50
17336,633513,2021-06-23,2021,MIA,TOR,1,3,3-1,TOR,9,0,34,38,72,143,144,287,6,11,17,0,3:18
17337,633475,2021-06-28,2021,BOS,KCA,6,5,6-5,BOS,9,1,34,37,71,135,138,273,13,12,25,2,3:02
17338,633540,2021-06-22,2021,SDN,LAN,3,2,3-2,SDN,9,1,31,39,70,166,120,286,7,13,20,2,3:09
17339,633319,2021-07-17,2021,ARI,CHN,2,4,4-2,CHN,9,0,35,39,74,131,133,264,9,13,22,2,3:15
17340,633423,2021-07-04,2021,ATL,MIA,8,7,8-7,ATL,10,0,45,44,89,196,163,359,24,14,38,1,4:08
17341,633574,2021-06-20,2021,TEX,MIN,2,4,4-2,MIN,9,0,35,41,76,153,136,289,8,16,24,1,3:07
17342,634620,2021-06-28,2021,WAS,NYN,8,4,8-4,WAS,9,1,38,38,76,155,116,271,16,12,28,3,3:03
17343,633541,2021-06-23,2021,DET,SLN,6,2,6-2,DET,9,1,36,35,71,128,161,289,13,9,22,5,3:12
17344,633486,2021-06-27,2021,MIL,COL,5,0,5-0,MIL,9,1,34,32,66,133,164,297,12,6,18,1,3:09
17345,633501,2021-06-26,2021,CHA,SEA,2,3,3-2,SEA,9,0,34,37,71,149,142,291,10,10,20,3,3:17 (1:38 delay)
17346,633603,2021-06-22,2021,ARI,MIL,0,5,5-0,MIL,9,0,34,37,71,143,137,280,7,11,18,2,3:13
17347,633539,2021-06-26,2021,NYN,PHI,4,3,4-3,NYN,9,0,39,35,74,125,143,268,12,9,21,1,3:05
17348,633587,2021-06-29,2021,ATL,NYN,3,4,4-3,NYN,9,0,37,37,74,139,140,279,11,11,22,1,3:15
17349,633503,2021-06-24,2021,TEX,OAK,1,5,5-1,OAK,9,0,36,40,76,159,137,296,11,13,24,0,3:03
17350,633186,2021-07-24,2021,CHN,ARI,3,7,7-3,ARI,9,0,35,40,75,162,119,281,9,14,23,2,3:15 (1:39 delay)
17351,633448,2021-07-02,2021,PHI,SDN,4,3,4-3,PHI,10,0,35,38,73,158,128,286,8,8,16,2,3:09
17352,633544,2021-06-27,2021,SDN,ARI,5,4,5-4,SDN,9,1,37,37,74,148,127,275,14,10,24,1,3:27
17353,633262,2021-07-17,2021,CHA,HOU,10,1,10-1,CHA,9,1,42,30,72,107,167,274,19,3,22,1,2:51
17354,633627,2021-06-23,2021,SDN,LAN,5,3,5-3,SDN,9,1,36,35,71,148,137,285,15,9,24,4,3:30
17355,633234,2021-07-20,2021,CIN,NYN,4,3,4-3,CIN,9,1,36,39,75,153,137,290,14,12,26,2,3:13
17356,633156,2021-07-25,2021,BAL,WAS,5,4,5-4,BAL,9,0,36,40,76,142,147,289,13,14,27,4,3:18
17357,633578,2021-06-23,2021,ARI,MIL,2,3,3-2,MIL,9,0,34,40,74,150,138,288,8,14,22,1,3:28
17358,633591,2021-06-25,2021,MIA,WAS,11,2,11-2,MIA,9,1,42,35,77,138,159,297,16,11,27,1,3:21
17359,633497,2021-06-29,2021,TOR,SEA,9,3,9-3,TOR,9,1,42,37,79,146,145,291,19,11,30,0,3:08
17360,633169,2021-07-25,2021,SEA,OAK,4,3,4-3,SEA,9,1,35,36,71,149,136,285,12,10,22,3,3:07
17361,633355,2021-07-07,2021,ARI,COL,6,4,6-4,ARI,9,1,35,39,74,145,143,288,11,13,24,2,3:02
17362,633459,2021-06-27,2021,TBA,ANA,4,6,6-4,ANA,9,0,36,40,76,158,150,308,9,16,25,4,3:26
17363,633309,2021-07-16,2021,CHA,HOU,1,7,7-1,HOU,9,0,31,43,74,188,124,312,5,16,21,2,3:07
17364,633493,2021-06-27,2021,CIN,ATL,0,4,4-0,ATL,9,0,33,36,69,148,162,310,6,11,17,1,3:15
17365,633219,2021-07-26,2021,BOS,TOR,5,4,5-4,BOS,9,1,35,37,72,134,134,268,12,11,23,4,3:17
17366,633305,2021-07-16,2021,WAS,SDN,8,24,24-8,SDN,9,0,41,60,101,258,174,432,16,31,47,3,4:15
17367,633568,2021-06-23,2021,BAL,HOU,0,13,13-0,HOU,9,0,34,49,83,175,118,293,9,23,32,1,2:46
17368,633469,2021-07-01,2021,CLE,HOU,2,7,7-2,HOU,9,0,37,39,76,167,145,312,12,12,24,1,3:04
17369,633402,2021-07-02,2021,ANA,BAL,8,7,8-7,ANA,9,0,40,41,81,161,142,303,15,14,29,8,3:26
17370,633124,2021-07-29,2021,CHN,CIN,4,7,7-4,CIN,9,0,34,42,76,158,147,305,10,16,26,2,3:12
17371,633321,2021-07-16,2021,COL,LAN,4,10,10-4,LAN,9,0,39,48,87,153,131,284,14,20,34,2,3:17
17372,633163,2021-07-23,2021,MIL,CHA,7,1,7-1,MIL,9,1,39,36,75,121,143,264,18,10,28,1,3:00
17373,633175,2021-07-24,2021,CIN,SLN,5,3,5-3,CIN,9,1,36,39,75,143,128,271,12,14,26,1,2:55
17374,633159,2021-07-23,2021,MIN,ANA,5,4,5-4,MIN,9,1,37,39,76,137,140,277,15,12,27,1,3:07
17375,633306,2021-07-17,2021,OAK,CLE,2,3,3-2,CLE,9,0,38,37,75,137,154,291,12,11,23,0,3:11
17376,633229,2021-07-23,2021,SEA,OAK,4,3,4-3,SEA,9,1,33,36,69,159,139,298,9,11,20,1,3:17
17377,633508,2021-06-29,2021,SLN,ARI,3,2,3-2,SLN,9,1,36,37,73,147,148,295,12,11,23,1,3:11
17378,633199,2021-07-20,2021,LAN,SFN,8,6,8-6,LAN,9,0,39,38,77,151,135,286,16,10,26,3,3:22
17379,633446,2021-06-29,2021,MIL,CHN,2,1,2-1,MIL,9,1,32,40,72,172,144,316,7,15,22,1,3:40
17380,633127,2021-07-31,2021,SLN,MIN,1,8,8-1,MIN,9,0,34,43,77,160,133,293,9,14,23,1,2:58
17381,633532,2021-06-22,2021,TEX,OAK,6,13,13-6,OAK,9,0,38,46,84,183,129,312,13,20,33,3,3:20
17382,633243,2021-07-19,2021,ARI,PIT,4,2,4-2,ARI,9,1,36,40,76,140,145,285,13,14,27,2,3:25
17383,633534,2021-06-26,2021,TEX,KCA,8,0,8-0,TEX,9,1,45,32,77,138,183,321,20,6,26,1,3:27
17384,633491,2021-06-30,2021,COL,PIT,6,2,6-2,COL,9,1,39,37,76,151,162,313,18,11,29,2,3:27
17385,633569,2021-06-23,2021,PIT,CHA,3,4,4-3,CHA,9,0,38,39,77,163,152,315,11,13,24,3,3:37
17386,633399,2021-07-04,2021,OAK,BOS,0,1,1-0,BOS,9,0,34,34,68,117,147,264,7,7,14,1,2:52
17387,633450,2021-06-28,2021,MIL,CHN,14,4,14-4,MIL,9,1,45,39,84,161,152,313,22,13,35,2,3:43
17388,633490,2021-06-28,2021,SLN,ARI,7,1,7-1,SLN,9,1,37,38,75,175,141,316,12,12,24,3,3:33
17389,633259,2021-07-19,2021,LAN,SFN,2,7,7-2,SFN,9,0,36,43,79,159,157,316,9,17,26,5,3:45
17390,633526,2021-06-22,2021,DET,SLN,8,2,8-2,DET,9,1,41,38,79,157,157,314,17,11,28,3,3:13
17391,633317,2021-07-10,2021,CLE,KCA,14,6,14-6,CLE,9,1,41,39,80,152,147,299,20,12,32,4,3:20
17392,633142,2021-07-31,2021,SDN,COL,3,5,5-3,COL,9,0,37,36,73,149,151,300,12,9,21,0,3:13
17393,633132,2021-07-31,2021,WAS,CHN,3,6,6-3,CHN,9,0,38,41,79,153,137,290,11,13,24,2,3:16
17394,633496,2021-06-29,2021,BOS,KCA,7,6,7-6,BOS,9,1,40,41,81,164,154,318,20,16,36,2,3:31
17395,633267,2021-07-17,2021,WAS,SDN,4,10,10-4,SDN,9,0,40,45,85,170,154,324,15,23,38,2,3:37
17396,633099,2021-07-31,2021,ARI,LAN,3,8,8-3,LAN,9,0,32,45,77,149,148,297,7,18,25,4,3:33
17397,633549,2021-06-22,2021,PHI,WAS,2,3,3-2,WAS,9,0,38,39,77,161,183,344,11,12,23,2,3:52
17398,633621,2021-06-22,2021,NYA,KCA,5,6,6-5,KCA,9,0,45,39,84,138,190,328,19,11,30,3,3:38
17399,633260,2021-07-21,2021,ARI,PIT,6,4,6-4,ARI,9,1,39,38,77,144,147,291,17,12,29,3,3:24
17400,633290,2021-07-17,2021,PIT,NYN,9,7,9-7,PIT,9,0,43,40,83,160,165,325,18,16,34,2,3:49
17401,633551,2021-06-23,2021,NYA,KCA,6,5,6-5,NYA,9,0,41,41,82,142,200,342,18,16,34,2,3:40
17402,633144,2021-07-24,2021,SFN,PIT,2,10,10-2,PIT,9,0,33,46,79,185,132,317,7,20,27,2,3:27
17403,633747,2021-06-21,2021,BAL,HOU,2,10,10-2,HOU,9,0,32,47,79,190,163,353,4,21,25,2,3:40 (1:41 delay)
17404,633561,2021-06-23,2021,NYN,ATL,7,3,7-3,NYN,9,1,40,39,79,185,158,343,17,13,30,3,3:42
17405,633173,2021-07-23,2021,LAN,COL,6,9,9-6,COL,10,0,45,43,88,156,187,343,15,14,29,3,4:06
17406,633474,2021-06-30,2021,MIL,CHN,15,7,15-7,MIL,9,1,47,41,88,151,189,340,23,15,38,3,3:47
17407,633237,2021-07-18,2021,ATL,TBA,5,7,7-5,TBA,9,0,42,37,79,146,169,315,15,11,26,3,3:11
17408,633224,2021-07-21,2021,ATL,SDN,5,6,6-5,SDN,7,0,31,33,64,156,162,318,11,14,25,3,3:17 (4:08 delay)
17409,633449,2021-06-29,2021,HOU,BAL,3,13,13-3,BAL,9,0,42,47,89,197,156,353,18,21,39,6,3:53
17410,633329,2021-07-19,2021,DET,TEX,14,0,14-0,DET,9,1,47,32,79,135,176,311,26,5,31,3,3:25
17411,633230,2021-07-20,2021,SLN,CHN,6,7,7-6,CHN,9,0,38,42,80,172,161,333,11,15,26,3,3:43
17412,633564,2021-06-24,2021,DET,HOU,3,12,12-3,HOU,9,0,38,53,91,201,142,343,13,26,39,2,3:52
17413,633098,2021-07-28,2021,BAL,MIA,8,7,8-7,BAL,9,0,41,46,87,164,173,337,19,19,38,3,3:32
17414,633202,2021-07-24,2021,PHI,ATL,3,15,15-3,ATL,9,0,41,50,91,178,166,344,14,22,36,3,3:31
17415,633483,2021-06-28,2021,HOU,BAL,7,9,9-7,BAL,9,0,47,45,92,185,198,383,21,19,40,6,4:19
17416,633546,2021-06-23,2021,PHI,WAS,12,13,13-12,WAS,9,0,50,44,94,195,183,378,22,20,42,5,4:19
17417,633146,2021-07-28,2021,SEA,HOU,4,11,11-4,HOU,9,0,42,49,91,206,189,395,15,22,37,3,4:14
17418,633570,2021-06-23,2021,ANA,SFN,3,9,9-3,SFN,13,0,50,55,105,208,176,384,14,18,32,2,4:51
17419,633138,2021-07-28,2021,MIN,DET,14,17,17-14,DET,9,0,51,51,102,196,205,401,24,25,49,3,4:03
17420,633253,2021-07-17,2021,CIN,MIL,4,7,7-4,MIL,11,0,45,52,97,194,195,389,13,19,32,4,4:37 (:43 delay)
17421,633460,2021-07-01,2021,COL,SLN,5,2,5-2,COL,9,0,35,35,70,109,135,244,10,8,18,0,2:47 (:58 delay)
17422,633547,2021-06-22,2021,BAL,HOU,1,3,3-1,HOU,9,0,32,38,70,155,115,270,7,12,19,4,2:55
17423,633750,2021-06-22,2021,NYN,ATL,0,3,3-0,ATL,9,0,33,37,70,150,131,281,6,10,16,0,3:02 (:26 delay)
17424,633670,2021-06-22,2021,ANA,SFN,0,5,5-0,SFN,9,0,35,39,74,158,131,289,8,13,21,0,2:53
17425,633351,2021-07-08,2021,MIL,CIN,5,3,5-3,MIL,9,1,37,38,75,149,143,292,15,11,26,3,3:16
17426,633457,2021-07-01,2021,BOS,KCA,15,1,15-1,BOS,9,1,45,35,80,118,174,292,23,8,31,0,3:08
17427,633386,2021-07-05,2021,CHN,PHI,3,13,13-3,PHI,9,0,36,44,80,174,147,321,10,17,27,2,3:33
17428,633519,2021-06-22,2021,TBA,BOS,5,9,9-5,BOS,11,0,46,45,91,197,169,366,15,15,30,3,4:21
17429,632924,2021-08-12,2021,CHA,NYA,9,8,9-8,CHA,9,0,37,42,79,189,128,317,13,14,27,2,3:29
17430,632297,2021-09-29,2021,LAN,SDN,11,9,11-9,LAN,9,1,39,43,82,160,139,299,15,16,31,4,3:34
17431,632949,2021-08-12,2021,NYN,WAS,4,1,4-1,NYN,7,1,29,26,55,110,96,206,13,7,20,2,2:28
17432,632963,2021-08-07,2021,TOR,BOS,1,0,1-0,TOR,7,0,21,24,45,100,77,177,3,4,7,0,1:55
17433,632940,2021-08-10,2021,ANA,TOR,0,4,4-0,TOR,7,0,28,32,60,121,94,215,7,12,19,1,2:23
17434,632893,2021-08-17,2021,NYA,BOS,2,0,2-0,NYA,7,1,27,30,57,108,103,211,9,9,18,2,2:31
17435,632497,2021-09-14,2021,TOR,TBA,0,2,2-0,TBA,9,0,30,34,64,118,103,221,4,7,11,0,2:20
17436,633003,2021-08-05,2021,TOR,CLE,3,0,3-0,TOR,9,1,30,33,63,134,105,239,6,5,11,0,2:25
17437,632861,2021-08-18,2021,DET,ANA,1,3,3-1,ANA,9,0,31,34,65,121,100,221,6,7,13,1,2:25
17438,632919,2021-08-17,2021,SFN,NYN,3,2,3-2,SFN,9,1,30,35,65,107,126,233,7,9,16,2,2:27
17439,633095,2021-08-01,2021,ATL,MIL,1,2,2-1,MIL,9,0,36,30,66,122,127,249,9,3,12,1,2:38
17440,632997,2021-08-10,2021,CHN,MIL,2,4,4-2,MIL,7,0,32,30,62,105,119,224,11,9,20,1,2:38
17441,632997,2021-08-10,2021,CHN,MIL,2,4,4-2,MIL,7,0,32,30,62,105,119,224,11,9,20,1,2:38
17442,632437,2021-09-20,2021,CLE,KCA,2,7,7-2,KCA,7,0,28,30,58,111,97,208,8,10,18,1,2:08
17443,633066,2021-08-03,2021,WAS,PHI,4,5,5-4,PHI,9,0,37,35,72,116,130,246,10,8,18,1,2:35
17444,632912,2021-08-12,2021,NYN,WAS,5,4,5-4,NYN,7,0,30,31,61,120,114,234,11,12,23,2,2:46
17445,633054,2021-08-02,2021,TEX,ANA,4,1,4-1,TEX,9,1,31,32,63,125,110,235,8,5,13,1,2:29
17446,632813,2021-08-16,2021,COL,SDN,6,5,6-5,COL,9,0,32,36,68,116,108,224,10,11,21,0,2:32
17447,632872,2021-08-17,2021,MIA,ATL,0,2,2-0,ATL,9,0,31,34,65,122,119,241,6,7,13,1,2:33
17448,632912,2021-08-12,2021,NYN,WAS,5,4,5-4,NYN,7,0,30,31,61,120,114,234,11,12,23,2,2:46
17449,632303,2021-09-29,2021,NYN,MIA,2,3,3-2,MIA,9,0,33,32,65,110,111,221,9,8,17,1,2:39
17450,633394,2021-09-20,2021,CLE,KCA,2,4,4-2,KCA,7,0,24,29,53,135,103,238,4,10,14,3,2:37
17451,632982,2021-08-06,2021,SLN,KCA,4,2,4-2,SLN,9,1,35,35,70,116,140,256,12,9,21,0,2:49
17452,633047,2021-08-01,2021,CHA,CLE,2,1,2-1,CHA,9,0,34,32,66,134,130,264,9,6,15,0,2:45
17453,632928,2021-08-11,2021,PIT,SLN,0,4,4-0,SLN,9,0,28,39,67,159,88,247,2,16,18,1,2:52
17454,632972,2021-08-13,2021,ANA,HOU,1,4,4-1,HOU,9,0,32,36,68,132,122,254,5,8,13,1,2:51
17455,632678,2021-08-30,2021,TEX,COL,4,3,4-3,TEX,9,1,33,35,68,142,114,256,11,9,20,1,2:49
17456,633009,2021-08-08,2021,CIN,PIT,3,2,3-2,CIN,9,1,33,34,67,133,129,262,10,7,17,1,2:52
17457,633049,2021-08-03,2021,MIA,NYN,5,4,5-4,MIA,9,1,35,36,71,113,123,236,12,10,22,3,2:43
17458,632859,2021-08-18,2021,KCA,HOU,3,2,3-2,KCA,9,1,31,37,68,129,112,241,9,12,21,2,2:49
17459,632516,2021-09-12,2021,SLN,CIN,2,0,2-0,SLN,9,1,28,33,61,132,108,240,4,6,10,2,2:35
17460,632947,2021-08-12,2021,SEA,TEX,3,1,3-1,SEA,9,1,32,29,61,108,110,218,8,3,11,0,2:08
17461,632975,2021-08-08,2021,ATL,WAS,5,4,5-4,ATL,9,1,31,40,71,161,88,249,7,14,21,1,2:42
17462,632847,2021-08-15,2021,TEX,OAK,7,4,7-4,TEX,9,1,33,38,71,131,118,249,9,12,21,1,2:39
17463,632801,2021-08-22,2021,CIN,MIA,3,1,3-1,CIN,9,1,32,32,64,127,137,264,10,5,15,0,2:43
17464,632357,2021-09-24,2021,MIN,TOR,3,1,3-1,MIN,9,1,33,32,65,129,123,252,9,5,14,1,2:38
17465,632875,2021-08-17,2021,KCA,HOU,3,1,3-1,KCA,9,1,33,33,66,131,111,242,11,9,20,1,2:45
17466,632341,2021-09-25,2021,PHI,PIT,3,0,3-0,PHI,9,1,35,28,63,97,144,241,14,4,18,1,2:33
17467,633050,2021-08-01,2021,DET,BAL,6,2,6-2,DET,9,1,36,34,70,129,148,277,12,7,19,3,2:56
17468,633055,2021-08-04,2021,TEX,ANA,1,2,2-1,ANA,9,0,32,34,66,127,136,263,7,8,15,0,2:53
17469,633069,2021-08-01,2021,MIA,NYA,1,3,3-1,NYA,9,0,32,35,67,133,133,266,7,7,14,2,3:04
17470,633027,2021-08-04,2021,TBA,SEA,4,3,4-3,TBA,9,1,33,35,68,136,129,265,9,8,17,1,2:39
17471,632869,2021-08-17,2021,ARI,PHI,3,2,3-2,ARI,9,1,32,36,68,136,116,252,10,10,20,1,2:49
17472,633032,2021-08-03,2021,SLN,ATL,1,6,6-1,ATL,9,0,34,37,71,134,141,275,9,13,22,0,2:39
17473,632863,2021-08-15,2021,SFN,COL,5,2,5-2,SFN,9,1,36,35,71,117,128,245,13,9,22,3,2:53
17474,632853,2021-08-17,2021,TEX,SEA,1,3,3-1,SEA,9,0,33,35,68,124,132,256,7,9,16,1,2:56
17475,633331,2021-09-11,2021,BAL,TOR,2,11,11-2,TOR,7,0,29,36,65,146,111,257,7,15,22,2,2:28
17476,633000,2021-08-10,2021,CHN,MIL,3,6,6-3,MIL,7,0,31,31,62,124,119,243,10,11,21,5,2:55 (1:29 delay)
17477,632685,2021-08-26,2021,SDN,LAN,0,4,4-0,LAN,9,0,31,34,65,141,123,264,5,7,12,1,3:01
17478,632483,2021-09-15,2021,TOR,TBA,6,3,6-3,TOR,9,1,33,33,66,135,125,260,9,6,15,0,2:29
17479,632525,2021-09-11,2021,SLN,CIN,6,4,6-4,SLN,9,1,33,34,67,128,123,251,12,8,20,0,2:44
17480,632518,2021-09-13,2021,WAS,MIA,0,3,3-0,MIA,9,0,29,37,66,137,106,243,2,13,15,0,2:36
17481,632995,2021-08-07,2021,HOU,MIN,4,0,4-0,HOU,9,1,34,31,65,122,135,257,11,4,15,0,2:55
17482,632986,2021-08-07,2021,LAN,ANA,5,3,5-3,LAN,9,1,36,38,74,146,124,270,12,11,23,2,3:05
17483,633086,2021-08-01,2021,SFN,HOU,5,3,5-3,SFN,9,1,36,36,72,135,126,261,13,11,24,2,3:01
17484,633012,2021-08-07,2021,CHN,CHA,0,4,4-0,CHA,9,0,34,35,69,125,148,273,7,8,15,2,3:10
17485,633291,2021-08-17,2021,NYA,BOS,5,3,5-3,NYA,7,1,33,29,62,118,127,245,15,10,25,4,2:56
17486,633246,2021-08-07,2021,TOR,BOS,1,2,2-1,BOS,8,0,32,31,63,130,140,270,9,9,18,2,2:59
17487,632780,2021-08-21,2021,CLE,ANA,5,1,5-1,CLE,9,1,39,30,69,117,146,263,17,4,21,5,2:50
17488,632528,2021-09-10,2021,SEA,ARI,5,4,5-4,SEA,9,1,32,35,67,154,114,268,10,8,18,1,2:38
17489,632934,2021-08-10,2021,MIN,CHA,4,3,4-3,MIN,9,1,35,33,68,119,144,263,12,7,19,0,2:43
17490,633866,2021-09-23,2021,CLE,CHA,2,7,7-2,CHA,7,0,28,34,62,136,133,269,9,15,24,2,2:46
17491,632304,2021-09-29,2021,CHA,CIN,6,1,6-1,CHA,9,1,34,34,68,123,132,255,10,8,18,2,2:41
17492,632880,2021-08-17,2021,MIN,CLE,1,3,3-1,CLE,9,0,35,34,69,110,155,265,9,7,16,1,3:01
17493,632415,2021-09-20,2021,MIL,SLN,2,5,5-2,SLN,9,0,30,38,68,136,107,243,4,12,16,1,2:43
17494,632556,2021-09-09,2021,BAL,KCA,0,6,6-0,KCA,9,0,33,38,71,119,134,253,7,12,19,1,2:44
17495,632897,2021-08-14,2021,PIT,MIL,0,6,6-0,MIL,7,0,26,33,59,125,101,226,5,15,20,1,2:34
17496,632264,2021-10-02,2021,KCA,MIN,0,4,4-0,MIN,9,0,30,37,67,130,122,252,6,10,16,3,2:52
17497,633060,2021-08-04,2021,COL,CHN,2,3,3-2,CHN,9,0,35,38,73,138,122,260,12,12,24,0,3:04
17498,632939,2021-08-12,2021,SFN,COL,7,0,7-0,SFN,9,1,35,31,66,128,156,284,12,7,19,0,2:44
17499,632790,2021-08-21,2021,COL,ARI,5,2,5-2,COL,9,0,34,37,71,114,153,267,9,11,20,0,3:04
17500,632339,2021-09-24,2021,CHN,SLN,5,8,8-5,SLN,7,0,32,33,65,118,128,246,12,13,25,1,2:39
17501,632776,2021-08-24,2021,HOU,KCA,4,0,4-0,HOU,9,1,37,31,68,120,151,271,13,6,19,1,3:21
17502,632409,2021-09-27,2021,CLE,KCA,8,3,8-3,CLE,9,1,38,33,71,124,139,263,12,7,19,2,2:44
17503,632458,2021-09-17,2021,NYA,CLE,8,0,8-0,NYA,9,1,36,32,68,126,138,264,13,7,20,1,2:50
17504,632479,2021-09-15,2021,DET,MIL,4,1,4-1,DET,9,1,31,34,65,148,127,275,8,6,14,1,2:46
17505,632876,2021-08-15,2021,PIT,MIL,1,2,2-1,MIL,9,0,33,37,70,129,140,269,5,11,16,1,3:09
17506,632263,2021-10-02,2021,MIA,PHI,3,1,3-1,MIA,9,1,32,34,66,130,130,260,10,8,18,1,2:52
17507,633036,2021-08-03,2021,TOR,CLE,7,2,7-2,TOR,9,1,38,34,72,121,134,255,14,7,21,0,2:46
17508,633421,2021-08-16,2021,NYA,ANA,2,1,2-1,NYA,9,1,31,32,63,131,125,256,10,4,14,4,2:49
17509,632254,2021-10-03,2021,ATL,NYN,5,0,5-0,ATL,9,1,32,29,61,115,118,233,9,4,13,1,2:26
17510,632342,2021-09-25,2021,OAK,HOU,2,1,2-1,OAK,9,0,38,32,70,113,135,248,14,5,19,1,2:49
17511,632942,2021-08-09,2021,SDN,MIA,8,3,8-3,SDN,9,1,36,35,71,151,135,286,13,8,21,0,3:06
17512,632964,2021-08-09,2021,MIN,CHA,1,11,11-1,CHA,9,0,29,44,73,164,118,282,4,17,21,1,2:48
17513,632952,2021-08-11,2021,SEA,TEX,2,1,2-1,SEA,9,0,36,34,70,138,141,279,13,8,21,1,3:12
17514,632909,2021-08-17,2021,LAN,PIT,4,3,4-3,LAN,9,1,36,36,72,130,150,280,12,7,19,1,3:29
17515,632881,2021-08-15,2021,ANA,HOU,3,1,3-1,ANA,9,1,34,37,71,138,147,285,10,11,21,2,3:02
17516,632442,2021-09-18,2021,SFN,ATL,2,0,2-0,SFN,9,1,34,33,67,119,130,249,10,8,18,1,2:40
17517,632438,2021-09-19,2021,WAS,COL,3,0,3-0,WAS,9,1,33,35,68,145,109,254,10,10,20,3,3:01
17518,632666,2021-09-28,2021,NYN,MIA,2,1,2-1,NYN,9,0,32,32,64,127,136,263,10,6,16,1,2:59
17519,633004,2021-08-05,2021,TEX,ANA,0,5,5-0,ANA,9,0,35,40,75,142,133,275,8,12,20,4,2:59
17520,632298,2021-09-29,2021,SFN,ARI,1,0,1-0,SFN,9,1,36,31,67,105,153,258,12,5,17,0,2:52
17521,632291,2021-09-30,2021,LAN,SDN,8,3,8-3,LAN,9,1,35,36,71,138,117,255,13,9,22,3,2:55
17522,632299,2021-09-29,2021,SEA,OAK,4,2,4-2,SEA,9,1,34,35,69,135,132,267,8,8,16,1,3:06
17523,633024,2021-08-01,2021,SLN,MIN,7,3,7-3,SLN,9,1,39,33,72,102,150,252,16,7,23,0,3:01
17524,632877,2021-08-14,2021,ARI,SDN,7,0,7-0,ARI,9,1,39,28,67,102,146,248,17,3,20,1,2:31
17525,633129,2021-08-01,2021,NYN,CIN,1,7,7-1,CIN,9,0,31,45,76,185,104,289,5,19,24,1,3:06
17526,632967,2021-08-08,2021,PHI,NYN,3,0,3-0,PHI,9,1,28,30,58,108,107,215,6,3,9,0,2:20
17527,632260,2021-10-02,2021,LAN,MIL,8,3,8-3,LAN,9,1,33,33,66,133,133,266,10,7,17,1,2:53
17528,632993,2021-08-07,2021,CLE,DET,1,2,2-1,DET,9,0,38,34,72,105,143,248,11,8,19,2,2:39 (1:06 delay)
17529,632943,2021-08-13,2021,KCA,SLN,0,6,6-0,SLN,9,0,32,40,72,165,124,289,6,13,19,1,3:08
17530,632945,2021-08-08,2021,MIL,SFN,4,5,5-4,SFN,9,0,35,39,74,139,136,275,10,12,22,1,2:49
17531,633044,2021-08-01,2021,WAS,CHN,6,5,6-5,WAS,9,0,40,33,73,152,133,285,20,7,27,1,3:20
17532,633019,2021-08-04,2021,LAN,HOU,7,5,7-5,LAN,9,1,37,36,73,151,136,287,13,9,22,0,3:10
17533,632874,2021-08-15,2021,MIA,CHN,4,1,4-1,MIA,9,1,34,37,71,155,126,281,10,10,20,5,3:21
17534,632743,2021-08-26,2021,BAL,ANA,13,1,13-1,BAL,9,1,44,33,77,120,161,281,21,7,28,2,3:07
17535,632839,2021-08-18,2021,CIN,CHN,1,7,7-1,CHN,9,0,35,41,76,149,139,288,9,16,25,0,3:01
17536,632409,2021-09-27,2021,CLE,KCA,8,3,8-3,CLE,9,1,38,33,71,124,139,263,12,7,19,2,2:44
17537,632515,2021-09-11,2021,DET,TBA,2,7,7-2,TBA,9,0,32,40,72,143,132,275,4,12,16,1,2:49
17538,632826,2021-08-20,2021,CHN,KCA,2,6,6-2,KCA,9,0,33,38,71,153,133,286,7,11,18,0,2:55
17539,632246,2021-10-03,2021,MIA,PHI,5,4,5-4,MIA,9,1,32,37,69,129,123,252,9,11,20,2,2:46
17540,632321,2021-09-28,2021,CHA,CIN,7,1,7-1,CHA,9,1,39,31,70,113,144,257,16,5,21,2,2:49
17541,633002,2021-08-06,2021,CIN,PIT,10,0,10-0,CIN,9,1,39,34,73,127,149,276,15,9,24,0,2:41
17542,632851,2021-08-17,2021,COL,SDN,7,3,7-3,COL,9,1,38,33,71,116,156,272,14,7,21,4,2:57
17543,632281,2021-09-30,2021,SLN,MIL,4,3,4-3,SLN,9,1,30,36,66,141,116,257,7,11,18,3,2:41
17544,632882,2021-08-16,2021,LAN,PIT,2,1,2-1,LAN,9,1,32,38,70,133,124,257,9,13,22,2,2:50
17545,632916,2021-08-14,2021,PHI,CIN,6,1,6-1,PHI,9,1,35,31,66,121,141,262,11,5,16,1,2:38
17546,632290,2021-09-26,2021,TBA,MIA,3,2,3-2,TBA,9,1,32,35,67,123,142,265,8,8,16,3,2:54
17547,633035,2021-08-06,2021,COL,MIA,14,2,14-2,COL,9,1,46,35,81,132,150,282,23,9,32,1,2:51
17548,633015,2021-08-05,2021,CHA,KCA,2,3,3-2,KCA,9,0,35,36,71,156,141,297,9,10,19,1,2:58
17549,632561,2021-09-09,2021,CLE,MIN,4,1,4-1,CLE,9,1,38,31,69,124,164,288,15,6,21,1,2:46
17550,632766,2021-08-25,2021,CLE,TEX,7,2,7-2,CLE,9,1,37,38,75,138,152,290,13,13,26,3,2:56
17551,633067,2021-08-01,2021,TOR,KCA,5,1,5-1,TOR,9,1,38,36,74,141,160,301,15,10,25,2,2:56
17552,632729,2021-08-26,2021,PIT,SLN,11,7,11-7,PIT,9,1,43,37,80,131,142,273,20,11,31,4,3:07
17553,632520,2021-09-13,2021,SFN,SDN,9,1,9-1,SFN,9,1,36,36,72,128,155,283,12,9,21,1,2:51
17554,632946,2021-08-11,2021,CHN,MIL,0,10,10-0,MIL,9,0,30,45,75,168,109,277,4,19,23,0,2:58
17555,632523,2021-09-12,2021,ATL,MIA,5,3,5-3,ATL,9,1,35,35,70,135,139,274,11,7,18,1,3:17
17556,632390,2021-09-23,2021,BAL,TEX,3,0,3-0,BAL,9,1,32,35,67,154,130,284,8,9,17,1,2:46
17557,632990,2021-08-06,2021,CLE,DET,6,1,6-1,CLE,9,1,38,34,72,148,144,292,16,8,24,1,3:11
17558,632988,2021-08-07,2021,SDN,ARI,6,2,6-2,SDN,9,1,37,31,68,122,150,272,16,6,22,1,3:18
17559,632347,2021-09-25,2021,DET,KCA,5,1,5-1,DET,9,1,35,35,70,122,146,268,14,10,24,5,3:00
17560,632553,2021-09-12,2021,OAK,TEX,3,4,4-3,TEX,9,0,31,39,70,166,110,276,6,13,19,1,3:04
17561,632267,2021-10-01,2021,SFN,SDN,3,0,3-0,SFN,9,1,35,34,69,126,138,264,10,9,19,0,2:50
17562,632965,2021-08-11,2021,ANA,TOR,2,10,10-2,TOR,9,0,36,40,76,163,132,295,8,13,21,2,3:03
17563,632724,2021-08-26,2021,TOR,CHA,7,10,10-7,CHA,9,0,40,41,81,157,116,273,13,14,27,3,3:14
17564,632655,2021-09-01,2021,ANA,NYA,1,4,4-1,NYA,9,0,31,37,68,139,133,272,4,12,16,3,2:50
17565,632268,2021-10-01,2021,TOR,BAL,6,4,6-4,TOR,9,1,37,36,73,133,112,245,14,12,26,5,2:55
17566,632871,2021-08-17,2021,CIN,CHN,1,2,2-1,CHN,9,0,35,36,71,110,133,243,9,13,22,2,2:45
17567,632294,2021-09-30,2021,BAL,BOS,6,2,6-2,BAL,9,1,34,34,68,117,142,259,12,9,21,1,2:40
17568,632239,2021-10-03,2021,NYA,TBA,1,0,1-0,NYA,9,0,30,36,66,143,117,260,7,9,16,5,3:03
17569,632238,2021-10-03,2021,SLN,CHN,2,3,3-2,CHN,8,1,29,28,57,113,95,208,10,7,17,0,2:11 (:42 delay)
17570,633038,2021-08-03,2021,COL,CHN,13,6,13-6,COL,9,1,42,36,78,127,146,273,18,10,28,1,3:04
17571,632679,2021-08-31,2021,NYN,MIA,3,1,3-1,NYN,7,1,23,28,51,96,79,175,9,7,16,1,2:05
17572,632970,2021-08-08,2021,CHN,CHA,3,9,9-3,CHA,9,0,36,41,77,157,147,304,9,15,24,0,3:06
17573,634173,2021-08-09,2021,CLE,CIN,9,3,9-3,CLE,9,1,41,38,79,146,153,299,17,12,29,2,3:09
17574,633010,2021-08-04,2021,OAK,SDN,5,4,5-4,OAK,10,0,39,40,79,132,155,287,14,12,26,0,3:23
17575,632977,2021-08-08,2021,COL,MIA,13,8,13-8,COL,9,1,39,42,81,155,128,283,15,15,30,2,3:06
17576,632922,2021-08-11,2021,BAL,DET,2,5,5-2,DET,9,0,38,40,78,134,147,281,12,14,26,1,3:01 (1:11 delay)
17577,633057,2021-08-02,2021,WAS,PHI,5,7,7-5,PHI,9,0,36,43,79,151,136,287,12,20,32,4,3:16
17578,632950,2021-08-07,2021,NYA,SEA,5,4,5-4,NYA,9,1,37,36,73,141,152,293,13,9,22,3,3:11
17579,632918,2021-08-12,2021,ANA,TOR,6,3,6-3,ANA,9,1,37,34,71,146,146,292,16,8,24,3,3:08
17580,632864,2021-08-17,2021,TBA,BAL,10,0,10-0,TBA,9,1,38,33,71,142,163,305,12,6,18,3,2:55
17581,632648,2021-09-01,2021,SEA,HOU,1,0,1-0,SEA,9,1,32,35,67,160,133,293,8,10,18,3,3:17
17582,632845,2021-08-19,2021,SLN,MIL,8,4,8-4,SLN,9,1,39,36,75,127,153,280,15,10,25,2,3:21
17583,632987,2021-08-10,2021,KCA,NYA,8,4,8-4,KCA,9,1,37,38,75,163,126,289,12,11,23,4,3:03
17584,632904,2021-08-11,2021,HOU,COL,5,1,5-1,HOU,9,1,39,38,77,140,144,284,15,11,26,0,3:04
17585,632366,2021-09-24,2021,MIL,NYN,5,1,5-1,MIL,9,1,34,34,68,146,143,289,11,6,17,1,2:56
17586,633079,2021-08-02,2021,MIA,NYN,6,3,6-3,MIA,9,1,35,39,74,150,142,292,10,13,23,1,3:11
17587,632340,2021-09-24,2021,ARI,LAN,2,4,4-2,LAN,9,0,34,39,73,136,138,274,7,14,21,1,2:59
17588,632293,2021-09-30,2021,ATL,PHI,5,3,5-3,ATL,9,1,34,35,69,125,142,267,10,9,19,2,2:53
17589,632270,2021-10-01,2021,SEA,ANA,1,2,2-1,ANA,9,0,34,33,67,146,147,293,9,8,17,2,3:13
17590,632429,2021-09-20,2021,PHI,BAL,0,2,2-0,BAL,9,0,32,35,67,144,124,268,5,10,15,1,2:49
17591,632968,2021-08-07,2021,SLN,KCA,5,2,5-2,SLN,9,1,37,34,71,156,133,289,15,7,22,1,3:07
17592,632292,2021-09-30,2021,HOU,TBA,3,2,3-2,HOU,9,1,32,32,64,142,128,270,8,7,15,1,3:00
17593,632236,2021-10-03,2021,TEX,CLE,0,6,6-0,CLE,9,0,32,39,71,156,128,284,5,11,16,1,2:54
17594,632265,2021-10-02,2021,CHA,DET,5,4,5-4,CHA,9,1,34,36,70,147,127,274,10,10,20,2,3:05 (:26 delay)
17595,633030,2021-08-03,2021,CHA,KCA,7,1,7-1,CHA,9,1,35,33,68,138,139,277,12,5,17,1,2:44
17596,633089,2021-08-01,2021,TBA,BOS,3,2,3-2,TBA,9,1,30,39,69,149,112,261,8,12,20,2,2:51
17597,632927,2021-08-11,2021,MIN,CHA,1,0,1-0,MIN,9,1,31,35,66,131,138,269,8,9,17,2,2:48
17598,632994,2021-08-07,2021,ATL,WAS,2,3,3-2,WAS,9,0,36,37,73,131,139,270,9,11,20,0,3:01
17599,632460,2021-09-17,2021,MIA,PIT,1,2,2-1,PIT,9,0,34,39,73,133,147,280,8,14,22,2,3:04
17600,632312,2021-09-28,2021,SEA,OAK,4,2,4-2,SEA,9,1,38,36,74,113,148,261,14,8,22,4,3:08
17601,632306,2021-09-29,2021,ATL,PHI,7,2,7-2,ATL,9,1,40,33,73,123,139,262,16,6,22,2,3:05
17602,632247,2021-10-02,2021,TOR,BAL,10,1,10-1,TOR,9,1,39,31,70,111,140,251,14,4,18,1,2:47
17603,632812,2021-08-22,2021,CLE,ANA,3,0,3-0,CLE,9,1,33,33,66,136,118,254,9,8,17,1,2:47
17604,632973,2021-08-10,2021,HOU,COL,5,0,5-0,HOU,9,1,36,35,71,165,155,320,13,10,23,3,3:28
17605,632933,2021-08-10,2021,SFN,ARI,8,7,8-7,SFN,9,0,41,38,79,138,158,296,17,12,29,3,3:10
17606,633087,2021-08-03,2021,DET,BOS,4,2,4-2,DET,9,1,34,38,72,167,146,313,11,11,22,2,3:24
17607,633061,2021-08-03,2021,LAN,HOU,0,3,3-0,HOU,9,0,37,38,75,155,151,306,9,15,24,1,3:23
17608,632956,2021-08-08,2021,LAN,ANA,8,2,8-2,LAN,9,1,40,39,79,148,141,289,17,12,29,1,2:58
17609,633018,2021-08-04,2021,NYA,BAL,10,3,10-3,NYA,9,1,40,32,72,122,152,274,17,7,24,3,2:56
17610,632734,2021-08-27,2021,TEX,HOU,4,5,5-4,HOU,9,0,40,39,79,151,140,291,14,12,26,1,3:15
17611,632526,2021-09-12,2021,PIT,WAS,2,6,6-2,WAS,9,0,33,41,74,144,135,279,8,16,24,2,3:06
17612,633074,2021-08-06,2021,PHI,NYN,4,2,4-2,PHI,9,1,33,37,70,159,141,300,10,9,19,0,3:16
17613,632951,2021-08-11,2021,SFN,ARI,7,2,7-2,SFN,9,1,37,38,75,154,136,290,15,12,27,0,3:14
17614,632745,2021-08-26,2021,NYN,SFN,2,3,3-2,SFN,9,0,38,35,73,128,140,268,14,8,22,3,3:07
17615,632491,2021-09-14,2021,SFN,SDN,6,1,6-1,SFN,9,1,41,32,73,117,163,280,19,4,23,4,3:17
17616,632989,2021-08-10,2021,ATL,CIN,3,2,3-2,ATL,9,1,35,35,70,149,141,290,11,9,20,3,3:02
17617,632756,2021-08-25,2021,BAL,ANA,10,6,10-6,BAL,9,1,39,38,77,131,158,289,16,13,29,7,3:22
17618,632318,2021-09-28,2021,LAN,SDN,2,1,2-1,LAN,9,1,39,33,72,123,157,280,16,8,24,1,3:04
17619,632524,2021-09-12,2021,SEA,ARI,4,5,5-4,ARI,9,0,37,37,74,115,152,267,8,12,20,3,3:03
17620,632423,2021-09-20,2021,DET,CHA,4,3,4-3,DET,9,1,32,36,68,141,143,284,7,9,16,0,2:56
17621,632316,2021-09-28,2021,HOU,TBA,4,3,4-3,HOU,9,0,36,36,72,152,132,284,12,10,22,2,2:59
17622,632436,2021-09-17,2021,SLN,SDN,8,2,8-2,SLN,9,1,35,37,72,147,140,287,11,11,22,4,3:13
17623,632305,2021-09-29,2021,HOU,TBA,0,7,7-0,TBA,9,0,32,39,71,148,124,272,5,17,22,1,3:04
17624,632371,2021-09-23,2021,ANA,HOU,3,2,3-2,ANA,9,1,34,38,72,149,136,285,10,11,21,2,3:18
17625,632564,2021-09-09,2021,SLN,LAN,2,1,2-1,SLN,9,1,32,34,66,134,129,263,8,7,15,1,2:56
17626,632439,2021-09-18,2021,TEX,CHA,2,1,2-1,TEX,9,1,35,37,72,148,125,273,12,10,22,1,3:15
17627,632308,2021-09-28,2021,TEX,ANA,5,2,5-2,TEX,9,1,35,32,67,133,141,274,13,6,19,2,2:59
17628,632374,2021-09-23,2021,ARI,ATL,6,4,6-4,ARI,9,1,36,37,73,148,130,278,14,12,26,2,2:56
17629,632698,2021-08-29,2021,PIT,SLN,4,3,4-3,PIT,9,0,33,35,68,144,129,273,8,11,19,1,3:00
17630,633008,2021-08-06,2021,SDN,ARI,5,8,8-5,ARI,9,0,40,39,79,147,144,291,14,14,28,3,3:09
17631,633034,2021-08-05,2021,CIN,PIT,7,4,7-4,CIN,9,1,36,37,73,159,152,311,12,12,24,0,3:17
17632,632998,2021-08-05,2021,HOU,MIN,3,5,5-3,MIN,9,0,34,42,76,161,142,303,7,16,23,3,3:14
17633,633013,2021-08-05,2021,NYA,SEA,5,3,5-3,NYA,9,1,37,38,75,158,145,303,13,14,27,0,3:13
17634,633052,2021-08-04,2021,DET,BOS,1,4,4-1,BOS,9,0,38,38,76,144,164,308,11,13,24,2,3:20
17635,633041,2021-08-02,2021,TOR,CLE,2,5,5-2,CLE,10,0,38,42,80,173,142,315,9,13,22,0,3:14
17636,632583,2021-09-07,2021,ATL,WAS,8,5,8-5,ATL,9,1,38,40,78,144,141,285,15,15,30,2,3:14
17637,632856,2021-08-18,2021,WAS,TOR,8,5,8-5,WAS,9,1,40,39,79,146,149,295,17,13,30,5,3:19
17638,632789,2021-08-24,2021,MIA,WAS,1,5,5-1,WAS,9,0,35,40,75,151,153,304,9,15,24,2,3:16
17639,632286,2021-09-30,2021,PIT,CHN,0,9,9-0,CHN,9,0,32,42,74,151,116,267,8,16,24,0,2:49
17640,632240,2021-10-03,2021,PIT,CIN,3,6,6-3,CIN,9,0,36,41,77,155,123,278,10,15,25,1,2:59
17641,632377,2021-09-22,2021,TBA,TOR,7,1,7-1,TBA,9,1,38,37,75,140,146,286,15,9,24,4,3:20
17642,632420,2021-09-19,2021,ANA,OAK,2,3,3-2,OAK,10,0,38,44,82,155,125,280,9,16,25,2,3:21
17643,632301,2021-09-29,2021,SLN,MIL,0,4,4-0,MIL,9,0,33,38,71,147,139,286,7,12,19,1,2:48
17644,632300,2021-09-29,2021,MIN,DET,5,2,5-2,MIN,9,1,35,40,75,146,127,273,12,14,26,2,3:05
17645,633020,2021-08-06,2021,MIL,SFN,2,1,2-1,MIL,10,0,33,37,70,149,128,277,7,6,13,0,3:08
17646,633084,2021-08-01,2021,SDN,COL,8,1,8-1,SDN,9,1,38,34,72,132,160,292,14,10,24,1,3:02
17647,632416,2021-09-19,2021,KCA,SEA,1,7,7-1,SEA,9,0,31,43,74,177,117,294,4,18,22,1,3:04
17648,632913,2021-08-14,2021,MIN,TBA,12,0,12-0,MIN,9,1,45,30,75,102,164,266,21,5,26,0,2:51
17649,632921,2021-08-13,2021,WAS,ATL,2,4,4-2,ATL,9,0,38,34,72,122,146,268,13,8,21,1,3:02 (3:12 delay)
17650,632917,2021-08-15,2021,ARI,SDN,2,8,8-2,SDN,9,0,36,45,81,176,122,298,9,22,31,1,3:19
17651,632883,2021-08-16,2021,KCA,HOU,7,6,7-6,KCA,9,1,40,37,77,104,143,247,16,13,29,3,3:06
17652,632346,2021-09-25,2021,MIL,NYN,2,1,2-1,MIL,9,1,33,34,67,139,146,285,11,8,19,0,3:16
17653,632738,2021-08-25,2021,CHN,COL,5,2,5-2,CHN,7,1,27,25,52,95,107,202,9,4,13,2,2:09
17654,632241,2021-10-03,2021,SFN,SDN,11,4,11-4,SFN,9,1,40,36,76,128,138,266,16,10,26,3,2:56
17655,633045,2021-08-03,2021,CIN,MIN,5,7,7-5,MIN,9,0,37,41,78,184,139,323,12,15,27,2,3:37
17656,633040,2021-08-04,2021,WAS,PHI,5,9,9-5,PHI,9,0,36,44,80,159,132,291,9,15,24,2,3:10
17657,632962,2021-08-07,2021,OAK,TEX,12,3,12-3,OAK,9,1,44,37,81,138,174,312,22,10,32,1,3:04
17658,633031,2021-08-06,2021,ATL,WAS,8,4,8-4,ATL,9,1,41,34,75,146,164,310,17,9,26,2,3:11
17659,632906,2021-08-13,2021,SFN,COL,5,4,5-4,SFN,9,1,39,41,80,152,141,293,15,14,29,1,3:13
17660,632588,2021-09-07,2021,BOS,TBA,7,12,12-7,TBA,9,0,43,41,84,145,149,294,16,15,31,1,2:57
17661,632422,2021-09-19,2021,HOU,ARI,7,6,7-6,HOU,9,1,38,36,74,138,165,303,14,10,24,2,3:17
17662,632443,2021-09-19,2021,SLN,SDN,8,7,8-7,SLN,9,1,36,38,74,150,130,280,13,12,25,3,3:16
17663,632710,2021-09-01,2021,DET,OAK,8,6,8-6,DET,9,1,38,38,76,152,146,298,14,11,25,2,3:13
17664,633078,2021-08-02,2021,NYA,BAL,1,7,7-1,BAL,9,0,37,38,75,158,152,310,11,13,24,1,3:12
17665,632387,2021-09-23,2021,CIN,WAS,2,3,3-2,WAS,9,0,38,38,76,150,144,294,12,12,24,1,3:09
17666,632336,2021-09-26,2021,MIN,TOR,2,5,5-2,TOR,9,0,37,38,75,151,146,297,12,11,23,3,3:27
17667,633075,2021-08-01,2021,TEX,SEA,4,3,4-3,TEX,9,0,33,40,73,184,123,307,10,15,25,1,3:05
17668,632365,2021-09-23,2021,PHI,PIT,12,6,12-6,PHI,9,1,42,34,76,121,178,299,20,8,28,2,3:21
17669,632935,2021-08-11,2021,KCA,NYA,2,5,5-2,NYA,9,0,36,39,75,145,150,295,9,16,25,3,3:22
17670,632282,2021-10-01,2021,NYA,TBA,3,4,4-3,TBA,9,0,36,39,75,160,131,291,9,13,22,5,3:25
17671,632424,2021-09-20,2021,ANA,HOU,0,10,10-0,HOU,9,0,35,45,80,166,123,289,10,19,29,1,3:12
17672,632407,2021-09-19,2021,NYN,PHI,3,2,3-2,NYN,9,1,33,39,72,158,132,290,10,12,22,3,3:34
17673,632446,2021-09-19,2021,TOR,MIN,5,3,5-3,TOR,9,1,37,35,72,131,159,290,14,7,21,1,2:58
17674,633048,2021-08-01,2021,ANA,OAK,3,8,8-3,OAK,9,0,33,45,78,168,123,291,8,19,27,2,3:08
17675,632941,2021-08-14,2021,MIA,CHN,5,4,5-4,MIA,9,1,35,33,68,126,152,278,8,8,16,1,3:03
17676,632726,2021-08-26,2021,MIL,CIN,1,5,5-1,CIN,9,0,35,34,69,145,136,281,11,10,21,2,3:00
17677,632884,2021-08-17,2021,SLN,MIL,0,2,2-0,MIL,9,0,34,42,76,145,140,285,7,17,24,0,3:15
17678,632688,2021-08-31,2021,DET,OAK,3,9,9-3,OAK,9,0,38,42,80,153,137,290,12,16,28,1,2:58
17679,632245,2021-10-03,2021,HOU,OAK,7,6,7-6,HOU,9,0,39,36,75,129,143,272,15,9,24,1,2:52
17680,632666,2021-09-28,2021,NYN,MIA,2,1,2-1,NYN,9,0,32,32,64,127,136,263,10,6,16,1,2:59
17681,632894,2021-08-14,2021,TEX,OAK,3,8,8-3,OAK,9,0,36,38,74,154,105,259,11,11,22,2,2:55
17682,632954,2021-08-13,2021,SEA,TOR,3,2,3-2,SEA,9,0,34,38,72,127,124,251,10,14,24,2,3:00
17683,632327,2021-09-26,2021,ANA,SEA,1,5,5-1,SEA,9,0,33,40,73,171,122,293,6,12,18,2,3:09
17684,632611,2021-09-04,2021,WAS,NYN,4,3,4-3,WAS,7,1,24,29,53,109,96,205,8,8,16,1,2:17
17685,632953,2021-08-08,2021,NYA,SEA,0,2,2-0,SEA,9,0,38,38,76,174,160,334,11,11,22,1,3:48
17686,633021,2021-08-04,2021,MIA,NYN,3,5,5-3,NYN,9,0,34,44,78,177,133,310,7,16,23,3,3:33
17687,633023,2021-08-03,2021,NYA,BAL,13,1,13-1,NYA,9,1,40,36,76,138,164,302,16,10,26,1,3:04
17688,632955,2021-08-10,2021,SEA,TEX,4,5,5-4,TEX,10,0,43,39,82,146,174,320,15,8,23,1,3:28
17689,633068,2021-08-04,2021,MIL,PIT,4,2,4-2,MIL,9,1,34,38,72,152,163,315,10,12,22,1,3:16
17690,632538,2021-09-11,2021,ATL,MIA,4,6,6-4,MIA,9,0,40,40,80,137,167,304,12,13,25,1,3:23
17691,632519,2021-09-12,2021,MIN,KCA,3,5,5-3,KCA,9,0,36,41,77,158,139,297,9,14,23,3,3:31
17692,632510,2021-09-12,2021,CLE,MIL,1,11,11-1,MIL,9,0,31,44,75,165,141,306,5,15,20,1,2:59
17693,632944,2021-08-12,2021,PIT,SLN,6,7,7-6,SLN,9,0,38,41,79,155,153,308,12,15,27,2,3:39
17694,632250,2021-10-01,2021,PIT,CIN,9,2,9-2,PIT,9,1,39,35,74,148,152,300,17,8,25,3,3:21
17695,633033,2021-08-05,2021,MIA,NYN,4,2,4-2,MIA,9,1,33,44,77,190,122,312,11,17,28,3,3:38
17696,632277,2021-10-01,2021,ATL,NYN,3,4,4-3,NYN,9,0,36,36,72,131,155,286,9,13,22,0,3:02
17697,632489,2021-09-13,2021,TOR,TBA,8,1,8-1,TOR,9,1,42,30,72,113,169,282,19,3,22,2,2:53
17698,632271,2021-10-01,2021,MIA,PHI,0,5,5-0,PHI,9,0,35,39,74,140,133,273,11,13,24,0,3:01
17699,632689,2021-09-01,2021,MIN,CHN,0,3,3-0,CHN,9,0,32,31,63,134,126,260,6,5,11,0,2:28
17700,632932,2021-08-13,2021,ARI,SDN,3,2,3-2,ARI,9,0,35,37,72,130,157,287,13,10,23,1,3:06
17701,632862,2021-08-18,2021,COL,SDN,7,5,7-5,COL,9,1,35,39,74,134,142,276,13,12,25,2,3:10
17702,632820,2021-08-14,2021,PIT,MIL,14,4,14-4,PIT,7,1,40,28,68,103,162,265,23,8,31,2,2:43
17703,632765,2021-08-29,2021,CHA,CHN,13,1,13-1,CHA,9,1,39,33,72,147,133,280,17,7,24,2,3:00
17704,632908,2021-08-17,2021,CHA,OAK,9,0,9-0,CHA,9,1,38,31,69,111,158,269,15,8,23,1,2:46
17705,632322,2021-09-28,2021,COL,WAS,3,1,3-1,COL,9,1,36,35,71,117,142,259,14,12,26,1,3:00
17706,632562,2021-09-09,2021,OAK,CHA,3,1,3-1,OAK,9,1,32,34,66,127,129,256,9,8,17,0,2:41
17707,633581,2021-09-14,2021,MIN,CLE,1,3,3-1,CLE,7,0,24,29,53,99,83,182,4,8,12,1,2:06
17708,632992,2021-08-05,2021,WAS,PHI,6,7,7-6,PHI,9,0,42,41,83,146,170,316,16,15,31,2,3:43
17709,632533,2021-09-11,2021,CLE,MIL,0,3,3-0,MIL,9,0,28,38,66,134,124,258,1,11,12,0,2:39
17710,632842,2021-08-21,2021,OAK,SFN,5,6,6-5,SFN,9,0,38,42,80,164,149,313,11,16,27,2,3:33
17711,633053,2021-08-04,2021,CHA,KCA,1,9,9-1,KCA,9,0,32,40,72,168,147,315,6,14,20,0,3:14
17712,632907,2021-08-14,2021,SEA,TOR,9,3,9-3,SEA,9,1,36,40,76,176,140,316,13,13,26,4,3:32
17713,632673,2021-08-29,2021,PHI,ARI,7,4,7-4,PHI,9,1,39,41,80,168,143,311,17,14,31,2,3:25
17714,632382,2021-09-22,2021,PHI,BAL,4,3,4-3,PHI,9,1,35,38,73,165,142,307,13,13,26,3,3:19
17715,633037,2021-08-04,2021,SLN,ATL,4,7,7-4,ATL,9,0,38,40,78,162,153,315,11,13,24,2,3:28
17716,633001,2021-08-07,2021,COL,MIA,7,4,7-4,COL,9,1,40,41,81,158,133,291,18,14,32,2,3:17
17717,632295,2021-09-29,2021,TEX,ANA,2,7,7-2,ANA,9,0,36,39,75,161,135,296,9,14,23,3,3:20
17718,632386,2021-09-22,2021,MIL,SLN,2,10,10-2,SLN,9,0,32,46,78,172,119,291,5,17,22,2,2:57
17719,632419,2021-09-19,2021,BOS,BAL,8,6,8-6,BOS,9,1,36,40,76,151,124,275,13,14,27,3,2:55
17720,632503,2021-09-14,2021,PIT,CIN,6,5,6-5,PIT,9,1,35,40,75,154,141,295,12,13,25,1,3:00
17721,632901,2021-08-13,2021,PHI,CIN,1,6,6-1,CIN,9,0,33,36,69,138,144,282,6,11,17,0,2:58
17722,632487,2021-09-15,2021,PIT,CIN,5,4,5-4,PIT,9,0,40,37,77,145,138,283,15,11,26,1,3:03 (:25 delay)
17723,632536,2021-09-09,2021,MIA,NYN,3,2,3-2,MIA,9,1,30,36,66,138,116,254,8,11,19,3,2:59
17724,632274,2021-10-01,2021,CHA,DET,8,1,8-1,CHA,9,1,43,35,78,151,151,302,19,11,30,1,3:25
17725,633025,2021-08-03,2021,ARI,SFN,3,1,3-1,ARI,9,1,39,34,73,137,159,296,15,8,23,0,3:10
17726,632800,2021-08-27,2021,NYN,WAS,1,2,2-1,WAS,9,0,31,36,67,157,128,285,5,9,14,0,3:03 (:21 delay)
17727,632323,2021-09-27,2021,SEA,OAK,13,4,13-4,SEA,9,1,42,35,77,143,157,300,19,8,27,2,3:20
17728,632811,2021-08-20,2021,LAN,NYN,3,2,3-2,LAN,9,1,30,35,65,129,110,239,6,8,14,1,2:39
17729,632493,2021-09-14,2021,MIN,CLE,6,3,6-3,MIN,7,1,26,28,54,112,95,207,10,7,17,2,2:17
17730,632615,2021-09-04,2021,COL,ATL,7,6,7-6,COL,9,1,37,38,75,151,138,289,14,10,24,3,3:10
17731,632625,2021-09-04,2021,ANA,TEX,4,1,4-1,ANA,9,1,31,31,62,100,112,212,7,5,12,1,2:21
17732,633043,2021-08-05,2021,SLN,ATL,4,8,8-4,ATL,9,0,37,43,80,161,156,317,12,19,31,4,3:30
17733,632966,2021-08-10,2021,NYN,WAS,8,7,8-7,NYN,9,1,39,41,80,161,139,300,14,14,28,2,3:37 (1:57 delay)
17734,632966,2021-08-10,2021,NYN,WAS,8,7,8-7,NYN,9,1,39,41,80,161,139,300,14,14,28,2,3:37 (1:57 delay)
17735,632825,2021-08-17,2021,WAS,TOR,12,6,12-6,WAS,9,1,38,41,79,163,137,300,16,15,31,2,3:25
17736,633026,2021-08-05,2021,DET,BOS,8,1,8-1,DET,9,1,39,39,78,152,166,318,15,12,27,2,3:14
17737,632866,2021-08-15,2021,MIN,TBA,5,4,5-4,MIN,9,0,38,38,76,149,166,315,14,10,24,2,3:21
17738,632302,2021-09-29,2021,KCA,CLE,10,5,10-5,KCA,9,1,40,39,79,168,137,305,17,13,30,1,3:16
17739,633101,2021-08-01,2021,ARI,LAN,0,13,13-0,LAN,9,0,31,50,81,195,122,317,5,24,29,1,3:13
17740,632961,2021-08-15,2021,BOS,BAL,6,2,6-2,BOS,9,1,38,37,75,139,161,300,16,11,27,2,3:07
17741,632999,2021-08-07,2021,CIN,PIT,11,3,11-3,CIN,9,1,41,36,77,149,164,313,20,11,31,2,3:15
17742,632262,2021-10-02,2021,ATL,NYN,6,5,6-5,ATL,9,1,37,41,78,161,148,309,14,14,28,1,3:13
17743,632244,2021-10-02,2021,WAS,BOS,3,5,5-3,BOS,9,0,37,40,77,170,142,312,10,14,24,5,3:53
17744,633056,2021-08-03,2021,TEX,ANA,3,11,11-3,ANA,9,0,35,44,79,178,134,312,8,19,27,3,3:23
17745,632242,2021-10-03,2021,LAN,MIL,10,3,10-3,LAN,9,1,39,37,76,147,158,305,16,9,25,3,3:20
17746,633072,2021-08-02,2021,MIL,PIT,6,2,6-2,MIL,9,1,37,37,74,162,156,318,15,11,26,2,3:30
17747,632350,2021-09-25,2021,MIN,TOR,1,6,6-1,TOR,9,0,36,39,75,154,150,304,10,14,24,0,3:18
17748,632902,2021-08-13,2021,BOS,BAL,8,1,8-1,BOS,9,1,40,36,76,141,159,300,16,9,25,0,3:05
17749,632959,2021-08-11,2021,SDN,MIA,0,7,7-0,MIA,9,0,33,44,77,180,125,305,7,20,27,2,3:07
17750,632936,2021-08-13,2021,TEX,OAK,8,6,8-6,TEX,9,1,40,39,79,154,139,293,15,14,29,2,3:02
17751,632565,2021-09-08,2021,MIL,PHI,4,3,4-3,MIL,9,1,36,35,71,168,143,311,12,10,22,2,3:29
17752,632920,2021-08-13,2021,DET,CLE,4,7,7-4,CLE,9,0,35,41,76,155,137,292,8,13,21,1,2:57
17753,632937,2021-08-11,2021,CLE,OAK,3,6,6-3,OAK,9,0,33,38,71,149,152,301,9,13,22,2,3:14 (:50 delay)
17754,632208,2021-08-10,2021,TOR,ANA,3,6,6-3,ANA,7,0,31,35,66,144,111,255,12,14,26,2,2:43
17755,632820,2021-08-14,2021,PIT,MIL,14,4,14-4,PIT,7,1,40,28,68,103,162,265,23,8,31,2,2:43
17756,632606,2021-09-05,2021,COL,ATL,2,9,9-2,ATL,9,0,31,39,70,136,107,243,4,13,17,2,2:38
17757,632860,2021-08-15,2021,KCA,SLN,2,7,7-2,SLN,9,0,37,41,78,147,135,282,11,15,26,2,3:04
17758,632363,2021-09-24,2021,CLE,CHA,0,1,1-0,CHA,9,0,32,31,63,111,147,258,7,5,12,2,2:48
17759,632626,2021-09-04,2021,MIA,PHI,3,2,3-2,MIA,9,1,32,37,69,149,124,273,8,12,20,1,3:06
17760,632716,2021-08-28,2021,MIN,MIL,6,4,6-4,MIN,9,1,36,36,72,117,129,246,13,9,22,2,2:47
17761,633028,2021-08-06,2021,LAN,ANA,3,4,4-3,ANA,10,0,43,37,80,141,181,322,13,11,24,4,4:01
17762,633042,2021-08-05,2021,ARI,SFN,4,5,5-4,SFN,10,0,42,43,85,160,161,321,13,13,26,2,3:40
17763,633071,2021-08-04,2021,CIN,MIN,6,5,6-5,CIN,9,1,37,41,78,181,159,340,14,16,30,3,3:15
17764,633011,2021-08-04,2021,TOR,CLE,8,6,8-6,TOR,9,1,38,44,82,161,165,326,15,17,32,3,3:16
17765,632974,2021-08-06,2021,TOR,BOS,12,4,12-4,TOR,9,1,44,40,84,171,148,319,21,14,35,2,3:34
17766,632960,2021-08-10,2021,BAL,DET,4,9,9-4,DET,9,0,38,40,78,171,162,333,11,15,26,2,3:13 (1:54 delay)
17767,632425,2021-09-18,2021,MIL,CHN,6,4,6-4,MIL,9,1,38,41,79,151,159,310,13,14,27,1,3:35
17768,632332,2021-09-26,2021,CHN,SLN,2,4,4-2,SLN,9,0,39,41,80,159,160,319,14,15,29,3,3:36
17769,632623,2021-09-04,2021,ARI,SEA,5,8,8-5,SEA,9,0,39,42,81,155,145,300,14,16,30,1,3:10
17770,632373,2021-09-24,2021,BOS,NYA,3,8,8-3,NYA,9,0,37,44,81,166,148,314,12,18,30,2,3:31
17771,632276,2021-10-01,2021,ARI,COL,7,9,9-7,COL,9,0,37,42,79,157,152,309,10,15,25,2,3:22
17772,632259,2021-10-02,2021,NYA,TBA,2,12,12-2,TBA,9,0,35,47,82,175,140,315,7,23,30,4,3:26
17773,632368,2021-09-23,2021,OAK,SEA,5,6,6-5,SEA,9,0,40,37,77,149,155,304,13,10,23,2,3:16
17774,632435,2021-09-20,2021,CIN,PIT,9,5,9-5,CIN,9,1,41,35,76,130,184,314,17,9,26,2,3:25 (1:25 delay)
17775,632691,2021-08-30,2021,WAS,PHI,4,7,7-4,PHI,9,0,40,42,82,164,146,310,13,15,28,1,3:37
17776,632508,2021-09-12,2021,CHN,SFN,5,6,6-5,SFN,9,0,39,40,79,152,126,278,12,15,27,1,3:02
17777,632696,2021-08-29,2021,TEX,HOU,13,2,13-2,TEX,9,1,45,34,79,132,157,289,20,8,28,3,3:12
17778,632889,2021-08-14,2021,SFN,COL,1,4,4-1,COL,9,0,34,37,71,138,156,294,10,10,20,1,3:07
17779,632614,2021-09-05,2021,KCA,CHA,6,0,6-0,KCA,9,1,36,34,70,139,142,281,11,8,19,1,2:54
17780,632926,2021-08-13,2021,MIN,TBA,4,10,10-4,TBA,9,0,38,44,82,152,146,298,13,16,29,2,3:14
17781,632671,2021-09-01,2021,CHA,PIT,6,3,6-3,CHA,9,1,38,36,74,132,134,266,16,10,26,2,2:59
17782,632284,2021-09-30,2021,KCA,CLE,1,6,6-1,CLE,9,0,37,39,76,137,148,285,11,12,23,0,3:04
17783,632814,2021-08-20,2021,BAL,ATL,0,3,3-0,ATL,9,0,29,39,68,152,90,242,4,11,15,2,2:29
17784,633017,2021-08-06,2021,OAK,TEX,4,1,4-1,OAK,11,0,38,38,76,153,153,306,11,6,17,0,3:30
17785,632345,2021-09-26,2021,BOS,NYA,3,6,6-3,NYA,9,0,38,37,75,149,130,279,12,14,26,3,3:42 (:04 delay)
17786,632929,2021-08-12,2021,ATL,CIN,3,12,12-3,CIN,9,0,38,44,82,170,155,325,10,17,27,1,3:12
17787,633046,2021-08-04,2021,ARI,SFN,1,7,7-1,SFN,9,0,34,41,75,183,143,326,7,13,20,1,3:31
17788,632978,2021-08-10,2021,CLE,OAK,3,4,4-3,OAK,10,0,40,41,81,166,168,334,12,14,26,1,3:42
17789,632915,2021-08-11,2021,PHI,LAN,2,8,8-2,LAN,9,0,36,45,81,206,123,329,9,19,28,1,3:50 (:57 delay)
17790,632359,2021-09-24,2021,ANA,SEA,5,6,6-5,SEA,9,0,42,37,79,156,161,317,18,10,28,5,3:40
17791,632253,2021-10-03,2021,ARI,COL,5,4,5-4,ARI,9,0,38,38,76,150,162,312,13,11,24,2,3:21
17792,632248,2021-10-01,2021,TEX,CLE,6,9,9-6,CLE,9,0,37,43,80,167,139,306,11,15,26,2,3:06
17793,632273,2021-10-01,2021,LAN,MIL,8,6,8-6,LAN,9,1,37,39,76,172,132,304,15,12,27,4,3:38
17794,632596,2021-09-06,2021,HOU,SEA,11,2,11-2,HOU,9,1,47,36,83,140,162,302,22,13,35,3,3:23
17795,632369,2021-09-24,2021,BAL,TEX,5,8,8-5,TEX,9,0,38,42,80,146,159,305,12,17,29,5,3:33
17796,632445,2021-09-17,2021,KCA,SEA,2,6,6-2,SEA,9,0,39,38,77,169,145,314,14,15,29,4,3:35
17797,632459,2021-09-17,2021,TEX,CHA,0,8,8-0,CHA,9,0,39,44,83,169,150,319,13,17,30,1,3:27
17798,632454,2021-09-17,2021,BOS,BAL,7,1,7-1,BOS,9,1,40,32,72,150,181,331,17,6,23,2,3:27
17799,632810,2021-08-21,2021,SLN,PIT,4,5,5-4,PIT,9,0,40,38,78,135,152,287,12,15,27,1,3:25
17800,632892,2021-08-16,2021,CHA,OAK,5,2,5-2,CHA,9,1,37,37,74,144,151,295,14,11,25,0,3:16
17801,632664,2021-08-30,2021,TBA,BOS,6,1,6-1,TBA,9,1,40,34,74,144,167,311,16,8,24,2,3:20
17802,632335,2021-09-25,2021,TBA,MIA,7,3,7-3,TBA,9,1,38,41,79,166,119,285,14,16,30,2,2:59
17803,632283,2021-09-30,2021,NYN,MIA,12,3,12-3,NYN,9,1,41,38,79,156,150,306,20,11,31,2,3:25
17804,632832,2021-08-20,2021,CIN,MIA,5,3,5-3,CIN,9,1,34,35,69,135,101,236,10,7,17,1,2:35
17805,632251,2021-10-02,2021,TEX,CLE,7,2,7-2,TEX,9,1,37,32,69,127,149,276,15,7,22,1,2:50
17806,632517,2021-09-11,2021,SEA,ARI,3,7,7-3,ARI,9,0,36,38,74,149,132,281,9,13,22,2,2:57
17807,632392,2021-09-22,2021,ARI,ATL,2,9,9-2,ATL,9,0,33,39,72,149,147,296,7,15,22,1,3:00
17808,632905,2021-08-14,2021,BOS,BAL,16,2,16-2,BOS,9,1,44,34,78,143,153,296,23,9,32,2,3:12
17809,632667,2021-09-04,2021,MIL,SLN,4,0,4-0,MIL,9,1,30,29,59,100,131,231,10,3,13,1,2:26
17810,632775,2021-08-21,2021,TOR,DET,3,0,3-0,TOR,9,1,30,31,61,131,88,219,8,7,15,0,2:17
17811,632401,2021-09-21,2021,OAK,SEA,2,5,5-2,SEA,9,0,36,39,75,152,145,297,10,13,23,0,2:59
17812,632985,2021-08-08,2021,SLN,KCA,5,6,6-5,KCA,9,0,43,40,83,143,188,331,18,12,30,3,3:43 (2:10 delay)
17813,633007,2021-08-08,2021,TOR,BOS,9,8,9-8,TOR,9,1,38,45,83,167,158,325,15,18,33,5,4:04
17814,632751,2021-08-25,2021,SLN,DET,3,2,3-2,SLN,10,0,42,40,82,152,163,315,15,15,30,0,3:20
17815,632971,2021-08-08,2021,BAL,TBA,6,9,9-6,TBA,9,0,41,41,82,180,165,345,17,15,32,2,3:32
17816,632867,2021-08-15,2021,WAS,ATL,5,6,6-5,ATL,9,0,41,41,82,157,162,319,16,13,29,1,3:19
17817,632551,2021-09-11,2021,NYN,NYA,7,8,8-7,NYA,9,0,44,38,82,145,188,333,17,11,28,2,3:58
17818,632662,2021-09-01,2021,KCA,CLE,3,5,5-3,CLE,11,0,44,45,89,171,137,308,10,18,28,2,3:36
17819,632411,2021-09-19,2021,MIA,PIT,6,5,6-5,MIA,10,0,41,40,81,158,161,319,15,10,25,2,3:36
17820,632249,2021-10-02,2021,HOU,OAK,10,4,10-4,HOU,9,1,39,42,81,163,160,323,15,18,33,3,3:48
17821,633029,2021-08-06,2021,HOU,MIN,4,5,5-4,MIN,11,0,46,43,89,152,179,331,12,9,21,1,3:54
17822,632911,2021-08-13,2021,NYN,LAN,5,6,6-5,LAN,10,0,43,42,85,182,158,340,16,14,30,2,4:18
17823,632448,2021-09-18,2021,MIA,PIT,3,6,6-3,PIT,9,0,33,43,76,163,146,309,8,16,24,1,3:30
17824,632506,2021-09-14,2021,CHA,ANA,9,3,9-3,CHA,9,1,40,39,79,184,131,315,19,13,32,2,3:21
17825,632466,2021-09-17,2021,ANA,OAK,4,5,5-4,OAK,9,0,38,43,81,178,127,305,11,18,29,3,3:19
17826,632256,2021-10-02,2021,SFN,SDN,2,3,3-2,SDN,10,0,36,41,77,154,145,299,6,14,20,2,3:41
17827,633014,2021-08-07,2021,BAL,TBA,3,12,12-3,TBA,9,0,35,47,82,174,125,299,9,17,26,1,3:02 (:27 delay)
17828,632886,2021-08-16,2021,SFN,NYN,7,5,7-5,SFN,9,1,37,41,78,154,145,299,14,13,27,3,3:23
17829,632266,2021-10-01,2021,SLN,CHN,4,3,4-3,SLN,9,0,38,38,76,154,140,294,14,14,28,2,3:25
17830,633337,2021-09-24,2021,CHN,SLN,4,12,12-4,SLN,7,0,30,39,69,150,103,253,9,19,28,3,2:41
17831,632750,2021-08-29,2021,DET,TOR,1,2,2-1,TOR,9,0,36,42,78,160,128,288,8,17,25,1,2:54 (:26 delay)
17832,632577,2021-09-07,2021,NYA,TOR,1,5,5-1,TOR,9,0,34,37,71,147,132,279,8,11,19,2,2:56
17833,633005,2021-08-03,2021,TBA,SEA,2,4,4-2,SEA,9,0,36,37,73,165,134,299,10,9,19,0,3:12
17834,632730,2021-09-13,2021,NYA,MIN,6,5,6-5,NYA,10,0,36,42,78,168,151,319,10,12,22,5,3:31
17835,632275,2021-09-30,2021,TEX,ANA,7,6,7-6,TEX,9,1,36,40,76,167,149,316,13,14,27,2,3:18
17836,632885,2021-08-14,2021,WAS,ATL,2,12,12-2,ATL,9,0,36,45,81,181,128,309,8,19,27,2,3:17
17837,632644,2021-09-03,2021,COL,ATL,4,3,4-3,COL,9,1,31,31,62,94,127,221,8,7,15,1,2:31
17838,632849,2021-08-18,2021,TBA,BAL,8,4,8-4,TBA,9,1,41,35,76,156,149,305,18,8,26,1,3:09
17839,632835,2021-08-19,2021,LAN,NYN,4,1,4-1,LAN,9,1,31,33,64,125,122,247,9,7,16,1,2:46
17840,632545,2021-09-08,2021,OAK,CHA,5,1,5-1,OAK,9,1,35,35,70,127,123,250,12,10,22,1,2:50
17841,632709,2021-08-27,2021,DET,TOR,2,1,2-1,DET,9,1,31,35,66,117,116,233,7,8,15,0,2:32
17842,632656,2021-09-01,2021,LAN,ATL,4,3,4-3,LAN,9,1,34,34,68,129,146,275,10,7,17,3,3:00
17843,633006,2021-08-06,2021,BAL,TBA,6,10,10-6,TBA,9,0,42,47,89,180,168,348,16,19,35,3,3:47
17844,632584,2021-09-06,2021,MIL,PHI,0,12,12-0,PHI,9,0,34,47,81,179,139,318,7,20,27,2,3:21
17845,632272,2021-10-01,2021,KCA,MIN,11,6,11-6,KCA,9,1,45,40,85,159,162,321,22,15,37,3,3:30
17846,632269,2021-10-02,2021,ARI,COL,11,2,11-2,ARI,9,1,45,35,80,148,162,310,22,10,32,1,3:17
17847,632235,2021-10-03,2021,TOR,BAL,12,4,12-4,TOR,9,1,41,44,85,154,168,322,18,17,35,1,3:22
17848,632375,2021-09-23,2021,MIN,TOR,7,2,7-2,MIN,9,1,39,40,79,140,169,309,19,15,34,2,3:34
17849,632467,2021-09-17,2021,NYN,PHI,3,4,4-3,PHI,9,0,38,37,75,161,167,328,12,10,22,3,3:52
17850,632354,2021-09-25,2021,BOS,NYA,3,5,5-3,NYA,9,0,37,35,72,151,167,318,10,9,19,4,3:33
17851,632280,2021-09-30,2021,TOR,NYA,2,6,6-2,NYA,9,0,38,37,75,162,163,325,12,10,22,2,3:29
17852,632948,2021-08-10,2021,PIT,SLN,1,4,4-1,SLN,9,0,30,37,67,148,124,272,4,12,16,1,2:51
17853,632969,2021-08-12,2021,PHI,LAN,2,1,2-1,PHI,9,1,32,36,68,147,121,268,10,10,20,2,3:10
17854,632931,2021-08-11,2021,BOS,TBA,20,8,20-8,BOS,9,1,53,38,91,135,167,302,32,11,43,1,3:17
17855,632444,2021-09-18,2021,ANA,OAK,1,3,3-1,OAK,9,0,35,35,70,134,143,277,8,9,17,1,3:06
17856,632816,2021-08-19,2021,CIN,MIA,6,1,6-1,CIN,9,1,35,34,69,131,128,259,14,9,23,0,2:43
17857,632315,2021-09-28,2021,KCA,CLE,6,4,6-4,KCA,9,1,33,39,72,137,151,288,8,13,21,7,3:24
17858,632699,2021-09-01,2021,CIN,SLN,4,5,5-4,SLN,7,0,30,35,65,120,108,228,10,16,26,0,2:20
17859,632367,2021-09-23,2021,MIL,SLN,5,8,8-5,SLN,9,0,38,39,77,149,165,314,12,15,27,1,3:31
17860,632627,2021-09-03,2021,TBA,MIN,5,3,5-3,TBA,9,1,31,35,66,139,96,235,6,7,13,0,2:25
17861,632659,2021-09-02,2021,SFN,MIL,5,1,5-1,SFN,9,1,33,31,64,122,116,238,8,6,14,1,2:31
17862,632352,2021-09-24,2021,SDN,ATL,0,4,4-0,ATL,9,0,29,36,65,121,98,219,3,8,11,1,2:28
17863,632824,2021-08-21,2021,CHN,KCA,2,4,4-2,KCA,9,0,30,38,68,136,117,253,3,11,14,1,3:02 (:34 delay)
17864,632643,2021-09-08,2021,SLN,LAN,5,4,5-4,SLN,9,1,34,33,67,112,117,229,10,7,17,1,2:35
17865,632873,2021-08-16,2021,MIN,CLE,5,4,5-4,MIN,10,0,48,41,89,152,175,327,24,12,36,1,3:43
17866,632477,2021-09-15,2021,WAS,MIA,6,8,8-6,MIA,9,0,47,42,89,143,179,322,20,16,36,5,3:53
17867,632878,2021-08-16,2021,CIN,CHN,14,5,14-5,CIN,9,1,46,38,84,150,204,354,22,12,34,3,3:37
17868,633062,2021-08-06,2021,NYA,SEA,3,2,3-2,NYA,11,0,45,42,87,176,178,354,16,10,26,4,4:16
17869,633224,2021-07-21,2021,ATL,SDN,5,6,6-5,SDN,7,0,31,33,64,156,162,318,11,14,25,3,3:17 (4:08 delay)
17870,632349,2021-09-25,2021,COL,SFN,2,7,7-2,SFN,9,0,40,41,81,156,157,313,13,14,27,3,3:36
17871,633070,2021-08-02,2021,TBA,SEA,2,8,8-2,SEA,9,0,35,45,80,187,150,337,9,19,28,1,3:20
17872,632285,2021-09-30,2021,MIN,DET,7,10,10-7,DET,9,0,41,41,82,154,162,316,14,14,28,5,3:33
17873,632900,2021-08-12,2021,CLE,OAK,0,17,17-0,OAK,9,0,31,54,85,203,107,310,6,27,33,3,3:27
17874,632857,2021-08-15,2021,SEA,TOR,3,8,8-3,TOR,9,0,38,39,77,162,166,328,11,12,23,0,3:05
17875,632925,2021-08-14,2021,ANA,HOU,2,8,8-2,HOU,9,0,39,42,81,153,151,304,13,17,30,3,3:35
17876,632818,2021-08-14,2021,KCA,SLN,4,9,9-4,SLN,9,0,40,41,81,168,153,321,15,14,29,3,3:25
17877,632257,2021-10-02,2021,SLN,CHN,5,6,6-5,CHN,9,0,39,40,79,152,175,327,13,15,28,0,3:25
17878,632686,2021-09-02,2021,DET,OAK,6,8,8-6,OAK,9,0,41,44,85,164,162,326,14,17,31,3,3:36
17879,632313,2021-09-28,2021,PIT,CHN,8,6,8-6,PIT,9,1,36,42,78,167,122,289,13,17,30,3,3:04
17880,632361,2021-09-24,2021,DET,KCA,1,3,3-1,KCA,9,0,36,33,69,119,166,285,13,6,19,2,3:07
17881,632358,2021-09-24,2021,TBA,MIA,8,0,8-0,TBA,9,1,41,29,70,115,173,288,17,4,21,0,2:59
17882,632362,2021-09-24,2021,COL,SFN,2,7,7-2,SFN,9,0,39,40,79,160,123,283,12,14,26,2,3:06
17883,632255,2021-10-02,2021,SEA,ANA,6,4,6-4,SEA,9,1,41,37,78,152,166,318,17,11,28,4,3:37
17884,632799,2021-08-20,2021,NYA,MIN,10,2,10-2,NYA,9,1,41,34,75,135,171,306,19,8,27,1,3:02
17885,633022,2021-08-03,2021,OAK,SDN,1,8,8-1,SDN,9,0,36,44,80,184,156,340,10,17,27,1,3:20
17886,632841,2021-08-19,2021,ARI,PHI,6,2,6-2,ARI,9,1,33,37,70,131,125,256,9,10,19,1,2:48
17887,632742,2021-08-27,2021,MIA,CIN,0,6,6-0,CIN,9,0,34,37,71,118,134,252,9,11,20,0,2:28
17888,633372,2021-08-30,2021,DET,MIN,2,3,3-2,MIN,9,0,34,34,68,119,125,244,8,8,16,1,2:42
17889,632782,2021-08-27,2021,ANA,SDN,0,5,5-0,SDN,9,0,32,41,73,144,111,255,5,13,18,2,2:42
17890,632684,2021-08-29,2021,MIA,CIN,2,1,2-1,MIA,9,1,28,32,60,138,114,252,6,6,12,1,2:36
17891,632261,2021-10-01,2021,WAS,BOS,2,4,4-2,BOS,9,0,41,40,81,137,170,307,15,14,29,3,3:25
17892,632499,2021-09-14,2021,DET,MIL,1,0,1-0,DET,11,0,37,39,76,153,139,292,8,8,16,1,3:16 (1:49 delay)
17893,632278,2021-09-30,2021,SFN,ARI,5,4,5-4,SFN,9,0,37,43,80,173,137,310,13,17,30,3,3:28
17894,632699,2021-09-01,2021,CIN,SLN,4,5,5-4,SLN,7,0,30,35,65,120,108,228,10,16,26,0,2:20
17895,632628,2021-09-06,2021,SLN,LAN,1,5,5-1,LAN,9,0,33,33,66,137,115,252,6,7,13,0,2:37
17896,632733,2021-08-28,2021,ATL,SFN,0,5,5-0,SFN,9,0,35,39,74,153,134,287,9,12,21,0,2:53
17897,632647,2021-09-05,2021,SDN,HOU,4,3,4-3,SDN,9,0,31,35,66,106,114,220,10,9,19,2,2:58
17898,632727,2021-08-25,2021,PHI,TBA,4,7,7-4,TBA,9,0,36,39,75,118,122,240,11,11,22,2,2:48
17899,632707,2021-08-28,2021,LAN,COL,5,2,5-2,LAN,9,1,35,31,66,133,166,299,15,5,20,5,3:42
17900,632793,2021-08-22,2021,HOU,SEA,3,6,6-3,SEA,11,0,47,43,90,170,171,341,17,11,28,4,3:58
17901,632670,2021-09-02,2021,WAS,PHI,6,7,7-6,PHI,9,0,42,41,83,181,161,342,15,13,28,5,3:52
17902,632500,2021-09-14,2021,BAL,NYA,2,7,7-2,NYA,9,0,38,41,79,166,182,348,11,17,28,1,3:28
17903,632258,2021-10-02,2021,PIT,CIN,8,6,8-6,PIT,9,1,44,39,83,161,174,335,24,14,38,2,3:42
17904,632850,2021-08-18,2021,SFN,NYN,2,6,6-2,NYN,12,0,45,49,94,184,158,342,12,14,26,1,4:02
17905,632279,2021-10-01,2021,HOU,OAK,6,8,8-6,OAK,9,0,44,40,84,157,178,335,17,10,27,6,3:54
17906,632887,2021-08-18,2021,LAN,PIT,9,0,9-0,LAN,9,1,40,31,71,111,151,262,16,5,21,1,2:34
17907,632653,2021-09-01,2021,TBA,BOS,2,3,3-2,BOS,9,0,36,35,71,161,131,292,12,10,22,2,3:13
17908,632252,2021-10-03,2021,CHA,DET,2,5,5-2,DET,9,0,38,40,78,163,153,316,12,12,24,1,3:16
17909,632243,2021-10-03,2021,KCA,MIN,3,7,7-3,MIN,9,0,38,36,74,145,151,296,12,10,22,2,3:10
17910,632821,2021-08-21,2021,NYA,MIN,7,1,7-1,NYA,9,1,37,34,71,131,147,278,12,7,19,1,3:04
17911,632631,2021-09-08,2021,SDN,ANA,8,5,8-5,SDN,9,1,39,36,75,151,169,320,16,9,25,4,3:31
17912,632413,2021-09-19,2021,MIL,CHN,4,6,6-4,CHN,9,0,42,40,82,183,155,338,16,14,30,4,3:46
17913,632693,2021-08-29,2021,SEA,KCA,4,3,4-3,SEA,9,1,34,36,70,133,135,268,9,10,19,0,2:51
17914,632722,2021-08-28,2021,CHA,CHN,0,7,7-0,CHN,9,0,32,38,70,153,109,262,7,12,19,1,2:45
17915,632804,2021-08-21,2021,TBA,CHA,8,4,8-4,TBA,9,1,37,35,72,130,124,254,15,10,25,2,2:27
17916,632702,2021-08-28,2021,TEX,HOU,2,5,5-2,HOU,9,0,35,41,76,136,112,248,8,17,25,0,2:48
17917,632372,2021-09-23,2021,CLE,CHA,5,3,5-3,CLE,7,0,29,31,60,123,115,238,12,11,23,2,2:34
17918,632568,2021-09-12,2021,LAN,SDN,8,0,8-0,LAN,9,1,40,28,68,98,140,238,17,1,18,3,2:45
17919,632287,2021-09-29,2021,PIT,CHN,2,3,3-2,CHN,9,0,36,44,80,176,144,320,10,20,30,2,3:44
17920,632381,2021-09-22,2021,NYA,TEX,7,3,7-3,NYA,9,1,37,36,73,142,139,281,15,8,23,3,3:21
17921,633082,2021-08-01,2021,PIT,PHI,4,15,15-4,PHI,9,0,36,52,88,204,151,355,9,25,34,2,3:44
17922,632899,2021-08-15,2021,CHA,NYA,3,5,5-3,NYA,9,0,38,46,84,209,150,359,14,18,32,3,3:48
17923,632914,2021-08-12,2021,ARI,SDN,12,3,12-3,ARI,9,1,46,36,82,143,204,347,24,10,34,4,3:42
17924,632237,2021-10-03,2021,SEA,ANA,3,7,7-3,ANA,9,0,39,44,83,173,156,329,12,19,31,6,3:56
17925,632307,2021-09-28,2021,SFN,ARI,6,4,6-4,SFN,9,1,42,37,79,155,181,336,18,11,29,1,3:42
17926,632234,2021-10-03,2021,WAS,BOS,5,7,7-5,BOS,9,0,39,43,82,168,151,319,15,17,32,4,3:46
17927,632338,2021-09-25,2021,CIN,WAS,7,6,7-6,CIN,9,0,39,43,82,159,164,323,17,17,34,4,3:41
17928,632428,2021-09-21,2021,ARI,ATL,1,6,6-1,ATL,9,0,38,37,75,151,135,286,12,9,21,3,3:07
17929,632868,2021-08-17,2021,DET,ANA,2,8,8-2,ANA,9,0,38,48,86,197,127,324,11,22,33,2,3:30
17930,632976,2021-08-10,2021,SDN,MIA,6,5,6-5,SDN,9,1,37,37,74,153,134,287,14,12,26,4,3:24
17931,632827,2021-08-20,2021,BOS,TEX,6,0,6-0,BOS,9,1,37,34,71,128,149,277,14,9,23,1,3:13
17932,632787,2021-08-23,2021,TOR,CHA,2,1,2-1,TOR,9,1,31,36,67,143,104,247,7,11,18,0,2:44
17933,632747,2021-08-25,2021,NYN,SFN,2,3,3-2,SFN,9,0,38,32,70,112,134,246,14,6,20,2,2:52
17934,632597,2021-09-06,2021,CHN,CIN,4,3,4-3,CHN,9,1,32,36,68,124,125,249,7,10,17,1,2:45
17935,632488,2021-09-18,2021,SLN,SDN,3,2,3-2,SLN,9,1,31,35,66,131,115,246,7,9,16,0,2:59
17936,632398,2021-09-21,2021,CLE,KCA,4,1,4-1,CLE,9,1,32,36,68,131,129,260,9,11,20,1,2:35
17937,633051,2021-08-08,2021,SDN,ARI,2,0,2-0,SDN,9,1,31,33,64,144,107,251,9,6,15,0,2:43
17938,632389,2021-09-22,2021,BOS,NYN,12,5,12-5,BOS,9,1,40,41,81,161,162,323,17,16,33,1,3:42
17939,632858,2021-08-16,2021,MIA,ATL,2,12,12-2,ATL,9,0,33,52,85,199,132,331,6,25,31,2,3:28
17940,632343,2021-09-25,2021,SDN,ATL,8,10,10-8,ATL,10,0,42,49,91,202,142,344,13,19,32,2,4:07
17941,632795,2021-08-21,2021,LAN,NYN,4,3,4-3,LAN,9,1,34,39,73,155,122,277,11,12,23,2,3:16
17942,632981,2021-08-07,2021,PHI,NYN,5,3,5-3,PHI,9,1,35,39,74,172,141,313,11,11,22,3,3:35
17943,632809,2021-08-20,2021,OAK,SFN,4,1,4-1,OAK,9,1,34,35,69,137,152,289,10,9,19,2,3:06
17944,632797,2021-08-21,2021,CIN,MIA,7,4,7-4,CIN,9,1,33,37,70,130,122,252,12,16,28,3,2:52
17945,632744,2021-08-24,2021,PIT,ARI,4,2,4-2,PIT,9,1,34,37,71,149,118,267,15,11,26,0,2:46
17946,632903,2021-08-12,2021,BOS,TBA,1,8,8-1,TBA,9,0,31,41,72,151,117,268,5,17,22,4,2:59
17947,632731,2021-09-01,2021,CIN,SLN,12,2,12-2,CIN,7,1,37,25,62,104,155,259,19,4,23,3,2:48
17948,632470,2021-09-17,2021,CIN,LAN,3,1,3-1,CIN,9,1,32,36,68,136,118,254,9,9,18,1,2:34
17949,633059,2021-08-03,2021,MIL,PIT,5,8,8-5,PIT,10,0,43,46,89,199,163,362,14,16,30,4,4:06
17950,632370,2021-09-23,2021,SDN,SFN,7,6,7-6,SDN,10,0,44,40,84,174,181,355,17,11,28,3,4:10
17951,632453,2021-09-17,2021,SFN,ATL,6,5,6-5,SFN,11,0,46,42,88,139,177,316,21,9,30,1,3:15
17952,632661,2021-09-01,2021,SFN,MIL,2,5,5-2,MIL,9,0,39,42,81,165,164,329,14,15,29,1,3:45
17953,632815,2021-08-20,2021,SLN,PIT,0,4,4-0,PIT,9,0,39,35,74,136,149,285,13,8,21,1,2:54
17954,632794,2021-08-22,2021,SLN,PIT,3,0,3-0,SLN,9,1,37,31,68,119,150,269,14,4,18,0,2:55
17955,632840,2021-08-19,2021,NYA,MIN,7,5,7-5,NYA,9,1,33,34,67,142,143,285,9,8,17,2,2:54
17956,632529,2021-09-11,2021,HOU,ANA,2,4,4-2,ANA,9,0,38,40,78,138,171,309,12,15,27,2,3:42
17957,632777,2021-08-24,2021,PHI,TBA,1,3,3-1,TBA,9,0,34,36,70,145,116,261,7,11,18,2,2:57
17958,632544,2021-09-10,2021,OAK,TEX,10,5,10-5,OAK,9,1,44,38,82,155,163,318,20,11,31,2,3:25
17959,632663,2021-08-31,2021,LAN,ATL,3,2,3-2,LAN,9,1,35,33,68,122,153,275,12,6,18,1,2:55
17960,632485,2021-09-15,2021,TEX,HOU,2,7,7-2,HOU,9,0,32,39,71,148,113,261,5,14,19,2,2:56
17961,632455,2021-09-18,2021,CIN,LAN,1,5,5-1,LAN,9,0,34,39,73,131,126,257,6,10,16,1,3:05
17962,632433,2021-09-19,2021,SFN,ATL,0,3,3-0,ATL,9,0,30,37,67,133,121,254,5,11,16,2,2:51
17963,632855,2021-08-18,2021,TEX,SEA,1,3,3-1,SEA,9,0,34,33,67,134,150,284,9,9,18,2,3:00
17964,632534,2021-09-10,2021,SLN,CIN,2,4,4-2,CIN,9,0,35,36,71,129,140,269,7,10,17,0,2:43
17965,632823,2021-08-19,2021,CHA,OAK,4,5,5-4,OAK,9,0,40,40,80,155,129,284,13,13,26,0,2:57
17966,632566,2021-09-08,2021,CHN,CIN,4,1,4-1,CHN,10,0,33,35,68,115,141,256,6,7,13,0,2:49
17967,632620,2021-09-06,2021,ANA,TEX,0,4,4-0,TEX,9,0,32,37,69,121,122,243,7,12,19,0,2:37
17968,632706,2021-08-28,2021,OAK,NYA,3,2,3-2,OAK,9,1,34,32,66,126,128,254,10,6,16,1,2:45
17969,633077,2021-08-02,2021,ARI,SFN,8,11,11-8,SFN,10,0,44,45,89,176,176,352,14,16,30,3,4:04
17970,632579,2021-09-08,2021,CLE,MIN,0,3,3-0,MIN,9,0,28,33,61,126,110,236,1,8,9,0,2:23
17971,632501,2021-09-11,2021,PIT,WAS,10,7,10-7,PIT,9,1,42,43,85,184,173,357,17,19,36,1,3:53
17972,632531,2021-09-11,2021,CHA,BOS,8,9,9-8,BOS,10,0,44,46,90,186,160,346,17,16,33,3,4:12
17973,632865,2021-08-18,2021,MIA,ATL,9,11,11-9,ATL,9,0,43,49,92,202,168,370,16,24,40,3,3:49
17974,632833,2021-08-19,2021,TBA,BAL,7,2,7-2,TBA,9,1,37,35,72,142,151,293,14,9,23,1,2:49
17975,632469,2021-09-17,2021,HOU,ARI,4,3,4-3,HOU,10,0,36,41,77,180,123,303,10,13,23,3,3:40
17976,632749,2021-08-26,2021,OAK,NYA,6,7,7-6,NYA,9,0,39,39,78,170,173,343,12,13,25,2,3:43
17977,632356,2021-09-24,2021,OAK,HOU,14,2,14-2,OAK,9,1,42,37,79,146,185,331,20,10,30,1,3:46
17978,632896,2021-08-20,2021,MIL,WAS,1,4,4-1,WAS,9,0,31,41,72,148,128,276,5,17,22,3,3:09
17979,632891,2021-08-15,2021,PHI,CIN,4,7,7-4,CIN,9,0,41,41,82,174,154,328,14,15,29,4,3:54
17980,632991,2021-08-08,2021,CLE,DET,7,5,7-5,CLE,9,1,38,38,76,174,140,314,13,9,22,2,3:02 (:24 delay)
17981,632717,2021-08-28,2021,NYN,WAS,5,3,5-3,NYN,9,1,34,37,71,134,124,258,11,12,23,2,3:02 (:23 delay)
17982,632591,2021-09-06,2021,CLE,MIN,2,5,5-2,MIN,9,0,34,39,73,144,120,264,9,13,22,1,2:52
17983,632680,2021-08-31,2021,TEX,COL,4,3,4-3,TEX,9,1,35,35,70,139,146,285,12,9,21,3,3:16
17984,632309,2021-09-29,2021,BAL,BOS,0,6,6-0,BOS,9,0,34,39,73,160,131,291,6,14,20,1,3:02
17985,632740,2021-08-27,2021,LAN,COL,2,4,4-2,COL,9,0,33,37,70,145,140,285,6,11,17,2,3:10
17986,632542,2021-09-10,2021,LAN,SDN,3,0,3-0,LAN,9,1,33,36,69,126,130,256,11,9,20,0,2:53
17987,632683,2021-08-31,2021,CHA,PIT,4,2,4-2,CHA,9,1,34,35,69,143,117,260,10,9,19,2,2:57
17988,632311,2021-09-28,2021,NYN,MIA,5,2,5-2,NYN,7,1,31,26,57,103,110,213,11,7,18,0,2:22
17989,632412,2021-09-20,2021,OAK,SEA,2,4,4-2,SEA,9,0,34,36,70,137,124,261,8,11,19,1,2:47
17990,632296,2021-09-29,2021,TOR,NYA,6,5,6-5,TOR,9,1,34,35,69,146,123,269,10,8,18,1,2:52
17991,632980,2021-08-06,2021,CHN,CHA,6,8,8-6,CHA,10,0,43,47,90,191,180,371,13,20,33,5,4:27 (:16 delay)
17992,632408,2021-09-20,2021,MIA,WAS,8,7,8-7,MIA,10,0,39,49,88,179,180,359,12,22,34,3,3:55
17993,632481,2021-09-15,2021,SEA,BOS,4,9,9-4,BOS,10,0,38,46,84,204,150,354,10,15,25,5,3:58
17994,632837,2021-08-20,2021,CLE,ANA,9,1,9-1,CLE,9,1,43,32,75,114,176,290,19,5,24,0,3:02
17995,632632,2021-09-03,2021,ANA,TEX,3,2,3-2,ANA,9,1,34,37,71,144,139,283,11,11,22,1,3:22
17996,632657,2021-08-31,2021,SEA,HOU,4,0,4-0,SEA,9,1,34,35,69,122,167,289,11,10,21,1,3:13
17997,632715,2021-08-31,2021,TOR,BAL,2,4,4-2,BAL,9,0,37,35,72,146,138,284,10,8,18,2,2:55
17998,632675,2021-08-31,2021,ANA,NYA,6,4,6-4,ANA,9,1,32,37,69,153,132,285,9,15,24,4,3:12
17999,632621,2021-09-03,2021,MIA,PHI,10,3,10-3,MIA,9,1,36,36,72,142,122,264,15,10,25,3,3:08
18000,632757,2021-08-28,2021,MIA,CIN,6,1,6-1,MIA,9,1,39,35,74,130,151,281,15,9,24,0,3:00
18001,632527,2021-09-11,2021,MIN,KCA,9,2,9-2,MIN,9,1,40,37,77,133,167,300,16,12,28,3,3:13
18002,632320,2021-09-28,2021,ATL,PHI,2,1,2-1,ATL,9,1,31,35,66,146,116,262,6,8,14,0,2:46
18003,632555,2021-09-10,2021,PIT,WAS,4,3,4-3,PIT,9,0,37,35,72,140,122,262,13,8,21,2,2:52
18004,632509,2021-09-13,2021,LAN,ARI,5,1,5-1,LAN,9,1,40,36,76,129,145,274,16,9,25,3,3:15
18005,632700,2021-08-29,2021,OAK,NYA,3,1,3-1,OAK,9,1,36,35,71,148,121,269,10,10,20,0,3:12
18006,632805,2021-08-23,2021,ATL,NYA,1,5,5-1,NYA,9,0,35,38,73,154,123,277,9,11,20,1,2:58
18007,632482,2021-09-14,2021,TEX,HOU,8,1,8-1,TEX,9,1,36,32,68,133,122,255,12,8,20,1,2:45
18008,632658,2021-09-06,2021,BAL,KCA,2,3,3-2,KCA,9,0,34,38,72,144,131,275,8,12,20,2,3:02
18009,632660,2021-09-03,2021,CHN,PIT,6,5,6-5,CHN,9,1,37,35,72,127,140,267,17,8,25,2,3:02
18010,632687,2021-08-30,2021,SFN,MIL,1,3,3-1,MIL,9,0,34,38,72,140,129,269,7,12,19,3,3:15
18011,632348,2021-09-25,2021,CLE,CHA,6,0,6-0,CLE,9,1,32,31,63,118,131,249,8,5,13,0,2:40
18012,632575,2021-09-08,2021,BOS,TBA,2,1,2-1,BOS,9,1,32,34,66,132,115,247,10,9,19,2,2:46
18013,632400,2021-09-22,2021,CHN,MIN,4,5,5-4,MIN,9,0,35,37,72,127,145,272,9,10,19,1,3:02
18014,632808,2021-08-27,2021,PHI,ARI,7,6,7-6,PHI,11,0,47,42,89,182,180,362,17,9,26,1,4:12 (:26 delay)
18015,632774,2021-08-20,2021,HOU,SEA,12,3,12-3,HOU,9,1,43,36,79,147,157,304,20,9,29,1,3:05
18016,632854,2021-08-18,2021,CHA,OAK,3,2,3-2,CHA,9,1,35,40,75,170,110,280,12,13,25,4,3:20
18017,632791,2021-08-22,2021,OAK,SFN,1,2,2-1,SFN,9,0,34,34,68,150,135,285,9,8,17,0,3:10
18018,632360,2021-09-24,2021,PHI,PIT,8,6,8-6,PHI,9,1,38,42,80,152,153,305,14,16,30,3,3:39
18019,632888,2021-08-20,2021,TOR,DET,1,4,4-1,DET,10,0,37,40,77,146,138,284,11,10,21,1,3:06
18020,632848,2021-08-18,2021,ARI,PHI,4,2,4-2,ARI,9,1,38,34,72,136,147,283,17,8,25,2,2:57
18021,632772,2021-08-22,2021,BAL,ATL,1,3,3-1,ATL,9,0,36,34,70,132,148,280,12,9,21,3,2:55
18022,632712,2021-08-28,2021,PHI,ARI,7,0,7-0,PHI,9,1,36,31,67,151,129,280,13,4,17,0,2:57
18023,632594,2021-09-07,2021,BAL,KCA,7,3,7-3,BAL,9,1,34,39,73,145,136,281,10,11,21,1,2:47
18024,632748,2021-08-24,2021,SDN,LAN,2,5,5-2,LAN,9,0,36,35,71,130,159,289,9,9,18,3,3:23
18025,632552,2021-09-10,2021,NYN,NYA,10,3,10-3,NYN,9,1,40,34,74,122,151,273,17,8,25,1,3:23
18026,632355,2021-09-25,2021,BAL,TEX,3,2,3-2,BAL,9,1,31,35,66,146,123,269,10,11,21,3,2:54
18027,632595,2021-09-07,2021,ARI,TEX,1,3,3-1,TEX,9,0,32,35,67,139,119,258,5,6,11,1,2:47
18028,632692,2021-08-30,2021,CIN,SLN,1,3,3-1,SLN,9,0,32,36,68,152,125,277,4,10,14,2,2:47
18029,632792,2021-08-23,2021,CHN,COL,6,4,6-4,CHN,9,0,37,36,73,130,140,270,14,10,24,1,2:58
18030,632895,2021-08-15,2021,NYN,LAN,4,14,14-4,LAN,9,0,41,51,92,205,143,348,11,24,35,2,3:48
18031,632677,2021-08-31,2021,WAS,PHI,6,12,12-6,PHI,9,0,43,51,94,177,163,340,17,26,43,5,3:50
18032,632819,2021-08-14,2021,DET,CLE,6,4,6-4,DET,9,1,36,40,76,158,157,315,14,14,28,2,3:27
18033,632752,2021-08-25,2021,TOR,CHA,3,1,3-1,TOR,9,1,36,34,70,140,151,291,11,8,19,1,3:06
18034,632758,2021-08-23,2021,OAK,SEA,3,5,5-3,SEA,9,0,33,37,70,165,138,303,7,10,17,2,3:07
18035,632762,2021-08-27,2021,PIT,SLN,3,4,4-3,SLN,9,0,38,37,75,140,146,286,13,12,25,1,3:18
18036,632676,2021-08-31,2021,KCA,CLE,2,7,7-2,CLE,9,0,33,39,72,158,136,294,8,13,21,1,2:54
18037,632634,2021-09-04,2021,BOS,CLE,4,3,4-3,BOS,9,0,40,35,75,136,153,289,16,10,26,4,3:09
18038,632672,2021-08-31,2021,ARI,SDN,0,3,3-0,SDN,9,0,32,39,71,157,141,298,5,13,18,0,3:05
18039,632314,2021-09-28,2021,SLN,MIL,6,2,6-2,SLN,9,1,35,38,73,137,118,255,12,12,24,0,2:54
18040,632618,2021-09-05,2021,CIN,DET,1,4,4-1,DET,9,0,34,34,68,128,145,273,8,9,17,2,2:54
18041,632540,2021-09-11,2021,PHI,COL,6,1,6-1,PHI,9,1,38,36,74,145,136,281,15,12,27,1,3:17
18042,632593,2021-09-06,2021,NYA,TOR,0,8,8-0,TOR,9,0,30,40,70,140,121,261,5,13,18,0,2:45
18043,632474,2021-09-16,2021,TBA,DET,5,2,5-2,TBA,9,1,37,32,69,136,129,265,14,8,22,1,2:38
18044,632581,2021-09-07,2021,SDN,ANA,0,4,4-0,ANA,9,0,33,34,67,138,124,262,7,7,14,2,2:53
18045,632769,2021-08-24,2021,OAK,SEA,1,5,5-1,SEA,9,0,36,40,76,167,128,295,10,14,24,2,3:09
18046,632396,2021-09-21,2021,NYA,TEX,7,1,7-1,NYA,9,1,35,33,68,139,144,283,13,7,20,2,3:00
18047,632607,2021-09-05,2021,TOR,OAK,8,0,8-0,TOR,9,1,41,32,73,145,147,292,17,5,22,2,3:02
18048,632645,2021-09-03,2021,SFN,LAN,3,2,3-2,SFN,11,0,50,44,94,161,199,360,17,12,29,4,4:32
18049,632732,2021-08-27,2021,ATL,SFN,6,5,6-5,ATL,9,1,34,35,69,143,123,266,10,9,19,1,2:54 (:35 delay)
18050,632846,2021-08-19,2021,DET,ANA,10,13,13-10,ANA,9,0,43,52,95,205,158,363,16,24,40,7,3:58
18051,632395,2021-09-22,2021,ANA,HOU,5,9,9-5,HOU,12,0,48,51,99,195,165,360,18,17,35,4,4:18
18052,632831,2021-08-18,2021,MIN,CLE,8,7,8-7,MIN,11,0,48,50,98,197,145,342,18,18,36,3,4:16
18053,632979,2021-08-09,2021,KCA,NYA,6,8,8-6,NYA,11,0,49,47,96,199,185,384,17,16,33,6,4:52
18054,632522,2021-09-12,2021,NYN,NYA,7,6,7-6,NYN,9,1,40,40,80,190,146,336,15,14,29,3,4:06
18055,632760,2021-08-25,2021,MIA,WAS,4,3,4-3,MIA,10,0,43,36,79,125,143,268,19,10,29,1,3:22
18056,632739,2021-08-26,2021,SEA,KCA,4,6,6-4,KCA,9,0,39,39,78,135,154,289,13,12,25,3,3:26
18057,632690,2021-08-30,2021,ANA,NYA,8,7,8-7,ANA,9,1,36,39,75,155,132,287,13,13,26,2,3:10
18058,632513,2021-09-12,2021,CHA,BOS,2,1,2-1,CHA,9,0,33,33,66,131,137,268,9,7,16,2,2:57
18059,633039,2021-08-08,2021,OAK,TEX,6,3,6-3,OAK,9,1,38,35,73,129,155,284,16,8,24,2,3:00
18060,632530,2021-09-11,2021,LAN,SDN,5,4,5-4,LAN,9,1,29,37,66,131,142,273,7,11,18,2,3:02
18061,632705,2021-08-29,2021,MIN,MIL,2,6,6-2,MIL,9,0,34,40,74,144,138,282,7,14,21,0,2:52
18062,632668,2021-08-30,2021,TOR,BAL,7,3,7-3,TOR,9,1,34,34,68,134,138,272,11,8,19,4,2:55
18063,632569,2021-09-07,2021,MIL,PHI,10,0,10-0,MIL,9,1,40,31,71,97,170,267,16,6,22,1,3:05
18064,632637,2021-09-07,2021,CHN,CIN,3,4,4-3,CIN,9,0,35,39,74,125,138,263,8,14,22,1,2:49
18065,632484,2021-09-15,2021,LAN,ARI,5,3,5-3,LAN,9,1,39,35,74,132,141,273,19,9,28,4,3:26
18066,632674,2021-08-30,2021,LAN,ATL,5,3,5-3,LAN,9,1,35,35,70,130,134,264,12,8,20,2,3:00
18067,632383,2021-09-22,2021,OAK,SEA,1,4,4-1,SEA,9,0,32,41,73,152,123,275,6,14,20,3,2:58
18068,632498,2021-09-12,2021,BAL,TOR,7,22,22-7,TOR,9,0,38,55,93,213,164,377,11,29,40,3,3:26
18069,632376,2021-09-23,2021,COL,LAN,5,7,7-5,LAN,10,0,41,45,86,167,177,344,12,16,28,1,4:01
18070,632521,2021-09-15,2021,NYN,SLN,4,11,11-4,SLN,9,0,41,45,86,168,146,314,13,19,32,3,3:34
18071,632834,2021-08-21,2021,HOU,SEA,15,1,15-1,HOU,9,1,42,37,79,152,171,323,18,11,29,2,3:22
18072,632640,2021-09-01,2021,TOR,BAL,5,4,5-4,TOR,9,1,34,38,72,164,130,294,13,14,27,3,3:05
18073,632711,2021-08-29,2021,NYN,WAS,9,4,9-4,NYN,9,1,41,37,78,152,151,303,19,9,28,1,3:26
18074,632430,2021-09-17,2021,TOR,MIN,3,7,7-3,MIN,9,0,35,40,75,153,132,285,7,14,21,2,3:02
18075,632958,2021-08-14,2021,NYN,LAN,1,2,2-1,LAN,10,0,37,36,73,141,146,287,7,7,14,3,3:21
18076,632788,2021-08-26,2021,CLE,TEX,10,6,10-6,CLE,9,1,42,38,80,135,157,292,19,11,30,2,3:12
18077,632585,2021-09-06,2021,PIT,DET,6,3,6-3,PIT,9,1,36,36,72,123,132,255,14,10,24,1,2:46
18078,632317,2021-09-28,2021,BAL,BOS,4,2,4-2,BAL,9,1,34,32,66,116,131,247,11,5,16,1,2:37
18079,632310,2021-09-29,2021,COL,WAS,10,5,10-5,COL,9,1,43,41,84,187,183,370,21,16,37,5,3:57 (2:00 delay)
18080,632828,2021-08-20,2021,COL,ARI,9,4,9-4,COL,9,1,42,44,86,156,135,291,19,18,37,1,3:16
18081,632767,2021-08-25,2021,BOS,MIN,6,9,9-6,MIN,10,0,47,45,92,173,179,352,19,16,35,3,4:07
18082,632624,2021-09-04,2021,CHN,PIT,7,6,7-6,CHN,9,0,38,42,80,169,134,303,15,15,30,3,3:42
18083,632704,2021-08-29,2021,CLE,BOS,7,5,7-5,CLE,9,1,38,38,76,176,140,316,15,13,28,2,3:22 (3:10 delay)
18084,632806,2021-08-21,2021,SDN,PHI,4,3,4-3,SDN,10,0,36,41,77,177,135,312,7,14,21,3,3:43
18085,632830,2021-08-22,2021,SDN,PHI,4,7,7-4,PHI,9,0,37,41,78,168,131,299,11,17,28,1,3:20
18086,632447,2021-09-18,2021,NYN,PHI,3,5,5-3,PHI,9,0,35,40,75,151,136,287,8,14,22,2,3:35
18087,632604,2021-09-06,2021,WAS,NYN,4,3,4-3,WAS,9,0,42,38,80,144,151,295,18,14,32,0,3:25
18088,632669,2021-08-31,2021,TBA,BOS,8,5,8-5,TBA,9,1,37,41,78,158,145,303,12,13,25,2,3:08
18089,632608,2021-09-06,2021,COL,SFN,5,10,10-5,SFN,9,0,37,45,82,163,130,293,10,20,30,2,3:27
18090,632587,2021-09-07,2021,COL,SFN,3,12,12-3,SFN,9,0,37,44,81,160,112,272,11,21,32,2,3:02
18091,632558,2021-09-07,2021,SLN,LAN,2,7,7-2,LAN,9,0,37,39,76,145,137,282,10,12,22,2,3:06
18092,632609,2021-09-08,2021,PIT,DET,1,5,5-1,DET,9,0,33,39,72,144,139,283,8,14,22,0,2:51
18093,632650,2021-09-02,2021,NYN,MIA,4,3,4-3,NYN,9,1,34,35,69,152,123,275,8,8,16,2,2:59
18094,632649,2021-09-04,2021,CIN,DET,7,4,7-4,CIN,9,1,38,39,77,151,155,306,15,13,28,1,3:18
18095,632514,2021-09-12,2021,PHI,COL,4,5,5-4,COL,9,0,37,36,73,149,142,291,10,10,20,3,3:27
18096,632399,2021-09-21,2021,COL,LAN,4,5,5-4,LAN,10,0,44,37,81,129,150,279,14,9,23,2,3:30
18097,632802,2021-08-24,2021,NYN,SFN,0,8,8-0,SFN,9,0,34,44,78,152,158,310,8,17,25,2,3:16
18098,632462,2021-09-16,2021,PIT,CIN,0,1,1-0,CIN,9,0,35,35,70,127,149,276,9,8,17,0,3:05
18099,632630,2021-09-02,2021,TBA,BOS,0,4,4-0,BOS,9,0,33,38,71,152,139,291,7,13,20,2,2:55
18100,632714,2021-08-29,2021,LAN,COL,0,5,5-0,COL,9,0,34,44,78,154,130,284,7,17,24,3,3:21
18101,632796,2021-08-22,2021,LAN,NYN,2,7,7-2,NYN,9,0,33,42,75,157,133,290,7,17,24,1,3:17
18102,632701,2021-08-29,2021,ATL,SFN,9,0,9-0,ATL,9,1,39,36,75,134,160,294,15,10,25,3,3:15
18103,632535,2021-09-11,2021,OAK,TEX,6,8,8-6,TEX,9,0,37,40,77,129,132,261,11,13,24,2,2:46
18104,632353,2021-09-25,2021,ARI,LAN,7,2,7-2,ARI,9,1,37,33,70,132,157,289,13,7,20,2,3:07
18105,632761,2021-08-25,2021,MIL,CIN,4,1,4-1,MIL,9,1,35,32,67,139,139,278,12,6,18,2,3:08
18106,632735,2021-08-27,2021,CLE,BOS,3,4,4-3,BOS,9,0,34,34,68,147,138,285,10,7,17,1,2:58
18107,632486,2021-09-15,2021,PHI,CHN,6,5,6-5,PHI,9,0,37,40,77,142,121,263,14,12,26,2,3:12
18108,632574,2021-09-08,2021,MIA,NYN,2,1,2-1,MIA,10,0,41,35,76,127,141,268,13,7,20,0,3:06
18109,632394,2021-09-22,2021,COL,LAN,10,5,10-5,COL,9,1,41,38,79,145,155,300,17,12,29,4,3:25
18110,632983,2021-08-07,2021,MIL,SFN,6,9,9-6,SFN,11,0,44,51,95,213,153,366,11,19,30,2,4:26
18111,632923,2021-08-11,2021,ATL,CIN,8,6,8-6,ATL,11,0,46,49,95,199,184,383,16,16,32,2,3:58
18112,632426,2021-09-20,2021,ARI,ATL,4,11,11-4,ATL,9,0,37,46,83,184,156,340,13,18,31,1,3:29
18113,632730,2021-09-13,2021,NYA,MIN,6,5,6-5,NYA,10,0,36,42,78,168,151,319,10,12,22,5,3:31
18114,632560,2021-09-07,2021,PIT,DET,3,2,3-2,PIT,9,1,41,37,78,145,156,301,17,13,30,0,3:16
18115,632495,2021-09-14,2021,PHI,CHN,3,6,6-3,CHN,9,0,34,38,72,168,124,292,10,12,22,2,3:24
18116,632351,2021-09-25,2021,CHN,SLN,5,8,8-5,SLN,9,0,40,37,77,143,154,297,16,10,26,1,3:18
18117,632633,2021-09-03,2021,KCA,CHA,7,2,7-2,KCA,9,1,38,36,74,141,159,300,15,9,24,2,3:17 (2:03 delay)
18118,632494,2021-09-15,2021,BAL,NYA,3,4,4-3,NYA,9,0,35,38,73,156,142,298,8,10,18,4,3:18
18119,632289,2021-09-28,2021,MIN,DET,3,2,3-2,MIN,9,1,32,39,71,154,132,286,9,13,22,0,3:03
18120,632548,2021-09-09,2021,PHI,COL,3,4,4-3,COL,9,0,34,38,72,147,133,280,8,12,20,1,3:00
18121,632781,2021-08-24,2021,SLN,DET,3,4,4-3,DET,9,0,35,40,75,151,136,287,10,15,25,5,3:13
18122,632695,2021-09-02,2021,COL,ATL,5,6,6-5,ATL,9,0,35,38,73,141,118,259,10,11,21,1,2:51
18123,632665,2021-08-30,2021,SEA,HOU,3,4,4-3,HOU,9,0,37,41,78,161,144,305,10,14,24,3,3:35
18124,632713,2021-08-28,2021,SEA,KCA,2,4,4-2,KCA,9,0,42,37,79,118,174,292,15,11,26,3,3:13
18125,632427,2021-09-18,2021,TBA,DET,3,4,4-3,DET,9,0,37,34,71,136,131,267,12,7,19,1,2:50
18126,632898,2021-08-14,2021,CHA,NYA,5,7,7-5,NYA,10,0,46,43,89,198,188,386,18,15,33,7,4:20
18127,632728,2021-08-24,2021,MIL,CIN,7,4,7-4,MIL,9,1,38,36,74,158,165,323,14,11,25,3,3:46
18128,632783,2021-08-24,2021,CLE,TEX,3,7,7-3,TEX,9,0,34,43,77,164,147,311,9,17,26,5,3:14
18129,632651,2021-09-03,2021,SDN,HOU,3,6,6-3,HOU,9,0,38,37,75,141,164,305,13,9,22,3,3:37
18130,632602,2021-09-05,2021,MIA,PHI,3,4,4-3,PHI,10,0,37,38,75,142,162,304,6,9,15,4,3:40
18131,632612,2021-09-04,2021,SDN,HOU,10,2,10-2,SDN,9,1,40,37,77,149,145,294,18,11,29,2,3:21
18132,632554,2021-09-08,2021,ATL,WAS,2,4,4-2,WAS,9,0,39,41,80,144,161,305,12,15,27,3,3:35
18133,632599,2021-09-05,2021,SFN,LAN,6,4,6-4,SFN,9,1,37,40,77,167,130,297,16,12,28,4,3:22
18134,632337,2021-09-26,2021,ARI,LAN,0,3,3-0,LAN,9,0,37,40,77,162,140,302,9,14,23,2,3:28
18135,632619,2021-09-05,2021,ANA,TEX,3,7,7-3,TEX,9,0,38,42,80,160,118,278,11,15,26,3,3:15
18136,632870,2021-08-21,2021,BOS,TEX,1,10,10-1,TEX,9,0,33,48,81,174,123,297,8,22,30,1,3:25
18137,632721,2021-08-28,2021,BAL,TBA,3,4,4-3,TBA,9,0,36,35,71,133,145,278,10,9,19,2,2:50
18138,632550,2021-09-10,2021,CHN,SFN,1,6,6-1,SFN,9,0,31,38,69,163,134,297,7,13,20,3,3:04
18139,632785,2021-08-22,2021,TBA,CHA,9,0,9-0,TBA,9,1,39,35,74,144,154,298,17,9,26,2,3:05
18140,632843,2021-08-19,2021,KCA,HOU,3,6,6-3,HOU,10,0,37,44,81,169,147,316,9,16,25,3,3:48
18141,632910,2021-08-15,2021,DET,CLE,0,11,11-0,CLE,9,0,28,45,73,182,116,298,1,18,19,1,2:51
18142,632600,2021-09-04,2021,TBA,MIN,11,4,11-4,TBA,9,1,43,38,81,140,170,310,20,13,33,1,3:09
18143,632586,2021-09-07,2021,CLE,MIN,0,3,3-0,MIN,9,0,38,38,76,156,178,334,12,11,23,2,3:39
18144,632708,2021-09-03,2021,ARI,SEA,5,6,6-5,SEA,10,0,40,45,85,150,157,307,11,15,26,3,3:31
18145,632636,2021-09-04,2021,SFN,LAN,1,6,6-1,LAN,9,0,37,39,76,157,138,295,10,13,23,4,3:28
18146,632434,2021-09-19,2021,TEX,CHA,2,7,7-2,CHA,9,0,35,42,77,148,153,301,9,16,25,2,3:06
18147,632414,2021-09-20,2021,NYA,TEX,4,3,4-3,NYA,9,1,37,36,73,161,143,304,14,9,23,4,3:21
18148,632590,2021-09-07,2021,HOU,SEA,5,4,5-4,HOU,10,0,42,38,80,134,164,298,14,9,23,1,3:29
18149,632670,2021-09-02,2021,WAS,PHI,6,7,7-6,PHI,9,0,42,41,83,181,161,342,15,13,28,5,3:52
18150,632505,2021-09-14,2021,LAN,ARI,8,4,8-4,LAN,9,1,37,36,73,132,157,289,13,10,23,2,3:14
18151,632406,2021-09-20,2021,TBA,TOR,6,4,6-4,TBA,9,1,36,35,71,151,158,309,15,7,22,4,3:23
18152,632984,2021-08-10,2021,PHI,LAN,0,5,5-0,LAN,9,0,35,42,77,161,155,316,9,17,26,5,3:35 (1:44 delay)
18153,632449,2021-09-18,2021,KCA,SEA,8,1,8-1,KCA,9,1,42,31,73,127,180,307,17,7,24,1,3:27
18154,632616,2021-09-04,2021,TOR,OAK,10,8,10-8,TOR,9,1,43,38,81,154,145,299,20,12,32,4,3:13
18155,632532,2021-09-12,2021,HOU,ANA,3,1,3-1,HOU,9,1,36,34,70,152,159,311,14,8,22,1,3:19
18156,632344,2021-09-25,2021,ANA,SEA,14,1,14-1,ANA,9,1,46,32,78,122,176,298,23,7,30,2,3:07
18157,632431,2021-09-18,2021,TOR,MIN,6,2,6-2,TOR,9,1,38,34,72,144,157,301,15,7,22,3,2:58
18158,632463,2021-09-15,2021,MIN,CLE,3,12,12-3,CLE,9,0,33,43,76,164,128,292,6,17,23,3,2:49
18159,632635,2021-09-02,2021,KCA,CLE,2,4,4-2,CLE,9,0,36,37,73,160,128,288,8,10,18,0,2:56
18160,632879,2021-08-21,2021,BAL,ATL,4,5,5-4,ATL,9,0,36,39,75,170,140,310,9,12,21,4,3:01
18161,632461,2021-09-17,2021,MIL,CHN,8,5,8-5,MIL,9,1,40,40,80,164,178,342,18,13,31,3,3:45
18162,632641,2021-09-01,2021,TEX,COL,5,9,9-5,COL,9,0,40,43,83,185,170,355,15,14,29,5,4:01
18163,632844,2021-08-18,2021,SLN,MIL,4,6,6-4,MIL,10,0,44,41,85,157,165,322,14,10,24,0,4:03
18164,632589,2021-09-08,2021,COL,SFN,4,7,7-4,SFN,9,0,39,43,82,176,139,315,14,16,30,4,3:35
18165,632957,2021-08-08,2021,HOU,MIN,5,7,7-5,MIN,9,0,39,46,85,178,181,359,16,19,35,4,4:07
18166,632478,2021-09-13,2021,NYN,SLN,0,7,7-0,SLN,9,0,36,46,82,163,152,315,10,20,30,1,3:41
18167,632697,2021-08-28,2021,ANA,SDN,10,2,10-2,ANA,9,1,40,41,81,166,157,323,18,15,33,4,3:35
18168,632719,2021-08-28,2021,DET,TOR,2,3,3-2,TOR,10,0,36,44,80,185,148,333,7,15,22,2,3:39
18169,632385,2021-09-22,2021,MIA,WAS,5,7,7-5,WAS,9,0,38,44,82,155,151,306,11,19,30,3,3:17
18170,632472,2021-09-16,2021,TEX,HOU,1,12,12-1,HOU,9,0,35,49,84,180,131,311,10,23,33,3,3:28
18171,632468,2021-09-16,2021,KCA,OAK,2,7,7-2,OAK,9,0,38,41,79,155,128,283,12,16,28,4,3:28
18172,632380,2021-09-19,2021,NYA,CLE,1,11,11-1,CLE,9,0,33,47,80,183,145,328,8,20,28,1,3:25
18173,632490,2021-09-15,2021,CHA,ANA,2,3,3-2,ANA,9,0,36,38,74,154,143,297,10,14,24,1,3:12
18174,632379,2021-09-21,2021,MIA,WAS,1,7,7-1,WAS,9,0,34,41,75,160,126,286,8,13,21,2,3:02
18175,632476,2021-09-16,2021,CHA,ANA,3,9,9-3,ANA,9,0,39,40,79,169,151,320,13,14,27,2,3:16
18176,632417,2021-09-18,2021,WAS,COL,0,6,6-0,COL,9,0,35,45,80,155,131,286,11,18,29,0,3:06
18177,632720,2021-08-27,2021,BAL,TBA,3,6,6-3,TBA,9,0,38,35,73,136,117,253,12,8,20,0,2:25
18178,632364,2021-09-24,2021,CIN,WAS,8,7,8-7,CIN,11,0,45,50,95,211,197,408,17,19,36,3,4:24
18179,633016,2021-08-12,2021,CHN,MIL,4,17,17-4,MIL,9,0,42,53,95,200,177,377,13,27,40,2,4:00
18180,632652,2021-09-04,2021,KCA,CHA,7,10,10-7,CHA,9,0,36,46,82,187,137,324,9,21,30,3,3:36
18181,632328,2021-09-26,2021,MIL,NYN,8,4,8-4,MIL,9,1,40,37,77,156,151,307,15,10,25,2,3:24
18182,632573,2021-09-08,2021,ARI,TEX,5,8,8-5,TEX,9,0,39,41,80,160,147,307,12,17,29,5,3:35
18183,632817,2021-08-20,2021,SDN,PHI,3,4,4-3,PHI,9,0,42,35,77,166,178,344,16,9,25,2,3:38
18184,632725,2021-08-27,2021,OAK,NYA,2,8,8-2,NYA,9,0,38,42,80,158,164,322,12,15,27,2,3:27
18185,632996,2021-08-10,2021,BOS,TBA,4,8,8-4,TBA,9,0,38,45,83,165,140,305,13,19,32,3,3:28
18186,632507,2021-09-13,2021,SEA,BOS,5,4,5-4,SEA,9,1,36,35,71,146,144,290,12,8,20,2,3:11
18187,632755,2021-08-24,2021,BOS,MIN,11,9,11-9,BOS,9,1,40,45,85,182,155,337,17,20,37,4,4:09
18188,632759,2021-08-27,2021,MIN,MIL,2,0,2-0,MIN,9,1,35,34,69,139,159,298,12,7,19,4,3:22
18189,632598,2021-09-05,2021,WAS,NYN,6,13,13-6,NYN,9,0,39,46,85,178,141,319,12,21,33,3,3:35
18190,632378,2021-09-21,2021,SDN,SFN,5,6,6-5,SFN,9,0,39,41,80,147,157,304,14,16,30,3,3:45
18191,632326,2021-09-26,2021,DET,KCA,1,2,2-1,KCA,9,0,36,40,76,165,141,306,10,14,24,2,3:18
18192,632324,2021-09-26,2021,OAK,HOU,4,3,4-3,OAK,9,0,40,38,78,170,144,314,16,12,28,3,3:37
18193,632504,2021-09-14,2021,ATL,COL,4,5,5-4,COL,9,0,38,38,76,151,157,308,11,13,24,1,3:12
18194,632629,2021-09-03,2021,TOR,OAK,11,10,11-10,TOR,9,0,38,43,81,149,139,288,14,16,30,2,3:06
18195,632622,2021-09-04,2021,NYA,BAL,3,4,4-3,BAL,9,0,35,43,78,184,159,343,8,15,23,5,3:54
18196,632737,2021-08-28,2021,CLE,BOS,3,5,5-3,BOS,10,0,45,42,87,155,185,340,16,14,30,4,3:59
18197,632638,2021-09-03,2021,MIL,SLN,4,15,15-4,SLN,9,0,37,46,83,185,146,331,12,19,31,3,3:24
18198,632605,2021-09-05,2021,TBA,MIN,5,6,6-5,MIN,9,0,39,45,84,162,165,327,15,19,34,4,3:32
18199,632617,2021-09-03,2021,WAS,NYN,2,6,6-2,NYN,10,0,38,47,85,192,139,331,10,19,29,0,3:49
18200,632465,2021-09-15,2021,ATL,COL,2,3,3-2,COL,10,0,43,37,80,169,169,338,15,7,22,2,4:16
18201,632405,2021-09-21,2021,DET,CHA,5,3,5-3,DET,9,1,39,43,82,170,151,321,19,18,37,3,3:27
18202,632741,2021-08-26,2021,BOS,MIN,12,2,12-2,BOS,9,1,42,37,79,150,169,319,18,10,28,2,3:33
18203,632770,2021-08-23,2021,HOU,KCA,1,7,7-1,KCA,9,0,38,43,81,169,147,316,12,17,29,4,3:35
18204,632543,2021-09-10,2021,DET,TBA,10,4,10-4,DET,9,1,39,42,81,150,156,306,15,15,30,3,3:26
18205,632410,2021-09-21,2021,BOS,NYN,6,3,6-3,BOS,9,1,37,37,74,159,150,309,14,11,25,4,3:38
18206,632771,2021-08-22,2021,CHN,KCA,1,9,9-1,KCA,9,0,34,45,79,176,131,307,8,20,28,1,3:25
18207,632441,2021-09-18,2021,NYA,CLE,3,11,11-3,CLE,9,0,37,46,83,165,181,346,13,19,32,2,3:26
18208,632480,2021-09-14,2021,SEA,BOS,4,8,8-4,BOS,9,0,39,43,82,195,155,350,12,17,29,5,3:59
18209,632511,2021-09-14,2021,KCA,OAK,10,7,10-7,KCA,9,1,41,41,82,174,159,333,18,15,33,4,3:59
18210,632334,2021-09-26,2021,BAL,TEX,4,7,7-4,TEX,9,0,37,40,77,179,143,322,12,13,25,5,3:11
18211,632559,2021-09-10,2021,CHA,BOS,4,3,4-3,CHA,9,1,39,37,76,168,153,321,15,10,25,4,3:48
18212,632576,2021-09-08,2021,BAL,KCA,9,8,9-8,BAL,9,1,39,41,80,146,174,320,13,17,30,5,3:32
18213,632391,2021-09-21,2021,TBA,TOR,2,4,4-2,TOR,9,0,41,36,77,131,154,285,17,10,27,0,3:19
18214,632557,2021-09-10,2021,CLE,MIL,3,10,10-3,MIL,9,0,38,45,83,161,150,311,9,17,26,2,3:24
18215,632319,2021-09-27,2021,COL,WAS,4,5,5-4,WAS,9,0,42,40,82,153,162,315,15,16,31,1,3:45
18216,632578,2021-09-07,2021,OAK,CHA,3,6,6-3,CHA,9,0,34,46,80,200,113,313,9,20,29,3,3:20
18217,632639,2021-09-03,2021,BOS,CLE,8,5,8-5,BOS,9,1,39,41,80,152,155,307,16,14,30,4,3:09
18218,632421,2021-09-19,2021,TBA,DET,0,2,2-0,DET,9,0,34,36,70,133,133,266,10,9,19,1,2:44
18219,632329,2021-09-26,2021,PHI,PIT,0,6,6-0,PIT,9,0,36,44,80,169,153,322,10,21,31,1,3:31
18220,632930,2021-08-13,2021,MIA,CHN,14,10,14-10,MIA,9,1,44,50,94,199,202,401,21,23,44,3,4:14
18221,632786,2021-08-22,2021,MIL,WAS,7,3,7-3,MIL,9,1,43,39,82,173,190,363,21,14,35,2,3:53
18222,632473,2021-09-16,2021,SFN,SDN,4,7,7-4,SDN,9,0,40,42,82,162,177,339,15,17,32,3,3:39
18223,632763,2021-08-24,2021,ATL,NYA,4,5,5-4,NYA,9,0,39,37,76,155,157,312,14,10,24,2,3:35
18224,632773,2021-08-23,2021,BOS,TEX,8,4,8-4,BOS,11,0,45,45,90,171,162,333,15,12,27,3,3:44
18225,632452,2021-09-16,2021,BAL,NYA,3,2,3-2,BAL,10,0,39,41,80,175,164,339,13,14,27,3,4:04
18226,632288,2021-09-28,2021,TOR,NYA,2,7,7-2,NYA,9,0,33,41,74,183,141,324,7,15,22,3,3:36
18227,632432,2021-09-19,2021,CIN,LAN,5,8,8-5,LAN,9,0,35,43,78,169,139,308,10,18,28,1,3:09
18228,632539,2021-09-11,2021,BAL,TOR,10,11,11-10,TOR,7,0,39,38,77,132,162,294,18,17,35,3,3:11
18229,632682,2021-08-31,2021,SFN,MIL,2,6,6-2,MIL,9,0,38,41,79,155,158,313,12,15,27,1,3:10
18230,632798,2021-08-23,2021,PIT,ARI,6,5,6-5,PIT,9,1,39,39,78,164,177,341,15,12,27,3,3:40
18231,632418,2021-09-21,2021,ANA,HOU,5,10,10-5,HOU,9,0,37,43,80,166,142,308,11,17,28,3,3:08
18232,632388,2021-09-27,2021,CIN,PIT,13,1,13-1,CIN,9,1,46,34,80,146,194,340,20,8,28,1,3:11
18233,632836,2021-08-20,2021,TBA,CHA,5,7,7-5,CHA,11,0,42,49,91,196,162,358,10,14,24,1,3:49
18234,632646,2021-09-02,2021,CHN,PIT,6,5,6-5,CHN,11,0,48,44,92,159,174,333,20,11,31,2,3:55
18235,632537,2021-09-10,2021,PHI,COL,2,11,11-2,COL,9,0,41,43,84,192,162,354,14,16,30,2,3:39
18236,632610,2021-09-05,2021,MIL,SLN,6,5,6-5,MIL,9,0,40,46,86,197,147,344,18,19,37,4,4:08
18237,632325,2021-09-26,2021,SDN,ATL,3,4,4-3,ATL,9,0,43,42,85,164,165,329,18,16,34,4,3:48
18238,632773,2021-08-23,2021,BOS,TEX,8,4,8-4,BOS,11,0,45,45,90,171,162,333,15,12,27,3,3:44
18239,632768,2021-08-25,2021,HOU,KCA,6,5,6-5,HOU,10,0,44,39,83,151,175,326,16,11,27,3,3:45
18240,632736,2021-08-29,2021,BAL,TBA,8,12,12-8,TBA,9,0,45,42,87,152,162,314,18,17,35,3,3:09
18241,632330,2021-09-26,2021,CLE,CHA,2,5,5-2,CHA,9,0,38,45,83,159,154,313,11,19,30,2,3:38
18242,632779,2021-08-24,2021,TOR,CHA,2,5,5-2,CHA,9,0,36,44,80,168,143,311,11,20,31,1,3:12
18243,632549,2021-09-10,2021,HOU,ANA,10,5,10-5,HOU,9,1,44,41,85,150,169,319,21,14,35,1,3:37
18244,632703,2021-08-30,2021,ARI,SDN,5,7,7-5,SDN,9,0,37,42,79,166,169,335,10,17,27,4,3:35
18245,632496,2021-09-14,2021,WAS,MIA,8,2,8-2,WAS,9,1,41,33,74,154,165,319,21,5,26,3,3:21
18246,632829,2021-08-21,2021,MIL,WAS,9,6,9-6,MIL,9,1,41,44,85,186,170,356,17,19,36,5,4:18
18247,632807,2021-08-24,2021,BAL,ANA,8,14,14-8,ANA,9,0,46,52,98,170,192,362,18,25,43,8,3:50
18248,632571,2021-09-10,2021,ATL,MIA,6,2,6-2,ATL,9,1,37,37,74,159,168,327,13,9,22,1,3:24
18249,632803,2021-08-22,2021,COL,ARI,4,8,8-4,ARI,9,0,38,45,83,191,150,341,12,19,31,3,3:50
18250,632572,2021-09-07,2021,MIA,NYN,4,9,9-4,NYN,9,0,41,42,83,174,162,336,12,13,25,2,3:59
18251,632613,2021-09-05,2021,CHN,PIT,11,8,11-8,CHN,9,1,43,45,88,192,184,376,19,20,39,6,4:12
18252,632580,2021-09-08,2021,HOU,SEA,5,8,8-5,SEA,9,0,39,47,86,181,129,310,13,20,33,5,3:46
18253,632642,2021-09-03,2021,NYA,BAL,4,3,4-3,NYA,11,0,40,44,84,173,179,352,9,14,23,3,3:48
18254,632601,2021-09-05,2021,ARI,SEA,4,10,10-4,SEA,11,0,40,49,89,173,153,326,8,17,25,2,3:49
18255,632393,2021-09-27,2021,DET,CHA,7,8,8-7,CHA,9,0,44,41,85,168,189,357,18,19,37,2,3:44
18256,632723,2021-08-28,2021,PIT,SLN,0,13,13-0,SLN,9,0,34,53,87,222,134,356,8,27,35,0,3:45
18257,632838,2021-08-19,2021,TEX,SEA,8,9,9-8,SEA,11,0,44,51,95,192,162,354,14,18,32,2,4:02
18258,632592,2021-09-05,2021,BOS,CLE,5,11,11-5,CLE,9,0,44,44,88,184,171,355,17,19,36,3,3:59
18259,632563,2021-09-10,2021,BAL,TOR,6,3,6-3,BAL,9,1,41,43,84,164,179,343,18,15,33,3,3:34
18260,632393,2021-09-27,2021,DET,CHA,7,8,8-7,CHA,9,0,44,41,85,168,189,357,18,19,37,2,3:44
18261,632456,2021-09-18,2021,HOU,ARI,4,6,6-4,ARI,10,0,40,43,83,178,134,312,13,13,26,2,3:44
18262,632402,2021-09-21,2021,PHI,BAL,3,2,3-2,PHI,10,0,40,41,81,149,151,300,13,13,26,3,3:40
18263,632784,2021-08-22,2021,TOR,DET,3,5,5-3,DET,11,0,48,45,93,189,177,366,15,11,26,3,3:59
18264,632822,2021-08-25,2021,CHN,COL,10,13,13-10,COL,10,0,44,48,92,199,149,348,15,20,35,5,4:18
18265,632567,2021-09-08,2021,NYA,TOR,3,6,6-3,TOR,9,0,37,44,81,195,157,352,11,18,29,4,3:54
18266,632388,2021-09-27,2021,CIN,PIT,13,1,13-1,CIN,9,1,46,34,80,146,194,340,20,8,28,1,3:11
18267,632546,2021-09-09,2021,NYA,TOR,4,6,6-4,TOR,9,0,36,44,80,192,157,349,12,18,30,2,3:30
18268,632397,2021-09-21,2021,MIL,SLN,1,2,2-1,SLN,9,0,36,34,70,137,160,297,10,7,17,0,3:24
18269,634556,2021-09-04,2021,WAS,NYN,9,11,11-9,NYN,9,0,45,43,88,180,174,354,19,15,34,1,4:05
18270,632822,2021-08-25,2021,CHN,COL,10,13,13-10,COL,10,0,44,48,92,199,149,348,15,20,35,5,4:18
18271,632512,2021-09-12,2021,DET,TBA,8,7,8-7,DET,11,0,48,47,95,172,171,343,17,16,33,2,3:48
18272,632502,2021-09-13,2021,TEX,HOU,1,15,15-1,HOU,9,0,36,48,84,192,161,353,11,22,33,3,3:53
18273,632582,2021-09-05,2021,NYA,BAL,7,8,8-7,BAL,9,0,41,44,85,189,175,364,14,18,32,6,4:01
18274,632570,2021-09-09,2021,ATL,WAS,7,6,7-6,ATL,10,0,42,44,86,168,182,350,15,15,30,3,3:47
18275,632890,2021-08-16,2021,TBA,BAL,9,2,9-2,TBA,9,1,40,36,76,147,153,300,16,10,26,3,2:53
18276,632192,2021-04-11,2021,NYN,MIA,6,5,6-5,NYN,9,0,42,43,85,199,161,360,16,16,32,4,4:05 (2:10 delay)
18277,632403,2021-09-21,2021,CIN,PIT,2,6,6-2,PIT,9,0,40,41,81,176,145,321,16,15,31,4,3:36
18278,632464,2021-09-15,2021,SFN,SDN,6,9,9-6,SDN,9,0,40,46,86,190,169,359,15,20,35,2,4:06
18279,632547,2021-09-11,2021,CHN,SFN,4,15,15-4,SFN,9,0,37,50,87,212,137,349,12,26,38,2,3:47
18280,632778,2021-08-25,2021,PIT,ARI,2,5,5-2,ARI,9,0,38,38,76,155,135,290,10,11,21,2,3:18 (:09 delay)
18281,632450,2021-09-17,2021,WAS,COL,8,9,9-8,COL,9,0,46,39,85,171,179,350,20,13,33,2,4:04
18282,632694,2021-08-31,2021,MIN,CHN,1,3,3-1,CHN,9,0,35,36,71,172,144,316,12,9,21,4,3:34
18283,632475,2021-09-16,2021,PHI,CHN,17,8,17-8,PHI,9,1,48,41,89,176,182,358,24,17,41,6,3:58
18284,632492,2021-09-14,2021,NYN,SLN,6,7,7-6,SLN,11,0,44,47,91,173,184,357,15,14,29,4,4:34
18285,632654,2021-09-03,2021,CIN,DET,5,15,15-5,DET,9,0,42,48,90,191,199,390,15,21,36,4,4:00
18286,632746,2021-08-26,2021,PHI,ARI,7,8,8-7,ARI,9,0,42,45,87,160,193,353,12,19,31,4,3:54
18287,632541,2021-09-10,2021,MIN,KCA,4,6,6-4,KCA,11,0,42,44,86,148,162,310,9,11,20,0,3:37
18288,632471,2021-09-15,2021,KCA,OAK,10,12,12-10,OAK,9,0,48,48,96,173,188,361,23,23,46,4,4:02
18289,632404,2021-09-21,2021,CHN,MIN,5,9,9-5,MIN,9,0,44,48,92,185,168,353,20,21,41,3,4:05
18290,632384,2021-09-22,2021,SDN,SFN,6,8,8-6,SFN,9,0,46,41,87,168,170,338,20,15,35,3,3:56
18291,632718,2021-08-27,2021,CHA,CHN,17,13,17-13,CHA,9,1,52,42,94,173,209,382,26,16,42,5,4:09
18292,632753,2021-08-27,2021,SEA,KCA,7,8,8-7,KCA,12,0,53,53,106,189,207,396,18,19,37,3,4:40
18293,632603,2021-09-06,2021,BOS,TBA,10,11,11-10,TBA,10,0,51,52,103,186,219,405,25,21,46,4,4:54
18294,632333,2021-09-26,2021,CIN,WAS,9,2,9-2,CIN,9,1,48,38,86,164,194,358,24,10,34,2,3:43
18295,632754,2021-08-26,2021,MIA,WAS,7,5,7-5,MIA,9,1,37,43,80,161,143,304,12,17,29,2,3:25
18296,632852,2021-08-18,2021,NYA,BOS,5,2,5-2,NYA,9,1,37,33,70,154,166,320,14,7,21,3,3:41
18297,632938,2021-08-12,2021,BAL,DET,4,6,6-4,DET,9,0,38,38,76,157,136,293,13,13,26,1,3:00
18298,632681,2021-09-01,2021,ARI,SDN,8,3,8-3,ARI,9,1,44,33,77,114,178,292,21,7,28,2,3:16
18299,632764,2021-08-25,2021,SDN,LAN,3,5,5-3,LAN,16,0,62,63,125,273,216,489,21,18,39,2,5:49
18300,632440,2021-09-17,2021,TBA,DET,7,4,7-4,TBA,10,0,43,38,81,127,168,295,15,8,23,2,3:17
18301,633064,2021-08-05,2021,COL,CHN,6,5,6-5,COL,9,1,37,37,74,144,131,275,15,11,26,3,3:10
18302,632331,2021-09-26,2021,COL,SFN,2,6,6-2,SFN,9,0,34,41,75,158,147,305,5,15,20,3,3:31
18303,632451,2021-09-18,2021,BOS,BAL,9,3,9-3,BOS,9,1,40,38,78,156,146,302,17,12,29,3,3:09
18304,662766,2022-04-07,2022,KCA,CLE,3,1,3-1,KCA,9,1,31,37,68,152,123,275,6,11,17,3,2:49
18305,661042,2022-04-07,2022,ANA,HOU,1,3,3-1,HOU,9,0,31,38,69,140,111,251,6,12,18,5,3:15
18306,662021,2022-04-07,2022,SLN,PIT,9,0,9-0,SLN,9,1,41,32,73,121,168,289,16,8,24,1,3:08
18307,661577,2022-04-07,2022,ATL,CIN,3,6,6-3,CIN,9,0,36,38,74,142,158,300,9,12,21,1,3:01
18308,663418,2022-04-07,2022,ARI,SDN,4,2,4-2,ARI,9,0,34,36,70,165,143,308,11,11,22,4,3:18
18309,663178,2022-04-07,2022,CHN,MIL,5,4,5-4,CHN,9,1,35,40,75,153,151,304,13,15,28,4,3:18
18310,662571,2022-04-07,2022,WAS,NYN,1,5,5-1,NYN,9,0,35,42,77,169,134,303,8,19,27,2,3:31 (1:16 delay)
18311,663417,2022-04-08,2022,ARI,SDN,0,3,3-0,SDN,9,0,30,38,68,141,114,255,3,15,18,2,2:44
18312,661750,2022-04-08,2022,MIN,SEA,1,2,2-1,SEA,9,0,34,39,73,141,132,273,9,13,22,0,2:53
18313,661750,2022-04-08,2022,MIN,SEA,1,2,2-1,SEA,9,0,34,39,73,141,132,273,9,13,22,0,2:53
18314,661131,2022-04-08,2022,PHI,OAK,9,5,9-5,PHI,9,1,39,35,74,115,164,279,16,7,23,2,3:14
18315,662933,2022-04-08,2022,COL,LAN,3,5,5-3,LAN,9,0,38,41,79,152,137,289,10,13,23,2,3:09
18316,661918,2022-04-08,2022,TBA,BAL,2,1,2-1,TBA,9,1,35,37,72,148,146,294,11,11,22,4,3:14
18317,662559,2022-04-08,2022,WAS,NYN,3,7,7-3,NYN,9,0,33,45,78,181,113,294,7,20,27,3,3:43 (:52 delay)
18318,662888,2022-04-08,2022,DET,CHA,5,4,5-4,DET,9,0,39,37,76,158,157,315,14,11,25,2,3:30
18319,661576,2022-04-08,2022,ATL,CIN,7,6,7-6,ATL,9,1,39,37,76,140,148,288,15,10,25,2,3:07
18320,661782,2022-04-08,2022,TOR,TEX,10,8,10-8,TOR,9,1,37,41,78,157,145,302,14,14,28,3,3:26
18321,662124,2022-04-08,2022,SFN,MIA,6,5,6-5,SFN,10,0,40,42,82,156,151,307,14,12,26,4,3:26
18322,661333,2022-04-08,2022,NYA,BOS,6,5,6-5,NYA,11,0,46,43,89,157,162,319,17,14,31,4,3:56
18323,661333,2022-04-08,2022,NYA,BOS,6,5,6-5,NYA,11,0,46,43,89,157,162,319,17,14,31,4,3:56
18324,661041,2022-04-08,2022,ANA,HOU,6,13,13-6,HOU,9,0,41,43,84,167,161,328,13,17,30,4,3:44
18325,661917,2022-04-09,2022,TBA,BAL,5,3,5-3,TBA,9,1,33,36,69,124,114,238,11,10,21,1,2:33
18326,661803,2022-04-09,2022,TOR,TEX,4,3,4-3,TOR,9,1,37,36,73,122,113,235,13,10,23,1,2:39
18327,661130,2022-04-09,2022,PHI,OAK,4,2,4-2,PHI,9,1,34,31,65,115,133,248,12,6,18,1,2:37
18328,662123,2022-04-09,2022,SFN,MIA,1,2,2-1,MIA,9,0,33,35,68,137,131,268,7,8,15,2,2:57
18329,662931,2022-04-09,2022,COL,LAN,3,2,3-2,COL,9,1,34,34,68,125,139,264,10,7,17,1,2:48
18330,662765,2022-04-09,2022,KCA,CLE,1,0,1-0,KCA,10,0,34,35,69,130,126,256,8,7,15,3,2:49
18331,663404,2022-04-09,2022,ARI,SDN,2,5,5-2,SDN,9,0,33,39,72,153,123,276,7,14,21,0,2:52
18332,661575,2022-04-09,2022,ATL,CIN,2,1,2-1,ATL,9,1,36,32,68,130,134,264,14,5,19,3,2:50
18333,661332,2022-04-09,2022,NYA,BOS,4,2,4-2,NYA,9,1,30,37,67,150,109,259,7,9,16,2,2:58
18334,661040,2022-04-09,2022,ANA,HOU,2,0,2-0,ANA,9,1,33,32,65,123,138,261,11,5,16,3,3:02
18335,662588,2022-04-09,2022,WAS,NYN,0,5,5-0,NYN,9,0,32,41,73,153,130,283,5,15,20,2,3:14
18336,661756,2022-04-09,2022,MIN,SEA,3,4,4-3,SEA,9,0,34,39,73,152,146,298,7,13,20,1,3:09
18337,662864,2022-04-09,2022,DET,CHA,2,5,5-2,CHA,9,0,36,37,73,133,150,283,12,10,22,5,3:11
18338,662020,2022-04-09,2022,SLN,PIT,6,2,6-2,SLN,9,1,38,40,78,171,144,315,15,13,28,4,3:32
18339,663205,2022-04-09,2022,CHN,MIL,9,0,9-0,CHN,9,1,44,33,77,140,184,324,20,9,29,2,3:28
18340,661129,2022-04-10,2022,PHI,OAK,1,4,4-1,OAK,9,0,32,39,71,144,103,247,6,13,19,2,2:57
18341,662122,2022-04-10,2022,SFN,MIA,3,2,3-2,SFN,9,1,31,37,68,129,106,235,7,13,20,3,2:43
18342,662570,2022-04-10,2022,WAS,NYN,4,2,4-2,WAS,9,1,31,37,68,141,115,256,6,11,17,3,3:01
18343,661039,2022-04-10,2022,ANA,HOU,1,4,4-1,HOU,9,0,34,39,73,148,131,279,8,13,21,2,3:15
18344,662887,2022-04-10,2022,DET,CHA,1,10,10-1,CHA,9,0,32,43,75,156,134,290,6,16,22,1,2:56
18345,661738,2022-04-10,2022,MIN,SEA,10,4,10-4,MIN,9,1,38,37,75,147,157,304,13,11,24,2,3:11
18346,662934,2022-04-10,2022,COL,LAN,9,4,9-4,COL,9,1,39,38,77,145,156,301,15,12,27,3,3:13
18347,663204,2022-04-10,2022,CHN,MIL,4,5,5-4,MIL,9,0,36,36,72,149,162,311,10,10,20,2,3:03
18348,662019,2022-04-10,2022,SLN,PIT,4,9,9-4,PIT,9,0,35,44,79,180,138,318,9,18,27,1,3:08
18349,661573,2022-04-10,2022,ATL,CIN,3,6,6-3,CIN,9,0,35,40,75,181,142,323,9,13,22,4,3:14
18350,661916,2022-04-10,2022,TBA,BAL,8,0,8-0,TBA,9,1,38,37,75,166,155,321,16,11,27,4,3:10
18351,662755,2022-04-10,2022,KCA,CLE,3,17,17-3,CLE,9,0,36,53,89,194,124,318,9,27,36,2,3:09
18352,661802,2022-04-10,2022,TOR,TEX,6,12,12-6,TEX,9,0,38,45,83,175,143,318,12,18,30,3,3:24
18353,663395,2022-04-10,2022,ARI,SDN,5,10,10-5,SDN,9,0,39,43,82,178,174,352,14,15,29,1,3:15
18354,661316,2022-04-10,2022,NYA,BOS,3,4,4-3,BOS,9,0,41,37,78,137,170,307,16,10,26,3,3:40
18355,662863,2022-04-11,2022,DET,BOS,3,1,3-1,DET,9,1,35,31,66,109,145,254,11,4,15,3,2:50
18356,661036,2022-04-11,2022,ANA,MIA,6,2,6-2,ANA,9,1,36,30,66,124,145,269,13,3,16,1,2:42
18357,661637,2022-04-11,2022,PHI,NYN,5,4,5-4,PHI,9,1,34,37,71,141,142,283,12,10,22,4,3:05
18358,661754,2022-04-11,2022,MIN,SEA,4,0,4-0,MIN,9,1,36,34,70,130,161,291,13,5,18,1,3:00
18359,661315,2022-04-11,2022,NYA,TOR,0,3,3-0,TOR,9,0,35,38,73,135,131,266,10,11,21,2,3:03
18360,661915,2022-04-11,2022,TBA,OAK,2,13,13-2,OAK,9,0,36,45,81,158,140,298,9,17,26,2,3:00
18361,663403,2022-04-11,2022,BAL,MIL,2,0,2-0,BAL,9,1,37,36,73,141,162,303,12,10,22,3,3:24
18362,662116,2022-04-11,2022,SFN,SDN,2,4,4-2,SDN,9,0,40,42,82,170,153,323,15,15,30,2,3:30
18363,662754,2022-04-11,2022,KCA,CLE,7,10,10-7,CLE,9,0,42,44,86,172,154,326,16,18,34,6,3:37
18364,661572,2022-04-11,2022,ATL,WAS,2,11,11-2,WAS,9,0,34,49,83,201,146,347,7,23,30,2,3:33
18365,662042,2022-04-11,2022,TEX,COL,4,6,6-4,COL,10,0,40,47,87,177,167,344,13,19,32,3,4:01
18366,662017,2022-04-12,2022,SLN,KCA,6,5,6-5,SLN,9,1,36,36,72,134,121,255,12,10,22,0,2:36
18367,662318,2022-04-12,2022,PIT,CHN,1,2,2-1,CHN,9,0,33,34,67,125,136,261,6,10,16,1,2:51
18368,661636,2022-04-12,2022,PHI,NYN,0,2,2-0,NYN,9,0,32,34,66,136,133,269,6,8,14,4,3:12
18369,661314,2022-04-12,2022,NYA,TOR,4,0,4-0,NYA,9,1,33,33,66,134,147,281,11,5,16,2,3:07
18370,661038,2022-04-12,2022,ANA,MIA,4,3,4-3,ANA,9,0,32,38,70,153,131,284,7,12,19,1,2:59
18371,663411,2022-04-12,2022,ARI,HOU,1,2,2-1,HOU,9,0,36,39,75,134,148,282,9,13,22,3,3:20
18372,661995,2022-04-12,2022,TEX,COL,1,4,4-1,COL,9,0,37,38,75,149,133,282,10,12,22,2,3:09
18373,662862,2022-04-12,2022,DET,BOS,3,5,5-3,BOS,9,0,33,38,71,147,112,259,7,12,19,3,2:49
18374,662104,2022-04-12,2022,SFN,SDN,13,2,13-2,SFN,9,1,43,36,79,152,176,328,20,11,31,2,3:13
18375,661538,2022-04-12,2022,CHA,SEA,3,2,3-2,CHA,9,1,33,40,73,150,140,290,9,13,22,3,3:22
18376,663295,2022-04-12,2022,BAL,MIL,4,5,5-4,MIL,9,0,41,39,80,158,169,327,13,12,25,4,3:38
18377,663088,2022-04-12,2022,CIN,CLE,5,10,10-5,CLE,9,0,32,42,74,197,143,340,8,17,25,2,3:30
18378,661753,2022-04-12,2022,MIN,LAN,2,7,7-2,LAN,9,0,37,45,82,205,151,356,9,18,27,6,4:00 (1:28 delay)
18379,661571,2022-04-12,2022,ATL,WAS,16,4,16-4,ATL,9,1,52,36,88,150,204,354,29,10,39,2,3:37
18380,661944,2022-04-12,2022,TBA,OAK,9,8,9-8,TBA,10,0,51,45,96,185,212,397,22,19,41,6,4:12
18381,662115,2022-04-13,2022,SFN,SDN,2,1,2-1,SFN,9,1,29,34,63,115,112,227,6,7,13,0,2:11
18382,661570,2022-04-13,2022,ATL,WAS,1,3,3-1,WAS,9,0,31,34,65,128,128,256,7,7,14,1,2:57
18383,661530,2022-04-13,2022,CHA,SEA,6,4,6-4,CHA,9,1,36,36,72,149,117,266,14,9,23,1,2:54 (:47 delay)
18384,662317,2022-04-13,2022,PIT,CHN,6,2,6-2,PIT,9,1,35,35,70,143,139,282,13,9,22,2,2:49
18385,661734,2022-04-13,2022,MIN,LAN,0,7,7-0,LAN,9,0,29,44,73,154,107,261,2,16,18,0,2:34
18386,663433,2022-04-13,2022,BAL,MIL,2,4,4-2,MIL,9,0,36,37,73,133,145,278,10,11,21,2,3:04
18387,661313,2022-04-13,2022,NYA,TOR,4,6,6-4,TOR,9,0,39,38,77,135,131,266,13,10,23,3,3:10
18388,661943,2022-04-13,2022,TBA,OAK,2,4,4-2,OAK,9,0,38,36,74,153,134,287,10,9,19,3,3:02
18389,663117,2022-04-13,2022,CIN,CLE,3,7,7-3,CLE,9,0,35,46,81,181,151,332,9,19,28,1,3:07 (:43 delay)
18390,662885,2022-04-13,2022,DET,BOS,7,9,9-7,BOS,9,0,42,46,88,169,194,363,15,19,34,4,3:51
18391,663341,2022-04-13,2022,ARI,HOU,3,2,3-2,ARI,10,0,47,40,87,138,210,348,18,11,29,2,3:50
18392,661643,2022-04-13,2022,PHI,NYN,6,9,9-6,NYN,9,0,42,43,85,176,182,358,16,18,34,5,4:04
18393,661942,2022-04-14,2022,TBA,OAK,3,6,6-3,OAK,9,0,33,38,71,134,106,240,7,12,19,2,2:33
18394,661312,2022-04-14,2022,NYA,TOR,3,0,3-0,NYA,9,1,32,38,70,153,113,266,9,12,21,4,3:06 (1:30 delay)
18395,661292,2022-04-14,2022,MIL,SLN,5,1,5-1,MIL,9,1,36,33,69,143,140,283,12,6,18,1,3:04
18396,662950,2022-04-14,2022,COL,CHN,2,5,5-2,CHN,9,0,41,36,77,111,161,272,14,13,27,3,3:02
18397,661418,2022-04-14,2022,MIA,PHI,4,3,4-3,MIA,9,1,34,39,73,134,148,282,11,14,25,3,3:23
18398,661529,2022-04-14,2022,CHA,SEA,1,5,5-1,SEA,9,0,33,42,75,172,130,302,5,14,19,3,3:01
18399,662237,2022-04-14,2022,SDN,ATL,12,1,12-1,SDN,9,1,48,32,80,124,168,292,23,6,29,1,3:07
18400,662702,2022-04-14,2022,KCA,DET,2,4,4-2,DET,9,0,37,36,73,146,145,291,10,12,22,2,3:10
18401,662627,2022-04-14,2022,LAN,CIN,9,3,9-3,LAN,9,1,39,35,74,146,161,307,17,9,26,4,3:10
18402,661993,2022-04-14,2022,TEX,ANA,10,5,10-5,TEX,9,1,42,42,84,189,150,339,17,17,34,2,3:30
18403,662307,2022-04-14,2022,PIT,WAS,9,4,9-4,PIT,9,1,46,41,87,155,197,352,22,14,36,2,3:37
18404,662701,2022-04-15,2022,KCA,DET,1,2,2-1,DET,9,0,33,32,65,102,128,230,5,5,10,1,2:18
18405,661528,2022-04-15,2022,CHA,TBA,3,2,3-2,CHA,9,1,30,34,64,141,107,248,6,8,14,1,2:51
18406,661792,2022-04-15,2022,TOR,OAK,4,1,4-1,TOR,9,1,38,33,71,137,125,262,19,6,25,5,3:00
18407,662192,2022-04-15,2022,SEA,HOU,11,1,11-1,SEA,9,1,44,32,76,113,165,278,23,6,29,2,3:04
18408,662236,2022-04-15,2022,SDN,ATL,2,5,5-2,ATL,9,0,34,39,73,162,145,307,7,13,20,2,3:22
18409,662620,2022-04-15,2022,LAN,CIN,3,1,3-1,LAN,9,1,36,36,72,142,145,287,14,9,23,1,3:15
18410,662291,2022-04-15,2022,PIT,WAS,2,7,7-2,WAS,9,0,34,42,76,165,148,313,7,17,24,1,3:14
18411,661417,2022-04-15,2022,MIA,PHI,7,1,7-1,MIA,9,1,39,37,76,160,156,316,16,11,27,2,3:15
18412,662485,2022-04-15,2022,NYN,ARI,10,3,10-3,NYN,9,1,41,35,76,161,158,319,17,9,26,1,3:24
18413,662960,2022-04-15,2022,COL,CHN,6,5,6-5,COL,9,1,36,44,80,163,149,312,13,20,33,3,3:26
18414,663265,2022-04-15,2022,BOS,MIN,4,8,8-4,MIN,9,0,34,44,78,197,127,324,8,19,27,0,3:33
18415,661267,2022-04-15,2022,MIL,SLN,1,10,10-1,SLN,9,0,36,46,82,164,143,307,9,20,29,2,3:10
18416,662014,2022-04-15,2022,TEX,ANA,6,9,9-6,ANA,9,0,41,39,80,156,161,317,15,13,28,4,3:32
18417,663136,2022-04-15,2022,CLE,SFN,1,4,4-1,SFN,9,0,32,41,73,146,116,262,6,13,19,3,2:56
18418,663357,2022-04-15,2022,BAL,NYA,2,1,2-1,BAL,11,0,47,40,87,165,190,355,17,10,27,4,4:15
18419,663238,2022-04-16,2022,BOS,MIN,4,0,4-0,BOS,9,1,31,33,64,133,108,241,8,9,17,3,2:45
18420,662619,2022-04-16,2022,LAN,CIN,5,2,5-2,LAN,9,1,33,32,65,136,140,276,10,6,16,2,2:53
18421,661759,2022-04-16,2022,TOR,OAK,5,7,7-5,OAK,9,0,37,37,74,134,143,277,11,11,22,1,3:05
18422,662235,2022-04-16,2022,SDN,ATL,2,5,5-2,ATL,9,0,32,39,71,140,142,282,5,14,19,2,2:57
18423,662798,2022-04-16,2022,KCA,DET,3,1,3-1,KCA,9,1,33,36,69,157,127,284,10,11,21,2,3:02
18424,661527,2022-04-16,2022,CHA,TBA,3,2,3-2,CHA,9,1,32,36,68,159,116,275,7,11,18,0,2:50
18425,662966,2022-04-16,2022,COL,CHN,9,6,9-6,COL,9,1,38,39,77,143,139,282,15,14,29,2,2:58
18426,661335,2022-04-16,2022,MIL,SLN,1,2,2-1,SLN,9,0,31,37,68,146,128,274,5,11,16,3,2:55
18427,662626,2022-04-16,2022,NYN,ARI,2,3,3-2,ARI,9,0,34,40,74,163,131,294,9,15,24,3,3:12
18428,661981,2022-04-16,2022,TEX,ANA,2,7,7-2,ANA,9,0,33,44,77,191,113,304,6,16,22,1,3:10
18429,662290,2022-04-16,2022,PIT,WAS,6,4,6-4,PIT,9,1,36,42,78,152,141,293,13,14,27,4,3:25
18430,663266,2022-04-16,2022,BAL,NYA,2,5,5-2,NYA,9,0,37,43,80,161,138,299,10,17,27,5,3:26 (1:15 delay)
18431,663076,2022-04-16,2022,CLE,SFN,2,4,4-2,SFN,9,0,37,38,75,178,129,307,11,10,21,4,3:19
18432,661416,2022-04-16,2022,MIA,PHI,3,10,10-3,PHI,9,0,37,45,82,200,129,329,12,17,29,1,3:23
18433,662206,2022-04-16,2022,SEA,HOU,0,4,4-0,HOU,9,0,30,38,68,133,102,235,4,11,15,1,2:36
18434,662234,2022-04-17,2022,SDN,ATL,2,1,2-1,SDN,9,1,36,32,68,125,150,275,12,5,17,2,2:54
18435,663308,2022-04-17,2022,BOS,MIN,8,1,8-1,BOS,9,1,37,33,70,148,122,270,13,7,20,2,2:51
18436,663365,2022-04-17,2022,BAL,NYA,5,0,5-0,BAL,9,1,37,34,71,127,154,281,13,7,20,3,3:16
18437,662625,2022-04-17,2022,NYN,ARI,5,0,5-0,NYN,9,1,36,36,72,150,138,288,12,9,21,4,2:59
18438,661804,2022-04-17,2022,TOR,OAK,4,3,4-3,TOR,9,1,36,36,72,123,139,262,13,10,23,4,3:05
18439,662618,2022-04-17,2022,LAN,CIN,9,1,9-1,LAN,9,1,41,34,75,137,169,306,17,8,25,3,3:02
18440,663132,2022-04-17,2022,CLE,SFN,1,8,8-1,SFN,9,0,34,39,73,164,148,312,9,13,22,1,2:57
18441,662930,2022-04-17,2022,COL,CHN,4,6,6-4,CHN,9,0,39,44,83,157,159,316,13,19,32,4,3:19
18442,661462,2022-04-17,2022,CHA,TBA,3,9,9-3,TBA,9,0,35,45,80,161,146,307,9,18,27,3,3:35
18443,662294,2022-04-17,2022,PIT,WAS,5,3,5-3,PIT,9,1,35,40,75,174,132,306,12,15,27,4,3:20
18444,662174,2022-04-17,2022,SEA,HOU,7,2,7-2,SEA,9,1,36,35,71,160,122,282,12,12,24,1,2:56
18445,662038,2022-04-17,2022,TEX,ANA,3,8,8-3,ANA,9,0,38,43,81,162,139,301,12,18,30,3,3:25
18446,661226,2022-04-17,2022,MIL,SLN,6,5,6-5,MIL,9,1,39,40,79,185,176,361,16,13,29,2,3:51
18447,661415,2022-04-17,2022,MIA,PHI,11,3,11-3,MIA,9,1,48,38,86,148,167,315,24,12,36,2,3:32
18448,662929,2022-04-18,2022,COL,PHI,4,1,4-1,COL,9,1,34,32,66,118,126,244,12,7,19,2,2:53
18449,662233,2022-04-18,2022,SDN,CIN,4,1,4-1,SDN,9,1,36,36,72,135,140,275,13,9,22,0,2:50
18450,663197,2022-04-18,2022,CHN,TBA,4,2,4-2,CHN,9,1,32,35,67,144,131,275,9,10,19,2,2:43
18451,662407,2022-04-18,2022,OAK,BAL,5,1,5-1,OAK,9,1,34,35,69,143,139,282,8,10,18,1,2:59
18452,662617,2022-04-18,2022,LAN,ATL,7,4,7-4,LAN,9,1,38,37,75,147,161,308,14,10,24,2,3:14
18453,662928,2022-04-18,2022,HOU,ANA,8,3,8-3,HOU,9,1,40,36,76,128,168,296,16,10,26,3,3:22
18454,663236,2022-04-18,2022,BOS,MIN,3,8,8-3,MIN,9,0,40,42,82,165,147,312,14,17,31,3,3:28
18455,661242,2022-04-18,2022,MIL,PIT,6,1,6-1,MIL,9,1,34,37,71,142,131,273,11,10,21,0,2:44
18456,662583,2022-04-19,2022,WAS,ARI,1,0,1-0,WAS,9,1,30,35,65,136,97,233,6,8,14,2,2:31
18457,661211,2022-04-19,2022,MIL,PIT,5,2,5-2,MIL,9,1,30,31,61,127,133,260,5,4,9,0,2:29
18458,662616,2022-04-19,2022,NYN,SFN,3,1,3-1,NYN,9,1,34,32,66,128,150,278,11,5,16,1,2:41
18459,662616,2022-04-19,2022,NYN,SFN,3,1,3-1,NYN,9,1,34,32,66,128,150,278,11,5,16,1,2:41
18460,662232,2022-04-19,2022,SDN,CIN,6,2,6-2,SDN,9,1,34,34,68,136,124,260,11,7,18,2,2:41
18461,662587,2022-04-19,2022,WAS,ARI,6,1,6-1,WAS,9,1,36,34,70,150,138,288,13,9,22,2,3:08
18462,662753,2022-04-19,2022,KCA,MIN,4,3,4-3,KCA,9,1,34,39,73,150,123,273,12,13,25,3,3:06
18463,662587,2022-04-19,2022,WAS,ARI,6,1,6-1,WAS,9,1,36,34,70,150,138,288,13,9,22,2,3:08
18464,662406,2022-04-19,2022,OAK,BAL,2,1,2-1,OAK,9,1,35,38,73,159,129,288,12,11,23,3,3:11
18465,663196,2022-04-19,2022,CHN,TBA,5,6,6-5,TBA,9,0,37,39,76,149,142,291,10,14,24,3,3:09
18466,662925,2022-04-19,2022,COL,PHI,6,5,6-5,COL,9,1,36,37,73,133,142,275,12,14,26,1,3:02
18467,661405,2022-04-19,2022,MIA,SLN,1,5,5-1,SLN,9,0,36,38,74,150,140,290,10,12,22,3,3:04
18468,662717,2022-04-19,2022,LAN,ATL,1,3,3-1,ATL,9,0,29,38,67,130,121,251,3,13,16,0,2:49
18469,662927,2022-04-19,2022,HOU,ANA,2,7,7-2,ANA,9,0,37,43,80,171,155,326,9,19,28,3,3:36
18470,662350,2022-04-19,2022,NYN,SFN,5,4,5-4,NYN,10,0,39,42,81,148,139,287,11,13,24,1,3:33
18471,663249,2022-04-19,2022,BOS,TOR,2,1,2-1,BOS,9,1,31,36,67,152,138,290,6,9,15,2,3:10
18472,662896,2022-04-19,2022,DET,NYA,2,4,4-2,NYA,9,0,39,42,81,197,174,371,13,14,27,4,3:59
18473,662161,2022-04-19,2022,SEA,TEX,6,2,6-2,SEA,9,1,34,34,68,118,133,251,11,7,18,1,2:37
18474,663146,2022-04-20,2022,CHN,TBA,2,8,8-2,TBA,6,1,23,30,53,104,105,209,7,11,18,1,2:07 (1:04 delay)
18475,662703,2022-04-20,2022,KCA,MIN,2,0,2-0,KCA,9,1,29,32,61,135,107,242,6,8,14,1,2:29
18476,661404,2022-04-20,2022,MIA,SLN,0,2,2-0,SLN,9,0,35,33,68,117,153,270,8,7,15,1,3:03
18477,661203,2022-04-20,2022,MIL,PIT,4,2,4-2,MIL,9,1,34,35,69,148,124,272,10,9,19,3,2:55
18478,663075,2022-04-20,2022,CLE,CHA,2,1,2-1,CLE,9,1,33,34,67,134,144,278,9,8,17,4,3:01
18479,663094,2022-04-20,2022,CLE,CHA,11,1,11-1,CLE,9,1,40,32,72,123,147,270,14,6,20,1,2:41
18480,662231,2022-04-20,2022,SDN,CIN,6,0,6-0,SDN,9,1,36,33,69,135,130,265,15,7,22,1,2:56
18481,662926,2022-04-20,2022,HOU,ANA,0,6,6-0,ANA,9,0,29,40,69,165,114,279,2,14,16,2,3:08
18482,662734,2022-04-20,2022,LAN,ATL,5,1,5-1,LAN,9,1,37,31,68,125,138,263,13,7,20,2,2:43
18483,662178,2022-04-20,2022,SEA,TEX,4,2,4-2,SEA,9,1,37,34,71,134,148,282,15,8,23,2,2:56
18484,662861,2022-04-20,2022,DET,NYA,3,5,5-3,NYA,9,0,38,36,74,145,141,286,14,8,22,1,3:06
18485,662392,2022-04-20,2022,OAK,BAL,0,1,1-0,BAL,9,0,35,34,69,127,143,270,9,8,17,2,3:02
18486,662924,2022-04-20,2022,COL,PHI,6,9,9-6,PHI,9,0,41,44,85,140,145,285,14,17,31,2,3:09
18487,663075,2022-04-20,2022,CLE,CHA,2,1,2-1,CLE,9,1,33,34,67,134,144,278,9,8,17,4,3:01
18488,662560,2022-04-20,2022,WAS,ARI,2,11,11-2,ARI,9,0,37,42,79,162,150,312,10,14,24,1,3:12
18489,663247,2022-04-20,2022,BOS,TOR,1,6,6-1,TOR,9,0,39,42,81,173,129,302,12,15,27,1,3:07
18490,662349,2022-04-20,2022,NYN,SFN,2,5,5-2,SFN,9,0,39,37,76,153,166,319,13,11,24,1,3:20
18491,663225,2022-04-21,2022,BOS,TOR,2,3,3-2,TOR,9,0,33,37,70,146,106,252,9,11,20,3,2:59
18492,662391,2022-04-21,2022,OAK,BAL,6,4,6-4,OAK,9,1,35,34,69,133,127,260,11,9,20,3,2:50
18493,663093,2022-04-21,2022,CLE,CHA,6,3,6-3,CLE,9,1,40,34,74,122,151,273,15,9,24,3,3:07
18494,662593,2022-04-21,2022,NYN,SFN,6,2,6-2,NYN,9,1,39,32,71,105,136,241,16,5,21,1,2:35
18495,661391,2022-04-21,2022,MIA,SLN,5,0,5-0,MIA,9,1,34,32,66,133,129,262,11,5,16,1,2:43
18496,663145,2022-04-21,2022,CHN,PIT,3,4,4-3,PIT,9,0,35,40,75,176,155,331,9,15,24,3,3:35
18497,662850,2022-04-21,2022,DET,NYA,3,0,3-0,DET,9,1,33,34,67,112,122,234,12,8,20,2,2:34
18498,662742,2022-04-21,2022,KCA,MIN,0,1,1-0,MIN,9,0,30,34,64,149,125,274,5,10,15,0,2:43
18499,662558,2022-04-21,2022,WAS,ARI,3,4,4-3,ARI,9,0,38,39,77,153,125,278,12,13,25,2,3:00
18500,662177,2022-04-21,2022,SEA,TEX,6,8,8-6,TEX,9,0,45,43,88,180,192,372,19,13,32,4,3:47
18501,662175,2022-04-22,2022,SEA,KCA,4,1,4-1,SEA,9,1,35,33,68,112,138,250,10,9,19,2,2:42
18502,661037,2022-04-22,2022,ANA,BAL,3,5,5-3,BAL,9,0,32,36,68,128,128,256,9,9,18,2,2:55
18503,661755,2022-04-22,2022,MIN,CHA,2,1,2-1,MIN,9,1,30,36,66,155,129,284,8,9,17,1,3:04
18504,662557,2022-04-22,2022,WAS,SFN,1,7,7-1,SFN,9,0,31,42,73,161,112,273,7,17,24,1,2:53
18505,661311,2022-04-22,2022,NYA,CLE,4,1,4-1,NYA,9,1,35,35,70,144,150,294,11,9,20,0,2:58
18506,663195,2022-04-22,2022,CHN,PIT,2,4,4-2,PIT,9,0,37,35,72,131,158,289,11,10,21,2,3:08
18507,662922,2022-04-22,2022,HOU,TOR,3,4,4-3,TOR,9,0,36,34,70,133,133,266,9,8,17,0,2:53
18508,661569,2022-04-22,2022,ATL,MIA,3,0,3-0,ATL,9,1,33,36,69,144,150,294,9,9,18,2,3:04
18509,663169,2022-04-22,2022,CIN,SLN,2,4,4-2,SLN,9,0,38,43,81,160,143,303,13,17,30,3,3:19
18510,662390,2022-04-22,2022,OAK,TEX,1,8,8-1,TEX,9,0,32,40,72,179,130,309,5,14,19,2,3:05
18511,661914,2022-04-22,2022,TBA,BOS,3,4,4-3,BOS,9,0,38,37,75,135,162,297,11,12,23,2,3:21
18512,663394,2022-04-22,2022,ARI,NYN,5,6,6-5,NYN,10,0,40,40,80,160,147,307,11,10,21,3,3:29
18513,662230,2022-04-22,2022,SDN,LAN,1,6,6-1,LAN,9,0,35,40,75,185,136,321,7,15,22,4,3:25
18514,661621,2022-04-22,2022,PHI,MIL,4,2,4-2,PHI,9,1,37,37,74,163,157,320,13,10,23,2,3:20
18515,662849,2022-04-23,2022,DET,COL,2,3,3-2,COL,9,0,36,33,69,131,146,277,9,6,15,0,2:47
18516,662875,2022-04-23,2022,HOU,TOR,2,3,3-2,TOR,9,0,35,35,70,131,133,264,9,10,19,3,2:54
18517,661620,2022-04-23,2022,PHI,MIL,3,5,5-3,MIL,9,0,33,36,69,144,117,261,8,10,18,2,2:57
18518,662849,2022-04-23,2022,DET,COL,2,3,3-2,COL,9,0,36,33,69,131,146,277,9,6,15,0,2:47
18519,661941,2022-04-23,2022,TBA,BOS,3,2,3-2,TBA,10,0,34,38,72,146,133,279,5,7,12,2,3:05
18520,662549,2022-04-23,2022,WAS,SFN,2,5,5-2,SFN,9,0,35,38,73,140,134,274,8,13,21,1,2:48
18521,662276,2022-04-23,2022,SDN,LAN,3,2,3-2,SDN,10,0,37,37,74,156,149,305,9,9,18,2,3:27
18522,663144,2022-04-23,2022,CHN,PIT,21,0,21-0,CHN,9,1,53,30,83,106,169,275,28,3,31,1,2:47
18523,661035,2022-04-23,2022,ANA,BAL,4,5,5-4,BAL,9,0,39,42,81,145,154,299,11,13,24,2,3:11
18524,661310,2022-04-23,2022,NYA,CLE,5,4,5-4,NYA,9,0,36,32,68,133,139,272,13,6,19,3,2:50
18525,661752,2022-04-23,2022,MIN,CHA,9,2,9-2,MIN,9,1,43,36,79,151,193,344,19,9,28,2,3:32 (:05 delay)
18526,663384,2022-04-23,2022,ARI,NYN,5,2,5-2,ARI,9,1,38,35,73,141,168,309,14,10,24,3,3:19
18527,662848,2022-04-23,2022,DET,COL,13,0,13-0,DET,9,1,45,34,79,138,162,300,23,9,32,2,3:02
18528,661568,2022-04-23,2022,ATL,MIA,7,9,9-7,MIA,9,0,39,48,87,188,159,347,12,22,34,4,3:44
18529,662389,2022-04-23,2022,OAK,TEX,0,2,2-0,TEX,9,0,32,32,64,112,127,239,5,7,12,1,2:41
18530,662191,2022-04-23,2022,SEA,KCA,13,7,13-7,SEA,9,1,48,43,91,178,192,370,24,16,40,6,4:06
18531,663100,2022-04-23,2022,CIN,SLN,0,5,5-0,SLN,9,0,31,42,73,174,120,294,8,16,24,2,3:13
18532,661640,2022-04-24,2022,PHI,MIL,0,1,1-0,MIL,9,0,34,30,64,113,132,245,7,4,11,0,2:49
18533,661931,2022-04-24,2022,TBA,BOS,5,2,5-2,TBA,9,1,37,34,71,114,126,240,16,7,23,3,2:38
18534,663361,2022-04-24,2022,ARI,NYN,2,6,6-2,NYN,9,0,34,41,75,144,118,262,7,14,21,3,2:56
18535,662388,2022-04-24,2022,OAK,TEX,2,0,2-0,OAK,9,1,33,34,67,136,144,280,12,6,18,1,2:56
18536,661317,2022-04-24,2022,NYA,CLE,10,2,10-2,NYA,9,1,40,35,75,143,129,272,17,9,26,1,2:43
18537,662853,2022-04-24,2022,DET,COL,2,6,6-2,COL,9,0,36,39,75,161,131,292,10,13,23,1,2:55
18538,662539,2022-04-24,2022,WAS,SFN,3,12,12-3,SFN,9,0,35,48,83,181,122,303,9,21,30,5,3:19
18539,661033,2022-04-24,2022,ANA,BAL,7,6,7-6,ANA,9,1,40,40,80,159,159,318,18,15,33,7,3:42
18540,663166,2022-04-24,2022,CHN,PIT,3,4,4-3,PIT,9,0,41,40,81,178,156,334,16,13,29,3,3:37 (:55 delay)
18541,662921,2022-04-24,2022,HOU,TOR,8,7,8-7,HOU,10,0,44,43,87,138,179,317,16,13,29,4,3:45
18542,661590,2022-04-24,2022,ATL,MIA,4,5,5-4,MIA,9,0,42,44,86,178,165,343,15,18,33,6,3:42
18543,663111,2022-04-24,2022,CIN,SLN,4,1,4-1,CIN,9,1,32,35,67,137,117,254,12,8,20,2,2:47
18544,662274,2022-04-24,2022,SDN,LAN,2,10,10-2,LAN,9,0,35,42,77,159,140,299,10,13,23,2,3:02
18545,661781,2022-04-24,2022,MIN,CHA,6,4,6-4,MIN,10,0,46,40,86,153,186,339,18,12,30,1,3:50
18546,662188,2022-04-24,2022,SEA,KCA,5,4,5-4,SEA,12,0,48,47,95,179,194,373,18,13,31,2,4:12
18547,661034,2022-04-25,2022,ANA,CLE,3,0,3-0,ANA,9,1,33,32,65,119,117,236,10,7,17,1,2:22
18548,661760,2022-04-25,2022,TOR,BOS,6,2,6-2,TOR,9,1,32,34,66,109,97,206,10,8,18,2,2:16
18549,663382,2022-04-25,2022,ARI,LAN,0,4,4-0,LAN,9,0,31,38,69,148,108,256,4,12,16,0,2:33
18550,661210,2022-04-25,2022,MIL,SFN,2,4,4-2,SFN,9,0,33,36,69,150,130,280,6,12,18,1,3:01
18551,662008,2022-04-25,2022,SLN,NYN,2,5,5-2,NYN,9,0,36,38,74,135,147,282,8,11,19,1,3:00
18552,661979,2022-04-25,2022,TEX,HOU,6,2,6-2,TEX,9,1,39,38,77,149,149,298,15,11,26,3,3:14
18553,661639,2022-04-25,2022,PHI,COL,8,2,8-2,PHI,9,1,38,32,70,129,157,286,12,8,20,3,3:09
18554,661589,2022-04-26,2022,ATL,CHN,3,1,3-1,ATL,9,1,30,32,62,126,118,244,6,6,12,0,2:31
18555,661032,2022-04-26,2022,ANA,CLE,4,1,4-1,ANA,9,1,32,32,64,125,116,241,9,5,14,2,2:34
18556,663383,2022-04-26,2022,ARI,LAN,5,3,5-3,ARI,9,1,33,36,69,142,129,271,8,16,24,1,2:53
18557,662540,2022-04-26,2022,WAS,MIA,2,5,5-2,MIA,9,0,35,40,75,145,138,283,12,13,25,1,3:13
18558,661980,2022-04-26,2022,TEX,HOU,1,5,5-1,HOU,9,0,32,36,68,160,128,288,6,10,16,1,3:02
18559,661733,2022-04-26,2022,MIN,DET,5,4,5-4,MIN,9,0,34,37,71,166,143,309,10,12,22,3,3:05
18560,662007,2022-04-26,2022,SLN,NYN,0,3,3-0,NYN,9,0,35,39,74,154,141,295,9,15,24,2,3:32
18561,661567,2022-04-26,2022,PHI,COL,10,3,10-3,PHI,9,1,40,37,77,157,162,319,15,10,25,2,3:19
18562,663079,2022-04-26,2022,CIN,SDN,6,9,9-6,SDN,9,0,36,43,79,179,136,315,9,17,26,1,3:11
18563,661309,2022-04-26,2022,NYA,BAL,12,8,12-8,NYA,9,1,40,39,79,139,166,305,15,12,27,5,3:19 (:09 delay)
18564,661536,2022-04-26,2022,CHA,KCA,0,6,6-0,KCA,9,0,35,44,79,189,149,338,8,17,25,2,3:20
18565,662297,2022-04-26,2022,PIT,MIL,8,12,12-8,MIL,9,0,45,43,88,155,178,333,17,18,35,6,3:29
18566,661929,2022-04-26,2022,TBA,SEA,4,8,8-4,SEA,9,0,40,43,83,169,191,360,14,13,27,1,3:15
18567,661758,2022-04-26,2022,TOR,BOS,6,5,6-5,TOR,10,0,42,40,82,163,180,343,15,11,26,5,3:47
18568,662086,2022-04-26,2022,SFN,OAK,8,2,8-2,SFN,9,1,35,35,70,162,134,296,11,8,19,2,3:01
18569,661909,2022-04-27,2022,TBA,SEA,3,2,3-2,TBA,9,1,34,34,68,138,124,262,11,7,18,3,2:41
18570,661638,2022-04-27,2022,PHI,COL,7,3,7-3,PHI,9,1,38,38,76,151,149,300,16,14,30,2,3:20
18571,663439,2022-04-27,2022,ANA,CLE,9,5,9-5,ANA,9,1,41,38,79,146,162,308,17,12,29,2,3:12
18572,662546,2022-04-27,2022,WAS,MIA,1,2,2-1,MIA,9,0,36,35,71,164,154,318,9,10,19,4,3:20
18573,663393,2022-04-27,2022,ARI,LAN,3,1,3-1,ARI,9,1,31,34,65,127,114,241,6,8,14,0,2:36
18574,661306,2022-04-27,2022,NYA,BAL,5,2,5-2,NYA,9,1,34,34,68,124,134,258,10,8,18,3,2:57
18575,661533,2022-04-27,2022,CHA,KCA,7,3,7-3,CHA,9,1,35,36,71,144,128,272,12,10,22,2,2:42
18576,662066,2022-04-27,2022,SFN,OAK,0,1,1-0,OAK,9,0,32,35,67,123,155,278,6,10,16,2,3:00
18577,661739,2022-04-27,2022,MIN,DET,5,0,5-0,MIN,9,1,34,30,64,120,114,234,12,3,15,0,2:23
18578,663148,2022-04-27,2022,CIN,SDN,5,8,8-5,SDN,9,0,43,40,83,157,175,332,15,15,30,2,3:28
18579,662048,2022-04-27,2022,SLN,NYN,10,5,10-5,SLN,9,1,43,38,81,160,156,316,21,14,35,3,3:29
18580,662289,2022-04-27,2022,PIT,MIL,1,3,3-1,MIL,9,0,34,37,71,152,139,291,8,9,17,3,3:01
18581,661964,2022-04-27,2022,TEX,HOU,3,4,4-3,HOU,9,0,37,38,75,149,164,313,11,11,22,1,3:17
18582,661757,2022-04-27,2022,TOR,BOS,1,7,7-1,BOS,9,0,35,43,78,162,141,303,8,16,24,3,3:05
18583,661552,2022-04-27,2022,ATL,CHN,3,6,6-3,CHN,10,0,43,45,88,209,180,389,13,17,30,3,4:04
18584,661729,2022-04-28,2022,MIN,DET,7,1,7-1,MIN,9,1,39,40,79,145,144,289,15,15,30,1,3:09
18585,661908,2022-04-28,2022,TBA,SEA,2,1,2-1,TBA,9,1,33,35,68,133,128,261,12,10,22,4,3:04
18586,662538,2022-04-28,2022,WAS,MIA,2,3,3-2,MIA,9,0,34,36,70,121,134,255,8,9,17,2,2:46
18587,661641,2022-04-28,2022,PHI,COL,7,1,7-1,PHI,9,1,35,37,72,153,136,289,10,11,21,2,3:08
18588,662295,2022-04-28,2022,PIT,MIL,2,3,3-2,MIL,9,0,33,39,72,152,147,299,6,12,18,2,3:08
18589,661532,2022-04-28,2022,CHA,KCA,2,5,5-2,KCA,10,0,34,44,78,193,132,325,6,15,21,1,3:20
18590,661305,2022-04-28,2022,NYA,BAL,10,5,10-5,NYA,9,1,40,45,85,175,167,342,17,18,35,5,3:51
18591,663078,2022-04-28,2022,CIN,SDN,5,7,7-5,SDN,9,0,38,43,81,175,157,332,12,18,30,3,3:35
18592,661551,2022-04-28,2022,ATL,CHN,5,1,5-1,ATL,9,1,37,32,69,124,124,248,14,8,22,2,2:49
18593,662047,2022-04-28,2022,SLN,ARI,8,3,8-3,SLN,9,1,41,37,78,139,156,295,18,10,28,2,3:01
18594,661912,2022-04-28,2022,TEX,HOU,2,3,3-2,HOU,9,0,33,32,65,115,117,232,6,5,11,0,2:37
18595,661827,2022-04-28,2022,TOR,BOS,1,0,1-0,TOR,9,1,34,32,66,114,131,245,9,5,14,1,2:42
18596,663432,2022-04-28,2022,ANA,CLE,4,1,4-1,ANA,9,1,34,32,66,145,127,272,10,6,16,0,2:35
18597,663337,2022-04-29,2022,BAL,BOS,1,3,3-1,BOS,9,0,35,35,70,128,143,271,9,8,17,3,2:57
18598,662592,2022-04-29,2022,NYN,PHI,3,0,3-0,NYN,9,1,32,32,64,159,134,293,11,6,17,2,3:18
18599,661390,2022-04-29,2022,MIA,SEA,8,6,8-6,MIA,9,1,37,38,75,157,144,301,15,11,26,1,3:06
18600,662405,2022-04-29,2022,OAK,CLE,8,9,9-8,CLE,9,0,40,41,81,173,144,317,13,16,29,3,3:21
18601,661209,2022-04-29,2022,MIL,CHN,11,1,11-1,MIL,9,1,40,35,75,154,170,324,18,8,26,3,3:15
18602,661535,2022-04-29,2022,CHA,ANA,1,5,5-1,ANA,9,0,32,40,72,159,129,288,5,16,21,4,3:19
18603,661826,2022-04-29,2022,TOR,HOU,7,11,11-7,HOU,9,0,44,48,92,178,165,343,17,22,39,3,3:42
18604,662081,2022-04-29,2022,SFN,WAS,4,14,14-4,WAS,9,0,39,52,91,181,162,343,13,25,38,4,3:46
18605,662037,2022-04-29,2022,SLN,ARI,2,6,6-2,ARI,9,0,35,40,75,161,153,314,8,15,23,3,3:24
18606,661911,2022-04-29,2022,TEX,ATL,3,6,6-3,ATL,9,0,35,42,77,173,145,318,8,16,24,3,3:23
18607,661907,2022-04-29,2022,TBA,MIN,6,1,6-1,TBA,9,1,34,30,64,114,129,243,11,4,15,0,2:16
18608,662699,2022-04-29,2022,LAN,DET,5,1,5-1,LAN,9,1,34,32,66,109,144,253,10,7,17,1,2:43
18609,662741,2022-04-29,2022,KCA,NYA,2,12,12-2,NYA,8,0,33,39,72,162,130,292,10,13,23,2,2:58 (:34 delay)
18610,662296,2022-04-29,2022,PIT,SDN,3,7,7-3,SDN,9,0,38,42,80,170,135,305,12,17,29,3,3:19
18611,663009,2022-04-29,2022,COL,CIN,10,4,10-4,COL,9,1,47,40,87,135,195,330,23,17,40,3,3:25
18612,663008,2022-04-30,2022,COL,CIN,4,3,4-3,COL,9,1,30,31,61,98,124,222,9,5,14,3,2:31
18613,661901,2022-04-30,2022,TEX,ATL,3,1,3-1,TEX,9,1,30,31,61,115,102,217,8,4,12,2,2:16
18614,661389,2022-04-30,2022,MIA,SEA,3,1,3-1,MIA,9,1,34,33,67,134,132,266,11,8,19,1,2:46
18615,662393,2022-04-30,2022,OAK,CLE,1,3,3-1,CLE,9,0,35,36,71,145,128,273,9,12,21,1,2:42
18616,662288,2022-04-30,2022,PIT,SDN,7,6,7-6,PIT,10,0,38,38,76,146,148,294,11,9,20,2,3:07
18617,662698,2022-04-30,2022,LAN,DET,1,5,5-1,DET,9,0,33,41,74,147,138,285,7,14,21,2,3:05
18618,663364,2022-04-30,2022,BAL,BOS,2,1,2-1,BAL,10,0,35,40,75,140,133,273,7,11,18,3,3:09
18619,661208,2022-04-30,2022,MIL,CHN,9,1,9-1,MIL,9,1,41,35,76,136,165,301,15,9,24,0,3:03
18620,661825,2022-04-30,2022,TOR,HOU,2,1,2-1,TOR,9,1,32,39,71,124,106,230,9,11,20,2,2:43
18621,662797,2022-04-30,2022,KCA,NYA,0,3,3-0,NYA,9,0,38,40,78,170,129,299,11,17,28,0,3:08
18622,662084,2022-04-30,2022,SFN,WAS,9,3,9-3,SFN,9,1,42,36,78,128,173,301,18,12,30,4,3:20
18623,662591,2022-04-30,2022,NYN,PHI,1,4,4-1,PHI,9,0,41,35,76,149,180,329,12,10,22,5,3:48
18624,661534,2022-04-30,2022,CHA,ANA,4,0,4-0,CHA,9,1,35,33,68,138,121,259,13,7,20,2,2:55 (1:01 delay)
18625,661906,2022-04-30,2022,TBA,MIN,1,9,9-1,MIN,9,0,34,45,79,183,137,320,7,17,24,3,3:05
18626,662036,2022-04-30,2022,SLN,ARI,0,2,2-0,ARI,9,0,32,33,65,118,136,254,4,5,9,1,2:38
18627,663007,2022-05-01,2022,COL,CIN,10,1,10-1,COL,9,1,42,31,73,99,178,277,18,6,24,1,2:56
18628,662293,2022-05-01,2022,PIT,SDN,2,5,5-2,SDN,9,0,36,39,75,144,132,276,11,11,22,2,3:02 (1:22 delay)
18629,661905,2022-05-01,2022,TBA,MIN,3,9,9-3,MIN,9,0,35,43,78,164,130,294,9,16,25,1,2:53
18630,661988,2022-05-01,2022,SLN,ARI,7,5,7-5,SLN,9,1,36,37,73,153,155,308,11,11,22,4,3:14
18631,662397,2022-05-01,2022,OAK,CLE,3,7,7-3,CLE,9,0,37,43,80,174,143,317,10,15,25,4,3:13
18632,663363,2022-05-01,2022,BAL,BOS,9,5,9-5,BAL,9,1,41,42,83,160,165,325,19,17,36,4,3:19 (2:05 delay)
18633,662691,2022-05-01,2022,KCA,NYA,4,6,6-4,NYA,9,0,39,40,79,178,149,327,13,15,28,2,3:23
18634,661531,2022-05-01,2022,CHA,ANA,5,6,6-5,ANA,9,0,41,42,83,173,129,302,16,18,34,4,3:15
18635,662579,2022-05-01,2022,NYN,PHI,10,6,10-6,NYN,9,1,41,36,77,142,160,302,18,10,28,2,3:20
18636,661824,2022-05-01,2022,TOR,HOU,3,2,3-2,TOR,9,1,29,35,64,129,118,247,6,8,14,2,2:52
18637,661216,2022-05-01,2022,MIL,CHN,0,2,2-0,CHN,9,0,31,34,65,129,139,268,6,7,13,2,2:43
18638,662716,2022-05-01,2022,LAN,DET,6,3,6-3,LAN,9,1,34,39,73,162,119,281,8,13,21,2,2:57
18639,661935,2022-05-01,2022,TEX,ATL,7,3,7-3,TEX,9,1,41,37,78,146,157,303,17,11,28,1,3:00
18640,661365,2022-05-01,2022,MIA,SEA,3,7,7-3,SEA,9,0,42,40,82,151,175,326,14,19,33,2,3:22
18641,662106,2022-05-01,2022,SFN,WAS,5,11,11-5,WAS,9,0,40,46,86,175,157,332,13,20,33,4,3:37
18642,662009,2022-05-02,2022,SLN,KCA,1,0,1-0,SLN,9,1,28,33,61,144,124,268,5,6,11,0,2:40
18643,661526,2022-05-02,2022,CHA,ANA,3,0,3-0,CHA,9,1,33,30,63,125,128,253,10,3,13,0,2:39
18644,662009,2022-05-02,2022,SLN,KCA,1,0,1-0,SLN,9,1,28,33,61,144,124,268,5,6,11,0,2:40
18645,662920,2022-05-02,2022,HOU,SEA,3,0,3-0,HOU,9,1,34,31,65,130,117,247,10,8,18,1,2:48
18646,663362,2022-05-02,2022,BAL,MIN,1,2,2-1,MIN,9,0,32,33,65,128,135,263,6,8,14,3,2:56
18647,661823,2022-05-02,2022,TOR,NYA,2,3,3-2,NYA,9,0,35,35,70,126,125,251,11,8,19,3,2:54
18648,662387,2022-05-02,2022,OAK,TBA,1,6,6-1,TBA,9,0,30,39,69,143,126,269,3,12,15,0,2:37
18649,662578,2022-05-02,2022,NYN,ATL,2,5,5-2,ATL,9,0,36,37,73,134,149,283,8,11,19,1,3:18
18650,661362,2022-05-02,2022,MIA,ARI,4,5,5-4,ARI,9,0,38,37,75,154,157,311,12,12,24,2,3:27
18651,663463,2022-05-03,2022,BAL,MIN,2,7,7-2,MIN,9,0,37,41,78,151,128,279,10,15,25,3,3:00
18652,661796,2022-05-03,2022,TOR,NYA,1,9,9-1,NYA,9,0,35,41,76,158,113,271,8,13,21,2,2:57
18653,662459,2022-05-03,2022,NYN,ATL,3,0,3-0,NYN,9,1,32,34,66,104,108,212,10,9,19,0,2:18
18654,661635,2022-05-03,2022,PHI,TEX,4,6,6-4,TEX,9,0,37,39,76,158,133,291,12,11,23,2,3:05
18655,661364,2022-05-03,2022,MIA,ARI,4,5,5-4,ARI,9,0,37,40,77,149,163,312,10,13,23,3,3:24
18656,663237,2022-05-03,2022,BOS,ANA,4,0,4-0,BOS,9,1,33,30,63,101,115,216,10,6,16,1,2:23
18657,662690,2022-05-03,2022,KCA,SLN,7,1,7-1,KCA,9,1,40,34,74,123,128,251,18,10,28,3,2:47
18658,662708,2022-05-03,2022,LAN,SFN,3,1,3-1,LAN,9,1,32,35,67,129,136,265,8,9,17,2,3:05
18659,662994,2022-05-03,2022,COL,WAS,2,10,10-2,WAS,9,0,35,44,79,138,123,261,9,20,29,0,2:39
18660,662569,2022-05-03,2022,NYN,ATL,5,4,5-4,NYN,9,1,35,37,72,151,126,277,12,9,21,1,2:49
18661,663165,2022-05-03,2022,CHN,CHA,1,3,3-1,CHA,9,0,35,36,71,128,150,278,9,11,20,2,3:01
18662,662919,2022-05-03,2022,HOU,SEA,4,0,4-0,HOU,9,1,34,33,67,151,142,293,11,7,18,2,3:12
18663,661200,2022-05-03,2022,MIL,CIN,6,3,6-3,MIL,9,1,35,33,68,144,167,311,11,6,17,3,3:10
18664,662386,2022-05-03,2022,OAK,TBA,7,10,10-7,TBA,10,0,41,45,86,153,148,301,14,18,32,5,3:21
18665,662382,2022-05-04,2022,OAK,TBA,0,3,3-0,TBA,9,0,32,38,70,154,90,244,5,11,16,2,2:39
18666,663164,2022-05-04,2022,CHN,CHA,3,4,4-3,CHA,9,0,33,36,69,121,146,267,7,12,19,3,3:05
18667,663462,2022-05-04,2022,BAL,MIN,9,4,9-4,BAL,9,1,37,34,71,130,125,255,14,13,27,1,2:43
18668,661634,2022-05-04,2022,PHI,TEX,1,2,2-1,TEX,10,0,37,37,74,114,133,247,10,11,21,2,3:14
18669,661795,2022-05-04,2022,TOR,NYA,2,1,2-1,TOR,9,1,31,35,66,129,129,258,8,9,17,1,2:44
18670,662835,2022-05-04,2022,HOU,SEA,7,2,7-2,HOU,9,1,37,31,68,128,164,292,15,5,20,1,3:01
18671,661363,2022-05-04,2022,MIA,ARI,7,8,8-7,ARI,9,0,40,40,80,149,160,309,14,14,28,3,3:25
18672,662839,2022-05-04,2022,DET,PIT,2,7,7-2,PIT,9,0,39,41,80,164,129,293,11,17,28,1,3:07
18673,662739,2022-05-04,2022,KCA,SLN,0,10,10-0,SLN,9,0,32,44,76,202,117,319,5,17,22,2,3:02
18674,662707,2022-05-04,2022,LAN,SFN,9,1,9-1,LAN,9,1,37,33,70,120,161,281,16,8,24,3,3:00
18675,661197,2022-05-04,2022,MIL,CIN,18,4,18-4,MIL,9,1,51,38,89,158,211,369,28,10,38,5,3:46
18676,662577,2022-05-04,2022,NYN,ATL,2,9,9-2,ATL,9,0,38,41,79,161,146,307,13,13,26,3,3:28
18677,663068,2022-05-04,2022,CLE,SDN,6,5,6-5,CLE,10,0,42,43,85,175,181,356,16,17,33,3,3:46
18678,663248,2022-05-04,2022,BOS,ANA,5,10,10-5,ANA,10,0,40,42,82,180,148,328,13,12,25,3,3:42
18679,662993,2022-05-04,2022,COL,WAS,5,2,5-2,COL,9,1,35,31,66,124,94,218,9,9,18,1,2:18 (:25 delay)
18680,662838,2022-05-04,2022,DET,PIT,3,2,3-2,DET,9,1,31,33,64,143,113,256,5,7,12,2,2:41
18681,662839,2022-05-04,2022,DET,PIT,2,7,7-2,PIT,9,0,39,41,80,164,129,293,11,17,28,1,3:07
18682,663067,2022-05-04,2022,CLE,SDN,4,5,5-4,SDN,9,0,40,39,79,144,163,307,13,11,24,2,3:15
18683,663068,2022-05-04,2022,CLE,SDN,6,5,6-5,CLE,10,0,42,43,85,175,181,356,16,17,33,3,3:46
18684,663066,2022-05-05,2022,CLE,TOR,6,5,6-5,CLE,9,1,36,38,74,157,140,297,13,11,24,2,3:03
18685,662105,2022-05-05,2022,SFN,SLN,1,7,7-1,SLN,9,0,38,40,78,154,150,304,14,14,28,3,3:01
18686,661204,2022-05-05,2022,MIL,CIN,10,5,10-5,MIL,9,1,40,38,78,139,167,306,16,10,26,1,3:05
18687,662189,2022-05-05,2022,SEA,TBA,3,4,4-3,TBA,9,0,34,35,69,127,130,257,8,8,16,3,2:50
18688,661341,2022-05-05,2022,BAL,MIN,5,3,5-3,BAL,9,1,35,37,72,132,138,270,12,14,26,5,3:03
18689,662262,2022-05-05,2022,SDN,MIA,2,1,2-1,SDN,9,1,32,32,64,133,130,263,10,6,16,2,2:50
18690,662816,2022-05-05,2022,HOU,DET,3,2,3-2,HOU,9,0,33,34,67,140,140,280,10,10,20,0,2:55
18691,663227,2022-05-05,2022,BOS,ANA,0,8,8-0,ANA,9,0,34,38,72,154,127,281,6,11,17,1,2:55
18692,661619,2022-05-05,2022,PHI,NYN,7,8,8-7,NYN,9,0,42,39,81,140,134,274,15,12,27,2,3:15
18693,663013,2022-05-05,2022,COL,WAS,9,7,9-7,COL,9,1,38,43,81,157,153,310,14,18,32,4,3:25
18694,663360,2022-05-06,2022,ARI,COL,4,1,4-1,ARI,9,1,34,36,70,114,135,249,10,10,20,2,2:47
18695,663431,2022-05-06,2022,ANA,WAS,3,0,3-0,ANA,9,1,33,33,66,110,131,241,12,8,20,0,2:28
18696,662815,2022-05-06,2022,HOU,DET,3,2,3-2,HOU,9,1,36,32,68,120,139,259,12,4,16,2,3:06
18697,662103,2022-05-06,2022,SFN,SLN,2,3,3-2,SLN,9,0,34,35,69,131,128,259,9,8,17,3,2:52
18698,661775,2022-05-06,2022,MIN,OAK,2,1,2-1,MIN,9,1,36,32,68,125,136,261,12,6,18,1,2:44
18699,662187,2022-05-06,2022,SEA,TBA,7,8,8-7,TBA,9,0,43,43,86,181,167,348,17,18,35,5,3:54
18700,662272,2022-05-06,2022,SDN,MIA,3,2,3-2,SDN,9,1,35,34,69,129,168,297,11,7,18,1,3:19
18701,661541,2022-05-06,2022,ATL,MIL,3,6,6-3,MIL,9,0,32,43,75,176,139,315,6,15,21,3,3:15
18702,663224,2022-05-06,2022,BOS,CHA,2,4,4-2,CHA,9,0,37,40,77,162,137,299,12,15,27,1,3:29
18703,662796,2022-05-07,2022,HOU,DET,3,2,3-2,HOU,9,1,34,38,72,135,129,264,11,13,24,2,3:01
18704,663359,2022-05-07,2022,ARI,COL,1,4,4-1,COL,9,0,37,38,75,148,133,281,13,10,23,2,3:19
18705,663057,2022-05-07,2022,CLE,TOR,8,2,8-2,CLE,9,1,39,30,69,134,164,298,15,6,21,0,2:55
18706,663142,2022-05-07,2022,CHN,LAN,2,6,6-2,LAN,9,0,36,39,75,168,129,297,8,12,20,1,3:05
18707,663430,2022-05-07,2022,ANA,WAS,3,7,7-3,WAS,9,0,37,40,77,156,137,293,10,13,23,3,3:02
18708,663226,2022-05-07,2022,BOS,CHA,1,3,3-1,CHA,10,0,40,43,83,160,148,308,10,13,23,1,3:42
18709,663057,2022-05-07,2022,CLE,TOR,8,2,8-2,CLE,9,1,39,30,69,134,164,298,15,6,21,0,2:55
18710,663162,2022-05-07,2022,CHN,LAN,0,7,7-0,LAN,9,0,32,40,72,162,121,283,8,15,23,1,2:43
18711,662261,2022-05-07,2022,SDN,MIA,0,8,8-0,MIA,9,0,34,41,75,162,108,270,7,14,21,1,2:54
18712,662102,2022-05-07,2022,SFN,SLN,13,7,13-7,SFN,9,1,44,43,87,159,178,337,19,17,36,2,3:22
18713,662159,2022-05-07,2022,SEA,TBA,2,8,8-2,TBA,9,0,34,41,75,164,137,301,8,16,24,2,3:01
18714,661701,2022-05-07,2022,MIN,OAK,1,0,1-0,MIN,9,1,31,33,64,129,132,261,8,7,15,3,2:55
18715,661540,2022-05-07,2022,ATL,MIL,3,2,3-2,ATL,9,1,35,33,68,131,135,266,11,8,19,0,2:57
18716,663142,2022-05-07,2022,CHN,LAN,2,6,6-2,LAN,9,0,36,39,75,168,129,297,8,12,20,1,3:05
18717,663089,2022-05-07,2022,CIN,PIT,9,2,9-2,CIN,9,1,39,36,75,133,158,291,15,10,25,3,3:09
18718,663056,2022-05-07,2022,CLE,TOR,3,8,8-3,TOR,9,0,36,45,81,193,153,346,10,20,30,3,3:23
18719,663070,2022-05-07,2022,CIN,PIT,5,8,8-5,PIT,9,0,40,45,85,199,170,369,14,19,33,4,3:46
18720,662795,2022-05-08,2022,HOU,DET,5,0,5-0,HOU,9,1,34,31,65,127,137,264,11,4,15,0,2:44
18721,661626,2022-05-08,2022,PHI,NYN,3,2,3-2,PHI,9,1,35,33,68,134,141,275,12,9,21,0,2:58
18722,663278,2022-05-08,2022,BOS,CHA,2,3,3-2,CHA,9,0,35,36,71,130,134,264,10,10,20,3,3:21
18723,661304,2022-05-08,2022,NYA,TEX,2,4,4-2,TEX,9,0,36,35,71,117,156,273,10,9,19,3,3:07
18724,663086,2022-05-08,2022,CLE,TOR,4,3,4-3,CLE,9,1,35,35,70,142,146,288,13,7,20,3,3:02
18725,662260,2022-05-08,2022,SDN,MIA,3,2,3-2,SDN,9,0,36,34,70,129,155,284,10,7,17,1,3:07
18726,661304,2022-05-08,2022,NYA,TEX,2,4,4-2,TEX,9,0,36,35,71,117,156,273,10,9,19,3,3:07
18727,661302,2022-05-08,2022,NYA,TEX,2,1,2-1,NYA,9,0,34,34,68,144,144,288,8,7,15,2,2:54
18728,661345,2022-05-08,2022,BAL,KCA,4,2,4-2,BAL,9,1,37,33,70,110,155,265,13,7,20,1,2:43
18729,662098,2022-05-08,2022,SFN,SLN,4,3,4-3,SFN,9,1,38,39,77,153,142,295,14,12,26,1,3:08
18730,661307,2022-05-08,2022,BAL,KCA,4,6,6-4,KCA,9,0,42,41,83,134,153,287,16,14,30,3,3:17
18731,661627,2022-05-08,2022,PHI,NYN,1,6,6-1,NYN,9,0,35,41,76,171,147,318,7,14,21,2,3:15
18732,663368,2022-05-08,2022,ARI,COL,4,0,4-0,ARI,9,1,34,33,67,115,133,248,12,6,18,1,2:44
18733,661550,2022-05-08,2022,ATL,MIL,9,2,9-2,ATL,9,1,39,34,73,142,149,291,16,9,25,0,2:52
18734,661627,2022-05-08,2022,PHI,NYN,1,6,6-1,NYN,9,0,35,41,76,171,147,318,7,14,21,2,3:15
18735,663069,2022-05-08,2022,CIN,PIT,7,3,7-3,CIN,9,1,37,33,70,155,160,315,12,6,18,1,3:01
18736,662160,2022-05-08,2022,SEA,TBA,2,1,2-1,SEA,10,0,38,35,73,146,119,265,12,8,20,0,3:04
18737,663429,2022-05-08,2022,ANA,WAS,5,4,5-4,ANA,9,0,40,39,79,156,165,321,15,14,29,2,3:26
18738,661345,2022-05-08,2022,BAL,KCA,4,2,4-2,BAL,9,1,37,33,70,110,155,265,13,7,20,1,2:43
18739,663161,2022-05-08,2022,CHN,LAN,1,7,7-1,LAN,9,0,33,40,73,152,130,282,7,14,21,0,2:57
18740,661700,2022-05-08,2022,MIN,OAK,4,3,4-3,MIN,9,1,33,36,69,158,136,294,10,10,20,2,3:19
18741,663366,2022-05-09,2022,ARI,MIA,4,3,4-3,ARI,9,1,34,35,69,123,126,249,10,10,20,3,2:50
18742,662837,2022-05-09,2022,DET,OAK,0,2,2-0,OAK,9,0,32,34,66,125,130,255,6,8,14,2,2:49
18743,661349,2022-05-09,2022,BAL,KCA,6,1,6-1,BAL,9,1,36,37,73,148,134,282,13,10,23,2,2:53
18744,661349,2022-05-09,2022,BAL,KCA,6,1,6-1,BAL,9,1,36,37,73,148,134,282,13,10,23,2,2:53
18745,662259,2022-05-09,2022,SDN,CHN,0,6,6-0,CHN,9,0,30,38,68,159,123,282,4,13,17,1,2:59
18746,662097,2022-05-09,2022,SFN,COL,8,5,8-5,SFN,9,1,39,38,77,163,160,323,16,13,29,1,3:15
18747,662158,2022-05-09,2022,SEA,PHI,0,9,9-0,PHI,9,0,34,46,80,161,139,300,8,19,27,1,3:01
18748,663101,2022-05-09,2022,CIN,MIL,10,5,10-5,CIN,9,1,40,37,77,159,166,325,17,10,27,4,3:18
18749,661303,2022-05-09,2022,NYA,TEX,1,0,1-0,NYA,9,1,31,32,63,127,136,263,9,6,15,2,2:41
18750,663438,2022-05-09,2022,ANA,TBA,11,3,11-3,ANA,9,1,38,40,78,142,147,289,14,12,26,2,3:02
18751,661525,2022-05-09,2022,CHA,CLE,9,12,12-9,CLE,11,0,51,51,102,186,192,378,16,16,32,2,4:13
18752,661303,2022-05-09,2022,NYA,TEX,1,0,1-0,NYA,9,1,31,32,63,127,136,263,9,6,15,2,2:41
18753,662287,2022-05-09,2022,PIT,LAN,5,1,5-1,PIT,9,1,37,37,74,143,110,253,15,10,25,2,2:41
18754,663416,2022-05-10,2022,ANA,TBA,12,0,12-0,ANA,9,1,43,28,71,108,138,246,19,1,20,0,2:19
18755,661524,2022-05-10,2022,CHA,CLE,4,1,4-1,CHA,9,1,33,35,68,123,118,241,9,10,19,2,2:43
18756,662412,2022-05-10,2022,OAK,DET,0,6,6-0,DET,9,0,32,41,73,155,115,270,7,16,23,1,2:56
18757,661696,2022-05-10,2022,MIN,HOU,0,5,5-0,HOU,9,0,29,45,74,180,110,290,5,17,22,3,3:10
18758,661987,2022-05-10,2022,SLN,BAL,3,5,5-3,BAL,9,0,32,40,72,143,123,266,8,14,22,3,2:53
18759,662258,2022-05-10,2022,SDN,CHN,5,4,5-4,SDN,9,1,38,41,79,172,122,294,16,14,30,2,3:08
18760,662016,2022-05-10,2022,TEX,KCA,6,4,6-4,TEX,9,1,37,36,73,147,143,290,13,8,21,2,3:01
18761,662537,2022-05-10,2022,WAS,NYN,2,4,4-2,NYN,9,0,32,43,75,170,115,285,9,16,25,2,3:08
18762,662855,2022-05-10,2022,DET,OAK,1,4,4-1,OAK,9,0,38,36,74,136,147,283,11,10,21,1,2:59
18763,662292,2022-05-10,2022,PIT,LAN,1,11,11-1,LAN,9,0,37,44,81,167,145,312,11,18,29,1,3:02
18764,662157,2022-05-10,2022,SEA,PHI,5,4,5-4,SEA,9,1,40,35,75,171,157,328,15,8,23,3,3:36
18765,663090,2022-05-10,2022,CIN,MIL,4,5,5-4,MIL,9,0,39,43,82,174,167,341,13,17,30,4,3:50
18766,663350,2022-05-10,2022,ARI,MIA,9,3,9-3,ARI,9,1,39,38,77,144,178,322,17,10,27,2,3:17
18767,661301,2022-05-10,2022,NYA,TOR,6,5,6-5,NYA,9,0,38,38,76,178,157,335,13,12,25,5,3:39
18768,662096,2022-05-10,2022,SFN,COL,9,2,9-2,SFN,9,1,42,38,80,159,175,334,18,12,30,3,3:10
18769,661549,2022-05-10,2022,ATL,BOS,4,9,9-4,BOS,9,0,38,45,83,183,174,357,11,18,29,1,3:47
18770,661300,2022-05-11,2022,NYA,TOR,5,3,5-3,NYA,9,1,33,39,72,136,127,263,9,12,21,4,2:50
18771,663358,2022-05-11,2022,ARI,MIA,3,11,11-3,MIA,9,0,34,43,77,168,124,292,7,18,25,2,2:58
18772,662176,2022-05-11,2022,SEA,PHI,2,4,4-2,PHI,9,0,37,35,72,144,144,288,10,10,20,3,3:11
18773,661548,2022-05-11,2022,ATL,BOS,5,3,5-3,ATL,9,0,35,37,72,163,125,288,10,11,21,3,3:11
18774,662526,2022-05-11,2022,WAS,NYN,8,3,8-3,WAS,9,1,38,37,75,134,150,284,15,10,25,3,3:05
18775,662095,2022-05-11,2022,SFN,COL,7,1,7-1,SFN,9,1,42,32,74,132,176,308,16,6,22,3,3:14
18776,662006,2022-05-11,2022,SLN,BAL,10,1,10-1,SLN,9,1,40,33,73,132,169,301,16,6,22,1,2:58
18777,662385,2022-05-11,2022,PIT,LAN,5,3,5-3,PIT,9,1,39,37,76,154,163,317,15,10,25,3,3:20
18778,662873,2022-05-11,2022,DET,OAK,0,9,9-0,OAK,9,0,33,43,76,177,126,303,7,18,25,1,3:04
18779,663074,2022-05-11,2022,CIN,MIL,14,11,14-11,CIN,9,1,44,45,89,162,148,310,21,19,40,3,3:26
18780,661702,2022-05-11,2022,MIN,HOU,3,11,11-3,HOU,9,0,42,45,87,173,163,336,14,18,32,1,3:33 (1:21 delay)
18781,662273,2022-05-11,2022,SDN,CHN,5,7,7-5,CHN,9,0,43,37,80,147,167,314,16,12,28,0,3:26
18782,663450,2022-05-11,2022,ANA,TBA,2,4,4-2,TBA,10,0,37,38,75,151,156,307,8,8,16,1,3:17
18783,661702,2022-05-11,2022,MIN,HOU,3,11,11-3,HOU,9,0,42,45,87,173,163,336,14,18,32,1,3:33 (1:21 delay)
18784,661899,2022-05-11,2022,TEX,KCA,2,8,8-2,KCA,9,0,32,42,74,148,113,261,7,13,20,2,2:55
18785,662548,2022-05-12,2022,WAS,NYN,1,4,4-1,NYN,9,0,30,36,66,158,119,277,5,11,16,1,2:45
18786,662372,2022-05-12,2022,PIT,CIN,0,4,4-0,CIN,9,0,31,39,70,152,124,276,8,12,20,2,2:52
18787,662872,2022-05-12,2022,DET,OAK,3,5,5-3,OAK,9,0,35,35,70,143,131,274,9,9,18,0,2:57
18788,661694,2022-05-12,2022,MIN,HOU,0,5,5-0,HOU,9,0,36,41,77,160,143,303,9,15,24,2,3:20
18789,662706,2022-05-12,2022,LAN,PHI,7,9,9-7,PHI,9,0,44,40,84,140,172,312,17,13,30,2,3:29
18790,661883,2022-05-12,2022,TEX,KCA,3,1,3-1,TEX,9,1,35,37,72,128,135,263,11,10,21,2,2:52
18791,662005,2022-05-12,2022,SLN,BAL,2,3,3-2,BAL,9,0,34,35,69,128,160,288,10,8,18,3,3:05
18792,661519,2022-05-12,2022,CHA,NYA,7,15,15-7,NYA,9,0,40,48,88,211,152,363,12,22,34,2,3:56
18793,662381,2022-05-13,2022,OAK,ANA,0,2,2-0,ANA,9,0,30,33,63,126,120,246,4,6,10,0,2:30
18794,661882,2022-05-13,2022,TEX,BOS,1,7,7-1,BOS,9,0,33,40,73,145,120,265,6,14,20,1,2:46
18795,663349,2022-05-13,2022,ARI,CHN,4,3,4-3,ARI,9,1,37,35,72,142,129,271,14,9,23,3,2:56
18796,661491,2022-05-13,2022,CHA,NYA,4,10,10-4,NYA,9,0,37,44,81,162,133,295,10,18,28,1,3:21
18797,661361,2022-05-13,2022,MIA,MIL,1,2,2-1,MIL,9,0,30,36,66,147,114,261,5,8,13,1,2:53
18798,661986,2022-05-13,2022,SLN,SFN,2,8,8-2,SFN,9,0,35,43,78,154,138,292,10,17,27,2,3:06
18799,661698,2022-05-13,2022,MIN,CLE,12,8,12-8,MIN,9,1,41,44,85,168,161,329,19,16,35,4,3:26
18800,663012,2022-05-13,2022,COL,KCA,10,14,14-10,KCA,9,0,45,48,93,153,190,343,17,21,38,6,3:53
18801,661904,2022-05-13,2022,TBA,TOR,5,2,5-2,TBA,9,1,33,33,66,128,119,247,9,7,16,4,2:49
18802,662705,2022-05-13,2022,LAN,PHI,10,12,12-10,PHI,10,0,48,51,99,190,185,375,19,23,42,4,4:18
18803,662494,2022-05-13,2022,PIT,CIN,2,8,8-2,CIN,9,0,36,40,76,149,160,309,9,14,23,1,3:02
18804,662525,2022-05-13,2022,WAS,HOU,1,6,6-1,HOU,9,0,36,36,72,134,120,254,10,10,20,1,2:45
18805,662523,2022-05-13,2022,NYN,SEA,1,2,2-1,SEA,9,0,35,35,70,137,140,277,8,10,18,1,2:56
18806,662851,2022-05-13,2022,DET,BAL,4,2,4-2,DET,9,1,32,43,75,169,117,286,9,17,26,4,3:10
18807,661547,2022-05-13,2022,ATL,SDN,6,11,11-6,SDN,9,0,42,47,89,164,170,334,16,20,36,3,3:42
18808,662704,2022-05-14,2022,LAN,PHI,3,8,8-3,PHI,9,0,36,36,72,122,137,259,9,10,19,0,2:38
18809,663011,2022-05-14,2022,COL,KCA,10,4,10-4,COL,9,1,38,33,71,124,145,269,15,6,21,1,2:39
18810,661985,2022-05-14,2022,SLN,SFN,4,0,4-0,SLN,9,1,34,37,71,148,134,282,10,12,22,2,3:05
18811,661903,2022-05-14,2022,TBA,TOR,1,5,5-1,TOR,9,0,35,39,74,143,142,285,9,11,20,2,3:03
18812,661546,2022-05-14,2022,ATL,SDN,6,5,6-5,ATL,9,1,34,35,69,134,128,262,12,6,18,3,2:55
18813,661490,2022-05-14,2022,CHA,NYA,3,2,3-2,CHA,9,0,39,37,76,142,150,292,15,13,28,2,3:27
18814,662379,2022-05-14,2022,OAK,ANA,4,3,4-3,OAK,9,0,34,41,75,143,144,287,12,16,28,5,3:18
18815,662568,2022-05-14,2022,NYN,SEA,5,4,5-4,NYN,9,1,34,41,75,173,137,310,8,16,24,2,3:30 (1:08 delay)
18816,661147,2022-05-14,2022,TEX,BOS,3,11,11-3,BOS,9,0,35,46,81,174,132,306,8,18,26,2,3:23
18817,662844,2022-05-14,2022,DET,BAL,3,0,3-0,DET,9,1,30,31,61,133,99,232,8,6,14,2,2:29
18818,661695,2022-05-14,2022,MIN,CLE,2,3,3-2,CLE,10,0,43,37,80,150,177,327,14,9,23,2,3:31
18819,662547,2022-05-14,2022,WAS,HOU,13,6,13-6,WAS,9,1,43,43,86,164,172,336,19,17,36,2,3:27
18820,663348,2022-05-14,2022,ARI,CHN,2,4,4-2,CHN,9,0,39,35,74,158,160,318,12,8,20,3,3:22
18821,662399,2022-05-14,2022,OAK,ANA,1,9,9-1,ANA,9,0,32,41,73,165,128,293,9,15,24,0,2:47
18822,662384,2022-05-14,2022,PIT,CIN,3,1,3-1,PIT,9,1,29,34,63,142,139,281,7,8,15,1,2:54
18823,661414,2022-05-14,2022,MIA,MIL,9,3,9-3,MIA,9,1,41,35,76,150,170,320,15,9,24,2,3:30
18824,661902,2022-05-15,2022,TBA,TOR,3,0,3-0,TBA,9,1,32,31,63,128,106,234,7,6,13,2,2:47
18825,662519,2022-05-15,2022,PIT,CIN,1,0,1-0,PIT,9,1,30,32,62,126,127,253,6,6,12,1,2:34
18826,661732,2022-05-15,2022,MIN,CLE,3,1,3-1,MIN,9,1,30,33,63,137,114,251,6,6,12,1,2:38
18827,661146,2022-05-15,2022,TEX,BOS,7,1,7-1,TEX,9,1,33,37,70,154,128,282,9,10,19,1,2:57
18828,663367,2022-05-15,2022,ARI,CHN,2,3,3-2,CHN,9,0,34,37,71,155,122,277,8,10,18,4,3:05
18829,662380,2022-05-15,2022,OAK,ANA,1,4,4-1,ANA,9,0,38,37,75,152,145,297,11,11,22,3,3:29
18830,662843,2022-05-15,2022,DET,BAL,5,1,5-1,DET,9,1,36,33,69,148,135,283,15,6,21,2,3:00
18831,662696,2022-05-15,2022,LAN,PHI,5,4,5-4,LAN,9,0,36,41,77,156,146,302,13,15,28,1,3:33
18832,662567,2022-05-15,2022,NYN,SEA,7,8,8-7,SEA,9,0,40,42,82,163,151,314,15,17,32,3,3:22
18833,661984,2022-05-15,2022,SLN,SFN,15,6,15-6,SLN,9,1,48,37,85,148,166,314,24,11,35,2,3:05
18834,661403,2022-05-15,2022,MIA,MIL,3,7,7-3,MIL,9,0,36,43,79,175,149,324,7,16,23,1,3:33
18835,661545,2022-05-15,2022,ATL,SDN,3,7,7-3,SDN,11,0,42,44,86,157,170,327,9,11,20,1,3:33
18836,662528,2022-05-15,2022,WAS,HOU,0,8,8-0,HOU,9,0,34,40,74,130,161,291,8,14,22,1,3:07
18837,663010,2022-05-15,2022,COL,KCA,7,8,8-7,KCA,9,0,42,41,83,147,182,329,15,16,31,4,3:23
18838,661489,2022-05-15,2022,CHA,NYA,1,5,5-1,NYA,9,0,31,34,65,149,114,263,4,7,11,0,2:32
18839,661212,2022-05-16,2022,MIL,ATL,1,0,1-0,MIL,9,1,31,30,61,133,129,262,7,3,10,0,2:31
18840,663151,2022-05-16,2022,CHN,PIT,9,0,9-0,CHN,9,1,41,30,71,112,150,262,17,3,20,1,2:29
18841,661961,2022-05-16,2022,TBA,DET,2,3,3-2,DET,9,0,34,35,69,127,135,262,9,8,17,2,2:43
18842,661145,2022-05-16,2022,TEX,ANA,7,4,7-4,TEX,9,1,37,37,74,124,142,266,11,11,22,2,2:51
18843,663275,2022-05-16,2022,BOS,HOU,6,3,6-3,BOS,9,1,34,38,72,143,121,264,11,12,23,3,3:07 (1:38 delay)
18844,661402,2022-05-16,2022,MIA,WAS,8,2,8-2,MIA,9,1,39,36,75,115,156,271,20,8,28,2,3:01
18845,662695,2022-05-16,2022,LAN,ARI,5,4,5-4,LAN,9,1,38,35,73,133,152,285,16,8,24,0,2:56
18846,662378,2022-05-16,2022,OAK,MIN,1,3,3-1,MIN,9,0,32,38,70,152,132,284,6,11,17,1,2:54
18847,662728,2022-05-16,2022,KCA,CHA,3,5,5-3,CHA,10,0,36,42,78,157,135,292,8,12,20,1,3:05
18848,661308,2022-05-16,2022,BAL,NYA,2,6,6-2,NYA,9,0,32,42,74,162,147,309,6,16,22,1,2:59
18849,663005,2022-05-16,2022,COL,SFN,6,7,7-6,SFN,9,0,42,40,82,159,163,322,16,12,28,3,3:23
18850,661794,2022-05-16,2022,TOR,SEA,6,2,6-2,TOR,9,1,39,38,77,160,156,316,16,10,26,3,3:23
18851,663157,2022-05-17,2022,CHN,PIT,7,0,7-0,CHN,9,1,35,31,66,113,128,241,11,7,18,2,2:38
18852,661765,2022-05-17,2022,TOR,SEA,3,0,3-0,TOR,9,1,34,32,66,117,123,240,11,8,19,1,2:20
18853,662053,2022-05-17,2022,TBA,DET,8,1,8-1,TBA,9,1,37,33,70,122,126,248,13,7,20,2,2:38
18854,661625,2022-05-17,2022,PHI,SDN,0,3,3-0,SDN,9,0,32,37,69,142,127,269,5,10,15,1,2:53
18855,662697,2022-05-17,2022,LAN,ARI,12,3,12-3,LAN,9,1,41,36,77,118,143,261,18,11,29,0,2:45
18856,662727,2022-05-17,2022,KCA,CHA,2,1,2-1,KCA,9,1,33,32,65,125,146,271,10,7,17,0,2:35
18857,662507,2022-05-17,2022,NYN,SLN,3,1,3-1,NYN,9,1,34,36,70,152,136,288,9,9,18,1,2:54
18858,661401,2022-05-17,2022,MIA,WAS,5,1,5-1,MIA,9,1,36,36,72,147,146,293,12,11,23,6,3:28
18859,662370,2022-05-17,2022,OAK,MIN,5,2,5-2,OAK,9,1,39,37,76,156,148,304,16,10,26,3,3:20
18860,661342,2022-05-17,2022,BAL,NYA,4,5,5-4,NYA,9,0,37,43,80,145,138,283,10,17,27,2,3:06
18861,661196,2022-05-17,2022,MIL,ATL,0,3,3-0,ATL,9,0,37,38,75,171,136,307,11,11,22,2,3:14
18862,662780,2022-05-17,2022,KCA,CHA,0,3,3-0,CHA,9,0,39,37,76,144,158,302,13,12,25,1,3:10
18863,663271,2022-05-17,2022,BOS,HOU,4,13,13-4,HOU,9,0,44,45,89,131,166,297,16,17,33,1,3:12
18864,663032,2022-05-17,2022,CLE,CIN,4,5,5-4,CIN,10,0,39,42,81,168,147,315,9,17,26,1,3:22
18865,662566,2022-05-17,2022,NYN,SLN,3,4,4-3,SLN,9,0,39,43,82,155,176,331,11,17,28,3,3:42
18866,662566,2022-05-17,2022,NYN,SLN,3,4,4-3,SLN,9,0,39,43,82,155,176,331,11,17,28,3,3:42
18867,661126,2022-05-17,2022,TEX,ANA,10,5,10-5,TEX,9,1,39,42,81,179,168,347,17,16,33,5,3:58
18868,663004,2022-05-17,2022,COL,SFN,7,10,10-7,SFN,9,0,40,49,89,200,148,348,15,21,36,1,3:40
18869,662628,2022-05-17,2022,LAN,ARI,7,6,7-6,LAN,9,1,34,39,73,182,139,321,11,12,23,4,3:10
18870,663270,2022-05-18,2022,BOS,HOU,5,1,5-1,BOS,9,1,33,29,62,112,128,240,8,2,10,0,2:38
18871,661624,2022-05-18,2022,PHI,SDN,3,0,3-0,PHI,9,1,32,30,62,116,140,256,8,4,12,1,2:44
18872,661344,2022-05-18,2022,BAL,NYA,2,3,3-2,NYA,9,0,33,34,67,139,120,259,7,7,14,1,2:34
18873,663003,2022-05-18,2022,COL,SFN,5,3,5-3,COL,9,1,34,38,72,147,117,264,10,11,21,2,2:42
18874,662054,2022-05-18,2022,TBA,DET,6,1,6-1,TBA,9,1,35,32,67,142,145,287,14,6,20,1,2:55
18875,661767,2022-05-18,2022,TOR,SEA,1,5,5-1,SEA,9,0,35,38,73,143,134,277,11,12,23,1,2:47
18876,662744,2022-05-18,2022,LAN,ARI,5,3,5-3,LAN,9,1,33,38,71,158,132,290,9,12,21,2,3:01
18877,661125,2022-05-18,2022,TEX,ANA,6,5,6-5,TEX,10,0,43,41,84,141,162,303,17,11,28,1,3:23
18878,663156,2022-05-18,2022,CHN,PIT,2,3,3-2,PIT,9,0,36,37,73,159,149,308,10,11,21,2,3:02
18879,662726,2022-05-18,2022,KCA,CHA,6,2,6-2,KCA,9,1,37,38,75,154,141,295,14,11,25,1,3:11
18880,662554,2022-05-18,2022,NYN,SLN,11,4,11-4,NYN,9,1,42,38,80,146,164,310,19,12,31,2,3:29
18881,661400,2022-05-18,2022,MIA,WAS,4,5,5-4,WAS,10,0,41,44,85,177,153,330,11,16,27,1,3:56
18882,662377,2022-05-18,2022,OAK,MIN,4,14,14-4,MIN,9,0,40,50,90,187,139,326,13,25,38,1,3:25
18883,661202,2022-05-18,2022,MIL,ATL,7,6,7-6,MIL,11,0,44,45,89,170,172,342,16,13,29,1,4:03
18884,662778,2022-05-19,2022,HOU,TEX,5,1,5-1,HOU,9,1,38,35,73,125,147,272,17,8,25,1,3:10
18885,663043,2022-05-19,2022,CLE,CIN,2,4,4-2,CIN,9,0,34,33,67,133,149,282,8,9,17,3,2:48
18886,663193,2022-05-19,2022,CHN,ARI,1,3,3-1,ARI,9,0,37,34,71,133,151,284,9,7,16,3,3:10
18887,661623,2022-05-19,2022,PHI,SDN,0,2,2-0,SDN,9,0,35,38,73,154,156,310,9,11,20,3,3:31
18888,662520,2022-05-19,2022,NYN,SLN,7,6,7-6,NYN,10,0,40,44,84,151,152,303,14,16,30,2,3:41
18889,663269,2022-05-19,2022,BOS,SEA,12,6,12-6,BOS,9,1,44,41,85,168,158,326,21,14,35,4,3:38
18890,661347,2022-05-19,2022,BAL,NYA,9,6,9-6,BAL,9,0,40,40,80,167,166,333,14,16,30,5,4:01
18891,662715,2022-05-19,2022,KCA,CHA,4,7,7-4,CHA,9,0,38,45,83,182,152,334,12,20,32,2,3:47
18892,663043,2022-05-19,2022,CLE,CIN,2,4,4-2,CIN,9,0,34,33,67,133,149,282,8,9,17,3,2:48
18893,662764,2022-05-20,2022,HOU,TEX,0,3,3-0,TEX,9,0,32,34,66,136,108,244,9,8,17,2,2:57
18894,663135,2022-05-20,2022,CLE,DET,6,1,6-1,CLE,9,1,32,31,63,128,115,243,10,4,14,2,2:38
18895,661195,2022-05-20,2022,MIL,WAS,7,0,7-0,MIL,9,1,37,33,70,109,144,253,15,7,22,2,2:46
18896,661766,2022-05-20,2022,TOR,CIN,2,1,2-1,TOR,9,1,33,35,68,137,113,250,10,9,19,1,2:42
18897,663268,2022-05-20,2022,BOS,SEA,7,3,7-3,BOS,9,1,34,36,70,151,120,271,10,9,19,2,2:54
18898,663449,2022-05-20,2022,ANA,OAK,2,4,4-2,OAK,9,0,36,38,74,152,156,308,9,11,20,3,3:24
18899,662506,2022-05-20,2022,PIT,SLN,3,5,5-3,SLN,9,0,36,40,76,170,134,304,10,13,23,3,3:38
18900,663143,2022-05-20,2022,CHN,ARI,6,10,10-6,ARI,9,0,40,42,82,151,150,301,13,16,29,2,3:06
18901,661339,2022-05-20,2022,MIA,ATL,3,5,5-3,ATL,9,0,39,41,80,178,149,327,13,14,27,1,3:32
18902,661632,2022-05-20,2022,PHI,LAN,1,4,4-1,LAN,9,0,35,41,76,194,156,350,8,16,24,2,3:44
18903,662714,2022-05-20,2022,KCA,MIN,4,6,6-4,MIN,9,0,38,41,79,194,145,339,13,13,26,4,3:22
18904,662078,2022-05-20,2022,SFN,SDN,7,8,8-7,SDN,10,0,45,42,87,156,170,326,15,13,28,2,3:23
18905,661348,2022-05-20,2022,BAL,TBA,8,6,8-6,BAL,13,0,53,51,104,177,165,342,17,14,31,7,4:22
18906,661793,2022-05-21,2022,TOR,CIN,3,1,3-1,TOR,9,1,33,32,65,99,106,205,10,7,17,0,2:19
18907,662763,2022-05-21,2022,HOU,TEX,2,1,2-1,HOU,9,1,31,36,67,138,117,255,8,10,18,0,2:52
18908,661291,2022-05-21,2022,BAL,TBA,1,6,6-1,TBA,9,0,36,36,72,142,132,274,10,11,21,2,2:53
18909,663234,2022-05-21,2022,BOS,SEA,6,5,6-5,BOS,9,1,37,38,75,145,123,268,14,12,26,2,2:59
18910,663448,2022-05-21,2022,ANA,OAK,5,3,5-3,ANA,9,1,34,37,71,135,136,271,11,11,22,5,3:12
18911,663002,2022-05-21,2022,COL,NYN,1,5,5-1,NYN,9,0,37,42,79,145,137,282,10,15,25,1,2:55
18912,662077,2022-05-21,2022,SFN,SDN,1,2,2-1,SDN,9,0,35,40,75,148,130,278,9,13,22,1,3:05
18913,662713,2022-05-21,2022,KCA,MIN,2,9,9-2,MIN,9,0,37,41,78,140,136,276,10,15,25,2,2:54
18914,663002,2022-05-21,2022,COL,NYN,1,5,5-1,NYN,9,0,37,42,79,145,137,282,10,15,25,1,2:55
18915,663001,2022-05-21,2022,COL,NYN,11,3,11-3,COL,9,1,40,36,76,137,144,281,16,10,26,2,2:58
18916,661399,2022-05-21,2022,MIA,ATL,3,4,4-3,ATL,9,0,39,38,77,150,167,317,13,14,27,2,3:28
18917,661280,2022-05-21,2022,MIL,WAS,5,1,5-1,MIL,9,1,39,36,75,161,135,296,15,11,26,1,3:13
18918,661289,2022-05-21,2022,NYA,CHA,7,5,7-5,NYA,9,1,37,41,78,182,162,344,15,13,28,1,3:40
18919,662478,2022-05-21,2022,PIT,SLN,4,5,5-4,SLN,9,0,37,40,77,162,155,317,11,12,23,3,3:19
18920,663194,2022-05-21,2022,CHN,ARI,6,7,7-6,ARI,10,0,39,44,83,188,148,336,10,16,26,4,3:42 (1:35 delay)
18921,661631,2022-05-21,2022,PHI,LAN,4,7,7-4,LAN,9,0,35,43,78,177,150,327,9,18,27,8,3:57
18922,663447,2022-05-22,2022,ANA,OAK,4,1,4-1,ANA,9,1,38,32,70,113,129,242,14,5,19,1,2:49
18923,661290,2022-05-22,2022,NYA,CHA,0,5,5-0,CHA,9,0,32,41,73,136,120,256,5,15,20,1,2:51
18924,663150,2022-05-22,2022,CHN,ARI,5,4,5-4,CHN,9,1,37,36,73,130,144,274,14,10,24,1,2:43
18925,661290,2022-05-22,2022,NYA,CHA,0,5,5-0,CHA,9,0,32,41,73,136,120,256,5,15,20,1,2:51
18926,662857,2022-05-22,2022,HOU,TEX,5,2,5-2,HOU,9,1,36,37,73,133,146,279,13,11,24,3,3:10
18927,663120,2022-05-22,2022,CLE,DET,2,4,4-2,DET,9,0,34,35,69,130,134,264,11,9,20,2,2:46 (:20 delay)
18928,661763,2022-05-22,2022,TOR,CIN,2,3,3-2,CIN,9,0,36,37,73,161,133,294,8,11,19,5,3:17
18929,661288,2022-05-22,2022,NYA,CHA,1,3,3-1,CHA,9,0,36,37,73,138,146,284,12,10,22,2,3:09
18930,661398,2022-05-22,2022,MIA,ATL,4,3,4-3,MIA,9,1,37,35,72,115,136,251,13,8,21,1,2:42
18931,662982,2022-05-22,2022,COL,NYN,0,2,2-0,NYN,9,0,36,32,68,120,129,249,10,7,17,1,2:34
18932,663277,2022-05-22,2022,BOS,SEA,8,4,8-4,BOS,10,0,41,39,80,154,150,304,15,10,25,2,3:18
18933,662076,2022-05-22,2022,SFN,SDN,1,10,10-1,SDN,9,0,33,48,81,165,127,292,7,21,28,1,2:57
18934,661611,2022-05-22,2022,PHI,LAN,4,3,4-3,PHI,10,0,38,42,80,158,152,310,13,13,26,1,3:29
18935,662479,2022-05-22,2022,PIT,SLN,4,18,18-4,SLN,9,0,39,52,91,170,168,338,12,24,36,2,3:19 (:08 delay)
18936,662712,2022-05-22,2022,KCA,MIN,6,7,7-6,MIN,9,0,39,44,83,174,178,352,11,19,30,4,3:37
18937,661248,2022-05-22,2022,MIL,WAS,2,8,8-2,WAS,9,0,35,41,76,162,142,304,11,15,26,2,3:03
18938,661279,2022-05-22,2022,BAL,TBA,7,6,7-6,BAL,11,0,52,49,101,189,217,406,18,16,34,3,4:31 (:51 delay)
18939,661287,2022-05-23,2022,NYA,BAL,4,6,6-4,BAL,9,0,36,37,73,125,149,274,10,10,20,1,2:50
18940,662524,2022-05-23,2022,WAS,LAN,1,10,10-1,LAN,9,0,33,45,78,174,112,286,7,18,25,1,2:52
18941,661999,2022-05-23,2022,SLN,TOR,7,3,7-3,SLN,10,0,39,41,80,150,152,302,15,12,27,3,3:21
18942,663073,2022-05-23,2022,CIN,CHN,4,7,7-4,CHN,9,0,37,39,76,154,156,310,10,13,23,3,3:16
18943,663340,2022-05-23,2022,ARI,KCA,9,5,9-5,ARI,9,1,39,45,84,181,156,337,15,18,33,7,3:36
18944,661730,2022-05-23,2022,MIN,DET,5,4,5-4,MIN,9,0,35,40,75,153,132,285,11,13,24,1,2:55
18945,662075,2022-05-23,2022,SFN,NYN,3,13,13-3,NYN,9,0,35,45,80,142,143,285,9,19,28,1,2:51
18946,661544,2022-05-23,2022,ATL,PHI,3,7,7-3,PHI,9,0,37,44,81,187,153,340,12,18,30,4,3:37
18947,662257,2022-05-23,2022,SDN,MIL,3,2,3-2,SDN,10,0,43,41,84,174,182,356,17,13,30,0,3:54
18948,662858,2022-05-23,2022,HOU,CLE,1,6,6-1,CLE,9,0,32,41,73,154,128,282,6,13,19,2,3:02
18949,662455,2022-05-23,2022,PIT,COL,2,1,2-1,PIT,9,1,34,37,71,127,153,280,13,11,24,3,3:05
18950,662135,2022-05-23,2022,SEA,OAK,7,6,7-6,SEA,9,1,37,40,77,173,156,329,14,14,28,4,3:24
18951,663381,2022-05-24,2022,ANA,TEX,5,3,5-3,ANA,9,1,35,33,68,119,110,229,14,7,21,2,2:30
18952,661699,2022-05-24,2022,MIN,DET,2,0,2-0,MIN,9,1,34,33,67,121,163,284,12,7,19,0,2:53
18953,661978,2022-05-24,2022,TBA,MIA,4,0,4-0,TBA,9,1,34,32,66,150,106,256,11,8,19,0,2:26
18954,662134,2022-05-24,2022,SEA,OAK,5,7,7-5,OAK,9,0,40,41,81,143,144,287,14,15,29,3,3:25
18955,662229,2022-05-24,2022,SDN,MIL,1,4,4-1,MIL,9,0,35,34,69,149,149,298,10,7,17,1,3:14
18956,662536,2022-05-24,2022,WAS,LAN,4,9,9-4,LAN,9,0,40,44,84,185,146,331,14,17,31,1,3:19
18957,662454,2022-05-24,2022,PIT,COL,1,2,2-1,COL,10,0,39,39,78,150,158,308,9,9,18,2,3:21
18958,661543,2022-05-24,2022,ATL,PHI,6,5,6-5,ATL,9,0,38,41,79,162,176,338,16,15,31,1,3:58
18959,662846,2022-05-24,2022,HOU,CLE,7,3,7-3,HOU,9,1,35,35,70,134,126,260,11,8,19,1,2:45
18960,661998,2022-05-24,2022,SLN,TOR,1,8,8-1,TOR,9,0,37,47,84,182,166,348,9,20,29,2,3:30
18961,661285,2022-05-24,2022,NYA,BAL,7,6,7-6,NYA,11,0,45,41,86,153,163,316,17,8,25,4,3:36
18962,661488,2022-05-24,2022,CHA,BOS,3,16,16-3,BOS,9,0,37,51,88,204,152,356,10,24,34,2,3:41
18963,663339,2022-05-24,2022,ARI,KCA,8,6,8-6,ARI,9,1,38,37,75,150,154,304,17,12,29,2,3:09
18964,662074,2022-05-24,2022,SFN,NYN,13,12,13-12,SFN,9,0,50,47,97,168,193,361,25,20,45,4,3:50
18965,663103,2022-05-24,2022,CIN,CHN,4,11,11-4,CHN,9,0,38,48,86,168,156,324,11,20,31,1,3:12
18966,661487,2022-05-25,2022,CHA,BOS,3,1,3-1,CHA,9,1,32,40,72,155,122,277,8,14,22,2,2:58 (:30 delay)
18967,662845,2022-05-25,2022,HOU,CLE,2,1,2-1,HOU,9,1,33,34,67,152,122,274,11,7,18,2,3:00
18968,662052,2022-05-25,2022,TBA,MIA,5,4,5-4,TBA,9,1,33,38,71,159,129,288,10,13,23,0,3:05
18969,662527,2022-05-25,2022,WAS,LAN,1,0,1-0,WAS,9,1,30,36,66,149,113,262,9,11,20,0,2:53
18970,661772,2022-05-25,2022,MIN,DET,2,4,4-2,DET,10,0,41,43,84,170,175,345,10,14,24,4,3:45 (:56 delay)
18971,663082,2022-05-25,2022,CIN,CHN,4,3,4-3,CIN,9,1,33,37,70,175,123,298,9,10,19,0,3:04
18972,662093,2022-05-25,2022,SFN,NYN,9,3,9-3,SFN,9,1,35,36,71,144,135,279,13,9,22,2,2:44
18973,662133,2022-05-25,2022,SEA,OAK,2,4,4-2,OAK,9,0,35,37,72,141,143,284,12,11,23,1,3:10
18974,662228,2022-05-25,2022,SDN,MIL,1,2,2-1,MIL,9,0,36,32,68,146,141,287,8,8,16,2,3:05
18975,661286,2022-05-25,2022,NYA,BAL,2,0,2-0,NYA,9,1,30,36,66,150,124,274,6,8,14,1,3:07
18976,662453,2022-05-25,2022,PIT,COL,10,5,10-5,PIT,9,1,39,40,79,169,170,339,15,16,31,2,3:20
18977,663446,2022-05-25,2022,ANA,TEX,2,7,7-2,TEX,9,0,34,39,73,127,134,261,8,12,20,1,2:49
18978,661542,2022-05-25,2022,ATL,PHI,8,4,8-4,ATL,9,1,41,41,82,164,185,349,20,15,35,2,3:30
18979,661574,2022-05-26,2022,ATL,PHI,1,4,4-1,PHI,9,0,34,35,69,122,124,246,7,9,16,2,2:43
18980,662515,2022-05-26,2022,WAS,COL,7,3,7-3,WAS,9,1,38,36,74,113,133,246,14,10,24,1,2:40
18981,662051,2022-05-26,2022,TBA,NYA,2,7,7-2,NYA,9,0,34,39,73,150,124,274,7,12,19,3,2:49
18982,661771,2022-05-26,2022,MIN,KCA,2,3,3-2,KCA,9,0,41,35,76,127,164,291,14,9,23,2,3:05
18983,663081,2022-05-26,2022,CIN,CHN,20,5,20-5,CIN,9,1,49,38,87,136,167,303,28,11,39,1,3:10 (:59 delay)
18984,662842,2022-05-26,2022,DET,CLE,4,3,4-3,DET,9,0,39,35,74,135,158,293,14,9,23,1,2:52
18985,661997,2022-05-26,2022,SLN,MIL,3,4,4-3,MIL,9,0,41,40,81,155,169,324,14,13,27,0,3:21
18986,663445,2022-05-26,2022,ANA,TOR,3,6,6-3,TOR,9,0,36,36,72,146,129,275,11,10,21,0,2:56
18987,661486,2022-05-26,2022,CHA,BOS,7,16,16-7,BOS,9,0,42,51,93,218,178,396,15,24,39,3,4:02
18988,662376,2022-05-26,2022,OAK,TEX,1,4,4-1,TEX,9,0,34,36,70,131,123,254,8,9,17,1,2:44
18989,663338,2022-05-26,2022,ARI,LAN,1,14,14-1,LAN,9,0,36,54,90,198,143,341,10,28,38,1,3:21
18990,662132,2022-05-27,2022,SEA,HOU,6,1,6-1,SEA,9,1,37,37,74,144,119,263,13,11,24,0,2:45
18991,661960,2022-05-27,2022,TBA,NYA,0,2,2-0,NYA,9,0,28,34,62,124,108,232,2,7,9,1,2:23
18992,663080,2022-05-27,2022,CIN,SFN,5,1,5-1,CIN,9,1,38,35,73,134,158,292,14,10,24,3,3:16 (2:08 delay)
18993,663444,2022-05-27,2022,ANA,TOR,3,4,4-3,TOR,9,0,35,37,72,126,139,265,7,13,20,3,3:05
18994,661992,2022-05-27,2022,SLN,MIL,4,2,4-2,SLN,9,1,31,37,68,162,114,276,6,12,18,2,2:54
18995,663347,2022-05-27,2022,ARI,LAN,4,6,6-4,LAN,9,0,41,37,78,144,167,311,16,11,27,1,3:11
18996,662369,2022-05-27,2022,OAK,TEX,5,8,8-5,TEX,9,0,34,38,72,144,125,269,8,14,22,3,2:54
18997,661777,2022-05-27,2022,MIN,KCA,10,7,10-7,MIN,9,1,47,45,92,169,160,329,23,21,44,6,3:40
18998,662543,2022-05-27,2022,NYN,PHI,8,6,8-6,NYN,9,1,38,40,78,146,167,313,16,13,29,3,3:41
18999,663276,2022-05-27,2022,BOS,BAL,8,12,12-8,BAL,9,0,46,45,91,158,168,326,20,19,39,6,3:38
19000,661539,2022-05-27,2022,ATL,MIA,6,4,6-4,ATL,9,1,33,35,68,144,145,289,9,8,17,3,3:02
19001,662281,2022-05-27,2022,SDN,PIT,4,3,4-3,SDN,9,1,34,34,68,125,149,274,12,7,19,1,2:56
19002,663257,2022-05-28,2022,BOS,BAL,5,3,5-3,BOS,9,1,39,33,72,108,170,278,16,8,24,2,2:58
19003,661518,2022-05-28,2022,CHA,CHN,1,5,5-1,CHN,9,0,35,39,74,130,139,269,10,16,26,2,3:03
19004,661991,2022-05-28,2022,SLN,MIL,8,3,8-3,SLN,9,1,37,37,74,152,119,271,13,10,23,0,2:45
19005,663309,2022-05-28,2022,BOS,BAL,2,4,4-2,BAL,9,0,37,38,75,137,137,274,10,11,21,3,3:09
19006,663330,2022-05-28,2022,ARI,LAN,2,3,3-2,LAN,9,0,33,36,69,139,137,276,6,13,19,2,3:12
19007,662852,2022-05-28,2022,DET,CLE,1,8,8-1,CLE,9,0,36,42,78,158,114,272,11,15,26,1,2:50
19008,661933,2022-05-28,2022,TBA,NYA,3,1,3-1,TBA,9,1,33,29,62,125,132,257,10,4,14,1,2:47
19009,662556,2022-05-28,2022,NYN,PHI,8,2,8-2,NYN,9,1,36,38,74,138,140,278,14,11,25,2,3:09
19010,663400,2022-05-28,2022,ANA,TOR,5,6,6-5,TOR,9,0,45,41,86,163,161,324,20,16,36,4,3:45
19011,663118,2022-05-28,2022,CIN,SFN,3,2,3-2,CIN,9,1,30,40,70,157,132,289,6,14,20,2,3:00
19012,661774,2022-05-28,2022,MIN,KCA,3,7,7-3,KCA,9,0,41,42,83,163,150,313,14,14,28,3,3:12
19013,661537,2022-05-28,2022,ATL,MIA,1,4,4-1,MIA,9,0,31,40,71,155,131,286,7,14,21,0,2:48
19014,662280,2022-05-28,2022,SDN,PIT,2,4,4-2,PIT,9,0,45,40,85,155,189,344,18,13,31,1,3:43
19015,662513,2022-05-28,2022,WAS,COL,2,3,3-2,COL,9,0,36,41,77,133,134,267,9,14,23,1,2:53
19016,662131,2022-05-28,2022,SEA,HOU,6,0,6-0,SEA,9,1,43,34,77,136,152,288,18,7,25,1,3:01
19017,662514,2022-05-28,2022,WAS,COL,13,7,13-7,WAS,9,1,45,41,86,168,186,354,22,14,36,3,3:37
19018,662375,2022-05-28,2022,OAK,TEX,4,11,11-4,TEX,9,0,39,49,88,180,139,319,12,24,36,2,3:15
19019,662514,2022-05-28,2022,WAS,COL,13,7,13-7,WAS,9,1,45,41,86,168,186,354,22,14,36,3,3:37
19020,662130,2022-05-29,2022,SEA,HOU,1,2,2-1,HOU,9,0,35,35,70,125,128,253,9,10,19,2,3:00
19021,663328,2022-05-29,2022,ARI,LAN,1,3,3-1,LAN,9,0,37,32,69,123,131,254,11,6,17,1,2:47
19022,662279,2022-05-29,2022,SDN,PIT,4,2,4-2,SDN,10,0,35,37,72,124,132,256,10,9,19,0,2:50
19023,661910,2022-05-29,2022,TBA,NYA,4,2,4-2,TBA,9,1,31,36,67,133,131,264,7,9,16,1,2:35
19024,661990,2022-05-29,2022,SLN,MIL,0,8,8-0,MIL,9,0,32,40,72,167,122,289,5,15,20,2,2:48
19025,661731,2022-05-29,2022,MIN,KCA,7,3,7-3,MIN,9,1,38,35,73,134,149,283,15,8,23,1,3:05
19026,663072,2022-05-29,2022,CIN,SFN,4,6,6-4,SFN,9,0,36,39,75,163,127,290,12,12,24,3,3:10
19027,661517,2022-05-29,2022,ATL,MIA,6,3,6-3,ATL,9,1,35,38,73,153,151,304,11,12,23,0,3:09
19028,662840,2022-05-29,2022,DET,CLE,2,1,2-1,DET,9,1,29,35,64,146,91,237,5,8,13,2,2:37
19029,662512,2022-05-29,2022,WAS,COL,6,5,6-5,WAS,9,1,37,40,77,162,138,300,13,14,27,2,3:13
19030,663299,2022-05-29,2022,BOS,BAL,12,2,12-2,BOS,9,1,43,36,79,139,191,330,20,12,32,1,3:27
19031,662374,2022-05-29,2022,OAK,TEX,6,5,6-5,OAK,9,0,48,39,87,132,177,309,22,11,33,4,3:38
19032,662555,2022-05-29,2022,NYN,PHI,5,4,5-4,NYN,10,0,41,40,81,171,144,315,14,12,26,3,3:51
19033,661461,2022-05-29,2022,CHA,CHN,5,4,5-4,CHA,12,0,48,46,94,177,162,339,13,11,24,0,3:54
19034,663414,2022-05-29,2022,ANA,TOR,10,11,11-10,TOR,9,0,44,48,92,199,190,389,17,22,39,7,4:13
19035,663147,2022-05-30,2022,CHN,MIL,1,3,3-1,MIL,9,0,33,37,70,157,131,288,8,9,17,1,2:52
19036,663327,2022-05-30,2022,ARI,ATL,6,2,6-2,ARI,9,1,34,37,71,133,132,265,10,10,20,2,2:53
19037,662373,2022-05-30,2022,OAK,HOU,1,5,5-1,HOU,9,0,30,38,68,148,114,262,5,10,15,2,2:58
19038,661613,2022-05-30,2022,PHI,SFN,4,5,5-4,SFN,10,0,34,39,73,159,125,284,5,10,15,1,3:13
19039,663147,2022-05-30,2022,CHN,MIL,1,3,3-1,MIL,9,0,33,37,70,157,131,288,8,9,17,1,2:52
19040,663109,2022-05-30,2022,CLE,KCA,7,3,7-3,CLE,9,1,38,38,76,135,132,267,14,13,27,2,2:49
19041,662854,2022-05-30,2022,DET,MIN,7,5,7-5,DET,9,1,40,38,78,142,145,287,16,12,28,2,3:04
19042,662743,2022-05-30,2022,LAN,PIT,5,6,6-5,PIT,9,0,40,39,79,149,171,320,13,12,25,1,3:18
19043,662992,2022-05-30,2022,COL,MIA,7,1,7-1,COL,9,1,37,33,70,118,156,274,15,6,21,1,2:56
19044,663149,2022-05-30,2022,CHN,MIL,6,7,7-6,MIL,9,0,44,36,80,147,172,319,17,10,27,1,3:17
19045,662545,2022-05-30,2022,NYN,WAS,13,5,13-5,NYN,9,1,43,40,83,143,180,323,20,16,36,3,3:29
19046,661989,2022-05-30,2022,SLN,SDN,6,3,6-3,SLN,9,1,38,39,77,154,140,294,16,13,29,5,3:33
19047,661900,2022-05-30,2022,TEX,TBA,9,5,9-5,TEX,9,1,40,41,81,152,156,308,17,15,32,2,3:21
19048,663298,2022-05-30,2022,BOS,BAL,0,10,10-0,BAL,9,0,32,42,74,162,123,285,5,17,22,1,3:05
19049,661884,2022-05-31,2022,TEX,TBA,3,0,3-0,TEX,9,1,33,30,63,106,114,220,10,3,13,1,2:21
19050,662836,2022-05-31,2022,DET,MIN,4,0,4-0,DET,9,1,34,32,66,112,140,252,10,5,15,0,2:29
19051,662735,2022-05-31,2022,LAN,PIT,3,5,5-3,PIT,9,0,38,40,78,136,159,295,12,14,26,2,3:09
19052,661075,2022-05-31,2022,BAL,SEA,0,10,10-0,SEA,9,0,33,45,78,157,129,286,7,18,25,2,2:51
19053,663034,2022-05-31,2022,CLE,KCA,8,3,8-3,CLE,9,1,41,37,78,145,134,279,19,11,30,2,2:50
19054,662367,2022-05-31,2022,OAK,HOU,1,3,3-1,HOU,9,0,39,36,75,147,154,301,13,11,24,3,3:23
19055,662806,2022-05-31,2022,DET,MIN,2,8,8-2,MIN,9,0,35,40,75,161,134,295,8,11,19,1,2:46
19056,661331,2022-05-31,2022,NYA,ANA,9,1,9-1,NYA,9,1,38,36,74,129,149,278,16,10,26,2,2:54
19057,663329,2022-05-31,2022,ARI,ATL,8,7,8-7,ARI,10,0,42,42,84,139,169,308,19,17,36,4,3:35
19058,662544,2022-05-31,2022,NYN,WAS,10,0,10-0,NYN,9,1,44,35,79,139,182,321,21,10,31,2,3:31
19059,661977,2022-05-31,2022,SLN,SDN,3,2,3-2,SLN,10,0,40,37,77,175,158,333,13,8,21,0,3:37
19060,663154,2022-05-31,2022,CHN,MIL,8,7,8-7,CHN,9,1,41,40,81,177,174,351,18,13,31,2,3:33
19061,661797,2022-05-31,2022,TOR,CHA,6,5,6-5,TOR,9,1,39,41,80,162,157,319,15,16,31,2,3:24
19062,663297,2022-05-31,2022,BOS,CIN,1,2,2-1,CIN,9,0,33,37,70,148,145,293,7,10,17,4,3:04
19063,661618,2022-05-31,2022,PHI,SFN,4,7,7-4,SFN,11,0,49,49,98,208,183,391,19,18,37,6,4:52
19064,662991,2022-06-01,2022,COL,MIA,13,12,13-12,COL,10,0,49,51,100,184,203,387,24,22,46,5,4:14
19065,662833,2022-06-01,2022,DET,MIN,5,0,5-0,DET,9,1,32,30,62,124,106,230,9,3,12,0,2:13
19066,663296,2022-06-01,2022,BOS,CIN,7,1,7-1,BOS,9,1,36,31,67,106,143,249,13,7,20,2,2:40
19067,662457,2022-06-01,2022,NYN,WAS,5,0,5-0,NYN,9,1,37,38,75,150,125,275,14,12,26,3,3:02
19068,663031,2022-06-01,2022,CLE,KCA,4,0,4-0,CLE,9,1,38,36,74,142,144,286,13,9,22,0,2:48
19069,661982,2022-06-01,2022,SLN,SDN,5,2,5-2,SLN,9,1,32,36,68,155,101,256,10,9,19,2,2:43
19070,663326,2022-06-01,2022,ARI,ATL,0,6,6-0,ATL,9,0,34,43,77,177,129,306,8,16,24,1,2:59
19071,661343,2022-06-01,2022,BAL,SEA,9,2,9-2,BAL,9,1,37,36,73,129,160,289,16,11,27,2,3:07
19072,661612,2022-06-01,2022,PHI,SFN,6,5,6-5,PHI,9,1,36,33,69,128,148,276,11,6,17,1,3:02
19073,662366,2022-06-01,2022,OAK,HOU,4,5,5-4,HOU,9,0,33,42,75,154,123,277,7,17,24,4,3:07
19074,663184,2022-06-01,2022,CHN,MIL,4,3,4-3,CHN,10,0,37,38,75,156,134,290,12,10,22,0,3:03
19075,662981,2022-06-01,2022,COL,MIA,1,14,14-1,MIA,9,0,36,50,86,167,142,309,9,24,33,1,3:00
19076,661764,2022-06-01,2022,TOR,CHA,7,3,7-3,TOR,9,1,41,36,77,134,185,319,18,10,28,1,3:14
19077,662721,2022-06-01,2022,LAN,PIT,4,8,8-4,PIT,9,0,38,41,79,154,161,315,15,15,30,3,3:28
19078,661963,2022-06-01,2022,TEX,TBA,3,4,4-3,TBA,11,0,48,42,90,153,208,361,16,10,26,2,4:01
19079,662991,2022-06-01,2022,COL,MIA,13,12,13-12,COL,10,0,49,51,100,184,203,387,24,22,46,5,4:14
19080,662832,2022-06-02,2022,DET,MIN,3,2,3-2,DET,9,1,29,37,66,150,100,250,7,10,17,1,2:38
19081,662693,2022-06-02,2022,LAN,NYN,2,0,2-0,LAN,9,1,34,31,65,127,138,265,11,4,15,1,2:54
19082,661397,2022-06-02,2022,MIA,SFN,3,0,3-0,MIA,9,1,33,32,65,140,128,268,10,6,16,1,2:34
19083,663091,2022-06-02,2022,CIN,WAS,8,1,8-1,CIN,9,1,37,33,70,118,139,257,15,6,21,2,2:40
19084,661762,2022-06-02,2022,TOR,CHA,8,3,8-3,TOR,9,1,40,35,75,128,143,271,17,9,26,3,3:05
19085,661329,2022-06-02,2022,NYA,ANA,2,1,2-1,NYA,9,1,36,32,68,130,162,292,13,5,18,3,3:08
19086,661330,2022-06-02,2022,NYA,ANA,6,1,6-1,NYA,9,1,38,38,76,147,145,292,16,12,28,2,3:07 (1:28 delay)
19087,661330,2022-06-02,2022,NYA,ANA,6,1,6-1,NYA,9,1,38,38,76,147,145,292,16,12,28,2,3:07 (1:28 delay)
19088,661934,2022-06-02,2022,TEX,TBA,1,3,3-1,TBA,9,0,34,41,75,168,119,287,8,16,24,2,3:04
19089,663000,2022-06-02,2022,COL,ATL,6,13,13-6,ATL,9,0,40,47,87,157,159,316,16,20,36,0,2:58
19090,663139,2022-06-02,2022,CHN,SLN,7,5,7-5,CHN,9,1,41,38,79,132,166,298,18,12,30,3,3:04
19091,661340,2022-06-02,2022,MIL,SDN,5,4,5-4,MIL,9,0,37,41,78,168,162,330,14,15,29,1,3:20
19092,661247,2022-06-02,2022,BAL,SEA,6,7,7-6,SEA,10,0,42,46,88,166,168,334,12,18,30,5,4:00
19093,661913,2022-06-03,2022,TEX,SEA,3,4,4-3,SEA,9,0,37,34,71,120,157,277,9,7,16,0,2:51
19094,662720,2022-06-03,2022,LAN,NYN,6,1,6-1,LAN,9,1,35,34,69,136,144,280,10,8,18,2,2:55
19095,661642,2022-06-03,2022,PHI,ANA,10,0,10-0,PHI,9,1,38,33,71,117,143,260,14,6,20,2,2:41
19096,661318,2022-06-03,2022,NYA,DET,13,0,13-0,NYA,9,1,41,30,71,126,139,265,21,3,24,1,2:39
19097,661058,2022-06-03,2022,BAL,CLE,3,6,6-3,CLE,9,0,34,40,74,132,135,267,7,14,21,3,2:52
19098,662692,2022-06-03,2022,KCA,HOU,3,10,10-3,HOU,9,0,35,42,77,140,136,276,8,18,26,2,2:48
19099,661761,2022-06-03,2022,TOR,MIN,3,9,9-3,MIN,9,0,34,39,73,160,144,304,7,14,21,3,3:02
19100,663119,2022-06-03,2022,CIN,WAS,5,8,8-5,WAS,9,0,38,42,80,155,140,295,11,14,25,3,3:09
19101,661334,2022-06-03,2022,MIL,SDN,0,7,7-0,SDN,9,0,32,45,77,180,128,308,5,16,21,2,3:03
19102,662365,2022-06-03,2022,OAK,BOS,2,7,7-2,BOS,9,0,36,43,79,157,150,307,10,20,30,5,3:15
19103,661897,2022-06-03,2022,TBA,CHA,6,3,6-3,TBA,9,1,35,41,76,164,137,301,12,14,26,3,3:09
19104,662980,2022-06-03,2022,COL,ATL,1,3,3-1,ATL,10,0,34,43,77,178,128,306,4,16,20,1,3:32
19105,662452,2022-06-03,2022,PIT,ARI,6,8,8-6,ARI,9,0,41,44,85,160,149,309,16,16,32,2,3:15
19106,661396,2022-06-03,2022,MIA,SFN,6,15,15-6,SFN,9,0,39,48,87,189,153,342,11,21,32,1,3:10
19107,663153,2022-06-03,2022,CHN,SLN,5,14,14-5,SLN,9,0,40,44,84,164,181,345,15,18,33,0,3:14
19108,661346,2022-06-04,2022,BAL,CLE,5,4,5-4,BAL,9,1,31,35,66,140,97,237,7,11,18,1,2:33
19109,661936,2022-06-04,2022,TEX,SEA,3,2,3-2,TEX,9,1,30,36,66,154,97,251,6,10,16,0,2:30
19110,662451,2022-06-04,2022,PIT,ARI,2,1,2-1,PIT,9,0,30,35,65,137,118,255,7,7,14,2,2:46
19111,661395,2022-06-04,2022,MIA,SFN,5,4,5-4,MIA,9,0,33,34,67,147,137,284,9,7,16,1,2:54
19112,661896,2022-06-04,2022,TBA,CHA,2,3,3-2,CHA,9,0,38,33,71,119,166,285,12,8,20,3,3:03
19113,662689,2022-06-04,2022,KCA,HOU,6,0,6-0,KCA,9,1,35,37,72,151,130,281,11,10,21,1,3:10 (:51 delay)
19114,661214,2022-06-04,2022,MIL,SDN,0,4,4-0,SDN,9,0,36,33,69,129,151,280,9,6,15,0,2:43
19115,661749,2022-06-04,2022,TOR,MIN,12,3,12-3,TOR,9,1,47,35,82,120,172,292,23,9,32,1,3:01
19116,661278,2022-06-04,2022,NYA,DET,3,0,3-0,NYA,9,1,31,28,59,111,129,240,7,2,9,1,2:28
19117,663179,2022-06-04,2022,CHN,SLN,6,1,6-1,CHN,9,1,41,36,77,160,154,314,18,9,27,1,3:05
19118,662687,2022-06-04,2022,LAN,NYN,4,9,9-4,NYN,9,0,38,41,79,154,182,336,11,15,26,5,3:33
19119,663102,2022-06-04,2022,CIN,WAS,8,10,10-8,WAS,9,0,41,46,87,189,170,359,14,19,33,2,3:44
19120,663152,2022-06-04,2022,CHN,SLN,4,7,7-4,SLN,10,0,45,45,90,191,172,363,18,17,35,3,4:11
19121,662987,2022-06-04,2022,COL,ATL,2,6,6-2,ATL,11,0,41,45,86,148,176,324,9,11,20,1,3:34
19122,662364,2022-06-04,2022,OAK,BOS,0,8,8-0,BOS,9,0,32,43,75,165,125,290,6,18,24,2,3:07
19123,661615,2022-06-04,2022,PHI,ANA,7,2,7-2,PHI,9,1,37,36,73,136,143,279,14,10,24,3,3:05
19124,662363,2022-06-05,2022,OAK,BOS,2,5,5-2,BOS,9,0,35,36,71,145,135,280,8,8,16,1,3:01
19125,662450,2022-06-05,2022,PIT,ARI,3,0,3-0,PIT,9,1,35,34,69,146,137,283,12,7,19,0,2:56
19126,663058,2022-06-05,2022,CIN,WAS,4,5,5-4,WAS,9,0,37,39,76,145,140,285,14,12,26,2,3:22
19127,661151,2022-06-05,2022,BAL,CLE,2,3,3-2,CLE,9,0,35,36,71,131,154,285,8,9,17,4,2:58
19128,661394,2022-06-05,2022,MIA,SFN,1,5,5-1,SFN,9,0,34,40,74,170,141,311,7,14,21,2,3:10
19129,661895,2022-06-05,2022,TBA,CHA,5,6,6-5,CHA,9,0,36,44,80,170,141,311,11,19,30,2,3:18
19130,661747,2022-06-05,2022,TOR,MIN,6,8,8-6,MIN,9,0,38,44,82,173,138,311,13,19,32,3,3:20
19131,662990,2022-06-05,2022,COL,ATL,7,8,8-7,ATL,9,0,43,43,86,171,165,336,16,15,31,2,3:33
19132,661277,2022-06-05,2022,NYA,DET,5,4,5-4,NYA,10,0,40,38,78,151,152,303,13,10,23,3,3:24
19133,662688,2022-06-05,2022,KCA,HOU,4,7,7-4,HOU,9,0,40,45,85,171,155,326,14,19,33,4,3:30
19134,661962,2022-06-05,2022,TEX,SEA,5,6,6-5,SEA,10,0,40,47,87,177,154,331,11,17,28,2,3:39
19135,663138,2022-06-05,2022,CHN,SLN,3,5,5-3,SLN,11,0,45,46,91,166,160,326,15,15,30,0,3:44
19136,662612,2022-06-05,2022,LAN,NYN,4,5,5-4,NYN,10,0,40,43,83,177,167,344,9,14,23,3,3:59
19137,661633,2022-06-05,2022,PHI,ANA,9,7,9-7,PHI,9,0,45,38,83,160,183,343,17,12,29,5,3:57
19138,661241,2022-06-05,2022,MIL,SDN,4,6,6-4,SDN,10,0,41,42,83,162,174,336,12,11,23,2,3:30
19139,663065,2022-06-06,2022,CIN,ARI,7,0,7-0,CIN,7,0,35,21,56,87,140,227,16,1,17,0,2:13 (:59 delay)
19140,663399,2022-06-06,2022,ANA,BOS,0,1,1-0,BOS,9,0,29,35,64,132,105,237,4,8,12,0,2:32
19141,662613,2022-06-06,2022,KCA,TOR,0,8,8-0,TOR,9,0,30,43,73,168,110,278,3,16,19,2,2:50 (2:05 delay)
19142,662762,2022-06-06,2022,HOU,SEA,4,7,7-4,SEA,9,0,40,42,82,181,154,335,15,14,29,4,3:46
19143,662278,2022-06-06,2022,SDN,NYN,5,11,11-5,NYN,9,0,35,47,82,189,140,329,9,21,30,3,3:43
19144,661516,2022-06-07,2022,ATL,OAK,3,2,3-2,ATL,9,1,33,31,64,113,120,233,10,5,15,1,2:19
19145,661460,2022-06-07,2022,CHA,LAN,4,0,4-0,CHA,9,1,34,33,67,146,117,263,11,8,19,2,2:49
19146,662761,2022-06-07,2022,HOU,SEA,4,1,4-1,HOU,9,1,35,37,72,144,139,283,12,11,23,2,3:19
19147,662449,2022-06-07,2022,PIT,DET,3,5,5-3,DET,9,0,33,39,72,156,111,267,8,13,21,2,2:50 (2:05 delay)
19148,663122,2022-06-07,2022,CLE,TEX,6,3,6-3,CLE,9,1,40,36,76,111,159,270,16,9,25,0,2:40 (1:19 delay)
19149,661205,2022-06-07,2022,MIL,PHI,2,3,3-2,PHI,9,0,36,38,74,141,140,281,10,12,22,0,3:00
19150,662678,2022-06-07,2022,KCA,TOR,0,7,7-0,TOR,9,0,35,41,76,157,137,294,10,18,28,2,3:09
19151,662277,2022-06-07,2022,SDN,NYN,7,0,7-0,SDN,9,1,37,31,68,118,144,262,12,5,17,1,2:48
19152,661894,2022-06-07,2022,TBA,SLN,4,2,4-2,TBA,10,0,35,42,77,154,138,292,6,13,19,0,3:13
19153,661169,2022-06-07,2022,MIA,WAS,12,2,12-2,MIA,9,1,42,38,80,145,145,290,18,11,29,2,2:57
19154,662092,2022-06-07,2022,SFN,COL,3,5,5-3,COL,9,0,37,38,75,176,148,324,10,10,20,1,3:13
19155,663134,2022-06-07,2022,CLE,TEX,3,6,6-3,TEX,9,0,36,44,80,176,139,315,9,17,26,1,3:10
19156,663134,2022-06-07,2022,CLE,TEX,3,6,6-3,TEX,9,0,36,44,80,176,139,315,9,17,26,1,3:10
19157,663064,2022-06-07,2022,CIN,ARI,14,8,14-8,CIN,9,1,46,38,84,140,174,314,22,12,34,3,3:12 (1:03 delay)
19158,663391,2022-06-07,2022,ANA,BOS,5,6,6-5,BOS,10,0,42,45,87,170,167,337,13,17,30,1,3:56
19159,661170,2022-06-07,2022,BAL,CHN,9,3,9-3,BAL,9,1,35,41,76,172,123,295,13,14,27,1,2:53
19160,661693,2022-06-07,2022,MIN,NYA,4,10,10-4,NYA,9,0,40,50,90,219,155,374,14,24,38,4,3:50
19161,661459,2022-06-08,2022,CHA,LAN,1,4,4-1,LAN,9,0,33,34,67,133,125,258,6,7,13,0,2:36
19162,661188,2022-06-08,2022,MIL,PHI,0,10,10-0,PHI,9,0,31,41,72,147,113,260,5,15,20,0,2:50
19163,662094,2022-06-08,2022,SFN,COL,2,1,2-1,SFN,10,0,37,35,72,134,145,279,10,6,16,0,2:49
19164,661150,2022-06-08,2022,MIA,WAS,2,1,2-1,MIA,10,0,40,37,77,119,177,296,12,7,19,1,3:29
19165,663398,2022-06-08,2022,ANA,BOS,0,1,1-0,BOS,9,0,34,38,72,157,129,286,8,11,19,3,3:09
19166,662223,2022-06-08,2022,SDN,NYN,13,2,13-2,SDN,9,1,44,34,78,123,169,292,20,8,28,1,2:58
19167,662448,2022-06-08,2022,PIT,DET,1,3,3-1,DET,9,0,33,37,70,157,144,301,7,11,18,1,2:57
19168,663055,2022-06-08,2022,CLE,TEX,4,0,4-0,CLE,9,1,35,31,66,100,119,219,12,6,18,1,2:07 (2:07 delay)
19169,661681,2022-06-08,2022,MIN,NYA,8,1,8-1,MIN,9,1,37,33,70,126,157,283,14,9,23,2,3:00
19170,662760,2022-06-08,2022,HOU,SEA,3,6,6-3,SEA,9,0,36,43,79,164,148,312,11,18,29,2,3:09
19171,663050,2022-06-08,2022,CIN,ARI,0,7,7-0,ARI,9,0,35,44,79,189,134,323,9,18,27,2,3:18 (1:40 delay)
19172,661892,2022-06-08,2022,TBA,SLN,11,3,11-3,TBA,9,1,47,35,82,130,173,303,22,9,31,3,3:11
19173,662679,2022-06-08,2022,KCA,TOR,8,4,8-4,KCA,9,1,43,40,83,171,179,350,20,13,33,3,3:26
19174,661515,2022-06-08,2022,ATL,OAK,13,2,13-2,ATL,9,1,40,35,75,122,153,275,16,10,26,2,2:47
19175,661891,2022-06-09,2022,TBA,SLN,2,1,2-1,TBA,9,1,26,32,58,111,85,196,3,4,7,0,1:54
19176,661514,2022-06-09,2022,ATL,PIT,3,1,3-1,ATL,9,1,32,33,65,134,109,243,9,8,17,0,2:26
19177,661149,2022-06-09,2022,MIA,WAS,7,4,7-4,MIA,9,1,36,39,75,148,136,284,14,13,27,3,3:09
19178,662091,2022-06-09,2022,SFN,COL,2,4,4-2,COL,9,0,35,39,74,145,143,288,9,12,21,1,2:56
19179,663413,2022-06-09,2022,ANA,BOS,5,2,5-2,ANA,9,1,36,35,71,130,149,279,12,8,20,1,3:09
19180,663015,2022-06-09,2022,CLE,OAK,8,4,8-4,CLE,9,1,40,38,78,147,151,298,18,13,31,5,3:23
19181,663049,2022-06-09,2022,CIN,ARI,4,5,5-4,ARI,9,0,37,43,80,167,144,311,10,17,27,1,3:29
19182,662677,2022-06-09,2022,KCA,BAL,7,5,7-5,KCA,9,1,38,43,81,178,143,321,14,16,30,4,3:17
19183,661697,2022-06-09,2022,MIN,NYA,7,10,10-7,NYA,9,0,39,45,84,169,155,324,13,19,32,4,3:32
19184,661194,2022-06-09,2022,MIL,PHI,3,8,8-3,PHI,9,0,42,43,85,211,189,400,15,16,31,1,4:01
19185,661458,2022-06-09,2022,CHA,LAN,9,11,11-9,LAN,9,0,44,46,90,206,195,401,17,20,37,3,4:13
19186,661513,2022-06-10,2022,ATL,PIT,4,2,4-2,ATL,9,1,36,36,72,147,121,268,14,9,23,4,3:04
19187,662090,2022-06-10,2022,SFN,LAN,7,2,7-2,SFN,9,1,34,35,69,143,124,267,12,8,20,1,2:45
19188,662676,2022-06-10,2022,KCA,BAL,8,1,8-1,KCA,9,1,37,33,70,143,128,271,13,6,19,2,2:55
19189,661617,2022-06-10,2022,PHI,ARI,7,5,7-5,PHI,9,1,35,38,73,154,152,306,13,11,24,4,3:24
19190,662831,2022-06-10,2022,DET,TOR,1,10,10-1,TOR,9,0,32,45,77,176,114,290,6,18,24,1,2:50 (:26 delay)
19191,663390,2022-06-10,2022,ANA,NYN,3,7,7-3,NYN,9,0,37,40,77,141,151,292,12,17,29,4,3:21
19192,662275,2022-06-10,2022,SDN,COL,9,0,9-0,SDN,9,1,44,33,77,139,175,314,22,7,29,1,3:04
19193,662511,2022-06-10,2022,WAS,MIL,11,5,11-5,WAS,9,1,44,37,81,156,164,320,21,11,32,2,3:15
19194,661983,2022-06-10,2022,SLN,CIN,2,0,2-0,SLN,9,1,33,35,68,144,127,271,9,9,18,1,2:47
19195,662759,2022-06-10,2022,HOU,MIA,4,7,7-4,MIA,9,0,42,37,79,157,167,324,16,10,26,5,3:49
19196,661485,2022-06-10,2022,CHA,TEX,8,3,8-3,CHA,9,1,37,34,71,145,136,281,15,7,22,2,2:59
19197,663014,2022-06-10,2022,CLE,OAK,3,2,3-2,CLE,9,0,36,36,72,139,120,259,11,8,19,1,2:50
19198,661678,2022-06-10,2022,MIN,TBA,9,4,9-4,MIN,9,1,41,35,76,149,137,286,16,9,25,2,2:58
19199,661284,2022-06-10,2022,NYA,CHN,2,1,2-1,NYA,13,0,53,49,102,185,185,370,19,14,33,0,4:16
19200,662129,2022-06-10,2022,SEA,BOS,3,4,4-3,BOS,9,0,42,39,81,179,186,365,15,13,28,3,3:48
19201,661276,2022-06-11,2022,NYA,CHN,8,0,8-0,NYA,9,1,36,35,71,125,138,263,12,7,19,0,2:48
19202,661160,2022-06-11,2022,ATL,PIT,10,4,10-4,ATL,9,1,37,35,72,146,120,266,13,9,22,2,2:42
19203,662510,2022-06-11,2022,WAS,MIL,8,6,8-6,WAS,9,1,36,42,78,150,135,285,14,15,29,2,3:02
19204,662674,2022-06-11,2022,KCA,BAL,4,6,6-4,BAL,9,0,38,38,76,143,133,276,12,13,25,2,3:03
19205,662830,2022-06-11,2022,DET,TOR,3,1,3-1,DET,9,1,34,38,72,141,121,262,12,11,23,2,2:51
19206,662756,2022-06-11,2022,HOU,MIA,1,5,5-1,MIA,9,0,37,38,75,142,138,280,10,11,21,1,3:12
19207,662251,2022-06-11,2022,SDN,COL,2,1,2-1,SDN,10,0,32,39,71,136,136,272,4,11,15,1,3:03
19208,661614,2022-06-11,2022,PHI,ARI,4,0,4-0,PHI,9,1,34,34,68,148,138,286,11,7,18,1,2:56
19209,663412,2022-06-11,2022,ANA,NYN,11,6,11-6,ANA,9,1,42,41,83,145,154,299,19,12,31,4,3:21
19210,662128,2022-06-11,2022,SEA,BOS,7,6,7-6,SEA,9,0,44,36,80,146,179,325,19,9,28,3,3:37
19211,661680,2022-06-11,2022,MIN,TBA,6,5,6-5,MIN,9,1,37,38,75,170,149,319,16,13,29,2,3:30
19212,662089,2022-06-11,2022,SFN,LAN,3,2,3-2,SFN,9,1,35,43,78,166,146,312,10,16,26,4,3:32
19213,661976,2022-06-11,2022,SLN,CIN,5,4,5-4,SLN,9,0,37,40,77,137,173,310,14,14,28,2,3:10
19214,662222,2022-06-11,2022,SDN,COL,2,6,6-2,COL,9,0,34,43,77,173,146,319,7,14,21,2,3:20
19215,661484,2022-06-11,2022,CHA,TEX,9,11,11-9,TEX,10,0,49,49,98,184,187,371,18,21,39,3,4:03
19216,663084,2022-06-11,2022,CLE,OAK,5,10,10-5,OAK,9,0,36,42,78,150,134,284,10,15,25,3,3:08
19217,663083,2022-06-12,2022,CLE,OAK,6,3,6-3,CLE,9,1,35,37,72,137,118,255,12,11,23,1,2:31
19218,662085,2022-06-12,2022,SFN,LAN,2,0,2-0,SFN,9,1,31,36,67,144,121,265,7,9,16,1,2:56
19219,662829,2022-06-12,2022,DET,TOR,0,6,6-0,TOR,9,0,28,39,67,153,120,273,2,16,18,0,2:43
19220,661144,2022-06-12,2022,ATL,PIT,5,3,5-3,ATL,9,1,34,34,68,114,146,260,10,9,19,0,2:48
19221,662127,2022-06-12,2022,SEA,BOS,0,2,2-0,BOS,9,0,33,34,67,131,128,259,6,8,14,1,2:52
19222,662256,2022-06-12,2022,SDN,COL,2,4,4-2,COL,9,0,31,38,69,139,122,261,7,11,18,0,2:41
19223,662758,2022-06-12,2022,HOU,MIA,9,4,9-4,HOU,9,1,41,33,74,113,177,290,19,4,23,3,3:21
19224,663397,2022-06-12,2022,ANA,NYN,1,4,4-1,NYN,9,0,34,42,76,146,147,293,9,16,25,2,3:11
19225,661975,2022-06-12,2022,SLN,CIN,6,7,7-6,CIN,9,0,43,35,78,119,171,290,14,14,28,2,3:12
19226,661679,2022-06-12,2022,MIN,TBA,0,6,6-0,TBA,9,0,35,40,75,160,168,328,9,12,21,2,3:17
19227,662673,2022-06-12,2022,KCA,BAL,7,10,10-7,BAL,9,0,43,48,91,190,164,354,15,22,37,6,3:42
19228,661622,2022-06-12,2022,PHI,ARI,1,13,13-1,ARI,9,0,38,50,88,210,158,368,12,24,36,4,3:50
19229,661270,2022-06-12,2022,NYA,CHN,18,4,18-4,NYA,9,1,48,38,86,154,192,346,24,13,37,2,3:23
19230,662542,2022-06-12,2022,WAS,MIL,1,4,4-1,MIL,9,0,38,35,73,149,144,293,12,9,21,2,3:11
19231,661483,2022-06-12,2022,CHA,TEX,6,8,8-6,TEX,12,0,50,52,102,202,179,381,18,16,34,2,4:17
19232,663183,2022-06-13,2022,CHN,SDN,1,4,4-1,SDN,9,0,33,37,70,116,122,238,6,11,17,1,2:45 (1:25 delay)
19233,661629,2022-06-13,2022,PHI,MIA,3,2,3-2,PHI,9,0,38,33,71,126,135,261,13,6,19,1,2:59
19234,661974,2022-06-13,2022,SLN,PIT,7,5,7-5,SLN,9,1,39,36,75,143,150,293,15,9,24,4,3:07
19235,662069,2022-06-13,2022,SFN,KCA,6,2,6-2,SFN,9,1,38,33,71,113,164,277,15,7,22,1,2:48
19236,662126,2022-06-13,2022,SEA,MIN,2,3,3-2,MIN,9,0,37,40,77,140,137,277,10,13,23,2,3:10
19237,661746,2022-06-13,2022,TOR,BAL,11,1,11-1,TOR,9,1,42,36,78,126,166,292,20,8,28,4,3:17
19238,663345,2022-06-13,2022,ARI,CIN,4,5,5-4,CIN,9,0,39,39,78,159,149,308,12,14,26,3,3:20
19239,662828,2022-06-13,2022,DET,CHA,5,9,9-5,CHA,9,0,41,44,85,167,163,330,15,18,33,3,3:20
19240,662505,2022-06-13,2022,WAS,ATL,5,9,9-5,ATL,9,0,40,42,82,170,143,313,15,16,31,2,3:15 (1:33 delay)
19241,661881,2022-06-13,2022,TEX,HOU,5,3,5-3,TEX,9,1,39,36,75,134,143,277,15,10,25,3,3:18
19242,662018,2022-06-14,2022,SLN,PIT,3,1,3-1,SLN,9,1,38,35,73,137,150,287,11,10,21,2,2:56
19243,661880,2022-06-14,2022,TEX,HOU,3,4,4-3,HOU,9,0,34,37,71,132,117,249,9,10,19,1,2:40
19244,662441,2022-06-14,2022,NYN,MIL,4,0,4-0,NYN,9,1,34,29,63,125,144,269,11,4,15,1,2:39
19245,662125,2022-06-14,2022,SEA,MIN,5,0,5-0,SEA,9,1,33,32,65,137,122,259,9,6,15,1,2:36
19246,661328,2022-06-14,2022,NYA,TBA,2,0,2-0,NYA,9,1,34,35,69,142,137,279,9,9,18,1,3:03
19247,662068,2022-06-14,2022,SFN,KCA,4,2,4-2,SFN,9,1,33,36,69,152,143,295,10,12,22,2,3:00
19248,663279,2022-06-14,2022,BOS,OAK,6,1,6-1,BOS,9,1,39,32,71,116,157,273,16,7,23,0,2:43
19249,661745,2022-06-14,2022,TOR,BAL,5,6,6-5,BAL,9,0,40,39,79,142,154,296,13,13,26,4,3:12
19250,662018,2022-06-14,2022,SLN,PIT,3,1,3-1,SLN,9,1,38,35,73,137,150,287,11,10,21,2,2:56
19251,662611,2022-06-14,2022,LAN,ANA,2,0,2-0,LAN,9,1,32,33,65,130,130,260,8,6,14,2,2:58
19252,662935,2022-06-14,2022,COL,CLE,3,4,4-3,CLE,10,0,40,42,82,145,151,296,12,14,26,1,3:02
19253,662884,2022-06-14,2022,DET,CHA,1,5,5-1,CHA,9,0,37,42,79,158,163,321,10,16,26,0,3:20
19254,663182,2022-06-14,2022,CHN,SDN,5,12,12-5,SDN,9,0,36,49,85,174,110,284,11,21,32,5,3:13
19255,661616,2022-06-14,2022,PHI,MIA,9,11,11-9,MIA,9,0,45,42,87,156,187,343,19,15,34,4,3:54
19256,661973,2022-06-14,2022,SLN,PIT,9,1,9-1,SLN,9,1,41,30,71,132,147,279,18,3,21,1,2:48
19257,662503,2022-06-14,2022,WAS,ATL,4,10,10-4,ATL,9,0,35,45,80,166,153,319,8,18,26,1,3:14
19258,663342,2022-06-14,2022,ARI,CIN,3,5,5-3,CIN,12,0,42,48,90,172,159,331,6,16,22,0,3:41
19259,661583,2022-06-15,2022,PHI,MIA,3,1,3-1,PHI,9,0,36,32,68,103,152,255,12,7,19,2,3:12
19260,661845,2022-06-15,2022,TEX,HOU,2,9,9-2,HOU,9,0,33,39,72,136,135,271,6,13,19,1,2:45
19261,661744,2022-06-15,2022,TOR,BAL,7,6,7-6,TOR,10,0,39,37,76,128,131,259,13,7,20,2,2:53
19262,661972,2022-06-15,2022,SLN,PIT,4,6,6-4,PIT,9,0,40,37,77,142,158,300,14,12,26,4,3:14
19263,662173,2022-06-15,2022,SEA,MIN,0,5,5-0,MIN,9,0,34,38,72,149,124,273,8,12,20,3,3:00
19264,662694,2022-06-15,2022,LAN,ANA,4,1,4-1,LAN,9,1,33,33,66,134,148,282,9,6,15,2,2:50
19265,662082,2022-06-15,2022,SFN,KCA,2,3,3-2,KCA,9,0,38,32,70,118,178,296,11,5,16,2,2:52
19266,662893,2022-06-15,2022,COL,CLE,5,7,7-5,CLE,9,0,39,41,80,148,132,280,13,14,27,4,3:02
19267,661327,2022-06-15,2022,NYA,TBA,4,3,4-3,NYA,9,1,28,38,66,155,122,277,6,11,17,2,2:58
19268,662480,2022-06-15,2022,NYN,MIL,2,10,10-2,MIL,9,0,34,44,78,162,152,314,9,21,30,2,3:11
19269,663235,2022-06-15,2022,BOS,OAK,10,1,10-1,BOS,9,1,44,34,78,131,181,312,20,8,28,1,3:08
19270,663155,2022-06-15,2022,CHN,SDN,5,19,19-5,SDN,9,0,44,55,99,208,167,375,17,30,47,4,3:46
19271,662504,2022-06-15,2022,WAS,ATL,2,8,8-2,ATL,9,0,36,46,82,189,162,351,8,20,28,4,3:27
19272,663336,2022-06-15,2022,ARI,CIN,7,4,7-4,ARI,9,1,36,35,71,137,132,269,10,9,19,1,2:50
19273,662883,2022-06-15,2022,DET,CHA,0,13,13-0,CHA,9,0,32,51,83,189,109,298,4,27,31,2,2:51
19274,662172,2022-06-16,2022,SEA,ANA,1,4,4-1,ANA,9,0,34,38,72,137,136,273,7,11,18,1,2:53
19275,662827,2022-06-16,2022,DET,TEX,1,3,3-1,TEX,9,0,36,35,71,148,115,263,9,10,19,0,2:50
19276,661326,2022-06-16,2022,NYA,TBA,2,1,2-1,NYA,9,0,30,31,61,134,112,246,7,5,12,3,2:38
19277,661743,2022-06-16,2022,TOR,BAL,2,10,10-2,BAL,9,0,36,43,79,140,131,271,9,15,24,2,2:58
19278,663267,2022-06-16,2022,BOS,OAK,3,4,4-3,OAK,9,0,43,36,79,117,157,274,16,7,23,4,3:15
19279,663125,2022-06-16,2022,CHN,SDN,4,6,6-4,SDN,9,0,36,43,79,164,136,300,8,17,25,2,3:03
19280,662535,2022-06-16,2022,NYN,MIL,5,4,5-4,NYN,9,1,37,37,74,169,143,312,13,12,25,2,3:26
19281,662501,2022-06-16,2022,WAS,PHI,1,10,10-1,PHI,9,0,33,44,77,172,126,298,7,16,23,1,3:02
19282,662986,2022-06-16,2022,COL,CLE,2,4,4-2,CLE,9,0,39,37,76,136,129,265,13,10,23,2,2:50
19283,662985,2022-06-17,2022,COL,SDN,10,4,10-4,COL,9,1,40,35,75,112,152,264,18,11,29,1,2:55
19284,663124,2022-06-17,2022,CHN,ATL,1,0,1-0,CHN,9,1,29,35,64,145,116,261,6,8,14,1,2:40
19285,662171,2022-06-17,2022,SEA,ANA,8,1,8-1,SEA,9,1,37,33,70,124,140,264,15,6,21,1,2:37
19286,662534,2022-06-17,2022,NYN,MIA,10,4,10-4,NYN,9,1,40,43,83,161,129,290,16,16,32,3,3:23
19287,663063,2022-06-17,2022,CIN,MIL,4,5,5-4,MIL,9,0,35,36,71,154,126,280,10,10,20,2,2:53
19288,662719,2022-06-17,2022,LAN,CLE,1,2,2-1,CLE,10,0,41,38,79,138,166,304,11,9,20,3,3:20
19289,662757,2022-06-17,2022,HOU,CHA,13,3,13-3,HOU,9,1,40,34,74,123,144,267,17,8,25,2,2:55
19290,662826,2022-06-17,2022,DET,TEX,0,7,7-0,TEX,9,0,31,43,74,175,127,302,5,16,21,1,3:01
19291,663335,2022-06-17,2022,ARI,MIN,7,2,7-2,ARI,9,1,38,37,75,135,138,273,13,11,24,1,2:40
19292,662580,2022-06-17,2022,WAS,PHI,3,5,5-3,PHI,9,0,38,43,81,180,146,326,13,16,29,2,3:32
19293,662362,2022-06-17,2022,OAK,KCA,1,5,5-1,KCA,9,0,37,42,79,165,169,334,10,16,26,2,3:28
19294,663256,2022-06-17,2022,BOS,SLN,6,5,6-5,BOS,9,1,35,39,74,157,133,290,13,14,27,5,3:05
19295,661093,2022-06-17,2022,BAL,TBA,1,0,1-0,BAL,9,1,32,33,65,135,118,253,8,9,17,3,2:49
19296,662502,2022-06-17,2022,WAS,PHI,7,8,8-7,PHI,10,0,45,42,87,176,165,341,16,13,29,2,3:45
19297,662437,2022-06-17,2022,PIT,SFN,0,2,2-0,SFN,9,0,30,34,64,163,109,272,4,11,15,1,2:46
19298,661742,2022-06-17,2022,TOR,NYA,3,12,12-3,NYA,9,0,36,46,82,183,148,331,9,21,30,3,3:21
19299,661748,2022-06-18,2022,TOR,NYA,0,4,4-0,NYA,9,0,34,38,72,151,136,287,8,12,20,4,3:05
19300,662686,2022-06-18,2022,LAN,CLE,7,1,7-1,LAN,9,1,42,32,74,128,168,296,17,4,21,2,2:57
19301,662368,2022-06-18,2022,OAK,KCA,0,2,2-0,KCA,9,0,31,40,71,158,120,278,5,13,18,4,2:46
19302,662752,2022-06-18,2022,HOU,CHA,0,7,7-0,CHA,9,0,30,42,72,163,122,285,5,14,19,1,2:51
19303,662170,2022-06-18,2022,SEA,ANA,0,3,3-0,ANA,9,0,35,35,70,137,142,279,8,8,16,1,2:57
19304,661127,2022-06-18,2022,BAL,TBA,6,7,7-6,TBA,9,0,41,43,84,159,182,341,13,17,30,4,3:51
19305,663239,2022-06-18,2022,CHN,ATL,6,3,6-3,CHN,9,1,38,38,76,152,127,279,15,12,27,1,2:55
19306,662802,2022-06-18,2022,DET,TEX,14,7,14-7,DET,9,1,45,36,81,143,174,317,22,11,33,1,2:57
19307,663255,2022-06-18,2022,BOS,SLN,2,11,11-2,SLN,9,0,36,47,83,205,157,362,10,20,30,1,3:28
19308,662533,2022-06-18,2022,NYN,MIA,3,2,3-2,NYN,9,1,33,32,65,143,131,274,9,5,14,3,2:51
19309,662999,2022-06-18,2022,COL,SDN,5,4,5-4,COL,9,1,35,40,75,136,116,252,11,14,25,0,2:42
19310,663351,2022-06-18,2022,ARI,MIN,1,11,11-1,MIN,9,0,31,46,77,179,117,296,4,19,23,1,2:40
19311,661123,2022-06-18,2022,PIT,SFN,5,7,7-5,SFN,9,0,39,46,85,194,167,361,13,20,33,4,3:53
19312,663062,2022-06-18,2022,CIN,MIL,3,7,7-3,MIL,9,0,38,45,83,192,128,320,11,19,30,3,3:21
19313,662194,2022-06-18,2022,SEA,ANA,2,4,4-2,ANA,10,0,41,39,80,150,157,307,11,9,20,2,3:24
19314,662500,2022-06-18,2022,WAS,PHI,1,2,2-1,PHI,10,0,36,41,77,185,139,324,8,11,19,1,3:48
19315,662169,2022-06-19,2022,SEA,ANA,0,4,4-0,ANA,9,0,32,35,67,139,122,261,5,9,14,1,2:44
19316,663334,2022-06-19,2022,ARI,MIN,7,1,7-1,ARI,9,1,34,33,67,139,133,272,10,7,17,2,2:51
19317,661074,2022-06-19,2022,BAL,TBA,2,1,2-1,BAL,9,1,29,38,67,147,112,259,6,12,18,3,2:55
19318,662553,2022-06-19,2022,WAS,PHI,9,3,9-3,WAS,9,1,41,36,77,111,151,262,18,8,26,2,2:57
19319,663218,2022-06-19,2022,CHN,ATL,0,6,6-0,ATL,9,0,35,37,72,136,137,273,10,10,20,3,2:41
19320,663254,2022-06-19,2022,BOS,SLN,6,4,6-4,BOS,9,1,37,38,75,156,131,287,14,12,26,3,3:13
19321,662751,2022-06-19,2022,HOU,CHA,4,3,4-3,HOU,9,1,34,38,72,151,120,271,11,12,23,0,3:05
19322,661741,2022-06-19,2022,TOR,NYA,10,9,10-9,TOR,9,1,40,43,83,187,172,359,15,18,33,5,3:41
19323,663061,2022-06-19,2022,CIN,MIL,3,6,6-3,MIL,9,0,37,42,79,163,146,309,11,15,26,1,3:06
19324,662590,2022-06-19,2022,LAN,CLE,3,5,5-3,CLE,9,0,36,45,81,147,142,289,10,18,28,4,3:08
19325,662532,2022-06-19,2022,NYN,MIA,2,6,6-2,MIA,9,0,35,38,73,160,128,288,9,11,20,2,3:02
19326,661122,2022-06-19,2022,PIT,SFN,4,3,4-3,PIT,9,0,32,37,69,147,117,264,9,12,21,1,2:38
19327,662361,2022-06-19,2022,OAK,KCA,4,0,4-0,OAK,9,1,34,38,72,142,110,252,11,10,21,3,2:46
19328,662807,2022-06-19,2022,DET,TEX,7,3,7-3,DET,9,1,39,35,74,126,156,282,17,9,26,2,3:09
19329,662998,2022-06-19,2022,COL,SDN,8,3,8-3,COL,9,1,38,40,78,152,162,314,16,14,30,3,3:24
19330,663443,2022-06-20,2022,ANA,KCA,2,6,6-2,KCA,9,0,36,39,75,118,146,264,10,14,24,1,2:58
19331,661143,2022-06-20,2022,ATL,SFN,2,1,2-1,ATL,9,0,35,35,70,142,138,280,10,10,20,1,2:54
19332,661186,2022-06-20,2022,MIL,SLN,2,0,2-0,MIL,9,1,33,31,64,140,123,263,9,5,14,1,2:46
19333,663253,2022-06-20,2022,BOS,DET,5,2,5-2,BOS,9,1,36,36,72,134,143,277,11,11,22,3,2:55
19334,661893,2022-06-20,2022,TBA,NYA,2,4,4-2,NYA,9,0,36,36,72,155,159,314,8,9,17,1,3:12
19335,661482,2022-06-20,2022,CHA,TOR,8,7,8-7,CHA,9,1,37,38,75,157,128,285,15,10,25,1,2:55
19336,662522,2022-06-20,2022,NYN,MIA,6,0,6-0,NYN,9,1,39,37,76,153,159,312,14,12,26,1,3:20
19337,661121,2022-06-20,2022,PIT,CHN,12,1,12-1,PIT,9,1,42,41,83,167,160,327,18,15,33,2,3:17
19338,662221,2022-06-20,2022,SDN,ARI,4,1,4-1,SDN,9,1,32,36,68,131,123,254,9,9,18,0,2:36
19339,661890,2022-06-21,2022,TBA,NYA,5,4,5-4,TBA,9,1,33,36,69,140,116,256,9,10,19,3,2:42
19340,661198,2022-06-21,2022,BAL,WAS,0,3,3-0,WAS,9,0,33,37,70,128,143,271,5,9,14,1,2:46
19341,663246,2022-06-21,2022,BOS,DET,5,4,5-4,BOS,9,1,32,39,71,141,131,272,8,14,22,1,2:53
19342,661124,2022-06-21,2022,PIT,CHN,7,1,7-1,PIT,9,1,36,35,71,136,154,290,11,8,19,0,2:44
19343,663041,2022-06-21,2022,CIN,LAN,2,8,8-2,LAN,9,0,33,43,76,161,132,293,7,18,25,1,2:56
19344,661148,2022-06-21,2022,MIA,COL,9,8,9-8,MIA,9,1,41,45,86,176,149,325,15,18,33,3,3:42
19345,661846,2022-06-21,2022,TEX,PHI,7,0,7-0,TEX,9,1,33,35,68,134,136,270,12,9,21,2,3:06
19346,662248,2022-06-21,2022,SDN,ARI,3,2,3-2,SDN,11,0,43,42,85,168,175,343,13,10,23,3,3:55
19347,661142,2022-06-21,2022,ATL,SFN,10,12,12-10,SFN,9,0,42,44,86,172,150,322,15,20,35,4,3:28
19348,662750,2022-06-21,2022,HOU,NYN,8,2,8-2,HOU,9,1,38,37,75,157,152,309,17,9,26,0,3:02
19349,662360,2022-06-21,2022,OAK,SEA,2,8,8-2,SEA,9,0,34,44,78,160,130,290,8,21,29,2,3:03
19350,661192,2022-06-21,2022,MIL,SLN,2,6,6-2,SLN,9,0,36,38,74,148,153,301,10,13,23,2,3:13
19351,661677,2022-06-21,2022,MIN,CLE,5,6,6-5,CLE,11,0,44,46,90,183,168,351,12,16,28,1,3:46
19352,663442,2022-06-21,2022,ANA,KCA,11,12,12-11,KCA,11,0,49,51,100,205,198,403,16,21,37,4,4:14
19353,661481,2022-06-21,2022,CHA,TOR,7,6,7-6,CHA,12,0,53,51,104,224,200,424,22,16,38,1,4:23
19354,661246,2022-06-22,2022,BAL,WAS,7,0,7-0,BAL,6,0,31,25,56,107,131,238,13,8,21,1,2:32 (1:46 delay)
19355,663252,2022-06-22,2022,BOS,DET,6,2,6-2,BOS,9,1,36,35,71,131,156,287,12,8,20,1,3:03
19356,661457,2022-06-22,2022,CHA,TOR,5,9,9-5,TOR,9,0,41,40,81,144,161,305,15,14,29,2,3:07
19357,662245,2022-06-22,2022,SDN,ARI,10,4,10-4,SDN,9,1,44,43,87,160,177,337,20,12,32,1,3:33
19358,662749,2022-06-22,2022,HOU,NYN,5,3,5-3,HOU,9,1,35,37,72,148,125,273,11,11,22,4,3:15
19359,661393,2022-06-22,2022,MIA,COL,7,4,7-4,MIA,9,1,36,37,73,147,152,299,14,11,25,1,3:08
19360,661107,2022-06-22,2022,PIT,CHN,5,14,14-5,CHN,9,0,40,47,87,159,164,323,10,21,31,1,3:07
19361,663389,2022-06-22,2022,ANA,KCA,5,0,5-0,ANA,9,1,38,29,67,120,179,299,14,3,17,2,3:04 (:12 delay)
19362,661141,2022-06-22,2022,ATL,SFN,4,3,4-3,ATL,9,0,34,36,70,147,133,280,8,7,15,1,2:52
19363,661851,2022-06-22,2022,TEX,PHI,4,2,4-2,TEX,9,1,35,35,70,143,154,297,11,7,18,2,3:12
19364,661690,2022-06-22,2022,MIN,CLE,10,11,11-10,CLE,9,0,40,44,84,180,143,323,15,17,32,5,3:35
19365,661230,2022-06-22,2022,MIL,SLN,4,5,5-4,SLN,9,0,37,35,72,157,172,329,11,9,20,2,3:06
19366,663040,2022-06-22,2022,CIN,LAN,4,8,8-4,LAN,9,0,35,43,78,174,139,313,9,16,25,2,3:22
19367,662359,2022-06-22,2022,OAK,SEA,0,9,9-0,SEA,9,0,34,46,80,188,136,324,8,18,26,2,3:13
19368,661889,2022-06-22,2022,TBA,NYA,4,5,5-4,NYA,9,0,37,44,81,174,130,304,14,16,30,3,3:35
19369,662227,2022-06-23,2022,SDN,PHI,2,6,6-2,PHI,9,0,35,35,70,121,117,238,9,9,18,1,2:38
19370,662358,2022-06-23,2022,OAK,SEA,1,2,2-1,SEA,9,0,34,35,69,139,129,268,8,8,16,1,2:54
19371,661183,2022-06-23,2022,MIL,SLN,6,4,6-4,MIL,9,1,36,36,72,139,144,283,15,11,26,3,3:01
19372,661685,2022-06-23,2022,MIN,CLE,1,0,1-0,MIN,9,1,31,35,66,147,132,279,7,8,15,1,2:54
19373,661456,2022-06-23,2022,CHA,BAL,0,4,4-0,BAL,9,0,38,38,76,164,157,321,13,12,25,3,3:11
19374,661325,2022-06-23,2022,NYA,HOU,7,6,7-6,NYA,9,0,38,40,78,135,166,301,12,14,26,2,3:24
19375,661140,2022-06-23,2022,ATL,SFN,7,6,7-6,ATL,9,1,39,41,80,149,153,302,15,18,33,2,3:08
19376,661392,2022-06-23,2022,MIA,COL,3,2,3-2,MIA,9,1,34,42,76,166,118,284,11,15,26,1,3:17
19377,661106,2022-06-23,2022,PIT,CHN,8,7,8-7,PIT,10,0,40,43,83,168,139,307,11,15,26,2,3:27 (:06 delay)
19378,663039,2022-06-23,2022,CIN,LAN,5,10,10-5,LAN,9,0,39,44,83,187,130,317,14,20,34,3,3:14
19379,661455,2022-06-24,2022,CHA,BAL,1,4,4-1,BAL,9,0,30,36,66,144,111,255,3,10,13,3,2:55
19380,661139,2022-06-24,2022,ATL,LAN,1,4,4-1,LAN,9,0,34,40,74,159,136,295,8,13,21,3,3:09
19381,661888,2022-06-24,2022,TBA,PIT,4,3,4-3,TBA,10,0,36,39,75,156,154,310,8,9,17,1,3:14
19382,661971,2022-06-24,2022,SLN,CHN,0,3,3-0,CHN,9,0,33,37,70,127,108,235,7,11,18,1,2:43
19383,661684,2022-06-24,2022,MIN,COL,0,1,1-0,COL,9,0,33,33,66,95,115,210,8,9,17,1,2:17
19384,663333,2022-06-24,2022,ARI,DET,1,5,5-1,DET,9,0,34,37,71,144,138,282,8,10,18,1,2:46
19385,662664,2022-06-24,2022,KCA,OAK,3,1,3-1,KCA,9,1,33,34,67,136,93,229,10,7,17,1,2:22
19386,662067,2022-06-24,2022,SFN,CIN,2,4,4-2,CIN,9,0,34,38,72,140,123,263,8,10,18,1,2:51
19387,662255,2022-06-24,2022,SDN,PHI,1,0,1-0,SDN,9,1,31,37,68,164,113,277,9,10,19,0,3:05
19388,661274,2022-06-24,2022,NYA,HOU,1,3,3-1,HOU,9,0,37,35,72,128,145,273,10,9,19,1,3:05
19389,661382,2022-06-24,2022,MIA,NYN,3,5,5-3,NYN,9,0,39,33,72,125,153,278,16,6,22,2,3:03
19390,661844,2022-06-24,2022,TEX,WAS,1,2,2-1,WAS,9,0,38,35,73,126,157,283,11,11,22,2,3:05
19391,661190,2022-06-24,2022,MIL,TOR,4,9,9-4,TOR,9,0,39,40,79,170,160,330,14,15,29,3,3:16
19392,663054,2022-06-24,2022,CLE,BOS,3,6,6-3,BOS,9,0,39,45,84,181,131,312,13,21,34,1,3:19
19393,663388,2022-06-24,2022,ANA,SEA,3,4,4-3,SEA,9,0,34,47,81,212,139,351,11,21,32,3,3:41
19394,661138,2022-06-25,2022,ATL,LAN,5,3,5-3,ATL,9,1,36,37,73,154,131,285,12,11,23,2,3:12
19395,663042,2022-06-25,2022,CLE,BOS,2,4,4-2,BOS,9,0,36,39,75,133,132,265,10,16,26,2,2:55
19396,662247,2022-06-25,2022,SDN,PHI,2,4,4-2,PHI,9,0,34,36,70,134,130,264,7,10,17,1,2:59
19397,661686,2022-06-25,2022,MIN,COL,6,0,6-0,MIN,9,1,38,33,71,150,134,284,14,6,20,0,2:54
19398,661970,2022-06-25,2022,SLN,CHN,5,3,5-3,SLN,9,1,38,37,75,164,148,312,14,11,25,2,3:22
19399,661898,2022-06-25,2022,TEX,WAS,3,2,3-2,TEX,9,0,30,35,65,136,107,243,7,11,18,0,2:42
19400,662083,2022-06-25,2022,SFN,CIN,9,2,9-2,SFN,9,1,36,34,70,141,147,288,13,8,21,0,2:43
19401,661271,2022-06-25,2022,NYA,HOU,0,3,3-0,HOU,9,0,31,38,69,150,150,300,3,13,16,0,3:14
19402,661381,2022-06-25,2022,MIA,NYN,3,5,5-3,NYN,9,0,32,39,71,152,123,275,6,12,18,1,3:00
19403,663346,2022-06-25,2022,ARI,DET,3,6,6-3,DET,9,0,35,38,73,141,135,276,10,9,19,2,2:54
19404,661454,2022-06-25,2022,CHA,BAL,2,6,6-2,BAL,9,0,37,40,77,150,138,288,10,13,23,1,2:48 (1:21 delay)
19405,661264,2022-06-25,2022,MIL,TOR,5,4,5-4,MIL,9,1,38,36,74,132,167,299,13,10,23,2,3:10
19406,661887,2022-06-25,2022,TBA,PIT,6,5,6-5,TBA,9,0,43,37,80,133,174,307,18,11,29,1,3:09
19407,663441,2022-06-25,2022,ANA,SEA,3,5,5-3,SEA,9,0,39,44,83,168,138,306,16,17,33,4,3:22
19408,662672,2022-06-25,2022,KCA,OAK,7,9,9-7,OAK,9,0,44,46,90,191,170,361,17,18,35,5,3:46
19409,661380,2022-06-26,2022,MIA,NYN,3,2,3-2,MIA,9,0,32,36,68,134,127,261,6,9,15,0,2:44
19410,663121,2022-06-26,2022,CLE,BOS,3,8,8-3,BOS,9,0,37,51,88,202,126,328,12,29,41,0,3:22
19411,663387,2022-06-26,2022,ANA,SEA,2,1,2-1,ANA,9,1,36,32,68,120,135,255,15,7,22,2,3:04
19412,662665,2022-06-26,2022,KCA,OAK,3,5,5-3,OAK,9,0,36,36,72,112,147,259,11,9,20,2,2:43
19413,661453,2022-06-26,2022,CHA,BAL,4,3,4-3,CHA,9,1,33,38,71,136,126,262,9,9,18,0,2:35
19414,661692,2022-06-26,2022,MIN,COL,6,3,6-3,MIN,9,1,36,41,77,176,135,311,12,15,27,2,3:06
19415,662254,2022-06-26,2022,SDN,PHI,5,8,8-5,PHI,9,0,37,39,76,153,137,290,10,15,25,1,3:19
19416,661847,2022-06-26,2022,TEX,WAS,4,6,6-4,WAS,9,0,38,41,79,172,153,325,12,16,28,2,3:17
19417,661886,2022-06-26,2022,TBA,PIT,4,2,4-2,TBA,9,1,39,34,73,133,143,276,17,7,24,2,2:57
19418,661206,2022-06-26,2022,MIL,TOR,10,3,10-3,MIL,9,1,40,34,74,122,154,276,18,9,27,1,2:51
19419,661969,2022-06-26,2022,SLN,CHN,5,6,6-5,CHN,10,0,40,43,83,175,153,328,12,16,28,6,3:50
19420,662061,2022-06-26,2022,SFN,CIN,3,10,10-3,CIN,9,0,34,42,76,156,130,286,7,17,24,2,2:58
19421,661512,2022-06-26,2022,ATL,LAN,3,5,5-3,LAN,11,0,46,48,94,191,195,386,14,17,31,4,4:23
19422,661273,2022-06-26,2022,NYA,HOU,6,3,6-3,NYA,10,0,38,41,79,174,153,327,12,12,24,1,3:45
19423,663331,2022-06-26,2022,ARI,DET,11,7,11-7,ARI,9,1,44,41,85,186,168,354,21,14,35,2,3:36
19424,662681,2022-06-27,2022,KCA,TEX,4,10,10-4,TEX,9,0,37,46,83,170,146,316,10,21,31,2,3:10
19425,663016,2022-06-27,2022,CLE,MIN,1,11,11-1,MIN,9,0,31,43,74,166,121,287,7,18,25,1,2:55
19426,662912,2022-06-27,2022,COL,LAN,4,0,4-0,COL,9,1,34,29,63,102,126,228,12,3,15,0,2:19
19427,663440,2022-06-27,2022,ANA,CHA,4,3,4-3,ANA,9,1,36,33,69,103,135,238,14,7,21,0,2:42
19428,662168,2022-06-27,2022,SEA,BAL,2,9,9-2,BAL,9,0,33,41,74,147,120,267,6,14,20,1,2:39
19429,661968,2022-06-27,2022,SLN,MIA,9,0,9-0,SLN,9,1,36,33,69,117,140,257,12,9,21,0,2:40
19430,662487,2022-06-27,2022,WAS,PIT,3,2,3-2,WAS,9,1,37,36,73,158,122,280,14,9,23,0,2:54
19431,661740,2022-06-27,2022,TOR,BOS,7,2,7-2,TOR,9,1,37,37,74,140,133,273,13,10,23,1,2:59
19432,661275,2022-06-27,2022,NYA,OAK,9,5,9-5,NYA,9,1,40,37,77,132,166,298,15,9,24,3,3:24
19433,662186,2022-06-28,2022,SEA,BAL,2,0,2-0,SEA,9,1,31,32,63,133,122,255,8,5,13,1,2:39
19434,661967,2022-06-28,2022,SLN,MIA,5,3,5-3,SLN,9,1,34,33,67,148,133,281,12,8,20,2,3:01
19435,662521,2022-06-28,2022,NYN,HOU,1,9,9-1,HOU,9,0,37,42,79,172,124,296,12,17,29,2,3:17
19436,663344,2022-06-28,2022,ARI,SDN,7,6,7-6,ARI,9,0,40,40,80,174,172,346,16,13,29,3,3:38
19437,663392,2022-06-28,2022,ANA,CHA,4,11,11-4,CHA,9,0,38,47,85,187,148,335,10,21,31,3,3:16
19438,661728,2022-06-28,2022,TOR,BOS,6,5,6-5,TOR,9,0,39,40,79,154,144,298,17,15,32,3,3:21
19439,661272,2022-06-28,2022,NYA,OAK,2,1,2-1,NYA,9,1,29,34,63,140,134,274,7,9,16,2,3:03
19440,662060,2022-06-28,2022,SFN,DET,4,3,4-3,SFN,9,1,36,38,74,148,172,320,12,14,26,2,3:16
19441,661885,2022-06-28,2022,TBA,MIL,3,5,5-3,MIL,9,0,36,37,73,163,154,317,8,13,21,2,3:21
19442,662484,2022-06-28,2022,WAS,PIT,3,1,3-1,WAS,9,1,36,36,72,133,141,274,10,9,19,0,2:51
19443,662911,2022-06-28,2022,COL,LAN,7,4,7-4,COL,9,1,41,38,79,137,133,270,17,12,29,0,2:45
19444,662615,2022-06-28,2022,KCA,TEX,3,8,8-3,TEX,9,0,33,42,75,161,119,280,9,17,26,1,2:51
19445,663033,2022-06-28,2022,CLE,MIN,0,6,6-0,MIN,9,0,34,42,76,155,127,282,7,18,25,1,3:00
19446,663045,2022-06-28,2022,CLE,MIN,3,2,3-2,CLE,9,1,31,37,68,146,148,294,8,9,17,1,2:59
19447,663231,2022-06-28,2022,CHN,CIN,3,5,5-3,CIN,9,0,40,41,81,150,176,326,14,15,29,2,3:24
19448,661580,2022-06-28,2022,PHI,ATL,3,5,5-3,ATL,9,0,37,37,74,160,152,312,12,10,22,3,3:18
19449,661263,2022-06-29,2022,NYA,OAK,5,3,5-3,NYA,9,1,30,39,69,166,113,279,8,12,20,0,2:52
19450,663325,2022-06-29,2022,ARI,SDN,0,4,4-0,SDN,9,0,33,41,74,179,118,297,6,15,21,1,3:12
19451,662440,2022-06-29,2022,NYN,HOU,0,2,2-0,HOU,9,0,30,36,66,124,111,235,3,10,13,1,2:43
19452,661134,2022-06-29,2022,SLN,MIA,3,4,4-3,MIA,9,0,35,34,69,129,117,246,9,9,18,0,2:35
19453,663396,2022-06-29,2022,ANA,CHA,4,1,4-1,ANA,9,1,31,37,68,173,133,306,7,9,16,2,3:21
19454,661879,2022-06-29,2022,TBA,MIL,3,5,5-3,MIL,9,0,39,39,78,152,176,328,13,11,24,2,4:00
19455,663030,2022-06-29,2022,CLE,MIN,7,6,7-6,CLE,10,0,40,41,81,133,165,298,12,11,23,1,3:19
19456,662675,2022-06-29,2022,KCA,TEX,2,1,2-1,KCA,9,1,31,34,65,134,108,242,10,7,17,0,2:18
19457,661727,2022-06-29,2022,TOR,BOS,5,6,6-5,BOS,10,0,46,43,89,157,193,350,16,15,31,2,3:54
19458,661584,2022-06-29,2022,PHI,ATL,1,4,4-1,ATL,9,0,34,35,69,140,134,274,7,10,17,1,2:47
19459,662080,2022-06-29,2022,SFN,DET,2,3,3-2,DET,9,0,38,35,73,136,154,290,12,9,21,2,2:49
19460,663215,2022-06-29,2022,CHN,CIN,8,3,8-3,CHN,9,1,39,40,79,150,176,326,15,15,30,2,3:22
19461,662151,2022-06-29,2022,SEA,BAL,9,3,9-3,SEA,9,1,40,39,79,152,160,312,14,12,26,1,3:05
19462,662493,2022-06-29,2022,WAS,PIT,7,8,8-7,PIT,9,0,44,41,85,152,179,331,22,15,37,5,3:48
19463,662894,2022-06-29,2022,COL,LAN,4,8,8-4,LAN,9,0,36,42,78,154,131,285,11,16,27,3,2:56
19464,662733,2022-06-30,2022,LAN,SDN,3,1,3-1,LAN,9,1,29,36,65,149,111,260,6,10,16,2,2:50
19465,661105,2022-06-30,2022,PIT,MIL,8,7,8-7,PIT,9,1,36,42,78,160,133,293,13,15,28,2,3:00
19466,662788,2022-06-30,2022,HOU,NYA,2,1,2-1,HOU,9,1,29,35,64,152,113,265,6,8,14,1,2:54
19467,661726,2022-06-30,2022,TOR,TBA,4,1,4-1,TOR,9,1,35,33,68,133,142,275,13,7,20,1,2:55
19468,661579,2022-06-30,2022,PHI,ATL,14,4,14-4,PHI,9,1,42,37,79,139,154,293,18,10,28,1,2:58
19469,662150,2022-06-30,2022,SEA,OAK,8,6,8-6,SEA,9,1,35,40,75,153,131,284,12,13,25,2,2:53
19470,662983,2022-06-30,2022,CLE,MIN,5,3,5-3,CLE,9,0,42,36,78,135,186,321,15,10,25,1,3:19
19471,663199,2022-06-30,2022,CHN,CIN,15,7,15-7,CHN,9,1,50,40,90,153,174,327,27,14,41,1,3:14
19472,662748,2022-07-01,2022,HOU,ANA,8,1,8-1,HOU,9,1,38,29,67,128,147,275,15,3,18,0,2:45
19473,662997,2022-07-01,2022,COL,ARI,3,9,9-3,ARI,9,0,34,41,75,135,135,270,8,14,22,1,2:42
19474,662079,2022-07-01,2022,SFN,CHA,0,1,1-0,CHA,9,0,34,36,70,131,150,281,8,9,17,0,2:59
19475,662609,2022-07-01,2022,LAN,SDN,5,1,5-1,LAN,9,1,38,31,69,105,170,275,14,4,18,2,2:56
19476,661691,2022-07-01,2022,MIN,BAL,3,2,3-2,MIN,9,0,29,33,62,128,117,245,6,5,11,2,2:41
19477,662439,2022-07-01,2022,NYN,TEX,4,3,4-3,NYN,9,1,33,32,65,127,118,245,11,6,17,0,2:38
19478,663038,2022-07-01,2022,CIN,ATL,1,9,9-1,ATL,9,0,35,42,77,149,122,271,8,17,25,0,2:52
19479,662834,2022-07-01,2022,DET,KCA,1,3,3-1,KCA,9,0,38,36,74,122,129,251,12,11,23,2,2:50 (:16 delay)
19480,662149,2022-07-01,2022,SEA,OAK,1,3,3-1,OAK,9,0,36,41,77,139,139,278,9,14,23,1,3:00
19481,661582,2022-07-01,2022,PHI,SLN,5,3,5-3,PHI,9,1,36,36,72,165,142,307,11,11,22,3,3:20
19482,661725,2022-07-01,2022,TOR,TBA,9,2,9-2,TOR,9,1,39,40,79,169,130,299,16,13,29,0,2:58
19483,663185,2022-07-01,2022,CHN,BOS,6,5,6-5,CHN,9,1,41,38,79,162,154,316,17,13,30,4,3:31
19484,661104,2022-07-01,2022,PIT,MIL,2,19,19-2,MIL,9,0,38,51,89,204,166,370,11,23,34,1,3:34
19485,662492,2022-07-01,2022,WAS,MIA,3,6,6-3,MIA,9,0,34,42,76,142,133,275,8,15,23,1,3:05
19486,661724,2022-07-02,2022,TOR,TBA,2,6,6-2,TBA,9,0,34,42,76,148,129,277,8,15,23,2,2:47
19487,661683,2022-07-02,2022,MIN,BAL,4,3,4-3,MIN,9,0,36,37,73,135,142,277,11,12,23,2,3:01 (1:06 delay)
19488,663198,2022-07-02,2022,CHN,BOS,3,1,3-1,CHN,9,1,32,32,64,114,127,241,9,7,16,3,2:48
19489,661836,2022-07-02,2022,TOR,TBA,5,11,11-5,TBA,9,0,38,42,80,127,128,255,14,18,32,2,2:41
19490,661103,2022-07-02,2022,PIT,MIL,7,4,7-4,PIT,9,1,35,40,75,149,135,284,12,16,28,3,2:56
19491,662954,2022-07-02,2022,CLE,NYA,1,6,6-1,NYA,9,0,37,34,71,148,156,304,9,10,19,2,3:09
19492,662482,2022-07-02,2022,WAS,MIA,3,5,5-3,MIA,9,0,35,40,75,161,145,306,9,13,22,1,3:20
19493,663037,2022-07-02,2022,CIN,ATL,1,4,4-1,ATL,9,0,34,40,74,172,150,322,7,15,22,1,3:14
19494,662163,2022-07-02,2022,SEA,OAK,2,1,2-1,SEA,9,0,33,31,64,134,122,256,10,6,16,1,2:50
19495,662904,2022-07-02,2022,DET,KCA,4,3,4-3,DET,9,0,37,36,73,123,149,272,12,9,21,2,2:54
19496,662890,2022-07-02,2022,HOU,ANA,9,1,9-1,HOU,9,1,40,33,73,144,147,291,15,6,21,0,2:51
19497,662718,2022-07-02,2022,LAN,SDN,7,2,7-2,LAN,9,1,36,39,75,151,143,294,11,13,24,2,3:17
19498,661581,2022-07-02,2022,PHI,SLN,6,7,7-6,SLN,9,0,43,43,86,167,179,346,16,16,32,5,4:05
19499,662101,2022-07-02,2022,SFN,CHA,3,5,5-3,CHA,9,0,41,37,78,139,187,326,14,10,24,0,3:18
19500,662964,2022-07-02,2022,CLE,NYA,4,13,13-4,NYA,9,0,38,46,84,172,176,348,12,21,33,2,3:28
19501,662964,2022-07-02,2022,CLE,NYA,4,13,13-4,NYA,9,0,38,46,84,172,176,348,12,21,33,2,3:28
19502,662910,2022-07-02,2022,COL,ARI,11,7,11-7,COL,9,1,40,35,75,117,157,274,16,10,26,2,2:47
19503,662456,2022-07-02,2022,NYN,TEX,3,7,7-3,TEX,9,0,37,38,75,139,128,267,11,12,23,3,2:57
19504,662509,2022-07-03,2022,NYN,TEX,4,1,4-1,NYN,9,1,34,36,70,153,133,286,9,10,19,2,2:58
19505,663052,2022-07-03,2022,CIN,ATL,4,3,4-3,CIN,9,0,33,37,70,139,137,276,10,10,20,0,2:49
19506,662486,2022-07-03,2022,WAS,MIA,4,7,7-4,MIA,10,0,40,41,81,187,154,341,13,12,25,1,3:51
19507,661723,2022-07-03,2022,TOR,TBA,3,7,7-3,TBA,9,0,42,43,85,174,161,335,15,18,33,4,3:27
19508,662684,2022-07-03,2022,LAN,SDN,2,4,4-2,SDN,9,0,40,35,75,132,150,282,15,9,24,2,3:12
19509,662162,2022-07-03,2022,SEA,OAK,2,1,2-1,SEA,9,1,26,32,58,139,94,233,5,6,11,2,2:28
19510,661630,2022-07-03,2022,PHI,SLN,4,0,4-0,PHI,9,1,34,32,66,135,138,273,10,6,16,2,3:03
19511,661689,2022-07-03,2022,MIN,BAL,1,3,3-1,BAL,9,0,34,35,69,129,140,269,7,9,16,1,2:48
19512,662957,2022-07-03,2022,CLE,NYA,2,0,2-0,CLE,9,1,33,33,66,130,136,266,10,5,15,1,2:55
19513,661102,2022-07-03,2022,PIT,MIL,0,2,2-0,MIL,9,0,38,33,71,117,170,287,11,7,18,1,3:08
19514,663186,2022-07-03,2022,CHN,BOS,2,4,4-2,BOS,11,0,46,49,95,205,179,384,16,16,32,2,4:25
19515,662794,2022-07-03,2022,DET,KCA,4,7,7-4,KCA,9,0,37,44,81,175,158,333,13,20,33,3,3:33
19516,662913,2022-07-03,2022,COL,ARI,6,5,6-5,COL,9,1,34,41,75,142,127,269,11,15,26,3,3:09
19517,662889,2022-07-03,2022,HOU,ANA,4,2,4-2,HOU,9,0,38,35,73,147,154,301,13,9,22,2,3:23
19518,662099,2022-07-03,2022,SFN,CHA,4,13,13-4,CHA,9,0,36,48,84,180,158,338,9,20,29,2,3:22
19519,662841,2022-07-04,2022,DET,CLE,5,3,5-3,DET,9,1,37,34,71,123,140,263,12,10,22,2,2:55
19520,663343,2022-07-04,2022,ARI,SFN,8,3,8-3,ARI,9,1,37,37,74,161,158,319,13,12,25,0,3:13
19521,662906,2022-07-04,2022,DET,CLE,4,1,4-1,DET,9,1,37,31,68,126,143,269,14,6,20,3,2:55
19522,662355,2022-07-04,2022,OAK,TOR,5,1,5-1,OAK,9,1,33,32,65,111,130,241,10,5,15,1,2:27
19523,663251,2022-07-04,2022,BOS,TBA,4,0,4-0,BOS,9,1,35,32,67,129,149,278,12,4,16,2,2:57
19524,662732,2022-07-04,2022,LAN,COL,5,3,5-3,LAN,9,1,35,37,72,150,139,289,11,11,22,2,3:06
19525,661511,2022-07-04,2022,ATL,SLN,6,3,6-3,ATL,9,1,34,41,75,163,131,294,14,13,27,1,3:01 (2:37 delay)
19526,663036,2022-07-04,2022,CIN,NYN,4,7,7-4,NYN,9,0,36,43,79,167,140,307,10,17,27,1,3:14
19527,661073,2022-07-04,2022,BAL,TEX,7,6,7-6,BAL,10,0,45,46,91,188,138,326,18,16,34,4,3:33
19528,662541,2022-07-04,2022,WAS,MIA,2,3,3-2,MIA,10,0,36,42,78,134,117,251,10,13,23,1,2:53
19529,661181,2022-07-04,2022,MIL,CHN,5,2,5-2,MIL,10,0,42,39,81,177,158,335,14,11,25,1,3:29
19530,662841,2022-07-04,2022,DET,CLE,5,3,5-3,DET,9,1,37,34,71,123,140,263,12,10,22,2,2:55
19531,661452,2022-07-04,2022,CHA,MIN,3,6,6-3,MIN,10,0,37,43,80,155,135,290,11,15,26,1,3:13
19532,662874,2022-07-04,2022,HOU,KCA,7,6,7-6,HOU,9,0,39,39,78,154,163,317,13,14,27,2,3:19
19533,662270,2022-07-04,2022,SDN,SEA,2,8,8-2,SEA,9,0,38,46,84,185,153,338,12,18,30,3,3:21
19534,662731,2022-07-05,2022,LAN,COL,5,2,5-2,LAN,9,1,35,35,70,148,154,302,13,9,22,2,3:00
19535,662847,2022-07-05,2022,HOU,KCA,9,7,9-7,HOU,9,1,40,40,80,149,138,287,17,14,31,2,3:04
19536,661426,2022-07-05,2022,CHA,MIN,2,8,8-2,MIN,9,0,36,43,79,143,129,272,12,17,29,2,2:59 (:35 delay)
19537,661510,2022-07-05,2022,ATL,SLN,7,1,7-1,ATL,9,1,38,40,78,157,162,319,13,13,26,1,3:07
19538,661187,2022-07-05,2022,MIL,CHN,3,8,8-3,CHN,9,0,36,42,78,153,160,313,10,15,25,2,3:03
19539,662905,2022-07-05,2022,DET,CLE,11,4,11-4,DET,9,1,43,40,83,149,155,304,20,13,33,1,3:03
19540,661244,2022-07-05,2022,BAL,TEX,10,9,10-9,BAL,10,0,46,46,92,179,156,335,19,15,34,4,3:46
19541,661379,2022-07-05,2022,MIA,ANA,2,1,2-1,MIA,9,1,33,32,65,130,142,272,10,5,15,1,2:47
19542,662354,2022-07-05,2022,OAK,TOR,5,3,5-3,OAK,9,1,35,35,70,126,142,268,14,10,24,3,2:40
19543,663035,2022-07-05,2022,CIN,NYN,1,0,1-0,CIN,9,0,33,36,69,148,125,273,9,10,19,3,3:01 (:53 delay)
19544,663320,2022-07-05,2022,ARI,SFN,6,2,6-2,ARI,9,1,34,36,70,142,137,279,11,12,23,3,3:07
19545,661578,2022-07-05,2022,PHI,WAS,11,0,11-0,PHI,9,1,43,32,75,114,190,304,20,7,27,2,3:03
19546,662329,2022-07-05,2022,PIT,NYA,5,2,5-2,PIT,9,1,33,38,71,167,131,298,9,12,21,1,2:59
19547,662226,2022-07-05,2022,SDN,SEA,2,6,6-2,SEA,9,0,40,39,79,147,162,309,12,14,26,1,3:16
19548,663245,2022-07-05,2022,BOS,TBA,4,8,8-4,TBA,9,0,42,42,84,148,185,333,15,18,33,1,3:39
19549,661509,2022-07-06,2022,ATL,SLN,3,0,3-0,ATL,9,1,30,36,66,129,111,240,6,11,17,0,2:32
19550,661245,2022-07-06,2022,BAL,TEX,2,1,2-1,BAL,9,1,31,34,65,118,135,253,8,7,15,2,2:41
19551,662353,2022-07-06,2022,OAK,TOR,1,2,2-1,TOR,9,0,32,37,69,142,118,260,5,12,17,2,2:39
19552,661564,2022-07-06,2022,PHI,WAS,2,3,3-2,WAS,9,0,33,34,67,120,153,273,7,9,16,1,2:57
19553,662814,2022-07-06,2022,DET,CLE,8,2,8-2,DET,9,1,37,37,74,161,128,289,13,11,24,1,3:04
19554,662747,2022-07-06,2022,HOU,KCA,4,7,7-4,KCA,9,0,38,40,78,161,165,326,12,15,27,2,3:29
19555,662328,2022-07-06,2022,PIT,NYA,0,16,16-0,NYA,9,0,32,55,87,195,131,326,5,30,35,1,3:21 (1:09 delay)
19556,663051,2022-07-06,2022,CIN,NYN,3,8,8-3,NYN,10,0,39,47,86,159,184,343,13,19,32,3,3:46
19557,661413,2022-07-06,2022,CHA,MIN,9,8,9-8,CHA,10,0,44,45,89,173,172,345,18,17,35,0,3:47
19558,662630,2022-07-06,2022,LAN,COL,2,1,2-1,LAN,9,0,37,32,69,133,135,268,14,6,20,2,3:01
19559,661378,2022-07-06,2022,MIA,ANA,2,5,5-2,ANA,9,0,35,41,76,139,132,271,8,16,24,1,3:07
19560,661225,2022-07-06,2022,MIL,CHN,1,2,2-1,CHN,9,0,34,35,69,145,145,290,8,9,17,2,3:13
19561,663318,2022-07-06,2022,ARI,SFN,5,7,7-5,SFN,9,0,41,39,80,142,160,302,14,13,27,4,3:23
19562,663244,2022-07-06,2022,BOS,TBA,1,7,7-1,TBA,9,0,34,45,79,181,126,307,6,19,25,0,3:05
19563,663071,2022-07-07,2022,CIN,PIT,2,4,4-2,PIT,9,0,35,37,72,151,134,285,9,12,21,2,2:49
19564,662730,2022-07-07,2022,LAN,CHN,5,3,5-3,LAN,9,1,32,33,65,143,129,272,9,7,16,3,2:55
19565,662156,2022-07-07,2022,SEA,TOR,8,3,8-3,SEA,9,1,34,37,71,125,140,265,12,12,24,2,2:41
19566,662508,2022-07-07,2022,NYN,MIA,10,0,10-0,NYN,9,1,39,28,67,106,151,257,14,2,16,0,2:51
19567,663140,2022-07-07,2022,CIN,PIT,5,1,5-1,CIN,9,1,34,34,68,154,117,271,10,8,18,4,3:01
19568,661425,2022-07-07,2022,CHA,DET,1,2,2-1,DET,9,0,32,36,68,141,136,277,6,9,15,1,3:00
19569,661566,2022-07-07,2022,PHI,WAS,5,3,5-3,PHI,9,1,35,39,74,134,150,284,11,12,23,0,2:56
19570,662253,2022-07-07,2022,SDN,SFN,2,1,2-1,SDN,10,0,36,39,75,147,130,277,12,10,22,0,3:22 (:14 delay)
19571,663071,2022-07-07,2022,CIN,PIT,2,4,4-2,PIT,9,0,35,37,72,151,134,285,9,12,21,2,2:49
19572,663233,2022-07-07,2022,BOS,NYA,5,6,6-5,NYA,9,0,35,39,74,142,133,275,9,12,21,2,2:56
19573,662746,2022-07-07,2022,HOU,KCA,5,2,5-2,HOU,9,1,40,37,77,141,151,292,19,10,29,1,3:04
19574,661091,2022-07-07,2022,BAL,ANA,4,1,4-1,BAL,9,1,37,35,72,142,152,294,12,8,20,3,3:00
19575,663317,2022-07-07,2022,ARI,COL,3,4,4-3,COL,9,0,36,37,73,131,163,294,12,12,24,0,2:57
19576,661521,2022-07-07,2022,ATL,SLN,2,3,3-2,SLN,11,0,45,45,90,179,171,350,14,13,27,2,3:50
19577,661136,2022-07-08,2022,SLN,PHI,0,2,2-0,PHI,9,0,34,31,65,103,116,219,7,5,12,0,2:23
19578,662614,2022-07-08,2022,KCA,CLE,4,3,4-3,KCA,9,0,35,37,72,153,124,277,10,12,22,0,2:44
19579,661177,2022-07-08,2022,MIL,PIT,4,3,4-3,MIL,9,1,35,36,71,146,154,300,15,10,25,0,3:01
19580,663202,2022-07-08,2022,BOS,NYA,5,12,12-5,NYA,9,0,44,49,93,199,171,370,17,22,39,3,3:51
19581,662610,2022-07-08,2022,LAN,CHN,4,3,4-3,LAN,10,0,40,35,75,114,166,280,13,5,18,2,3:01
19582,661843,2022-07-08,2022,TEX,MIN,6,5,6-5,TEX,9,1,35,41,76,151,147,298,12,13,25,3,3:22
19583,663053,2022-07-08,2022,CIN,TBA,2,1,2-1,CIN,10,0,35,38,73,162,165,327,9,9,18,0,3:18
19584,663319,2022-07-08,2022,ARI,COL,5,6,6-5,COL,9,0,38,40,78,157,142,299,14,14,28,2,3:28
19585,662498,2022-07-08,2022,NYN,MIA,2,5,5-2,MIA,9,0,39,37,76,151,173,324,12,11,23,1,3:37
19586,661108,2022-07-08,2022,BAL,ANA,5,4,5-4,BAL,9,0,38,40,78,160,172,332,12,14,26,1,3:30
19587,662352,2022-07-08,2022,OAK,HOU,3,8,8-3,HOU,9,0,32,44,76,179,107,286,5,17,22,1,2:57
19588,661522,2022-07-08,2022,ATL,WAS,12,2,12-2,ATL,9,1,42,33,75,135,153,288,19,8,27,2,2:51 (1:15 delay)
19589,661412,2022-07-08,2022,CHA,DET,5,7,7-5,DET,9,0,40,38,78,135,141,276,14,11,25,2,2:56
19590,662225,2022-07-08,2022,SDN,SFN,6,3,6-3,SDN,9,1,40,36,76,149,160,309,16,9,25,3,3:16
19591,662155,2022-07-08,2022,SEA,TOR,5,2,5-2,SEA,11,0,41,46,87,180,170,350,15,15,30,3,4:08
19592,662351,2022-07-09,2022,OAK,HOU,3,2,3-2,OAK,9,1,30,35,65,137,96,233,7,8,15,1,2:33
19593,661508,2022-07-09,2022,ATL,WAS,4,3,4-3,ATL,9,1,32,39,71,124,127,251,11,14,25,1,2:36
19594,662497,2022-07-09,2022,NYN,MIA,5,4,5-4,NYN,10,0,37,39,76,154,158,312,8,12,20,3,3:41
19595,662663,2022-07-09,2022,KCA,CLE,1,13,13-1,CLE,9,0,37,54,91,202,146,348,13,29,42,2,3:10
19596,663092,2022-07-09,2022,CIN,TBA,5,4,5-4,CIN,10,0,45,42,87,181,190,371,18,15,33,2,4:00
19597,662147,2022-07-09,2022,SEA,TOR,2,1,2-1,SEA,9,1,30,34,64,143,116,259,7,9,16,1,2:42
19598,662683,2022-07-09,2022,LAN,CHN,4,2,4-2,LAN,9,1,35,33,68,118,125,243,11,6,17,2,2:41
19599,661071,2022-07-09,2022,BAL,ANA,1,0,1-0,BAL,9,1,31,35,66,155,120,275,8,10,18,2,2:59
19600,661224,2022-07-09,2022,MIL,PIT,3,4,4-3,PIT,9,0,39,36,75,147,160,307,13,9,22,3,3:14
19601,661842,2022-07-09,2022,TEX,MIN,9,7,9-7,TEX,9,1,40,39,79,141,158,299,19,13,32,2,3:19
19602,663310,2022-07-09,2022,ARI,COL,9,2,9-2,ARI,9,1,39,36,75,154,152,306,16,9,25,1,3:03
19603,662266,2022-07-09,2022,SDN,SFN,1,3,3-1,SFN,9,0,32,38,70,145,112,257,5,11,16,0,2:51
19604,661137,2022-07-09,2022,SLN,PHI,0,1,1-0,PHI,9,0,33,35,68,145,127,272,6,9,15,1,2:58
19605,661411,2022-07-09,2022,CHA,DET,8,0,8-0,CHA,9,1,38,31,69,117,154,271,14,6,20,0,2:35
19606,663223,2022-07-09,2022,BOS,NYA,6,5,6-5,BOS,10,0,41,40,81,172,130,302,12,13,25,3,3:38
19607,663307,2022-07-10,2022,ARI,COL,2,3,3-2,COL,9,0,33,36,69,131,133,264,6,7,13,2,2:43
19608,662662,2022-07-10,2022,KCA,CLE,5,1,5-1,KCA,9,1,37,35,72,162,140,302,13,8,21,1,2:48
19609,662215,2022-07-10,2022,OAK,HOU,1,6,6-1,HOU,9,0,32,38,70,131,131,262,6,12,18,0,2:39
19610,661410,2022-07-10,2022,CHA,DET,4,2,4-2,CHA,9,1,34,34,68,130,121,251,10,9,19,2,2:46
19611,662183,2022-07-10,2022,SEA,TOR,6,5,6-5,SEA,9,1,34,37,71,135,129,264,10,10,20,2,2:45
19612,661092,2022-07-10,2022,BAL,ANA,9,5,9-5,BAL,9,1,38,36,74,142,118,260,15,10,25,2,2:48
19613,661520,2022-07-10,2022,ATL,WAS,4,3,4-3,ATL,12,0,49,45,94,180,173,353,18,12,30,3,3:53
19614,662496,2022-07-10,2022,NYN,MIA,0,2,2-0,MIA,10,0,39,36,75,140,138,278,9,8,17,0,2:57
19615,661808,2022-07-10,2022,TEX,MIN,5,6,6-5,MIN,9,0,37,40,77,152,147,299,11,17,28,1,3:12
19616,663048,2022-07-10,2022,CIN,TBA,10,5,10-5,CIN,9,1,40,41,81,177,150,327,15,15,30,1,3:19
19617,661135,2022-07-10,2022,SLN,PHI,4,3,4-3,SLN,9,1,38,37,75,142,157,299,15,12,27,2,3:09
19618,663232,2022-07-10,2022,BOS,NYA,11,6,11-6,BOS,9,1,41,38,79,167,152,319,15,13,28,2,3:32
19619,662198,2022-07-10,2022,SDN,SFN,0,12,12-0,SFN,9,0,34,48,82,187,126,313,8,21,29,2,3:06
19620,661178,2022-07-10,2022,MIL,PIT,6,8,8-6,PIT,9,0,39,42,81,191,155,346,12,16,28,3,3:31
19621,662729,2022-07-10,2022,LAN,CHN,11,9,11-9,LAN,9,1,45,41,86,165,205,370,21,15,36,4,3:59
19622,662700,2022-07-11,2022,KCA,DET,3,1,3-1,KCA,9,1,34,33,67,116,116,232,10,5,15,1,2:30
19623,662700,2022-07-11,2022,KCA,DET,3,1,3-1,KCA,9,1,34,33,67,116,116,232,10,5,15,1,2:30
19624,661507,2022-07-11,2022,ATL,NYN,1,4,4-1,NYN,9,0,32,41,73,165,124,289,5,16,21,0,3:03
19625,661324,2022-07-11,2022,MIA,PIT,1,5,5-1,PIT,9,0,35,41,76,161,129,290,8,15,23,2,3:03
19626,662661,2022-07-11,2022,KCA,DET,7,3,7-3,KCA,9,1,40,38,78,145,140,285,16,12,28,2,3:00
19627,661120,2022-07-11,2022,SLN,PHI,6,1,6-1,SLN,9,1,33,32,65,134,117,251,9,8,17,2,2:41
19628,661814,2022-07-11,2022,TEX,OAK,10,8,10-8,TEX,9,1,40,42,82,166,161,327,15,15,30,4,3:28
19629,662996,2022-07-11,2022,COL,SDN,5,6,6-5,SDN,9,0,39,41,80,154,145,299,12,15,27,2,3:01
19630,662956,2022-07-11,2022,CLE,CHA,8,4,8-4,CLE,9,1,39,34,73,114,152,266,17,9,26,2,2:51
19631,661878,2022-07-11,2022,TBA,BOS,10,5,10-5,TBA,9,1,41,38,79,166,157,323,19,12,31,1,3:31
19632,662100,2022-07-11,2022,SFN,ARI,3,4,4-3,ARI,9,0,38,42,80,170,152,322,12,18,30,4,3:46
19633,663087,2022-07-12,2022,CLE,CHA,4,1,4-1,CLE,9,1,31,30,61,95,114,209,11,4,15,0,2:09
19634,662984,2022-07-12,2022,COL,SDN,5,3,5-3,COL,9,1,34,39,73,157,113,270,10,14,24,3,3:11
19635,662660,2022-07-12,2022,KCA,DET,5,7,7-5,DET,9,0,39,43,82,151,134,285,13,14,27,3,3:08
19636,663402,2022-07-12,2022,ANA,HOU,5,6,6-5,HOU,9,0,38,43,81,169,162,331,9,16,25,2,3:37
19637,663087,2022-07-12,2022,CLE,CHA,4,1,4-1,CLE,9,1,31,30,61,95,114,209,11,4,15,0,2:09
19638,661722,2022-07-12,2022,TOR,PHI,4,3,4-3,TOR,9,1,35,35,70,136,132,268,16,7,23,1,2:52
19639,662108,2022-07-12,2022,SFN,ARI,13,0,13-0,SFN,9,1,41,37,78,143,158,301,17,10,27,1,2:45
19640,661688,2022-07-12,2022,MIN,MIL,3,6,6-3,MIL,9,0,37,35,72,153,156,309,11,9,20,1,3:02 (1:43 delay)
19641,661119,2022-07-12,2022,SLN,LAN,7,6,7-6,SLN,9,1,39,43,82,186,130,316,16,16,32,3,3:28
19642,662976,2022-07-12,2022,CLE,CHA,0,7,7-0,CHA,9,0,39,41,80,167,159,326,12,13,25,1,3:15
19643,661377,2022-07-12,2022,MIA,PIT,2,3,3-2,PIT,9,0,32,33,65,117,126,243,5,8,13,1,2:43
19644,661877,2022-07-12,2022,TBA,BOS,3,2,3-2,TBA,9,1,33,34,67,142,126,268,9,9,18,2,2:49
19645,663187,2022-07-12,2022,CHN,BAL,2,4,4-2,BAL,9,0,33,40,73,148,122,270,8,15,23,2,2:54
19646,661262,2022-07-12,2022,NYA,CIN,3,4,4-3,CIN,9,0,38,38,76,153,163,316,14,11,25,1,3:21 (1:01 delay)
19647,661506,2022-07-12,2022,ATL,NYN,4,1,4-1,ATL,9,1,33,36,69,165,153,318,9,10,19,3,3:04
19648,661813,2022-07-12,2022,TEX,OAK,7,14,14-7,OAK,12,0,49,54,103,180,174,354,15,20,35,3,4:03
19649,662949,2022-07-13,2022,CLE,CHA,1,2,2-1,CHA,9,0,33,36,69,140,128,268,6,10,16,2,2:57
19650,662517,2022-07-13,2022,WAS,SEA,4,6,6-4,SEA,9,0,40,37,77,147,132,279,15,11,26,2,2:53
19651,662107,2022-07-13,2022,SFN,ARI,4,3,4-3,SFN,9,0,35,38,73,158,131,289,13,13,26,3,3:05
19652,661505,2022-07-13,2022,ATL,NYN,3,7,7-3,NYN,9,0,36,39,75,168,139,307,10,11,21,1,3:05
19653,661269,2022-07-13,2022,NYA,CIN,7,6,7-6,NYA,10,0,39,43,82,166,173,339,11,15,26,2,3:56
19654,661721,2022-07-13,2022,TOR,PHI,8,2,8-2,TOR,9,1,35,30,65,107,137,244,13,2,15,1,2:31
19655,661812,2022-07-13,2022,TEX,OAK,5,2,5-2,TEX,9,1,32,32,64,124,131,255,9,5,14,1,2:34
19656,663230,2022-07-13,2022,CHN,BAL,1,7,7-1,BAL,9,0,36,42,78,155,153,308,9,16,25,2,3:11
19657,663401,2022-07-13,2022,ANA,HOU,7,1,7-1,ANA,9,1,42,34,76,146,183,329,18,7,25,2,3:45
19658,661876,2022-07-13,2022,TBA,BOS,4,1,4-1,TBA,9,1,34,30,64,113,139,252,10,5,15,1,2:30
19659,661118,2022-07-13,2022,SLN,LAN,6,7,7-6,LAN,9,0,38,46,84,203,146,349,11,20,31,2,3:46
19660,662531,2022-07-13,2022,WAS,SEA,1,2,2-1,SEA,9,0,34,36,70,143,129,272,11,11,22,3,2:58
19661,662531,2022-07-13,2022,WAS,SEA,1,2,2-1,SEA,9,0,34,36,70,143,129,272,11,11,22,3,2:58
19662,662659,2022-07-13,2022,KCA,DET,5,2,5-2,KCA,9,1,34,39,73,152,115,267,8,15,23,1,2:44
19663,661687,2022-07-13,2022,MIN,MIL,4,1,4-1,MIN,9,0,41,34,75,138,170,308,18,8,26,3,3:20
19664,661376,2022-07-13,2022,MIA,PIT,5,4,5-4,MIA,10,0,41,39,80,159,148,307,15,13,28,0,3:21
19665,662895,2022-07-13,2022,COL,SDN,10,6,10-6,COL,9,1,44,43,87,177,159,336,20,19,39,4,3:40
19666,663123,2022-07-14,2022,CLE,DET,4,0,4-0,CLE,9,1,38,32,70,120,143,263,16,5,21,1,2:37
19667,662518,2022-07-14,2022,WAS,ATL,4,5,5-4,ATL,9,0,38,33,71,136,147,283,12,8,20,0,2:54
19668,661720,2022-07-14,2022,TOR,KCA,1,3,3-1,KCA,9,0,35,36,71,145,130,275,10,14,24,2,3:00
19669,661101,2022-07-14,2022,CHN,NYN,0,8,8-0,NYN,9,0,35,44,79,175,135,310,10,18,28,1,3:01
19670,661811,2022-07-14,2022,TEX,SEA,5,6,6-5,SEA,9,0,39,44,83,186,132,318,16,17,33,2,3:20
19671,661261,2022-07-14,2022,NYA,CIN,6,7,7-6,CIN,10,0,46,44,90,154,187,341,16,14,30,4,3:44
19672,661675,2022-07-14,2022,MIN,CHA,2,12,12-2,CHA,9,0,39,49,88,159,165,324,13,21,34,1,3:19
19673,661375,2022-07-14,2022,MIA,PIT,3,2,3-2,MIA,11,0,41,45,86,192,182,374,14,15,29,2,4:13
19674,661875,2022-07-14,2022,TBA,BOS,5,4,5-4,TBA,9,1,33,36,69,141,119,260,10,9,19,2,2:45
19675,661100,2022-07-14,2022,COL,SDN,8,5,8-5,COL,9,1,41,37,78,159,196,355,18,11,29,3,3:42
19676,663123,2022-07-14,2022,CLE,DET,4,0,4-0,CLE,9,1,38,32,70,120,143,263,16,5,21,1,2:37
19677,661117,2022-07-14,2022,SLN,LAN,0,4,4-0,LAN,9,0,33,36,69,127,148,275,8,13,21,2,3:00
19678,663386,2022-07-14,2022,ANA,HOU,2,3,3-2,HOU,10,0,45,40,85,151,164,315,15,13,28,0,3:28
19679,662109,2022-07-14,2022,SFN,MIL,2,3,3-2,MIL,10,0,37,46,83,186,156,342,8,17,25,2,3:52
19680,661719,2022-07-15,2022,TOR,KCA,8,1,8-1,TOR,9,1,40,34,74,119,155,274,17,7,24,0,2:48
19681,661674,2022-07-15,2022,MIN,CHA,2,6,6-2,CHA,9,0,36,38,74,143,142,285,11,11,22,2,3:09
19682,661874,2022-07-15,2022,TBA,BAL,5,4,5-4,TBA,9,1,34,39,73,152,125,277,10,12,22,2,3:05
19683,662942,2022-07-15,2022,CLE,DET,6,5,6-5,CLE,9,1,36,37,73,134,138,272,16,9,25,2,2:59
19684,661113,2022-07-15,2022,COL,PIT,13,2,13-2,COL,9,1,42,33,75,116,173,289,21,6,27,1,3:03
19685,661810,2022-07-15,2022,TEX,SEA,3,8,8-3,SEA,9,0,33,42,75,164,140,304,6,16,22,2,3:09
19686,663385,2022-07-15,2022,ANA,LAN,1,9,9-1,LAN,9,0,29,45,74,187,100,287,2,19,21,2,3:01
19687,661374,2022-07-15,2022,MIA,PHI,1,2,2-1,PHI,9,0,35,33,68,133,165,298,8,8,16,0,3:04
19688,662516,2022-07-15,2022,WAS,ATL,4,8,8-4,ATL,9,0,41,42,83,161,174,335,15,14,29,2,3:32
19689,661116,2022-07-15,2022,SLN,CIN,7,3,7-3,SLN,9,1,37,38,75,153,177,330,16,13,29,3,3:33
19690,661260,2022-07-15,2022,NYA,BOS,4,5,5-4,BOS,11,0,44,43,87,176,159,335,16,12,28,1,4:00
19691,662923,2022-07-15,2022,HOU,OAK,1,5,5-1,OAK,9,0,33,36,69,129,123,252,7,9,16,2,2:39
19692,662072,2022-07-15,2022,SFN,MIL,8,5,8-5,SFN,9,0,42,43,85,186,155,341,18,14,32,3,3:34
19693,662197,2022-07-15,2022,SDN,ARI,5,3,5-3,SDN,9,1,35,35,70,144,151,295,12,8,20,0,3:04
19694,662909,2022-07-16,2022,HOU,OAK,5,0,5-0,HOU,9,1,32,34,66,154,99,253,8,8,16,0,2:35
19695,662113,2022-07-16,2022,SFN,MIL,2,1,2-1,SFN,9,1,32,32,64,125,132,257,8,6,14,2,2:49
19696,662483,2022-07-16,2022,WAS,ATL,3,6,6-3,ATL,9,0,32,39,71,147,118,265,7,11,18,1,2:47 (1:49 delay)
19697,662952,2022-07-16,2022,CLE,DET,10,0,10-0,CLE,9,1,40,33,73,137,138,275,16,8,24,1,2:46
19698,661359,2022-07-16,2022,MIA,PHI,0,10,10-0,PHI,9,0,31,43,74,153,116,269,5,18,23,1,2:52
19699,662271,2022-07-16,2022,SDN,ARI,4,3,4-3,SDN,9,1,34,39,73,147,129,276,10,14,24,5,3:02
19700,661673,2022-07-16,2022,MIN,CHA,6,3,6-3,MIN,9,1,36,37,73,158,159,317,12,11,23,2,3:12
19701,661809,2022-07-16,2022,TEX,SEA,2,3,3-2,SEA,10,0,36,44,80,158,152,310,8,16,24,1,3:22
19702,661259,2022-07-16,2022,NYA,BOS,14,1,14-1,NYA,9,1,47,31,78,113,198,311,22,4,26,2,3:09
19703,661115,2022-07-16,2022,CHN,NYN,3,4,4-3,NYN,10,0,41,43,84,168,154,322,14,15,29,3,3:33
19704,661718,2022-07-16,2022,TOR,KCA,6,5,6-5,TOR,10,0,41,40,81,152,170,322,16,11,27,2,3:29
19705,663415,2022-07-16,2022,ANA,LAN,1,7,7-1,LAN,9,0,35,37,72,172,125,297,7,11,18,1,3:07
19706,661114,2022-07-16,2022,CHN,NYN,1,2,2-1,NYN,11,0,39,41,80,188,164,352,9,8,17,3,3:46
19707,661115,2022-07-16,2022,CHN,NYN,3,4,4-3,NYN,10,0,41,43,84,168,154,322,14,15,29,3,3:33
19708,661873,2022-07-16,2022,TBA,BAL,4,6,6-4,BAL,11,0,45,40,85,140,191,331,16,10,26,4,3:51
19709,661081,2022-07-16,2022,COL,PIT,2,0,2-0,COL,9,1,35,34,69,129,131,260,11,9,20,0,2:40
19710,661966,2022-07-16,2022,SLN,CIN,11,3,11-3,SLN,9,1,48,35,83,136,168,304,22,8,30,2,3:20
19711,661373,2022-07-17,2022,MIA,PHI,0,4,4-0,PHI,9,0,31,36,67,123,116,239,5,10,15,1,2:42
19712,661717,2022-07-17,2022,TOR,KCA,4,2,4-2,TOR,9,1,33,32,65,114,110,224,8,8,16,1,2:21
19713,662530,2022-07-17,2022,WAS,ATL,7,3,7-3,WAS,9,1,33,37,70,146,123,269,9,9,18,1,2:54
19714,661258,2022-07-17,2022,NYA,BOS,13,2,13-2,NYA,9,1,47,32,79,136,188,324,23,6,29,4,3:32
19715,662059,2022-07-17,2022,SFN,MIL,9,5,9-5,SFN,9,1,38,36,74,130,142,272,15,11,26,2,2:49
19716,661672,2022-07-17,2022,MIN,CHA,0,11,11-0,CHA,9,0,32,47,79,170,137,307,4,20,24,2,3:09
19717,662908,2022-07-17,2022,HOU,OAK,3,4,4-3,OAK,9,0,37,37,74,142,151,293,9,10,19,2,3:16
19718,661080,2022-07-17,2022,COL,PIT,3,8,8-3,PIT,9,0,37,46,83,175,131,306,13,19,32,2,3:13
19719,661821,2022-07-17,2022,TEX,SEA,2,6,6-2,SEA,9,0,39,39,78,145,172,317,12,14,26,2,3:22
19720,661872,2022-07-17,2022,TBA,BAL,7,5,7-5,TBA,9,1,36,39,75,125,150,275,13,13,26,3,2:58
19721,661082,2022-07-17,2022,CHN,NYN,3,2,3-2,CHN,9,1,33,36,69,155,148,303,10,12,22,2,3:09
19722,662269,2022-07-17,2022,SDN,ARI,1,3,3-1,ARI,9,0,32,40,72,153,135,288,6,12,18,4,3:20
19723,663466,2022-07-19,2022,NAS,AAS,2,3,3-2,AAS,9,0,36,37,73,148,151,299,9,11,20,2,3:11
19724,662408,2022-07-21,2022,OAK,DET,5,0,5-0,OAK,9,1,35,33,68,136,148,284,12,8,20,1,2:45
19725,661421,2022-07-21,2022,MIA,TEX,0,8,8-0,TEX,9,0,36,43,79,163,143,306,10,16,26,0,3:06
19726,662775,2022-07-21,2022,HOU,NYA,7,5,7-5,HOU,9,1,36,39,75,177,127,304,10,13,23,1,3:11
19727,662776,2022-07-21,2022,HOU,NYA,3,2,3-2,HOU,9,0,36,37,73,155,124,279,13,11,24,1,3:14
19728,662685,2022-07-21,2022,LAN,SFN,9,6,9-6,LAN,9,1,38,40,78,166,144,310,15,14,29,4,3:29
19729,662411,2022-07-21,2022,OAK,DET,2,7,7-2,DET,9,0,35,42,77,167,147,314,8,14,22,1,2:58
19730,662327,2022-07-22,2022,PIT,MIA,1,8,8-1,MIA,9,0,30,40,70,135,117,252,3,15,18,1,2:41
19731,662481,2022-07-22,2022,NYN,SDN,1,4,4-1,SDN,9,0,34,39,73,151,126,277,6,13,19,1,3:01 (:31 delay)
19732,663306,2022-07-22,2022,ARI,WAS,10,1,10-1,ARI,9,1,40,32,72,128,159,287,15,4,19,0,2:46
19733,662167,2022-07-22,2022,SEA,HOU,2,5,5-2,HOU,9,0,38,37,75,132,165,297,12,11,23,2,3:04
19734,662344,2022-07-22,2022,OAK,TEX,5,4,5-4,OAK,9,1,38,37,75,125,145,270,14,10,24,4,2:53
19735,662589,2022-07-22,2022,LAN,SFN,5,1,5-1,LAN,9,1,37,37,74,138,147,285,14,10,24,1,3:04
19736,661409,2022-07-22,2022,CHA,CLE,2,8,8-2,CLE,9,0,37,44,81,158,156,314,11,17,28,1,3:20
19737,663060,2022-07-22,2022,CIN,SLN,9,5,9-5,CIN,9,1,35,41,76,183,150,333,11,14,25,2,3:21
19738,662658,2022-07-22,2022,KCA,TBA,3,7,7-3,TBA,9,0,39,43,82,167,156,323,13,17,30,0,3:21
19739,661193,2022-07-22,2022,MIL,COL,6,5,6-5,MIL,13,0,52,52,104,212,197,409,21,14,35,2,4:44
19740,661504,2022-07-22,2022,ATL,ANA,8,1,8-1,ATL,9,1,35,36,71,154,128,282,11,10,21,2,2:59 (:55 delay)
19741,661072,2022-07-22,2022,BAL,NYA,6,7,7-6,NYA,9,0,40,37,77,151,173,324,14,12,26,4,3:47
19742,661560,2022-07-22,2022,PHI,CHN,2,15,15-2,CHN,9,0,39,50,89,184,148,332,12,26,38,1,3:28
19743,663222,2022-07-22,2022,BOS,TOR,5,28,28-5,TOR,9,0,37,63,100,228,169,397,10,35,45,2,3:49
19744,661523,2022-07-23,2022,CHA,CLE,4,7,7-4,CLE,9,0,40,40,80,120,147,267,13,14,27,2,2:58
19745,662146,2022-07-23,2022,SEA,HOU,1,3,3-1,HOU,9,0,33,36,69,134,117,251,7,10,17,1,2:46
19746,662436,2022-07-23,2022,PIT,MIA,1,0,1-0,PIT,9,1,35,33,68,115,122,237,13,8,21,1,3:00
19747,661559,2022-07-23,2022,PHI,CHN,2,6,6-2,CHN,10,0,36,40,76,173,144,317,9,10,19,4,3:36
19748,663305,2022-07-23,2022,ARI,WAS,7,2,7-2,ARI,9,1,36,32,68,113,153,266,13,6,19,1,2:44
19749,663221,2022-07-23,2022,BOS,TOR,1,4,4-1,TOR,9,0,36,35,71,137,148,285,10,11,21,1,3:09
19750,662495,2022-07-23,2022,NYN,SDN,1,2,2-1,SDN,9,0,36,33,69,113,150,263,11,5,16,1,3:10
19751,662902,2022-07-23,2022,DET,MIN,4,8,8-4,MIN,9,0,37,40,77,167,145,312,10,12,22,3,3:21
19752,662657,2022-07-23,2022,KCA,TBA,6,3,6-3,KCA,9,1,39,35,74,135,146,281,18,10,28,1,2:58
19753,661408,2022-07-23,2022,CHA,CLE,5,4,5-4,CHA,9,1,35,37,72,151,140,291,13,10,23,2,3:06
19754,661523,2022-07-23,2022,CHA,CLE,4,7,7-4,CLE,9,0,40,40,80,120,147,267,13,14,27,2,2:58
19755,661503,2022-07-23,2022,ATL,ANA,7,2,7-2,ATL,9,1,37,35,72,132,153,285,14,8,22,0,3:01
19756,662348,2022-07-23,2022,OAK,TEX,3,1,3-1,OAK,9,1,34,37,71,167,143,310,10,11,21,4,3:14
19757,661201,2022-07-23,2022,MIL,COL,9,4,9-4,MIL,9,1,38,36,74,154,149,303,15,9,24,1,3:13
19758,662608,2022-07-23,2022,LAN,SFN,4,2,4-2,LAN,9,1,35,37,72,145,168,313,11,10,21,4,3:21
19759,661057,2022-07-23,2022,BAL,NYA,6,3,6-3,BAL,9,1,36,41,77,160,158,318,14,14,28,1,3:35
19760,663047,2022-07-23,2022,CIN,SLN,3,6,6-3,SLN,9,0,38,46,84,169,158,327,10,21,31,3,3:27
19761,661556,2022-07-24,2022,PHI,CHN,3,4,4-3,CHN,9,0,36,37,73,129,138,267,10,11,21,0,2:50
19762,663059,2022-07-24,2022,CIN,SLN,6,3,6-3,CIN,9,1,33,33,66,119,137,256,10,7,17,1,2:44
19763,662901,2022-07-24,2022,DET,MIN,1,9,9-1,MIN,9,0,32,44,76,176,123,299,5,17,22,2,3:10
19764,662357,2022-07-24,2022,PIT,MIA,5,6,6-5,MIA,10,0,42,40,82,142,176,318,11,12,23,0,3:07
19765,663220,2022-07-24,2022,BOS,TOR,4,8,8-4,TOR,9,0,37,46,83,178,149,327,12,19,31,2,3:33
19766,662656,2022-07-24,2022,KCA,TBA,4,2,4-2,KCA,9,1,37,33,70,115,137,252,14,8,22,1,2:50
19767,661056,2022-07-24,2022,BAL,NYA,0,6,6-0,NYA,9,0,37,43,80,162,150,312,10,17,27,1,3:20
19768,662145,2022-07-24,2022,SEA,HOU,5,8,8-5,HOU,9,0,39,40,79,150,148,298,13,15,28,3,3:10
19769,662458,2022-07-24,2022,NYN,SDN,8,5,8-5,NYN,9,1,39,43,82,182,146,328,16,19,35,2,3:39
19770,663316,2022-07-24,2022,ARI,WAS,3,4,4-3,WAS,9,0,43,41,84,150,168,318,17,17,34,3,3:44
19771,662343,2022-07-24,2022,OAK,TEX,8,11,11-8,TEX,9,0,43,48,91,163,153,316,16,21,37,2,3:22
19772,662682,2022-07-24,2022,LAN,SFN,7,4,7-4,LAN,9,1,39,37,76,161,150,311,16,9,25,3,3:25
19773,661407,2022-07-24,2022,CHA,CLE,6,3,6-3,CHA,9,1,33,40,73,154,99,253,9,14,23,0,2:31
19774,661184,2022-07-24,2022,MIL,COL,10,9,10-9,MIL,9,1,41,47,88,198,199,397,17,21,38,4,4:17
19775,661502,2022-07-24,2022,ATL,ANA,1,9,9-1,ANA,9,0,38,45,83,164,172,336,11,18,29,3,3:17
19776,662166,2022-07-25,2022,SEA,TEX,4,3,4-3,SEA,9,1,35,37,72,140,129,269,12,10,22,3,3:02
19777,663315,2022-07-25,2022,ARI,SFN,7,0,7-0,ARI,9,1,41,28,69,111,141,252,18,4,22,3,2:43
19778,662347,2022-07-25,2022,OAK,HOU,7,5,7-5,OAK,9,1,33,38,71,128,123,251,11,11,22,4,2:55
19779,661231,2022-07-25,2022,MIL,COL,0,2,2-0,COL,9,0,33,33,66,141,133,274,7,7,14,0,2:50
19780,661065,2022-07-25,2022,CHN,PIT,3,2,3-2,CHN,9,1,34,36,70,138,125,263,14,10,24,1,2:52
19781,663219,2022-07-25,2022,BOS,CLE,3,1,3-1,BOS,9,1,33,37,70,132,143,275,9,11,20,4,3:03 (:38 delay)
19782,661555,2022-07-25,2022,PHI,ATL,6,4,6-4,PHI,9,1,36,37,73,149,135,284,12,10,22,0,3:16
19783,662655,2022-07-25,2022,KCA,ANA,7,0,7-0,KCA,9,1,41,33,74,134,144,278,19,7,26,2,3:03
19784,661055,2022-07-25,2022,BAL,TBA,5,1,5-1,BAL,9,1,36,38,74,162,125,287,13,11,24,3,3:11
19785,662809,2022-07-25,2022,DET,SDN,12,4,12-4,DET,9,1,41,38,79,146,151,297,16,12,28,3,3:09
19786,663046,2022-07-25,2022,CIN,MIA,11,2,11-2,CIN,9,1,42,35,77,134,166,300,21,10,31,2,3:16
19787,662576,2022-07-25,2022,LAN,WAS,1,4,4-1,WAS,9,0,37,40,77,150,134,284,9,16,25,1,3:14
19788,661064,2022-07-26,2022,CHN,PIT,4,2,4-2,CHN,9,1,34,32,66,128,113,241,11,4,15,0,2:30
19789,661054,2022-07-26,2022,BAL,TBA,5,3,5-3,BAL,9,1,30,39,69,147,104,251,7,13,20,3,2:43
19790,662184,2022-07-26,2022,SEA,TEX,5,4,5-4,SEA,9,0,39,36,75,123,137,260,16,11,27,2,2:59
19791,661563,2022-07-26,2022,PHI,ATL,3,6,6-3,ATL,9,0,34,38,72,149,145,294,7,12,19,1,3:10
19792,661079,2022-07-26,2022,COL,CHA,1,2,2-1,CHA,9,0,37,38,75,138,151,289,14,12,26,1,3:16
19793,663314,2022-07-26,2022,ARI,SFN,7,3,7-3,ARI,9,1,34,37,71,150,155,305,10,10,20,3,3:10
19794,661716,2022-07-26,2022,TOR,SLN,10,3,10-3,TOR,9,1,39,39,78,149,153,302,18,13,31,3,3:14
19795,662573,2022-07-26,2022,LAN,WAS,3,8,8-3,WAS,9,0,37,43,80,154,150,304,9,16,25,2,3:27
19796,662653,2022-07-26,2022,KCA,ANA,0,6,6-0,ANA,9,0,36,43,79,154,155,309,9,19,28,3,3:24
19797,663203,2022-07-26,2022,BOS,CLE,3,8,8-3,CLE,9,0,37,43,80,176,163,339,11,17,28,1,3:20
19798,663029,2022-07-26,2022,CIN,MIA,1,2,2-1,MIA,9,0,29,39,68,146,112,258,2,13,15,1,2:45
19799,662813,2022-07-26,2022,DET,SDN,4,6,6-4,SDN,10,0,42,45,87,170,149,319,13,15,28,1,3:43
19800,662346,2022-07-26,2022,OAK,HOU,5,3,5-3,OAK,9,1,35,36,71,126,155,281,11,12,23,3,3:04
19801,662438,2022-07-26,2022,NYN,NYA,6,3,6-3,NYN,9,1,35,40,75,154,145,299,12,13,25,2,3:27
19802,661281,2022-07-26,2022,MIL,MIN,7,6,7-6,MIL,9,0,43,39,82,142,183,325,17,13,30,1,3:30
19803,663028,2022-07-27,2022,CIN,MIA,5,3,5-3,CIN,9,1,33,34,67,111,135,246,10,8,18,0,2:32
19804,662652,2022-07-27,2022,KCA,ANA,0,4,4-0,ANA,9,0,35,37,72,136,133,269,8,13,21,2,2:48
19805,662420,2022-07-27,2022,NYN,NYA,3,2,3-2,NYN,9,0,38,38,76,131,142,273,13,11,24,3,3:09
19806,663294,2022-07-27,2022,ARI,SFN,5,3,5-3,ARI,9,1,34,37,71,158,122,280,9,10,19,3,3:03
19807,662900,2022-07-27,2022,DET,SDN,4,3,4-3,DET,9,0,36,36,72,143,137,280,11,9,20,1,3:03 (:20 delay)
19808,663191,2022-07-27,2022,BOS,CLE,6,7,7-6,CLE,9,0,37,42,79,143,137,280,11,13,24,2,3:02
19809,661249,2022-07-27,2022,MIL,MIN,10,4,10-4,MIL,9,1,41,37,78,149,188,337,18,9,27,1,3:27
19810,661053,2022-07-27,2022,BAL,TBA,4,6,6-4,TBA,10,0,43,42,85,163,146,309,14,15,29,4,3:46
19811,661715,2022-07-27,2022,TOR,SLN,1,6,6-1,SLN,9,0,31,39,70,155,122,277,5,16,21,1,2:57
19812,662165,2022-07-27,2022,SEA,TEX,4,2,4-2,SEA,9,1,34,35,69,125,117,242,10,8,18,2,2:40
19813,661554,2022-07-27,2022,PHI,ATL,7,2,7-2,PHI,9,1,35,35,70,145,126,271,12,8,20,1,2:54
19814,662345,2022-07-27,2022,OAK,HOU,4,2,4-2,OAK,9,1,33,34,67,115,137,252,9,8,17,1,2:27
19815,662565,2022-07-27,2022,LAN,WAS,7,1,7-1,LAN,9,1,39,35,74,147,168,315,18,10,28,2,3:03
19816,661078,2022-07-27,2022,COL,CHA,6,5,6-5,COL,9,0,44,37,81,132,181,313,22,13,35,3,3:36
19817,661052,2022-07-28,2022,BAL,TBA,3,0,3-0,BAL,9,1,31,37,68,162,102,264,7,10,17,2,2:54
19818,663380,2022-07-28,2022,ANA,TEX,0,2,2-0,TEX,9,0,32,35,67,136,124,260,5,10,15,0,2:47
19819,663200,2022-07-28,2022,BOS,CLE,4,2,4-2,BOS,9,1,32,33,65,118,110,228,9,7,16,1,2:33
19820,662058,2022-07-28,2022,SFN,CHN,4,2,4-2,SFN,9,1,35,32,67,125,144,269,10,6,16,3,3:00
19821,661077,2022-07-28,2022,COL,LAN,0,13,13-0,LAN,9,0,35,47,82,184,130,314,9,19,28,1,3:06
19822,662907,2022-07-28,2022,HOU,SEA,4,2,4-2,HOU,9,1,33,33,66,137,131,268,9,7,16,1,2:51
19823,661257,2022-07-28,2022,NYA,KCA,1,0,1-0,NYA,9,0,29,35,64,146,119,265,4,8,12,0,2:38
19824,661714,2022-07-28,2022,TOR,DET,5,3,5-3,TOR,9,1,37,35,72,126,140,266,13,7,20,2,2:52
19825,662326,2022-07-28,2022,PIT,PHI,7,8,8-7,PHI,9,0,39,42,81,152,138,290,13,15,28,2,3:11
19826,663027,2022-07-28,2022,CIN,MIA,6,7,7-6,MIA,9,0,40,39,79,143,169,312,14,14,28,5,3:40
19827,661871,2022-07-29,2022,TBA,CLE,1,4,4-1,CLE,9,0,34,38,72,162,122,284,8,11,19,0,2:43
19828,661256,2022-07-29,2022,NYA,KCA,11,5,11-5,NYA,9,1,41,37,78,144,151,295,16,10,26,1,3:12 (:23 delay)
19829,662268,2022-07-29,2022,SDN,MIN,10,1,10-1,SDN,9,1,37,32,69,123,140,263,13,6,19,1,2:47
19830,663026,2022-07-29,2022,CIN,BAL,2,6,6-2,BAL,9,0,34,42,76,159,146,305,10,16,26,5,3:29
19831,662477,2022-07-29,2022,WAS,SLN,2,6,6-2,SLN,9,0,36,35,71,143,120,263,9,8,17,1,2:42
19832,661406,2022-07-29,2022,CHA,OAK,3,7,7-3,OAK,9,0,34,37,71,152,123,275,7,9,16,1,2:54
19833,663379,2022-07-29,2022,ANA,TEX,2,7,7-2,TEX,9,0,34,40,74,155,128,283,6,13,19,2,3:13
19834,661713,2022-07-29,2022,TOR,DET,2,4,4-2,DET,9,0,34,41,75,159,152,311,7,14,21,2,3:20
19835,663190,2022-07-29,2022,BOS,MIL,1,4,4-1,MIL,9,0,36,39,75,139,153,292,9,16,25,3,3:27
19836,662745,2022-07-29,2022,HOU,SEA,11,1,11-1,HOU,9,1,47,34,81,112,183,295,23,8,31,2,3:06
19837,661372,2022-07-29,2022,MIA,NYN,4,6,6-4,NYN,9,0,37,44,81,169,139,308,12,18,30,0,3:16
19838,662057,2022-07-29,2022,SFN,CHN,2,4,4-2,CHN,9,0,42,38,80,152,152,304,16,11,27,2,3:17
19839,661076,2022-07-29,2022,COL,LAN,4,5,5-4,LAN,9,0,34,45,79,169,136,305,8,18,26,1,3:12
19840,661501,2022-07-29,2022,ATL,ARI,5,2,5-2,ATL,9,1,33,38,71,132,123,255,12,10,22,1,2:40
19841,662435,2022-07-29,2022,PIT,PHI,2,4,4-2,PHI,10,0,38,42,80,161,135,296,10,14,24,3,3:30
19842,662415,2022-07-30,2022,PIT,PHI,1,2,2-1,PHI,10,0,35,38,73,139,136,275,6,10,16,0,2:54
19843,662476,2022-07-30,2022,WAS,SLN,7,6,7-6,WAS,9,1,37,38,75,140,140,280,13,13,26,5,3:18
19844,662112,2022-07-30,2022,SFN,CHN,5,4,5-4,SFN,9,1,36,40,76,153,156,309,12,12,24,3,3:06
19845,661451,2022-07-30,2022,CHA,OAK,3,2,3-2,CHA,9,0,36,35,71,128,132,260,12,9,21,1,2:50
19846,661371,2022-07-30,2022,MIA,NYN,0,4,4-0,NYN,9,0,30,37,67,133,107,240,6,11,17,2,2:35
19847,661712,2022-07-30,2022,TOR,DET,5,3,5-3,TOR,9,1,31,39,70,128,116,244,9,14,23,3,2:46
19848,663025,2022-07-30,2022,CIN,BAL,8,2,8-2,CIN,9,1,38,31,69,136,141,277,15,6,21,1,2:54
19849,661499,2022-07-30,2022,ATL,ARI,6,2,6-2,ATL,9,1,36,34,70,155,152,307,13,6,19,0,2:51
19850,662989,2022-07-30,2022,COL,LAN,5,3,5-3,COL,9,1,34,35,69,132,125,257,11,8,19,2,2:43
19851,661870,2022-07-30,2022,TBA,CLE,6,4,6-4,TBA,9,1,36,39,75,138,148,286,13,12,25,1,2:58
19852,663378,2022-07-30,2022,ANA,TEX,9,7,9-7,ANA,9,1,40,40,80,161,135,296,17,15,32,1,3:04
19853,662196,2022-07-30,2022,SDN,MIN,4,7,7-4,MIN,9,0,39,38,77,162,156,318,12,13,25,2,3:34
19854,662738,2022-07-30,2022,HOU,SEA,4,5,5-4,SEA,9,0,39,38,77,150,161,311,13,13,26,2,3:28
19855,661255,2022-07-30,2022,NYA,KCA,8,2,8-2,NYA,9,1,40,36,76,155,177,332,15,10,25,2,3:20
19856,663192,2022-07-30,2022,BOS,MIL,4,9,9-4,MIL,9,0,40,46,86,179,185,364,14,21,35,3,3:49
19857,661711,2022-07-31,2022,TOR,DET,4,1,4-1,TOR,9,1,33,31,64,107,117,224,8,4,12,0,2:19
19858,661498,2022-07-31,2022,ATL,ARI,1,0,1-0,ATL,9,0,31,32,63,134,107,241,7,8,15,0,2:52
19859,661388,2022-07-31,2022,CHA,OAK,4,1,4-1,CHA,9,1,31,33,64,144,120,264,8,8,16,1,2:42
19860,663377,2022-07-31,2022,ANA,TEX,2,5,5-2,TEX,9,0,36,35,71,145,132,277,12,10,22,1,2:56
19861,662918,2022-07-31,2022,HOU,SEA,3,2,3-2,HOU,10,0,39,37,76,142,146,288,12,7,19,0,3:08
19862,661370,2022-07-31,2022,MIA,NYN,3,9,9-3,NYN,9,0,40,46,86,168,166,334,13,21,34,2,3:23
19863,662988,2022-07-31,2022,COL,LAN,3,7,7-3,LAN,9,0,36,41,77,146,163,309,10,15,25,2,3:11
19864,661869,2022-07-31,2022,TBA,CLE,3,5,5-3,CLE,9,0,38,41,79,163,147,310,13,14,27,3,3:03
19865,661254,2022-07-31,2022,NYA,KCA,6,8,8-6,KCA,9,0,40,42,82,182,169,351,13,16,29,5,4:00
19866,662267,2022-07-31,2022,SDN,MIN,3,2,3-2,SDN,9,1,32,34,66,114,137,251,7,8,15,1,2:45
19867,662475,2022-07-31,2022,WAS,SLN,0,5,5-0,SLN,9,0,31,40,71,165,112,277,6,12,18,1,2:50
19868,662071,2022-07-31,2022,SFN,CHN,4,0,4-0,SFN,9,1,39,31,70,132,151,283,16,4,20,1,2:58
19869,663024,2022-07-31,2022,CIN,BAL,3,2,3-2,CIN,9,1,33,37,70,150,143,293,11,10,21,5,3:22
19870,663189,2022-07-31,2022,BOS,MIL,7,2,7-2,BOS,9,1,38,37,75,137,151,288,14,14,28,3,2:58
19871,662414,2022-07-31,2022,PIT,PHI,2,8,8-2,PHI,9,0,37,43,80,150,141,291,11,18,29,1,3:07
19872,662224,2022-08-01,2022,SDN,COL,4,1,4-1,SDN,9,1,33,35,68,132,138,270,12,8,20,1,2:51
19873,662737,2022-08-01,2022,HOU,BOS,2,3,3-2,BOS,9,0,36,33,69,129,146,275,9,7,16,1,3:02
19874,661387,2022-08-01,2022,CHA,KCA,1,2,2-1,KCA,9,0,37,33,70,123,146,269,11,7,18,2,2:55
19875,661369,2022-08-01,2022,MIA,CIN,1,3,3-1,CIN,9,0,36,37,73,147,137,284,9,11,20,1,2:55
19876,661820,2022-08-01,2022,TEX,BAL,2,7,7-2,BAL,9,0,33,44,77,157,127,284,7,16,23,1,2:55
19877,662070,2022-08-01,2022,SFN,LAN,2,8,8-2,LAN,9,0,35,40,75,148,137,285,8,15,23,0,2:50
19878,661268,2022-08-01,2022,NYA,SEA,7,2,7-2,NYA,9,1,37,36,73,142,143,285,13,10,23,1,2:58
19879,662474,2022-08-01,2022,WAS,NYN,3,7,7-3,NYN,9,0,36,42,78,176,139,315,9,18,27,4,3:20
19880,661671,2022-08-01,2022,MIN,DET,5,3,5-3,MIN,10,0,42,38,80,141,158,299,15,8,23,2,3:17
19881,662947,2022-08-01,2022,CLE,ARI,6,5,6-5,CLE,11,0,47,43,90,154,173,327,16,12,28,4,3:42
19882,661868,2022-08-02,2022,TBA,TOR,1,3,3-1,TOR,9,0,30,36,66,145,112,257,4,11,15,0,2:45
19883,663376,2022-08-02,2022,ANA,OAK,3,1,3-1,ANA,9,1,31,37,68,135,111,246,9,11,20,1,2:33
19884,661959,2022-08-02,2022,SLN,CHN,6,0,6-0,SLN,9,1,35,34,69,131,133,264,14,9,23,1,2:37
19885,662736,2022-08-02,2022,HOU,BOS,1,2,2-1,BOS,9,0,37,32,69,134,141,275,11,6,17,1,2:59
19886,661386,2022-08-02,2022,CHA,KCA,9,2,9-2,CHA,9,1,40,37,77,137,121,258,17,10,27,1,2:52
19887,661368,2022-08-02,2022,MIA,CIN,1,2,2-1,CIN,9,0,32,37,69,151,113,264,5,9,14,2,2:46
19888,662529,2022-08-02,2022,WAS,NYN,5,1,5-1,WAS,9,1,33,35,68,124,133,257,10,9,19,1,2:48
19889,661661,2022-08-02,2022,MIN,DET,3,5,5-3,DET,9,0,37,37,74,153,128,281,12,11,23,2,3:10
19890,662941,2022-08-02,2022,CLE,ARI,3,6,6-3,ARI,9,0,36,36,72,137,141,278,10,11,21,1,2:50
19891,662298,2022-08-02,2022,PIT,MIL,5,3,5-3,PIT,9,1,35,39,74,141,142,283,11,12,23,3,3:02
19892,662056,2022-08-02,2022,SFN,LAN,5,9,9-5,LAN,9,0,37,41,78,147,130,277,11,15,26,3,3:03
19893,661819,2022-08-02,2022,TEX,BAL,2,8,8-2,BAL,9,0,39,40,79,161,159,320,12,14,26,3,3:17
19894,662220,2022-08-02,2022,SDN,COL,3,2,3-2,SDN,9,0,35,36,71,173,148,321,10,10,20,2,3:10
19895,661496,2022-08-02,2022,ATL,PHI,13,1,13-1,ATL,9,1,43,36,79,151,177,328,22,9,31,4,3:27
19896,662250,2022-08-02,2022,SDN,COL,13,5,13-5,SDN,9,1,47,39,86,143,176,319,26,14,40,2,3:35
19897,661253,2022-08-02,2022,NYA,SEA,6,8,8-6,SEA,9,0,40,39,79,166,161,327,17,12,29,5,3:43 (:11 delay)
19898,661367,2022-08-03,2022,MIA,CIN,3,0,3-0,MIA,9,1,33,31,64,105,112,217,11,7,18,1,2:09
19899,661385,2022-08-03,2022,CHA,KCA,4,1,4-1,CHA,9,1,36,32,68,131,120,251,14,5,19,0,2:35 (1:05 delay)
19900,661664,2022-08-03,2022,MIN,DET,4,1,4-1,MIN,9,1,33,33,66,128,128,256,10,7,17,0,2:40
19901,661500,2022-08-03,2022,ATL,PHI,1,3,3-1,PHI,9,0,33,36,69,135,121,256,7,9,16,3,2:40
19902,662725,2022-08-03,2022,HOU,BOS,6,1,6-1,HOU,9,1,36,33,69,126,137,263,13,6,19,1,2:42
19903,661867,2022-08-03,2022,TBA,TOR,3,2,3-2,TBA,9,1,34,33,67,126,145,271,10,6,16,1,2:48
19904,662055,2022-08-03,2022,SFN,LAN,0,3,3-0,LAN,9,0,37,37,74,141,133,274,11,10,21,2,3:06
19905,661293,2022-08-03,2022,NYA,SEA,3,7,7-3,SEA,9,0,34,36,70,132,130,262,8,11,19,2,2:47
19906,662946,2022-08-03,2022,CLE,ARI,7,4,7-4,CLE,9,1,36,36,72,162,142,304,13,9,22,1,3:03
19907,662244,2022-08-03,2022,SDN,COL,9,1,9-1,SDN,9,1,39,34,73,161,152,313,16,7,23,0,3:04
19908,661818,2022-08-03,2022,TEX,BAL,3,6,6-3,BAL,9,0,38,42,80,165,147,312,11,16,27,3,3:24
19909,662324,2022-08-03,2022,PIT,MIL,8,7,8-7,PIT,9,0,38,43,81,174,151,325,15,17,32,6,3:49
19910,662552,2022-08-03,2022,WAS,NYN,5,9,9-5,NYN,9,0,39,45,84,188,142,330,14,19,33,2,3:18
19911,663375,2022-08-03,2022,ANA,OAK,1,3,3-1,OAK,9,0,36,36,72,138,136,274,9,9,18,2,3:08
19912,661817,2022-08-04,2022,TEX,CHA,3,2,3-2,TEX,9,1,32,38,70,165,106,271,12,11,23,0,2:45
19913,661565,2022-08-04,2022,PHI,WAS,5,4,5-4,PHI,5,0,19,25,44,79,71,150,7,11,18,0,1:39 (2:06 delay)
19914,662651,2022-08-04,2022,KCA,BOS,7,3,7-3,KCA,9,1,36,35,71,147,138,285,14,10,24,0,3:04
19915,662419,2022-08-04,2022,NYN,ATL,6,4,6-4,NYN,9,1,35,35,70,135,130,265,12,8,20,0,2:49
19916,661945,2022-08-04,2022,SLN,CHN,4,3,4-3,SLN,9,0,33,38,71,139,125,264,9,10,19,2,2:51
19917,662812,2022-08-04,2022,DET,TBA,2,6,6-2,TBA,9,0,34,42,76,142,126,268,6,17,23,0,2:59
19918,662975,2022-08-04,2022,CLE,HOU,0,6,6-0,HOU,9,0,32,44,76,157,128,285,4,17,21,1,3:03
19919,662219,2022-08-04,2022,SDN,COL,3,7,7-3,COL,9,0,39,39,78,163,175,338,15,15,30,2,3:41
19920,662303,2022-08-04,2022,PIT,MIL,5,4,5-4,PIT,10,0,41,42,83,156,133,289,19,16,35,2,3:22
19921,661932,2022-08-04,2022,SLN,CHN,7,2,7-2,SLN,9,1,41,32,73,140,176,316,20,8,28,0,3:08
19922,663374,2022-08-04,2022,ANA,OAK,7,8,8-7,OAK,9,0,38,41,79,180,152,332,12,16,28,3,3:27
19923,661945,2022-08-04,2022,SLN,CHN,4,3,4-3,SLN,9,0,33,38,71,139,125,264,9,10,19,2,2:51
19924,662114,2022-08-04,2022,SFN,LAN,3,5,5-3,LAN,9,0,33,37,70,171,130,301,7,10,17,1,3:08
19925,661660,2022-08-04,2022,MIN,TOR,3,9,9-3,TOR,9,0,36,44,80,194,143,337,9,19,28,1,3:34
19926,662945,2022-08-05,2022,CLE,HOU,3,9,9-3,HOU,9,0,38,41,79,161,131,292,13,16,29,2,3:01
19927,661174,2022-08-05,2022,MIL,CIN,5,1,5-1,MIL,9,1,38,37,75,140,155,295,14,12,26,2,3:14
19928,661048,2022-08-05,2022,BAL,PIT,1,0,1-0,BAL,9,1,36,33,69,128,115,243,14,7,21,2,2:42 (1:49 delay)
19929,662564,2022-08-05,2022,LAN,SDN,8,1,8-1,LAN,9,1,39,34,73,167,148,315,15,7,22,1,3:03
19930,661562,2022-08-05,2022,PHI,WAS,7,2,7-2,PHI,9,1,35,33,68,124,123,247,12,7,19,1,2:46
19931,661816,2022-08-05,2022,TEX,CHA,1,2,2-1,CHA,9,0,36,34,70,151,129,280,8,8,16,0,3:00
19932,662164,2022-08-05,2022,SEA,ANA,3,4,4-3,ANA,10,0,42,38,80,150,181,331,14,11,25,1,3:36
19933,662418,2022-08-05,2022,NYN,ATL,6,9,9-6,ATL,9,0,43,44,87,153,170,323,17,18,35,4,3:38
19934,662811,2022-08-05,2022,DET,TBA,3,5,5-3,TBA,9,0,37,45,82,191,140,331,11,20,31,4,3:40
19935,661063,2022-08-05,2022,CHN,MIA,2,1,2-1,CHN,9,1,32,39,71,169,146,315,9,11,20,4,3:20
19936,663313,2022-08-05,2022,ARI,COL,6,5,6-5,ARI,9,1,37,40,77,136,157,293,14,13,27,2,3:02
19937,662650,2022-08-05,2022,KCA,BOS,4,7,7-4,BOS,9,0,41,44,85,187,156,343,14,18,32,4,3:44
19938,661946,2022-08-05,2022,SLN,NYA,4,3,4-3,SLN,9,1,35,39,74,156,141,297,11,15,26,3,3:19
19939,661659,2022-08-05,2022,MIN,TOR,6,5,6-5,MIN,10,0,43,41,84,159,152,311,16,13,29,2,3:24
19940,661062,2022-08-06,2022,CHN,MIA,4,0,4-0,CHN,9,1,36,32,68,130,131,261,13,6,19,2,2:46
19941,661662,2022-08-06,2022,MIN,TOR,7,3,7-3,MIN,9,1,40,38,78,138,164,302,15,11,26,5,3:32
19942,661815,2022-08-06,2022,TEX,CHA,8,0,8-0,TEX,9,1,38,30,68,134,175,309,13,3,16,1,3:00
19943,662417,2022-08-06,2022,NYN,ATL,6,2,6-2,NYN,9,1,37,34,71,141,129,270,11,7,18,0,3:02
19944,662154,2022-08-06,2022,SEA,ANA,2,1,2-1,SEA,9,1,34,35,69,112,145,257,10,8,18,2,2:48
19945,662193,2022-08-06,2022,SEA,ANA,1,7,7-1,ANA,9,0,35,39,74,151,130,281,9,11,20,0,2:47
19946,662937,2022-08-06,2022,CLE,HOU,4,1,4-1,CLE,9,1,35,33,68,130,109,239,11,7,18,0,2:30
19947,661949,2022-08-06,2022,SLN,NYA,1,0,1-0,SLN,9,1,29,31,60,145,131,276,7,5,12,2,3:06
19948,661050,2022-08-06,2022,BAL,PIT,6,3,6-3,BAL,9,1,42,35,77,131,163,294,18,9,27,3,3:17
19949,663288,2022-08-06,2022,ARI,COL,2,3,3-2,COL,9,0,34,34,68,117,121,238,10,11,21,1,2:33
19950,661561,2022-08-06,2022,PHI,WAS,11,5,11-5,PHI,9,1,42,44,86,174,186,360,18,18,36,2,3:39
19951,661173,2022-08-06,2022,MIL,CIN,5,7,7-5,CIN,9,0,40,42,82,155,177,332,15,16,31,3,3:30
19952,662499,2022-08-06,2022,NYN,ATL,8,5,8-5,NYN,9,1,44,44,88,165,172,337,22,18,40,5,3:53
19953,662308,2022-08-06,2022,OAK,SFN,3,7,7-3,SFN,9,0,38,44,82,153,167,320,11,17,28,2,3:21
19954,662649,2022-08-06,2022,KCA,BOS,5,4,5-4,KCA,9,0,33,36,69,130,126,256,8,9,17,0,2:44
19955,662654,2022-08-06,2022,LAN,SDN,8,3,8-3,LAN,9,1,37,36,73,139,136,275,12,8,20,3,3:08
19956,662856,2022-08-06,2022,DET,TBA,9,1,9-1,DET,9,1,36,39,75,153,123,276,13,12,25,2,2:54
19957,662944,2022-08-07,2022,CLE,HOU,1,0,1-0,CLE,9,1,34,29,63,100,129,229,10,3,13,1,2:29
19958,662563,2022-08-07,2022,LAN,SDN,4,0,4-0,LAN,9,1,35,30,65,114,137,251,11,4,15,0,2:48
19959,662810,2022-08-07,2022,DET,TBA,0,7,7-0,TBA,9,0,30,41,71,151,110,261,3,15,18,1,2:50
19960,661558,2022-08-07,2022,PHI,WAS,13,1,13-1,PHI,9,1,46,36,82,136,154,290,22,10,32,1,3:19
19961,661061,2022-08-07,2022,CHN,MIA,0,3,3-0,MIA,9,0,31,36,67,137,121,258,4,11,15,0,2:36 (:56 delay)
19962,661049,2022-08-07,2022,BAL,PIT,1,8,8-1,PIT,9,0,32,39,71,158,120,278,5,12,17,3,2:58
19963,662416,2022-08-07,2022,NYN,ATL,5,2,5-2,NYN,9,1,37,30,67,120,150,270,14,3,17,2,2:58 (:20 delay)
19964,661172,2022-08-07,2022,MIL,CIN,2,4,4-2,CIN,10,0,39,40,79,169,174,343,11,11,22,2,3:47
19965,662153,2022-08-07,2022,SEA,ANA,6,3,6-3,SEA,9,1,36,35,71,130,161,291,13,9,22,1,2:54
19966,662648,2022-08-07,2022,KCA,BOS,13,5,13-5,KCA,9,1,40,38,78,137,141,278,18,13,31,3,3:00
19967,663300,2022-08-07,2022,ARI,COL,6,4,6-4,ARI,9,1,36,41,77,153,129,282,15,17,32,3,3:17
19968,661835,2022-08-07,2022,TEX,CHA,2,8,8-2,CHA,9,0,40,45,85,156,172,328,14,17,31,1,3:27
19969,662332,2022-08-07,2022,OAK,SFN,4,6,6-4,SFN,9,0,41,41,82,150,153,303,14,16,30,2,3:18
19970,661948,2022-08-07,2022,SLN,NYA,12,9,12-9,SLN,9,1,44,48,92,207,173,380,20,22,42,5,4:25
19971,661653,2022-08-07,2022,MIN,TOR,2,3,3-2,TOR,10,0,42,39,81,170,142,312,12,12,24,2,3:41
19972,662331,2022-08-08,2022,OAK,ANA,0,1,1-0,ANA,9,0,31,30,61,109,112,221,4,5,9,0,2:14
19973,662218,2022-08-08,2022,SDN,SFN,0,1,1-0,SFN,9,0,31,36,67,162,114,276,6,9,15,2,3:15
19974,661047,2022-08-08,2022,BAL,TOR,7,4,7-4,BAL,9,1,33,41,74,148,116,264,13,15,28,4,2:55
19975,663304,2022-08-08,2022,ARI,PIT,3,0,3-0,ARI,9,1,32,30,62,112,119,231,9,6,15,2,2:36
19976,661060,2022-08-08,2022,CHN,WAS,6,3,6-3,CHN,9,1,37,36,73,140,142,282,15,10,25,1,2:48
19977,662152,2022-08-08,2022,SEA,NYA,4,9,9-4,NYA,9,0,37,44,81,171,147,318,10,17,27,2,3:24
19978,662445,2022-08-08,2022,NYN,CIN,5,1,5-1,NYN,9,1,36,39,75,133,133,266,13,12,25,1,2:56
19979,662444,2022-08-09,2022,NYN,CIN,6,2,6-2,NYN,9,1,36,38,74,135,143,278,15,11,26,3,2:59 (:51 delay)
19980,662647,2022-08-09,2022,KCA,CHA,4,2,4-2,KCA,9,1,35,36,71,132,113,245,10,9,19,2,2:36
19981,662793,2022-08-09,2022,DET,CLE,2,5,5-2,CLE,9,0,36,37,73,119,127,246,9,12,21,1,2:41
19982,662979,2022-08-09,2022,COL,SLN,16,5,16-5,COL,9,1,48,40,88,151,156,307,24,13,37,3,3:05
19983,661046,2022-08-09,2022,BAL,TOR,6,5,6-5,BAL,9,1,38,38,76,133,130,263,15,12,27,2,3:02 (1:18 delay)
19984,661553,2022-08-09,2022,PHI,MIA,4,1,4-1,PHI,9,1,31,36,67,144,123,267,10,9,19,1,2:46 (1:00 delay)
19985,662246,2022-08-09,2022,SDN,SFN,7,4,7-4,SDN,9,0,39,40,79,153,160,313,15,14,29,3,3:32
19986,661182,2022-08-09,2022,MIL,TBA,5,3,5-3,MIL,9,1,36,31,67,118,147,265,13,5,18,1,2:46
19987,662779,2022-08-09,2022,KCA,CHA,2,3,3-2,CHA,9,0,34,37,71,146,129,275,7,11,18,2,2:54
19988,662562,2022-08-09,2022,LAN,MIN,10,3,10-3,LAN,9,1,41,34,75,126,177,303,17,7,24,1,3:13
19989,662724,2022-08-09,2022,HOU,TEX,7,5,7-5,HOU,9,1,33,38,71,153,115,268,10,12,22,1,2:49
19990,663303,2022-08-09,2022,ARI,PIT,6,4,6-4,ARI,9,1,38,37,75,125,142,267,15,10,25,4,3:00
19991,662330,2022-08-09,2022,OAK,ANA,1,5,5-1,ANA,9,0,35,43,78,162,141,303,10,15,25,2,3:15
19992,661059,2022-08-09,2022,CHN,WAS,5,6,6-5,WAS,9,0,42,37,79,149,160,309,17,12,29,2,3:17
19993,662148,2022-08-09,2022,SEA,NYA,1,0,1-0,SEA,13,0,45,42,87,178,189,367,14,9,23,1,4:07
19994,663201,2022-08-09,2022,BOS,ATL,7,9,9-7,ATL,11,0,46,51,97,200,186,386,15,21,36,4,4:13
19995,661207,2022-08-10,2022,MIL,TBA,4,3,4-3,MIL,10,0,38,36,74,126,150,276,12,7,19,1,3:03
19996,661557,2022-08-10,2022,PHI,MIA,4,3,4-3,PHI,9,1,32,35,67,131,93,224,9,11,20,1,2:38
19997,662791,2022-08-10,2022,DET,CLE,2,3,3-2,CLE,9,0,37,35,72,137,148,285,10,9,19,1,3:02
19998,662185,2022-08-10,2022,SEA,NYA,4,3,4-3,SEA,9,1,29,36,65,144,122,266,6,9,15,2,2:44
19999,662723,2022-08-10,2022,HOU,TEX,4,8,8-4,TEX,10,0,44,43,87,161,165,326,14,15,29,1,3:41
20000,662639,2022-08-10,2022,KCA,CHA,8,3,8-3,KCA,9,1,40,38,78,153,150,303,18,10,28,2,3:19
20001,663188,2022-08-10,2022,BOS,ATL,4,8,8-4,ATL,9,0,37,39,76,174,139,313,11,14,25,2,3:06
20002,663229,2022-08-10,2022,CHN,WAS,4,2,4-2,CHN,9,1,34,36,70,134,126,260,11,10,21,3,2:45
20003,662443,2022-08-10,2022,NYN,CIN,10,2,10-2,NYN,9,1,40,38,78,121,180,301,20,11,31,0,3:01
20004,662217,2022-08-10,2022,SDN,SFN,13,7,13-7,SDN,9,1,43,43,86,154,165,319,19,18,37,4,3:32
20005,662892,2022-08-10,2022,COL,SLN,5,9,9-5,SLN,9,0,41,46,87,169,153,322,15,21,36,1,3:21
20006,662575,2022-08-10,2022,LAN,MIN,8,5,8-5,LAN,9,1,37,39,76,165,142,307,14,12,26,2,3:15
20007,663302,2022-08-10,2022,ARI,PIT,4,6,6-4,PIT,9,0,36,41,77,159,147,306,11,16,27,2,3:12
20008,662316,2022-08-10,2022,OAK,ANA,4,5,5-4,ANA,12,0,45,44,89,164,171,335,13,10,23,4,3:45
20009,663023,2022-08-11,2022,CIN,CHN,2,4,4-2,CHN,9,0,37,41,78,161,151,312,11,16,27,2,3:21
20010,661608,2022-08-11,2022,PHI,MIA,0,3,3-0,MIA,9,0,37,36,73,128,165,293,11,9,20,2,3:07
20011,662722,2022-08-11,2022,HOU,TEX,7,3,7-3,HOU,9,1,37,38,75,156,139,295,13,11,24,1,2:53
20012,663274,2022-08-11,2022,BOS,BAL,4,3,4-3,BOS,9,1,31,36,67,134,119,253,9,10,19,2,2:46
20013,662891,2022-08-11,2022,COL,SLN,8,6,8-6,COL,9,1,37,40,77,176,142,318,15,15,30,3,3:15
20014,663293,2022-08-11,2022,ARI,PIT,9,3,9-3,ARI,9,1,39,36,75,152,164,316,16,8,24,3,3:20
20015,662645,2022-08-11,2022,KCA,CHA,5,3,5-3,KCA,9,1,35,41,76,145,153,298,12,15,27,3,3:11
20016,662790,2022-08-11,2022,DET,CLE,3,4,4-3,CLE,10,0,40,43,83,168,161,329,11,12,23,3,3:37
20017,661710,2022-08-12,2022,TOR,CLE,0,8,8-0,CLE,9,0,29,45,74,150,132,282,3,19,22,0,2:33
20018,662817,2022-08-12,2022,HOU,OAK,7,5,7-5,HOU,9,1,37,38,75,140,142,282,15,15,30,4,3:19
20019,662978,2022-08-12,2022,COL,ARI,5,3,5-3,COL,9,1,33,34,67,132,120,252,8,8,16,1,2:33
20020,661384,2022-08-12,2022,CHA,DET,2,0,2-0,CHA,9,1,36,32,68,134,123,257,15,6,21,1,2:53
20021,662434,2022-08-12,2022,NYN,PHI,1,2,2-1,PHI,10,0,35,40,75,137,120,257,9,11,20,0,2:54
20022,661866,2022-08-12,2022,TBA,BAL,3,10,10-3,BAL,9,0,34,46,80,144,141,285,6,21,27,3,3:07
20023,661366,2022-08-12,2022,MIA,ATL,3,4,4-3,ATL,9,0,43,34,77,148,186,334,19,8,27,2,3:37
20024,661947,2022-08-12,2022,SLN,MIL,3,1,3-1,SLN,9,1,33,36,69,161,129,290,9,10,19,1,2:53
20025,663177,2022-08-12,2022,BOS,NYA,3,2,3-2,BOS,10,0,37,41,78,168,145,313,12,13,25,1,3:24
20026,663373,2022-08-12,2022,ANA,MIN,0,4,4-0,MIN,9,0,33,37,70,157,123,280,7,13,20,0,2:56
20027,662551,2022-08-12,2022,WAS,SDN,5,10,10-5,SDN,9,0,44,49,93,195,190,385,17,20,37,3,4:03
20028,662671,2022-08-12,2022,KCA,LAN,3,8,8-3,LAN,9,0,36,42,78,192,126,318,8,15,23,3,3:12
20029,661791,2022-08-12,2022,TEX,SEA,2,6,6-2,SEA,9,0,36,44,80,198,139,337,11,17,28,3,3:44
20030,662111,2022-08-12,2022,SFN,PIT,5,3,5-3,SFN,9,1,37,38,75,158,154,312,15,11,26,4,3:15
20031,662428,2022-08-13,2022,NYN,PHI,1,0,1-0,NYN,9,1,28,32,60,130,96,226,5,5,10,0,2:24
20032,661383,2022-08-13,2022,CHA,DET,6,4,6-4,CHA,9,1,39,37,76,124,129,253,15,12,27,2,2:46
20033,662882,2022-08-13,2022,COL,ARI,0,6,6-0,ARI,9,0,31,38,69,131,139,270,5,13,18,1,2:47
20034,663022,2022-08-13,2022,CIN,CHN,2,7,7-2,CHN,9,0,40,40,80,138,174,312,13,14,27,2,3:20
20035,661360,2022-08-13,2022,MIA,ATL,2,6,6-2,ATL,9,0,36,38,74,157,147,304,9,12,21,3,3:12
20036,661709,2022-08-13,2022,TOR,CLE,2,1,2-1,TOR,9,1,29,37,66,152,117,269,8,10,18,4,2:55
20037,661865,2022-08-13,2022,TBA,BAL,8,2,8-2,TBA,9,1,40,40,80,151,153,304,16,13,29,3,3:22
20038,661790,2022-08-13,2022,TEX,SEA,7,4,7-4,TEX,9,1,40,37,77,171,137,308,18,12,30,1,3:16
20039,662824,2022-08-13,2022,HOU,OAK,8,0,8-0,HOU,9,1,36,33,69,138,143,281,15,9,24,1,2:51
20040,663176,2022-08-13,2022,BOS,NYA,2,3,3-2,NYA,9,0,39,37,76,141,136,277,13,11,24,1,3:14
20041,661951,2022-08-13,2022,SLN,MIL,2,3,3-2,MIL,10,0,36,35,71,125,139,264,6,5,11,0,3:01
20042,661428,2022-08-13,2022,MIA,ATL,2,5,5-2,ATL,9,0,33,40,73,167,131,298,8,14,22,0,3:01
20043,662670,2022-08-13,2022,KCA,LAN,3,13,13-3,LAN,9,0,38,48,86,175,153,328,12,22,34,2,3:05
20044,662473,2022-08-13,2022,WAS,SDN,4,3,4-3,WAS,9,1,34,43,77,182,142,324,11,17,28,1,3:31
20045,663372,2022-08-13,2022,ANA,MIN,5,3,5-3,ANA,11,0,40,48,88,203,138,341,13,19,32,1,3:46
20046,662110,2022-08-13,2022,SFN,PIT,2,0,2-0,SFN,9,1,35,34,69,114,158,272,11,8,19,1,2:45
20047,661864,2022-08-14,2022,TBA,BAL,4,1,4-1,TBA,9,1,33,29,62,95,137,232,10,1,11,4,2:37
20048,663371,2022-08-14,2022,ANA,MIN,4,2,4-2,ANA,9,1,34,33,67,125,121,246,11,6,17,0,2:45
20049,662669,2022-08-14,2022,KCA,LAN,4,0,4-0,KCA,9,1,33,34,67,158,126,284,10,8,18,1,2:49
20050,662801,2022-08-14,2022,HOU,OAK,6,3,6-3,HOU,9,1,35,38,73,154,112,266,11,12,23,1,2:40
20051,661957,2022-08-14,2022,SLN,MIL,6,3,6-3,SLN,9,1,33,32,65,115,123,238,10,6,16,1,2:17
20052,661708,2022-08-14,2022,TOR,CLE,2,7,7-2,CLE,9,0,35,40,75,159,122,281,8,15,23,1,2:54
20053,661338,2022-08-14,2022,MIA,ATL,1,3,3-1,ATL,9,0,35,43,78,178,136,314,8,20,28,0,3:08
20054,663175,2022-08-14,2022,BOS,NYA,3,0,3-0,BOS,9,1,29,30,59,117,102,219,6,3,9,0,2:15
20055,662035,2022-08-14,2022,SFN,PIT,8,7,8-7,SFN,9,0,42,42,84,162,157,319,18,16,34,3,3:26
20056,661789,2022-08-14,2022,TEX,SEA,5,3,5-3,TEX,9,1,35,39,74,148,122,270,12,11,23,1,3:03
20057,662881,2022-08-14,2022,COL,ARI,4,7,7-4,ARI,9,0,41,41,82,148,148,296,15,14,29,2,3:08
20058,662427,2022-08-14,2022,NYN,PHI,6,0,6-0,NYN,9,1,36,39,75,172,138,310,13,12,25,2,3:22
20059,662472,2022-08-14,2022,WAS,SDN,0,6,6-0,SDN,9,0,33,42,75,172,138,310,7,15,22,1,3:18
20060,661450,2022-08-14,2022,CHA,DET,5,3,5-3,CHA,9,1,38,34,72,133,156,289,14,8,22,1,2:57
20061,663021,2022-08-14,2022,CIN,CHN,8,5,8-5,CIN,9,1,42,43,85,161,189,350,18,17,35,4,3:29
20062,662948,2022-08-15,2022,CLE,DET,5,7,7-5,DET,9,0,36,42,78,147,130,277,12,16,28,2,3:01
20063,663370,2022-08-15,2022,ANA,SEA,2,6,6-2,SEA,9,0,36,42,78,154,156,310,10,14,24,2,3:26
20064,661449,2022-08-15,2022,CHA,HOU,4,2,4-2,CHA,9,1,34,37,71,114,115,229,13,10,23,2,2:33
20065,663020,2022-08-15,2022,CIN,PHI,3,4,4-3,PHI,9,0,34,42,76,171,95,266,9,15,24,1,2:53
20066,661358,2022-08-15,2022,MIA,SDN,3,0,3-0,MIA,9,1,35,35,70,151,153,304,12,8,20,0,3:04
20067,661283,2022-08-15,2022,NYA,TBA,0,4,4-0,TBA,9,0,34,38,72,172,121,293,9,12,21,3,3:21
20068,662471,2022-08-15,2022,WAS,CHN,5,4,5-4,WAS,9,1,35,38,73,152,141,293,10,10,20,1,2:59
20069,662034,2022-08-15,2022,SFN,ARI,6,1,6-1,SFN,9,1,36,37,73,145,133,278,12,12,24,2,3:00
20070,661834,2022-08-15,2022,TEX,OAK,2,1,2-1,TEX,9,1,35,37,72,150,144,294,11,12,23,1,3:10
20071,661707,2022-08-15,2022,TOR,BAL,3,7,7-3,BAL,9,0,38,40,78,166,145,311,13,14,27,3,3:20
20072,662948,2022-08-15,2022,CLE,DET,5,7,7-5,DET,9,0,36,42,78,147,130,277,12,16,28,2,3:01
20073,662977,2022-08-15,2022,CLE,DET,4,1,4-1,CLE,9,1,36,32,68,119,143,262,12,5,17,2,2:54
20074,661497,2022-08-15,2022,ATL,NYN,13,1,13-1,ATL,9,1,43,35,78,156,162,318,19,8,27,3,3:18 (:55 delay)
20075,661676,2022-08-15,2022,MIN,KCA,4,2,4-2,MIN,9,1,37,37,74,125,127,252,16,11,27,3,2:57
20076,661199,2022-08-15,2022,MIL,LAN,0,4,4-0,LAN,9,0,33,39,72,176,151,327,6,11,17,0,3:12
20077,662004,2022-08-16,2022,SFN,ARI,2,1,2-1,SFN,9,0,34,33,67,132,130,262,9,6,15,0,2:46
20078,661250,2022-08-16,2022,NYA,TBA,1,3,3-1,TBA,9,0,32,31,63,125,147,272,5,4,9,2,2:51
20079,662302,2022-08-16,2022,PIT,BOS,3,5,5-3,BOS,9,0,35,35,70,124,139,263,8,9,17,1,2:37
20080,661357,2022-08-16,2022,MIA,SDN,4,3,4-3,MIA,9,1,33,42,75,192,128,320,10,16,26,3,3:33
20081,661706,2022-08-16,2022,TOR,BAL,2,4,4-2,BAL,9,0,33,40,73,147,121,268,8,12,20,1,2:54
20082,661495,2022-08-16,2022,ATL,NYN,5,0,5-0,ATL,9,1,35,30,65,130,126,256,14,5,19,3,2:51
20083,661682,2022-08-16,2022,MIN,KCA,9,0,9-0,MIN,9,1,44,32,76,135,158,293,19,6,25,2,3:01
20084,663369,2022-08-16,2022,ANA,SEA,2,8,8-2,SEA,9,0,36,38,74,150,148,298,10,11,21,1,3:04
20085,661833,2022-08-16,2022,TEX,OAK,1,5,5-1,OAK,9,0,36,40,76,139,137,276,12,15,27,1,3:07
20086,662943,2022-08-16,2022,CLE,DET,3,4,4-3,DET,9,0,37,41,78,164,146,310,10,15,25,1,3:20
20087,661448,2022-08-16,2022,CHA,HOU,4,3,4-3,CHA,9,1,34,39,73,156,121,277,12,13,25,0,3:10
20088,661955,2022-08-16,2022,SLN,COL,5,4,5-4,SLN,9,0,38,36,74,138,154,292,16,9,25,3,3:08
20089,661191,2022-08-16,2022,MIL,LAN,5,4,5-4,MIL,11,0,44,44,88,191,188,379,13,11,24,1,3:52
20090,662550,2022-08-16,2022,WAS,CHN,5,7,7-5,CHN,11,0,47,43,90,166,187,353,17,13,30,2,3:47
20091,663019,2022-08-16,2022,CIN,PHI,4,11,11-4,PHI,9,0,35,47,82,171,139,310,9,20,29,2,3:20
20092,663017,2022-08-17,2022,CIN,PHI,1,0,1-0,CIN,9,0,35,33,68,115,135,250,9,8,17,0,2:27
20093,661938,2022-08-17,2022,SLN,COL,5,1,5-1,SLN,9,1,38,34,72,135,147,282,16,9,25,2,3:06
20094,661788,2022-08-17,2022,TEX,OAK,2,7,7-2,OAK,9,0,37,40,77,147,139,286,11,13,24,2,3:00
20095,661654,2022-08-17,2022,MIN,KCA,4,0,4-0,MIN,9,1,33,33,66,143,129,272,9,8,17,2,2:49
20096,661171,2022-08-17,2022,MIL,LAN,1,2,2-1,LAN,9,0,34,33,67,135,139,274,8,9,17,0,2:49
20097,661705,2022-08-17,2022,TOR,BAL,6,1,6-1,TOR,9,1,36,31,67,105,141,246,12,4,16,3,2:47
20098,661447,2022-08-17,2022,CHA,HOU,2,3,3-2,HOU,9,0,36,35,71,133,135,268,12,8,20,0,3:06
20099,662301,2022-08-17,2022,PIT,BOS,3,8,8-3,BOS,9,0,33,45,78,160,115,275,6,20,26,1,2:43
20100,662470,2022-08-17,2022,WAS,CHN,2,3,3-2,CHN,9,0,33,34,67,132,149,281,7,7,14,2,2:56
20101,662003,2022-08-17,2022,SFN,ARI,2,3,3-2,ARI,9,0,37,37,74,153,132,285,11,9,20,1,3:07
20102,662951,2022-08-17,2022,CLE,DET,8,4,8-4,CLE,9,1,43,36,79,142,167,309,19,9,28,2,3:14
20103,661266,2022-08-17,2022,NYA,TBA,8,7,8-7,NYA,10,0,41,46,87,171,152,323,15,16,31,4,3:48 (1:03 delay)
20104,661494,2022-08-17,2022,ATL,NYN,7,9,9-7,NYN,9,0,37,43,80,168,144,312,12,16,28,3,3:22 (:34 delay)
20105,661356,2022-08-17,2022,MIA,SDN,3,10,10-3,SDN,9,0,38,47,85,181,160,341,12,23,35,3,3:44
20106,663408,2022-08-17,2022,ANA,SEA,7,11,11-7,SEA,9,0,40,45,85,174,148,322,13,18,31,2,3:14
20107,661109,2022-08-18,2022,BAL,CHN,2,3,3-2,CHN,9,0,37,35,72,125,148,273,10,8,18,4,3:03
20108,661493,2022-08-18,2022,ATL,NYN,3,2,3-2,ATL,9,1,30,33,63,122,119,241,6,6,12,2,2:41
20109,661937,2022-08-18,2022,SLN,COL,13,0,13-0,SLN,9,1,43,30,73,111,161,272,20,5,25,1,2:45
20110,661179,2022-08-18,2022,MIL,LAN,5,3,5-3,MIL,9,1,34,36,70,145,139,284,9,10,19,3,2:58
20111,661863,2022-08-18,2022,TBA,KCA,7,1,7-1,TBA,9,1,37,36,73,138,142,280,14,9,23,2,2:48
20112,662413,2022-08-18,2022,PIT,BOS,8,2,8-2,PIT,9,1,36,34,70,127,138,265,12,8,20,1,2:37
20113,661109,2022-08-18,2022,BAL,CHN,2,3,3-2,CHN,9,0,37,35,72,125,148,273,10,8,18,4,3:03
20114,661787,2022-08-18,2022,TEX,OAK,10,3,10-3,TEX,9,1,40,36,76,141,145,286,19,9,28,1,2:52
20115,662182,2022-08-18,2022,SDN,WAS,1,3,3-1,WAS,9,0,36,35,71,113,171,284,10,8,18,3,3:19
20116,662002,2022-08-18,2022,SFN,ARI,0,5,5-0,ARI,9,0,30,41,71,164,112,276,4,17,21,2,2:55
20117,661265,2022-08-18,2022,NYA,TOR,2,9,9-2,TOR,9,0,37,43,80,163,127,290,10,16,26,1,3:09
20118,661446,2022-08-18,2022,CHA,HOU,5,21,21-5,HOU,9,0,44,55,99,209,177,386,19,29,48,1,3:53
20119,662808,2022-08-19,2022,DET,ANA,0,1,1-0,ANA,9,0,28,31,59,114,97,211,4,4,8,0,2:15
20120,661655,2022-08-19,2022,MIN,TEX,2,1,2-1,MIN,9,1,32,34,66,142,121,263,8,8,16,1,2:54
20121,663292,2022-08-19,2022,ARI,SLN,1,5,5-1,SLN,9,0,33,40,73,157,127,284,6,15,21,2,2:52
20122,661319,2022-08-19,2022,NYA,TOR,0,4,4-0,TOR,9,0,32,37,69,132,113,245,5,10,15,2,2:52
20123,662574,2022-08-19,2022,LAN,MIA,2,1,2-1,LAN,9,1,33,34,67,124,127,251,10,8,18,1,2:41
20124,662341,2022-08-19,2022,OAK,SEA,2,10,10-2,SEA,9,0,35,44,79,154,120,274,9,17,26,2,2:44
20125,662936,2022-08-19,2022,CLE,CHA,5,2,5-2,CLE,9,1,37,34,71,133,154,287,15,8,23,3,3:14
20126,662396,2022-08-19,2022,PIT,CIN,5,4,5-4,PIT,9,0,40,35,75,120,126,246,17,7,24,3,2:48
20127,663228,2022-08-19,2022,CHN,MIL,8,7,8-7,CHN,9,1,36,39,75,151,141,292,12,13,25,2,2:54
20128,662880,2022-08-19,2022,COL,SFN,7,4,7-4,COL,9,1,36,37,73,153,135,288,12,10,22,2,2:56
20129,661607,2022-08-19,2022,PHI,NYN,2,7,7-2,NYN,9,0,38,43,81,169,143,312,11,16,27,0,3:28
20130,662181,2022-08-19,2022,SDN,WAS,3,6,6-3,WAS,9,0,37,42,79,166,158,324,9,14,23,3,3:46
20131,661492,2022-08-19,2022,ATL,HOU,6,2,6-2,ATL,9,1,40,34,74,123,142,265,17,8,25,0,3:04
20132,661862,2022-08-19,2022,TBA,KCA,2,3,3-2,KCA,10,0,36,37,73,136,140,276,10,8,18,0,2:48
20133,661044,2022-08-19,2022,BAL,BOS,15,10,15-10,BAL,9,1,45,48,93,184,168,352,22,21,43,5,4:06
20134,661628,2022-08-20,2022,PHI,NYN,2,8,8-2,NYN,9,0,37,43,80,186,145,331,10,18,28,4,3:42
20135,662180,2022-08-20,2022,SDN,WAS,2,1,2-1,SDN,9,1,37,36,73,139,148,287,12,9,21,0,3:18
20136,661240,2022-08-20,2022,NYA,TOR,2,5,5-2,TOR,9,0,38,35,73,147,146,293,10,10,20,0,3:11
20137,661861,2022-08-20,2022,TBA,KCA,5,2,5-2,TBA,9,1,35,33,68,131,134,265,12,5,17,2,2:50
20138,661606,2022-08-20,2022,PHI,NYN,4,1,4-1,PHI,9,1,39,35,74,130,177,307,14,9,23,3,3:23
20139,661043,2022-08-20,2022,BAL,BOS,3,4,4-3,BOS,9,0,35,39,74,142,123,265,9,13,22,2,3:04
20140,662917,2022-08-20,2022,DET,ANA,4,3,4-3,DET,9,1,38,35,73,139,123,262,14,9,23,1,2:40
20141,662879,2022-08-20,2022,COL,SFN,4,3,4-3,COL,10,0,39,37,76,148,120,268,14,7,21,1,3:07
20142,662395,2022-08-20,2022,PIT,CIN,1,10,10-1,CIN,9,0,38,46,84,171,164,335,12,17,29,1,3:34
20143,662561,2022-08-20,2022,LAN,MIA,7,0,7-0,LAN,9,1,38,32,70,115,163,278,15,5,20,0,2:39
20144,661628,2022-08-20,2022,PHI,NYN,2,8,8-2,NYN,9,0,37,43,80,186,145,331,10,18,28,4,3:42
20145,662340,2022-08-20,2022,OAK,SEA,4,3,4-3,OAK,10,0,40,41,81,147,141,288,13,12,25,0,3:19
20146,663291,2022-08-20,2022,ARI,SLN,7,16,16-7,SLN,9,0,41,49,90,181,157,338,14,23,37,4,3:43
20147,661610,2022-08-20,2022,ATL,HOU,5,4,5-4,ATL,11,0,42,44,86,193,179,372,13,11,24,1,3:59
20148,661670,2022-08-20,2022,MIN,TEX,3,4,4-3,TEX,10,0,42,43,85,153,162,315,11,13,24,2,3:27
20149,663116,2022-08-20,2022,CHN,MIL,6,5,6-5,CHN,11,0,47,45,92,154,192,346,16,12,28,3,3:51 (:41 delay)
20150,662953,2022-08-20,2022,CLE,CHA,0,2,2-0,CHA,9,0,33,35,68,128,119,247,6,9,15,2,2:39 (2:55 delay)
20151,662179,2022-08-21,2022,SDN,WAS,2,1,2-1,SDN,9,1,32,33,65,99,125,224,11,7,18,1,2:30
20152,662805,2022-08-21,2022,DET,ANA,4,0,4-0,DET,9,1,35,37,72,140,141,281,12,10,22,0,2:56
20153,661051,2022-08-21,2022,BAL,BOS,5,3,5-3,BAL,9,1,39,33,72,134,167,301,15,9,24,6,3:23
20154,661480,2022-08-21,2022,ATL,HOU,4,5,5-4,HOU,9,0,34,41,75,156,125,281,9,14,23,1,3:11
20155,661860,2022-08-21,2022,TBA,KCA,3,2,3-2,TBA,9,1,33,36,69,152,120,272,11,8,19,3,2:59
20156,661239,2022-08-21,2022,NYA,TOR,4,2,4-2,NYA,9,1,33,36,69,154,132,286,9,9,18,2,2:59
20157,662300,2022-08-21,2022,PIT,CIN,5,9,9-5,CIN,9,0,38,45,83,156,151,307,12,20,32,3,3:22
20158,661652,2022-08-21,2022,MIN,TEX,0,7,7-0,TEX,9,0,31,40,71,142,114,256,5,15,20,2,2:54
20159,662600,2022-08-21,2022,LAN,MIA,10,3,10-3,LAN,9,1,44,36,80,136,187,323,21,10,31,2,3:18
20160,663115,2022-08-21,2022,CHN,MIL,2,5,5-2,MIL,9,0,33,35,68,158,151,309,7,10,17,2,3:04
20161,662315,2022-08-21,2022,OAK,SEA,5,3,5-3,OAK,9,1,36,38,74,171,142,313,15,13,28,3,3:28
20162,661602,2022-08-21,2022,PHI,NYN,9,10,10-9,NYN,9,0,45,48,93,206,189,395,19,22,41,2,4:26 (:46 delay)
20163,663301,2022-08-21,2022,ARI,SLN,4,6,6-4,SLN,9,0,39,43,82,160,144,304,13,19,32,5,3:35
20164,662878,2022-08-21,2022,COL,SFN,8,9,9-8,SFN,11,0,45,48,93,160,162,322,13,14,27,5,3:47
20165,661601,2022-08-22,2022,PHI,CIN,4,1,4-1,PHI,9,1,34,32,66,118,130,248,10,6,16,1,2:40 (:57 delay)
20166,662394,2022-08-22,2022,PIT,ATL,1,2,2-1,ATL,9,0,32,33,65,116,132,248,6,7,13,0,2:40 (1:02 delay)
20167,661658,2022-08-22,2022,MIN,TEX,1,2,2-1,TEX,9,0,35,32,67,107,162,269,10,7,17,1,2:58
20168,663114,2022-08-22,2022,CHN,SLN,0,1,1-0,SLN,9,0,28,32,60,126,99,225,1,7,8,0,2:16
20169,661859,2022-08-22,2022,TBA,ANA,2,1,2-1,TBA,9,1,34,37,71,141,143,284,12,10,22,1,3:00
20170,662594,2022-08-22,2022,LAN,MIL,0,4,4-0,MIL,9,0,36,36,72,144,159,303,11,9,20,1,3:02
20171,662767,2022-08-22,2022,KCA,CHA,6,4,6-4,KCA,9,1,38,42,80,165,165,330,16,18,34,6,3:36
20172,662314,2022-08-22,2022,OAK,MIA,0,3,3-0,MIA,9,0,32,39,71,173,116,289,6,13,19,0,2:44
20173,661238,2022-08-22,2022,NYA,NYN,4,2,4-2,NYA,9,1,34,32,66,119,119,238,10,6,16,3,2:48
20174,662383,2022-08-23,2022,PIT,ATL,1,6,6-1,ATL,9,0,31,37,68,132,104,236,4,11,15,1,2:15
20175,662339,2022-08-23,2022,OAK,MIA,3,5,5-3,MIA,9,0,36,36,72,137,137,274,11,9,20,2,2:46
20176,662914,2022-08-23,2022,DET,SFN,1,3,3-1,SFN,9,0,33,35,68,136,136,272,8,10,18,0,2:52
20177,661237,2022-08-23,2022,NYA,NYN,4,2,4-2,NYA,9,1,35,39,74,157,136,293,13,14,27,3,3:23
20178,663163,2022-08-23,2022,CHN,SLN,2,0,2-0,CHN,9,1,34,38,72,170,131,301,9,10,19,2,3:09
20179,662142,2022-08-23,2022,SEA,WAS,4,2,4-2,SEA,9,1,32,33,65,145,132,277,8,7,15,2,2:48
20180,662605,2022-08-23,2022,LAN,MIL,10,1,10-1,LAN,9,1,42,32,74,130,165,295,17,6,23,2,3:02
20181,663113,2022-08-23,2022,CHN,SLN,3,13,13-3,SLN,9,0,35,49,84,187,119,306,8,25,33,5,3:15
20182,662800,2022-08-23,2022,HOU,MIN,4,2,4-2,HOU,9,1,36,35,71,154,135,289,14,8,22,4,3:19
20183,662213,2022-08-23,2022,SDN,CLE,1,3,3-1,CLE,9,0,38,34,72,137,169,306,11,7,18,2,3:20
20184,661600,2022-08-23,2022,PHI,CIN,7,6,7-6,PHI,9,0,36,42,78,153,136,289,11,15,26,2,3:12
20185,661858,2022-08-23,2022,TBA,ANA,11,1,11-1,TBA,9,1,42,34,76,123,170,293,18,7,25,3,2:57
20186,662668,2022-08-23,2022,KCA,ARI,3,7,7-3,ARI,9,0,34,48,82,187,133,320,8,22,30,4,3:29
20187,663461,2022-08-23,2022,BAL,CHA,5,3,5-3,BAL,9,1,31,43,74,167,139,306,8,16,24,5,3:36
20188,662876,2022-08-23,2022,COL,TEX,7,6,7-6,COL,9,1,36,37,73,135,127,262,13,11,24,0,2:37
20189,663174,2022-08-23,2022,BOS,TOR,3,9,9-3,TOR,9,0,41,44,85,172,150,322,14,18,32,3,3:18 (1:01 delay)
20190,662799,2022-08-24,2022,HOU,MIN,5,3,5-3,HOU,9,1,31,36,67,139,116,255,10,9,19,0,2:40
20191,662640,2022-08-24,2022,KCA,ARI,5,3,5-3,KCA,9,1,34,32,66,140,138,278,10,6,16,2,2:59
20192,662916,2022-08-24,2022,DET,SFN,6,1,6-1,DET,9,1,35,38,73,152,151,303,10,11,21,1,2:53
20193,663216,2022-08-24,2022,CHN,SLN,7,1,7-1,CHN,9,1,35,36,71,139,129,268,12,9,21,2,2:46
20194,662144,2022-08-24,2022,SEA,WAS,1,3,3-1,WAS,9,0,35,36,71,113,148,261,10,11,21,3,2:57
20195,663460,2022-08-24,2022,BAL,CHA,3,5,5-3,CHA,9,0,34,46,80,173,136,309,9,19,28,4,3:24
20196,662371,2022-08-24,2022,PIT,ATL,2,14,14-2,ATL,9,0,35,50,85,207,111,318,8,23,31,2,3:08
20197,662212,2022-08-24,2022,SDN,CLE,0,7,7-0,CLE,9,0,34,41,75,159,121,280,7,15,22,1,3:02
20198,663173,2022-08-24,2022,BOS,TOR,2,3,3-2,TOR,10,0,41,40,81,130,157,287,15,11,26,1,3:12
20199,661857,2022-08-24,2022,TBA,ANA,4,3,4-3,TBA,11,0,41,44,85,182,162,344,11,11,22,1,3:40
20200,662604,2022-08-24,2022,LAN,MIL,12,6,12-6,LAN,9,1,43,41,84,147,174,321,19,14,33,3,3:07
20201,662338,2022-08-24,2022,OAK,MIA,3,2,3-2,OAK,10,0,34,38,72,136,134,270,6,8,14,1,2:40
20202,662877,2022-08-24,2022,COL,TEX,4,16,16-4,TEX,9,0,36,50,86,183,139,322,10,23,33,2,3:08
20203,661605,2022-08-24,2022,PHI,CIN,7,5,7-5,PHI,9,1,44,39,83,143,164,307,22,12,34,3,3:16
20204,661604,2022-08-25,2022,PHI,CIN,4,0,4-0,PHI,9,1,32,33,65,101,127,228,9,6,15,1,2:36
20205,662141,2022-08-25,2022,SEA,CLE,3,1,3-1,SEA,9,1,32,33,65,155,139,294,9,7,16,1,2:46
20206,662433,2022-08-25,2022,NYN,COL,3,1,3-1,NYN,9,1,36,36,72,136,145,281,13,9,22,2,2:58
20207,662711,2022-08-25,2022,HOU,MIN,6,3,6-3,HOU,9,1,35,33,68,139,157,296,14,8,22,0,3:11
20208,661856,2022-08-25,2022,TBA,ANA,8,3,8-3,TBA,9,1,38,37,75,146,137,283,13,11,24,1,3:00
20209,662337,2022-08-25,2022,OAK,NYA,4,13,13-4,NYA,9,0,40,53,93,201,160,361,13,26,39,4,3:34
20210,663172,2022-08-25,2022,BOS,TOR,5,6,6-5,TOR,10,0,46,48,94,190,182,372,19,20,39,3,4:22
20211,663459,2022-08-25,2022,BAL,CHA,4,3,4-3,BAL,11,0,39,41,80,141,157,298,9,11,20,0,3:29
20212,663240,2022-08-25,2022,CHN,SLN,3,8,8-3,SLN,9,0,36,44,80,150,138,288,10,18,28,1,2:52
20213,661445,2022-08-26,2022,CHA,ARI,2,7,7-2,ARI,9,0,35,37,72,140,135,275,10,10,20,0,2:40
20214,662342,2022-08-26,2022,OAK,NYA,2,3,3-2,NYA,9,0,35,40,75,136,136,272,7,17,24,1,2:50
20215,661669,2022-08-26,2022,MIN,SFN,9,0,9-0,MIN,9,1,38,32,70,147,147,294,14,8,22,0,2:55
20216,662432,2022-08-26,2022,NYN,COL,7,6,7-6,NYN,9,0,40,39,79,119,147,266,15,14,29,1,3:09
20217,662710,2022-08-26,2022,HOU,BAL,0,2,2-0,BAL,9,0,33,37,70,144,113,257,7,11,18,1,2:57
20218,662469,2022-08-26,2022,WAS,CIN,3,7,7-3,CIN,9,0,36,40,76,162,142,304,10,14,24,1,3:07
20219,661189,2022-08-26,2022,MIL,CHN,3,4,4-3,CHN,10,0,42,34,76,150,169,319,14,4,18,3,3:16
20220,662143,2022-08-26,2022,SEA,CLE,3,2,3-2,SEA,11,0,39,43,82,157,141,298,11,13,24,2,3:29
20221,663171,2022-08-26,2022,BOS,TBA,9,8,9-8,BOS,9,1,43,39,82,144,171,315,19,13,32,2,3:30
20222,661603,2022-08-26,2022,PHI,PIT,7,4,7-4,PHI,9,1,36,33,69,113,154,267,11,8,19,1,2:55
20223,661786,2022-08-26,2022,TEX,DET,7,6,7-6,TEX,9,1,35,40,75,157,143,300,13,12,25,0,3:03
20224,661940,2022-08-26,2022,SLN,ATL,4,11,11-4,ATL,9,0,40,47,87,185,170,355,14,23,37,4,3:43
20225,661704,2022-08-26,2022,TOR,ANA,0,12,12-0,ANA,9,0,39,46,85,159,184,343,12,18,30,1,3:20
20226,662667,2022-08-26,2022,KCA,SDN,5,13,13-5,SDN,9,0,41,49,90,190,143,333,14,23,37,3,3:37
20227,661355,2022-08-26,2022,MIA,LAN,6,10,10-6,LAN,10,0,45,51,96,237,166,403,12,21,33,3,4:18
20228,661354,2022-08-27,2022,MIA,LAN,2,1,2-1,MIA,9,1,29,34,63,111,107,218,7,8,15,0,2:17
20229,663170,2022-08-27,2022,BOS,TBA,5,1,5-1,BOS,9,1,31,35,66,141,107,248,9,8,17,1,2:24
20230,662140,2022-08-27,2022,SEA,CLE,3,4,4-3,CLE,9,0,30,36,66,168,117,285,3,8,11,0,2:48
20231,661599,2022-08-27,2022,PHI,PIT,6,0,6-0,PHI,9,1,39,33,72,125,149,274,16,8,24,0,2:59
20232,662666,2022-08-27,2022,KCA,SDN,3,4,4-3,SDN,9,0,37,37,74,148,130,278,10,12,22,0,2:59
20233,662442,2022-08-27,2022,NYN,COL,3,0,3-0,NYN,9,1,34,32,66,144,143,287,11,5,16,0,2:54
20234,661090,2022-08-27,2022,HOU,BAL,1,3,3-1,BAL,9,0,29,35,64,157,111,268,4,11,15,2,2:55
20235,661703,2022-08-27,2022,TOR,ANA,0,2,2-0,ANA,9,0,31,37,68,155,133,288,3,11,14,0,3:20
20236,661444,2022-08-27,2022,CHA,ARI,5,10,10-5,ARI,9,0,34,46,80,183,126,309,8,19,27,4,3:32
20237,661785,2022-08-27,2022,TEX,DET,2,11,11-2,DET,9,0,36,47,83,173,122,295,13,21,34,2,3:00
20238,662336,2022-08-27,2022,OAK,NYA,3,2,3-2,OAK,11,0,41,36,77,135,134,269,8,7,15,3,3:07
20239,661180,2022-08-27,2022,MIL,CHN,7,0,7-0,MIL,9,1,40,35,75,152,154,306,15,9,24,1,3:04
20240,662468,2022-08-27,2022,WAS,CIN,2,6,6-2,CIN,9,0,36,39,75,163,143,306,11,13,24,2,3:05
20241,661939,2022-08-27,2022,SLN,ATL,6,5,6-5,SLN,9,0,42,37,79,133,159,292,17,11,28,1,3:20
20242,661657,2022-08-27,2022,MIN,SFN,3,2,3-2,MIN,10,0,44,38,82,168,190,358,18,9,27,2,3:57 (:51 delay)
20243,662467,2022-08-28,2022,WAS,CIN,3,2,3-2,WAS,9,1,31,33,64,117,123,240,9,6,15,0,2:21
20244,662139,2022-08-28,2022,SEA,CLE,4,0,4-0,SEA,9,1,31,31,62,132,118,250,7,5,12,1,2:31
20245,661950,2022-08-28,2022,SLN,ATL,6,3,6-3,SLN,9,1,33,36,69,128,132,260,9,10,19,4,3:06 (:59 delay)
20246,661443,2022-08-28,2022,CHA,ARI,2,3,3-2,ARI,9,0,37,32,69,119,138,257,12,6,18,1,2:50
20247,661598,2022-08-28,2022,PHI,PIT,0,5,5-0,PIT,9,0,34,36,70,137,134,271,7,10,17,1,2:51
20248,662446,2022-08-28,2022,NYN,COL,0,1,1-0,COL,9,0,32,36,68,145,130,275,5,10,15,0,2:50
20249,661089,2022-08-28,2022,HOU,BAL,3,1,3-1,HOU,9,1,33,34,67,147,138,285,10,9,19,2,3:08
20250,662335,2022-08-28,2022,OAK,NYA,4,1,4-1,OAK,9,1,33,34,67,159,148,307,11,7,18,4,3:19
20251,661773,2022-08-28,2022,TOR,ANA,3,8,8-3,ANA,9,0,41,43,84,150,176,326,16,15,31,3,3:16
20252,661784,2022-08-28,2022,TEX,DET,8,9,9-8,DET,9,0,41,44,85,185,155,340,14,18,32,3,3:35
20253,661168,2022-08-28,2022,MIL,CHN,9,7,9-7,MIL,9,1,42,43,85,172,173,345,20,17,37,4,3:24
20254,661353,2022-08-28,2022,MIA,LAN,1,8,8-1,LAN,9,0,33,44,77,168,147,315,6,19,25,1,3:14
20255,661663,2022-08-28,2022,MIN,SFN,8,3,8-3,MIN,9,1,37,40,77,180,155,335,14,14,28,3,3:27
20256,662638,2022-08-28,2022,KCA,SDN,15,7,15-7,KCA,9,1,50,44,94,189,197,386,25,16,41,5,4:00
20257,663211,2022-08-28,2022,BOS,TBA,4,12,12-4,TBA,9,0,40,49,89,199,132,331,14,23,37,0,3:14
20258,663424,2022-08-29,2022,ANA,NYA,4,3,4-3,ANA,9,1,33,36,69,130,111,241,10,11,21,3,3:00
20259,662001,2022-08-29,2022,SFN,SDN,5,6,6-5,SDN,9,0,39,39,78,163,162,325,14,13,27,1,3:44 (:40 delay)
20260,661651,2022-08-29,2022,MIN,BOS,4,2,4-2,MIN,9,1,36,38,74,141,161,302,13,11,24,3,3:27
20261,661352,2022-08-29,2022,MIA,LAN,2,3,3-2,LAN,10,0,42,41,83,150,165,315,11,11,22,2,3:27
20262,663018,2022-08-29,2022,CIN,SLN,4,13,13-4,SLN,9,0,36,46,82,169,144,313,11,18,29,3,3:01 (2:07 delay)
20263,661167,2022-08-29,2022,MIL,PIT,7,5,7-5,MIL,9,0,39,40,79,164,173,337,16,14,30,2,3:32
20264,661801,2022-08-29,2022,TOR,CHN,5,4,5-4,TOR,11,0,45,44,89,168,161,329,17,17,34,3,3:43
20265,663332,2022-08-29,2022,ARI,PHI,13,7,13-7,ARI,9,1,44,41,85,161,179,340,19,15,34,3,3:35
20266,661832,2022-08-30,2022,TEX,HOU,2,4,4-2,HOU,9,0,33,40,73,149,119,268,7,14,21,1,2:56
20267,663137,2022-08-30,2022,CIN,SLN,5,1,5-1,CIN,9,1,34,32,66,132,124,256,12,6,18,1,2:33
20268,663437,2022-08-30,2022,ANA,NYA,4,7,7-4,NYA,9,0,33,40,73,150,138,288,7,12,19,3,2:59
20269,662973,2022-08-30,2022,CLE,BAL,5,1,5-1,CLE,9,1,35,32,67,133,134,267,11,5,16,2,2:37
20270,661351,2022-08-30,2022,MIA,TBA,2,7,7-2,TBA,9,0,34,44,78,149,144,293,10,17,27,1,3:12
20271,662426,2022-08-30,2022,NYN,LAN,3,4,4-3,LAN,9,0,37,43,80,165,139,304,12,17,29,2,3:12
20272,661648,2022-08-30,2022,MIN,BOS,10,5,10-5,MIN,9,1,40,38,78,152,149,301,16,12,28,3,3:27
20273,662466,2022-08-30,2022,WAS,OAK,6,10,10-6,OAK,9,0,40,45,85,186,153,339,14,19,33,3,3:24
20274,661166,2022-08-30,2022,MIL,PIT,2,4,4-2,PIT,9,0,34,39,73,149,141,290,9,15,24,1,2:43
20275,662804,2022-08-30,2022,DET,SEA,3,9,9-3,SEA,9,0,36,40,76,165,140,305,8,13,21,1,2:53
20276,662000,2022-08-30,2022,SFN,SDN,3,4,4-3,SDN,9,0,40,40,80,171,159,330,13,12,25,3,3:35
20277,663286,2022-08-30,2022,ARI,PHI,12,3,12-3,ARI,9,1,44,31,75,117,158,275,19,6,25,0,2:59
20278,661800,2022-08-30,2022,TOR,CHN,5,3,5-3,TOR,9,1,36,36,72,148,146,294,12,11,23,3,3:03
20279,661479,2022-08-30,2022,ATL,COL,2,3,3-2,COL,9,0,39,40,79,164,161,325,11,12,23,0,3:34
20280,661442,2022-08-30,2022,CHA,KCA,7,9,9-7,KCA,9,0,42,42,84,175,158,333,15,16,31,4,3:21
20281,662972,2022-08-31,2022,CLE,BAL,0,4,4-0,BAL,9,0,34,37,71,156,115,271,8,11,19,3,2:54
20282,661779,2022-08-31,2022,TOR,CHN,5,7,7-5,CHN,9,0,37,36,73,147,137,284,10,11,21,5,3:07
20283,662033,2022-08-31,2022,SFN,SDN,4,5,5-4,SDN,9,0,36,38,74,156,137,293,10,13,23,3,3:13
20284,661831,2022-08-31,2022,TEX,HOU,3,5,5-3,HOU,9,0,36,45,81,172,141,313,9,18,27,0,3:23
20285,661478,2022-08-31,2022,ATL,COL,3,2,3-2,ATL,9,1,31,35,66,123,122,245,9,9,18,1,2:29
20286,661441,2022-08-31,2022,CHA,KCA,4,2,4-2,CHA,9,1,36,33,69,121,142,263,15,7,22,1,2:43
20287,663410,2022-08-31,2022,ANA,NYA,3,2,3-2,ANA,9,1,30,34,64,125,108,233,7,8,15,0,2:43
20288,661350,2022-08-31,2022,MIA,TBA,1,2,2-1,TBA,10,0,37,40,77,145,127,272,8,13,21,0,3:07
20289,662465,2022-08-31,2022,WAS,OAK,5,1,5-1,WAS,9,1,35,35,70,130,135,265,11,10,21,1,2:51
20290,661165,2022-08-31,2022,MIL,PIT,6,1,6-1,MIL,9,1,43,33,76,135,180,315,19,5,24,2,3:16
20291,662447,2022-08-31,2022,NYN,LAN,2,1,2-1,NYN,9,1,31,31,62,118,101,219,8,4,12,0,2:19
20292,662903,2022-08-31,2022,DET,SEA,3,5,5-3,SEA,9,0,39,39,78,154,141,295,13,12,25,1,3:00
20293,661649,2022-08-31,2022,MIN,BOS,5,6,6-5,BOS,9,0,38,43,81,166,151,317,12,15,27,0,3:19
20294,663312,2022-08-31,2022,ARI,PHI,2,18,18-2,PHI,9,0,34,57,91,189,108,297,8,32,40,3,3:26
20295,662995,2022-08-31,2022,CIN,SLN,3,5,5-3,SLN,13,0,57,53,110,223,195,418,24,16,40,5,4:48
20296,663290,2022-09-01,2022,ARI,MIL,5,0,5-0,ARI,9,1,37,30,67,117,124,241,13,4,17,1,2:28
20297,662971,2022-09-01,2022,CLE,BAL,0,3,3-0,BAL,9,0,33,35,68,136,123,259,6,8,14,0,2:41
20298,661477,2022-09-01,2022,ATL,COL,3,0,3-0,ATL,9,1,30,30,60,114,126,240,6,2,8,1,2:23
20299,663210,2022-09-01,2022,BOS,TEX,9,8,9-8,BOS,9,0,44,47,91,184,185,369,21,20,41,3,3:41
20300,661440,2022-09-01,2022,CHA,KCA,7,1,7-1,CHA,9,1,38,39,77,166,146,312,14,10,24,4,3:22
20301,662410,2022-09-01,2022,NYN,LAN,5,3,5-3,NYN,9,1,34,37,71,153,141,294,10,12,22,0,3:14
20302,662785,2022-09-01,2022,DET,SEA,0,7,7-0,SEA,9,0,32,42,74,174,112,286,5,15,20,0,2:47
20303,662491,2022-09-01,2022,WAS,OAK,7,5,7-5,WAS,10,0,47,44,91,166,180,346,18,16,34,4,4:02
20304,663133,2022-09-02,2022,CIN,COL,3,2,3-2,CIN,9,0,37,33,70,131,154,285,15,9,24,1,2:58
20305,662356,2022-09-02,2022,PIT,TOR,0,4,4-0,TOR,9,0,32,42,74,178,120,298,6,17,23,1,3:24
20306,663212,2022-09-02,2022,BOS,TEX,9,1,9-1,BOS,9,1,42,35,77,114,176,290,19,9,28,2,3:11
20307,661476,2022-09-02,2022,ATL,MIA,8,1,8-1,ATL,9,1,38,34,72,138,158,296,15,8,23,2,2:57
20308,661855,2022-09-02,2022,TBA,NYA,9,0,9-0,TBA,9,1,40,37,77,151,150,301,17,9,26,5,3:24
20309,663285,2022-09-02,2022,ARI,MIL,2,1,2-1,ARI,9,1,29,39,68,171,111,282,7,13,20,2,2:51
20310,662961,2022-09-02,2022,CLE,SEA,1,6,6-1,SEA,9,0,36,40,76,154,140,294,11,12,23,1,2:57
20311,661920,2022-09-02,2022,SLN,CHN,8,0,8-0,SLN,9,1,38,35,73,132,169,301,15,9,24,1,3:06
20312,663356,2022-09-02,2022,BAL,OAK,5,2,5-2,BAL,9,1,36,32,68,124,117,241,14,7,21,2,2:46
20313,662915,2022-09-02,2022,DET,KCA,5,4,5-4,DET,9,1,37,36,73,129,147,276,14,10,24,2,3:00
20314,661439,2022-09-02,2022,CHA,MIN,4,3,4-3,CHA,9,0,39,38,77,150,134,284,14,13,27,0,3:17
20315,663428,2022-09-02,2022,ANA,HOU,2,4,4-2,HOU,9,0,39,38,77,139,140,279,12,11,23,3,3:09
20316,662032,2022-09-02,2022,SFN,PHI,13,1,13-1,SFN,9,1,46,32,78,106,200,306,22,6,28,2,3:05
20317,662409,2022-09-02,2022,NYN,WAS,7,3,7-3,NYN,9,1,36,40,76,161,141,302,15,12,27,2,3:09
20318,662603,2022-09-02,2022,LAN,SDN,1,7,7-1,SDN,9,0,36,43,79,173,155,328,9,17,26,1,3:30
20319,662286,2022-09-03,2022,PIT,TOR,1,4,4-1,TOR,9,0,34,39,73,159,114,273,8,11,19,3,3:06
20320,662803,2022-09-03,2022,DET,KCA,2,12,12-2,KCA,9,0,37,45,82,163,135,298,11,19,30,1,2:59
20321,663355,2022-09-03,2022,BAL,OAK,8,1,8-1,BAL,9,1,39,36,75,145,157,302,15,10,25,3,3:17
20322,662031,2022-09-03,2022,SFN,PHI,5,4,5-4,SFN,9,1,40,39,79,148,170,318,16,15,31,5,3:33
20323,663214,2022-09-03,2022,BOS,TEX,5,3,5-3,BOS,9,1,38,38,76,139,156,295,12,11,23,1,3:12
20324,661854,2022-09-03,2022,TBA,NYA,2,1,2-1,TBA,9,1,31,31,62,116,109,225,10,3,13,3,2:39
20325,661438,2022-09-03,2022,CHA,MIN,13,0,13-0,CHA,9,1,40,29,69,103,140,243,17,3,20,1,2:21
20326,662425,2022-09-03,2022,NYN,WAS,1,7,7-1,WAS,9,0,33,41,74,150,116,266,6,17,23,1,2:52
20327,661475,2022-09-03,2022,ATL,MIA,2,1,2-1,ATL,9,0,36,34,70,130,156,286,13,8,21,1,3:05
20328,661928,2022-09-03,2022,SLN,CHN,8,4,8-4,SLN,9,1,39,37,76,125,162,287,16,14,30,1,3:02
20329,662963,2022-09-03,2022,CLE,SEA,0,4,4-0,SEA,9,0,36,41,77,167,139,306,11,14,25,1,3:19
20330,663436,2022-09-03,2022,ANA,HOU,2,1,2-1,ANA,12,0,45,44,89,157,169,326,11,9,20,2,4:11
20331,663321,2022-09-03,2022,ARI,MIL,6,8,8-6,MIL,10,0,43,46,89,178,199,377,14,16,30,3,4:12
20332,662597,2022-09-03,2022,LAN,SDN,12,1,12-1,LAN,9,1,42,32,74,104,158,262,18,5,23,1,2:42
20333,663354,2022-09-04,2022,BAL,OAK,0,5,5-0,OAK,9,0,34,38,72,117,144,261,9,12,21,2,2:59
20334,662424,2022-09-04,2022,NYN,WAS,1,7,7-1,WAS,9,0,34,41,75,133,138,271,8,16,24,1,2:54
20335,662030,2022-09-04,2022,SFN,PHI,5,3,5-3,SFN,9,0,38,38,76,153,165,318,13,11,24,0,3:10
20336,661927,2022-09-04,2022,SLN,CHN,2,0,2-0,SLN,9,1,30,29,59,109,114,223,7,4,11,1,2:22 (1:28 delay)
20337,663311,2022-09-04,2022,ARI,MIL,5,1,5-1,ARI,9,1,36,32,68,128,144,272,13,5,18,1,2:39
20338,663435,2022-09-04,2022,ANA,HOU,1,9,9-1,HOU,9,0,34,41,75,132,146,278,8,16,24,1,2:43
20339,661474,2022-09-04,2022,ATL,MIA,7,1,7-1,ATL,9,1,39,32,71,124,170,294,17,6,23,1,2:59 (1:51 delay)
20340,663108,2022-09-04,2022,CIN,COL,10,0,10-0,CIN,9,1,37,36,73,158,131,289,13,12,25,3,2:49 (:10 delay)
20341,663213,2022-09-04,2022,BOS,TEX,5,2,5-2,BOS,9,1,38,34,72,157,143,300,17,8,25,2,3:07
20342,662299,2022-09-04,2022,PIT,TOR,3,4,4-3,TOR,9,0,36,40,76,151,150,301,9,15,24,1,3:02
20343,663107,2022-09-04,2022,CIN,COL,4,8,8-4,COL,9,0,35,41,76,177,125,302,9,14,23,1,2:58
20344,661853,2022-09-04,2022,TBA,NYA,1,2,2-1,NYA,9,0,37,40,77,138,172,310,8,10,18,3,3:37
20345,662786,2022-09-04,2022,DET,KCA,2,3,3-2,KCA,9,0,36,43,79,179,157,336,12,18,30,4,3:39
20346,662962,2022-09-04,2022,CLE,SEA,3,6,6-3,SEA,11,0,46,47,93,185,151,336,18,16,34,3,3:47 (4:33 delay)
20347,662599,2022-09-04,2022,LAN,SDN,9,4,9-4,LAN,9,1,41,42,83,202,151,353,16,15,31,7,4:08
20348,663108,2022-09-04,2022,CIN,COL,10,0,10-0,CIN,9,1,37,36,73,158,131,289,13,12,25,3,2:49 (:10 delay)
20349,661437,2022-09-04,2022,CHA,MIN,1,5,5-1,MIN,9,0,34,41,75,165,123,288,8,14,22,2,3:21
20350,662121,2022-09-05,2022,SEA,CHA,2,3,3-2,CHA,9,0,35,35,70,126,146,272,8,7,15,0,2:48
20351,661045,2022-09-05,2022,BAL,TOR,4,8,8-4,TOR,9,0,39,40,79,145,136,281,12,13,25,2,2:57
20352,663434,2022-09-05,2022,ANA,DET,10,0,10-0,ANA,9,1,42,34,76,125,149,274,17,6,23,1,2:53
20353,662211,2022-09-05,2022,SDN,ARI,0,5,5-0,ARI,9,0,31,36,67,151,106,257,4,10,14,0,2:51
20354,661852,2022-09-05,2022,TBA,BOS,4,3,4-3,TBA,9,1,34,39,73,171,125,296,10,13,23,1,3:00
20355,662860,2022-09-05,2022,COL,MIL,4,6,6-4,MIL,9,0,38,38,76,142,155,297,11,12,23,2,3:15
20356,661088,2022-09-05,2022,HOU,TEX,1,0,1-0,HOU,9,1,31,30,61,122,112,234,9,4,13,0,2:37
20357,661236,2022-09-05,2022,NYA,MIN,5,2,5-2,NYA,9,1,31,36,67,136,135,271,11,10,21,2,2:58
20358,661045,2022-09-05,2022,BAL,TOR,4,8,8-4,TOR,9,0,39,40,79,145,136,281,12,13,25,2,2:57
20359,663353,2022-09-05,2022,BAL,TOR,3,7,7-3,TOR,9,0,35,42,77,154,128,282,8,18,26,5,3:17
20360,661926,2022-09-05,2022,SLN,WAS,0,6,6-0,WAS,9,0,32,47,79,176,123,299,5,20,25,1,3:05
20361,662602,2022-09-05,2022,LAN,SFN,4,7,7-4,SFN,9,0,35,40,75,161,144,305,9,13,22,2,3:01
20362,662646,2022-09-05,2022,KCA,CLE,5,6,6-5,CLE,10,0,40,43,83,159,161,320,10,16,26,1,3:17
20363,662601,2022-09-06,2022,LAN,SFN,6,3,6-3,LAN,9,1,33,35,68,111,125,236,10,8,18,1,2:43
20364,661925,2022-09-06,2022,SLN,WAS,4,1,4-1,SLN,9,1,32,33,65,140,127,267,9,8,17,0,2:49
20365,662282,2022-09-06,2022,PIT,NYN,8,2,8-2,PIT,9,1,39,37,76,152,152,304,16,12,28,2,3:10
20366,662859,2022-09-06,2022,COL,MIL,10,7,10-7,COL,10,0,41,41,82,157,132,289,14,13,27,4,3:01
20367,662205,2022-09-06,2022,SDN,ARI,6,5,6-5,SDN,9,0,36,38,74,159,138,297,10,12,22,2,3:13
20368,662313,2022-09-06,2022,OAK,ATL,9,10,10-9,ATL,9,0,40,43,83,149,166,315,14,18,32,5,3:09
20369,661087,2022-09-06,2022,HOU,TEX,3,4,4-3,TEX,9,0,39,39,78,137,165,302,11,12,23,2,3:23
20370,662138,2022-09-06,2022,SEA,CHA,3,0,3-0,SEA,9,1,34,36,70,161,127,288,11,10,21,1,3:02
20371,662043,2022-09-06,2022,TBA,BOS,8,4,8-4,TBA,9,1,37,34,71,129,137,266,16,8,24,0,2:37
20372,663242,2022-09-06,2022,CHN,CIN,9,3,9-3,CHN,9,1,43,35,78,130,190,320,21,7,28,4,3:08
20373,662644,2022-09-06,2022,KCA,CLE,1,4,4-1,CLE,9,0,30,37,67,132,111,243,5,12,17,1,2:32
20374,661597,2022-09-06,2022,PHI,MIA,3,2,3-2,PHI,9,0,33,36,69,142,118,260,11,11,22,2,3:06
20375,663407,2022-09-06,2022,ANA,DET,5,4,5-4,ANA,10,0,36,40,76,136,128,264,9,12,21,2,3:01
20376,663458,2022-09-06,2022,BAL,TOR,9,6,9-6,BAL,9,1,41,41,82,155,158,313,16,15,31,5,3:53 (:17 delay)
20377,662283,2022-09-07,2022,PIT,NYN,1,5,5-1,NYN,9,0,34,38,72,122,133,255,8,11,19,0,2:36
20378,661596,2022-09-07,2022,PHI,MIA,4,3,4-3,PHI,9,1,32,36,68,133,127,260,9,10,19,1,3:02
20379,662283,2022-09-07,2022,PIT,NYN,1,5,5-1,NYN,9,0,34,38,72,122,133,255,8,11,19,0,2:36
20380,662065,2022-09-07,2022,TBA,BOS,1,0,1-0,TBA,9,1,31,37,68,140,129,269,9,10,19,0,2:51
20381,663409,2022-09-07,2022,ANA,DET,4,5,5-4,DET,9,0,42,41,83,151,185,336,15,16,31,1,3:35
20382,662582,2022-09-07,2022,LAN,SFN,7,3,7-3,LAN,9,1,42,37,79,139,167,306,18,11,29,4,3:13
20383,661235,2022-09-07,2022,NYA,MIN,7,1,7-1,NYA,9,1,39,37,76,148,178,326,17,10,27,1,3:17
20384,662285,2022-09-07,2022,PIT,NYN,0,10,10-0,NYN,9,0,31,50,81,206,121,327,5,25,30,1,3:17
20385,662312,2022-09-07,2022,OAK,ATL,3,7,7-3,ATL,9,0,34,40,74,162,155,317,7,14,21,3,3:06
20386,661235,2022-09-07,2022,NYA,MIN,7,1,7-1,NYA,9,1,39,37,76,148,178,326,17,10,27,1,3:17
20387,661251,2022-09-07,2022,NYA,MIN,5,4,5-4,NYA,12,0,46,48,94,176,182,358,15,14,29,2,4:03
20388,663457,2022-09-07,2022,BAL,TOR,1,4,4-1,TOR,9,0,31,40,71,145,111,256,4,13,17,1,3:07
20389,662871,2022-09-07,2022,COL,MIL,8,4,8-4,COL,9,1,35,35,70,144,123,267,11,8,19,1,2:35
20390,662216,2022-09-07,2022,SDN,ARI,6,3,6-3,SDN,9,1,38,34,72,132,126,258,14,10,24,2,3:03
20391,663168,2022-09-07,2022,CHN,CIN,1,7,7-1,CIN,9,0,37,38,75,164,128,292,13,12,25,3,2:54
20392,662643,2022-09-07,2022,KCA,CLE,2,1,2-1,KCA,9,0,39,37,76,127,155,282,15,10,25,3,3:12
20393,661924,2022-09-07,2022,SLN,WAS,6,5,6-5,SLN,9,0,36,38,74,144,154,298,11,13,24,4,3:18
20394,661086,2022-09-07,2022,HOU,TEX,4,3,4-3,HOU,10,0,39,38,77,152,169,321,14,8,22,3,3:37
20395,662137,2022-09-07,2022,SEA,CHA,6,9,9-6,CHA,9,0,42,40,82,156,167,323,13,12,25,4,3:32
20396,661252,2022-09-08,2022,NYA,MIN,3,4,4-3,MIN,9,0,40,35,75,134,152,286,14,9,23,4,3:21
20397,661219,2022-09-08,2022,MIL,SFN,2,1,2-1,MIL,9,1,28,30,58,112,111,223,5,4,9,0,2:20
20398,661923,2022-09-08,2022,SLN,WAS,6,11,11-6,WAS,9,0,43,47,90,174,175,349,16,20,36,4,3:57
20399,661595,2022-09-08,2022,PHI,MIA,5,6,6-5,MIA,9,0,34,44,78,154,124,278,9,17,26,0,3:04
20400,661233,2022-09-08,2022,MIL,SFN,4,2,4-2,MIL,9,1,37,35,72,150,149,299,14,8,22,5,3:08
20401,663241,2022-09-08,2022,CHN,CIN,3,4,4-3,CIN,9,0,35,40,75,162,136,298,9,15,24,6,3:14
20402,662334,2022-09-08,2022,OAK,CHA,2,14,14-2,CHA,9,0,35,50,85,195,148,343,8,24,32,1,3:16
20403,661594,2022-09-09,2022,PHI,WAS,5,3,5-3,PHI,9,1,34,36,70,127,91,218,14,10,24,3,2:39
20404,661830,2022-09-09,2022,TEX,TOR,3,4,4-3,TOR,9,0,35,37,72,153,108,261,8,13,21,3,2:49
20405,661185,2022-09-09,2022,MIL,CIN,2,8,8-2,CIN,9,0,30,43,73,155,122,277,6,19,25,1,2:42
20406,662333,2022-09-09,2022,OAK,CHA,3,5,5-3,CHA,9,0,34,38,72,141,135,276,9,9,18,1,2:53
20407,662284,2022-09-09,2022,PIT,SLN,8,2,8-2,PIT,9,1,38,37,75,155,160,315,18,9,27,3,3:12
20408,661337,2022-09-09,2022,MIA,NYN,6,3,6-3,MIA,9,1,38,36,74,151,151,302,16,11,27,4,3:05
20409,661650,2022-09-09,2022,MIN,CLE,6,7,7-6,CLE,9,0,43,42,85,157,173,330,17,16,33,2,3:36 (1:16 delay)
20410,662870,2022-09-09,2022,COL,ARI,13,10,13-10,COL,9,0,44,40,84,140,164,304,22,14,36,3,3:05
20411,662637,2022-09-09,2022,KCA,DET,2,10,10-2,DET,9,0,35,47,82,189,133,322,9,20,29,2,3:05
20412,662136,2022-09-09,2022,SEA,ATL,4,6,6-4,ATL,9,0,36,40,76,166,139,305,10,13,23,1,3:06
20413,663456,2022-09-09,2022,BAL,BOS,3,2,3-2,BAL,9,1,34,39,73,165,144,309,12,13,25,5,3:29
20414,661085,2022-09-09,2022,HOU,ANA,4,3,4-3,HOU,9,1,35,33,68,137,137,274,13,6,19,1,3:00
20415,663217,2022-09-09,2022,CHN,SFN,4,2,4-2,CHN,9,1,30,36,66,149,131,280,8,8,16,4,2:52
20416,661234,2022-09-09,2022,NYA,TBA,2,4,4-2,TBA,9,0,38,42,80,145,148,293,11,16,27,2,3:32
20417,661850,2022-09-09,2022,SDN,LAN,5,4,5-4,SDN,10,0,41,39,80,180,138,318,14,9,23,1,3:47 (:45 delay)
20418,662088,2022-09-10,2022,SEA,ATL,3,1,3-1,SEA,9,1,33,30,63,117,133,250,9,3,12,1,2:49
20419,661849,2022-09-10,2022,SDN,LAN,4,8,8-4,LAN,9,0,36,41,77,160,112,272,11,16,27,2,3:07
20420,661084,2022-09-10,2022,HOU,ANA,1,6,6-1,ANA,9,0,34,39,73,152,129,281,10,14,24,1,3:08
20421,661175,2022-09-10,2022,MIL,CIN,5,1,5-1,MIL,9,1,34,30,64,120,156,276,12,3,15,1,2:34
20422,662265,2022-09-10,2022,PIT,SLN,5,7,7-5,SLN,9,0,39,41,80,142,149,291,15,15,30,0,3:14
20423,662869,2022-09-10,2022,COL,ARI,4,1,4-1,COL,9,1,37,32,69,132,140,272,14,8,22,1,3:01
20424,662636,2022-09-10,2022,KCA,DET,4,8,8-4,DET,8,1,28,36,64,146,114,260,6,14,20,2,2:38 (:58 delay)
20425,661593,2022-09-10,2022,PHI,WAS,8,5,8-5,PHI,9,1,39,40,79,147,145,292,15,13,28,2,3:15
20426,662322,2022-09-10,2022,OAK,CHA,2,10,10-2,CHA,9,0,35,49,84,198,153,351,6,24,30,3,3:43
20427,663127,2022-09-10,2022,CHN,SFN,2,5,5-2,SFN,9,0,34,38,72,149,130,279,8,13,21,0,2:43
20428,661282,2022-09-10,2022,NYA,TBA,10,3,10-3,NYA,9,1,40,35,75,127,116,243,16,8,24,2,2:47
20429,661323,2022-09-10,2022,MIA,NYN,3,11,11-3,NYN,9,0,36,47,83,173,129,302,10,21,31,1,3:13
20430,663455,2022-09-10,2022,BAL,BOS,4,17,17-4,BOS,9,0,36,54,90,209,114,323,8,29,37,3,3:25
20431,661665,2022-09-10,2022,MIN,CLE,4,6,6-4,CLE,9,0,40,42,82,170,146,316,14,16,30,3,3:27
20432,661841,2022-09-10,2022,TEX,TOR,7,11,11-7,TOR,9,0,41,49,90,189,163,352,15,23,38,3,3:37
20433,662325,2022-09-11,2022,PIT,SLN,3,4,4-3,SLN,9,0,36,35,71,131,128,259,9,10,19,2,2:40
20434,661322,2022-09-11,2022,MIA,NYN,3,9,9-3,NYN,9,0,34,46,80,178,120,298,8,21,29,1,3:01
20435,661232,2022-09-11,2022,NYA,TBA,10,4,10-4,NYA,9,1,37,39,76,137,168,305,14,13,27,4,3:11 (1:47 delay)
20436,661176,2022-09-11,2022,MIL,CIN,7,6,7-6,MIL,9,1,39,38,77,149,155,304,15,11,26,0,3:05
20437,661839,2022-09-11,2022,TEX,TOR,4,1,4-1,TEX,9,1,36,38,74,157,144,301,12,12,24,3,3:17
20438,663264,2022-09-11,2022,BAL,BOS,0,1,1-0,BOS,9,0,36,33,69,137,137,274,9,8,17,1,2:57 (1:12 delay)
20439,661647,2022-09-11,2022,MIN,CLE,1,4,4-1,CLE,9,0,35,43,78,153,148,301,8,18,26,4,3:19
20440,662120,2022-09-11,2022,SEA,ATL,8,7,8-7,SEA,9,0,39,38,77,169,155,324,14,11,25,3,3:24
20441,661592,2022-09-11,2022,PHI,WAS,7,5,7-5,PHI,9,1,39,40,79,168,160,328,16,13,29,2,3:29 (3:36 delay)
20442,663130,2022-09-11,2022,CHN,SFN,2,4,4-2,SFN,9,0,38,36,74,166,153,319,14,10,24,3,3:21
20443,662635,2022-09-11,2022,KCA,DET,4,0,4-0,KCA,9,1,33,31,64,113,112,225,11,5,16,0,2:11
20444,661083,2022-09-11,2022,HOU,ANA,12,4,12-4,HOU,9,1,44,39,83,144,198,342,22,13,35,2,3:27
20445,662868,2022-09-11,2022,COL,ARI,6,12,12-6,ARI,9,0,36,51,87,199,152,351,9,24,33,5,3:46
20446,662323,2022-09-11,2022,OAK,CHA,10,3,10-3,OAK,9,1,41,33,74,118,148,266,17,7,24,2,2:44
20447,661848,2022-09-11,2022,SDN,LAN,2,11,11-2,LAN,9,0,37,41,78,138,139,277,9,18,27,3,3:01
20448,661799,2022-09-12,2022,TOR,TBA,3,2,3-2,TOR,9,1,31,35,66,131,111,242,8,9,17,3,2:39
20449,662782,2022-09-12,2022,DET,HOU,0,7,7-0,HOU,9,0,32,42,74,159,107,266,7,16,23,0,2:43
20450,663324,2022-09-12,2022,ARI,LAN,0,6,6-0,LAN,9,0,31,38,69,140,108,248,7,11,18,1,2:37
20451,662029,2022-09-12,2022,SFN,ATL,3,2,3-2,SFN,9,1,34,35,69,132,133,265,11,11,22,1,2:47
20452,662970,2022-09-12,2022,CLE,ANA,5,4,5-4,CLE,9,1,36,36,72,148,139,287,14,9,23,3,3:08 (:08 delay)
20453,661420,2022-09-12,2022,MIA,TEX,2,3,3-2,TEX,9,0,36,37,73,141,132,273,10,11,21,3,3:00
20454,662423,2022-09-12,2022,NYN,CHN,2,5,5-2,CHN,9,0,39,35,74,150,146,296,12,11,23,3,3:09
20455,661419,2022-09-12,2022,MIA,TEX,10,6,10-6,MIA,9,1,39,39,78,155,138,293,15,13,28,5,3:09
20456,663085,2022-09-12,2022,CIN,PIT,3,6,6-3,PIT,9,0,38,44,82,161,141,302,13,15,28,1,2:54
20457,663106,2022-09-13,2022,CIN,PIT,0,1,1-0,PIT,9,0,32,30,62,115,131,246,6,4,10,3,2:32
20458,661645,2022-09-13,2022,MIN,KCA,6,3,6-3,MIN,9,1,35,32,67,146,124,270,14,6,20,0,2:43
20459,662430,2022-09-13,2022,NYN,CHN,1,4,4-1,CHN,9,0,34,37,71,141,137,278,9,9,18,1,2:55
20460,663158,2022-09-13,2022,CIN,PIT,1,6,6-1,PIT,9,0,35,43,78,149,133,282,9,16,25,2,2:56
20461,661436,2022-09-13,2022,CHA,COL,4,2,4-2,CHA,9,1,34,33,67,129,122,251,10,6,16,1,2:40
20462,661798,2022-09-13,2022,TOR,TBA,7,2,7-2,TOR,9,1,35,37,72,144,106,250,11,11,22,5,3:03
20463,661922,2022-09-13,2022,SLN,MIL,4,8,8-4,MIL,9,0,36,44,80,147,129,276,10,17,27,5,3:07
20464,661838,2022-09-13,2022,TEX,OAK,8,7,8-7,TEX,9,0,38,38,76,150,130,280,13,11,24,2,2:51
20465,663323,2022-09-13,2022,ARI,LAN,0,4,4-0,LAN,9,0,31,43,74,175,111,286,5,17,22,0,2:54
20466,663160,2022-09-13,2022,BOS,NYA,6,7,7-6,NYA,10,0,40,40,80,161,156,317,10,14,24,3,3:37
20467,661320,2022-09-13,2022,MIA,PHI,1,2,2-1,PHI,9,0,31,34,65,128,123,251,4,9,13,0,2:34
20468,662965,2022-09-13,2022,CLE,ANA,3,1,3-1,CLE,9,1,34,34,68,137,136,273,12,9,21,2,2:58
20469,662787,2022-09-13,2022,DET,HOU,3,6,6-3,HOU,9,0,33,41,74,138,121,259,8,14,22,1,2:52
20470,661840,2022-09-13,2022,TOR,TBA,2,4,4-2,TBA,9,0,39,35,74,119,156,275,11,9,20,1,2:59
20471,662028,2022-09-13,2022,SFN,ATL,1,5,5-1,ATL,9,0,34,39,73,162,150,312,9,13,22,3,3:01
20472,662464,2022-09-13,2022,WAS,BAL,3,4,4-3,BAL,9,0,39,42,81,158,124,282,10,17,27,4,3:18
20473,662119,2022-09-13,2022,SEA,SDN,0,2,2-0,SDN,9,0,29,40,69,166,118,284,3,13,16,1,3:04
20474,662027,2022-09-14,2022,SFN,ATL,4,1,4-1,SFN,9,1,34,32,66,133,143,276,10,7,17,3,2:45
20475,662118,2022-09-14,2022,SEA,SDN,6,1,6-1,SEA,9,1,34,37,71,150,126,276,12,10,22,1,2:53
20476,662463,2022-09-14,2022,WAS,BAL,2,6,6-2,BAL,9,0,33,40,73,152,115,267,6,14,20,1,2:53
20477,663159,2022-09-14,2022,BOS,NYA,3,5,5-3,NYA,9,0,36,41,77,171,115,286,9,13,22,1,3:07
20478,661921,2022-09-14,2022,SLN,MIL,4,1,4-1,SLN,9,1,35,40,75,171,133,304,13,14,27,1,3:10
20479,661336,2022-09-14,2022,MIA,PHI,1,6,6-1,PHI,9,0,33,40,73,171,143,314,8,15,23,2,3:12
20480,662422,2022-09-14,2022,NYN,CHN,3,6,6-3,CHN,9,0,35,40,75,176,143,319,10,13,23,3,3:14
20481,661770,2022-09-14,2022,TOR,TBA,5,1,5-1,TOR,9,1,34,36,70,143,121,264,14,9,23,1,2:35
20482,662969,2022-09-14,2022,CLE,ANA,5,3,5-3,CLE,9,1,35,35,70,124,128,252,14,10,24,3,2:56
20483,661646,2022-09-14,2022,MIN,KCA,4,0,4-0,MIN,9,1,36,33,69,120,160,280,13,6,19,1,2:43
20484,661435,2022-09-14,2022,CHA,COL,0,3,3-0,COL,9,0,36,37,73,166,133,299,11,9,20,1,3:07
20485,662792,2022-09-14,2022,DET,HOU,1,2,2-1,HOU,9,0,32,37,69,162,138,300,5,10,15,1,2:58
20486,663322,2022-09-14,2022,ARI,LAN,5,3,5-3,ARI,10,0,36,40,76,175,132,307,7,9,16,2,3:18
20487,663006,2022-09-14,2022,CIN,PIT,4,10,10-4,PIT,9,0,36,43,79,181,139,320,9,17,26,1,3:05
20488,661829,2022-09-14,2022,TEX,OAK,7,8,8-7,OAK,9,0,41,43,84,182,148,330,15,15,30,4,3:40
20489,661919,2022-09-15,2022,SLN,CIN,2,3,3-2,CIN,9,0,33,37,70,146,143,289,7,12,19,1,2:45
20490,663284,2022-09-15,2022,ARI,SDN,4,0,4-0,ARI,9,1,33,31,64,117,134,251,9,4,13,2,2:38
20491,661644,2022-09-15,2022,MIN,KCA,3,2,3-2,MIN,9,1,32,34,66,144,138,282,10,7,17,0,2:49
20492,661321,2022-09-15,2022,MIA,PHI,5,3,5-3,MIA,9,1,35,35,70,153,124,277,12,10,22,1,3:02
20493,662398,2022-09-15,2022,NYN,PIT,7,1,7-1,NYN,9,1,41,33,74,138,161,299,18,6,24,0,2:53
20494,662974,2022-09-15,2022,CLE,CHA,2,8,8-2,CHA,9,0,38,40,78,161,148,309,11,16,27,2,3:04
20495,661822,2022-09-15,2022,TOR,TBA,0,11,11-0,TBA,9,0,34,42,76,167,129,296,7,16,23,2,3:06
20496,662709,2022-09-15,2022,HOU,OAK,5,2,5-2,HOU,9,1,37,34,71,148,144,292,14,7,21,3,3:14
20497,662974,2022-09-15,2022,CLE,CHA,2,8,8-2,CHA,9,0,38,40,78,161,148,309,11,16,27,2,3:04
20498,663126,2022-09-16,2022,CHN,COL,2,1,2-1,CHN,9,1,34,33,67,108,108,216,10,8,18,0,2:10
20499,662404,2022-09-16,2022,NYN,PIT,4,3,4-3,NYN,9,1,34,33,67,117,119,236,12,6,18,1,2:39
20500,663427,2022-09-16,2022,ANA,SEA,8,7,8-7,ANA,9,1,38,42,80,182,132,314,14,16,30,4,3:29
20501,662959,2022-09-16,2022,CLE,MIN,4,3,4-3,CLE,9,1,36,35,71,112,134,246,13,8,21,1,2:46
20502,661776,2022-09-16,2022,TOR,BAL,6,3,6-3,TOR,9,1,33,33,66,127,135,262,10,7,17,0,2:40
20503,663209,2022-09-16,2022,BOS,KCA,2,1,2-1,BOS,9,1,33,34,67,116,128,244,11,9,20,2,2:38
20504,662026,2022-09-16,2022,SFN,LAN,0,5,5-0,LAN,9,0,29,39,68,167,120,287,3,12,15,1,2:59
20505,662740,2022-09-16,2022,HOU,OAK,5,0,5-0,HOU,9,1,36,33,69,156,152,308,12,7,19,0,3:01
20506,662490,2022-09-16,2022,WAS,MIA,5,4,5-4,WAS,9,1,34,39,73,155,144,299,14,14,28,2,3:00
20507,661473,2022-09-16,2022,ATL,PHI,7,2,7-2,ATL,9,1,36,35,71,147,151,298,12,9,21,3,3:15
20508,663283,2022-09-16,2022,ARI,SDN,3,12,12-3,SDN,9,0,33,43,76,163,120,283,7,17,24,1,2:58
20509,662781,2022-09-16,2022,DET,CHA,3,2,3-2,DET,10,0,38,38,76,134,160,294,9,6,15,1,3:18
20510,661953,2022-09-16,2022,SLN,CIN,6,5,6-5,SLN,9,1,36,41,77,153,153,306,13,14,27,6,3:17
20511,662064,2022-09-16,2022,TBA,TEX,3,4,4-3,TEX,9,0,42,35,77,134,155,289,15,9,24,3,3:12
20512,661164,2022-09-16,2022,MIL,NYA,7,6,7-6,MIL,9,0,45,44,89,180,200,380,18,18,36,4,4:09
20513,661965,2022-09-17,2022,SLN,CIN,5,1,5-1,SLN,9,1,38,36,74,117,155,272,15,10,25,0,2:45
20514,663426,2022-09-17,2022,ANA,SEA,2,1,2-1,ANA,9,1,29,32,61,139,113,252,6,7,13,0,2:48
20515,661163,2022-09-17,2022,MIL,NYA,4,1,4-1,MIL,9,1,33,33,66,113,140,253,9,7,16,0,2:56
20516,663208,2022-09-17,2022,BOS,KCA,0,9,9-0,KCA,9,0,33,44,77,158,119,277,7,17,24,2,2:39
20517,663289,2022-09-17,2022,ARI,SDN,0,2,2-0,SDN,9,0,32,34,66,149,125,274,5,8,13,1,2:51
20518,661965,2022-09-17,2022,SLN,CIN,5,1,5-1,SLN,9,1,38,36,74,117,155,272,15,10,25,0,2:45
20519,662462,2022-09-17,2022,WAS,MIA,5,3,5-3,WAS,9,1,34,34,68,146,148,294,10,8,18,2,3:02
20520,662403,2022-09-17,2022,NYN,PIT,5,1,5-1,NYN,9,1,41,34,75,135,158,293,17,8,25,2,3:06
20521,661769,2022-09-17,2022,TOR,BAL,6,3,6-3,TOR,9,1,35,39,74,154,134,288,11,13,24,1,3:00
20522,662024,2022-09-17,2022,SFN,LAN,2,7,7-2,LAN,9,0,36,43,79,149,142,291,8,17,25,2,3:12
20523,662823,2022-09-17,2022,HOU,OAK,5,8,8-5,OAK,9,0,35,41,76,140,98,238,10,14,24,0,2:28
20524,662015,2022-09-17,2022,TBA,TEX,5,1,5-1,TBA,9,1,32,35,67,128,124,252,10,9,19,4,3:00
20525,663141,2022-09-17,2022,CLE,MIN,5,1,5-1,CLE,9,1,39,30,69,101,139,240,18,4,22,0,2:32
20526,663129,2022-09-17,2022,CHN,COL,1,3,3-1,COL,9,0,38,34,72,129,149,278,12,6,18,0,2:48
20527,661472,2022-09-17,2022,ATL,PHI,4,3,4-3,ATL,9,1,34,38,72,168,116,284,10,11,21,3,3:18
20528,661952,2022-09-17,2022,SLN,CIN,1,0,1-0,SLN,11,0,39,37,76,146,150,296,11,4,15,1,3:11
20529,662784,2022-09-17,2022,DET,CHA,3,4,4-3,CHA,11,0,40,41,81,154,154,308,7,8,15,1,3:29
20530,662958,2022-09-17,2022,CLE,MIN,7,6,7-6,CLE,15,0,65,58,123,211,235,446,26,16,42,6,5:24
20531,662968,2022-09-18,2022,CLE,MIN,0,3,3-0,MIN,9,0,32,38,70,126,117,243,7,13,20,1,2:43
20532,661994,2022-09-18,2022,TBA,TEX,5,3,5-3,TBA,9,1,35,35,70,141,132,273,12,7,19,3,2:58
20533,662783,2022-09-18,2022,DET,CHA,5,11,11-5,CHA,9,0,36,44,80,166,136,302,10,16,26,2,3:14
20534,661930,2022-09-18,2022,SLN,CIN,0,3,3-0,CIN,9,0,32,37,69,141,120,261,6,12,18,3,2:50
20535,663425,2022-09-18,2022,ANA,SEA,5,1,5-1,ANA,9,1,34,36,70,153,122,275,11,9,20,2,2:43
20536,662461,2022-09-18,2022,WAS,MIA,1,3,3-1,MIA,9,0,33,37,70,148,103,251,9,11,20,0,2:27
20537,663287,2022-09-18,2022,ARI,SDN,1,6,6-1,SDN,9,0,33,39,72,138,143,281,5,13,18,1,3:03
20538,661471,2022-09-18,2022,ATL,PHI,5,2,5-2,ATL,9,1,36,36,72,158,132,290,12,8,20,1,3:06
20539,662822,2022-09-18,2022,HOU,OAK,11,2,11-2,HOU,9,1,41,33,74,124,159,283,18,6,24,3,3:09
20540,661162,2022-09-18,2022,MIL,NYA,8,12,12-8,NYA,9,0,43,47,90,191,170,361,16,20,36,6,3:46
20541,661780,2022-09-18,2022,TOR,BAL,4,5,5-4,BAL,9,0,39,41,80,149,148,297,14,17,31,1,3:18
20542,663112,2022-09-18,2022,CHN,COL,3,4,4-3,COL,9,0,35,40,75,167,135,302,8,13,21,1,3:07
20543,662402,2022-09-18,2022,NYN,PIT,7,3,7-3,NYN,9,1,44,33,77,159,167,326,19,6,25,3,3:29
20544,663207,2022-09-18,2022,BOS,KCA,13,3,13-3,BOS,9,1,48,40,88,171,178,349,25,13,38,2,3:32
20545,662025,2022-09-18,2022,SFN,LAN,3,4,4-3,LAN,10,0,42,42,84,169,187,356,13,14,27,4,4:11 (:20 delay)
20546,662622,2022-09-19,2022,LAN,ARI,5,2,5-2,LAN,9,1,34,35,69,131,133,264,13,9,22,0,2:46
20547,662013,2022-09-19,2022,TBA,HOU,0,4,4-0,HOU,9,0,37,34,71,114,148,262,10,7,17,0,2:45
20548,661470,2022-09-19,2022,ATL,WAS,5,2,5-2,ATL,9,1,35,36,71,133,134,267,14,10,24,0,2:46
20549,661161,2022-09-19,2022,MIL,NYN,2,7,7-2,NYN,9,0,31,41,72,164,114,278,4,16,20,1,2:49
20550,663044,2022-09-19,2022,CLE,MIN,11,4,11-4,CLE,9,1,44,37,81,129,170,299,20,13,33,3,3:10
20551,661299,2022-09-19,2022,MIA,CHN,10,3,10-3,MIA,9,1,42,38,80,150,170,320,18,13,31,1,2:57
20552,662886,2022-09-19,2022,COL,SFN,7,10,10-7,SFN,10,0,48,48,96,176,160,336,19,19,38,2,3:45
20553,663263,2022-09-19,2022,BAL,DET,0,11,11-0,DET,9,0,32,45,77,168,120,288,6,18,24,2,2:58
20554,663423,2022-09-19,2022,ANA,SEA,1,9,9-1,SEA,9,0,37,43,80,172,147,319,10,17,27,1,3:08
20555,662204,2022-09-20,2022,SDN,SLN,5,0,5-0,SDN,9,1,35,34,69,136,152,288,12,8,20,1,2:56
20556,662634,2022-09-20,2022,KCA,MIN,5,4,5-4,KCA,9,1,35,38,73,132,132,264,13,13,26,3,2:58
20557,661469,2022-09-20,2022,ATL,WAS,3,2,3-2,ATL,9,1,32,40,72,151,135,286,8,14,22,3,3:18
20558,661298,2022-09-20,2022,MIA,CHN,1,2,2-1,CHN,9,0,34,35,69,146,127,273,10,8,18,1,2:48
20559,662621,2022-09-20,2022,LAN,ARI,6,5,6-5,LAN,9,1,45,40,85,158,188,346,19,12,31,2,3:30
20560,662321,2022-09-20,2022,OAK,SEA,4,1,4-1,OAK,9,1,34,33,67,139,132,271,11,6,17,1,2:49
20561,662607,2022-09-20,2022,LAN,ARI,2,5,5-2,ARI,9,0,35,39,74,129,126,255,9,11,20,1,2:49
20562,661837,2022-09-20,2022,TEX,ANA,2,5,5-2,ANA,9,0,33,36,69,144,135,279,9,13,22,3,2:50
20563,663262,2022-09-20,2022,BAL,DET,2,3,3-2,DET,9,0,38,36,74,109,148,257,11,10,21,2,2:58
20564,662867,2022-09-20,2022,COL,SFN,3,6,6-3,SFN,9,0,37,39,76,152,140,292,12,13,25,3,3:07
20565,662012,2022-09-20,2022,TBA,HOU,0,5,5-0,HOU,9,0,35,38,73,152,154,306,9,14,23,2,3:10
20566,663104,2022-09-20,2022,CIN,BOS,3,5,5-3,BOS,9,0,40,41,81,170,144,314,14,16,30,3,3:27
20567,661159,2022-09-20,2022,MIL,NYN,5,7,7-5,NYN,9,0,42,37,79,136,183,319,15,10,25,6,3:19
20568,661229,2022-09-20,2022,NYA,PIT,9,8,9-8,NYA,9,0,41,44,85,171,168,339,15,16,31,3,3:33
20569,661434,2022-09-20,2022,CHA,CLE,7,10,10-7,CLE,11,0,45,49,94,190,149,339,12,19,31,2,3:57 (:40 delay)
20570,661591,2022-09-20,2022,PHI,TOR,11,18,18-11,TOR,9,0,45,53,98,175,163,338,18,25,43,3,3:41
20571,661158,2022-09-21,2022,MIL,NYN,6,0,6-0,MIL,9,1,34,36,70,142,117,259,12,10,22,3,2:47
20572,663261,2022-09-21,2022,BAL,DET,8,1,8-1,BAL,9,1,39,29,68,94,152,246,14,3,17,1,2:27
20573,661297,2022-09-21,2022,MIA,CHN,3,4,4-3,CHN,9,0,35,36,71,156,139,295,8,7,15,2,2:47
20574,661228,2022-09-21,2022,NYA,PIT,14,2,14-2,NYA,9,1,40,35,75,126,155,281,16,8,24,3,2:51
20575,662606,2022-09-21,2022,LAN,ARI,1,6,6-1,ARI,9,0,31,39,70,137,136,273,5,12,17,0,2:53
20576,661468,2022-09-21,2022,ATL,WAS,2,3,3-2,WAS,9,0,37,39,76,143,164,307,13,12,25,3,3:13
20577,662320,2022-09-21,2022,OAK,SEA,2,1,2-1,OAK,9,1,33,30,63,116,135,251,10,5,15,1,2:39
20578,661070,2022-09-21,2022,CIN,BOS,5,1,5-1,CIN,9,1,33,31,64,140,119,259,10,7,17,1,2:37
20579,661588,2022-09-21,2022,PHI,TOR,4,3,4-3,PHI,10,0,45,42,87,179,168,347,17,14,31,2,4:08
20580,662899,2022-09-21,2022,COL,SFN,1,6,6-1,SFN,9,0,34,42,76,141,128,269,7,16,23,3,2:39
20581,661783,2022-09-21,2022,TEX,ANA,7,2,7-2,TEX,9,1,35,32,67,128,130,258,11,8,19,1,2:35
20582,662011,2022-09-21,2022,TBA,HOU,2,5,5-2,HOU,9,0,37,38,75,115,140,255,10,12,22,0,2:47
20583,661433,2022-09-21,2022,CHA,CLE,2,8,8-2,CLE,9,0,34,42,76,147,111,258,7,15,22,0,2:31
20584,662203,2022-09-21,2022,SDN,SLN,1,0,1-0,SDN,9,1,32,31,63,141,139,280,9,4,13,1,2:55
20585,662633,2022-09-21,2022,KCA,MIN,5,2,5-2,KCA,9,1,34,36,70,158,126,284,11,10,21,2,2:56
20586,663260,2022-09-22,2022,BAL,HOU,2,0,2-0,BAL,9,1,29,29,58,106,124,230,7,2,9,1,2:37
20587,662632,2022-09-22,2022,KCA,MIN,4,1,4-1,KCA,9,1,35,32,67,138,120,258,11,6,17,0,2:34
20588,662586,2022-09-22,2022,LAN,ARI,3,2,3-2,LAN,9,0,33,34,67,144,128,272,8,7,15,2,3:05
20589,662898,2022-09-22,2022,COL,SFN,0,3,3-0,SFN,9,0,34,38,72,164,121,285,11,13,24,2,3:02
20590,661806,2022-09-22,2022,TEX,ANA,5,3,5-3,TEX,9,1,32,38,70,131,146,277,10,11,21,2,2:49
20591,662306,2022-09-22,2022,OAK,SEA,5,9,9-5,SEA,9,0,40,40,80,145,155,300,13,15,28,3,3:22
20592,661432,2022-09-22,2022,CHA,CLE,2,4,4-2,CLE,9,0,33,37,70,125,116,241,7,10,17,1,2:33
20593,661243,2022-09-22,2022,NYA,BOS,5,4,5-4,NYA,10,0,40,42,82,177,141,318,18,13,31,1,3:34
20594,661609,2022-09-22,2022,PHI,ATL,1,0,1-0,PHI,9,1,32,36,68,114,154,268,8,9,17,1,3:08
20595,661069,2022-09-22,2022,CIN,MIL,1,5,5-1,MIL,9,0,33,36,69,151,142,293,7,9,16,1,2:50
20596,662202,2022-09-22,2022,SDN,SLN,4,5,5-4,SLN,9,0,37,38,75,139,138,277,11,12,23,1,3:03
20597,662264,2022-09-22,2022,PIT,CHN,2,3,3-2,CHN,9,0,39,35,74,148,142,290,14,10,24,2,3:04 (:26 delay)
20598,662041,2022-09-22,2022,TBA,TOR,10,5,10-5,TBA,9,1,41,37,78,161,182,343,17,11,28,1,3:30
20599,663259,2022-09-23,2022,BAL,HOU,6,0,6-0,BAL,9,1,35,31,66,106,141,247,11,6,17,2,2:40
20600,661222,2022-09-23,2022,NYA,BOS,5,4,5-4,NYA,9,1,35,35,70,145,141,286,12,10,22,0,3:00
20601,662642,2022-09-23,2022,KCA,SEA,5,1,5-1,KCA,9,1,35,35,70,144,124,268,11,10,21,0,2:29
20602,662305,2022-09-23,2022,OAK,NYN,2,9,9-2,NYN,9,0,32,43,75,140,104,244,7,18,25,1,2:31
20603,662585,2022-09-23,2022,LAN,SLN,0,11,11-0,SLN,9,0,34,44,78,166,141,307,9,15,24,2,2:57
20604,661668,2022-09-23,2022,MIN,ANA,2,4,4-2,ANA,9,0,37,37,74,149,148,297,12,11,23,4,3:21
20605,661431,2022-09-23,2022,CHA,DET,3,5,5-3,DET,9,0,39,38,77,144,135,279,12,12,24,1,3:04
20606,661587,2022-09-23,2022,PHI,ATL,9,1,9-1,PHI,9,1,42,35,77,146,165,311,19,9,28,0,3:20
20607,661068,2022-09-23,2022,CIN,MIL,3,5,5-3,MIL,9,0,37,44,81,174,136,310,11,17,28,3,3:22
20608,662897,2022-09-23,2022,COL,SDN,4,3,4-3,COL,10,0,43,38,81,160,156,316,17,8,25,2,3:23
20609,662040,2022-09-23,2022,TBA,TOR,10,6,10-6,TBA,9,1,40,40,80,155,153,308,18,13,31,2,3:21
20610,661296,2022-09-23,2022,MIA,WAS,5,2,5-2,MIA,9,1,37,35,72,123,132,255,14,8,22,2,2:41
20611,663282,2022-09-23,2022,ARI,SFN,5,6,6-5,SFN,9,0,42,41,83,155,182,337,15,15,30,3,3:37
20612,661807,2022-09-23,2022,TEX,CLE,3,6,6-3,CLE,9,0,41,37,78,159,175,334,14,10,24,2,3:31
20613,662263,2022-09-23,2022,PIT,CHN,5,6,6-5,CHN,9,0,40,44,84,185,171,356,14,19,33,1,3:33
20614,661805,2022-09-24,2022,TEX,CLE,2,4,4-2,CLE,9,0,36,35,71,117,119,236,10,10,20,1,2:30
20615,662249,2022-09-24,2022,PIT,CHN,6,0,6-0,PIT,9,1,35,33,68,124,126,250,10,6,16,1,2:26
20616,661295,2022-09-24,2022,MIA,WAS,4,1,4-1,MIA,9,1,34,31,65,112,125,237,11,5,16,1,2:18
20617,662039,2022-09-24,2022,TBA,TOR,1,3,3-1,TOR,9,0,35,34,69,131,147,278,9,9,18,3,3:18
20618,661430,2022-09-24,2022,CHA,DET,2,7,7-2,DET,9,0,36,41,77,152,127,279,9,16,25,1,3:01
20619,662311,2022-09-24,2022,OAK,NYN,10,4,10-4,OAK,9,1,44,37,81,131,147,278,20,13,33,1,2:55
20620,662584,2022-09-24,2022,LAN,SLN,6,2,6-2,LAN,9,1,35,35,70,128,146,274,12,9,21,0,2:50
20621,661067,2022-09-24,2022,CIN,MIL,2,10,10-2,MIL,9,0,34,42,76,159,145,304,9,17,26,1,2:57
20622,661656,2022-09-24,2022,MIN,ANA,8,4,8-4,MIN,9,1,38,39,77,153,132,285,12,11,23,2,2:49
20623,663281,2022-09-24,2022,ARI,SFN,5,2,5-2,ARI,9,1,34,32,66,115,134,249,10,5,15,0,2:37
20624,662866,2022-09-24,2022,COL,SDN,3,9,9-3,SDN,9,0,36,42,78,167,131,298,9,16,25,2,3:14
20625,661221,2022-09-24,2022,NYA,BOS,7,5,7-5,NYA,9,1,36,43,79,159,155,314,14,16,30,3,3:25
20626,661586,2022-09-24,2022,PHI,ATL,3,6,6-3,ATL,9,0,35,40,75,166,154,320,6,15,21,3,3:22
20627,662641,2022-09-24,2022,KCA,SEA,5,6,6-5,SEA,9,0,37,47,84,201,119,320,11,22,33,4,3:25
20628,663258,2022-09-24,2022,BAL,HOU,10,11,11-10,HOU,9,0,46,43,89,164,170,334,18,18,36,4,3:58
20629,661220,2022-09-25,2022,NYA,BOS,2,0,2-0,NYA,6,0,27,21,48,101,95,196,8,3,11,0,2:07 (1:38 delay)
20630,661828,2022-09-25,2022,TEX,CLE,4,10,10-4,CLE,9,0,35,42,77,151,147,298,7,15,22,1,2:54
20631,663280,2022-09-25,2022,ARI,SFN,2,3,3-2,SFN,9,0,35,42,77,160,138,298,8,17,25,4,3:19
20632,662598,2022-09-25,2022,LAN,SLN,4,1,4-1,LAN,9,1,35,34,69,118,148,266,11,8,19,1,2:48
20633,661066,2022-09-25,2022,CIN,MIL,2,1,2-1,CIN,9,1,34,31,65,137,147,284,11,6,17,1,2:46
20634,662063,2022-09-25,2022,TBA,TOR,1,7,7-1,TOR,9,0,36,40,76,159,137,296,9,14,23,1,3:04
20635,662631,2022-09-25,2022,KCA,SEA,13,12,13-12,KCA,9,1,42,48,90,174,178,352,21,23,44,6,3:43
20636,661667,2022-09-25,2022,MIN,ANA,3,10,10-3,ANA,9,0,40,46,86,190,160,350,13,19,32,5,3:47
20637,661429,2022-09-25,2022,CHA,DET,1,4,4-1,DET,9,0,33,41,74,153,130,283,9,16,25,1,3:04
20638,662310,2022-09-25,2022,OAK,NYN,4,13,13-4,NYN,9,0,36,49,85,170,144,314,10,23,33,2,3:07
20639,662243,2022-09-25,2022,PIT,CHN,3,8,8-3,CHN,9,0,36,44,80,184,132,316,10,15,25,3,3:08
20640,661294,2022-09-25,2022,MIA,WAS,1,6,6-1,WAS,9,0,35,40,75,140,152,292,9,14,23,2,3:09
20641,663454,2022-09-25,2022,BAL,HOU,3,6,6-3,HOU,11,0,39,44,83,192,165,357,9,14,23,5,4:02 (:46 delay)
20642,662865,2022-09-25,2022,COL,SDN,6,13,13-6,SDN,9,0,41,50,91,187,160,347,15,23,38,4,3:43
20643,661585,2022-09-25,2022,PHI,ATL,7,8,8-7,ATL,11,0,46,48,94,179,182,361,16,17,33,1,4:09 (2:09 delay)
20644,662460,2022-09-26,2022,WAS,ATL,0,8,8-0,ATL,9,0,32,38,70,144,106,250,7,13,20,1,2:24
20645,662242,2022-09-26,2022,PIT,CIN,8,3,8-3,PIT,9,1,43,34,77,129,194,323,19,6,25,3,3:05 (:38 delay)
20646,663250,2022-09-26,2022,BOS,BAL,8,14,14-8,BAL,9,0,42,48,90,192,148,340,18,22,40,2,3:19 (1:40 delay)
20647,661768,2022-09-26,2022,TOR,NYA,3,2,3-2,TOR,10,0,39,38,77,153,150,303,11,11,22,3,3:29
20648,663128,2022-09-27,2022,CHN,PHI,2,1,2-1,CHN,9,1,29,32,61,112,87,199,8,8,16,1,2:15
20649,661666,2022-09-27,2022,MIN,CHA,4,0,4-0,MIN,9,1,35,29,64,116,151,267,12,3,15,2,2:38
20650,662046,2022-09-27,2022,SFN,COL,5,2,5-2,SFN,9,1,34,37,71,135,125,260,10,11,21,0,2:33
20651,662241,2022-09-27,2022,PIT,CIN,4,1,4-1,PIT,9,1,37,36,73,151,148,299,14,11,25,0,3:01
20652,662774,2022-09-27,2022,DET,KCA,4,3,4-3,DET,10,0,39,40,79,142,140,282,14,12,26,2,3:00
20653,661155,2022-09-27,2022,MIL,SLN,2,6,6-2,SLN,9,0,35,41,76,178,142,320,9,15,24,4,3:13
20654,662210,2022-09-27,2022,SDN,LAN,4,3,4-3,SDN,10,0,41,46,87,207,147,354,12,15,27,2,4:09
20655,663422,2022-09-27,2022,ANA,OAK,4,3,4-3,ANA,9,1,37,36,73,140,131,271,13,11,24,3,3:14
20656,661778,2022-09-27,2022,TOR,NYA,2,5,5-2,NYA,9,0,32,42,74,166,111,277,8,16,24,3,2:55
20657,662401,2022-09-27,2022,NYN,MIA,4,6,6-4,MIA,9,0,34,42,76,180,140,320,7,17,24,0,3:17
20658,662489,2022-09-27,2022,WAS,ATL,2,8,8-2,ATL,9,0,34,41,75,153,131,284,7,13,20,1,2:47
20659,663206,2022-09-27,2022,BOS,BAL,13,9,13-9,BOS,9,1,46,44,90,176,204,380,23,18,41,4,3:57
20660,662117,2022-09-27,2022,SEA,TEX,0,5,5-0,TEX,9,0,36,37,73,144,177,321,10,12,22,3,3:22
20661,662821,2022-09-27,2022,HOU,ARI,10,2,10-2,HOU,9,1,44,35,79,138,191,329,20,8,28,2,3:28
20662,662955,2022-09-27,2022,CLE,TBA,5,6,6-5,TBA,11,0,50,41,91,159,212,371,20,8,28,1,4:06 (:23 delay)
20663,663181,2022-09-28,2022,BOS,BAL,3,1,3-1,BOS,9,1,33,34,67,140,132,272,11,9,20,1,2:39
20664,662967,2022-09-28,2022,CLE,TBA,2,1,2-1,CLE,10,0,36,37,73,152,159,311,11,9,20,2,3:19 (1:03 delay)
20665,662773,2022-09-28,2022,DET,KCA,2,1,2-1,DET,9,1,32,41,73,153,138,291,8,16,24,1,2:50
20666,661112,2022-09-28,2022,SEA,TEX,3,1,3-1,SEA,9,1,33,31,64,117,128,245,10,6,16,0,2:34
20667,663098,2022-09-28,2022,CHN,PHI,4,2,4-2,CHN,9,1,32,41,73,139,119,258,7,14,21,4,2:59
20668,661099,2022-09-28,2022,WAS,ATL,3,2,3-2,WAS,10,0,38,39,77,143,149,292,9,9,18,1,3:13
20669,662240,2022-09-28,2022,PIT,CIN,4,3,4-3,PIT,10,0,43,38,81,118,148,266,15,9,24,0,2:37
20670,663421,2022-09-28,2022,ANA,OAK,4,1,4-1,ANA,9,1,34,35,69,151,148,299,9,8,17,4,3:23
20671,661737,2022-09-28,2022,TOR,NYA,3,8,8-3,NYA,9,0,34,43,77,158,140,298,8,15,23,5,3:20
20672,661133,2022-09-28,2022,MIN,CHA,8,4,8-4,MIN,9,1,39,37,76,156,128,284,18,11,29,2,3:06
20673,662820,2022-09-28,2022,HOU,ARI,2,5,5-2,ARI,10,0,38,40,78,143,149,292,10,11,21,1,3:29
20674,661154,2022-09-28,2022,MIL,SLN,5,1,5-1,MIL,9,1,38,39,77,163,156,319,15,14,29,4,3:31
20675,662214,2022-09-28,2022,SDN,LAN,0,1,1-0,LAN,10,0,37,41,78,177,148,325,9,11,20,0,3:44
20676,662045,2022-09-28,2022,SFN,COL,6,3,6-3,SFN,9,1,37,36,73,157,167,324,13,8,21,1,3:19
20677,662400,2022-09-28,2022,NYN,MIA,5,4,5-4,NYN,10,0,42,40,82,164,166,330,15,10,25,4,3:26
20678,663420,2022-09-29,2022,ANA,OAK,4,2,4-2,ANA,9,1,37,32,69,135,140,275,16,6,22,1,3:07
20679,661156,2022-09-29,2022,MIL,MIA,2,4,4-2,MIA,9,0,37,35,72,136,148,284,13,7,20,2,3:08
20680,663110,2022-09-29,2022,CHN,PHI,2,0,2-0,CHN,9,1,37,36,73,138,143,281,13,10,23,1,2:55
20681,662050,2022-09-29,2022,SFN,COL,6,4,6-4,SFN,9,1,34,35,69,176,120,296,12,8,20,2,2:57
20682,663180,2022-09-29,2022,BOS,BAL,5,3,5-3,BOS,9,1,35,38,73,155,149,304,11,10,21,1,3:00
20683,662209,2022-09-29,2022,SDN,LAN,2,5,5-2,LAN,9,0,39,37,76,154,160,314,13,10,23,3,3:17
20684,662772,2022-09-29,2022,DET,KCA,10,3,10-3,DET,9,1,42,41,83,140,161,301,17,14,31,4,3:03
20685,661132,2022-09-29,2022,MIN,CHA,3,4,4-3,CHA,9,0,39,37,76,142,159,301,12,10,22,2,3:11
20686,662932,2022-09-29,2022,CLE,TBA,2,1,2-1,CLE,9,1,32,35,67,145,114,259,8,8,16,0,2:43
20687,661128,2022-09-29,2022,SEA,TEX,10,9,10-9,SEA,11,0,46,47,93,188,191,379,18,16,34,2,3:48
20688,661157,2022-09-30,2022,MIL,MIA,1,0,1-0,MIL,9,1,29,32,61,130,100,230,5,7,12,0,2:28
20689,663406,2022-09-30,2022,ANA,TEX,4,1,4-1,ANA,9,1,37,33,70,130,130,260,12,6,18,1,2:35
20690,662940,2022-09-30,2022,CLE,KCA,6,3,6-3,CLE,9,1,35,30,65,114,129,243,11,4,15,1,2:27
20691,661467,2022-09-30,2022,ATL,NYN,5,2,5-2,ATL,9,1,31,35,66,140,123,263,8,10,18,1,2:54
20692,661111,2022-09-30,2022,SEA,OAK,2,1,2-1,SEA,9,0,33,30,63,109,153,262,10,5,15,0,2:47
20693,663099,2022-09-30,2022,CHN,CIN,6,1,6-1,CHN,9,1,35,32,67,121,131,252,11,6,17,1,2:29
20694,662819,2022-09-30,2022,HOU,TBA,3,7,7-3,TBA,9,0,34,42,76,150,104,254,7,15,22,1,2:54
20695,661751,2022-09-30,2022,TOR,BOS,9,0,9-0,TOR,9,1,40,32,72,141,146,287,16,6,22,0,3:04
20696,661218,2022-09-30,2022,NYA,BAL,1,2,2-1,BAL,9,0,33,38,71,155,134,289,7,12,19,3,3:12
20697,661958,2022-09-30,2022,SLN,PIT,2,1,2-1,SLN,9,1,33,39,72,154,127,281,10,12,22,1,3:01
20698,662771,2022-09-30,2022,DET,MIN,0,7,7-0,MIN,9,0,35,45,80,164,144,308,8,19,27,1,3:17
20699,662208,2022-09-30,2022,SDN,CHA,1,3,3-1,CHA,9,0,36,36,72,134,172,306,10,9,19,2,3:23
20700,662596,2022-09-30,2022,LAN,COL,10,1,10-1,LAN,9,1,42,35,77,122,156,278,18,9,27,1,2:45
20701,662049,2022-09-30,2022,SFN,ARI,10,4,10-4,SFN,9,1,39,40,79,151,148,299,15,15,30,1,2:59
20702,661097,2022-09-30,2022,WAS,PHI,1,5,5-1,PHI,9,0,36,41,77,174,162,336,11,13,24,1,3:17
20703,663405,2022-10-01,2022,ANA,TEX,3,2,3-2,ANA,9,1,32,29,61,115,113,228,9,2,11,1,2:27
20704,662207,2022-10-01,2022,SDN,CHA,5,2,5-2,SDN,9,1,37,32,69,121,152,273,14,7,21,2,3:07
20705,661110,2022-10-01,2022,SEA,OAK,5,1,5-1,SEA,9,1,34,31,65,122,132,254,11,4,15,0,2:36
20706,661217,2022-10-01,2022,NYA,BAL,8,0,8-0,NYA,9,1,39,32,71,118,124,242,19,6,25,1,2:38 (:27 delay)
20707,662818,2022-10-01,2022,HOU,TBA,2,1,2-1,HOU,9,1,31,33,64,147,101,248,7,8,15,0,2:44
20708,663167,2022-10-01,2022,CHN,CIN,2,1,2-1,CHN,9,1,34,33,67,123,146,269,10,5,15,2,2:32
20709,661466,2022-10-01,2022,ATL,NYN,4,2,4-2,ATL,9,1,33,36,69,132,133,265,11,9,20,2,2:54
20710,661098,2022-10-01,2022,WAS,PHI,2,8,8-2,PHI,9,0,36,42,78,152,126,278,9,15,24,2,2:49
20711,662770,2022-10-01,2022,DET,MIN,3,2,3-2,DET,9,1,32,39,71,179,118,297,7,15,22,3,3:12
20712,662572,2022-10-01,2022,WAS,PHI,13,4,13-4,WAS,9,1,42,37,79,137,155,292,18,11,29,2,2:58 (:41 delay)
20713,661956,2022-10-01,2022,SLN,PIT,13,3,13-3,SLN,9,1,43,35,78,129,168,297,18,8,26,2,3:01
20714,661152,2022-10-01,2022,MIL,MIA,3,4,4-3,MIA,9,0,39,33,72,137,172,309,12,6,18,4,3:28
20715,661098,2022-10-01,2022,WAS,PHI,2,8,8-2,PHI,9,0,36,42,78,152,126,278,9,15,24,2,2:49
20716,662023,2022-10-01,2022,SFN,ARI,4,8,8-4,ARI,9,0,37,44,81,147,150,297,11,16,27,2,3:10
20717,662939,2022-10-01,2022,CLE,KCA,1,7,7-1,KCA,9,0,35,43,78,163,164,327,10,17,27,2,3:21
20718,661736,2022-10-01,2022,TOR,BOS,10,0,10-0,TOR,9,1,46,33,79,135,169,304,24,6,30,1,3:09
20719,662595,2022-10-01,2022,LAN,COL,6,4,6-4,LAN,9,1,45,36,81,145,167,312,21,12,33,4,3:29
20720,661096,2022-10-02,2022,WAS,PHI,1,8,8-1,PHI,6,0,22,33,55,123,96,219,4,15,19,1,2:20 (1:28 delay)
20721,662087,2022-10-02,2022,SEA,OAK,3,10,10-3,OAK,9,0,38,43,81,137,158,295,11,16,27,1,3:11
20722,663419,2022-10-02,2022,ANA,TEX,8,3,8-3,ANA,9,1,39,39,78,142,141,283,20,11,31,1,2:50
20723,662825,2022-10-02,2022,HOU,TBA,3,1,3-1,HOU,9,1,35,36,71,147,124,271,11,10,21,0,2:56
20724,661215,2022-10-02,2022,NYA,BAL,1,3,3-1,BAL,9,0,35,42,77,168,147,315,9,16,25,4,3:35
20725,661735,2022-10-02,2022,TOR,BOS,6,3,6-3,TOR,9,1,35,35,70,136,141,277,12,8,20,0,2:50
20726,662581,2022-10-02,2022,LAN,COL,1,4,4-1,COL,9,0,34,38,72,143,132,275,7,12,19,0,2:49
20727,662190,2022-10-02,2022,SDN,CHA,1,2,2-1,CHA,9,0,36,35,71,154,134,288,9,8,17,0,3:06
20728,661465,2022-10-02,2022,ATL,NYN,5,3,5-3,ATL,9,1,34,39,73,140,155,295,10,13,23,5,3:21
20729,663097,2022-10-02,2022,CHN,CIN,8,1,8-1,CHN,9,1,42,36,78,120,188,308,18,9,27,1,2:53
20730,662938,2022-10-02,2022,CLE,KCA,7,5,7-5,CLE,9,1,37,43,80,175,143,318,14,16,30,2,3:00
20731,661954,2022-10-02,2022,SLN,PIT,5,7,7-5,PIT,9,0,42,39,81,144,163,307,15,12,27,3,3:18
20732,662769,2022-10-02,2022,DET,MIN,5,2,5-2,DET,9,1,33,36,69,159,147,306,10,8,18,1,3:09
20733,662022,2022-10-02,2022,SFN,ARI,4,3,4-3,SFN,10,0,40,42,82,148,172,320,13,15,28,1,3:36
20734,661153,2022-10-02,2022,MIL,MIA,3,4,4-3,MIA,12,0,48,47,95,198,181,379,17,13,30,4,4:12
20735,663453,2022-10-03,2022,BOS,TBA,4,3,4-3,BOS,9,1,35,32,67,128,141,269,10,6,16,1,2:35
20736,663273,2022-10-03,2022,BAL,TOR,1,5,5-1,TOR,8,1,27,34,61,123,105,228,6,13,19,0,2:16 (:54 delay)
20737,662201,2022-10-03,2022,SEA,DET,3,4,4-3,DET,9,0,36,39,75,170,122,292,10,13,23,1,3:11
20738,662044,2022-10-03,2022,TEX,NYA,1,3,3-1,NYA,9,0,29,36,65,126,114,240,3,15,18,0,2:29
20739,663096,2022-10-03,2022,CIN,CHN,3,1,3-1,CIN,9,1,33,31,64,131,125,256,11,7,18,1,2:31
20740,661464,2022-10-03,2022,CHA,MIN,3,2,3-2,CHA,9,1,31,36,67,138,123,261,6,10,16,0,2:32
20741,662309,2022-10-03,2022,PIT,SLN,3,2,3-2,PIT,9,0,33,38,71,159,136,295,10,11,21,5,3:10
20742,662629,2022-10-03,2022,LAN,COL,1,2,2-1,COL,9,0,32,37,69,160,130,290,6,10,16,1,3:02
20743,662777,2022-10-03,2022,HOU,PHI,0,3,3-0,PHI,9,0,29,38,67,167,121,288,2,14,16,1,2:59
20744,661424,2022-10-03,2022,MIA,ATL,4,0,4-0,MIA,9,1,34,32,66,131,139,270,11,5,16,0,2:29
20745,663105,2022-10-03,2022,CLE,KCA,2,5,5-2,KCA,10,0,41,38,79,150,159,309,11,7,18,0,3:02
20746,661213,2022-10-03,2022,MIL,ARI,6,5,6-5,MIL,10,0,39,39,78,164,148,312,12,9,21,2,3:19
20747,662431,2022-10-03,2022,OAK,ANA,5,4,5-4,OAK,10,0,45,41,86,149,165,314,15,14,29,3,3:49
20748,662239,2022-10-03,2022,SDN,SFN,7,4,7-4,SDN,9,1,35,39,74,160,140,300,14,13,27,2,3:12
20749,662624,2022-10-04,2022,LAN,COL,2,5,5-2,COL,9,0,34,38,72,145,122,267,7,10,17,0,2:48
20750,662252,2022-10-04,2022,SDN,SFN,6,2,6-2,SDN,9,1,39,33,72,110,149,259,17,7,24,1,2:44
20751,662010,2022-10-04,2022,TEX,NYA,3,2,3-2,TEX,9,1,28,36,64,140,127,267,6,10,16,0,2:36
20752,661094,2022-10-04,2022,NYN,WAS,4,2,4-2,NYN,9,1,37,35,72,147,142,289,13,9,22,2,3:12
20753,662429,2022-10-04,2022,OAK,ANA,2,1,2-1,OAK,10,0,40,39,79,134,137,271,13,11,24,1,3:07
20754,663452,2022-10-04,2022,BOS,TBA,6,0,6-0,BOS,5,0,25,18,43,64,101,165,10,4,14,1,1:44 (:52 delay)
20755,661095,2022-10-04,2022,NYN,WAS,8,0,8-0,NYN,9,1,40,35,75,155,161,316,17,9,26,2,3:09
20756,662199,2022-10-04,2022,SEA,DET,9,6,9-6,SEA,9,1,42,41,83,149,178,327,18,13,31,2,3:22
20757,663243,2022-10-04,2022,CIN,CHN,3,2,3-2,CIN,9,0,33,35,68,135,140,275,10,6,16,3,2:52
20758,663077,2022-10-04,2022,CLE,KCA,5,3,5-3,CLE,9,1,34,34,68,134,130,264,11,6,17,1,2:33
20759,662062,2022-10-04,2022,TEX,NYA,4,5,5-4,NYA,9,0,37,37,74,129,138,267,11,10,21,1,2:45
20760,661095,2022-10-04,2022,NYN,WAS,8,0,8-0,NYN,9,1,40,35,75,155,161,316,17,9,26,2,3:09
20761,662768,2022-10-04,2022,HOU,PHI,10,0,10-0,HOU,9,1,43,32,75,140,142,282,21,5,26,2,3:01
20762,661423,2022-10-04,2022,MIA,ATL,1,2,2-1,ATL,9,0,35,42,77,158,144,302,8,18,26,1,3:09
20763,662200,2022-10-04,2022,SEA,DET,7,6,7-6,SEA,10,0,43,41,84,163,174,337,16,11,27,2,3:24
20764,662319,2022-10-04,2022,PIT,SLN,7,8,8-7,SLN,10,0,47,45,92,159,186,345,20,14,34,4,3:53
20765,661463,2022-10-04,2022,CHA,MIN,8,3,8-3,CHA,9,1,34,34,68,116,147,263,10,8,18,1,2:52
20766,661223,2022-10-04,2022,MIL,ARI,3,0,3-0,MIL,9,1,35,33,68,152,150,302,11,6,17,0,3:02
20767,662789,2022-10-05,2022,HOU,PHI,3,2,3-2,HOU,9,1,33,33,66,159,117,276,14,6,20,1,2:49
20768,662623,2022-10-05,2022,LAN,COL,6,1,6-1,LAN,9,1,36,33,69,128,147,275,12,6,18,1,2:44
20769,662304,2022-10-05,2022,PIT,SLN,5,3,5-3,PIT,9,1,35,36,71,133,141,274,14,10,24,1,2:42
20770,661427,2022-10-05,2022,CHA,MIN,1,10,10-1,MIN,9,0,38,42,80,165,137,302,11,16,27,1,2:46
20771,662421,2022-10-05,2022,OAK,ANA,3,2,3-2,OAK,9,1,31,33,64,131,119,250,6,8,14,2,2:44
20772,663095,2022-10-05,2022,CLE,KCA,9,2,9-2,CLE,9,1,43,34,77,119,138,257,20,7,27,1,2:39
20773,663131,2022-10-05,2022,CIN,CHN,2,15,15-2,CHN,9,0,40,48,88,182,164,346,12,23,35,3,3:20
20774,661996,2022-10-05,2022,TEX,NYA,4,2,4-2,TEX,9,1,35,34,69,130,134,264,14,9,23,1,2:48
20775,662238,2022-10-05,2022,SDN,SFN,1,8,8-1,SFN,9,0,31,44,75,151,135,286,5,17,22,2,3:07
20776,663451,2022-10-05,2022,BAL,TOR,5,4,5-4,BAL,9,1,35,41,76,155,122,277,12,16,28,2,2:46
20777,663272,2022-10-05,2022,BAL,TOR,1,5,5-1,TOR,9,0,35,40,75,153,143,296,9,13,22,4,3:04
20778,663272,2022-10-05,2022,BAL,TOR,1,5,5-1,TOR,9,0,35,40,75,153,143,296,9,13,22,4,3:04
20779,663352,2022-10-05,2022,BOS,TBA,6,3,6-3,BOS,9,1,36,39,75,188,156,344,14,14,28,1,3:21
20780,661422,2022-10-05,2022,MIA,ATL,12,9,12-9,MIA,9,1,41,46,87,200,156,356,19,19,38,5,3:40
20781,662488,2022-10-05,2022,NYN,WAS,9,2,9-2,NYN,9,1,36,35,71,128,139,267,13,9,22,1,2:44 (1:51 delay)
20782,661227,2022-10-05,2022,MIL,ARI,2,4,4-2,ARI,9,0,35,36,71,128,137,265,10,11,21,1,2:43
20783,662195,2022-10-05,2022,SEA,DET,5,4,5-4,SEA,9,0,38,37,75,130,157,287,13,10,23,1,2:48